season,week,gameId,eventId,teamId,playerId,actionType,targetType,targetDirection,targetDepth,yards,yardsAfterCatch,firstContact,yardsAfterContact,yardsBeforeContact,scoreType,inMotion,fumbled,fumbleLost,missedTackles,targetLinedUp,lastUpdate,trueYardage,noContact,rawYardsAfterContact
2019,18,2782,10,4,6983,2,10,5,-4,7,11,-2,9,-2,0,True,False,False,0,1,2020-01-05T13:41:53.323,7,,9.0
2019,18,2782,30,4,5119,2,34,4,-4,4,8,4,0,4,0,True,False,False,1,3,2020-01-05T13:22:30.177,4,,0.0
2019,18,2782,35,4,5224,2,11,3,11,16,5,16,0,16,6,False,False,False,0,6,2020-01-05T13:23:51.413,16,,0.0
2019,18,2782,50,13,2136,2,5,5,5,5,0,5,0,5,0,False,False,False,0,3,2020-01-05T13:27:45.357,5,,0.0
2019,18,2782,70,13,2136,2,12,10,11,11,0,11,0,11,0,False,False,False,0,2,2020-01-05T13:32:12.48,11,,0.0
2019,18,2782,85,13,245,13,6,4,10,0,0,0,0,0,0,False,False,False,0,3,2020-01-05T13:36:20.637,0,,0.0
2019,18,2782,100,4,5119,2,30,9,-3,4,7,3,1,3,0,True,False,False,0,1,2020-02-20T19:02:30.063,4,,1.0
2019,18,2782,110,4,3448,2,13,3,7,7,0,7,0,7,0,False,False,False,0,3,2020-01-05T13:43:45.623,7,,0.0
2019,18,2782,115,4,2629,3,7,6,18,0,0,0,0,0,0,False,False,False,0,3,2020-01-05T13:46:00.18,0,,
2019,18,2782,120,4,1113,3,32,10,-2,0,0,0,0,0,0,False,False,False,0,1,2020-01-05T13:49:29.39,0,,0.0
2019,18,2782,130,4,6953,13,4,3,6,0,0,0,0,0,0,True,False,False,0,2,2020-02-20T19:02:58.173,0,,0.0
2019,18,2782,135,4,594,2,10,10,-2,7,9,4,3,4,0,False,False,False,0,3,2020-01-05T15:15:24.337,7,,3.0
2019,18,2782,150,13,404,2,15,10,-5,5,10,-3,8,-3,0,False,False,False,1,1,2020-01-08T01:12:06.153,5,,8.0
2019,18,2782,155,13,1430,2,5,9,4,11,7,8,3,8,0,False,False,False,1,3,2020-01-05T14:00:23.26,11,,3.0
2019,18,2782,160,13,245,13,4,9,5,0,0,0,0,0,0,False,False,False,0,3,2020-01-05T14:01:36.31,0,,0.0
2019,18,2782,200,4,6983,13,2,9,6,0,0,0,0,0,0,False,False,False,0,2,2020-01-05T14:13:15.51,0,,0.0
2019,18,2782,210,4,5119,2,13,10,7,10,3,11,-1,11,0,False,False,False,0,2,2020-01-05T14:17:37.293,10,,-1.0
2019,18,2782,215,4,1412,2,4,7,20,28,8,28,0,28,0,False,False,False,0,2,2020-01-06T19:48:06.92,28,,0.0
2019,18,2782,225,4,1412,13,8,8,22,0,0,0,0,0,0,False,False,False,0,2,2020-01-05T14:31:49.307,0,,0.0
2019,18,2782,235,4,1412,13,7,2,19,0,0,0,0,0,0,False,False,False,0,3,2020-01-05T14:34:02.473,0,,0.0
2019,18,2782,260,13,1430,2,5,10,8,10,2,9,1,9,0,False,False,False,0,4,2020-01-05T14:39:23.653,10,,1.0
2019,18,2782,280,13,404,2,1,3,1,7,6,5,2,5,0,False,False,False,0,1,2020-01-05T14:48:13.993,7,,2.0
2019,18,2782,320,4,3448,2,35,6,15,15,0,15,0,15,0,False,False,False,0,3,2020-01-06T19:48:21.41,15,,0.0
2019,18,2782,330,4,594,2,26,10,7,21,14,18,3,18,0,False,False,False,1,3,2020-01-05T15:08:04.333,21,,3.0
2019,18,2782,335,4,6983,2,4,5,3,12,9,3,9,3,0,False,False,False,2,2,2020-01-08T01:13:56.633,12,,9.0
2019,18,2782,345,4,1412,2,5,3,2,7,5,5,2,5,0,False,False,False,0,3,2020-01-06T19:48:42.61,7,,2.0
2019,18,2782,350,4,594,2,1,5,1,6,5,3,3,3,0,False,False,False,1,3,2020-01-05T15:13:43.42,6,,3.0
2019,18,2782,355,4,6983,2,12,5,3,3,0,3,0,3,0,False,False,False,0,1,2020-01-05T15:18:30.4,3,,0.0
2019,18,2782,375,4,3448,13,19,2,22,0,0,0,0,0,0,False,False,False,0,2,2020-01-06T19:48:55.42,0,,0.0
2019,18,2782,400,13,3562,13,4,10,5,0,0,0,0,0,0,False,False,False,0,3,2020-01-05T15:41:25.01,0,,0.0
2019,18,2782,425,4,2629,13,13,9,5,0,0,0,0,0,0,False,False,False,0,3,2020-01-05T15:48:59.423,0,,0.0
2019,18,2782,455,13,2136,13,35,6,33,0,0,0,0,0,0,False,False,False,0,3,2020-01-08T00:00:36.76,0,,0.0
2019,18,2782,460,13,245,2,5,3,5,5,0,5,0,5,0,False,True,True,0,2,2020-01-05T16:00:40.513,5,,0.0
2019,18,2782,470,4,1377,2,1,5,1,8,7,4,4,4,0,False,False,False,0,4,2020-01-05T16:17:52.667,8,,4.0
2019,18,2782,515,13,3562,2,1,3,0,5,5,3,2,3,0,False,False,False,0,3,2020-01-05T16:27:27.257,5,,2.0
2019,18,2782,520,13,245,2,6,9,14,14,0,14,0,14,0,False,False,False,0,3,2020-01-05T16:29:33.153,14,,0.0
2019,18,2782,545,13,245,2,5,5,10,10,0,10,0,10,0,False,False,False,0,3,2020-01-05T16:35:15.66,10,,0.0
2019,18,2782,565,4,3448,2,8,8,15,20,5,20,0,20,0,True,False,False,0,3,2020-02-20T19:04:10.617,20,,0.0
2019,18,2782,570,4,5119,2,34,4,-4,5,9,5,0,5,0,True,False,False,0,3,2020-01-05T16:41:56.543,5,,0.0
2019,18,2782,575,4,3448,2,4,5,11,82,71,11,71,11,0,False,False,False,0,2,2020-01-05T16:47:35.16,82,,
2019,18,2782,585,4,3448,2,6,10,6,7,1,6,1,6,0,False,False,False,0,2,2020-01-06T19:49:14.88,7,,1.0
2019,18,2782,600,13,2136,2,29,6,17,20,3,18,2,18,0,False,False,False,0,3,2020-01-05T16:58:38.823,20,,2.0
2019,18,2782,610,13,1430,2,1,5,0,2,2,1,1,1,0,True,False,False,0,4,2020-02-20T19:06:09.393,2,,1.0
2019,18,2782,635,4,6983,2,15,3,-5,2,7,0,2,0,0,False,False,False,0,1,2020-01-05T17:08:22.523,2,,2.0
2019,18,2782,640,4,3448,13,6,9,8,0,0,0,0,0,0,False,False,False,0,3,2020-01-05T17:11:18.25,0,,0.0
2019,18,2782,655,13,245,2,19,0,34,41,7,36,5,36,0,False,False,False,0,2,2020-01-08T01:19:13.047,41,,5.0
2019,18,2782,675,13,1430,2,17,9,9,14,5,9,5,9,0,False,False,False,0,4,2020-01-05T17:35:30.083,14,,5.0
2019,18,2782,685,13,153,2,1,5,-1,5,6,5,0,5,6,False,False,False,0,1,2020-01-05T17:43:51.713,5,,0.0
2019,18,2782,700,4,6983,2,10,9,-6,38,44,32,6,32,0,False,False,False,0,1,2020-01-05T17:49:50.877,38,,6.0
2019,18,2782,785,4,3448,13,29,2,18,0,0,0,0,0,0,False,False,False,0,2,2020-01-05T18:17:19.967,0,,0.0
2019,18,2782,790,4,1412,13,12,2,18,0,0,0,0,0,0,False,False,False,0,2,2020-02-17T17:14:48.18,0,,0.0
2019,18,2782,795,4,1412,2,5,10,14,14,0,14,0,14,0,False,False,False,0,2,2020-01-06T19:49:31.78,14,,0.0
2019,18,2782,805,4,1412,13,35,3,10,0,0,0,0,0,0,False,False,False,0,3,2020-01-05T18:24:55.443,0,,0.0
2019,18,2782,810,4,5119,13,3,6,18,0,0,0,0,0,0,False,False,False,0,2,2020-01-05T18:26:24.203,0,,0.0
2019,18,2782,815,4,594,2,2,9,5,10,5,10,0,10,0,False,False,False,0,3,2020-01-05T18:37:31.147,10,,0.0
2019,18,2782,830,4,3448,13,19,2,29,0,0,0,0,0,0,False,False,False,0,2,2020-01-05T18:33:02.337,0,,0.0
2019,18,2782,835,4,3448,13,19,2,29,0,0,0,0,0,0,False,False,False,0,2,2020-01-05T18:34:01.407,0,,0.0
2019,18,2782,875,13,245,2,6,4,10,10,0,10,0,10,0,False,False,False,0,3,2020-01-05T18:44:11.14,10,,0.0
2019,18,2782,885,13,1430,3,12,9,10,0,0,0,0,0,0,False,False,False,0,4,2020-01-05T18:45:40.393,0,,0.0
2019,18,2782,900,4,710,13,19,2,50,0,0,0,0,0,0,False,False,False,0,2,2020-01-05T18:51:57.793,0,,0.0
2019,18,2782,905,4,6953,2,32,5,7,14,7,7,7,7,0,False,False,False,1,3,2020-01-05T18:53:49.98,14,,7.0
2019,18,2782,910,4,1412,2,1,3,1,1,0,1,0,1,0,False,False,False,0,3,2020-01-05T18:54:33.36,1,,0.0
2019,18,2782,925,4,6983,2,12,5,12,14,2,12,2,12,0,False,False,False,0,2,2020-01-05T18:57:05.153,14,,2.0
2019,18,2782,935,4,594,13,5,3,2,0,0,0,0,0,0,False,False,False,0,3,2020-01-06T19:49:49.507,0,,0.0
2019,18,2782,945,4,3448,3,4,5,3,0,0,0,0,0,0,False,False,False,0,2,2020-01-06T19:50:01.253,0,,0.0
2019,18,2782,955,13,245,2,35,10,10,10,0,10,0,10,0,False,False,False,0,3,2020-01-05T19:05:09.28,10,,0.0
2019,18,2782,970,13,404,2,31,9,9,18,9,16,2,16,0,False,False,False,0,1,2020-01-05T19:09:52.457,18,,2.0
2019,18,2782,980,13,2136,2,5,5,10,10,0,10,0,10,0,False,False,False,0,3,2020-01-05T19:11:58.907,10,,0.0
2019,18,2782,990,13,2497,2,12,5,-1,34,35,29,5,29,0,False,False,False,1,2,2020-01-05T19:14:41.927,34,,5.0
2019,18,2783,10,19,7173,13,4,3,5,0,0,0,0,0,0,False,False,False,0,2,2020-01-05T13:06:58.963,0,,0.0
2019,18,2783,20,19,919,2,35,6,20,21,1,20,1,20,0,False,False,False,0,4,2020-02-27T14:47:33.043,21,,1.0
2019,18,2783,25,19,1328,2,10,9,-3,29,32,23,6,23,0,False,False,False,0,1,2020-01-05T13:14:41.257,29,,6.0
2019,18,2783,30,19,917,13,20,6,25,0,0,0,0,0,0,False,False,False,0,2,2020-01-05T13:16:14.143,0,,0.0
2019,18,2783,40,19,7173,13,13,10,6,0,0,0,0,0,0,False,False,False,0,3,2020-01-05T13:19:14.257,0,,0.0
2019,18,2783,55,31,5096,2,31,10,0,9,9,8,1,8,0,True,False,False,0,4,2020-01-05T13:22:26.013,9,,1.0
2019,18,2783,70,31,3506,2,4,3,3,6,3,5,1,5,0,False,False,False,0,2,2020-01-05T13:27:52.733,6,,1.0
2019,18,2783,90,31,2901,2,30,3,2,4,2,4,0,4,0,False,False,False,0,1,2020-01-08T20:15:24.95,4,,0.0
2019,18,2783,105,31,5080,13,12,2,17,0,0,0,0,0,0,False,False,False,0,3,2020-01-05T13:38:48.217,0,,
2019,18,2783,120,31,6724,2,17,4,12,12,0,12,0,12,6,False,False,False,0,3,2020-01-08T20:13:32.76,12,,0.0
2019,18,2783,140,19,917,2,39,4,5,11,6,7,4,7,0,False,False,False,0,3,2020-01-05T13:49:52.147,11,,4.0
2019,18,2783,155,19,919,2,6,4,10,11,1,11,0,11,0,False,False,False,0,3,2020-01-05T13:54:42.93,11,,0.0
2019,18,2783,160,19,1510,2,10,4,-3,9,12,7,2,7,0,False,False,False,0,1,2020-01-05T13:56:15.537,9,,2.0
2019,18,2783,175,19,6266,2,28,10,-2,2,4,2,0,2,0,False,False,False,0,1,2020-01-05T14:00:17.03,2,,0.0
2019,18,2783,200,31,6793,2,10,3,-1,4,5,3,1,3,0,False,False,False,0,2,2020-01-05T14:04:00.793,4,,1.0
2019,18,2783,210,31,3506,13,4,10,4,0,0,0,0,0,0,True,False,False,0,3,2020-01-05T14:06:32.193,0,,0.0
2019,18,2783,220,19,6266,2,4,9,3,7,4,6,1,6,0,False,False,False,0,1,2020-01-05T14:08:37.057,7,,1.0
2019,18,2783,230,19,54,2,5,5,3,6,3,5,1,5,0,True,False,False,0,2,2020-01-05T14:12:24.78,6,,1.0
2019,18,2783,240,19,1510,2,15,3,-2,11,13,5,6,5,0,False,False,False,0,1,2020-01-08T20:52:49.113,11,,6.0
2019,18,2783,260,31,3506,13,26,10,5,0,0,0,0,0,0,False,False,False,0,3,2020-03-09T21:29:48.223,0,,0.0
2019,18,2783,280,19,917,13,19,6,32,0,0,0,0,0,0,False,False,False,0,2,2020-02-27T14:49:58.757,0,,0.0
2019,18,2783,295,19,7173,2,6,9,6,7,1,7,0,7,0,False,False,False,0,2,2020-01-05T14:26:49.68,7,,0.0
2019,18,2783,305,19,1510,2,10,9,-3,12,15,10,2,10,0,False,False,False,0,1,2020-01-05T14:29:07.253,12,,2.0
2019,18,2783,355,31,5096,13,35,2,26,0,0,0,0,0,0,False,False,False,0,4,2020-01-05T14:35:48.223,0,,0.0
2019,18,2783,380,31,3504,2,10,3,-5,22,27,21,1,21,0,False,False,False,0,1,2020-01-05T14:40:01.67,22,,1.0
2019,18,2783,400,19,1328,2,28,3,4,9,5,8,1,8,0,False,False,False,0,1,2020-01-05T14:43:34.55,9,,1.0
2019,18,2783,410,19,919,2,32,3,2,6,4,6,0,6,0,False,False,False,0,4,2020-01-05T14:44:48.943,6,,0.0
2019,18,2783,415,19,919,3,33,10,4,0,0,0,0,0,0,False,False,False,0,4,2020-01-05T14:46:09.28,0,,0.0
2019,18,2783,420,19,7173,13,19,2,30,0,0,0,0,0,0,False,False,False,0,2,2020-01-05T14:47:30.507,0,,0.0
2019,18,2783,425,19,1328,2,10,9,-2,8,10,8,0,8,0,False,False,False,0,1,2020-01-05T14:48:46.577,8,,0.0
2019,18,2783,430,19,7173,13,19,8,52,0,0,0,0,0,0,False,False,False,0,3,2020-01-05T14:50:28.713,0,,0.0
2019,18,2783,460,31,2901,2,32,5,0,0,0,0,0,0,0,False,False,False,0,1,2020-01-05T14:55:02.11,0,,0.0
2019,18,2783,470,31,6724,3,7,2,16,0,0,0,0,0,0,True,False,False,0,3,2020-01-08T20:13:32.76,0,,0.0
2019,18,2783,490,19,7173,2,4,10,12,14,2,11,3,11,0,False,False,False,0,3,2020-01-05T15:02:41.853,14,,3.0
2019,18,2783,495,19,7173,3,10,3,0,0,0,0,0,0,0,False,False,False,0,2,2020-02-25T19:25:05.207,0,,0.0
2019,18,2783,500,19,54,13,5,3,12,0,0,0,0,0,0,False,False,False,0,2,2020-01-05T15:05:27.43,0,,0.0
2019,18,2783,505,19,919,2,12,1,36,38,2,36,2,36,0,False,False,False,0,3,2020-01-05T15:08:01.497,38,,
2019,18,2783,510,19,1328,2,10,9,-5,-4,1,-5,1,-5,0,False,False,False,0,1,2020-01-05T15:09:25.07,-4,,1.0
2019,18,2783,525,31,3506,13,17,8,19,0,0,0,0,0,0,False,False,False,0,3,2020-01-05T15:13:08.29,0,,
2019,18,2783,540,31,5080,13,19,2,34,0,0,0,0,0,0,False,False,False,0,2,2020-01-05T15:17:27.963,0,,0.0
2019,18,2783,560,19,54,2,5,7,16,20,4,19,1,19,0,False,False,False,0,3,2020-01-05T15:21:40.577,20,,1.0
2019,18,2783,570,19,917,13,10,9,0,0,0,0,0,0,0,False,False,False,0,3,2020-01-05T15:24:10.84,0,,0.0
2019,18,2783,575,19,7173,13,4,5,7,0,0,0,0,0,0,False,False,False,0,2,2020-01-05T15:25:48.223,0,,0.0
2019,18,2783,610,31,5080,13,7,2,27,0,0,0,0,0,0,False,False,False,0,3,2020-03-09T21:31:00.457,0,,0.0
2019,18,2783,615,19,1116,13,8,1,51,0,0,0,0,0,0,False,False,False,0,3,2020-01-05T15:33:23.163,0,,0.0
2019,18,2783,620,19,1328,2,5,3,4,6,2,5,1,5,0,False,False,False,0,1,2020-01-05T15:34:39.46,6,,
2019,18,2783,625,19,54,2,6,4,3,4,1,3,1,3,0,True,False,False,0,3,2020-01-05T15:36:27.777,4,,1.0
2019,18,2783,635,19,1116,13,3,3,12,0,0,0,0,0,0,False,False,False,0,2,2020-03-09T21:31:38.107,0,,0.0
2019,18,2783,655,31,2288,2,28,3,5,8,3,8,0,8,0,False,False,False,0,1,2020-01-05T15:43:19.99,8,,0.0
2019,18,2783,715,19,1328,2,28,4,4,20,16,12,8,12,0,False,False,False,2,1,2020-01-05T15:58:36.67,20,,8.0
2019,18,2783,720,19,1116,2,4,3,6,6,0,6,0,6,0,False,False,False,0,2,2020-01-05T15:59:33.83,6,,0.0
2019,18,2783,725,19,54,3,5,3,6,0,0,0,0,0,0,False,False,False,0,3,2020-01-05T16:00:57.643,0,,0.0
2019,18,2783,730,19,1116,13,6,10,5,0,0,0,0,0,0,False,False,False,0,2,2020-01-05T16:02:12.12,0,,0.0
2019,18,2783,750,31,5080,2,5,5,7,8,1,7,1,7,0,False,False,False,0,2,2020-01-05T16:04:54.347,8,,
2019,18,2783,760,31,6724,2,7,3,11,11,0,11,0,11,0,True,False,False,0,3,2020-01-08T20:13:32.76,11,,0.0
2019,18,2783,815,19,917,13,4,10,9,0,0,0,0,0,0,True,False,False,0,2,2020-01-05T16:14:46.967,0,,0.0
2019,18,2784,10,18,2853,13,35,9,10,0,0,0,0,0,0,False,False,False,0,2,2020-03-11T21:07:08.567,0,,
2019,18,2784,20,18,1381,2,30,10,-3,3,6,1,2,1,0,False,True,True,0,3,2020-01-06T12:33:35.527,3,,2.0
2019,18,2784,40,20,3763,2,5,3,5,12,7,9,3,9,0,False,False,False,0,3,2020-01-06T13:38:51.507,12,,3.0
2019,18,2784,45,20,5140,13,1,3,3,0,0,0,0,0,0,False,False,False,0,1,2020-01-06T13:41:54.87,0,,
2019,18,2784,55,20,958,2,4,10,3,4,1,4,0,4,0,False,False,False,0,3,2020-01-06T13:47:27.88,4,,0.0
2019,18,2784,90,18,6900,2,15,5,-3,10,13,7,3,7,0,False,False,False,0,1,2020-01-06T13:52:32.547,10,,3.0
2019,18,2784,100,18,813,2,4,4,5,5,0,5,0,5,0,False,False,False,0,4,2020-01-06T13:56:11.273,5,,0.0
2019,18,2784,115,18,813,13,17,1,19,0,0,0,0,0,0,False,False,False,0,4,2020-01-06T14:00:08.707,0,,0.0
2019,18,2784,120,18,6897,2,2,9,4,9,5,9,0,9,0,False,False,False,0,3,2020-01-06T14:01:31.603,9,,0.0
2019,18,2784,135,20,3763,2,4,3,5,5,0,5,0,5,0,False,False,False,0,2,2020-01-06T14:03:58.137,5,,0.0
2019,18,2784,145,20,5140,13,1,3,1,0,0,0,0,0,0,False,False,False,0,1,2020-09-09T16:18:52.783,0,,0.0
2019,18,2784,170,18,813,2,32,5,2,9,7,1,8,1,0,False,False,False,1,4,2020-01-06T14:12:33.717,9,,8.0
2019,18,2784,190,20,3763,2,5,6,15,15,0,15,0,15,0,False,False,False,0,2,2020-09-09T16:19:44.893,15,,0.0
2019,18,2784,195,20,1162,2,1,10,1,1,0,1,0,1,0,False,False,False,0,1,2020-09-09T16:20:25.133,1,,0.0
2019,18,2784,200,20,1162,13,10,10,-3,0,0,0,0,0,0,False,False,False,0,4,2020-01-06T14:19:51.837,0,,0.0
2019,18,2784,205,20,1162,2,31,10,2,2,0,2,0,2,0,False,False,False,0,4,2020-09-09T16:21:02.533,2,,0.0
2019,18,2784,225,18,813,13,2,10,6,0,0,0,0,0,0,False,False,False,0,3,2020-01-06T14:26:31.493,0,,0.0
2019,18,2784,245,20,7353,2,8,1,48,50,2,49,1,49,0,False,False,False,0,3,2020-01-06T14:31:03.17,50,,1.0
2019,18,2784,265,18,1381,13,35,1,20,0,0,0,0,0,0,False,False,False,0,2,2020-01-06T14:35:21.297,0,,0.0
2019,18,2784,275,18,813,2,38,4,1,13,12,4,9,4,0,False,False,False,2,4,2020-01-06T14:37:36.58,13,,9.0
2019,18,2784,295,18,1381,2,5,3,8,8,0,8,0,8,0,False,False,False,0,3,2020-01-06T14:41:41.873,8,,0.0
2019,18,2784,305,18,4572,2,10,10,-4,19,23,19,0,19,0,False,False,False,0,1,2020-01-06T14:44:27.59,19,,0.0
2019,18,2784,315,18,6361,13,32,3,1,0,0,0,0,0,0,False,False,False,0,4,2020-01-06T14:49:05.793,0,,0.0
2019,18,2784,340,20,6388,13,8,1,26,0,0,0,0,0,0,False,False,False,0,3,2020-01-06T14:52:14.947,0,,0.0
2019,18,2784,345,20,5140,2,10,10,-6,4,10,2,2,2,0,True,False,False,0,1,2020-02-20T19:08:56.53,4,,2.0
2019,18,2784,350,20,509,13,8,8,44,0,0,0,0,0,0,False,False,False,0,2,2020-03-11T21:35:13.18,0,,0.0
2019,18,2784,365,18,1381,2,8,1,18,19,1,19,0,19,0,False,False,False,0,3,2020-01-06T14:56:42.83,19,,0.0
2019,18,2784,370,18,4572,13,10,10,-5,0,0,0,0,0,0,False,False,False,0,1,2020-01-06T14:57:44.243,0,,0.0
2019,18,2784,390,18,1381,2,5,3,8,13,5,13,0,13,0,False,False,False,0,3,2020-01-06T15:00:40.827,13,,0.0
2019,18,2784,395,18,813,13,5,3,5,0,0,0,0,0,0,False,False,False,0,3,2020-01-06T15:02:51.34,0,,0.0
2019,18,2784,415,20,3763,2,6,7,20,20,0,20,0,20,0,False,False,False,0,2,2020-01-06T15:05:36.84,20,,0.0
2019,18,2784,450,20,306,2,10,10,-7,4,11,1,3,1,0,False,False,False,1,1,2020-09-09T16:23:39.623,4,,3.0
2019,18,2784,455,20,3763,2,5,3,4,6,2,5,1,5,0,False,False,False,0,3,2020-09-09T16:24:44.203,6,,1.0
2019,18,2784,465,20,5140,2,34,4,-4,-6,-2,-6,0,-6,0,True,False,False,0,1,2020-03-09T21:23:47.5,-6,,0.0
2019,18,2784,485,18,4572,2,4,4,3,11,8,8,3,8,0,False,False,False,0,1,2020-01-06T15:37:44.173,11,,3.0
2019,18,2784,490,18,6897,3,6,10,5,0,0,0,0,0,0,False,False,False,0,3,2020-01-06T15:39:43.4,0,,0.0
2019,18,2784,505,20,5140,2,5,3,4,9,5,8,1,8,0,False,False,False,0,1,2020-01-06T15:45:19.287,9,,1.0
2019,18,2784,510,20,3763,13,4,9,12,0,0,0,0,0,0,False,False,False,0,3,2020-01-06T15:46:34.443,0,,0.0
2019,18,2784,520,18,6907,13,35,10,11,0,0,0,0,0,0,False,False,False,0,4,2020-01-06T15:48:37.607,0,,
2019,18,2784,530,18,1381,13,6,10,12,0,0,0,0,0,0,False,False,False,0,3,2020-01-06T15:51:40.277,0,,0.0
2019,18,2784,535,18,1381,2,19,2,28,34,6,34,0,34,0,True,False,False,0,2,2020-03-09T21:24:37.95,34,,0.0
2019,18,2784,540,18,6897,2,30,3,2,8,6,5,3,5,0,True,False,False,0,3,2020-01-06T15:54:26.387,8,,3.0
2019,18,2784,550,18,2853,2,35,9,9,9,0,9,0,9,0,False,False,False,0,2,2020-03-09T21:25:31.903,9,,0.0
2019,18,2784,575,20,306,13,15,3,-3,0,0,0,0,0,0,False,False,False,0,1,2020-01-06T16:00:44.37,0,,0.0
2019,18,2784,585,20,5140,2,10,3,-4,3,7,0,3,0,0,False,False,False,0,2,2020-01-06T16:03:09.657,3,,3.0
2019,18,2784,610,18,6900,13,10,10,-2,0,0,0,0,0,0,False,False,False,0,1,2020-01-06T16:06:25.273,0,,0.0
2019,18,2784,630,20,958,2,5,3,13,14,1,14,0,14,0,False,False,False,0,3,2020-09-09T16:26:59.67,14,,0.0
2019,18,2784,640,20,5140,2,4,9,5,5,0,5,0,5,0,False,False,False,0,1,2020-01-06T16:27:34.203,5,,0.0
2019,18,2784,645,20,958,2,2,10,6,14,8,8,6,8,0,False,False,False,1,3,2020-09-09T16:27:52.613,14,,6.0
2019,18,2784,650,20,509,2,5,2,18,18,0,18,0,18,0,False,False,False,0,3,2020-03-11T21:30:20.73,18,,0.0
2019,18,2784,665,20,4535,2,9,6,20,20,0,20,0,20,6,True,False,False,0,2,2020-09-09T16:28:38.843,20,,0.0
2019,18,2784,705,18,6896,13,8,1,26,0,0,0,0,0,0,False,False,False,0,3,2020-01-06T17:02:24.24,0,,0.0
2019,18,2784,715,20,4535,2,30,10,-2,5,7,3,2,3,0,False,False,False,0,4,2020-09-09T16:29:30.18,5,,2.0
2019,18,2784,720,20,5140,2,12,5,3,4,1,4,0,4,0,False,False,False,0,1,2020-09-09T16:30:30.693,4,,0.0
2019,18,2784,735,20,3763,2,5,3,3,5,2,3,2,3,0,False,False,False,0,3,2020-09-09T16:31:50.543,5,,2.0
2019,18,2784,755,18,2853,13,25,6,28,0,0,0,0,0,0,False,False,False,0,3,2020-01-06T17:28:17.463,0,,0.0
2019,18,2784,760,18,1381,2,5,5,10,9,-1,9,0,9,0,False,False,False,0,3,2020-01-06T17:30:04.353,9,,0.0
2019,18,2784,790,20,5140,2,15,5,-4,6,10,2,4,2,0,False,False,False,1,1,2020-01-06T17:35:59.56,6,,4.0
2019,18,2784,795,20,958,2,5,5,7,8,1,8,0,8,0,False,False,False,0,3,2020-01-06T17:36:59.037,8,,0.0
2019,18,2784,800,20,5140,2,4,10,5,9,4,9,0,9,0,False,False,False,0,3,2020-01-06T17:38:02.37,9,,0.0
2019,18,2784,805,20,3763,2,2,10,6,7,1,6,1,6,0,False,False,False,0,3,2020-01-06T17:39:06.35,7,,1.0
2019,18,2784,810,20,958,2,13,5,4,14,10,4,10,4,0,False,False,False,2,3,2020-01-06T17:40:47.633,14,,10.0
2019,18,2784,860,18,4572,2,1,3,4,6,2,6,0,6,0,False,False,False,0,1,2020-01-06T17:46:53.647,6,,0.0
2019,18,2784,865,18,2853,2,2,9,6,10,4,7,3,7,0,False,False,False,0,2,2020-01-06T17:47:59.86,10,,3.0
2019,18,2784,870,18,4572,13,10,3,-8,0,0,0,0,0,0,False,False,False,0,1,2020-01-06T17:49:24.637,0,,0.0
2019,18,2784,880,18,1381,2,19,2,40,43,3,41,2,41,0,False,False,False,0,2,2020-02-27T14:51:42.367,43,,2.0
2019,18,2784,900,18,813,2,9,3,4,4,0,4,0,4,6,False,False,False,0,2,2020-03-09T21:26:12.09,4,,0.0
2019,18,2785,10,27,7408,2,2,10,7,9,2,7,2,7,0,False,False,False,0,2,2020-01-06T15:24:09.957,9,,2.0
2019,18,2785,20,27,650,13,5,5,4,0,0,0,0,0,0,False,False,False,0,3,2020-01-06T15:27:02.983,0,,0.0
2019,18,2785,40,24,4382,13,7,6,17,0,0,0,0,0,0,False,False,False,0,3,2020-01-08T15:17:38.61,0,,0.0
2019,18,2785,65,27,7408,13,10,9,-1,0,0,0,0,0,0,False,False,False,0,2,2020-01-06T15:37:23.937,0,,0.0
2019,18,2785,75,27,650,13,35,2,15,0,0,0,0,0,0,False,False,False,0,3,2020-01-06T15:39:57.92,0,,0.0
2019,18,2785,95,24,7003,2,2,4,5,6,1,5,1,5,0,False,False,False,0,2,2020-01-06T15:45:59.16,6,,
2019,18,2785,105,24,6937,13,12,9,10,0,0,0,0,0,0,False,False,False,0,1,2020-01-06T15:51:39.323,0,,0.0
2019,18,2785,110,24,6389,2,32,10,-2,3,5,0,3,0,0,False,False,False,0,1,2020-01-06T15:53:54.87,3,,3.0
2019,18,2785,125,27,657,2,1,3,1,5,4,3,2,3,0,False,False,False,0,1,2020-01-06T15:56:30.157,5,,2.0
2019,18,2785,130,27,650,2,5,5,1,7,6,3,4,3,0,False,False,False,0,3,2020-01-06T15:57:56.77,7,,4.0
2019,18,2785,140,27,5069,13,29,2,18,0,0,0,0,0,0,False,False,False,0,2,2020-01-06T16:00:02.63,0,,0.0
2019,18,2785,145,27,7408,2,12,2,22,24,2,22,2,22,0,False,False,False,0,3,2020-03-09T21:11:00.28,24,,2.0
2019,18,2785,155,27,650,2,12,5,13,13,0,13,0,13,0,False,False,False,0,2,2020-01-06T16:04:46.1,13,,0.0
2019,18,2785,165,27,650,13,17,8,18,0,0,0,0,0,0,False,False,False,0,3,2020-01-08T14:08:39.487,0,,0.0
2019,18,2785,210,24,6937,2,10,10,-8,-5,3,-7,2,-7,0,False,False,False,0,1,2020-01-06T16:17:17.673,-5,,2.0
2019,18,2785,220,27,7408,2,5,5,8,8,0,8,0,8,0,False,False,False,0,3,2020-01-06T16:20:11.73,8,,0.0
2019,18,2785,225,27,650,2,4,4,13,13,0,13,0,13,0,False,False,False,0,2,2020-01-06T16:22:11.543,13,,0.0
2019,18,2785,235,27,4835,2,29,3,12,14,2,14,0,14,0,False,False,False,0,3,2020-01-06T16:25:02.39,14,,
2019,18,2785,240,27,650,2,12,6,26,29,3,26,3,26,0,False,False,False,0,3,2020-01-06T16:28:17.66,29,,3.0
2019,18,2785,245,27,7404,2,4,9,1,3,2,1,2,1,0,False,False,False,0,1,2020-01-06T16:30:10.607,3,,
2019,18,2785,255,27,7404,2,15,5,-4,5,9,2,3,2,0,False,False,False,0,1,2020-01-06T16:32:55.373,5,,3.0
2019,18,2785,265,27,657,13,10,9,-4,0,0,0,0,0,0,False,False,False,0,3,2020-01-06T16:34:37.883,0,,0.0
2019,18,2785,275,24,6673,2,5,3,5,5,0,5,0,5,0,True,False,False,0,3,2020-01-06T16:36:49.903,5,,0.0
2019,18,2785,285,24,6373,2,39,4,5,5,0,5,0,5,0,False,False,False,0,4,2020-01-06T16:40:07.343,5,,0.0
2019,18,2785,300,24,894,3,5,3,7,0,0,0,0,0,0,False,False,False,0,3,2020-01-06T16:58:09.253,0,,0.0
2019,18,2785,315,24,6373,2,6,1,15,17,2,16,1,16,0,False,False,False,0,3,2020-01-06T17:01:04.733,17,,1.0
2019,18,2785,335,24,6389,2,10,3,-5,-1,4,-1,0,-1,0,True,False,False,0,1,2020-01-06T17:08:24.243,-1,,0.0
2019,18,2785,350,27,7408,2,4,3,3,4,1,2,2,2,0,False,False,False,0,2,2020-01-06T17:10:48.003,4,,2.0
2019,18,2785,365,27,7408,2,13,10,4,26,22,26,0,26,0,False,False,False,0,2,2020-01-06T17:13:23.683,26,,0.0
2019,18,2785,375,27,650,13,9,6,23,0,0,0,0,0,0,False,False,False,0,3,2020-01-08T14:11:27.94,0,,0.0
2019,18,2785,380,27,5069,13,19,2,41,0,0,0,0,0,0,False,False,False,0,2,2020-01-08T14:16:57.4,0,,0.0
2019,18,2785,390,27,5069,2,6,10,4,38,34,3,35,3,0,False,False,False,2,3,2020-01-08T14:40:34.977,38,,35.0
2019,18,2785,400,27,650,13,12,5,-4,0,0,0,0,0,0,False,False,False,0,3,2020-01-06T17:28:39.863,0,,0.0
2019,18,2785,410,27,7408,13,2,10,8,0,0,0,0,0,0,False,False,False,0,2,2020-01-08T15:08:59.15,0,,
2019,18,2785,435,24,6373,2,39,4,6,6,0,6,0,6,0,False,False,False,0,3,2020-01-06T17:35:44.117,6,,0.0
2019,18,2785,465,24,894,2,35,2,17,32,15,32,0,32,0,False,False,False,0,3,2020-01-06T17:48:11.557,32,,0.0
2019,18,2785,475,24,4382,13,9,2,30,0,0,0,0,0,0,False,False,False,0,3,2020-01-06T17:50:50.957,0,,
2019,18,2785,490,24,6373,2,1,3,2,2,0,2,0,2,0,False,False,False,0,4,2020-03-09T21:12:11.46,2,,0.0
2019,18,2785,515,27,4835,2,30,9,-1,9,10,8,1,8,0,False,False,False,0,4,2020-01-06T18:08:51.223,9,,1.0
2019,18,2785,520,27,4835,13,32,10,-4,0,0,0,0,0,0,False,False,False,0,4,2020-01-06T18:10:11.85,0,,0.0
2019,18,2785,530,27,657,2,1,10,0,20,20,17,3,17,0,False,False,False,0,1,2020-01-06T18:12:22.123,20,,3.0
2019,18,2785,540,27,7408,2,17,7,36,53,17,48,5,48,6,False,False,False,0,3,2020-01-06T18:16:05.43,53,,5.0
2019,18,2785,560,24,6373,2,4,9,7,14,7,12,2,12,0,False,False,False,0,3,2020-01-06T18:19:11.51,14,,2.0
2019,18,2785,570,24,4382,2,5,9,4,14,10,11,3,11,0,False,False,False,0,3,2020-01-06T18:22:17.647,14,,3.0
2019,18,2785,585,24,4382,2,34,4,-4,-6,-2,-6,0,-6,0,True,False,False,0,3,2020-03-09T21:12:52.557,-6,,0.0
2019,18,2785,590,24,6389,2,4,9,2,21,19,20,1,20,0,False,False,False,0,1,2020-01-06T18:30:14.203,21,,1.0
2019,18,2785,620,27,7408,13,9,2,26,0,0,0,0,0,0,False,False,False,0,2,2020-01-06T18:35:11.713,0,,0.0
2019,18,2785,655,27,5069,2,6,4,11,19,8,19,0,19,0,True,False,False,1,2,2020-01-06T18:44:03.11,19,,0.0
2019,18,2785,685,24,4382,2,6,8,16,16,0,16,0,16,0,False,False,False,0,3,2020-01-08T15:18:33.67,16,,0.0
2019,18,2785,690,24,894,2,5,5,10,12,2,12,0,12,0,False,False,False,0,4,2020-03-09T21:14:03.697,12,,0.0
2019,18,2785,700,24,6937,2,1,3,1,7,6,5,2,5,0,False,False,False,1,1,2020-01-06T18:55:24.56,7,,2.0
2019,18,2785,725,24,6373,2,31,9,5,12,7,9,3,9,0,True,False,False,0,4,2020-01-06T19:01:06.513,12,,3.0
2019,18,2785,730,24,6937,3,15,3,1,0,0,0,0,0,0,False,False,False,0,1,2020-01-06T19:02:04.647,0,,0.0
2019,18,2785,745,27,4835,2,31,9,5,7,2,7,0,7,0,False,False,False,0,3,2020-01-06T19:07:50.973,7,,0.0
2019,18,2785,755,24,894,13,8,1,16,0,0,0,0,0,0,False,False,False,0,4,2020-01-06T19:09:33.05,0,,0.0
2019,18,2785,760,24,6373,2,5,3,13,17,4,15,2,15,0,False,False,False,0,4,2020-01-08T14:13:41.737,17,,2.0
2019,18,2785,765,24,6373,13,12,10,4,0,0,0,0,0,0,False,False,False,0,3,2020-01-06T19:13:26.597,0,,0.0
2019,18,2785,770,24,4397,13,7,6,40,0,0,0,0,0,0,False,False,False,0,2,2020-01-08T15:19:01.573,0,,
2019,18,2785,785,24,6937,2,1,3,1,6,5,5,1,5,0,False,False,False,0,1,2020-01-06T19:26:25.017,6,,1.0
2019,18,2785,820,27,7408,2,21,8,33,36,3,34,2,34,0,False,False,False,0,2,2020-01-06T19:21:51.957,36,,2.0
2019,19,2786,20,18,2853,13,5,3,11,0,0,0,0,0,0,False,False,False,0,3,2020-01-15T18:34:11.48,0,,
2019,19,2786,35,28,7224,2,2,4,6,10,4,8,2,8,0,False,False,False,0,3,2020-01-12T12:30:06.6,10,,
2019,19,2786,40,28,4922,3,5,3,8,0,0,0,0,0,0,False,False,False,0,4,2020-01-12T19:28:40.207,0,,
2019,19,2786,45,28,213,2,35,6,21,22,1,21,1,21,0,False,False,False,0,3,2020-01-12T12:35:18.483,22,,
2019,19,2786,50,28,213,2,2,4,7,11,4,11,0,11,0,False,False,False,0,3,2020-01-12T12:38:54.347,11,,
2019,19,2786,60,28,4922,2,2,9,7,11,4,10,1,10,0,False,False,False,0,3,2020-01-12T12:44:59.313,11,,
2019,19,2786,65,28,4912,2,2,4,3,3,0,3,0,3,6,False,False,False,0,3,2020-01-12T12:46:54.883,3,,
2019,19,2786,85,18,2853,13,4,3,10,0,0,0,0,0,0,False,False,False,0,2,2020-01-12T12:51:54.56,0,,
2019,19,2786,90,18,6361,2,10,4,-6,5,11,4,1,4,0,False,False,False,0,4,2020-01-12T12:59:16.447,5,,
2019,19,2786,95,18,6907,2,30,10,-2,3,5,0,3,0,0,False,False,False,1,4,2020-01-15T15:44:47.563,3,,
2019,19,2786,100,18,1381,2,2,9,9,12,3,12,0,12,0,False,False,False,0,2,2020-01-12T13:08:01.803,12,,
2019,19,2786,105,18,4572,2,4,9,3,4,1,3,1,3,0,False,False,False,0,1,2020-01-12T13:11:04.997,4,,
2019,19,2786,115,18,2853,2,19,6,21,41,20,41,0,41,6,False,False,False,0,2,2020-01-12T13:14:07.617,41,,
2019,19,2786,150,28,7224,13,2,10,8,0,0,0,0,0,0,False,False,False,0,2,2020-01-12T13:45:39.003,0,,
2019,19,2786,160,28,4912,2,35,2,16,16,0,16,0,16,0,False,False,False,0,3,2020-01-12T13:54:56.033,16,,
2019,19,2786,175,28,4922,13,6,4,13,0,0,0,0,0,0,True,False,False,0,3,2020-01-15T18:15:53.52,0,,
2019,19,2786,220,28,4912,13,4,10,11,0,0,0,0,0,0,False,False,False,0,3,2020-03-09T21:02:30.403,0,,
2019,19,2786,235,28,7224,2,6,3,11,14,3,12,2,12,0,False,False,False,2,3,2020-03-09T21:03:39.757,14,,
2019,19,2786,260,28,7224,2,9,3,9,18,9,14,4,14,0,False,False,False,0,3,2020-01-15T18:17:28.847,18,,
2019,19,2786,290,18,4572,2,4,4,1,1,0,-1,2,-1,0,False,False,False,0,1,2020-01-12T15:02:56.187,1,,
2019,19,2786,295,18,813,2,13,10,3,3,0,3,0,3,0,False,False,False,0,4,2020-01-12T15:04:36.62,3,,
2019,19,2786,320,28,7224,13,6,10,10,0,0,0,0,0,0,False,False,False,0,2,2020-01-12T15:16:31.673,0,,
2019,19,2786,325,18,4572,2,10,4,-4,4,8,-2,6,-2,0,False,False,False,1,1,2020-01-15T15:46:40.427,4,,
2019,19,2786,335,18,1381,2,5,3,5,9,4,9,0,9,0,False,False,False,0,3,2020-01-12T15:22:29.2,9,,
2019,19,2786,340,18,4572,2,10,9,-4,-1,3,-3,2,-3,0,False,False,False,0,1,2020-01-15T18:34:56.97,-1,,
2019,19,2786,345,18,2853,13,5,3,11,0,0,0,0,0,0,False,False,False,0,2,2020-01-12T15:26:24.673,0,,
2019,19,2786,395,28,7224,13,6,4,14,0,0,0,0,0,0,False,False,False,0,2,2020-03-09T21:04:23.743,0,,
2019,19,2786,400,28,4912,2,6,1,16,21,5,19,2,19,0,True,False,False,0,3,2020-01-12T16:16:42.74,21,,
2019,19,2786,445,18,4572,13,5,10,-1,0,0,0,0,0,0,False,False,False,0,1,2020-01-15T18:35:28.463,0,,
2019,19,2786,450,18,1381,13,4,10,9,0,0,0,0,0,0,False,False,False,0,2,2020-01-12T16:33:25.32,0,,
2019,19,2786,505,18,1381,2,5,3,3,5,2,4,1,4,0,False,False,False,0,3,2020-01-12T16:49:39.527,5,,
2019,19,2786,510,18,813,2,32,4,0,1,1,0,1,0,0,False,False,False,0,4,2020-01-12T17:33:04.483,1,,
2019,19,2786,515,18,813,13,5,6,16,0,0,0,0,0,0,True,False,False,0,3,2020-01-15T18:20:46.823,0,,
2019,19,2786,550,28,4922,2,10,5,-3,4,7,2,2,2,0,True,False,False,0,1,2020-03-03T16:09:19.493,4,,
2019,19,2786,560,28,4922,2,10,10,-2,1,3,-1,2,-1,0,True,False,False,0,4,2020-03-09T21:05:34.52,1,,
2019,19,2786,575,18,1381,3,4,5,10,0,0,0,0,0,0,False,False,False,0,2,2020-01-12T17:52:34.657,0,,
2019,19,2786,580,18,6890,2,12,4,-2,2,4,1,1,1,0,False,False,False,0,5,2020-02-26T16:06:53.393,2,,
2019,19,2786,605,28,4912,3,2,10,4,0,0,0,0,0,0,False,False,False,0,2,2020-01-12T18:00:35.67,0,,
2019,19,2786,620,18,4572,2,10,10,-3,-2,1,-3,1,-3,0,False,True,False,0,1,2020-01-12T18:06:16.23,-2,,
2019,19,2786,670,18,2853,2,6,9,5,16,11,11,5,11,0,False,False,False,1,2,2020-01-12T18:39:06.73,16,,
2019,19,2786,675,18,4572,3,13,4,1,0,0,0,0,0,0,False,False,False,0,1,2020-01-15T18:35:42.553,0,,
2019,19,2786,680,18,6907,2,5,3,9,15,6,13,2,13,0,False,False,False,0,4,2020-01-12T18:42:40.837,15,,
2019,19,2786,685,18,4572,2,16,4,1,2,1,1,1,1,0,False,False,False,0,1,2020-01-12T18:44:40.89,2,,
2019,19,2786,690,18,1381,2,4,3,7,7,0,7,0,7,0,False,False,False,0,2,2020-01-15T18:21:40.84,7,,
2019,19,2786,705,18,2853,13,19,6,32,0,0,0,0,0,0,False,False,False,0,2,2020-01-12T18:49:41.37,0,,
2019,19,2786,740,18,1381,2,3,3,13,17,4,16,1,16,0,False,False,False,0,2,2020-01-12T18:57:27.723,17,,
2019,19,2786,760,18,566,2,6,10,3,7,4,5,2,5,0,False,False,False,0,1,2020-01-15T18:22:14.473,7,,
2019,19,2786,765,18,6907,2,17,1,20,21,1,21,0,21,0,False,False,False,0,4,2020-01-15T18:35:55.307,21,,
2019,19,2787,15,31,2901,2,13,9,5,15,10,14,1,14,0,False,False,False,0,4,2020-01-12T14:21:07.197,15,,
2019,19,2787,25,31,3504,2,10,5,-1,-1,0,-1,0,-1,0,False,False,False,0,1,2020-01-12T14:23:40.657,-1,,
2019,19,2787,35,31,6793,13,6,7,22,0,0,0,0,0,0,False,False,False,0,2,2020-01-12T14:26:05.507,0,,
2019,19,2787,60,3,6454,2,5,3,12,12,0,12,0,12,0,True,False,False,0,3,2020-01-12T14:33:08.257,12,,
2019,19,2787,75,3,6454,13,35,9,13,0,0,0,0,0,0,False,False,False,0,4,2020-01-12T14:38:00.267,0,,
2019,19,2787,115,31,5096,2,24,3,12,12,0,12,0,12,6,False,False,False,0,3,2020-01-12T14:47:50.13,12,,
2019,19,2787,135,3,2688,2,12,4,5,6,1,6,0,6,0,False,False,False,0,3,2020-01-12T14:50:50.487,6,,
2019,19,2787,150,3,2847,2,26,3,4,4,0,4,0,4,0,False,False,False,0,2,2020-01-12T14:53:50.25,4,,
2019,19,2787,165,31,4037,2,23,7,45,45,0,45,0,45,6,False,False,False,0,3,2020-01-12T14:58:35.84,45,,
2019,19,2787,180,3,2847,3,35,7,20,0,0,0,0,0,0,False,False,False,0,3,2020-01-12T15:00:51.343,0,,
2019,19,2787,190,3,6936,13,3,6,17,0,0,0,0,0,0,False,False,False,0,2,2020-01-14T00:23:51.817,0,,
2019,19,2787,210,31,3506,13,19,6,30,0,0,0,0,0,0,False,False,False,0,2,2020-01-12T15:06:30.527,0,,
2019,19,2787,220,31,3506,13,7,6,25,0,0,0,0,0,0,False,False,False,0,3,2020-01-15T01:30:23.907,0,,
2019,19,2787,240,3,2847,13,6,10,13,0,0,0,0,0,0,False,False,False,0,2,2020-01-12T15:13:34.723,0,,
2019,19,2787,245,3,6936,13,5,5,11,0,0,0,0,0,0,False,False,False,0,2,2020-01-15T01:30:47.62,0,,
2019,19,2787,250,3,6936,2,4,7,21,30,9,30,0,30,0,False,False,False,0,2,2020-01-12T15:16:42.44,30,,
2019,19,2787,265,3,6454,2,4,4,10,16,6,14,2,14,0,False,False,False,0,4,2020-01-12T15:20:20.767,16,,
2019,19,2787,270,3,6936,13,5,2,18,0,0,0,0,0,0,False,False,False,0,3,2020-01-15T01:31:13.273,0,,
2019,19,2787,280,3,2688,3,6,9,8,0,0,0,0,0,0,False,False,False,0,3,2020-01-15T16:45:27.303,0,,
2019,19,2787,295,31,5096,2,30,10,-2,0,2,0,0,0,0,False,False,False,0,4,2020-01-12T15:29:16.857,0,,
2019,19,2787,310,31,3504,2,10,9,-4,8,12,2,6,2,0,False,False,False,0,1,2020-01-12T16:04:18.813,8,,
2019,19,2787,320,31,5080,13,39,8,17,0,0,0,0,0,0,True,False,False,0,3,2020-02-20T19:17:22.233,0,,
2019,19,2787,330,3,2688,2,6,4,5,5,0,5,0,5,0,False,False,False,0,3,2020-01-12T16:11:36.033,5,,
2019,19,2787,340,3,6918,2,1,5,-1,5,6,5,0,5,0,False,False,False,0,1,2020-01-12T16:14:28.333,5,,
2019,19,2787,360,3,2847,2,35,8,21,26,5,25,1,25,0,False,False,False,0,2,2020-01-15T01:31:42.063,26,,
2019,19,2787,365,3,6918,13,12,6,27,0,0,0,0,0,0,False,False,False,0,1,2020-01-12T16:19:05.503,0,,
2019,19,2787,370,3,6936,2,17,5,12,16,4,16,0,16,0,False,False,False,0,3,2020-01-12T16:20:14.717,16,,
2019,19,2787,375,3,2688,2,6,10,4,7,3,5,2,5,0,False,False,False,0,3,2020-01-12T16:21:39.46,7,,
2019,19,2787,395,3,6918,2,6,9,5,4,-1,4,0,4,0,False,False,False,0,3,2020-01-12T16:24:39.21,4,,
2019,19,2787,405,3,6936,2,19,2,32,38,6,37,1,37,0,False,False,False,0,3,2020-01-12T16:26:11.077,38,,
2019,19,2787,435,3,2976,13,4,9,12,0,0,0,0,0,0,False,False,False,0,4,2020-01-12T16:32:07.317,0,,
2019,19,2787,450,3,2976,13,17,8,23,0,0,0,0,0,0,False,False,False,0,4,2020-01-12T16:35:42.84,0,,
2019,19,2787,460,3,6936,2,2,10,5,9,4,9,0,9,0,False,False,False,0,3,2020-01-12T16:40:05.177,9,,
2019,19,2787,465,3,6935,13,35,6,20,0,0,0,0,0,0,False,False,False,0,3,2020-01-12T16:41:15.937,0,,
2019,19,2787,480,3,6936,13,8,1,27,0,0,0,0,0,0,False,False,False,0,3,2020-01-15T17:07:44.553,0,,
2019,19,2787,485,3,5214,2,42,9,7,8,1,7,1,7,0,False,False,False,0,3,2020-01-12T16:47:09.317,8,,
2019,19,2787,520,31,3139,13,2,10,3,0,0,0,0,0,0,False,False,False,0,3,2020-03-11T22:38:48.197,0,,
2019,19,2787,525,31,5080,2,2,4,3,3,0,3,0,3,6,False,False,False,0,3,2020-01-12T17:03:20.673,3,,
2019,19,2787,550,31,5096,13,9,6,16,0,0,0,0,0,0,True,False,False,0,4,2020-01-12T17:07:08.05,0,,
2019,19,2787,555,31,6793,2,13,10,2,9,7,3,6,3,0,False,False,False,1,2,2020-01-12T17:08:19.43,9,,
2019,19,2787,585,3,6935,2,4,3,4,4,0,4,0,4,0,False,False,False,0,2,2020-01-12T17:13:45.617,4,,
2019,19,2787,590,3,6918,2,16,4,4,4,0,4,0,4,0,False,False,False,0,1,2020-01-12T17:15:04.07,4,,
2019,19,2787,595,3,902,3,1,10,0,0,0,0,0,0,0,False,False,False,0,1,2020-01-12T17:18:02.07,0,,
2019,19,2787,605,3,6935,2,6,4,11,13,2,13,0,13,0,False,False,False,0,3,2020-01-12T17:39:25.193,13,,
2019,19,2787,610,3,6454,2,4,10,8,11,3,9,2,9,0,False,False,False,0,3,2020-01-12T17:40:26.887,11,,
2019,19,2787,615,3,2688,3,13,9,3,0,0,0,0,0,0,False,False,False,0,3,2020-01-12T17:41:49.12,0,,
2019,19,2787,620,3,2688,2,6,9,5,5,0,5,0,5,0,False,False,False,0,2,2020-01-15T16:55:07.587,5,,
2019,19,2787,630,3,6935,13,5,9,7,0,0,0,0,0,0,False,False,False,0,2,2020-01-12T17:44:16.07,0,,
2019,19,2787,655,31,6793,13,2,10,7,0,0,0,0,0,0,False,False,False,0,2,2020-01-13T22:58:25.18,0,,
2019,19,2787,670,3,6918,2,15,10,-7,3,10,1,2,1,0,False,False,False,0,1,2020-01-12T17:51:34.48,3,,
2019,19,2787,680,3,5214,13,17,8,35,0,0,0,0,0,0,False,False,False,0,3,2020-01-15T16:55:07.587,0,,
2019,19,2787,690,3,6454,2,26,10,0,0,0,0,0,0,0,False,False,False,0,3,2020-01-12T17:55:54.02,0,,
2019,19,2787,695,3,6935,2,3,3,10,9,-1,9,0,9,0,False,False,False,0,2,2020-01-12T17:57:16.66,9,,
2019,19,2787,705,3,902,2,28,4,4,9,5,8,1,8,0,False,False,False,0,1,2020-01-12T17:58:57.173,9,,
2019,19,2787,710,3,2688,2,4,9,5,7,2,5,2,5,0,False,False,False,0,3,2020-01-12T18:00:07.483,7,,
2019,19,2787,715,3,5214,2,17,1,15,15,0,15,0,15,6,False,False,False,0,3,2020-01-12T18:01:11.503,15,,
2019,19,2787,790,3,6454,3,17,4,10,0,0,0,0,0,0,False,False,False,0,3,2020-01-12T18:12:34.21,0,,
2019,19,2787,795,3,2688,2,17,7,20,26,6,24,2,24,0,False,False,False,0,3,2020-01-12T18:13:52.077,26,,
2019,19,2787,800,3,6936,2,4,10,7,7,0,7,0,7,0,False,False,False,0,3,2020-01-12T18:15:00.257,7,,
2019,19,2787,805,3,6936,2,4,5,5,9,4,7,2,7,0,False,False,False,1,2,2020-01-12T18:16:38.06,9,,
2019,19,2787,820,3,5214,3,17,4,13,0,0,0,0,0,0,False,False,False,0,3,2020-01-12T18:36:55.98,0,,
2019,19,2787,835,3,6454,13,6,4,7,0,0,0,0,0,0,False,False,False,0,3,2020-01-12T18:39:31.913,0,,
2019,19,2787,865,3,5214,2,32,5,5,18,13,14,4,14,0,False,False,False,0,4,2020-01-15T16:55:07.587,18,,
2019,19,2787,880,3,6918,2,28,4,3,14,11,12,2,12,0,False,False,False,0,1,2020-01-12T18:45:37.93,14,,
2019,19,2787,885,3,5214,2,4,10,5,12,7,9,3,9,0,False,False,False,0,3,2020-01-12T18:46:49.837,12,,
2019,19,2787,895,3,6935,13,35,2,27,0,0,0,0,0,0,False,False,False,0,2,2020-01-12T18:48:25.153,0,,
2019,19,2787,900,3,6936,2,6,8,17,17,0,17,0,17,0,False,False,False,0,2,2020-01-15T01:33:41.35,17,,
2019,19,2787,915,3,3586,13,17,8,20,0,0,0,0,0,0,False,False,False,0,3,2020-01-12T18:51:50.833,0,,
2019,19,2787,920,3,6935,3,35,10,11,0,0,0,0,0,0,False,False,False,0,2,2020-01-12T18:52:50.6,0,,
2019,19,2788,10,13,245,2,10,9,-3,1,4,1,0,1,0,False,False,False,0,3,2020-01-13T12:23:18.88,1,,
2019,19,2788,20,13,3951,2,2,9,5,9,4,7,2,7,0,False,False,False,0,3,2020-01-13T12:25:33.35,9,,
2019,19,2788,25,13,153,2,4,10,2,2,0,1,1,1,0,False,False,False,0,1,2020-01-13T12:29:17.937,2,,
2019,19,2788,35,13,2136,2,19,6,25,54,29,54,0,54,6,False,False,False,0,3,2020-03-09T20:55:00.553,54,,
2019,19,2788,60,16,7176,2,2,10,6,6,0,6,0,6,0,False,False,False,0,2,2020-01-13T12:51:24.883,6,,
2019,19,2788,70,16,374,3,6,4,8,0,0,0,0,0,0,False,False,False,0,3,2020-01-13T12:55:16.77,0,,
2019,19,2788,90,16,3938,2,4,10,14,17,3,15,2,15,0,False,False,False,0,2,2020-01-15T16:56:40.157,17,,
2019,19,2788,100,16,374,2,1,3,0,15,15,7,8,7,0,True,False,False,0,4,2020-02-20T19:23:38.813,15,,
2019,19,2788,105,16,1400,13,12,2,15,0,0,0,0,0,0,False,False,False,0,1,2020-01-15T14:22:43.513,0,,
2019,19,2788,110,16,374,2,30,10,-1,5,6,3,2,3,0,False,False,False,0,4,2020-01-13T13:10:29.173,5,,
2019,19,2788,115,16,4143,3,13,10,2,0,0,0,0,0,0,False,False,False,0,2,2020-01-15T19:25:14.01,0,,
2019,19,2788,145,13,3951,2,4,9,4,6,2,5,1,5,0,False,False,False,0,3,2020-01-13T13:20:45.973,6,,
2019,19,2788,150,13,404,2,32,5,-2,-1,1,-2,1,-2,0,False,False,False,0,1,2020-01-13T13:22:40.22,-1,,
2019,19,2788,155,13,2136,13,19,2,25,0,0,0,0,0,0,False,False,False,0,2,2020-01-13T13:24:11.467,0,,
2019,19,2788,175,13,1430,2,4,4,4,4,0,4,0,4,6,False,False,False,0,4,2020-01-13T13:36:36.213,4,,
2019,19,2788,190,16,1400,3,15,5,-6,0,0,0,0,0,0,False,False,False,0,1,2020-01-13T13:40:45.577,0,,
2019,19,2788,195,16,4143,3,2,4,5,0,0,0,0,0,0,False,False,False,0,3,2020-01-13T13:41:55.357,0,,
2019,19,2788,200,16,3938,13,35,2,18,0,0,0,0,0,0,False,False,False,0,3,2020-01-15T19:19:20.18,0,,
2019,19,2788,230,13,245,2,5,3,13,13,0,13,0,13,0,False,False,False,0,2,2020-01-13T14:02:52.427,13,,
2019,19,2788,240,13,2136,2,12,10,9,15,6,15,0,15,0,False,False,False,0,3,2020-01-15T19:19:35.08,15,,
2019,19,2788,250,13,1430,3,32,10,3,0,0,0,0,0,0,True,False,False,0,3,2020-02-20T19:24:21.837,0,,
2019,19,2788,260,13,404,2,28,3,-1,8,9,6,2,6,0,False,False,False,0,1,2020-01-13T14:19:15.223,8,,
2019,19,2788,280,16,374,2,5,5,10,25,15,13,12,13,0,False,False,False,0,3,2020-01-13T14:24:27.377,25,,
2019,19,2788,285,16,1400,2,11,9,5,17,12,17,0,17,6,True,False,False,0,1,2020-01-13T14:24:19.227,17,,
2019,19,2788,310,13,3951,13,4,3,4,0,0,0,0,0,0,False,False,False,0,2,2020-01-13T14:31:06.223,0,,
2019,19,2788,320,16,7176,13,19,2,28,0,0,0,0,0,0,False,False,False,0,2,2020-01-13T14:35:20.647,0,,
2019,19,2788,325,16,374,13,19,6,28,0,0,0,0,0,0,False,False,False,0,3,2020-01-13T14:38:27.95,0,,
2019,19,2788,330,16,374,3,30,5,2,0,0,0,0,0,0,False,False,False,0,4,2020-01-15T19:25:59.01,0,,
2019,19,2788,335,16,374,2,13,10,4,5,1,4,1,4,6,False,False,False,0,3,2020-01-13T14:50:31.14,5,,
2019,19,2788,350,16,374,2,30,10,0,2,2,2,0,2,0,False,False,False,0,4,2020-01-13T14:51:47.903,2,,
2019,19,2788,360,16,374,2,1,5,3,6,3,4,2,4,6,True,False,False,0,3,2020-01-15T16:58:25.65,6,,
2019,19,2788,375,13,245,2,4,9,4,9,5,4,5,4,0,False,False,False,1,3,2020-01-13T15:01:44.7,9,,
2019,19,2788,385,13,153,2,4,9,2,10,8,8,2,8,0,False,False,False,0,1,2020-01-14T22:00:53.893,10,,
2019,19,2788,400,13,245,2,10,9,-4,-5,-1,-5,0,-5,0,True,True,False,0,3,2020-02-20T19:27:24.923,-2,,
2019,19,2788,405,13,245,13,6,4,13,0,0,0,0,0,0,False,False,False,0,3,2020-01-13T15:15:31.957,0,,
2019,19,2788,415,16,374,13,24,2,20,0,0,0,0,0,0,False,False,False,0,3,2020-01-13T15:20:04.047,0,,
2019,19,2788,420,16,3938,2,5,3,10,20,10,9,11,9,0,False,False,False,1,2,2020-01-13T15:23:37.113,20,,
2019,19,2788,440,16,374,2,35,8,16,20,4,16,4,16,0,True,False,False,0,3,2020-01-15T17:01:51.47,20,,
2019,19,2788,450,16,1400,13,26,9,2,0,0,0,0,0,0,False,False,False,0,3,2020-01-13T15:34:54.847,0,,
2019,19,2788,455,16,4143,3,13,10,-1,0,0,0,0,0,0,False,False,False,0,3,2020-01-13T16:21:38.18,0,,
2019,19,2788,460,16,374,2,12,3,5,5,0,5,0,5,6,True,False,False,0,4,2020-01-13T15:39:50.723,5,,
2019,19,2788,475,13,245,2,19,7,36,38,2,36,2,36,0,False,False,False,0,2,2020-01-13T18:42:03.037,38,,
2019,19,2788,510,16,6565,2,30,9,0,11,11,5,6,5,0,False,False,False,1,4,2020-01-15T16:54:01.067,11,,
2019,19,2788,520,16,121,2,7,2,20,48,28,24,24,24,0,False,False,False,2,3,2020-02-27T15:05:47.343,48,,
2019,19,2788,530,16,3938,2,10,5,-6,4,10,4,0,4,0,True,False,False,0,1,2020-01-13T16:12:01.647,4,,
2019,19,2788,560,13,245,2,2,3,6,9,3,7,2,7,0,False,False,False,0,2,2020-01-13T16:25:36.813,9,,
2019,19,2788,580,16,374,2,12,2,18,28,10,18,10,18,0,False,False,False,2,4,2020-01-15T15:34:02.423,28,,
2019,19,2788,595,16,4143,2,2,9,1,4,3,3,1,3,0,False,False,False,0,2,2020-01-13T16:39:04.35,4,,
2019,19,2788,600,16,3938,13,22,8,26,0,0,0,0,0,0,False,False,False,0,3,2020-01-13T16:41:48.053,0,,
2019,19,2788,605,16,7176,13,12,5,7,0,0,0,0,0,0,False,False,False,0,2,2020-01-15T19:26:12.447,0,,
2019,19,2788,640,13,245,2,35,8,18,21,3,21,0,21,0,False,False,False,0,3,2020-01-13T16:55:03.007,21,,
2019,19,2788,645,13,153,13,12,3,6,0,0,0,0,0,0,False,False,False,0,1,2020-01-13T16:56:21.263,0,,
2019,19,2788,650,13,2136,2,6,4,6,11,5,6,5,6,0,False,False,False,1,3,2020-01-14T22:01:25.71,11,,
2019,19,2788,665,13,245,2,12,5,9,9,0,9,0,9,0,False,False,False,0,3,2020-01-15T19:21:15.203,9,,
2019,19,2788,675,13,3951,2,19,6,27,39,12,35,4,35,0,False,False,False,0,2,2020-01-13T17:04:54.247,39,,
2019,19,2788,695,16,374,2,6,9,10,23,13,11,12,11,0,False,False,False,1,3,2020-01-15T19:21:28.593,23,,
2019,19,2788,705,16,7176,2,34,4,-4,13,17,12,1,12,0,True,False,False,0,3,2020-01-13T17:11:19.903,13,,
2019,19,2788,710,16,121,2,17,2,26,28,2,26,2,26,0,False,False,False,0,3,2020-02-27T15:06:25.137,28,,
2019,19,2788,715,16,2568,2,11,3,3,8,5,8,0,8,6,False,False,False,0,4,2020-01-13T17:16:30.847,8,,
2019,19,2788,730,13,6531,2,32,3,-3,7,10,-1,8,-1,0,False,False,False,0,4,2020-01-13T17:19:14.037,7,,
2019,19,2788,735,13,245,2,8,8,18,20,2,18,2,18,0,False,False,False,0,3,2020-01-15T19:21:38.357,20,,
2019,19,2788,740,13,153,2,28,4,0,6,6,3,3,3,0,False,False,False,0,1,2020-01-13T17:22:42.6,6,,
2019,19,2788,745,13,245,13,7,7,42,0,0,0,0,0,0,False,False,False,0,2,2020-01-14T21:27:45.69,0,,
2019,19,2788,750,13,2136,13,4,10,5,0,0,0,0,0,0,False,False,False,0,3,2020-01-13T17:26:10.287,0,,
2019,19,2788,760,13,245,13,12,4,13,0,0,0,0,0,0,False,False,False,0,3,2020-01-15T19:22:48.547,0,,
2019,19,2788,765,16,2568,2,1,10,-1,7,8,2,5,2,0,True,False,False,0,4,2020-02-20T19:28:09.483,7,,
2019,19,2788,785,16,1400,13,11,5,-1,0,0,0,0,0,0,False,False,False,0,1,2020-01-15T19:23:03.497,0,,
2019,19,2788,790,16,1400,2,10,9,-6,4,10,-1,5,-1,0,False,False,False,1,1,2020-01-13T17:38:47.377,4,,
2019,19,2788,805,13,1430,13,4,10,7,0,0,0,0,0,0,False,False,False,0,3,2020-01-13T17:41:22.957,0,,
2019,19,2788,815,13,2136,3,2,4,3,0,0,0,0,0,0,False,False,False,0,3,2020-01-13T17:43:52.117,0,,
2019,19,2788,820,13,404,2,1,5,-1,6,7,4,2,4,0,False,False,False,0,1,2020-01-15T19:23:23.713,6,,
2019,19,2788,825,13,1430,3,17,1,20,0,0,0,0,0,0,False,False,False,0,3,2020-01-13T17:47:34.703,0,,
2019,19,2788,830,13,3951,13,19,7,22,0,0,0,0,0,0,False,False,False,0,3,2020-01-13T17:51:13.317,0,,
2019,19,2788,835,13,1430,3,12,5,7,0,0,0,0,0,0,False,False,False,0,3,2020-01-13T17:53:07.697,0,,
2019,19,2788,845,13,1430,2,38,9,3,9,6,6,3,6,0,False,False,False,0,3,2020-01-13T17:56:48.317,9,,
2019,19,2788,850,13,245,13,12,4,8,0,0,0,0,0,0,False,False,False,0,2,2020-03-09T20:58:50.893,0,,
2019,19,2788,885,13,404,2,28,9,-2,9,11,5,4,5,0,False,False,False,0,1,2020-01-13T18:08:34.873,9,,
2019,19,2788,890,13,3951,13,4,2,22,0,0,0,0,0,0,False,False,False,0,2,2020-02-25T15:46:08.607,0,,
2019,19,2788,895,13,3951,2,4,5,4,5,1,4,1,4,0,False,False,False,0,3,2020-01-13T18:11:10.38,5,,
2019,19,2788,900,13,404,13,28,9,1,0,0,0,0,0,0,False,False,False,0,1,2020-01-13T18:14:07.027,0,,
2019,19,2788,905,13,3951,2,19,2,28,30,2,29,1,29,0,False,False,False,0,2,2020-01-13T18:16:04.117,30,,
2019,19,2788,910,13,404,2,28,9,-3,1,4,0,1,0,0,False,False,False,0,1,2020-02-17T17:11:22.61,1,,
2019,19,2788,915,13,3562,2,12,2,17,17,0,17,0,17,0,False,False,False,0,3,2020-01-15T19:24:10.277,17,,
2019,19,2788,920,13,1430,2,4,10,4,9,5,6,3,6,0,False,False,False,0,3,2020-01-13T18:21:29.887,9,,
2019,19,2788,925,13,2497,2,28,4,2,14,12,11,3,11,0,False,False,False,0,1,2020-01-13T18:22:43.653,14,,
2019,19,2788,935,13,404,3,12,3,8,0,0,0,0,0,0,False,False,False,0,1,2020-03-02T23:12:46.853,0,,
2019,19,2788,940,13,245,13,9,3,8,0,0,0,0,0,0,False,False,False,0,2,2020-01-13T18:27:36.32,0,,
2019,19,2788,945,13,3951,13,2,10,5,0,0,0,0,0,0,False,False,False,0,2,2020-01-13T18:28:58.92,0,,
2019,19,2789,15,12,556,2,13,5,4,14,10,14,0,14,0,False,False,False,0,3,2020-01-13T13:39:56.307,14,,
2019,19,2789,35,12,666,2,13,10,7,13,6,12,1,12,0,True,False,False,0,3,2020-01-13T13:44:21.72,13,,
2019,19,2789,50,12,556,2,20,6,20,20,0,20,0,20,6,False,False,False,0,2,2020-01-13T13:49:14.74,20,,
2019,19,2789,65,27,4835,2,13,10,7,11,4,10,1,10,0,False,False,False,0,4,2020-01-15T19:43:13.6,11,,
2019,19,2789,80,27,7408,13,12,6,35,0,0,0,0,0,0,False,False,False,0,2,2020-01-13T14:06:52.323,0,,
2019,19,2789,90,12,4537,13,15,3,-6,0,0,0,0,0,0,False,False,False,0,1,2020-02-17T17:06:38.63,0,,
2019,19,2789,140,12,3528,2,5,9,6,6,0,6,0,6,0,False,False,False,0,3,2020-01-13T19:33:40.657,6,,
2019,19,2789,145,12,4561,2,32,10,0,9,9,8,1,8,0,False,False,False,0,4,2020-01-15T16:17:21.35,9,,
2019,19,2789,155,27,6712,13,35,6,18,0,0,0,0,0,0,False,False,False,0,3,2020-01-15T14:25:02.883,0,,
2019,19,2789,160,27,650,2,9,6,22,28,6,28,0,28,0,False,False,False,0,2,2020-01-13T14:52:10.187,28,,
2019,19,2789,175,27,4835,3,13,3,3,0,0,0,0,0,0,False,False,False,0,3,2020-01-15T16:18:20.51,0,,
2019,19,2789,190,12,556,2,12,9,9,11,2,11,0,11,0,False,False,False,0,3,2020-01-15T16:19:29.177,11,,
2019,19,2789,200,12,556,2,30,10,-1,18,19,18,0,18,0,False,False,False,0,3,2020-01-13T15:20:02.277,18,,
2019,19,2789,205,12,556,2,4,4,12,15,3,12,3,12,0,False,False,False,1,3,2020-01-15T16:20:21.87,15,,
2019,19,2789,210,12,6357,2,1,5,4,8,4,6,2,6,0,False,False,False,0,3,2020-01-15T14:27:30.597,8,,
2019,19,2789,215,12,4537,2,10,9,-1,13,14,2,11,2,0,False,False,False,3,1,2020-01-15T16:04:03.763,13,,
2019,19,2789,220,12,556,13,9,2,23,0,0,0,0,0,0,False,False,False,0,2,2020-01-13T15:31:22.21,0,,
2019,19,2789,230,12,556,13,6,9,11,0,0,0,0,0,0,False,False,False,0,2,2020-01-15T16:21:51.5,0,,
2019,19,2789,240,12,556,3,34,4,-4,0,0,0,0,0,0,True,False,False,0,1,2020-03-09T20:50:08.367,0,,
2019,19,2789,275,27,650,2,12,7,26,31,5,31,0,31,0,False,False,False,0,3,2020-01-15T16:22:31.517,31,,
2019,19,2789,285,27,7408,2,35,5,11,13,2,13,0,13,0,False,False,False,0,3,2020-01-15T16:23:35.04,13,,
2019,19,2789,300,27,7404,13,12,3,5,0,0,0,0,0,0,False,False,False,0,1,2020-01-13T16:05:21.587,0,,
2019,19,2789,320,12,556,2,2,10,7,10,3,10,0,10,0,False,False,False,0,3,2020-01-13T16:10:55.543,10,,
2019,19,2789,325,12,2630,3,5,3,6,0,0,0,0,0,0,False,False,False,0,3,2020-01-13T16:13:18.893,0,,
2019,19,2789,330,12,6876,2,1,3,-2,2,4,2,0,2,0,False,False,False,0,4,2020-01-13T16:14:47.293,2,,
2019,19,2789,400,27,650,2,4,9,14,14,0,14,0,14,0,False,False,False,0,3,2020-01-13T16:28:52.78,14,,
2019,19,2789,405,27,7408,2,4,3,8,8,0,8,0,8,0,False,False,False,0,2,2020-01-15T16:24:50.813,8,,
2019,19,2789,435,27,650,13,19,8,57,0,0,0,0,0,0,False,False,False,0,2,2020-01-15T19:43:29.247,0,,
2019,19,2789,450,27,6712,13,4,5,11,0,0,0,0,0,0,False,False,False,0,2,2020-01-13T17:09:41.98,0,,
2019,19,2789,470,27,7408,2,4,5,13,24,11,22,2,22,0,False,False,False,0,2,2020-01-13T17:15:42.68,24,,
2019,19,2789,475,27,650,2,30,9,-2,6,8,6,0,6,0,True,False,False,0,4,2020-03-09T20:50:57.653,6,,
2019,19,2789,485,27,4835,2,13,10,1,3,2,3,0,3,0,False,False,False,0,3,2020-01-13T17:20:10.083,3,,
2019,19,2789,490,27,650,2,30,10,0,4,4,4,0,4,0,False,False,False,0,3,2020-01-13T17:22:13.66,4,,
2019,19,2789,515,12,4537,2,4,4,2,4,2,3,1,3,0,False,False,False,0,1,2020-01-13T17:35:18.23,4,,
2019,19,2789,520,12,666,2,35,8,21,27,6,24,3,24,0,True,False,False,0,3,2020-02-20T19:42:27.63,27,,
2019,19,2789,530,12,556,2,22,6,20,40,20,40,0,40,6,True,False,False,1,3,2020-02-20T19:42:55.153,40,,
2019,19,2789,545,27,650,13,5,5,14,0,0,0,0,0,0,False,False,False,0,3,2020-01-13T17:44:16.3,0,,
2019,19,2789,565,27,650,2,13,5,9,13,4,9,4,9,0,False,False,False,0,3,2020-01-13T17:47:39.58,13,,
2019,19,2789,570,27,7404,2,1,5,2,11,9,8,3,8,0,False,False,False,0,1,2020-01-13T17:49:03.61,11,,
2019,19,2789,575,27,4835,2,4,10,5,9,4,8,1,8,0,False,False,False,0,4,2020-01-13T17:52:59.84,9,,
2019,19,2789,590,27,670,2,12,4,-3,8,11,5,3,5,0,False,False,False,0,4,2020-01-13T17:56:24.107,8,,
2019,19,2789,605,27,650,2,12,5,7,7,0,7,0,7,6,True,False,False,0,3,2020-01-13T18:00:23.63,7,,
2019,19,2789,635,12,556,13,2,10,8,0,0,0,0,0,0,False,False,False,0,2,2020-01-13T18:15:44.237,0,,
2019,19,2789,645,27,650,2,35,6,19,19,0,19,0,19,0,False,False,False,0,3,2020-01-15T16:35:39.063,19,,
2019,19,2789,655,27,7408,2,2,10,6,14,8,10,4,10,0,False,False,False,0,2,2020-01-15T16:04:59.29,14,,
2019,19,2789,665,27,4835,2,6,2,16,19,3,18,1,18,0,False,False,False,0,4,2020-01-13T18:32:46.327,19,,
2019,19,2789,675,27,7404,2,1,5,-1,16,17,16,0,16,0,False,False,False,0,1,2020-01-13T18:36:49.963,16,,
2019,19,2789,700,12,666,13,32,9,0,0,0,0,0,0,0,False,False,False,0,4,2020-01-13T18:44:23.947,0,,
2019,19,2789,705,12,556,13,4,5,5,0,0,0,0,0,0,False,False,False,0,2,2020-01-13T18:45:51.153,0,,
2019,19,2789,710,12,3528,2,8,4,11,11,0,11,0,11,0,True,False,False,0,3,2020-02-20T19:43:28.017,11,,
2019,19,2789,750,27,650,2,12,5,14,14,0,14,0,14,0,False,False,False,0,4,2020-01-15T16:39:02.99,14,,
2019,19,2789,755,27,6712,3,4,10,14,0,0,0,0,0,0,False,False,False,0,2,2020-01-13T19:32:17.817,0,,
2019,19,2789,760,27,4835,2,31,5,5,5,0,5,0,5,0,True,False,False,0,4,2020-03-09T20:53:03.817,5,,
2019,19,2789,795,12,556,2,9,2,21,32,11,23,9,23,0,False,False,False,0,3,2020-01-15T16:06:19.81,32,,
2019,19,2789,820,12,666,2,13,9,4,9,5,8,1,8,0,True,False,False,0,3,2020-01-15T16:39:51.98,9,,
2019,20,2790,15,31,6793,2,6,10,14,37,23,20,17,20,0,False,False,False,1,2,2020-01-22T14:44:52.543,37,,
2019,20,2790,25,31,5080,2,12,5,4,12,8,10,2,10,0,False,False,False,0,2,2020-01-20T13:24:52.64,12,,
2019,20,2790,35,31,5080,13,12,3,12,0,0,0,0,0,0,False,False,False,0,3,2020-01-20T13:29:48.043,0,,
2019,20,2790,65,16,374,13,4,10,14,0,0,0,0,0,0,False,False,False,0,2,2020-01-20T13:39:01.39,0,,
2019,20,2790,85,31,5080,13,35,6,21,0,0,0,0,0,0,False,False,False,0,3,2020-01-20T13:47:04.717,0,,
2019,20,2790,110,31,5096,13,2,9,2,0,0,0,0,0,0,False,False,False,0,2,2020-01-20T13:55:28.23,0,,
2019,20,2790,115,31,2675,2,1,9,1,3,2,3,0,3,0,True,False,False,0,1,2020-02-20T19:49:40.843,3,,
2019,20,2790,120,31,5096,2,11,5,12,22,10,18,4,18,0,True,False,False,0,4,2020-01-20T14:00:19.36,22,,
2019,20,2790,140,16,1400,2,4,10,4,9,5,9,0,9,0,True,False,False,0,1,2020-02-20T19:52:02.16,9,,
2019,20,2790,150,16,3938,2,12,2,26,26,0,26,0,26,0,False,False,False,0,3,2020-01-20T14:12:11.543,26,,
2019,20,2790,160,16,121,3,5,3,4,0,0,0,0,0,0,False,False,False,0,3,2020-01-22T14:47:56.73,0,,
2019,20,2790,165,16,374,2,31,10,9,8,-1,8,0,8,0,False,False,False,0,3,2020-01-20T14:19:32.657,8,,
2019,20,2790,175,16,374,2,4,10,4,4,0,4,0,4,0,False,False,False,0,3,2020-01-22T14:48:36.923,4,,
2019,20,2790,180,16,7176,2,34,4,-4,8,12,6,2,6,0,True,False,False,0,1,2020-01-22T14:45:04.467,8,,
2019,20,2790,190,16,374,13,12,5,13,0,0,0,0,0,0,False,False,False,0,3,2020-02-17T17:04:50.09,0,,
2019,20,2790,195,16,3938,2,10,4,-4,8,12,8,0,8,6,False,False,False,0,4,2020-01-20T14:44:34.07,8,,
2019,20,2790,210,31,2901,2,10,9,-2,9,11,9,0,9,0,False,False,False,1,4,2020-01-20T14:48:14.1,9,,
2019,20,2790,225,31,5080,2,6,8,15,18,3,16,2,16,0,True,False,False,0,3,2020-01-20T14:51:22.163,18,,
2019,20,2790,235,31,6724,13,43,6,35,0,0,0,0,0,0,True,False,False,0,4,2020-01-20T14:53:48.443,0,,
2019,20,2790,250,31,2675,2,4,10,3,5,2,5,0,5,0,False,False,False,0,2,2020-01-20T15:00:23.06,5,,
2019,20,2790,260,31,6793,2,12,5,9,9,0,9,0,9,0,False,False,False,0,3,2020-01-20T15:05:23.053,9,,
2019,20,2790,270,31,5080,2,30,3,-2,-2,0,-2,0,-2,0,True,False,False,0,4,2020-01-20T15:10:14.45,-2,,
2019,20,2790,275,31,6793,13,17,1,20,0,0,0,0,0,0,False,False,False,0,3,2020-01-20T15:14:49.533,0,,
2019,20,2790,280,31,5080,2,4,10,10,10,0,10,0,10,0,False,False,False,0,2,2020-01-22T14:55:24.227,10,,
2019,20,2790,305,31,912,2,31,9,1,1,0,1,0,1,6,False,False,False,0,4,2020-01-21T21:50:41.827,1,,
2019,20,2790,325,16,374,13,35,9,10,0,0,0,0,0,0,False,False,False,0,2,2020-01-20T15:28:29.28,0,,
2019,20,2790,330,16,4143,2,4,3,9,24,15,19,5,19,0,False,False,False,0,2,2020-01-20T15:29:58.883,24,,
2019,20,2790,335,16,121,2,12,5,13,13,0,13,0,13,0,False,False,False,0,2,2020-01-20T15:31:52.787,13,,
2019,20,2790,345,16,3938,2,17,7,20,20,0,20,0,20,6,False,False,False,0,3,2020-02-27T15:08:41.733,20,,
2019,20,2790,370,31,2288,2,10,10,-4,6,10,6,0,6,0,False,False,False,0,1,2020-01-20T15:51:17.327,6,,
2019,20,2790,385,16,1400,2,15,5,2,17,15,6,11,6,0,False,False,False,1,1,2020-01-20T15:53:57.333,17,,
2019,20,2790,390,16,1400,2,4,3,4,8,4,8,0,8,0,True,False,False,0,2,2020-01-20T15:57:36.057,8,,
2019,20,2790,395,16,3938,2,18,10,-4,-2,2,-2,0,-2,0,False,False,False,1,3,2020-01-20T16:00:17.473,-2,,
2019,20,2790,400,16,374,2,4,9,11,18,7,18,0,18,0,True,False,False,0,3,2020-01-20T16:02:22.577,18,,
2019,20,2790,410,16,121,13,12,7,22,0,0,0,0,0,0,False,False,False,0,3,2020-03-09T20:47:31.763,0,,
2019,20,2790,415,16,121,2,4,10,8,11,3,11,0,11,0,False,False,False,0,3,2020-01-22T14:42:46.34,11,,
2019,20,2790,455,16,1400,2,5,5,4,7,3,7,0,7,0,False,False,False,0,1,2020-01-20T16:25:42.88,7,,
2019,20,2790,465,16,3938,13,12,7,18,0,0,0,0,0,0,False,False,False,0,3,2020-01-22T15:01:09.167,0,,
2019,20,2790,470,16,4143,2,4,3,4,7,3,7,0,7,0,False,False,False,0,2,2020-01-20T16:30:39.27,7,,
2019,20,2790,475,16,121,2,12,5,5,5,0,5,0,5,0,False,False,False,0,4,2020-01-22T15:21:33.99,5,,
2019,20,2790,490,16,7210,13,5,9,0,0,0,0,0,0,0,False,False,False,0,1,2020-01-22T14:42:46.34,0,,
2019,20,2790,500,16,3938,3,7,7,20,0,0,0,0,0,0,False,False,False,0,3,2020-01-20T16:51:31.053,0,,
2019,20,2790,515,31,6793,13,2,9,7,0,0,0,0,0,0,False,False,False,0,2,2020-01-21T21:46:54.553,0,,
2019,20,2790,520,31,2675,2,5,3,8,8,0,8,0,8,0,True,False,False,0,3,2020-02-20T19:52:29.437,8,,
2019,20,2790,575,16,121,2,4,3,7,7,0,7,0,7,0,False,False,False,0,2,2020-01-20T17:24:49.843,7,,
2019,20,2790,605,16,3938,2,13,5,9,15,6,15,0,15,0,False,False,False,0,3,2020-01-20T17:34:39.963,15,,
2019,20,2790,615,16,2035,3,5,5,3,0,0,0,0,0,0,False,False,False,0,4,2020-03-11T21:43:38.823,0,,
2019,20,2790,635,31,5080,2,35,5,12,15,3,15,0,15,0,False,False,False,0,3,2020-01-20T17:41:49.347,15,,
2019,20,2790,640,31,3504,2,12,5,-2,-2,0,-2,0,-2,0,False,False,False,0,1,2020-01-20T17:45:13.64,-2,,
2019,20,2790,645,31,6793,2,39,10,3,5,2,5,0,5,0,False,False,False,0,3,2020-01-22T14:44:16.167,5,,
2019,20,2790,670,16,121,2,2,10,6,11,5,9,2,9,0,False,False,False,1,3,2020-01-20T17:51:53.687,11,,
2019,20,2790,680,16,121,2,4,3,7,7,0,7,0,7,0,False,False,False,0,2,2020-01-20T17:53:44.427,7,,
2019,20,2790,690,16,1400,2,4,10,2,3,1,3,0,3,0,True,False,False,0,1,2020-01-22T15:12:20.313,3,,
2019,20,2790,695,16,121,2,12,8,42,60,18,60,0,60,6,False,False,False,0,3,2020-01-22T14:44:24.423,60,,
2019,20,2790,710,31,3504,2,10,9,-6,-6,0,-6,0,-6,0,False,False,False,0,1,2020-01-20T18:06:11.507,-6,,
2019,20,2790,715,31,5080,13,5,2,16,0,0,0,0,0,0,False,False,False,0,3,2020-01-20T18:08:07.823,0,,
2019,20,2790,720,31,5096,2,2,9,4,8,4,8,0,8,0,True,False,False,0,3,2020-02-20T19:53:09.333,8,,
2019,20,2790,725,31,6802,2,17,4,8,28,20,26,2,26,0,False,False,False,0,4,2020-01-20T18:13:02.537,28,,
2019,20,2790,730,31,5096,2,1,5,4,8,4,8,0,8,0,False,False,False,0,4,2020-01-20T18:15:02.473,8,,
2019,20,2790,735,31,5080,2,4,5,11,22,11,11,11,11,0,False,False,False,1,2,2020-01-22T14:45:39.827,22,,
2019,20,2790,745,31,6724,2,17,8,22,22,0,22,0,22,6,False,False,False,0,3,2020-01-20T18:20:53.753,22,,
2019,20,2790,775,16,7176,13,35,2,41,0,0,0,0,0,0,False,False,False,0,3,2020-01-22T15:13:50.68,0,,
2019,20,2790,825,31,2675,2,12,10,9,9,0,9,0,9,0,False,False,False,0,3,2020-01-20T18:42:58.493,9,,
2019,20,2790,830,31,2675,13,17,9,13,0,0,0,0,0,0,False,False,False,0,3,2020-01-22T14:44:33.96,0,,
2019,20,2790,835,31,6793,13,4,9,9,0,0,0,0,0,0,False,False,False,0,3,2020-01-20T18:46:26.563,0,,
2019,20,2791,35,12,556,2,10,9,-1,7,8,7,0,7,0,False,False,False,0,2,2020-01-20T13:33:09.81,7,,
2019,20,2791,40,12,467,2,30,10,-1,3,4,3,0,3,0,False,False,False,0,4,2020-01-20T13:35:12.917,3,,
2019,20,2791,50,12,4561,2,1,9,0,2,2,1,1,1,0,False,False,False,0,3,2020-01-20T13:41:17.473,2,,
2019,20,2791,60,28,7224,2,30,9,-3,16,19,4,12,4,0,True,False,False,1,3,2020-02-20T19:54:45.137,16,,
2019,20,2791,70,28,7224,2,6,8,16,30,14,18,12,18,0,False,False,False,1,3,2020-01-20T13:52:04.517,30,,
2019,20,2791,80,28,3264,2,10,9,-4,-4,0,0,-4,0,0,False,False,False,0,1,2020-01-20T13:58:58.353,-4,,
2019,20,2791,100,12,3528,2,5,3,1,1,0,1,0,1,0,False,False,False,0,3,2020-01-20T14:04:45.113,1,,
2019,20,2791,105,12,6691,2,35,3,13,13,0,13,0,13,0,False,False,False,0,3,2020-01-22T16:19:56.47,13,,
2019,20,2791,135,28,213,13,5,8,17,0,0,0,0,0,0,False,False,False,0,3,2020-01-20T16:24:27.493,0,,
2019,20,2791,145,28,213,13,35,10,8,0,0,0,0,0,0,False,False,False,0,3,2020-01-20T14:26:31.92,0,,
2019,20,2791,175,12,4537,2,10,9,-6,-2,4,-2,0,-2,0,False,False,False,0,1,2020-01-20T14:32:46.6,-2,,
2019,20,2791,230,12,2630,2,6,1,16,23,7,20,3,20,0,False,False,False,0,3,2020-01-22T16:16:44.6,23,,
2019,20,2791,260,28,7224,13,2,9,6,0,0,0,0,0,0,False,False,False,0,3,2020-01-20T15:12:03.957,0,,
2019,20,2791,295,28,7224,13,2,4,3,0,0,0,0,0,0,False,False,False,0,3,2020-03-02T23:24:44.38,0,,
2019,20,2791,300,28,4912,2,5,3,6,6,0,6,0,6,0,False,False,False,0,3,2020-01-20T15:26:12.103,6,,
2019,20,2791,320,12,6691,2,2,9,10,19,9,17,2,17,0,False,False,False,0,2,2020-01-22T16:16:54.22,19,,
2019,20,2791,330,12,4561,13,4,4,1,0,0,0,0,0,0,False,False,False,0,1,2020-01-20T15:31:57.19,0,,
2019,20,2791,335,12,3528,13,17,7,17,0,0,0,0,0,0,False,False,False,0,3,2020-01-20T15:34:02.783,0,,
2019,20,2791,380,12,4561,2,15,5,-5,-1,4,-2,1,-2,0,False,False,False,0,1,2020-01-20T15:45:45.323,-1,,
2019,20,2791,415,12,556,2,22,6,16,16,0,16,0,16,0,False,False,False,0,2,2020-01-20T15:57:43.53,16,,
2019,20,2791,420,12,556,13,19,6,16,0,0,0,0,0,0,False,False,False,0,2,2020-01-22T16:13:36.66,0,,
2019,20,2791,425,12,556,2,10,10,-2,14,16,9,5,9,0,False,False,False,0,3,2020-01-20T16:02:01.74,14,,
2019,20,2791,430,12,4537,2,31,4,2,8,6,7,1,7,0,False,False,False,0,1,2020-01-22T16:17:13.723,8,,
2019,20,2791,440,12,666,2,30,9,-3,2,5,0,2,0,0,False,False,False,0,4,2020-01-20T16:08:31.887,2,,
2019,20,2791,445,12,556,2,10,9,0,4,4,3,1,3,0,False,False,False,1,3,2020-01-20T16:10:32.69,4,,
2019,20,2791,450,12,4537,2,5,3,1,6,5,6,0,6,0,True,False,False,0,3,2020-01-20T16:12:25.247,6,,
2019,20,2791,460,12,3528,2,5,5,6,7,1,7,0,7,0,False,False,False,0,3,2020-01-20T16:17:53.993,7,,
2019,20,2791,465,12,467,2,10,9,-2,11,13,9,2,9,0,False,False,False,0,4,2020-01-20T16:20:44.003,11,,
2019,20,2791,470,12,4537,2,10,10,-4,9,13,9,0,9,6,False,False,False,0,1,2020-01-20T16:23:06.243,9,,
2019,20,2791,530,12,3965,2,15,3,-5,7,12,7,0,7,0,False,False,False,0,3,2020-01-20T16:43:16.557,7,,
2019,20,2791,535,12,6876,2,1,3,3,5,2,5,0,5,0,False,False,False,0,4,2020-01-22T16:17:22.283,5,,
2019,20,2791,540,12,666,13,17,1,28,0,0,0,0,0,0,False,False,False,0,3,2020-01-20T16:47:40.773,0,,
2019,20,2791,550,12,4537,2,28,4,0,6,6,5,1,5,0,False,False,False,0,1,2020-01-20T16:54:01.143,6,,
2019,20,2791,560,12,556,2,10,10,-1,2,3,2,0,2,0,False,False,False,2,3,2020-01-20T17:00:03.71,2,,
2019,20,2791,565,12,556,2,4,3,4,6,2,4,2,4,0,False,False,False,1,2,2020-01-20T17:05:09.9,6,,
2019,20,2791,570,12,666,2,32,10,2,10,8,8,2,8,0,False,False,False,0,4,2020-02-20T19:55:36.15,10,,
2019,20,2791,575,12,6691,2,6,4,4,4,0,4,0,4,0,False,False,False,0,3,2020-01-20T17:14:27.043,4,,
2019,20,2791,585,12,666,2,17,8,27,42,15,39,3,39,0,False,False,False,0,4,2020-01-20T17:18:17.65,42,,
2019,20,2791,635,12,666,2,10,10,0,5,5,5,0,5,0,False,False,False,0,4,2020-01-20T17:35:04.563,5,,
2019,20,2791,645,12,556,2,19,8,43,65,22,58,7,58,0,False,False,False,1,2,2020-01-22T16:18:55.543,65,,
2019,20,2791,655,12,556,2,5,3,7,8,1,8,0,8,0,False,False,False,0,2,2020-01-20T17:46:41.72,8,,
2019,20,2791,660,12,4537,2,10,9,-6,6,12,6,0,6,0,False,False,False,0,1,2020-01-20T17:49:44.16,6,,
2019,20,2791,665,12,6876,2,12,10,8,8,0,8,0,8,6,False,False,False,0,4,2020-01-20T17:51:16.68,8,,
2019,20,2791,680,28,4922,2,13,9,4,19,15,17,2,17,0,False,False,False,0,2,2020-01-20T17:57:34.203,19,,
2019,20,2791,695,28,4922,13,5,3,5,0,0,0,0,0,0,False,False,False,0,3,2020-01-20T18:02:03.017,0,,
2019,20,2791,710,28,3264,2,10,5,-4,10,14,8,2,8,0,True,False,False,0,3,2020-01-22T16:34:49.753,10,,
2019,20,2791,770,12,6691,13,19,2,52,0,0,0,0,0,0,False,False,False,0,2,2020-01-22T16:13:36.66,0,,
2019,20,2791,780,12,556,2,6,7,16,16,0,16,0,16,0,False,False,False,0,2,2020-01-20T18:34:08.697,16,,
2019,20,2791,790,12,556,13,8,1,57,0,0,0,0,0,0,False,False,False,0,2,2020-01-20T18:36:47.013,0,,
2019,21,2792,15,16,1400,13,15,3,-6,0,0,0,0,0,0,False,False,False,0,1,2020-02-03T12:26:15.877,0,,
2019,21,2792,20,16,1400,13,15,5,-3,0,0,0,0,0,0,False,False,False,0,1,2020-02-03T12:28:44.597,0,,
2019,21,2792,35,28,4922,2,26,9,0,11,11,9,2,9,0,False,False,False,0,3,2020-02-03T12:34:05.907,11,,
2019,21,2792,60,28,3264,2,10,9,-1,2,3,1,1,1,0,False,False,False,0,1,2020-02-03T18:36:31.753,2,,
2019,21,2792,65,28,7224,2,10,10,-3,-2,1,-2,0,-2,0,False,False,False,0,2,2020-03-09T20:41:11.693,-2,,
2019,21,2792,70,28,6624,3,16,10,4,0,0,0,0,0,0,False,False,False,0,1,2020-02-03T13:24:42.64,0,,
2019,21,2792,75,28,4922,13,26,9,7,0,0,0,0,0,0,False,False,False,0,3,2020-02-03T13:29:25.707,0,,
2019,21,2792,90,16,3938,2,4,5,8,9,1,9,0,9,0,False,False,False,0,3,2020-02-03T13:36:29.967,9,,
2019,21,2792,100,16,3938,2,2,10,4,8,4,4,4,4,0,False,False,False,1,2,2020-02-03T13:42:03.64,8,,
2019,21,2792,105,16,1400,13,1,5,2,0,0,0,0,0,0,False,False,False,0,1,2020-02-03T13:45:07.07,0,,
2019,21,2792,115,16,374,2,17,4,6,9,3,9,0,9,0,True,False,False,0,3,2020-02-03T13:47:45.78,9,,
2019,21,2792,125,16,3938,2,34,4,-3,3,6,2,1,2,0,True,False,False,0,1,2020-02-03T13:51:22.72,3,,
2019,21,2792,130,16,374,2,6,4,8,11,3,8,3,8,0,False,False,False,1,3,2020-02-03T13:53:26.743,11,,
2019,21,2792,140,16,3938,13,30,5,-5,0,0,0,0,0,0,False,False,False,0,3,2020-02-03T18:36:43.767,0,,
2019,21,2792,175,28,213,2,4,8,18,18,0,18,0,18,0,False,False,False,0,2,2020-02-03T22:16:08.75,18,,
2019,21,2792,185,28,7224,2,10,5,-6,-2,4,-6,4,-6,0,True,False,False,1,1,2020-02-03T14:16:09.237,-2,,
2019,21,2792,190,28,7224,13,7,2,16,0,0,0,0,0,0,False,False,False,0,3,2020-02-03T14:19:21.537,0,,
2019,21,2792,195,16,121,2,43,6,26,28,2,28,0,28,0,True,False,False,0,4,2020-02-03T14:22:15.557,28,,
2019,21,2792,210,16,7176,2,10,3,-3,2,5,0,2,0,0,False,False,False,0,2,2020-02-03T14:24:46.11,2,,
2019,21,2792,220,16,121,2,13,4,3,4,1,3,1,3,0,True,False,False,0,2,2020-02-03T18:32:24.667,4,,
2019,21,2792,230,16,1400,13,11,2,16,0,0,0,0,0,0,False,False,False,0,1,2020-02-03T14:33:16.473,0,,
2019,21,2792,240,16,7210,13,16,4,3,0,0,0,0,0,0,False,False,False,0,1,2020-02-03T14:36:52.557,0,,
2019,21,2792,265,28,7224,2,34,4,-4,16,20,13,3,13,0,True,False,False,0,3,2020-02-03T14:42:46.807,16,,
2019,21,2792,280,28,7224,2,2,4,6,11,5,8,3,8,0,False,False,False,0,3,2020-02-03T14:48:25.243,11,,
2019,21,2792,285,28,262,2,32,10,4,15,11,4,11,4,6,True,False,False,1,4,2020-02-03T14:49:52.93,15,,
2019,21,2792,300,16,1400,2,32,5,0,10,10,10,0,10,0,False,False,False,1,1,2020-02-03T14:57:25.397,10,,
2019,21,2792,305,16,2568,2,9,3,7,9,2,9,0,9,0,False,False,False,0,4,2020-02-03T15:00:02.953,9,,
2019,21,2792,315,16,3938,2,4,9,9,10,1,8,2,8,0,False,False,False,1,2,2020-02-03T15:05:23.747,10,,
2019,21,2792,335,16,1400,2,10,10,-3,1,4,1,0,1,0,False,False,False,0,1,2020-02-03T15:11:43.273,1,,
2019,21,2792,360,28,6624,2,16,9,3,20,17,19,1,19,0,False,False,False,0,1,2020-02-03T15:20:52.787,20,,
2019,21,2792,370,28,4922,2,7,2,34,42,8,42,0,42,0,False,False,False,0,3,2020-02-03T15:22:49.17,42,,
2019,21,2792,390,28,213,2,4,10,5,5,0,5,0,5,0,False,False,False,0,3,2020-02-03T15:29:12.023,5,,
2019,21,2792,395,28,213,2,2,4,13,15,2,14,1,14,0,True,False,False,0,3,2020-02-03T15:31:26.37,15,,
2019,21,2792,410,28,262,2,9,3,11,14,3,14,0,14,0,False,False,False,0,1,2020-02-03T15:35:07.233,14,,
2019,21,2792,415,28,4922,2,10,5,-4,5,9,4,1,4,0,False,False,False,0,3,2020-02-03T15:36:44.14,5,,
2019,21,2792,425,28,743,2,2,10,1,3,2,1,2,1,0,True,False,False,0,2,2020-02-04T20:27:28.743,3,,
2019,21,2792,440,16,121,2,12,5,14,19,5,17,2,17,0,False,False,False,0,2,2020-02-03T22:16:48.11,19,,
2019,21,2792,445,16,374,2,26,10,1,4,3,3,1,3,0,False,False,False,0,3,2020-02-03T16:18:05.363,4,,
2019,21,2792,455,16,121,2,5,3,9,9,0,9,0,9,0,False,False,False,0,3,2020-02-03T16:21:02.653,9,,
2019,21,2792,470,16,3938,13,4,8,19,0,0,0,0,0,0,False,False,False,0,3,2020-02-03T16:30:11.02,0,,
2019,21,2792,475,28,7224,2,6,8,15,16,1,15,1,15,0,False,False,False,1,3,2020-02-03T16:31:47.5,16,,
2019,21,2792,485,28,213,13,6,7,17,0,0,0,0,0,0,False,False,False,0,2,2020-02-03T16:40:19.55,0,,
2019,21,2792,490,28,4912,2,6,9,14,26,12,17,9,17,0,True,False,False,0,2,2020-02-20T20:02:01.337,26,,
2019,21,2792,495,28,262,2,32,4,2,10,8,7,3,7,0,False,False,False,0,4,2020-02-03T16:44:47.513,10,,
2019,21,2792,530,16,121,13,6,4,12,0,0,0,0,0,0,False,False,False,0,3,2020-02-03T16:51:12.27,0,,
2019,21,2792,535,16,374,2,5,9,5,9,4,5,4,5,0,True,False,False,1,3,2020-02-03T16:52:57.407,9,,
2019,21,2792,550,16,3938,13,12,6,21,0,0,0,0,0,0,False,False,False,0,4,2021-02-01T14:28:08.763,0,,
2019,21,2792,555,16,3938,2,4,3,7,14,7,11,3,11,0,False,False,False,0,2,2020-02-03T16:58:04.127,14,,
2019,21,2792,560,16,1400,2,32,3,0,13,13,3,10,3,0,False,False,False,1,1,2020-02-03T16:59:41.467,13,,
2019,21,2792,575,16,3938,13,2,4,10,0,0,0,0,0,0,False,False,False,0,3,2020-02-03T22:23:57.41,0,,
2019,21,2792,585,28,4922,2,2,4,11,12,1,12,0,12,0,True,False,False,0,3,2020-02-03T17:06:58.56,12,,
2019,21,2792,595,28,7224,13,6,4,9,0,0,0,0,0,0,False,False,False,0,3,2020-03-09T20:44:50.207,0,,
2019,21,2792,625,16,3938,2,4,9,9,9,0,9,0,9,0,False,False,False,0,2,2020-02-03T17:23:14.793,9,,
2019,21,2792,640,16,3938,13,4,9,5,0,0,0,0,0,0,False,False,False,0,2,2020-02-03T17:25:44.577,0,,
2019,21,2792,645,16,3938,13,4,8,17,0,0,0,0,0,0,False,False,False,0,3,2020-02-03T22:08:29.2,0,,
2019,21,2792,650,16,3938,2,22,6,42,44,2,43,1,43,0,False,False,False,0,3,2020-02-05T15:22:14.45,44,,
2019,21,2792,655,16,3938,13,9,6,15,0,0,0,0,0,0,False,False,False,0,2,2020-02-03T17:31:55.283,0,,
2019,21,2792,665,16,374,13,17,6,21,0,0,0,0,0,0,False,False,False,0,3,2020-02-03T17:34:25.133,0,,
2019,21,2792,670,16,374,2,7,10,1,1,0,1,0,1,6,False,False,False,0,4,2020-02-04T21:34:45.907,1,,
2019,21,2792,690,28,4922,13,2,10,7,0,0,0,0,0,0,False,False,False,0,3,2020-02-26T18:26:43.62,0,,
2019,21,2792,695,28,4912,13,4,10,8,0,0,0,0,0,0,False,False,False,0,3,2020-02-03T17:40:23.487,0,,
2019,21,2792,705,16,3938,2,10,9,-3,5,8,4,1,4,0,False,False,False,0,3,2020-02-03T17:41:56.143,5,,
2019,21,2792,710,16,374,2,6,9,7,9,2,7,2,7,0,False,False,False,0,3,2020-02-03T17:43:50.763,9,,
2019,21,2792,715,16,3938,2,4,5,2,3,1,3,0,3,0,False,False,False,0,2,2020-02-03T17:44:48.737,3,,
2019,21,2792,720,16,121,2,19,2,22,38,16,38,0,38,0,False,False,False,0,2,2020-02-03T17:46:13.28,38,,
2019,21,2792,735,16,1400,2,30,5,1,5,4,4,1,4,6,False,False,False,0,1,2020-02-03T17:50:18.34,5,,
2019,21,2792,760,28,4922,2,5,5,2,8,6,4,4,4,0,True,False,False,0,3,2020-02-03T17:55:41.257,8,,
2019,21,2792,770,28,4912,2,12,9,8,16,8,13,3,13,0,False,False,False,0,3,2020-02-03T17:57:15.37,16,,
2019,21,2792,775,28,7224,13,26,10,4,0,0,0,0,0,0,False,False,False,0,3,2020-02-03T17:58:28.243,0,,
2019,21,2792,780,28,4912,13,2,4,9,0,0,0,0,0,0,False,False,False,0,3,2020-02-03T18:00:20.697,0,,
2019,21,2792,785,28,213,13,8,7,39,0,0,0,0,0,0,False,False,False,0,3,2020-02-03T18:10:17.887,0,,
2019,21,2792,820,28,4922,13,31,9,1,0,0,0,0,0,0,False,False,False,0,4,2020-02-03T18:18:22.443,0,,
2019,21,2792,825,28,7224,13,17,1,34,0,0,0,0,0,0,False,False,False,0,3,2020-02-03T18:21:18.16,0,,
2020,1,2793,15,13,3951,3,29,6,18,0,0,0,0,0,0,False,False,False,0,3,2020-09-11T11:14:07.607,0,,0.0
2020,1,2793,25,13,2455,13,28,10,-2,0,0,0,0,0,0,False,False,False,0,1,2020-09-11T11:17:08.753,0,,0.0
2020,1,2793,45,16,6499,2,44,3,-1,6,7,2,4,2,0,False,False,False,0,1,2020-09-11T11:23:08.21,6,,4.0
2020,1,2793,50,16,7176,2,34,4,-4,6,10,5,1,5,0,True,False,False,1,2,2020-09-11T11:25:09.45,6,,1.0
2020,1,2793,55,16,374,2,4,10,5,11,6,7,4,7,0,True,False,False,1,3,2020-09-11T11:26:15.353,11,,4.0
2020,1,2793,60,16,4143,13,20,7,36,0,0,0,0,0,0,False,False,False,0,2,2020-09-11T11:29:54.417,0,,0.0
2020,1,2793,70,16,4143,13,32,5,-1,0,0,0,0,0,0,False,False,False,0,4,2020-09-11T11:34:42.513,0,,0.0
2020,1,2793,85,13,1430,2,4,4,6,12,6,9,3,9,0,False,False,False,0,4,2020-09-11T11:39:59.593,12,,3.0
2020,1,2793,95,13,2455,2,48,9,-3,5,8,5,0,5,0,False,False,False,1,1,2020-09-11T11:45:22.027,5,,0.0
2020,1,2793,100,13,3951,2,5,9,4,6,2,6,0,6,0,False,False,False,0,3,2021-02-25T19:09:05.04,6,,0.0
2020,1,2793,110,13,876,2,6,10,11,11,0,11,0,11,0,False,False,False,0,3,2020-09-11T11:53:02.7,11,,0.0
2020,1,2793,115,13,876,2,51,9,-8,9,17,0,9,0,0,True,False,False,1,3,2020-09-17T17:20:27.607,9,,9.0
2020,1,2793,135,16,3938,2,4,3,3,7,4,5,2,5,0,False,False,False,0,2,2020-09-11T12:11:34.53,7,,2.0
2020,1,2793,155,16,374,2,53,9,-1,15,16,15,0,15,0,False,False,False,1,4,2020-09-11T12:18:15.03,15,,0.0
2020,1,2793,160,16,121,2,46,3,1,10,9,6,4,6,0,False,False,False,0,3,2020-09-11T12:22:34.607,10,,4.0
2020,1,2793,170,16,121,2,2,10,7,13,6,10,3,10,0,False,False,False,0,3,2020-09-11T12:26:58.8,13,,3.0
2020,1,2793,175,16,374,2,30,9,0,2,2,1,1,1,0,False,False,False,0,4,2020-09-11T12:53:48.317,2,,1.0
2020,1,2793,180,16,4143,3,35,9,6,0,0,0,0,0,0,False,False,False,0,3,2020-09-11T12:33:17.98,0,,0.0
2020,1,2793,185,16,374,2,2,9,6,6,0,6,0,6,6,True,False,False,0,3,2020-09-11T12:35:17.827,6,,0.0
2020,1,2793,200,13,3951,2,2,10,9,19,10,16,3,16,0,False,False,False,0,3,2020-09-11T12:37:21.147,19,,3.0
2020,1,2793,225,16,374,2,32,5,0,5,5,3,2,3,0,True,False,False,0,4,2020-09-11T12:47:05.893,5,,2.0
2020,1,2793,235,16,3938,13,5,8,18,0,0,0,0,0,0,False,False,False,0,3,2020-09-11T12:51:24.21,0,,0.0
2020,1,2793,255,16,4143,2,46,3,0,4,4,1,3,1,0,False,False,False,0,3,2020-09-11T13:54:53.16,4,,3.0
2020,1,2793,290,16,4143,2,13,10,2,9,7,3,6,3,0,False,False,False,1,2,2020-09-11T14:15:45.553,9,,6.0
2020,1,2793,295,16,121,2,26,3,3,9,6,8,1,8,0,False,False,False,0,2,2020-09-11T14:19:08.65,9,,1.0
2020,1,2793,305,16,121,2,50,10,0,2,2,1,1,1,6,True,False,False,0,2,2020-09-11T14:26:51.21,2,,1.0
2020,1,2793,320,13,1430,2,30,9,0,7,7,6,1,6,0,False,False,False,0,4,2020-09-11T14:33:52.427,7,,1.0
2020,1,2793,340,13,876,13,9,2,18,0,0,0,0,0,0,False,False,False,0,2,2020-09-11T14:39:24.06,0,,0.0
2020,1,2793,345,13,2455,2,12,10,2,15,13,7,8,7,0,False,False,False,1,1,2021-03-08T16:19:01.947,15,,8.0
2020,1,2793,350,13,876,13,13,4,3,0,0,0,0,0,0,False,False,False,0,3,2020-09-11T14:43:20.09,0,,0.0
2020,1,2793,355,13,6528,2,5,10,5,20,15,7,13,7,0,False,False,False,3,4,2020-09-17T15:48:39.327,20,,13.0
2020,1,2793,365,13,404,13,12,10,2,0,0,0,0,0,0,False,False,False,0,1,2021-03-08T16:18:50.143,0,,0.0
2020,1,2793,370,13,3951,13,19,2,26,0,0,0,0,0,0,False,False,False,0,3,2020-09-17T15:44:30.77,0,,0.0
2020,1,2793,380,16,121,13,4,3,7,0,0,0,0,0,0,False,False,False,0,2,2020-09-11T14:52:52.81,0,,0.0
2020,1,2793,385,16,121,2,7,6,16,17,1,17,0,17,0,False,False,False,0,3,2020-09-11T14:58:20.563,17,,0.0
2020,1,2793,395,16,374,2,2,4,4,11,7,5,6,5,0,False,False,False,1,3,2020-09-17T15:49:36.16,11,,6.0
2020,1,2793,400,16,374,13,9,6,16,0,0,0,0,0,0,False,False,False,0,3,2020-09-11T18:19:14.11,0,,
2020,1,2793,415,16,3938,2,5,5,5,7,2,6,1,6,0,False,False,False,0,3,2020-09-11T15:08:20.437,7,,1.0
2020,1,2793,425,16,121,2,2,10,6,12,6,9,3,9,0,False,False,False,0,3,2020-09-11T15:12:29.877,12,,3.0
2020,1,2793,440,16,3938,2,51,9,0,14,14,8,6,8,0,False,False,False,0,3,2020-09-11T15:16:51.983,14,,6.0
2020,1,2793,445,16,4143,2,44,3,-2,7,9,2,5,2,0,True,False,False,1,2,2021-02-08T23:12:40.937,7,,5.0
2020,1,2793,465,13,3951,2,6,9,8,8,0,8,0,8,0,False,False,False,0,3,2020-09-11T15:28:14.853,8,,0.0
2020,1,2793,480,13,3951,2,2,10,7,7,0,7,0,7,0,False,False,False,0,2,2020-09-11T15:37:50.657,7,,0.0
2020,1,2793,515,16,121,2,5,5,14,19,5,19,0,19,0,False,False,False,0,2,2020-09-11T16:12:15.113,19,,0.0
2020,1,2793,525,16,7681,13,28,10,-6,0,0,0,0,0,0,False,False,False,0,1,2020-09-11T16:15:18.713,0,,0.0
2020,1,2793,530,16,3938,2,35,10,14,15,1,15,0,15,0,False,False,False,0,3,2020-09-11T16:17:37.233,15,,0.0
2020,1,2793,545,16,6499,2,44,9,-6,1,7,-1,2,-1,0,False,False,False,0,1,2020-09-11T16:22:15.723,1,,2.0
2020,1,2793,565,13,3951,2,8,9,13,20,7,17,3,17,0,False,False,False,0,2,2020-09-11T16:31:53.297,20,,3.0
2020,1,2793,570,13,876,13,8,8,20,0,0,0,0,0,0,False,False,False,0,3,2020-09-17T12:44:48.737,0,,0.0
2020,1,2793,580,16,121,13,5,5,5,0,0,0,0,0,0,False,False,False,0,3,2020-09-11T16:38:28.977,0,,0.0
2020,1,2793,595,16,6500,13,35,5,8,0,0,0,0,0,0,False,False,False,0,4,2020-09-11T16:44:08.603,0,,
2020,1,2793,610,16,3938,2,13,5,3,3,0,3,0,3,6,False,False,False,0,3,2020-09-11T16:48:44.74,3,,0.0
2020,1,2793,625,13,3951,2,2,9,8,10,2,9,1,9,0,False,False,False,0,3,2020-09-11T16:51:28.36,10,,1.0
2020,1,2793,630,13,2455,2,28,10,-3,12,15,6,6,6,0,False,False,False,1,1,2020-09-11T16:56:14.617,12,,6.0
2020,1,2793,645,13,2136,3,6,4,9,0,0,0,0,0,0,False,False,False,0,3,2021-02-08T23:15:15.843,0,,0.0
2020,1,2793,660,13,2136,3,9,2,19,0,0,0,0,0,0,False,False,False,0,2,2020-09-11T17:06:32.8,0,,0.0
2020,1,2793,665,13,3951,2,5,3,9,11,2,10,1,10,0,False,False,False,0,3,2020-09-11T17:08:19,11,,1.0
2020,1,2793,675,13,6528,2,17,1,19,19,0,19,0,19,6,False,False,False,0,4,2020-09-11T17:10:49.36,19,,0.0
2020,1,2793,700,16,7681,13,46,3,2,0,0,0,0,0,0,False,False,False,0,1,2020-09-11T17:21:26.847,0,,0.0
2020,1,2793,715,13,3951,2,19,6,26,31,5,27,4,27,0,False,False,False,0,3,2020-09-11T17:26:13.327,31,,4.0
2020,1,2793,725,13,496,2,50,9,-2,17,19,15,2,15,0,False,False,False,0,2,2020-09-11T17:28:16.487,17,,2.0
2020,1,2793,730,13,496,13,8,10,9,0,0,0,0,0,0,False,False,False,0,3,2020-09-11T17:29:22.297,0,,0.0
2020,1,2793,735,13,3562,2,2,4,4,8,4,6,2,6,0,False,False,False,0,3,2020-09-11T17:30:41.467,8,,2.0
2020,1,2793,805,13,496,2,5,3,4,6,2,6,0,6,0,False,False,False,0,3,2020-09-11T17:44:03.983,6,,0.0
2020,1,2793,810,13,3562,3,8,9,12,0,0,0,0,0,0,False,False,False,0,3,2020-09-11T17:45:22.2,0,,0.0
2020,1,2794,25,2,661,13,6,3,12,0,0,0,0,0,0,False,False,False,0,3,2020-09-14T10:26:36.673,0,,0.0
2020,1,2794,30,2,5223,2,7,6,19,19,0,19,0,19,0,False,False,False,0,3,2020-09-14T10:30:14.683,19,,0.0
2020,1,2794,45,2,661,2,4,9,11,12,1,12,0,12,0,False,False,False,0,3,2020-09-17T14:57:15.6,12,,0.0
2020,1,2794,65,27,650,2,6,10,13,15,2,13,2,13,0,False,False,False,0,3,2020-09-14T10:50:49.893,15,,2.0
2020,1,2794,70,27,505,2,5,5,7,9,2,7,2,7,0,True,False,False,0,3,2021-02-17T22:17:24.017,9,,2.0
2020,1,2794,80,27,5050,2,44,3,-1,9,10,8,1,8,0,False,False,False,0,1,2020-09-17T18:52:05.88,9,,1.0
2020,1,2794,85,27,5050,2,48,3,-7,6,13,3,3,3,0,False,False,False,0,1,2020-09-14T11:00:32.317,6,,3.0
2020,1,2794,95,27,650,2,12,3,4,5,1,5,0,5,0,True,False,False,0,3,2021-03-08T16:23:10.21,5,,0.0
2020,1,2794,110,27,650,13,9,6,41,0,0,0,0,0,0,False,False,False,0,3,2021-02-19T14:47:46.563,0,,
2020,1,2794,115,27,5069,2,49,5,-1,7,8,5,2,5,0,False,False,False,0,2,2020-09-17T17:08:03.737,7,,2.0
2020,1,2794,120,27,5050,2,47,5,2,3,1,3,0,3,6,False,False,False,0,1,2020-09-14T11:33:38.217,3,,0.0
2020,1,2794,135,2,661,2,26,7,15,28,13,23,5,23,0,False,False,False,0,3,2020-09-14T11:42:22.153,28,,5.0
2020,1,2794,140,2,990,2,46,3,-4,0,4,-2,2,-2,0,False,False,False,0,1,2020-09-14T11:45:40.69,0,,2.0
2020,1,2794,155,2,990,13,47,5,2,0,0,0,0,0,0,False,False,False,0,3,2020-09-14T11:52:17.337,0,,0.0
2020,1,2794,160,27,7408,2,2,9,10,13,3,12,1,12,0,False,False,False,0,2,2020-09-14T11:56:26.42,13,,1.0
2020,1,2794,170,27,5050,2,48,9,-7,19,26,17,2,17,6,False,False,False,0,1,2020-09-14T12:01:10.723,19,,2.0
2020,1,2794,190,2,5214,2,35,2,27,27,0,27,0,27,0,True,False,False,0,3,2020-09-16T00:47:32.437,27,,0.0
2020,1,2794,205,2,5223,2,5,5,6,15,9,7,8,7,0,False,False,False,1,2,2020-09-17T17:45:00.293,15,,8.0
2020,1,2794,215,2,6247,2,4,10,12,16,4,12,4,12,0,False,False,False,1,3,2020-09-14T12:24:32.443,16,,4.0
2020,1,2794,260,27,7404,2,45,5,-5,3,8,1,2,1,0,False,False,False,1,1,2020-09-14T12:38:09.223,3,,2.0
2020,1,2794,285,2,6247,2,4,9,5,11,6,8,3,8,0,True,False,False,0,3,2020-09-16T00:48:35.817,11,,3.0
2020,1,2794,295,2,6247,2,50,10,-1,4,5,-1,5,-1,0,False,False,False,1,3,2020-09-14T12:52:39.513,4,,5.0
2020,1,2794,310,27,6397,2,13,10,3,5,2,3,2,3,0,False,False,False,0,4,2020-09-17T14:57:15.6,5,,2.0
2020,1,2794,325,27,650,2,2,9,2,6,4,5,1,5,0,False,False,False,0,3,2020-09-14T13:07:26.79,6,,1.0
2020,1,2794,330,27,7408,13,4,3,5,0,0,0,0,0,0,False,False,False,0,2,2021-01-29T15:04:15.74,0,,0.0
2020,1,2794,350,2,5214,13,46,3,2,0,0,0,0,0,0,False,False,False,0,3,2021-02-03T18:04:31.313,0,,0.0
2020,1,2794,355,2,661,2,13,9,5,5,0,5,0,5,0,False,False,False,0,2,2020-09-17T17:02:03.047,5,,0.0
2020,1,2794,380,27,5050,2,18,3,-2,5,7,3,2,3,0,False,False,False,0,2,2020-09-14T13:25:09.527,5,,2.0
2020,1,2794,390,27,7404,2,44,3,1,1,0,1,0,1,0,False,False,False,0,1,2020-09-14T13:27:48.767,1,,0.0
2020,1,2794,405,2,2223,13,39,4,3,0,0,0,0,0,0,False,False,False,0,4,2020-09-14T13:30:43.86,0,,0.0
2020,1,2794,415,2,661,3,6,4,13,0,0,0,0,0,0,False,False,False,0,3,2021-02-25T14:30:50.707,0,,0.0
2020,1,2794,420,2,5223,2,5,3,12,22,10,13,9,13,0,False,False,False,2,2,2020-09-17T19:20:46.853,22,,9.0
2020,1,2794,425,2,990,2,48,5,-4,3,7,-1,4,-1,0,False,False,False,0,1,2020-09-14T17:36:20.437,3,,
2020,1,2794,430,2,6240,13,3,5,11,0,0,0,0,0,0,False,False,False,0,2,2020-09-19T15:10:40.42,0,,
2020,1,2794,435,2,990,3,4,4,3,0,0,0,0,0,0,False,False,False,0,1,2020-09-14T13:49:23.347,0,,0.0
2020,1,2794,440,2,6247,2,4,9,7,13,6,13,0,13,0,False,False,False,0,3,2020-09-14T13:51:32.763,13,,0.0
2020,1,2794,445,2,6247,3,46,3,3,0,0,0,0,0,0,False,False,False,0,3,2020-09-16T00:23:20.007,0,,0.0
2020,1,2794,450,2,6247,13,6,4,8,0,0,0,0,0,0,False,False,False,0,3,2020-09-17T16:56:04.72,0,,0.0
2020,1,2794,455,2,6247,2,2,4,7,10,3,8,2,8,0,False,False,False,0,3,2020-09-14T14:00:46.173,10,,2.0
2020,1,2794,495,27,7408,3,6,7,16,0,0,0,0,0,0,False,False,False,0,2,2020-09-14T14:09:15.157,0,,0.0
2020,1,2794,500,27,6397,2,18,3,-1,3,4,0,3,0,0,False,False,False,1,2,2020-09-14T14:11:35.793,3,,3.0
2020,1,2794,505,27,7408,2,13,10,6,7,1,6,1,6,0,False,False,False,0,2,2021-01-29T15:08:40.137,7,,1.0
2020,1,2794,515,27,4835,2,13,9,3,9,6,7,2,7,0,False,False,False,0,3,2020-10-21T15:01:57.643,9,,2.0
2020,1,2794,520,27,650,2,51,5,-2,4,6,2,2,2,0,False,False,False,0,3,2020-10-21T15:00:19.863,4,,
2020,1,2794,525,27,7408,13,8,7,15,0,0,0,0,0,0,False,False,False,0,2,2020-09-14T14:27:02.207,0,,0.0
2020,1,2794,540,27,7408,2,19,6,33,38,5,38,0,38,6,False,False,False,0,2,2021-01-29T15:07:55.003,38,,0.0
2020,1,2794,565,2,5214,2,13,10,3,4,1,4,0,4,0,False,False,False,0,3,2020-09-17T18:15:55.01,4,,0.0
2020,1,2794,575,27,5050,2,48,9,-7,3,10,-4,7,-4,0,False,False,False,0,1,2020-09-17T19:20:55.79,3,,7.0
2020,1,2794,580,27,650,2,12,10,9,10,1,10,0,10,0,False,False,False,0,3,2020-09-14T14:54:54.677,10,,0.0
2020,1,2794,600,27,505,2,17,10,7,7,0,7,0,7,6,False,False,False,0,3,2020-09-14T15:03:02.917,7,,0.0
2020,1,2794,615,2,661,2,20,7,42,44,2,42,2,42,0,False,False,False,0,3,2020-09-14T15:08:00.623,44,,2.0
2020,1,2794,620,2,990,2,48,4,-2,1,3,-1,2,-1,0,False,False,False,0,1,2020-09-14T15:11:22.283,1,,2.0
2020,1,2794,625,2,661,2,2,10,11,11,0,11,0,11,0,False,False,False,0,3,2020-09-17T17:10:42.847,11,,0.0
2020,1,2794,635,2,661,2,5,5,5,7,2,5,2,5,0,False,False,False,1,3,2020-09-16T00:24:06.527,7,,2.0
2020,1,2794,650,27,650,2,35,6,16,16,0,16,0,16,0,False,False,False,0,3,2020-09-17T17:07:29.747,16,,0.0
2020,1,2794,655,27,650,2,35,6,17,20,3,18,2,18,0,False,False,False,0,3,2020-09-14T15:26:41.24,20,,2.0
2020,1,2794,665,27,5069,2,49,5,-2,3,5,3,0,3,0,False,False,False,0,2,2020-09-14T15:32:26.34,3,,0.0
2020,1,2794,670,27,650,2,13,5,4,10,6,7,3,7,0,False,False,False,0,3,2020-09-14T15:34:36,10,,3.0
2020,1,2794,695,27,650,2,13,10,7,10,3,9,1,9,0,False,False,False,0,3,2020-09-14T15:41:48.283,10,,1.0
2020,1,2794,700,27,7852,2,2,9,5,17,12,12,5,12,0,False,False,False,0,2,2020-09-15T21:21:39.74,17,,5.0
2020,1,2794,715,2,661,2,6,6,19,19,0,19,0,19,0,False,False,False,0,2,2020-09-14T15:48:28.037,19,,0.0
2020,1,2794,720,2,6247,2,5,3,6,8,2,8,0,8,0,False,False,False,0,3,2020-09-14T15:51:46.85,8,,0.0
2020,1,2794,725,2,5223,2,5,5,12,12,0,12,0,12,0,False,False,False,0,2,2020-09-17T18:28:22.373,12,,0.0
2020,1,2794,730,2,661,2,17,8,17,18,1,17,1,17,0,False,False,False,0,3,2020-09-14T15:57:04.767,18,,1.0
2020,1,2794,735,2,5223,2,7,2,18,18,0,18,0,18,6,False,False,False,0,2,2020-09-17T18:57:50.793,18,,0.0
2020,1,2794,755,27,505,2,13,9,3,4,1,3,1,3,0,False,False,False,0,4,2020-09-14T16:03:32.9,4,,1.0
2020,1,2794,760,27,7408,3,13,9,3,0,0,0,0,0,0,False,False,False,0,3,2020-09-14T16:06:18.5,0,,0.0
2020,1,2794,770,2,5223,2,3,6,15,15,0,15,0,15,0,False,False,False,0,2,2020-09-14T16:08:42.167,15,,0.0
2020,1,2794,775,2,661,2,2,10,6,13,7,10,3,10,0,False,False,False,0,2,2020-09-14T16:11:00.463,13,,3.0
2020,1,2794,780,2,5214,2,5,5,5,7,2,6,1,6,0,False,False,False,0,4,2020-09-14T16:13:14.57,7,,1.0
2020,1,2794,785,2,5214,13,17,8,18,0,0,0,0,0,0,False,False,False,0,4,2020-09-14T16:15:41.2,0,,0.0
2020,1,2794,790,2,5223,13,5,6,15,0,0,0,0,0,0,False,False,False,0,3,2021-01-29T15:12:51.09,0,,0.0
2020,1,2794,795,2,5223,13,5,6,15,0,0,0,0,0,0,False,False,False,0,2,2020-09-17T18:53:28.66,0,,0.0
2020,1,2794,810,27,7408,2,20,2,26,37,11,32,5,32,0,False,False,False,0,2,2020-09-14T16:25:25.963,37,,5.0
2020,1,2794,815,27,505,2,30,10,-1,4,5,3,1,3,0,False,False,False,0,4,2020-09-14T16:27:00.923,4,,1.0
2020,1,2794,830,27,5069,2,12,5,5,18,13,15,3,15,0,False,False,False,1,4,2021-03-08T16:23:53.563,18,,3.0
2020,1,2794,855,2,4670,2,4,9,4,4,0,4,0,4,0,False,False,False,0,1,2020-09-14T17:24:30.367,4,,0.0
2020,1,2794,860,2,661,13,19,6,39,0,0,0,0,0,0,False,False,False,0,3,2020-09-14T16:40:10.837,0,,0.0
2020,1,2794,865,2,6247,2,2,9,7,24,17,10,14,10,0,False,False,False,2,3,2020-09-17T18:38:02.457,24,,14.0
2020,1,2794,870,2,4670,2,4,4,3,4,1,4,0,4,0,False,False,False,0,1,2020-09-17T18:57:17.04,4,,0.0
2020,1,2794,875,2,5223,2,3,5,10,10,0,10,0,10,0,False,False,False,0,2,2021-03-02T17:17:41.17,10,,0.0
2020,1,2794,880,2,6247,2,4,9,9,12,3,9,3,9,0,False,False,False,0,3,2020-09-14T16:48:34.273,12,,3.0
2020,1,2794,890,2,6472,2,48,4,-2,1,3,-1,2,-1,0,False,False,False,1,1,2020-09-14T17:31:08.9,1,,2.0
2020,1,2794,900,2,6472,2,4,4,2,2,0,2,0,2,0,False,False,False,0,1,2020-09-14T16:52:22.993,2,,0.0
2020,1,2794,905,2,5223,2,6,4,12,12,0,12,0,12,0,False,False,False,0,2,2020-09-17T18:58:19.953,12,,0.0
2020,1,2794,910,2,6472,2,44,3,-2,-1,1,-2,1,-2,0,False,False,False,0,1,2020-09-14T16:57:05.52,-1,,1.0
2020,1,2794,920,2,6247,13,7,5,7,0,0,0,0,0,0,False,False,False,0,3,2020-09-14T16:59:57.617,0,,0.0
2020,1,2794,925,2,5223,2,12,10,7,7,0,7,0,7,6,False,False,False,0,2,2021-03-08T16:24:26.53,7,,0.0
2020,1,2794,940,2,6247,2,4,6,16,16,0,16,0,16,0,False,False,False,0,2,2020-09-14T17:06:18.203,16,,0.0
2020,1,2794,945,2,5214,13,19,6,38,0,0,0,0,0,0,False,False,False,0,3,2020-09-17T18:58:34.163,0,,0.0
2020,1,2795,15,8,7652,2,4,9,4,5,1,5,0,5,0,True,False,False,0,4,2021-02-08T18:14:05.43,5,,0.0
2020,1,2795,20,8,6439,2,4,3,6,6,0,6,0,6,0,True,False,False,0,2,2021-02-08T18:15:37.037,6,,0.0
2020,1,2795,30,8,5053,13,16,9,4,0,0,0,0,0,0,False,False,False,0,1,2021-02-08T18:18:28.367,0,,0.0
2020,1,2795,35,8,6633,13,2,9,10,0,0,0,0,0,0,False,False,False,0,2,2021-03-04T20:56:55.193,0,,0.0
2020,1,2795,55,3,7672,2,51,3,-2,12,14,8,4,8,0,False,False,False,0,3,2020-09-14T11:10:08.38,12,,4.0
2020,1,2795,75,3,6454,2,6,4,5,5,0,5,0,5,6,False,False,False,0,4,2020-09-16T03:09:04.477,5,,0.0
2020,1,2795,100,8,7652,13,5,5,5,0,0,0,0,0,0,False,False,False,0,3,2020-09-14T11:49:16.32,0,,0.0
2020,1,2795,135,8,232,2,12,2,17,16,-1,17,-1,17,0,False,False,False,0,2,2021-03-08T16:26:48.707,16,,-1.0
2020,1,2795,145,8,3883,2,12,5,6,6,0,6,0,6,0,False,False,False,0,2,2020-09-14T12:20:42.273,6,,0.0
2020,1,2795,165,8,4976,2,7,3,1,1,0,1,0,1,6,False,False,False,0,4,2020-09-14T18:52:47.11,1,,0.0
2020,1,2795,180,3,6936,2,7,6,42,47,5,43,4,43,0,False,False,False,0,3,2020-09-17T14:17:19.747,47,,4.0
2020,1,2795,210,8,232,2,2,4,4,8,4,8,0,8,0,False,False,False,0,3,2020-09-14T12:57:02.353,8,,0.0
2020,1,2795,225,8,232,13,8,2,17,0,0,0,0,0,0,False,False,False,0,3,2021-02-05T15:15:37.023,0,,0.0
2020,1,2795,230,8,232,2,5,3,10,13,3,11,2,11,0,False,False,False,0,3,2020-09-17T19:28:52.45,13,,2.0
2020,1,2795,245,8,3883,2,6,10,9,9,0,9,0,9,0,False,False,False,0,3,2020-09-14T13:16:18.613,9,,0.0
2020,1,2795,255,8,1067,2,50,5,-2,1,3,0,1,0,0,False,False,False,0,2,2021-02-08T18:52:55.343,1,,1.0
2020,1,2795,260,8,1067,13,8,10,14,0,0,0,0,0,0,False,False,False,0,3,2020-09-14T13:27:19.08,0,,0.0
2020,1,2795,290,3,5017,2,47,5,1,9,8,6,3,6,0,True,False,False,0,3,2020-09-14T13:40:20.167,9,,3.0
2020,1,2795,295,3,6935,2,13,5,8,25,17,20,5,20,0,False,False,False,0,2,2020-09-17T14:17:19.747,25,,5.0
2020,1,2795,300,3,6936,2,35,5,14,21,7,21,0,21,0,False,False,False,0,3,2021-02-05T15:12:58.473,21,,0.0
2020,1,2795,320,3,6936,2,3,5,6,4,-2,4,0,4,0,False,False,False,0,2,2020-09-14T14:11:01.88,4,,0.0
2020,1,2795,325,3,2688,2,39,4,4,16,12,13,3,13,0,False,False,False,0,3,2020-09-14T14:13:07.873,16,,3.0
2020,1,2795,345,8,1067,2,4,8,16,16,0,16,0,16,0,False,False,False,0,2,2020-09-17T14:43:04.817,16,,0.0
2020,1,2795,360,8,4976,2,9,6,23,28,5,23,5,23,0,False,False,False,0,3,2021-02-08T19:31:26.267,28,,5.0
2020,1,2795,370,8,5053,2,31,10,1,8,7,1,7,1,0,False,False,False,1,1,2020-09-14T14:49:29.767,8,,7.0
2020,1,2795,380,8,1067,3,26,10,3,0,0,0,0,0,0,False,False,False,0,3,2020-09-14T14:51:25.06,0,,0.0
2020,1,2795,390,3,2688,2,12,10,14,20,6,19,1,19,0,False,False,False,0,3,2020-09-14T14:54:31.2,20,,1.0
2020,1,2795,400,3,6936,2,4,9,9,13,4,12,1,12,0,False,False,False,0,2,2020-09-14T14:57:07.353,13,,1.0
2020,1,2795,410,3,6936,2,3,2,15,16,1,16,0,16,0,False,False,False,0,2,2020-09-17T14:46:39.64,16,,0.0
2020,1,2795,415,3,6454,2,12,3,11,11,0,11,0,11,0,False,False,False,0,3,2021-02-05T15:14:04.433,11,,0.0
2020,1,2795,420,3,6454,13,4,4,9,0,0,0,0,0,0,False,False,False,0,3,2020-09-14T15:05:04.927,0,,0.0
2020,1,2795,425,3,6935,3,5,3,9,0,0,0,0,0,0,False,False,False,0,2,2020-09-14T15:06:38.527,0,,0.0
2020,1,2795,430,3,6454,2,17,10,9,9,0,9,0,9,6,False,False,False,0,3,2020-09-14T15:08:09.527,9,,0.0
2020,1,2795,465,3,2976,13,5,10,4,0,0,0,0,0,0,False,False,False,0,3,2021-02-05T15:16:18.727,0,,0.0
2020,1,2795,485,8,1067,13,8,10,11,0,0,0,0,0,0,False,False,False,0,3,2020-09-14T15:25:43.55,0,,0.0
2020,1,2795,490,8,1067,13,8,7,38,0,0,0,0,0,0,False,False,False,0,2,2021-02-08T19:49:26.13,0,,
2020,1,2795,495,8,1067,13,9,6,19,0,0,0,0,0,0,False,False,False,0,3,2020-09-17T16:37:17.207,0,,
2020,1,2795,505,8,5053,13,5,5,3,0,0,0,0,0,0,False,False,False,0,1,2020-09-17T19:10:48.173,0,,0.0
2020,1,2795,510,8,1067,13,5,3,8,0,0,0,0,0,0,False,False,False,0,3,2020-09-17T15:03:05.347,0,,
2020,1,2795,515,8,1067,13,12,5,8,0,0,0,0,0,0,False,False,False,0,2,2021-02-08T19:53:08.617,0,,0.0
2020,1,2795,525,8,1067,13,6,4,13,0,0,0,0,0,0,False,False,False,0,2,2020-09-14T15:43:59.447,0,,0.0
2020,1,2795,540,3,2976,2,38,10,3,4,1,4,0,4,0,False,False,False,0,3,2020-09-17T16:39:45.01,4,,0.0
2020,1,2795,545,3,6454,2,20,7,17,21,4,21,0,21,0,False,False,False,0,3,2020-09-15T20:54:10.097,21,,0.0
2020,1,2795,560,3,2688,2,35,7,18,19,1,19,0,19,6,False,False,False,0,3,2020-09-14T15:58:16.37,19,,0.0
2020,1,2795,585,8,232,2,7,2,20,20,0,20,0,20,0,False,False,False,0,3,2020-09-14T16:04:59.467,20,,0.0
2020,1,2795,590,8,232,13,3,5,11,0,0,0,0,0,0,False,False,False,0,2,2021-02-08T20:05:38.68,0,,
2020,1,2795,600,8,1067,2,13,10,1,5,4,0,5,0,0,False,False,False,1,3,2020-09-17T19:13:26.447,5,,5.0
2020,1,2795,605,8,4976,2,35,8,19,21,2,21,0,21,0,False,False,False,0,3,2021-02-08T20:10:11.367,21,,0.0
2020,1,2795,610,8,5053,2,4,10,1,3,2,2,1,2,0,False,False,False,1,1,2020-09-14T16:17:12.46,3,,1.0
2020,1,2795,615,8,5053,2,48,9,-2,-2,0,-2,0,-2,0,False,False,False,0,1,2020-09-14T16:18:57.02,-2,,0.0
2020,1,2795,620,8,6633,13,7,5,13,0,0,0,0,0,0,False,False,False,0,2,2020-09-17T17:27:34.607,0,,0.0
2020,1,2795,625,8,1067,13,19,6,19,0,0,0,0,0,0,False,False,False,0,2,2020-09-14T18:45:23,0,,
2020,1,2795,635,3,6454,2,6,10,12,12,0,12,0,12,0,False,False,False,0,2,2020-09-17T14:17:19.747,12,,0.0
2020,1,2795,645,3,2976,2,47,5,-2,-1,1,-1,0,-1,0,False,False,False,0,4,2020-09-17T19:17:25.737,-1,,0.0
2020,1,2795,650,3,6936,13,12,7,27,0,0,0,0,0,0,False,False,False,0,3,2020-09-17T15:24:14.06,0,,0.0
2020,1,2795,660,8,232,2,26,10,4,4,0,4,0,4,0,False,False,False,0,3,2020-09-14T16:36:20.3,4,,0.0
2020,1,2795,680,3,6935,2,45,5,-3,2,5,-1,3,-1,0,True,False,False,0,3,2020-09-17T14:17:19.747,2,,3.0
2020,1,2795,720,8,5053,2,28,10,-1,0,1,0,0,0,0,False,False,False,0,1,2020-09-14T17:01:36.12,0,,0.0
2020,1,2795,725,8,3606,2,4,5,7,9,2,9,0,9,0,False,False,False,1,2,2021-02-08T20:43:55.803,9,,0.0
2020,1,2795,730,8,6994,13,5,5,5,0,0,0,0,0,0,False,False,False,0,4,2021-01-12T23:13:09.103,0,,0.0
2020,1,2795,740,8,1067,13,19,2,38,0,0,0,0,0,0,False,False,False,0,2,2020-09-14T17:10:45.75,0,,0.0
2020,1,2795,750,3,6936,2,2,4,9,7,-2,9,-2,9,0,False,False,False,1,3,2020-09-17T17:32:17.46,7,,
2020,1,2795,760,3,6935,2,2,9,7,10,3,10,0,10,0,False,False,False,0,2,2020-09-14T17:26:37.763,10,,0.0
2020,1,2795,785,8,6633,2,5,3,11,12,1,12,0,12,0,False,False,False,0,3,2021-02-08T20:54:06.39,12,,0.0
2020,1,2795,840,3,2688,2,2,9,6,9,3,7,2,7,0,False,False,False,0,2,2020-09-14T17:55:18.563,9,,2.0
2020,1,2796,10,22,6262,13,7,8,19,0,0,0,0,0,0,False,False,False,0,4,2020-09-14T18:19:02.49,0,,0.0
2020,1,2796,20,22,3170,13,5,5,11,0,0,0,0,0,0,False,False,False,0,3,2020-09-18T20:19:32.21,0,,0.0
2020,1,2796,30,4,7646,2,5,9,1,3,2,1,2,1,0,False,False,False,1,3,2020-09-14T10:19:56.85,3,,2.0
2020,1,2796,35,4,2853,2,4,9,5,5,0,5,0,5,0,False,False,False,0,3,2020-09-14T10:21:53.727,5,,0.0
2020,1,2796,40,4,2853,2,4,3,4,4,0,4,0,4,0,False,False,False,0,2,2020-09-14T18:07:38.107,4,,0.0
2020,1,2796,70,22,1361,2,18,5,-1,0,1,-1,1,-1,0,False,False,False,1,2,2021-03-02T17:24:49.613,0,,1.0
2020,1,2796,80,4,6983,2,44,3,2,9,7,8,1,8,0,False,False,False,0,1,2020-09-14T10:47:39.247,9,,1.0
2020,1,2796,90,4,1412,2,2,10,12,17,5,13,4,13,0,False,False,False,0,3,2020-09-17T18:06:37.623,17,,4.0
2020,1,2796,95,4,6953,2,53,9,-3,11,14,10,1,10,0,False,False,False,0,4,2020-09-14T10:57:00.72,11,,1.0
2020,1,2796,100,4,1412,2,4,9,4,5,1,5,0,5,0,False,False,False,0,2,2020-09-14T11:00:22.787,5,,0.0
2020,1,2796,110,4,1412,13,5,5,5,0,0,0,0,0,0,False,False,False,0,2,2021-02-05T17:49:11.263,0,,
2020,1,2796,130,22,3170,3,26,10,2,0,0,0,0,0,0,False,False,False,0,3,2020-09-14T11:15:23.92,0,,0.0
2020,1,2796,135,22,256,13,35,5,13,0,0,0,0,0,0,False,False,False,0,3,2020-09-14T11:18:17.367,0,,0.0
2020,1,2796,140,22,256,13,12,10,12,0,0,0,0,0,0,False,False,False,0,3,2021-03-08T16:28:57.603,0,,0.0
2020,1,2796,150,4,6983,3,48,9,-2,0,0,0,0,0,0,False,False,False,0,1,2020-09-14T11:24:53.093,0,,0.0
2020,1,2796,155,4,1412,13,19,2,35,0,0,0,0,0,0,False,False,False,0,2,2021-02-05T15:30:43.777,0,,
2020,1,2796,160,4,1412,2,12,2,20,20,0,20,0,20,0,False,False,False,0,2,2020-09-17T15:18:41.34,20,,0.0
2020,1,2796,175,4,6953,13,12,3,9,0,0,0,0,0,0,False,False,False,0,2,2020-09-14T17:31:06.763,0,,0.0
2020,1,2796,185,4,7645,2,12,5,4,4,0,4,0,4,6,False,False,False,0,1,2020-09-14T11:42:55.307,4,,0.0
2020,1,2796,215,22,3170,3,35,8,15,0,0,0,0,0,0,False,False,False,0,3,2020-09-14T11:51:38.497,0,,0.0
2020,1,2796,220,22,6262,2,12,3,2,9,7,7,2,7,0,False,False,False,0,4,2021-03-08T16:29:24.597,9,,2.0
2020,1,2796,235,4,2853,2,5,5,10,11,1,11,0,11,0,False,False,False,0,3,2020-09-14T11:59:25.077,11,,0.0
2020,1,2796,245,4,594,2,12,10,6,5,-1,5,0,5,0,False,False,False,0,3,2020-09-14T12:03:05.94,5,,0.0
2020,1,2796,250,4,7645,2,16,4,3,4,1,4,0,4,0,False,False,False,0,1,2020-09-14T12:04:56.467,4,,0.0
2020,1,2796,260,4,7645,2,48,9,-3,8,11,6,2,6,0,False,False,False,0,1,2020-09-14T12:11:09.583,8,,2.0
2020,1,2796,270,4,1412,13,9,6,27,0,0,0,0,0,0,False,False,False,0,2,2020-09-15T13:16:04.903,0,,
2020,1,2796,275,4,1412,13,12,4,4,0,0,0,0,0,0,False,False,False,0,3,2020-09-14T17:32:17.567,0,,0.0
2020,1,2796,280,4,1412,13,5,3,5,0,0,0,0,0,0,False,False,False,0,3,2020-09-14T17:32:26.787,0,,0.0
2020,1,2796,285,4,2853,2,5,5,11,11,0,11,0,11,0,False,False,False,0,3,2020-09-14T12:23:15.82,11,,0.0
2020,1,2796,290,4,6983,2,48,10,0,8,8,5,3,5,0,False,False,False,1,1,2021-02-05T15:33:19.853,8,,3.0
2020,1,2796,305,4,1412,2,50,5,-3,17,20,17,0,17,6,False,False,False,0,2,2021-02-05T15:41:33.003,17,,0.0
2020,1,2796,330,22,256,2,6,10,5,13,8,11,2,11,0,False,False,False,0,2,2020-09-14T12:41:50.36,13,,2.0
2020,1,2796,335,22,3170,13,12,1,21,0,0,0,0,0,0,False,False,False,0,3,2021-03-04T21:00:20.857,0,,0.0
2020,1,2796,340,4,6983,2,12,5,6,7,1,7,0,7,0,False,False,False,0,1,2020-09-14T12:47:05.883,7,,0.0
2020,1,2796,345,4,594,3,49,3,-3,0,0,0,0,0,0,False,False,False,0,2,2020-09-15T17:33:18.543,0,,0.0
2020,1,2796,350,4,1412,2,4,5,5,7,2,7,0,7,0,False,False,False,0,2,2020-09-14T12:50:54.423,7,,0.0
2020,1,2796,380,4,6983,2,47,5,0,0,0,0,0,0,0,False,False,False,0,1,2020-09-17T19:58:20.29,0,,0.0
2020,1,2796,385,4,5119,2,44,9,-6,5,11,5,0,5,0,True,False,False,0,2,2020-09-14T13:05:15.14,5,,0.0
2020,1,2796,395,4,2853,13,23,9,13,0,0,0,0,0,0,False,False,False,0,3,2020-09-14T13:07:49.89,0,,0.0
2020,1,2796,405,22,34,2,24,6,23,30,7,30,0,30,0,False,False,False,0,3,2021-02-05T17:49:11.263,30,,0.0
2020,1,2796,420,22,3170,2,5,10,4,4,0,4,0,4,0,False,False,False,0,3,2020-09-14T13:17:25.457,4,,0.0
2020,1,2796,425,22,3170,2,51,9,-2,4,6,3,1,3,0,False,False,False,0,3,2020-09-17T18:11:49.503,4,,1.0
2020,1,2796,435,22,1361,13,19,6,24,0,0,0,0,0,0,False,False,False,0,2,2020-09-14T13:23:37.497,0,,0.0
2020,1,2796,440,22,3170,2,12,10,11,21,10,17,4,17,0,False,False,False,0,3,2021-03-02T17:29:37.257,21,,4.0
2020,1,2796,455,22,34,13,24,5,12,0,0,0,0,0,0,False,False,False,0,1,2021-02-05T17:49:11.263,0,,
2020,1,2796,465,22,3170,2,50,9,-2,5,7,2,3,2,0,False,False,False,1,3,2020-09-14T13:36:51.713,5,,3.0
2020,1,2796,495,4,594,13,5,9,3,0,0,0,0,0,0,False,False,False,0,3,2020-09-14T13:51:27.953,0,,0.0
2020,1,2796,510,22,256,2,49,3,-2,-2,0,-2,0,-2,0,False,False,False,0,2,2021-02-05T15:44:19.107,-2,,0.0
2020,1,2796,515,22,34,2,48,9,-6,2,8,1,1,1,0,False,False,False,0,1,2020-09-14T13:57:25.77,2,,1.0
2020,1,2796,520,22,3170,2,3,5,10,10,0,10,0,10,0,False,False,False,0,3,2020-09-14T18:09:30.44,10,,0.0
2020,1,2796,545,4,594,2,17,8,24,29,5,29,0,29,0,False,False,False,0,3,2020-09-14T14:10:03.883,29,,0.0
2020,1,2796,555,4,1412,13,8,8,45,0,0,0,0,0,0,False,False,False,0,2,2021-03-08T14:07:21.21,0,,0.0
2020,1,2796,560,4,7646,2,5,5,7,13,6,10,3,10,0,False,False,False,0,3,2020-09-15T17:30:08.463,13,,3.0
2020,1,2796,565,4,2853,13,4,5,12,0,0,0,0,0,0,False,False,False,0,2,2020-09-14T18:02:29.067,0,,
2020,1,2796,595,22,3170,13,35,9,9,0,0,0,0,0,0,False,False,False,0,3,2020-09-17T17:09:44.443,0,,0.0
2020,1,2796,600,22,3170,2,51,5,0,69,69,3,66,3,6,False,False,False,2,3,2020-09-14T14:38:16.583,69,,66.0
2020,1,2796,615,4,2853,2,4,3,2,8,6,2,6,2,0,False,False,False,2,3,2021-03-02T17:30:27.567,8,,6.0
2020,1,2796,630,4,594,2,6,4,11,13,2,12,1,12,0,False,False,False,0,3,2020-09-14T17:58:52.907,13,,1.0
2020,1,2796,645,4,6983,13,11,3,14,0,0,0,0,0,0,True,False,False,0,1,2020-09-15T17:30:33.183,0,,0.0
2020,1,2796,680,22,6262,2,53,9,-6,-5,1,-5,0,-5,0,False,True,True,0,4,2021-02-05T15:45:53.95,-8,False,0.0
2020,1,2796,685,4,6983,2,48,10,-4,-1,3,-2,1,-2,0,False,False,False,1,1,2021-02-05T16:38:46.713,-1,,1.0
2020,1,2796,690,4,2853,2,12,3,14,14,0,14,0,14,0,False,False,False,0,2,2021-03-08T16:29:55.44,14,,0.0
2020,1,2796,695,4,5119,2,34,4,-3,10,13,6,4,6,0,True,False,False,0,3,2020-09-15T17:31:00.25,10,,4.0
2020,1,2796,710,4,2853,2,4,5,11,11,0,11,0,11,0,False,False,False,0,3,2020-09-14T15:23:58.353,11,,0.0
2020,1,2796,715,4,594,13,2,4,4,0,0,0,0,0,0,False,False,False,0,3,2020-09-14T15:25:55.203,0,,0.0
2020,1,2796,725,4,1412,13,35,9,4,0,0,0,0,0,0,False,False,False,0,3,2021-01-28T17:26:14.03,0,,0.0
2020,1,2796,730,4,7645,13,12,10,4,0,0,0,0,0,0,True,False,False,0,1,2020-09-15T17:52:03.567,0,,0.0
2020,1,2796,745,22,3170,13,8,1,21,0,0,0,0,0,0,False,False,False,0,3,2020-09-14T15:41:42.547,0,,0.0
2020,1,2796,755,22,1361,13,6,9,14,0,0,0,0,0,0,False,False,False,0,2,2020-09-14T15:49:28.813,0,,0.0
2020,1,2796,775,4,594,2,26,4,5,11,6,11,0,11,0,False,False,False,0,3,2020-09-18T20:20:36.38,11,,0.0
2020,1,2796,780,4,1412,2,4,5,4,4,0,4,0,4,0,False,False,False,0,2,2020-09-14T15:58:10.633,4,,0.0
2020,1,2796,785,4,2853,2,35,6,19,22,3,22,0,22,0,False,False,False,0,3,2020-09-17T18:30:31.937,22,,0.0
2020,1,2796,790,4,5119,2,34,4,-2,2,4,2,0,2,0,True,False,False,0,3,2020-09-15T17:34:00.37,2,,0.0
2020,1,2796,805,4,6953,2,11,3,13,15,2,15,0,15,0,False,False,False,0,4,2021-03-10T17:20:58.807,15,,0.0
2020,1,2796,840,22,3170,2,5,5,2,2,0,2,0,2,0,False,False,False,0,3,2020-09-14T16:24:41.83,2,,0.0
2020,1,2796,845,22,6262,2,6,9,7,9,2,9,0,9,0,False,False,False,0,2,2020-09-14T17:25:30.213,9,,0.0
2020,1,2796,850,22,6579,2,4,9,3,7,4,4,3,4,0,False,False,False,0,1,2020-09-14T18:15:20.84,7,,3.0
2020,1,2796,855,22,256,2,5,3,4,6,2,6,0,6,0,True,False,False,0,3,2020-09-17T18:31:45.76,6,,0.0
2020,1,2796,860,22,6579,2,31,4,2,7,5,5,2,5,0,False,False,False,0,1,2020-09-14T16:35:33.657,7,,2.0
2020,1,2796,870,22,6262,2,5,5,1,1,0,1,0,1,0,False,False,False,0,4,2020-09-14T17:12:14.33,1,,0.0
2020,1,2796,880,22,6262,2,4,4,5,8,3,8,0,8,0,False,False,False,0,4,2020-09-14T17:12:30.997,8,,0.0
2020,1,2796,885,22,6262,2,8,4,14,18,4,18,0,18,0,False,False,False,0,4,2020-09-14T16:43:00.36,18,,0.0
2020,1,2796,895,22,256,13,21,6,22,0,0,0,0,0,0,False,False,False,0,2,2020-09-14T17:47:38.643,0,,
2020,1,2796,900,22,1361,3,5,5,2,0,0,0,0,0,0,False,False,False,0,3,2020-09-14T16:49:24.473,0,,0.0
2020,1,2797,15,23,7688,13,8,8,47,0,0,0,0,0,0,False,False,False,0,3,2021-02-05T18:19:06.243,0,,0.0
2020,1,2797,20,23,2994,13,39,4,6,0,0,0,0,0,0,False,False,False,0,4,2021-02-05T17:08:46.577,0,,0.0
2020,1,2797,30,5,3477,2,2,4,5,10,5,8,2,8,0,False,False,False,0,3,2020-09-17T13:27:23.627,10,,2.0
2020,1,2797,40,5,4803,2,30,10,-2,2,4,0,2,0,0,True,False,False,0,4,2020-09-15T19:35:05.553,2,,2.0
2020,1,2797,45,5,4803,2,5,6,16,16,0,16,0,16,0,False,False,False,0,3,2021-03-09T14:43:34.307,16,,0.0
2020,1,2797,55,5,5220,3,13,9,3,0,0,0,0,0,0,False,False,False,0,3,2020-09-14T11:34:22.353,0,,0.0
2020,1,2797,60,5,2847,2,49,9,-3,5,8,1,4,1,0,False,False,False,1,3,2020-09-17T15:46:21.267,5,,4.0
2020,1,2797,85,23,2994,2,13,5,4,7,3,7,0,7,0,False,False,False,0,4,2020-09-17T15:46:54.76,7,,0.0
2020,1,2797,90,23,2994,2,4,5,6,8,2,6,2,6,0,False,False,False,0,2,2020-09-14T11:52:28.04,8,,2.0
2020,1,2797,105,23,7688,2,35,2,29,45,16,45,0,45,0,False,False,False,0,3,2021-01-28T19:13:36.757,45,,0.0
2020,1,2797,130,5,2847,13,35,2,16,0,0,0,0,0,0,False,False,False,0,4,2021-03-09T14:55:08.393,0,,0.0
2020,1,2797,135,5,5220,2,4,9,4,9,5,8,1,8,0,False,False,False,0,3,2020-09-17T16:09:05.357,9,,1.0
2020,1,2797,145,5,5220,2,12,2,15,16,1,15,1,15,0,False,False,False,0,3,2020-09-17T14:36:42.027,16,,1.0
2020,1,2797,200,23,2994,2,47,5,1,8,7,4,4,4,0,False,False,False,0,4,2020-10-21T15:05:52.12,8,,4.0
2020,1,2797,215,23,2994,2,4,3,6,6,0,6,0,6,0,False,False,False,0,2,2020-09-14T13:11:54.58,6,,0.0
2020,1,2797,220,23,7241,13,28,4,3,0,0,0,0,0,0,False,False,False,0,1,2020-09-14T13:15:18.763,0,,0.0
2020,1,2797,235,23,7688,13,11,6,18,0,0,0,0,0,0,False,False,False,0,3,2021-03-09T14:56:36.797,0,,0.0
2020,1,2797,240,23,7250,2,2,4,7,10,3,9,1,9,0,False,False,False,0,3,2020-09-14T13:27:34.027,10,,1.0
2020,1,2797,245,23,7250,2,51,10,-3,11,14,6,5,6,0,False,False,False,0,3,2020-09-17T14:41:21.653,11,,5.0
2020,1,2797,255,23,3957,2,47,10,0,3,3,2,1,2,0,False,False,False,0,1,2020-09-17T16:09:21.453,3,,1.0
2020,1,2797,260,23,596,2,5,5,1,2,1,2,0,2,0,False,False,False,0,3,2020-09-14T13:37:48.92,2,,0.0
2020,1,2797,285,5,4799,13,19,6,25,0,0,0,0,0,0,False,False,False,0,2,2020-09-17T13:59:07.27,0,,
2020,1,2797,295,5,3750,2,53,5,-4,4,8,1,3,1,0,True,False,False,0,4,2020-09-15T19:35:21.757,4,,3.0
2020,1,2797,300,5,4803,3,2,10,13,0,0,0,0,0,0,False,False,False,0,3,2020-09-14T16:12:00.847,0,,0.0
2020,1,2797,305,5,5220,13,50,5,0,0,0,0,0,0,0,False,False,False,0,2,2021-02-05T17:11:11.093,0,,0.0
2020,1,2797,330,23,7688,2,51,3,1,4,3,4,0,4,0,False,False,False,0,3,2020-09-17T14:18:29.713,4,,0.0
2020,1,2797,335,23,7688,2,26,10,1,6,5,6,0,6,0,False,False,False,0,3,2020-09-14T16:45:09.66,6,,0.0
2020,1,2797,350,23,2994,2,53,4,-2,8,10,6,2,6,0,False,False,False,0,4,2020-09-16T11:52:32.873,8,,2.0
2020,1,2797,360,23,2256,2,9,2,23,23,0,23,0,23,6,False,False,False,0,4,2021-03-09T14:59:04.887,23,,0.0
2020,1,2797,375,5,4799,2,48,3,-1,11,12,5,6,5,0,False,False,False,1,1,2020-09-15T01:52:09.367,11,,6.0
2020,1,2797,380,5,4803,13,13,4,2,0,0,0,0,0,0,False,False,False,0,3,2020-09-17T16:12:03.783,0,,0.0
2020,1,2797,385,5,3477,2,6,3,4,7,3,7,0,7,0,False,False,False,0,3,2020-09-17T13:40:47.417,7,,0.0
2020,1,2797,390,5,6425,2,47,5,1,5,4,5,0,5,0,False,False,False,0,3,2020-09-17T14:32:00.457,5,,0.0
2020,1,2797,395,5,5220,2,3,3,11,11,0,11,0,11,0,False,False,False,0,2,2021-03-09T14:59:45.597,11,,0.0
2020,1,2797,400,5,3477,13,17,8,24,0,0,0,0,0,0,False,False,False,0,3,2021-03-09T15:00:29.9,0,,0.0
2020,1,2797,405,5,6425,2,6,4,11,11,0,11,0,11,0,False,False,False,0,3,2020-09-17T15:24:36.577,11,,0.0
2020,1,2797,415,5,3477,2,4,4,11,11,0,11,0,11,0,False,False,False,0,3,2020-09-15T02:00:35.91,11,,0.0
2020,1,2797,425,5,3477,13,7,3,12,0,0,0,0,0,0,False,False,False,0,2,2021-03-09T15:02:31.333,0,,0.0
2020,1,2797,465,5,4803,2,51,9,-1,0,1,0,0,0,0,False,False,False,0,3,2020-09-14T17:30:33.927,0,,0.0
2020,1,2797,470,5,3477,2,13,4,1,5,4,3,2,3,0,False,False,False,0,3,2020-09-17T16:12:55.383,5,,2.0
2020,1,2797,480,23,7689,2,50,3,-1,9,10,9,0,9,0,False,False,False,0,2,2020-09-14T17:36:09.637,9,,0.0
2020,1,2797,495,23,7241,2,48,4,-3,-1,2,-2,1,-2,0,False,False,False,0,1,2020-09-14T17:46:39.027,-1,,1.0
2020,1,2797,500,23,3843,2,46,3,6,15,9,13,2,13,0,False,False,False,0,1,2020-09-14T17:49:43.807,15,,2.0
2020,1,2797,520,5,4799,13,46,3,1,0,0,0,0,0,0,False,False,False,0,1,2020-09-15T20:20:54.267,0,,0.0
2020,1,2797,530,5,5220,13,6,1,18,0,0,0,0,0,0,False,False,False,0,3,2021-03-09T15:03:36.453,0,,0.0
2020,1,2797,545,23,7241,2,16,10,6,29,23,12,17,12,0,False,False,False,1,1,2020-09-15T01:54:12.137,29,,17.0
2020,1,2797,555,23,7250,13,36,4,6,0,0,0,0,0,0,False,False,False,0,3,2020-09-17T14:10:57.703,0,,
2020,1,2797,605,5,5220,2,6,1,16,18,2,16,2,16,0,False,False,False,0,2,2020-09-17T15:28:32.973,18,,2.0
2020,1,2797,610,5,3477,2,26,3,4,6,2,5,1,5,0,False,False,False,0,3,2020-09-17T15:29:58.42,6,,1.0
2020,1,2797,620,5,4803,2,46,3,1,1,0,1,0,1,0,False,False,False,0,3,2020-09-17T13:45:41.527,1,,0.0
2020,1,2797,630,5,5220,13,19,8,25,0,0,0,0,0,0,False,False,False,0,3,2020-09-17T14:24:25.527,0,,0.0
2020,1,2797,635,5,4799,2,48,3,-1,11,12,5,6,5,0,False,False,False,1,1,2020-09-14T19:08:38.413,11,,6.0
2020,1,2797,645,5,4799,2,46,3,5,16,11,16,0,16,0,False,False,False,0,1,2020-09-17T15:30:47.747,16,,0.0
2020,1,2797,670,5,5220,13,2,5,3,0,0,0,0,0,0,False,False,False,0,2,2020-09-15T02:05:32.76,0,,0.0
2020,1,2797,705,23,7241,2,44,9,-5,0,5,-1,1,-1,0,False,False,False,0,1,2020-09-14T19:41:12.203,0,,1.0
2020,1,2797,710,23,2994,13,4,9,11,0,0,0,0,0,0,False,False,False,0,3,2020-10-16T18:27:55.22,0,,0.0
2020,1,2797,725,5,3477,2,24,2,25,75,50,25,50,25,6,True,False,False,1,3,2020-09-17T14:46:10.053,75,,50.0
2020,1,2797,745,23,7241,2,31,9,-1,18,19,2,16,2,0,False,False,False,1,1,2020-09-17T14:47:13.25,18,,16.0
2020,1,2797,750,23,3957,2,18,5,-2,6,8,2,4,2,0,False,False,False,0,2,2020-09-15T02:08:16.903,6,,4.0
2020,1,2797,755,23,3957,2,2,5,3,14,11,7,7,7,0,False,False,False,0,2,2020-09-17T15:34:18.593,14,,7.0
2020,1,2797,765,23,7241,13,47,5,0,0,0,0,0,0,0,False,False,False,0,1,2020-09-17T16:23:48.55,0,,0.0
2020,1,2797,770,23,7250,13,7,6,19,0,0,0,0,0,0,False,False,False,0,3,2021-03-09T15:06:00.423,0,,
2020,1,2797,775,23,2994,2,51,10,-4,8,12,6,2,6,0,False,False,False,0,4,2021-03-04T13:09:13.03,8,,2.0
2020,1,2797,870,5,4803,13,5,5,13,0,0,0,0,0,0,False,False,False,0,2,2021-03-09T15:08:01.76,0,,0.0
2020,1,2797,875,5,4803,2,5,2,19,19,0,19,0,19,0,False,False,False,0,2,2021-03-09T15:08:38.21,19,,0.0
2020,1,2798,40,11,7733,13,13,10,-1,0,0,0,0,0,0,False,False,False,0,3,2020-09-14T17:21:41.85,0,,0.0
2020,1,2798,50,6,666,13,12,5,-3,0,0,0,0,0,0,False,False,False,0,4,2021-03-08T16:32:35.993,0,,0.0
2020,1,2798,55,6,464,2,5,3,3,13,10,13,0,13,0,False,False,False,0,3,2020-09-14T19:19:49.11,13,,0.0
2020,1,2798,65,6,464,2,8,10,12,12,0,12,0,12,0,False,False,False,0,2,2021-02-24T20:46:45.047,12,,0.0
2020,1,2798,75,6,666,13,22,3,14,0,0,0,0,0,0,True,False,False,0,3,2020-09-19T17:12:31.253,0,,0.0
2020,1,2798,85,6,509,13,6,8,17,0,0,0,0,0,0,False,False,False,0,3,2020-09-17T20:50:38.373,0,,0.0
2020,1,2798,90,11,100,13,5,3,3,0,0,0,0,0,0,False,False,False,0,3,2020-09-17T21:28:06.49,0,,0.0
2020,1,2798,100,11,6810,13,12,5,9,0,0,0,0,0,0,False,False,False,0,4,2021-03-08T16:33:06.063,0,,
2020,1,2798,110,11,7733,2,8,4,13,20,7,20,0,20,0,False,False,False,0,3,2021-02-08T22:46:48.42,20,,0.0
2020,1,2798,120,11,7733,3,6,4,4,0,0,0,0,0,0,False,False,False,0,3,2020-09-14T19:28:35.947,0,,0.0
2020,1,2798,125,11,7733,13,8,10,9,0,0,0,0,0,0,False,False,False,0,2,2020-09-14T19:28:56.13,0,,0.0
2020,1,2798,145,6,6786,2,46,3,4,10,6,9,1,9,0,False,False,False,0,1,2020-09-14T18:05:35.943,10,,1.0
2020,1,2798,155,6,7725,2,4,7,16,19,3,17,2,17,0,False,False,False,0,2,2021-02-08T22:15:20.147,19,,2.0
2020,1,2798,175,6,464,13,12,2,17,0,0,0,0,0,0,False,False,False,0,3,2021-03-08T16:33:30.333,0,,0.0
2020,1,2798,180,6,6328,13,17,7,17,0,0,0,0,0,0,False,False,False,0,3,2021-02-25T15:31:10,0,,0.0
2020,1,2798,200,11,792,2,47,10,-1,8,9,5,3,5,0,False,False,False,0,1,2020-09-14T18:23:51.633,8,,3.0
2020,1,2798,205,11,100,2,4,4,11,11,0,11,0,11,0,False,False,False,0,3,2020-09-17T19:40:31.187,11,,0.0
2020,1,2798,240,6,811,2,13,9,3,12,9,8,4,8,0,False,False,False,1,2,2021-02-08T22:20:57.367,12,,4.0
2020,1,2798,250,6,464,13,19,6,37,0,0,0,0,0,0,False,False,False,0,2,2020-09-17T22:04:03.767,0,,0.0
2020,1,2798,255,6,464,13,8,1,19,0,0,0,0,0,0,False,False,False,0,3,2020-09-14T11:19:18.567,0,,0.0
2020,1,2798,265,11,3820,2,4,8,17,26,9,23,3,23,0,False,False,False,0,2,2020-09-14T11:26:26.48,26,,3.0
2020,1,2798,270,11,6810,2,53,9,-5,8,13,6,2,6,0,False,False,False,0,4,2020-09-17T19:56:22.143,8,,2.0
2020,1,2798,280,11,100,13,5,5,5,0,0,0,0,0,0,False,False,False,0,3,2020-09-14T11:39:05.347,0,,0.0
2020,1,2798,290,11,100,2,4,1,18,18,0,18,0,18,0,False,False,False,0,3,2020-09-17T19:36:42.693,18,,0.0
2020,1,2798,295,11,3820,13,19,6,45,0,0,0,0,0,0,False,False,False,0,3,2020-09-14T19:48:01.74,0,,0.0
2020,1,2798,300,11,914,3,2,9,5,0,0,0,0,0,0,False,False,False,0,3,2020-09-17T20:22:23.2,0,,0.0
2020,1,2798,305,11,914,2,38,4,4,21,17,-2,23,-2,0,True,False,False,1,3,2020-09-15T23:35:43.993,21,,23.0
2020,1,2798,325,11,4487,13,35,3,14,0,0,0,0,0,0,False,False,False,0,3,2020-09-14T12:03:11.57,0,,0.0
2020,1,2798,340,6,464,2,8,8,18,22,4,21,1,21,0,False,False,False,0,3,2020-09-17T22:11:48.943,22,,1.0
2020,1,2798,355,6,7725,2,26,3,9,19,10,18,1,18,0,True,False,False,1,2,2020-09-17T19:45:37.133,19,,1.0
2020,1,2798,365,6,666,13,5,5,9,0,0,0,0,0,0,False,False,False,0,4,2021-02-08T22:41:33.197,0,,0.0
2020,1,2798,370,6,7728,13,33,10,9,0,0,0,0,0,0,False,False,False,0,4,2020-09-17T22:04:13.647,0,,0.0
2020,1,2798,385,11,914,2,4,9,6,7,1,8,-1,8,0,False,False,False,0,3,2020-09-14T12:33:17.387,7,,-1.0
2020,1,2798,415,6,4471,2,46,3,-3,3,6,1,2,1,0,True,False,False,0,1,2020-09-19T17:12:51.22,3,,2.0
2020,1,2798,420,6,6328,13,9,2,22,0,0,0,0,0,0,False,False,False,0,3,2020-09-17T22:11:48.943,0,,0.0
2020,1,2798,425,6,6331,13,26,10,2,0,0,0,0,0,0,False,False,False,0,3,2020-09-14T12:45:35.853,0,,0.0
2020,1,2798,435,11,7732,2,2,10,4,7,3,4,3,4,0,False,False,False,0,2,2020-09-17T21:35:10.813,7,,3.0
2020,1,2798,445,11,6810,2,13,9,5,16,11,12,4,12,0,True,False,False,0,2,2020-09-14T13:43:43.233,16,,4.0
2020,1,2798,455,11,6810,2,7,6,18,24,6,24,0,24,0,False,False,False,0,3,2020-09-17T20:56:37.493,24,,0.0
2020,1,2798,500,11,100,2,5,3,3,15,12,13,2,13,0,True,False,False,0,3,2020-09-15T23:37:15.11,15,,2.0
2020,1,2798,510,11,7733,2,8,10,11,14,3,14,0,14,0,False,False,False,0,3,2020-09-14T14:01:00.977,14,,0.0
2020,1,2798,515,11,914,2,3,6,16,16,0,14,2,14,0,False,False,False,0,3,2020-09-17T20:05:54.54,16,,2.0
2020,1,2798,525,11,6810,2,16,9,4,4,0,4,0,4,6,True,False,False,0,4,2020-09-17T20:52:52.74,4,,0.0
2020,1,2798,560,6,7725,2,13,9,-1,0,1,-1,1,-1,0,False,False,False,0,3,2020-09-14T19:36:01.92,0,,1.0
2020,1,2798,575,11,792,2,47,10,3,9,6,7,2,7,0,False,False,False,1,1,2020-09-14T14:32:47.38,9,,2.0
2020,1,2798,590,11,7732,13,48,10,-6,0,0,0,0,0,0,False,False,False,0,1,2021-02-17T14:15:38.35,0,,
2020,1,2798,595,11,4487,13,2,10,10,0,0,0,0,0,0,False,False,False,0,3,2021-02-17T14:15:56.407,0,,
2020,1,2798,610,11,914,13,13,9,0,0,0,0,0,0,0,False,False,False,0,3,2020-09-14T14:47:44.703,0,,0.0
2020,1,2798,625,6,6786,13,51,3,-5,0,0,0,0,0,0,True,False,False,0,1,2020-09-17T20:06:40.22,0,,0.0
2020,1,2798,635,6,6328,2,17,7,18,18,0,18,0,18,0,False,False,False,0,3,2020-09-17T22:11:48.943,18,,0.0
2020,1,2798,640,6,464,2,35,7,22,22,0,18,4,18,0,False,False,False,0,3,2021-02-08T22:23:48.257,22,,4.0
2020,1,2798,650,6,2071,13,7,5,13,0,0,0,0,0,0,False,False,False,0,4,2021-01-28T19:08:40.973,0,,0.0
2020,1,2798,655,6,4471,2,47,5,-2,3,5,-2,5,-2,0,False,False,False,1,1,2020-09-14T15:03:41.507,3,,5.0
2020,1,2798,670,6,464,2,55,4,-1,5,6,1,4,1,0,True,False,False,0,4,2021-02-25T15:35:50.967,5,,4.0
2020,1,2798,675,6,6786,13,46,9,1,0,0,0,0,0,0,False,False,False,0,1,2021-02-08T22:25:12.607,0,,0.0
2020,1,2798,685,6,666,2,29,5,2,2,0,2,0,2,6,False,False,False,0,2,2020-09-14T19:18:33.85,2,,0.0
2020,1,2798,700,11,6810,2,47,5,1,4,3,3,1,3,0,True,False,False,0,3,2020-09-14T15:19:34.763,4,,1.0
2020,1,2798,715,11,7733,2,4,5,9,9,0,9,0,9,0,False,False,False,0,3,2020-09-14T15:29:23.307,9,,0.0
2020,1,2798,725,11,7733,13,4,5,13,0,0,0,0,0,0,False,False,False,0,2,2020-09-14T15:32:12.88,0,,0.0
2020,1,2798,730,11,7732,3,51,10,0,0,0,0,0,0,0,True,False,False,0,1,2020-09-17T20:07:36.543,0,,0.0
2020,1,2798,760,6,464,13,9,2,21,0,0,0,0,0,0,False,False,False,0,3,2021-02-24T20:47:41.087,0,,0.0
2020,1,2798,775,11,792,2,4,4,2,4,2,2,2,2,0,False,False,False,0,1,2020-09-14T15:51:00.023,4,,2.0
2020,1,2798,785,11,7733,13,4,2,16,0,0,0,0,0,0,False,False,False,0,2,2020-09-14T15:55:49.203,0,,0.0
2020,1,2798,805,11,7732,2,48,4,-4,5,9,1,4,1,0,False,False,False,1,1,2020-09-17T21:13:38.89,5,,4.0
2020,1,2798,815,6,666,2,2,10,5,7,2,5,2,5,0,False,False,False,0,2,2020-09-14T16:06:11.787,7,,2.0
2020,1,2798,820,6,6328,2,12,1,15,18,3,15,3,15,0,False,False,False,0,3,2020-09-14T16:08:25.873,18,,3.0
2020,1,2798,825,6,6328,2,5,3,13,13,0,13,0,13,0,False,False,False,0,3,2020-09-14T16:10:18.05,13,,0.0
2020,1,2798,830,6,666,2,13,5,6,16,10,10,6,10,0,False,False,False,0,4,2020-09-14T16:15:52.927,16,,6.0
2020,1,2798,835,6,6331,2,22,3,1,1,0,1,0,1,6,False,False,False,0,2,2020-09-14T19:18:51.497,1,,0.0
2020,1,2798,870,11,914,13,6,4,12,0,0,0,0,0,0,False,False,False,0,3,2021-03-04T21:02:44.34,0,,0.0
2020,1,2798,890,6,6328,2,9,2,27,27,0,25,2,25,6,False,False,False,0,3,2020-09-17T22:11:48.943,27,,2.0
2020,1,2798,910,11,914,2,6,10,11,11,0,11,0,11,0,False,False,False,0,2,2020-09-14T18:46:50.993,11,,0.0
2020,1,2798,930,11,100,2,5,5,5,5,0,5,0,5,0,False,False,False,0,3,2020-09-14T16:39:31.7,5,,0.0
2020,1,2798,935,11,7732,2,46,9,-3,3,6,3,0,3,0,False,False,False,0,1,2020-09-14T16:41:02.86,3,,0.0
2020,1,2798,945,11,7733,13,19,8,43,0,0,0,0,0,0,False,False,False,0,2,2020-09-14T16:43:01.123,0,,0.0
2020,1,2798,950,11,100,2,8,7,21,32,11,32,0,32,0,False,False,False,0,3,2020-09-17T19:22:26.293,32,,0.0
2020,1,2798,960,11,7732,3,11,6,15,0,0,0,0,0,0,False,False,False,0,1,2020-09-14T16:48:19.853,0,,0.0
2020,1,2798,965,11,914,13,12,6,16,0,0,0,0,0,0,False,False,False,0,2,2021-03-08T16:34:58.79,0,,0.0
2020,1,2799,10,14,5024,2,11,3,3,8,5,8,0,8,0,False,False,False,0,1,2020-09-14T19:17:42.273,8,,0.0
2020,1,2799,15,14,6938,2,6,9,12,21,9,19,2,19,0,False,False,False,0,3,2020-09-14T10:22:50.1,21,,2.0
2020,1,2799,30,14,7584,2,4,5,5,5,0,5,0,5,0,False,False,False,0,2,2020-09-14T15:12:52.467,5,,0.0
2020,1,2799,70,15,4997,2,46,3,5,5,0,5,0,5,0,False,False,False,0,3,2020-09-17T19:24:05.84,5,,0.0
2020,1,2799,85,15,7591,2,4,10,2,4,2,4,0,4,0,False,False,False,0,2,2020-09-14T10:55:58.62,4,,0.0
2020,1,2799,90,15,1561,2,4,10,4,4,0,4,0,4,0,False,False,False,0,1,2020-09-14T10:59:55.577,4,,0.0
2020,1,2799,95,15,1561,2,50,5,-3,2,5,2,0,2,0,True,False,False,0,2,2020-09-14T11:02:31.907,2,,0.0
2020,1,2799,105,14,6938,2,6,9,11,18,7,16,2,16,0,False,False,False,0,3,2020-09-14T11:07:53.973,18,,2.0
2020,1,2799,110,14,5024,2,48,9,-6,19,25,18,1,18,0,False,False,False,0,1,2020-09-14T11:11:19.883,19,,1.0
2020,1,2799,120,14,1119,13,8,9,12,0,0,0,0,0,0,False,False,False,0,4,2020-09-14T11:17:14.527,0,,0.0
2020,1,2799,125,14,4449,2,6,3,4,6,2,4,2,4,0,False,False,False,0,2,2020-09-14T11:20:38.187,6,,2.0
2020,1,2799,145,15,7591,13,2,4,12,0,0,0,0,0,0,False,False,False,0,3,2020-09-17T18:49:07.483,0,,0.0
2020,1,2799,155,15,6501,2,13,4,4,7,3,5,2,5,0,False,False,False,0,3,2020-09-14T19:13:48.077,7,,2.0
2020,1,2799,185,14,1114,2,5,2,20,20,0,20,0,20,0,False,False,False,0,2,2020-09-14T15:53:29.837,20,,0.0
2020,1,2799,190,14,1114,13,3,5,8,0,0,0,0,0,0,False,False,False,0,2,2020-09-14T15:55:28.847,0,,0.0
2020,1,2799,195,14,6938,2,13,10,0,0,0,0,0,0,0,False,False,False,0,3,2020-09-14T15:57:35.007,0,,0.0
2020,1,2799,200,14,1114,13,5,5,14,0,0,0,0,0,0,False,False,False,0,3,2020-09-14T16:00:21.803,0,,0.0
2020,1,2799,220,15,6501,2,9,5,6,6,0,6,0,6,6,False,False,False,0,3,2020-09-14T11:36:12.21,6,,0.0
2020,1,2799,240,14,6543,2,6,5,5,6,1,6,0,6,0,False,False,False,0,2,2020-09-14T11:44:22.06,6,,0.0
2020,1,2799,245,14,6938,2,7,6,16,17,1,17,0,17,0,False,False,False,0,3,2020-09-14T11:50:47.643,17,,0.0
2020,1,2799,250,14,6938,13,9,2,18,0,0,0,0,0,0,False,False,False,0,3,2020-09-14T19:18:42.207,0,,0.0
2020,1,2799,255,14,5024,2,4,9,2,3,1,3,0,3,0,False,False,False,0,1,2020-09-14T11:56:07.093,3,,0.0
2020,1,2799,260,14,1114,2,5,3,14,14,0,14,0,14,0,False,False,False,0,3,2020-09-14T11:58:01.347,14,,0.0
2020,1,2799,270,14,7582,2,48,9,-4,35,39,27,8,27,0,False,False,False,0,1,2020-09-17T20:33:57.82,35,,8.0
2020,1,2799,285,14,6543,2,48,9,-6,8,14,8,0,8,6,False,False,False,0,1,2020-09-14T12:09:38.927,8,,0.0
2020,1,2799,300,15,7591,2,11,2,15,18,3,17,1,17,0,True,False,False,0,3,2020-09-14T12:20:55.133,18,,1.0
2020,1,2799,305,15,4997,2,51,3,-3,4,7,2,2,2,0,False,False,False,0,3,2020-09-14T12:20:44.7,4,,2.0
2020,1,2799,310,15,4997,2,47,5,3,10,7,8,2,8,0,False,False,False,1,3,2020-09-14T12:24:41.737,10,,2.0
2020,1,2799,315,15,6501,2,2,10,6,12,6,8,4,8,0,False,False,False,0,2,2020-09-14T12:26:46.68,12,,4.0
2020,1,2799,340,15,4997,2,5,3,6,6,0,6,0,6,0,False,False,False,0,3,2020-09-14T12:38:09.72,6,,0.0
2020,1,2799,350,15,7591,2,42,9,5,15,10,13,2,13,6,False,False,False,0,2,2020-09-14T12:47:16.127,15,,2.0
2020,1,2799,365,14,1114,2,5,5,11,11,0,11,0,11,0,False,False,False,0,2,2020-09-14T12:51:02.013,11,,0.0
2020,1,2799,370,14,6543,2,44,9,-5,0,5,0,0,0,0,False,False,False,1,1,2020-09-14T12:54:11.283,0,,0.0
2020,1,2799,375,14,4449,2,4,9,12,12,0,12,0,12,0,False,False,False,0,3,2020-09-14T12:56:20.25,12,,0.0
2020,1,2799,380,14,1119,2,6,9,10,12,2,12,0,12,0,False,False,False,0,3,2020-09-14T13:00:08.05,12,,0.0
2020,1,2799,385,14,1119,2,39,4,6,9,3,7,2,7,0,False,False,False,0,3,2020-09-14T13:02:31.143,9,,2.0
2020,1,2799,390,14,6543,2,46,3,0,3,3,2,1,2,0,False,False,False,0,1,2020-09-14T13:04:14.75,3,,1.0
2020,1,2799,465,14,1119,2,7,10,14,28,14,16,12,16,0,False,False,False,1,4,2020-09-14T13:46:46.677,28,,12.0
2020,1,2799,475,14,6543,2,51,9,-4,8,12,8,0,8,0,False,False,False,0,1,2020-09-14T13:53:39.137,8,,0.0
2020,1,2799,480,14,5197,2,46,3,1,13,12,5,8,5,0,False,False,False,0,4,2020-09-14T16:03:31.52,13,,8.0
2020,1,2799,495,14,7582,2,48,10,-7,4,11,2,2,2,0,False,False,False,0,1,2020-09-14T16:11:22.84,4,,2.0
2020,1,2799,500,14,1114,13,17,4,12,0,0,0,0,0,0,False,False,False,0,3,2020-09-14T16:13:53,0,,0.0
2020,1,2799,515,15,2757,2,53,10,-3,0,3,-1,1,-1,0,False,False,False,0,4,2020-09-14T16:20:52.73,0,,1.0
2020,1,2799,520,15,7592,2,6,4,12,14,2,13,1,13,0,False,False,False,0,3,2020-09-14T16:23:19.123,14,,1.0
2020,1,2799,525,15,6501,13,19,6,34,0,0,0,0,0,0,False,False,False,0,2,2020-09-14T16:27:18.85,0,,
2020,1,2799,530,15,2407,2,30,10,-1,6,7,5,1,5,0,True,False,False,0,4,2020-09-14T16:29:42.217,6,,1.0
2020,1,2799,565,14,1114,13,29,6,18,0,0,0,0,0,0,False,False,False,0,2,2021-02-25T15:50:33.417,0,,
2020,1,2799,570,14,7582,2,51,10,-5,5,10,3,2,3,0,False,False,False,0,1,2020-09-14T16:45:51.923,5,,2.0
2020,1,2799,580,14,7582,13,11,5,10,0,0,0,0,0,0,False,False,False,0,1,2020-09-17T18:59:53.07,0,,
2020,1,2799,585,14,4449,3,35,7,15,0,0,0,0,0,0,False,False,False,0,3,2020-09-17T18:43:35.02,0,,0.0
2020,1,2799,615,14,6938,2,13,10,2,3,1,3,0,3,0,False,False,False,0,3,2020-09-14T17:11:03.363,3,,0.0
2020,1,2799,620,14,4449,13,13,9,3,0,0,0,0,0,0,False,False,False,0,4,2020-09-17T18:52:24.163,0,,
2020,1,2799,625,14,7582,2,47,5,-2,17,19,15,2,15,0,False,False,False,1,1,2020-09-14T17:34:41.71,17,,2.0
2020,1,2799,635,14,6543,2,16,10,6,9,3,8,1,8,0,False,False,False,0,1,2020-09-14T17:41:57.02,9,,1.0
2020,1,2799,640,14,7582,2,45,5,1,6,5,5,1,5,0,True,False,False,0,1,2020-09-14T17:45:23.313,6,,1.0
2020,1,2799,645,14,6543,2,2,4,3,7,4,4,3,4,0,False,False,False,0,3,2020-09-14T17:47:45.89,7,,3.0
2020,1,2799,665,15,8099,2,51,10,-5,28,33,5,23,5,0,False,False,False,2,1,2020-09-14T17:55:02.827,28,,23.0
2020,1,2799,670,15,922,2,30,3,2,8,6,6,2,6,0,True,False,False,0,4,2020-09-15T19:40:08.423,8,,2.0
2020,1,2799,680,15,152,2,30,10,-1,2,3,1,1,1,0,False,False,False,0,1,2020-09-17T18:39:29.067,2,,1.0
2020,1,2799,690,15,4997,2,35,2,21,22,1,22,0,22,6,False,False,False,0,3,2020-09-14T18:11:29.677,22,,0.0
2020,1,2799,705,14,7582,2,44,3,-5,0,5,-5,5,-5,0,False,False,False,1,1,2020-09-14T18:18:58.18,0,,5.0
2020,1,2799,710,14,5197,2,4,9,5,7,2,6,1,6,0,False,False,False,0,4,2020-09-14T18:21:10.913,7,,1.0
2020,1,2799,715,14,6938,13,35,3,11,0,0,0,0,0,0,False,False,False,0,3,2020-09-17T18:43:17.787,0,,0.0
2020,1,2799,750,14,6543,2,4,5,1,4,3,2,2,2,0,False,False,False,0,2,2020-09-17T18:41:54.277,4,,2.0
2020,1,2799,755,14,1114,2,6,5,7,8,1,7,1,7,0,False,False,False,0,2,2020-09-14T18:37:31.017,8,,1.0
2020,1,2799,770,14,6938,2,4,4,10,12,2,10,2,10,0,False,False,False,0,3,2020-09-17T18:42:21.437,12,,2.0
2020,1,2799,775,14,7584,2,4,5,6,5,-1,5,0,5,0,False,False,False,0,2,2020-09-14T18:47:53.137,5,,0.0
2020,1,2799,780,14,1114,13,3,3,12,0,0,0,0,0,0,False,False,False,0,2,2020-09-14T18:49:52.367,0,,0.0
2020,1,2799,785,14,6938,13,7,6,23,0,0,0,0,0,0,False,False,False,0,3,2020-09-14T18:52:40.07,0,,0.0
2020,1,2799,790,14,1114,13,4,5,5,0,0,0,0,0,0,False,False,False,0,2,2020-09-17T18:42:34.123,0,,0.0
2020,1,2800,25,12,4537,2,44,3,-3,6,9,-1,7,-1,0,False,False,False,1,1,2020-09-17T19:50:00.43,6,,7.0
2020,1,2800,30,12,3965,2,34,4,-4,6,10,4,2,4,0,True,False,False,0,3,2020-09-15T20:22:59.637,6,,2.0
2020,1,2800,35,12,556,2,5,5,6,7,1,7,0,7,0,True,False,False,0,2,2020-09-15T23:33:26.877,7,,0.0
2020,1,2800,45,12,6691,2,34,4,-4,9,13,2,7,2,0,True,False,False,0,3,2020-09-15T20:58:56.363,9,,7.0
2020,1,2800,55,12,4561,2,44,9,-2,15,17,-1,16,-1,0,False,False,False,1,1,2020-09-14T10:40:11.67,15,,16.0
2020,1,2800,60,12,4561,2,34,4,-4,-1,3,-1,0,-1,0,True,False,False,0,2,2020-09-14T10:43:28.463,-1,,0.0
2020,1,2800,65,12,4537,2,48,10,-5,-1,4,-5,4,-5,0,False,False,False,1,1,2020-09-15T20:24:03.96,-1,,4.0
2020,1,2800,70,12,4537,13,9,5,12,0,0,0,0,0,0,False,False,False,0,2,2020-09-14T10:50:56.38,0,,0.0
2020,1,2800,85,18,1381,2,6,9,5,7,2,6,1,6,0,False,False,False,0,3,2020-09-15T23:33:05.307,7,,1.0
2020,1,2800,90,18,1381,2,12,2,25,25,0,25,0,25,0,False,False,False,0,2,2021-03-08T16:23:32.247,25,,0.0
2020,1,2800,135,12,556,2,6,4,13,14,1,13,1,13,0,False,False,False,0,3,2020-09-14T11:21:09.6,14,,1.0
2020,1,2800,145,12,6876,13,9,2,32,0,0,0,0,0,0,False,False,False,0,2,2020-10-16T20:07:13.863,0,,0.0
2020,1,2800,150,12,556,2,5,5,12,12,0,12,0,12,0,False,False,False,0,2,2020-09-14T11:30:51.857,12,,0.0
2020,1,2800,160,12,556,2,13,10,5,7,2,7,0,7,0,False,False,False,0,3,2020-09-14T11:38:55.467,7,,0.0
2020,1,2800,180,12,556,2,51,9,-1,10,11,7,3,7,0,True,False,False,0,3,2020-09-17T19:18:49.07,10,,3.0
2020,1,2800,190,12,4537,13,12,5,1,0,0,0,0,0,0,False,False,False,0,1,2021-03-08T16:24:44.59,0,,0.0
2020,1,2800,200,12,556,13,2,9,1,0,0,0,0,0,0,False,False,False,0,2,2021-03-04T15:09:19.86,0,,0.0
2020,1,2800,225,12,6357,13,12,2,52,0,0,0,0,0,0,True,False,False,0,3,2021-03-08T16:25:28.33,0,,
2020,1,2800,235,12,556,2,13,10,3,18,15,10,8,10,0,False,False,False,1,3,2021-02-09T00:01:25.663,18,,8.0
2020,1,2800,245,12,7743,2,46,3,1,12,11,10,2,10,0,True,False,False,0,1,2020-09-15T21:02:04.587,12,,2.0
2020,1,2800,300,12,4561,2,46,3,1,1,0,1,0,1,0,False,False,False,0,1,2020-09-14T12:39:22.64,1,,0.0
2020,1,2800,310,12,7743,13,11,6,19,0,0,0,0,0,0,False,False,False,0,1,2020-09-14T12:43:01.173,0,,0.0
2020,1,2800,315,12,4561,2,46,3,1,6,5,4,2,4,0,False,False,False,0,1,2020-09-14T12:45:10.523,6,,2.0
2020,1,2800,325,12,556,2,51,10,-2,3,5,1,2,1,0,False,False,False,1,3,2020-09-17T19:47:51.59,3,,2.0
2020,1,2800,350,12,556,2,5,3,5,8,3,7,1,7,0,False,False,False,0,3,2020-09-14T12:57:32.017,8,,1.0
2020,1,2800,360,12,556,2,12,2,24,24,0,24,0,24,6,False,False,False,0,3,2021-03-08T16:27:51.49,24,,0.0
2020,1,2800,375,18,1381,13,4,5,14,0,0,0,0,0,0,False,False,False,0,2,2020-09-14T13:06:39.803,0,,0.0
2020,1,2800,380,18,1381,13,22,2,16,0,0,0,0,0,0,False,False,False,0,2,2021-03-04T21:05:02.4,0,,0.0
2020,1,2800,385,12,556,13,5,3,12,0,0,0,0,0,0,False,False,False,0,2,2021-03-05T12:49:58.147,0,,0.0
2020,1,2800,390,12,6357,2,19,2,40,45,5,41,4,41,6,False,False,False,0,2,2020-09-14T13:17:41.057,45,,4.0
2020,1,2800,410,18,813,2,17,8,15,22,7,22,0,22,0,False,False,False,0,4,2020-09-14T17:00:59.747,22,,0.0
2020,1,2800,450,18,7711,3,12,3,4,0,0,0,0,0,0,False,False,False,0,3,2021-03-08T16:29:41.487,0,,0.0
2020,1,2800,460,18,7711,2,50,3,-1,9,10,9,0,9,0,False,False,False,0,2,2020-09-14T13:41:25.023,9,,0.0
2020,1,2800,470,12,556,2,4,3,7,8,1,7,1,7,0,False,False,False,0,2,2020-09-14T13:44:47.75,8,,1.0
2020,1,2800,495,12,556,2,49,9,0,1,1,1,0,1,0,False,False,False,0,2,2020-09-17T19:27:14.81,1,,0.0
2020,1,2800,500,12,6357,3,13,10,4,0,0,0,0,0,0,False,False,False,0,3,2020-09-14T13:57:15.177,0,,0.0
2020,1,2800,525,18,4572,2,48,10,-3,-2,1,-2,0,-2,0,False,False,False,0,1,2020-09-14T14:07:45.5,-2,,0.0
2020,1,2800,530,18,6897,2,13,9,4,5,1,5,0,5,0,False,False,False,0,3,2020-09-14T14:10:42.08,5,,0.0
2020,1,2800,540,18,3506,13,19,2,35,0,0,0,0,0,0,False,False,False,0,2,2020-09-14T14:13:23.11,0,,0.0
2020,1,2800,545,12,6357,3,22,6,47,0,0,0,0,0,0,False,False,False,0,3,2020-09-14T17:03:17.127,0,,0.0
2020,1,2800,555,12,6691,2,5,5,11,12,1,12,0,12,0,False,False,False,0,3,2020-09-14T14:27:23.647,12,,0.0
2020,1,2800,570,12,556,2,5,3,5,3,-2,3,0,3,0,False,False,False,0,3,2020-09-14T14:31:54.213,3,,0.0
2020,1,2800,575,12,6357,2,19,2,23,39,16,36,3,36,0,False,False,False,0,3,2020-09-14T14:35:17.933,39,,3.0
2020,1,2800,585,12,556,2,5,3,1,1,0,1,0,1,6,False,False,False,0,3,2020-09-17T19:15:37.497,1,,0.0
2020,1,2800,600,18,6897,2,2,9,5,29,24,7,22,7,0,False,False,False,1,2,2020-09-14T14:44:48.913,29,,22.0
2020,1,2800,620,18,1381,2,7,6,37,37,0,37,0,37,6,False,False,False,0,3,2020-09-14T14:51:48.23,37,,0.0
2020,1,2800,655,12,556,13,12,6,34,0,0,0,0,0,0,False,False,False,0,2,2021-03-08T16:30:31.883,0,,0.0
2020,1,2800,660,12,6691,2,17,1,28,38,10,38,0,38,0,False,False,False,0,3,2020-09-14T15:07:23.327,38,,0.0
2020,1,2800,670,12,4537,2,44,3,0,1,1,1,0,1,0,False,False,False,0,1,2020-09-14T15:10:21.68,1,,0.0
2020,1,2800,675,12,6691,2,12,5,4,4,0,4,0,4,6,False,False,False,0,3,2021-03-08T16:31:09.2,4,,0.0
2020,1,2800,690,18,1381,2,5,3,10,10,0,10,0,10,0,True,False,False,0,2,2020-09-15T23:33:17.447,10,,0.0
2020,1,2800,700,18,4572,3,45,10,-4,0,0,0,0,0,0,False,False,False,0,1,2020-09-14T15:21:01.86,0,,0.0
2020,1,2800,705,18,6907,2,4,4,11,11,0,11,0,11,0,False,False,False,0,4,2020-09-14T15:23:04.813,11,,0.0
2020,1,2800,710,18,7711,2,2,4,4,17,13,17,0,17,0,False,False,False,1,3,2020-09-14T15:25:04.757,17,,0.0
2020,1,2800,715,18,6897,2,12,2,21,22,1,22,0,22,0,False,False,False,0,2,2021-03-08T16:31:44.773,22,,0.0
2020,1,2800,745,12,4537,2,51,10,-3,4,7,3,1,3,0,False,False,False,0,3,2020-09-17T19:27:55.427,4,,1.0
2020,1,2800,750,12,6357,2,5,5,5,6,1,6,0,6,0,True,False,False,0,3,2020-09-15T21:03:36.587,6,,0.0
2020,1,2800,760,12,556,2,19,2,36,40,4,40,0,40,0,False,False,False,0,2,2020-09-14T15:46:24.283,40,,0.0
2020,1,2800,765,12,6357,2,5,9,4,6,2,5,1,5,0,False,False,False,0,3,2020-09-17T19:41:45.663,6,,1.0
2020,1,2800,790,18,813,2,39,4,6,6,0,6,0,6,0,False,False,False,0,4,2020-09-14T15:56:53.66,6,,0.0
2020,1,2800,795,18,6900,2,4,4,3,7,4,4,3,4,0,False,False,False,0,1,2020-09-14T15:59:07.673,7,,3.0
2020,1,2800,800,18,6900,2,6,9,3,9,6,7,2,7,0,False,False,False,1,1,2020-09-17T18:39:24.147,9,,2.0
2020,1,2800,815,18,6900,2,31,4,3,9,6,4,5,4,0,False,False,False,1,1,2020-09-17T20:37:50.583,9,,5.0
2020,1,2800,820,18,6897,13,5,3,11,0,0,0,0,0,0,False,False,False,0,2,2020-09-14T16:09:57.19,0,,0.0
2020,1,2800,825,18,6900,2,6,4,4,5,1,5,0,5,0,False,False,False,0,1,2020-09-17T18:39:46.547,5,,0.0
2020,1,2800,835,18,1381,2,5,5,12,12,0,12,0,12,0,False,False,False,0,2,2020-09-14T16:14:20.04,12,,0.0
2020,1,2800,840,18,1381,2,9,2,19,19,0,19,0,19,6,False,False,False,0,2,2020-09-14T16:16:44.11,19,,0.0
2020,1,2801,20,17,2253,2,4,10,3,3,0,3,0,3,0,False,False,False,0,2,2020-09-14T10:16:05.587,3,,0.0
2020,1,2801,55,19,54,13,6,7,21,0,0,0,0,0,0,False,False,False,0,3,2020-09-17T15:08:34.017,0,,0.0
2020,1,2801,65,19,1328,2,12,3,1,10,9,2,8,2,0,False,False,False,0,1,2021-03-08T16:34:51.637,10,,8.0
2020,1,2801,75,17,2253,2,2,4,7,12,5,10,2,10,0,False,False,False,0,3,2020-09-14T11:03:00.09,12,,2.0
2020,1,2801,85,17,7051,2,4,9,-1,6,7,4,2,4,0,False,False,False,0,1,2021-02-08T23:17:31.223,6,,2.0
2020,1,2801,90,17,7024,2,47,5,0,13,13,10,3,10,0,False,False,False,0,1,2020-09-14T11:20:11.18,13,,3.0
2020,1,2801,105,17,4752,3,12,5,9,0,0,0,0,0,0,True,False,False,0,3,2020-09-15T23:25:59.473,0,,0.0
2020,1,2801,130,19,6273,2,35,9,14,25,11,23,2,23,0,False,False,False,0,4,2020-09-14T11:41:13.213,25,,2.0
2020,1,2801,145,19,7173,2,51,3,-4,6,10,6,0,6,0,True,False,False,0,3,2020-09-14T17:30:14.34,6,,0.0
2020,1,2801,160,19,54,2,5,3,6,6,0,6,0,6,0,False,False,False,0,3,2020-09-17T17:23:57.767,6,,0.0
2020,1,2801,185,17,2253,2,4,5,13,14,1,12,2,12,0,False,False,False,0,2,2020-09-17T15:08:34.017,14,,2.0
2020,1,2801,190,17,7024,2,28,5,-2,-1,1,-1,0,-1,0,False,False,False,0,1,2021-02-08T23:19:11.257,-1,,0.0
2020,1,2801,195,17,7087,13,7,6,25,0,0,0,0,0,0,False,False,False,0,2,2020-09-14T12:22:17.637,0,,0.0
2020,1,2801,200,17,7087,13,5,10,12,0,0,0,0,0,0,False,False,False,0,3,2021-03-04T21:08:54.883,0,,0.0
2020,1,2801,240,17,2253,2,6,7,18,18,0,18,0,18,0,False,False,False,0,2,2020-09-14T12:43:37.387,18,,0.0
2020,1,2801,255,17,7087,2,4,7,20,20,0,20,0,20,0,False,False,False,0,3,2020-09-14T12:49:27.67,20,,0.0
2020,1,2801,270,17,7087,13,4,5,8,0,0,0,0,0,0,False,False,False,0,2,2020-09-14T12:59:42.73,0,,0.0
2020,1,2801,285,19,7173,13,4,3,5,0,0,0,0,0,0,False,False,False,0,2,2020-09-14T17:44:10.453,0,,0.0
2020,1,2801,320,17,7087,13,2,3,6,0,0,0,0,0,0,False,False,False,0,2,2020-09-14T13:19:34.397,0,,0.0
2020,1,2801,325,17,7024,2,5,5,7,15,8,15,0,15,0,False,False,False,0,3,2020-09-14T13:21:43.967,15,,0.0
2020,1,2801,330,17,7024,2,48,5,-4,-1,3,-3,2,-3,0,False,False,False,0,1,2020-09-14T13:24:51.557,-1,,2.0
2020,1,2801,335,17,6274,2,6,10,8,9,1,9,0,9,0,False,False,False,0,3,2020-09-14T13:27:54.673,9,,0.0
2020,1,2801,345,17,4305,2,13,9,4,7,3,4,3,4,0,True,False,False,2,2,2020-09-17T16:58:58.31,7,,3.0
2020,1,2801,355,17,4752,13,8,4,8,0,0,0,0,0,0,False,False,False,0,3,2021-03-04T21:09:33.147,0,,0.0
2020,1,2801,360,19,1328,2,44,3,1,9,8,7,2,7,0,True,False,False,0,1,2020-09-14T13:46:09.577,9,,2.0
2020,1,2801,370,19,54,2,13,10,1,16,15,16,0,16,0,False,False,False,0,3,2020-09-14T13:48:28.573,16,,0.0
2020,1,2801,385,19,6273,13,2,10,3,0,0,0,0,0,0,False,False,False,0,2,2020-09-14T13:52:45.84,0,,0.0
2020,1,2801,420,19,54,2,2,4,5,10,5,7,3,7,0,False,False,False,0,3,2020-09-14T14:18:09.8,10,,3.0
2020,1,2801,425,19,54,2,35,10,13,16,3,15,1,15,0,False,False,False,0,2,2020-09-17T17:31:37.373,16,,1.0
2020,1,2801,430,19,1328,2,4,9,6,11,5,10,1,10,0,False,False,False,0,1,2020-09-14T14:23:24.067,11,,1.0
2020,1,2801,440,19,54,2,2,9,7,9,2,7,2,7,0,False,False,False,0,3,2021-02-08T23:24:40.293,9,,2.0
2020,1,2801,475,17,7051,2,28,9,0,3,3,0,3,0,0,False,False,False,1,1,2020-09-17T18:45:19.92,3,,3.0
2020,1,2801,480,17,6274,13,29,6,15,0,0,0,0,0,0,False,False,False,0,3,2020-09-14T14:42:02.633,0,,0.0
2020,1,2801,495,19,7173,2,4,10,9,13,4,10,3,10,0,False,False,False,0,3,2020-09-17T16:29:14.39,13,,3.0
2020,1,2801,500,19,8001,2,44,9,-4,4,8,3,1,3,0,False,False,False,0,1,2020-09-14T14:49:45.087,4,,1.0
2020,1,2801,515,19,7173,2,2,10,3,5,2,4,1,4,0,False,False,False,0,2,2020-09-17T15:08:34.017,5,,1.0
2020,1,2801,535,19,7173,2,2,9,5,6,1,5,1,5,0,False,False,False,0,2,2020-09-17T17:04:03.093,6,,1.0
2020,1,2801,545,19,54,13,7,2,17,0,0,0,0,0,0,False,False,False,0,3,2020-09-15T21:13:26.383,0,,
2020,1,2801,550,19,7173,2,30,10,4,9,5,8,1,8,0,False,True,True,0,3,2020-09-14T15:17:11.667,9,False,1.0
2020,1,2801,555,17,4305,2,35,3,14,14,0,14,0,14,0,False,False,False,0,3,2020-09-14T15:22:27.2,14,,0.0
2020,1,2801,560,17,4752,2,4,10,5,5,0,5,0,5,0,False,False,False,0,2,2020-09-17T17:55:19.833,5,,0.0
2020,1,2801,565,17,6274,2,13,4,3,3,0,3,0,3,0,False,False,False,0,3,2020-09-14T15:24:39.603,3,,0.0
2020,1,2801,580,17,7087,13,7,2,23,0,0,0,0,0,0,False,False,False,0,3,2020-09-14T17:48:19.677,0,,
2020,1,2801,585,17,6274,2,7,2,18,18,0,18,0,18,0,False,False,False,0,3,2020-09-14T15:36:19.69,18,,0.0
2020,1,2801,605,17,6274,13,17,10,6,0,0,0,0,0,0,True,False,False,0,4,2020-09-15T23:26:18.55,0,,
2020,1,2801,640,19,54,13,13,10,6,0,0,0,0,0,0,False,False,False,0,3,2020-09-14T16:01:26.247,0,,0.0
2020,1,2801,700,17,4752,2,5,5,5,8,3,8,0,8,0,False,False,False,0,3,2020-09-14T16:29:15.083,8,,0.0
2020,1,2801,705,17,4305,2,13,4,2,4,2,3,1,3,0,False,False,False,0,3,2020-09-14T16:32:09.28,4,,1.0
2020,1,2801,720,17,7087,13,4,6,19,0,0,0,0,0,0,False,False,False,0,2,2020-09-14T16:38:10.383,0,,
2020,1,2801,725,17,4752,3,26,9,5,0,0,0,0,0,0,False,False,False,0,3,2020-09-14T16:42:55.913,0,,0.0
2020,1,2801,740,17,7087,2,6,8,15,21,6,19,2,19,0,False,False,False,0,3,2020-09-14T16:48:19.713,21,,2.0
2020,1,2801,760,17,6274,13,17,10,10,0,0,0,0,0,0,False,False,False,0,3,2020-09-14T16:53:56.057,0,,0.0
2020,1,2802,20,32,3885,13,32,3,-1,0,0,0,0,0,0,False,False,False,0,3,2021-02-18T16:30:46.373,0,,0.0
2020,1,2802,30,24,6373,2,6,9,12,16,4,12,4,12,0,False,False,False,1,4,2020-09-17T16:01:29.743,16,,4.0
2020,1,2802,35,24,967,2,8,8,19,19,0,19,0,19,0,False,False,False,0,2,2020-09-14T10:25:26.483,19,,0.0
2020,1,2802,45,24,894,13,12,10,0,0,0,0,0,0,0,False,False,False,0,4,2020-09-14T15:25:28.813,0,,0.0
2020,1,2802,60,24,6373,2,32,5,3,12,9,7,5,7,0,False,False,False,1,4,2020-09-14T18:32:13.34,12,,5.0
2020,1,2802,65,24,894,2,16,9,5,5,0,5,0,5,6,False,False,False,0,3,2020-09-14T15:31:20.907,5,,0.0
2020,1,2802,80,32,7128,2,4,10,14,16,2,16,0,16,0,False,False,False,0,3,2020-09-14T15:35:33.643,16,,0.0
2020,1,2802,85,32,3885,13,11,5,12,0,0,0,0,0,0,False,False,False,0,1,2021-02-18T16:31:03.4,0,,0.0
2020,1,2802,105,24,6373,3,26,10,7,0,0,0,0,0,0,False,False,False,0,4,2020-09-17T19:05:57.643,0,,0.0
2020,1,2802,120,24,894,2,2,4,4,7,3,5,2,5,0,False,False,False,0,3,2021-01-28T19:35:06.52,7,,2.0
2020,1,2802,140,24,7798,2,23,8,51,55,4,52,3,52,0,False,False,False,0,3,2020-09-17T18:53:15.827,55,,3.0
2020,1,2802,150,24,7799,2,18,3,-2,-2,0,-2,0,-2,0,False,False,False,0,2,2020-09-14T11:21:16.797,-2,,0.0
2020,1,2802,175,32,1791,13,9,2,23,0,0,0,0,0,0,False,False,False,0,3,2020-10-16T20:10:47.337,0,,0.0
2020,1,2802,180,32,3885,13,4,3,9,0,0,0,0,0,0,False,False,False,0,3,2020-09-17T19:06:08.2,0,,0.0
2020,1,2802,190,24,4382,2,51,3,-2,0,2,-2,2,-2,0,False,False,False,0,3,2020-09-17T15:03:08.78,0,,2.0
2020,1,2802,200,24,4382,2,12,3,11,11,0,11,0,11,0,False,False,False,0,3,2021-03-08T16:37:24.2,11,,0.0
2020,1,2802,220,24,6389,2,48,3,-6,7,13,0,7,0,0,False,False,False,1,1,2020-09-17T16:05:59.32,7,,7.0
2020,1,2802,230,32,7807,2,45,5,-5,2,7,-2,4,-2,0,False,False,False,1,1,2020-09-14T11:58:40.17,2,,4.0
2020,1,2802,250,32,7494,2,50,5,-1,14,15,10,4,10,0,False,False,False,0,2,2020-09-17T14:59:12.98,14,,4.0
2020,1,2802,265,32,1427,13,13,9,3,0,0,0,0,0,0,False,False,False,0,3,2020-09-14T12:21:48.71,0,,0.0
2020,1,2802,275,24,894,13,2,9,13,0,0,0,0,0,0,False,False,False,0,4,2020-09-14T12:26:08.31,0,,0.0
2020,1,2802,280,24,7799,3,2,9,12,0,0,0,0,0,0,False,False,False,0,3,2020-09-17T18:34:53.003,0,,0.0
2020,1,2802,295,24,4382,2,4,5,6,10,4,10,0,10,0,False,False,False,0,3,2020-09-17T18:35:01.427,10,,0.0
2020,1,2802,300,24,6373,2,17,6,28,34,6,34,0,34,6,False,False,False,0,3,2020-09-17T18:53:15.827,34,,0.0
2020,1,2802,320,32,7128,13,7,6,25,0,0,0,0,0,0,False,False,False,0,2,2020-09-14T12:49:53.343,0,,0.0
2020,1,2802,330,32,1427,13,4,8,16,0,0,0,0,0,0,False,False,False,0,3,2020-09-17T18:35:11.19,0,,0.0
2020,1,2802,345,24,6373,2,53,10,-4,-4,0,-5,1,-5,0,False,False,False,0,4,2021-02-08T21:55:44.13,-4,,1.0
2020,1,2802,350,24,6389,2,32,5,-3,12,15,6,6,6,0,False,False,False,1,1,2020-09-17T18:35:20.787,12,,6.0
2020,1,2802,375,32,1791,13,6,8,16,0,0,0,0,0,0,False,False,False,0,2,2020-09-14T13:16:30.51,0,,0.0
2020,1,2802,385,24,7798,13,5,6,17,0,0,0,0,0,0,False,False,False,0,2,2021-03-04T21:15:18.847,0,,0.0
2020,1,2802,390,32,7128,2,2,10,7,21,14,11,10,11,0,False,False,False,1,2,2020-09-14T13:25:38.44,21,,10.0
2020,1,2802,395,32,1791,2,2,10,8,11,3,9,2,9,0,False,False,False,0,2,2020-09-14T18:34:23.043,11,,2.0
2020,1,2802,410,32,7128,2,4,9,6,7,1,7,0,7,0,False,False,False,0,3,2020-09-14T13:31:45.647,7,,0.0
2020,1,2802,420,32,1427,2,7,3,6,6,0,6,0,6,6,False,False,False,0,3,2020-09-17T18:35:31.287,6,,0.0
2020,1,2802,435,24,967,13,4,3,14,0,0,0,0,0,0,True,False,False,0,2,2020-09-15T17:16:50.163,0,,0.0
2020,1,2802,440,24,7798,13,8,7,50,0,0,0,0,0,0,False,False,False,0,2,2020-09-17T18:35:43.65,0,,0.0
2020,1,2802,445,24,967,13,8,2,54,0,0,0,0,0,0,False,False,False,0,2,2021-02-08T21:56:22.05,0,,0.0
2020,1,2802,475,24,7799,13,2,9,14,0,0,0,0,0,0,False,False,False,0,3,2021-02-08T21:59:22.61,0,,0.0
2020,1,2802,490,32,7128,13,35,10,12,0,0,0,0,0,0,False,False,False,0,2,2020-09-14T15:45:09.483,0,,0.0
2020,1,2802,495,32,7807,2,44,3,-3,6,9,6,0,6,0,False,False,False,0,1,2020-09-17T15:58:04.077,6,,0.0
2020,1,2802,510,24,7799,13,4,9,7,0,0,0,0,0,0,False,False,False,0,2,2021-03-04T21:15:45.82,0,,0.0
2020,1,2802,515,32,3885,2,50,3,1,1,0,1,0,1,0,True,False,False,0,2,2020-09-15T21:50:58.93,1,,0.0
2020,1,2802,520,32,7494,2,17,8,17,17,0,17,0,17,0,False,False,False,0,3,2020-09-17T16:31:14.763,17,,0.0
2020,1,2802,560,24,6373,2,39,10,4,23,19,11,12,11,0,False,False,False,1,3,2020-09-14T16:08:15.293,23,,12.0
2020,1,2802,565,24,6373,2,51,9,-4,6,10,3,3,3,0,False,False,False,0,3,2020-09-17T15:04:00.14,6,,3.0
2020,1,2802,580,24,894,13,23,8,25,0,0,0,0,0,0,False,False,False,0,4,2020-09-14T18:48:49.41,0,,0.0
2020,1,2802,610,32,1791,13,3,2,16,0,0,0,0,0,0,False,False,False,0,2,2020-09-21T20:41:16.35,0,,0.0
2020,1,2802,625,24,967,13,35,6,20,0,0,0,0,0,0,False,False,False,0,3,2020-09-17T18:53:15.827,0,,0.0
2020,1,2802,630,24,4382,2,51,5,-3,3,6,3,0,3,0,False,False,False,0,3,2020-09-15T13:05:51.557,3,,0.0
2020,1,2802,635,24,4382,13,17,5,9,0,0,0,0,0,0,False,False,False,0,3,2021-03-04T21:16:30.643,0,,
2020,1,2802,645,24,967,2,5,6,20,27,7,27,0,27,0,False,False,False,0,2,2020-09-17T14:03:08.117,27,,0.0
2020,1,2802,650,24,894,2,39,9,4,6,2,6,0,6,0,False,False,False,0,3,2020-09-14T16:45:38.533,6,,0.0
2020,1,2802,655,24,7798,13,6,1,24,0,0,0,0,0,0,False,False,False,0,2,2020-09-17T14:03:16.763,0,,0.0
2020,1,2802,660,24,4382,13,6,7,15,0,0,0,0,0,0,False,False,False,0,3,2020-09-17T18:53:15.827,0,,0.0
2020,1,2802,670,32,1427,2,35,9,14,19,5,18,1,18,0,False,False,False,0,4,2021-02-08T22:01:01.12,19,,1.0
2020,1,2802,675,32,1427,2,53,9,-3,4,7,1,3,1,0,False,False,False,0,4,2020-09-15T13:03:20.603,4,,3.0
2020,1,2802,690,32,3885,13,16,9,3,0,0,0,0,0,0,False,False,False,0,1,2020-09-17T18:36:08.223,0,,0.0
2020,1,2802,710,24,4385,2,48,10,-9,-6,3,-7,1,-7,0,False,False,False,0,1,2020-09-14T17:06:27.773,-6,,1.0
2020,1,2802,715,24,967,13,8,8,54,0,0,0,0,0,0,False,False,False,0,3,2021-03-01T22:21:41.777,0,,0.0
2020,1,2802,725,32,7128,2,50,5,-1,3,4,2,1,2,0,False,False,False,0,2,2020-09-15T13:03:33.477,3,,1.0
2020,1,2802,735,32,1427,2,4,9,6,8,2,8,0,8,0,False,False,False,0,3,2021-02-08T22:01:59.733,8,,0.0
2020,1,2802,740,32,7128,2,4,9,4,14,10,9,5,9,0,False,False,False,0,2,2020-09-14T17:20:17.947,14,,5.0
2020,1,2802,750,32,1427,13,8,7,23,0,0,0,0,0,0,False,False,False,0,4,2020-09-17T15:01:56.547,0,,0.0
2020,1,2802,755,32,1791,2,2,9,6,10,4,10,0,10,0,False,False,False,0,2,2020-09-17T16:32:00.347,10,,0.0
2020,1,2802,805,24,6373,2,17,10,6,10,4,8,2,8,0,False,False,False,0,4,2020-09-14T17:36:18.49,10,,2.0
2020,1,2802,815,24,6373,2,5,5,3,4,1,3,1,3,0,False,False,False,0,4,2020-09-14T17:38:36.673,4,,1.0
2020,1,2802,820,24,967,13,9,6,29,0,0,0,0,0,0,False,False,False,0,3,2020-09-14T17:40:05.09,0,,0.0
2020,1,2802,825,24,894,3,6,9,10,0,0,0,0,0,0,False,False,False,0,3,2020-09-14T17:41:26.85,0,,0.0
2020,1,2802,830,32,7494,2,30,5,-1,19,20,19,0,19,0,False,False,False,0,4,2020-09-14T17:44:28.793,19,,0.0
2020,1,2802,850,32,1427,13,39,10,7,0,0,0,0,0,0,False,False,False,0,3,2021-02-08T22:05:23.42,0,,0.0
2020,1,2802,935,24,4382,2,47,5,6,7,1,7,0,7,0,False,False,False,0,3,2020-09-17T18:53:15.827,7,,0.0
2020,1,2802,940,24,4385,2,46,9,3,8,5,5,3,5,0,False,False,False,0,1,2020-09-16T16:39:08.103,8,,3.0
2020,1,2802,945,24,4382,3,46,3,4,0,0,0,0,0,0,False,False,False,0,3,2020-09-16T16:39:21.66,0,,0.0
2020,1,2803,10,7,4679,2,51,10,-6,2,8,0,2,0,0,False,False,False,0,1,2020-09-17T18:48:07.983,2,,2.0
2020,1,2803,20,7,3445,13,5,5,12,0,0,0,0,0,0,False,False,False,0,2,2020-09-17T13:51:01.837,0,,0.0
2020,1,2803,30,26,309,13,2,9,9,0,0,0,0,0,0,True,False,False,0,3,2020-09-16T02:07:56.817,0,,0.0
2020,1,2803,40,26,309,2,4,3,5,10,5,8,2,8,0,False,False,False,0,3,2020-09-14T10:31:30.167,10,,2.0
2020,1,2803,50,26,4619,13,19,6,23,0,0,0,0,0,0,False,False,False,0,2,2020-09-14T10:38:39.713,0,,0.0
2020,1,2803,55,26,4619,13,9,6,16,0,0,0,0,0,0,True,False,False,0,2,2020-09-16T02:08:35.793,0,,0.0
2020,1,2803,65,7,910,2,2,10,10,11,1,11,0,11,0,False,False,False,0,3,2020-09-17T18:25:07.933,11,,0.0
2020,1,2803,70,7,6975,2,53,10,-1,7,8,4,3,4,0,False,False,False,0,4,2020-09-14T15:00:34.45,7,,3.0
2020,1,2803,85,7,910,2,4,5,4,4,0,4,0,4,0,False,False,False,0,2,2020-09-14T10:55:33.12,4,,0.0
2020,1,2803,90,7,4674,2,50,3,-2,2,4,-3,5,-3,0,False,False,False,1,2,2020-09-14T10:57:49.517,2,,5.0
2020,1,2803,105,26,4282,2,46,3,1,4,3,4,0,4,0,True,False,False,0,4,2020-09-17T15:22:12.467,4,,0.0
2020,1,2803,110,26,309,13,21,6,25,0,0,0,0,0,0,True,False,False,0,3,2020-09-14T11:20:52.993,0,,0.0
2020,1,2803,120,7,4679,13,32,5,-2,0,0,0,0,0,0,False,False,False,0,3,2020-09-17T16:07:16.15,0,,0.0
2020,1,2803,155,26,4619,13,4,10,10,0,0,0,0,0,0,False,False,False,0,2,2021-02-03T18:06:51.513,0,,0.0
2020,1,2803,165,7,4674,13,5,5,4,0,0,0,0,0,0,False,False,False,0,3,2020-09-17T15:50:16.48,0,,0.0
2020,1,2803,180,7,910,2,2,10,6,13,7,10,3,10,0,False,False,False,0,2,2020-09-14T12:06:46.787,13,,3.0
2020,1,2803,185,7,2631,13,17,1,23,0,0,0,0,0,0,False,False,False,0,4,2020-09-14T12:08:11.457,0,,0.0
2020,1,2803,210,26,309,2,30,10,1,13,12,10,3,10,0,False,False,False,0,3,2020-09-14T12:19:24.413,13,,3.0
2020,1,2803,215,26,4282,13,35,6,20,0,0,0,0,0,0,False,False,False,0,3,2020-09-17T15:50:57.607,0,,0.0
2020,1,2803,220,26,4619,2,5,2,15,15,0,15,0,15,0,False,False,False,0,2,2020-09-14T18:14:03.943,15,,0.0
2020,1,2803,235,26,4282,2,13,10,6,7,1,6,1,6,0,False,False,False,0,3,2020-09-17T17:07:11.19,7,,1.0
2020,1,2803,260,7,931,2,47,5,0,6,6,5,1,5,0,False,False,False,0,1,2020-09-14T15:01:19.127,6,,1.0
2020,1,2803,305,26,4282,2,53,9,-2,7,9,3,4,3,0,False,False,False,0,4,2021-02-05T18:35:33.787,7,,4.0
2020,1,2803,320,26,1900,3,13,4,4,0,0,0,0,0,0,False,False,False,0,4,2020-09-14T13:04:11.973,0,,0.0
2020,1,2803,325,26,4619,2,19,2,33,37,4,34,3,34,0,False,False,False,0,2,2020-09-14T13:05:44.687,37,,3.0
2020,1,2803,330,26,4282,13,11,5,9,0,0,0,0,0,0,False,False,False,0,4,2020-09-14T18:11:33.327,0,,
2020,1,2803,335,26,309,13,12,2,19,0,0,0,0,0,0,False,False,False,0,3,2020-09-14T13:13:11.94,0,,0.0
2020,1,2803,345,26,4282,13,35,9,6,0,0,0,0,0,0,False,False,False,0,3,2020-09-14T13:16:33.893,0,,0.0
2020,1,2803,385,26,4282,2,35,3,13,22,9,19,3,19,0,False,False,False,0,4,2021-03-05T17:37:45.937,22,,3.0
2020,1,2803,400,26,4619,13,19,2,27,0,0,0,0,0,0,False,False,False,0,3,2020-09-14T18:10:23.097,0,,
2020,1,2803,435,7,931,2,48,10,-3,1,4,-2,3,-2,0,False,False,False,0,1,2020-09-17T16:53:19.2,1,,3.0
2020,1,2803,440,7,2631,2,32,5,2,5,3,5,0,5,0,False,False,False,0,4,2020-09-17T16:57:37.333,5,,0.0
2020,1,2803,445,7,910,13,2,10,10,0,0,0,0,0,0,False,False,False,0,2,2020-09-14T13:52:50.453,0,,0.0
2020,1,2803,465,26,4619,2,4,3,10,10,0,10,0,10,0,False,False,False,0,2,2020-09-17T16:58:42.983,10,,0.0
2020,1,2803,470,26,4282,2,7,6,19,33,14,33,0,33,0,False,False,False,0,3,2020-09-14T13:59:19.703,33,,0.0
2020,1,2803,535,26,309,13,7,2,17,0,0,0,0,0,0,True,False,False,0,3,2020-09-14T14:44:16.377,0,,0.0
2020,1,2803,545,26,4619,2,2,9,3,7,4,3,4,3,0,False,False,False,0,2,2020-09-14T14:46:02.727,7,,4.0
2020,1,2803,565,7,910,2,4,5,4,9,5,4,5,4,0,False,False,False,1,2,2020-09-17T16:13:22.617,9,,5.0
2020,1,2803,570,7,4674,13,19,2,35,0,0,0,0,0,0,False,False,False,0,2,2020-09-14T14:54:49.55,0,,0.0
2020,1,2803,575,7,931,2,50,5,0,4,4,1,3,1,0,False,False,False,0,2,2020-09-14T14:56:51.847,4,,3.0
2020,1,2803,580,7,910,13,17,8,31,0,0,0,0,0,0,False,False,False,0,3,2020-09-14T14:58:40.297,0,,0.0
2020,1,2803,605,26,4619,13,19,2,30,0,0,0,0,0,0,True,False,False,0,2,2020-09-14T15:12:48.893,0,,0.0
2020,1,2803,625,7,3521,2,4,9,11,11,0,11,0,11,0,False,False,False,0,3,2020-09-14T15:20:53.263,11,,0.0
2020,1,2803,645,7,910,2,4,9,12,14,2,14,0,14,0,False,False,False,0,2,2020-09-14T15:27:02.13,14,,0.0
2020,1,2803,665,7,910,13,19,2,25,0,0,0,0,0,0,False,False,False,0,2,2020-09-14T15:33:15.17,0,,0.0
2020,1,2803,680,26,4616,2,44,3,-5,3,8,3,0,3,0,False,False,False,0,1,2020-09-14T15:36:51.41,3,,0.0
2020,1,2803,690,26,7453,2,12,5,14,16,2,16,0,16,0,False,False,False,0,3,2020-09-14T15:40:58.873,16,,0.0
2020,1,2803,710,26,309,2,4,9,5,6,1,5,1,5,0,False,False,False,0,3,2020-09-14T15:57:26.903,6,,1.0
2020,1,2803,745,7,3521,13,4,3,7,0,0,0,0,0,0,False,False,False,0,2,2020-09-14T16:06:46,0,,0.0
2020,1,2803,760,26,309,2,46,3,3,8,5,5,3,5,0,True,False,False,0,3,2020-09-17T14:40:30.84,8,,3.0
2020,1,2803,785,26,4619,13,9,3,3,0,0,0,0,0,0,False,False,False,0,2,2020-09-17T15:23:01.017,0,,0.0
2020,1,2803,790,26,4282,13,7,3,3,0,0,0,0,0,0,False,False,False,0,3,2020-09-17T14:40:30.84,0,,0.0
2020,1,2803,830,7,2631,2,6,10,8,15,7,12,3,12,0,False,False,False,0,2,2020-09-14T16:38:06.42,15,,3.0
2020,1,2803,835,7,2631,2,13,3,9,19,10,17,2,17,0,False,False,False,0,4,2020-09-14T16:40:17.073,19,,2.0
2020,1,2803,840,7,931,13,48,3,-1,0,0,0,0,0,0,False,False,False,0,1,2020-09-14T16:43:55.177,0,,0.0
2020,1,2803,850,26,309,2,30,5,0,1,1,1,0,1,0,True,False,False,0,4,2020-09-14T16:48:19.737,1,,
2020,1,2803,855,26,1900,2,4,10,5,10,5,7,3,7,0,False,False,False,0,4,2020-09-17T17:03:15.61,10,,3.0
2020,1,2803,875,7,3521,2,42,4,4,4,0,4,0,4,0,False,False,False,0,3,2020-09-14T17:09:30.78,4,,0.0
2020,1,2803,880,7,3521,2,26,5,4,8,4,7,1,7,0,False,False,False,0,3,2020-09-14T17:11:25.757,8,,1.0
2020,1,2803,885,7,4674,2,6,8,15,15,0,15,0,15,0,False,False,False,0,3,2020-09-17T18:27:18.957,15,,0.0
2020,1,2803,905,7,4674,3,5,5,9,0,0,0,0,0,0,False,False,False,0,3,2020-09-14T17:31:19.723,0,,0.0
2020,1,2803,910,7,3521,2,4,9,8,10,2,9,1,9,0,False,False,False,0,3,2020-09-14T17:28:33.913,10,,1.0
2020,1,2803,915,7,910,13,9,2,25,0,0,0,0,0,0,False,False,False,0,2,2020-09-14T17:30:41.077,0,,0.0
2020,1,2803,920,7,3445,2,5,10,12,12,0,12,0,12,0,False,False,False,0,3,2020-09-14T17:32:41.947,12,,0.0
2020,1,2803,925,7,3445,2,4,5,5,5,0,5,0,5,0,False,False,False,0,2,2020-09-14T17:34:16.04,5,,0.0
2020,1,2803,930,7,2631,2,5,5,4,6,2,4,2,4,0,False,False,False,0,3,2020-09-17T16:01:53.727,6,,2.0
2020,1,2803,945,7,931,2,47,5,1,10,9,8,2,8,0,False,False,False,0,1,2020-09-14T17:39:04.123,10,,2.0
2020,1,2803,950,7,910,2,3,5,3,3,0,3,0,3,6,False,False,False,0,2,2020-09-14T18:20:42.863,3,,
2020,1,2804,10,20,4535,2,30,10,-1,14,15,12,2,12,0,True,False,False,0,4,2020-09-17T15:51:14.77,14,,2.0
2020,1,2804,20,20,5140,2,44,3,-6,-2,4,-2,0,-2,0,True,False,False,0,3,2020-09-14T13:29:21.193,-2,,0.0
2020,1,2804,25,20,958,2,39,10,3,5,2,5,0,5,0,False,False,False,0,4,2021-03-09T15:22:09.233,5,,0.0
2020,1,2804,40,30,4523,13,17,9,6,0,0,0,0,0,0,True,False,False,0,3,2020-09-14T13:36:33.457,0,,
2020,1,2804,45,30,4516,2,22,2,27,29,2,29,0,29,0,True,False,False,0,3,2020-09-17T15:19:29.37,29,,0.0
2020,1,2804,55,30,6414,2,48,3,-2,8,10,6,2,6,0,False,False,False,0,1,2020-09-14T14:05:01.613,8,,2.0
2020,1,2804,60,30,793,13,9,6,24,0,0,0,0,0,0,False,False,False,0,3,2020-09-17T14:19:00.69,0,,
2020,1,2804,110,20,5140,2,51,9,-5,5,10,5,0,5,0,False,False,False,0,1,2020-09-15T23:30:44.677,5,,0.0
2020,1,2804,120,20,958,2,51,5,1,1,0,1,0,1,0,False,False,False,0,3,2020-09-17T15:15:09.623,1,,0.0
2020,1,2804,140,30,7268,2,6,9,6,8,2,7,1,7,0,False,False,False,0,2,2020-09-14T15:03:35.89,8,,1.0
2020,1,2804,150,20,3763,2,13,10,4,4,0,4,0,4,0,False,False,False,0,3,2020-09-14T15:05:48.217,4,,0.0
2020,1,2804,155,20,5140,2,32,9,-4,-2,2,-2,0,-2,0,True,False,False,0,1,2020-09-14T15:07:57.693,-2,,0.0
2020,1,2804,160,20,958,2,7,2,16,18,2,18,0,18,0,False,False,False,0,3,2020-09-14T15:09:40.187,18,,0.0
2020,1,2804,185,20,1162,13,5,5,12,0,0,0,0,0,0,False,False,False,0,4,2020-09-14T19:57:53.05,0,,0.0
2020,1,2804,190,20,958,2,4,9,6,10,4,8,2,8,0,False,False,False,0,3,2021-03-09T15:23:35.61,10,,2.0
2020,1,2804,205,20,5140,2,48,9,-4,12,16,12,0,12,6,False,False,False,0,1,2021-03-09T15:24:21.29,12,,0.0
2020,1,2804,225,30,793,13,17,7,26,0,0,0,0,0,0,False,False,False,0,3,2021-03-04T21:28:52.88,0,,0.0
2020,1,2804,235,20,3763,13,5,3,13,0,0,0,0,0,0,False,False,False,0,2,2020-09-14T15:47:18.613,0,,0.0
2020,1,2804,240,20,213,13,17,1,34,0,0,0,0,0,0,False,False,False,0,3,2020-09-15T23:33:30.603,0,,
2020,1,2804,260,30,6419,2,6,10,5,6,1,5,1,5,0,False,False,False,0,2,2020-09-14T15:59:51.417,6,,1.0
2020,1,2804,280,30,4516,2,5,5,5,7,2,6,1,6,0,False,False,False,0,3,2020-09-14T16:19:01.75,7,,1.0
2020,1,2804,290,30,63,2,53,5,-5,2,7,0,2,0,0,False,False,False,0,4,2021-03-09T15:27:32.707,2,,2.0
2020,1,2804,305,30,2290,13,13,9,7,0,0,0,0,0,0,False,False,False,0,2,2020-09-14T16:28:15.96,0,,0.0
2020,1,2804,325,20,5140,13,11,5,6,0,0,0,0,0,0,False,False,False,0,1,2020-09-14T16:32:51.153,0,,0.0
2020,1,2804,330,20,6388,2,3,3,5,4,-1,4,0,4,0,False,False,False,0,2,2020-09-14T16:34:31.153,4,,0.0
2020,1,2804,345,20,7353,2,50,3,-7,17,24,2,15,2,0,True,False,False,1,3,2021-03-09T15:29:35.347,17,,15.0
2020,1,2804,360,20,958,3,2,3,5,0,0,0,0,0,0,False,False,False,0,2,2021-03-09T15:33:03.677,0,,0.0
2020,1,2804,365,20,3763,2,2,10,5,8,3,7,1,7,0,False,False,False,0,3,2020-09-14T16:42:00.07,8,,1.0
2020,1,2804,370,20,213,13,17,9,12,0,0,0,0,0,0,False,False,False,0,3,2020-09-14T16:43:21.853,0,,0.0
2020,1,2804,375,20,5140,13,48,5,-7,0,0,0,0,0,0,False,False,False,0,1,2021-03-09T15:40:54.93,0,,0.0
2020,1,2804,400,30,7268,2,3,5,10,10,0,10,0,10,0,False,False,False,0,2,2020-09-14T17:10:12.87,10,,0.0
2020,1,2804,415,30,4516,2,50,9,-4,6,10,5,1,5,0,False,False,False,0,3,2020-09-14T17:13:32.833,6,,1.0
2020,1,2804,420,30,4516,13,12,7,17,0,0,0,0,0,0,False,False,False,0,3,2020-09-14T17:15:13.043,0,,0.0
2020,1,2804,450,30,6414,13,46,3,3,0,0,0,0,0,0,False,False,False,0,3,2020-10-16T20:16:09.67,0,,0.0
2020,1,2804,455,30,6414,2,46,3,2,18,16,14,4,14,0,False,False,False,0,3,2020-09-14T19:51:45.893,8,,4.0
2020,1,2804,460,30,4937,2,6,4,1,14,13,7,7,7,0,False,False,False,1,1,2020-09-14T17:23:29.227,14,,7.0
2020,1,2804,475,30,6419,13,5,5,4,0,0,0,0,0,0,False,False,False,0,3,2021-03-04T21:29:50.387,0,,0.0
2020,1,2804,490,30,793,13,19,6,40,0,0,0,0,0,0,False,False,False,0,2,2021-02-08T22:57:58.527,0,,
2020,1,2804,500,30,4523,2,35,3,9,9,0,9,0,9,6,False,False,False,0,4,2020-09-14T17:35:50.413,9,,0.0
2020,1,2804,530,20,213,13,3,6,17,0,0,0,0,0,0,False,False,False,0,3,2021-03-04T21:30:12.413,0,,
2020,1,2804,535,20,3763,13,11,6,17,0,0,0,0,0,0,False,False,False,0,3,2020-09-15T23:34:37.76,0,,0.0
2020,1,2804,560,30,7268,2,4,5,6,12,6,5,7,5,0,False,False,False,1,2,2020-09-14T17:49:23.92,12,,7.0
2020,1,2804,575,30,7268,13,4,9,5,0,0,0,0,0,0,True,False,False,0,2,2021-03-09T15:48:08.19,0,,0.0
2020,1,2804,580,30,793,13,5,2,15,0,0,0,0,0,0,False,False,False,0,2,2020-09-14T19:58:07.427,0,,0.0
2020,1,2804,600,20,958,13,12,4,10,0,0,0,0,0,0,False,False,False,0,3,2020-09-14T18:00:12.287,0,,0.0
2020,1,2804,615,30,63,2,47,5,-1,9,10,8,1,8,0,False,False,False,0,4,2021-03-09T15:50:57.2,9,,1.0
2020,1,2804,620,30,4516,2,33,4,12,23,11,18,5,18,0,True,False,False,0,4,2020-09-15T17:29:13.77,23,,5.0
2020,1,2804,625,30,7268,2,51,3,-3,6,9,6,0,6,0,True,False,False,0,3,2021-03-09T15:52:04.3,6,,0.0
2020,1,2804,630,30,7268,13,21,2,28,0,0,0,0,0,0,False,False,False,0,3,2020-09-14T19:57:36.213,0,,
2020,1,2804,690,30,63,13,17,1,27,0,0,0,0,0,0,False,False,False,0,4,2021-03-10T17:34:24.153,0,,0.0
2020,1,2804,705,20,5140,13,51,10,-5,0,0,0,0,0,0,True,False,False,0,1,2020-09-14T18:36:16.817,0,,0.0
2020,1,2804,710,20,958,2,19,6,35,46,11,46,0,46,0,False,False,False,0,2,2021-02-08T23:01:35.657,46,,0.0
2020,1,2804,720,20,306,13,12,5,-2,0,0,0,0,0,0,False,False,False,0,1,2021-03-09T15:53:26.36,0,,0.0
2020,1,2804,725,20,213,2,13,10,3,6,3,6,0,6,0,True,False,False,0,3,2020-09-14T18:43:54.683,6,,0.0
2020,1,2804,730,20,213,2,30,5,0,5,5,0,5,0,6,True,False,False,1,3,2020-09-17T16:38:35.13,5,,5.0
2020,1,2804,750,20,3763,2,2,10,5,5,0,5,0,5,0,False,False,False,0,2,2020-09-14T18:51:08.61,5,,0.0
2020,1,2804,770,20,213,13,35,5,3,0,0,0,0,0,0,False,False,False,0,3,2020-09-14T18:57:08.17,0,,0.0
2020,1,2804,785,30,4523,13,4,10,10,0,0,0,0,0,0,False,False,False,0,3,2021-03-09T15:55:20.077,0,,0.0
2020,1,2804,790,30,793,13,2,9,3,0,0,0,0,0,0,False,False,False,0,2,2020-09-14T19:00:42.47,0,,0.0
2020,1,2804,795,30,4523,13,24,6,22,0,0,0,0,0,0,False,False,False,0,4,2020-09-14T19:02:33.187,0,,0.0
2020,1,2804,815,20,213,2,13,9,3,4,1,4,0,4,0,False,False,False,0,3,2021-03-09T15:56:41.703,4,,0.0
2020,1,2804,830,30,4523,2,12,10,9,9,0,9,0,9,0,False,False,False,0,4,2021-03-08T16:41:12.72,9,,0.0
2020,1,2804,835,30,4523,2,17,1,15,15,0,15,0,15,0,False,False,False,0,4,2020-09-14T19:58:20.247,15,,0.0
2020,1,2804,845,30,4516,2,5,3,5,5,0,5,0,5,0,False,False,False,0,3,2020-09-14T19:15:38.007,5,,0.0
2020,1,2804,855,30,7268,2,19,7,35,37,2,36,1,36,0,False,False,False,0,2,2020-09-14T19:22:05.437,37,,1.0
2020,1,2804,860,30,119,2,5,9,3,2,-1,2,0,2,0,False,False,False,0,1,2021-02-08T23:04:18.013,2,,0.0
2020,1,2804,870,30,4523,2,46,3,3,3,0,3,0,3,0,False,False,False,0,3,2020-09-17T15:49:19.193,3,,0.0
2020,1,2804,875,30,4516,2,4,10,9,9,0,9,0,9,0,True,False,False,0,3,2021-03-09T15:58:21.82,9,,0.0
2020,1,2804,880,30,793,2,7,3,2,2,0,2,0,2,6,False,False,False,0,2,2020-09-15T17:30:13.81,2,,0.0
2020,1,2804,905,20,5140,2,11,2,21,38,17,36,2,36,0,False,False,False,0,1,2021-02-08T23:07:01.97,38,,2.0
2020,1,2805,10,28,4922,2,5,5,5,5,0,5,0,5,0,False,False,False,0,4,2020-09-14T10:28:03.743,5,,0.0
2020,1,2805,30,28,4922,2,39,4,10,11,1,10,1,10,0,True,False,False,0,3,2020-09-17T15:33:08.293,11,,1.0
2020,1,2805,45,1,245,2,5,3,3,3,0,3,0,3,0,False,False,False,0,3,2021-02-15T21:06:33.537,3,,0.0
2020,1,2805,50,1,525,2,4,9,7,7,0,7,0,7,0,False,False,False,0,3,2020-09-14T19:52:02.453,7,,0.0
2020,1,2805,60,1,525,13,4,10,4,0,0,0,0,0,0,False,False,False,0,3,2020-09-14T11:00:53.31,0,,0.0
2020,1,2805,65,1,525,2,53,10,-1,10,11,8,2,8,0,False,False,False,0,4,2020-09-14T19:22:29.07,10,,2.0
2020,1,2805,75,28,3264,2,16,9,5,76,71,76,0,76,6,False,False,False,0,1,2020-09-14T11:11:54.503,76,,0.0
2020,1,2805,90,1,245,2,51,9,-4,1,5,1,0,1,0,False,False,False,0,3,2020-09-17T15:01:08.56,1,,0.0
2020,1,2805,95,1,4307,2,51,5,-6,2,8,1,1,1,0,False,False,False,0,1,2021-02-08T22:10:36.48,2,,1.0
2020,1,2805,100,1,6405,13,9,2,22,0,0,0,0,0,0,False,False,False,0,3,2020-09-17T15:31:49.063,0,,0.0
2020,1,2805,110,28,3264,2,5,5,1,5,4,3,2,3,0,False,False,False,0,1,2021-02-08T22:12:11.533,5,,2.0
2020,1,2805,120,28,4932,13,5,5,5,0,0,0,0,0,0,False,False,False,0,3,2020-09-14T11:42:38.547,0,,0.0
2020,1,2805,130,1,6406,2,30,10,-1,10,11,7,3,7,6,False,False,False,0,1,2021-02-15T21:23:10.447,10,,3.0
2020,1,2805,150,28,4922,2,8,4,12,14,2,10,4,10,0,True,False,False,0,3,2020-09-17T15:47:52.2,14,,4.0
2020,1,2805,155,28,797,13,11,6,23,0,0,0,0,0,0,False,False,False,0,1,2020-09-14T12:03:16.213,0,,0.0
2020,1,2805,170,1,6405,13,12,2,27,0,0,0,0,0,0,False,False,False,0,2,2021-02-15T21:28:51.19,0,,0.0
2020,1,2805,175,1,525,2,51,9,-2,13,15,11,2,11,0,False,False,False,0,2,2021-02-15T21:30:48.41,8,,2.0
2020,1,2805,200,28,4922,2,13,9,2,14,12,11,3,11,0,True,False,False,0,4,2020-09-14T12:29:13.227,14,,3.0
2020,1,2805,205,28,969,2,6,9,3,10,7,5,5,5,0,False,False,False,0,3,2021-02-08T22:14:42.727,10,,5.0
2020,1,2805,255,1,245,13,18,3,-1,0,0,0,0,0,0,False,False,False,0,2,2021-03-02T13:24:54.187,0,,0.0
2020,1,2805,260,1,245,2,4,3,6,6,0,6,0,6,0,False,False,False,0,2,2020-09-14T12:55:33.99,6,,0.0
2020,1,2805,270,1,2416,13,46,9,2,0,0,0,0,0,0,True,False,False,0,1,2021-02-08T22:15:57.537,0,,0.0
2020,1,2805,275,1,525,2,6,4,7,9,2,7,2,7,0,False,False,False,0,3,2020-09-14T20:26:59.57,9,,2.0
2020,1,2805,280,1,245,2,50,3,-2,12,14,-1,13,-1,0,False,False,False,1,2,2021-03-04T13:12:18.71,12,,13.0
2020,1,2805,290,1,245,2,5,6,15,15,0,15,0,15,0,False,False,False,0,2,2020-09-14T13:19:38.467,15,,0.0
2020,1,2805,300,1,6406,2,5,3,4,5,1,4,1,4,0,False,False,False,0,3,2021-02-16T20:29:06.863,5,,1.0
2020,1,2805,305,1,6406,13,5,9,1,0,0,0,0,0,0,True,False,False,0,3,2020-09-14T19:56:32.72,0,,0.0
2020,1,2805,320,28,4912,2,26,10,9,18,9,15,3,15,0,True,False,False,0,3,2020-09-17T14:47:03.19,18,,3.0
2020,1,2805,325,28,6365,13,8,8,34,0,0,0,0,0,0,False,False,False,0,3,2020-09-17T14:47:10.74,0,,0.0
2020,1,2805,335,28,797,3,5,9,4,0,0,0,0,0,0,False,False,False,0,1,2020-09-14T20:00:36.13,0,,0.0
2020,1,2805,360,1,5152,2,26,9,8,13,5,11,2,11,0,False,False,False,0,4,2020-09-14T14:07:51.663,13,,2.0
2020,1,2805,370,1,2416,13,17,9,5,0,0,0,0,0,0,False,False,False,0,4,2021-03-04T21:40:27.333,0,,0.0
2020,1,2805,385,28,797,2,51,5,-1,9,10,8,1,8,0,True,False,False,0,1,2020-09-17T16:19:50.543,9,,1.0
2020,1,2805,390,28,797,2,2,10,5,6,1,5,1,5,0,True,False,False,0,3,2020-09-15T20:25:26.647,6,,1.0
2020,1,2805,395,28,4922,3,49,3,-2,0,0,0,0,0,0,False,False,False,0,2,2021-02-16T20:37:16.767,0,,0.0
2020,1,2805,400,28,4932,2,26,9,2,2,0,2,0,2,0,False,False,False,0,3,2021-02-16T22:00:11.363,2,,0.0
2020,1,2805,425,1,245,2,4,3,12,12,0,12,0,12,0,False,False,False,0,2,2020-09-14T14:33:38.267,12,,0.0
2020,1,2805,445,1,245,2,4,9,3,5,2,5,0,5,0,False,False,False,0,3,2020-09-14T14:37:52.763,5,,0.0
2020,1,2805,475,1,4307,2,46,3,2,3,1,3,0,3,0,False,False,False,0,1,2020-09-14T18:49:36.82,3,,0.0
2020,1,2805,480,1,245,2,5,5,9,9,0,9,0,9,0,False,False,False,0,2,2021-02-16T22:01:05.44,9,,0.0
2020,1,2805,485,1,245,2,3,3,13,12,-1,12,0,12,0,False,False,False,0,2,2020-09-14T20:05:18.54,12,,0.0
2020,1,2805,525,1,6405,13,3,5,10,0,0,0,0,0,0,False,False,False,0,2,2020-09-17T14:20:03.93,0,,0.0
2020,1,2805,545,28,4912,13,8,4,13,0,0,0,0,0,0,False,False,False,0,2,2020-09-14T15:32:23.72,0,,0.0
2020,1,2805,575,1,5152,2,18,3,0,8,8,7,1,7,0,False,True,False,0,2,2021-03-08T16:14:53.82,8,,1.0
2020,1,2805,580,1,245,13,29,6,17,0,0,0,0,0,0,False,False,False,0,3,2021-03-17T18:53:25.99,0,,0.0
2020,1,2805,610,28,4912,2,8,4,12,16,4,13,3,13,0,False,False,False,0,3,2020-10-16T20:22:09.293,16,,3.0
2020,1,2805,625,28,743,13,13,10,0,0,0,0,0,0,0,False,False,False,0,3,2020-09-14T16:12:00.347,0,,0.0
2020,1,2805,635,1,6406,13,48,9,-1,0,0,0,0,0,0,False,False,False,0,1,2020-09-17T16:32:19.897,0,,0.0
2020,1,2805,655,1,245,2,5,3,5,7,2,7,0,7,0,False,False,False,0,2,2020-09-17T14:47:54.717,7,,0.0
2020,1,2805,665,1,245,2,4,4,13,18,5,13,5,13,0,False,False,False,1,3,2020-09-17T16:49:08.667,18,,5.0
2020,1,2805,695,1,6405,13,19,2,40,0,0,0,0,0,0,False,False,False,0,2,2020-09-14T20:54:26.513,0,,
2020,1,2805,705,1,245,2,50,3,-2,7,9,6,1,6,0,False,False,False,0,2,2021-03-04T15:22:00.27,7,,1.0
2020,1,2805,735,28,262,2,11,2,18,41,23,26,15,26,0,False,False,False,0,1,2020-09-14T16:57:43.01,41,,15.0
2020,1,2805,740,28,262,3,5,5,2,0,0,0,0,0,0,False,False,False,0,1,2021-02-03T18:09:05.407,0,,0.0
2020,1,2805,745,28,3264,13,48,9,-1,0,0,0,0,0,0,False,False,False,0,1,2020-09-17T14:48:06.083,0,,0.0
2020,1,2805,750,28,797,13,12,2,27,0,0,0,0,0,0,False,False,False,0,1,2021-03-08T16:43:43.743,0,,
2020,1,2805,760,28,4912,13,12,10,5,0,0,0,0,0,0,False,False,False,0,3,2021-03-08T16:44:26.493,0,,0.0
2020,1,2805,770,28,797,2,46,3,1,5,4,1,4,1,6,False,False,False,0,1,2020-09-17T16:39:36.707,5,,4.0
2020,1,2805,785,1,6405,13,7,2,26,0,0,0,0,0,0,False,False,False,0,2,2021-02-08T22:25:53.033,0,,0.0
2020,1,2805,790,1,245,2,4,9,5,11,6,5,6,5,0,False,False,False,1,3,2020-09-17T16:50:32.257,11,,6.0
2020,1,2805,810,1,6405,2,51,10,-4,0,4,0,0,0,0,False,False,False,0,2,2020-09-14T17:28:28.397,0,,0.0
2020,1,2805,815,1,6406,2,16,10,3,4,1,3,1,3,0,False,False,False,0,1,2020-09-14T17:30:34.453,4,,1.0
2020,1,2805,820,1,245,2,13,5,6,33,27,29,4,29,0,True,False,False,0,3,2020-09-14T17:37:53.827,33,,4.0
2020,1,2805,845,28,3264,2,5,3,2,5,3,2,3,2,0,False,False,False,1,1,2020-09-17T14:48:16.98,5,,3.0
2020,1,2805,860,28,743,2,44,3,5,6,1,5,1,5,0,False,False,False,0,6,2020-09-17T16:58:48.43,6,,1.0
2020,1,2805,875,28,969,2,5,3,2,2,0,2,0,2,0,False,False,False,0,3,2020-09-14T17:58:02.247,2,,0.0
2020,1,2805,880,28,3264,2,16,9,5,9,4,5,4,5,0,False,False,False,0,1,2020-09-14T17:57:46.837,9,,4.0
2020,1,2805,885,28,4912,13,21,2,21,0,0,0,0,0,0,False,False,False,0,2,2020-09-17T15:41:46.663,0,,0.0
2020,1,2805,890,28,4932,2,6,4,4,5,1,4,1,4,0,False,False,False,0,3,2020-09-17T14:48:40.4,5,,1.0
2020,1,2805,895,28,4932,13,12,2,16,0,0,0,0,0,0,False,False,False,0,3,2020-09-14T18:04:34.663,0,,0.0
2020,1,2805,905,28,4932,13,5,5,6,0,0,0,0,0,0,False,False,False,0,3,2020-09-14T18:06:58.353,0,,0.0
2020,1,2806,15,29,1958,2,30,9,-2,20,22,16,4,16,0,False,False,False,1,3,2020-09-17T17:05:08.05,20,,4.0
2020,1,2806,25,29,1958,2,51,3,-4,31,35,30,1,30,0,True,False,False,0,4,2020-09-17T17:30:47.553,31,,1.0
2020,1,2806,30,29,1958,2,5,5,4,9,5,8,1,8,0,False,False,False,0,3,2020-09-17T19:27:46.807,9,,1.0
2020,1,2806,65,9,322,2,2,9,6,9,3,9,0,9,0,True,False,False,0,2,2020-09-15T17:17:13.537,9,,0.0
2020,1,2806,75,9,4202,2,13,9,2,10,8,9,1,9,0,False,False,False,0,3,2020-09-17T17:31:25.137,10,,1.0
2020,1,2806,90,9,7183,13,32,9,-2,0,0,0,0,0,0,False,False,False,0,1,2020-09-14T10:52:16.217,0,,0.0
2020,1,2806,120,29,3356,2,48,9,-5,18,23,4,14,4,0,False,False,False,0,1,2020-09-17T19:36:46.84,18,,14.0
2020,1,2806,125,29,1958,13,5,5,6,0,0,0,0,0,0,False,False,False,0,3,2021-02-08T23:38:03.617,0,,0.0
2020,1,2806,135,29,3356,2,48,10,-5,6,11,4,2,4,0,False,False,False,0,1,2020-09-14T11:04:16.21,6,,2.0
2020,1,2806,145,29,7788,2,46,3,1,4,3,4,0,4,0,False,False,False,0,1,2020-09-14T11:06:42.31,4,,0.0
2020,1,2806,150,29,4866,2,30,5,0,8,8,7,1,7,0,False,False,False,0,3,2020-09-14T11:07:58.033,8,,1.0
2020,1,2806,155,29,3398,2,47,5,1,4,3,3,1,3,0,False,False,False,0,3,2020-09-14T11:09:11.7,4,,1.0
2020,1,2806,175,29,1958,2,50,9,-2,5,7,2,3,2,0,False,False,False,0,3,2020-09-14T11:14:25.073,5,,3.0
2020,1,2806,200,9,6436,2,4,3,10,24,14,10,14,10,0,False,False,False,1,2,2020-09-17T16:12:56.89,24,,14.0
2020,1,2806,205,9,7183,2,34,4,-4,4,8,1,3,1,0,True,False,False,0,2,2020-09-17T17:00:23,4,,3.0
2020,1,2806,210,9,322,2,5,3,4,5,1,5,0,5,0,True,False,False,0,3,2020-09-15T17:18:18.133,5,,0.0
2020,1,2806,220,9,7816,2,35,2,19,33,14,33,0,33,0,False,False,False,0,3,2020-09-14T11:33:07.63,33,,0.0
2020,1,2806,225,9,322,2,5,5,6,6,0,6,0,6,0,False,False,False,0,2,2021-02-08T23:39:24.33,6,,0.0
2020,1,2806,235,9,4202,2,45,5,-1,19,20,12,7,12,6,False,False,False,2,1,2020-09-14T11:37:35.703,19,,7.0
2020,1,2806,260,29,4850,3,35,10,10,0,0,0,0,0,0,False,False,False,0,4,2020-09-14T11:43:51.787,0,,0.0
2020,1,2806,265,29,3398,2,2,9,3,21,18,17,4,17,0,False,False,False,0,3,2020-09-17T20:31:41.78,21,,4.0
2020,1,2806,280,29,4866,2,5,5,3,11,8,9,2,9,0,False,False,False,1,2,2020-09-17T17:55:20.217,11,,2.0
2020,1,2806,295,29,3356,3,48,10,-6,0,0,0,0,0,0,False,False,False,0,1,2020-09-14T11:51:18.113,0,,0.0
2020,1,2806,300,29,4866,13,50,9,-3,0,0,0,0,0,0,False,False,False,0,3,2020-09-14T11:52:38.26,0,,0.0
2020,1,2806,320,9,7816,2,51,5,-4,3,7,2,1,2,0,True,False,False,0,2,2020-09-17T16:59:31.993,3,,1.0
2020,1,2806,335,9,7183,2,46,9,3,18,15,5,13,5,0,False,False,False,1,1,2021-03-02T18:30:33.75,18,,13.0
2020,1,2806,340,9,4202,13,28,4,3,0,0,0,0,0,0,False,False,False,0,1,2021-03-01T22:47:08.817,0,,0.0
2020,1,2806,350,9,7816,13,4,10,4,0,0,0,0,0,0,False,False,False,0,3,2020-09-14T12:05:59.23,0,,0.0
2020,1,2806,370,29,7828,2,19,6,27,31,4,28,3,28,0,False,False,False,0,2,2021-02-08T23:40:46.68,31,,3.0
2020,1,2806,405,9,322,2,4,3,5,9,4,7,2,7,0,False,False,False,0,2,2020-09-14T12:23:02.82,9,,2.0
2020,1,2806,410,9,4447,2,5,3,12,12,0,12,0,12,0,False,False,False,0,3,2020-09-14T12:24:03.1,12,,0.0
2020,1,2806,415,9,7816,2,2,10,8,12,4,8,4,8,0,False,False,False,0,3,2020-09-14T12:25:05.617,12,,4.0
2020,1,2806,420,9,6436,2,6,9,13,14,1,13,1,13,0,False,False,False,0,2,2020-09-14T12:27:34.397,14,,1.0
2020,1,2806,435,9,4202,2,48,10,-3,12,15,10,2,10,6,False,False,False,0,1,2020-09-14T12:30:29.077,12,,
2020,1,2806,440,9,7816,2,2,10,8,9,1,9,0,9,0,False,False,False,0,3,2020-09-14T12:32:12.44,9,,0.0
2020,1,2806,510,9,6446,2,6,10,7,11,4,8,3,8,0,False,False,False,1,3,2020-09-14T12:50:18.727,11,,3.0
2020,1,2806,545,29,1958,2,5,3,6,10,4,9,1,9,0,True,False,False,0,3,2020-09-17T17:34:11.143,10,,1.0
2020,1,2806,550,29,4850,2,53,10,-1,14,15,8,6,8,0,False,False,False,1,4,2020-09-17T19:44:03.76,14,,
2020,1,2806,555,29,4850,2,5,3,6,7,1,7,0,7,0,False,False,False,0,3,2020-09-14T13:06:44.753,7,,0.0
2020,1,2806,570,29,1958,2,8,8,15,30,15,27,3,27,0,False,False,False,0,3,2020-09-17T17:46:35.367,30,,3.0
2020,1,2806,585,29,4866,2,4,9,5,6,1,5,1,5,0,False,False,False,0,3,2020-09-14T13:17:06.97,6,,1.0
2020,1,2806,590,29,4875,2,4,3,4,17,13,4,13,4,0,False,False,False,1,2,2021-03-02T18:37:34.237,17,,13.0
2020,1,2806,610,9,6436,2,4,5,8,12,4,10,2,10,0,False,False,False,0,2,2020-09-14T13:23:14.817,12,,2.0
2020,1,2806,620,9,322,13,4,5,5,0,0,0,0,0,0,False,False,False,0,2,2020-09-14T13:25:14.777,0,,0.0
2020,1,2806,625,9,6436,13,4,9,14,0,0,0,0,0,0,False,False,False,0,2,2020-09-14T13:27:16.967,0,,0.0
2020,1,2806,640,29,3398,13,24,8,16,0,0,0,0,0,0,False,False,False,0,3,2020-09-14T13:30:36.893,0,,0.0
2020,1,2806,645,29,7828,13,5,5,9,0,0,0,0,0,0,False,False,False,0,3,2021-03-04T21:42:55.847,0,,0.0
2020,1,2806,655,9,322,13,6,9,4,0,0,0,0,0,0,False,False,False,0,3,2020-09-14T13:36:09.04,0,,
2020,1,2806,660,9,322,2,4,5,10,11,1,10,1,10,0,False,False,False,0,2,2020-09-14T13:39:10.28,11,,1.0
2020,1,2806,670,9,6446,13,32,5,2,0,0,0,0,0,0,False,False,False,0,4,2020-09-14T13:41:19.703,0,,0.0
2020,1,2806,675,9,322,13,13,4,3,0,0,0,0,0,0,False,False,False,0,3,2020-09-14T13:43:29.493,0,,0.0
2020,1,2806,700,29,1958,13,13,10,5,0,0,0,0,0,0,False,False,False,0,3,2020-09-17T19:54:13.807,0,,0.0
2020,1,2806,735,9,322,2,4,5,6,11,5,10,1,10,0,False,False,False,1,2,2020-09-14T14:00:14.99,11,,1.0
2020,1,2806,740,9,322,2,35,9,14,14,0,14,0,14,0,True,False,False,0,4,2020-09-15T17:19:00.35,14,,0.0
2020,1,2806,750,9,6446,3,39,10,5,0,0,0,0,0,0,False,False,False,0,4,2020-09-14T14:07:06.05,0,,0.0
2020,1,2806,760,9,7816,2,13,10,2,2,0,2,0,2,0,False,False,False,0,2,2020-09-14T14:09:12.43,2,,0.0
2020,1,2806,765,29,3356,2,47,10,-5,7,12,6,1,6,0,False,False,False,0,1,2020-09-14T14:11:23.587,7,,1.0
2020,1,2806,770,29,4866,2,4,4,14,15,1,14,1,14,0,False,False,False,0,3,2020-09-17T21:46:04.647,15,,1.0
2020,1,2806,780,29,7828,13,5,6,15,0,0,0,0,0,0,False,False,False,0,3,2020-09-17T13:10:17.213,0,,0.0
2020,1,2806,785,29,3398,2,6,9,6,15,9,12,3,12,0,False,False,False,0,2,2020-09-14T14:20:27.387,15,,3.0
2020,1,2806,820,9,4202,2,4,4,2,2,0,2,0,2,0,False,False,False,0,1,2020-09-14T14:36:16.183,2,,0.0
2020,1,2806,825,9,322,13,5,5,7,0,0,7,-1006,7,0,False,False,False,0,3,2020-09-14T14:39:41.97,0,,0.0
2020,1,2806,875,9,322,2,4,5,4,5,1,4,1,4,0,False,False,False,0,2,2020-09-14T14:58:34.497,5,,1.0
2020,1,2806,880,9,322,2,6,10,4,7,3,7,0,7,0,False,False,False,0,2,2020-09-14T14:56:57.32,7,,0.0
2020,1,2806,890,9,322,2,6,9,4,4,0,4,0,4,0,False,False,False,0,2,2020-09-14T14:59:20.63,4,,0.0
2020,1,2806,910,9,6446,3,5,3,2,0,0,0,0,0,0,False,False,False,0,3,2020-09-14T15:04:13.443,0,,0.0
2020,1,2806,920,9,6436,2,19,6,39,47,8,43,4,43,0,False,False,False,0,2,2020-09-14T15:07:17.46,47,,
2020,1,2806,925,9,322,13,12,2,35,0,0,0,0,0,0,False,False,False,0,2,2020-09-14T15:08:58.14,0,,0.0
2020,1,2806,935,9,7816,13,12,6,20,0,0,0,0,0,0,False,False,False,0,3,2020-09-14T15:10:26.427,0,,0.0
2020,1,2807,10,21,3680,2,2,9,9,13,4,10,3,10,0,False,False,False,0,2,2020-09-15T12:13:29.833,13,,3.0
2020,1,2807,20,21,4422,3,4,9,12,0,0,0,0,0,0,False,False,False,0,3,2020-09-15T12:14:05.343,0,,0.0
2020,1,2807,25,21,3680,2,4,4,13,14,1,13,1,13,0,False,False,False,0,3,2020-09-15T12:06:18.17,14,,1.0
2020,1,2807,40,21,5015,2,13,4,5,7,2,6,1,6,0,False,False,False,0,2,2020-09-17T18:37:40.577,7,,1.0
2020,1,2807,60,21,7090,13,2,9,2,0,0,0,0,0,0,False,False,False,0,2,2020-09-15T12:37:26.187,0,,0.0
2020,1,2807,65,21,4422,13,31,10,2,0,0,0,0,0,0,False,False,False,0,4,2021-02-08T22:40:46.89,0,,0.0
2020,1,2807,100,21,6228,3,4,10,6,0,0,0,0,0,0,False,False,False,0,3,2020-09-17T17:41:14.793,0,,0.0
2020,1,2807,110,21,6228,2,48,10,-7,1,8,-1,2,-1,0,False,False,False,0,1,2020-09-17T18:37:40.577,1,,2.0
2020,1,2807,125,25,4587,13,48,10,0,0,0,0,0,0,0,False,False,False,0,1,2020-09-15T13:11:26.317,0,,0.0
2020,1,2807,130,25,4583,2,6,9,8,11,3,9,2,9,0,False,False,False,0,3,2020-09-17T20:13:54.433,11,,2.0
2020,1,2807,140,25,7060,13,2,10,9,0,0,0,0,0,0,False,False,False,0,2,2020-09-15T13:20:35.6,0,,0.0
2020,1,2807,145,25,7666,2,19,2,28,28,0,28,0,28,0,False,False,False,0,2,2020-09-16T19:45:07.317,28,,0.0
2020,1,2807,160,25,4587,2,5,3,4,6,2,5,1,5,0,False,False,False,0,3,2020-09-15T13:34:05.703,6,,1.0
2020,1,2807,170,25,4587,2,48,9,-4,2,6,2,0,2,0,False,False,False,0,1,2020-09-15T13:40:14.217,2,,0.0
2020,1,2807,175,25,7081,13,28,10,-2,0,0,0,0,0,0,False,False,False,0,1,2020-09-15T19:38:26.617,0,,0.0
2020,1,2807,190,21,7090,2,4,10,5,11,6,5,6,5,0,False,False,False,1,3,2020-09-15T13:47:41.573,11,,6.0
2020,1,2807,205,21,7226,2,46,3,2,12,10,8,4,8,0,False,False,False,0,4,2020-09-17T20:02:54.433,12,,4.0
2020,1,2807,215,21,7090,13,2,9,7,0,0,0,0,0,0,False,False,False,0,2,2020-09-17T20:14:58.043,0,,0.0
2020,1,2807,220,21,4422,13,6,10,12,0,0,0,0,0,0,False,False,False,0,3,2020-09-17T18:37:40.577,0,,
2020,1,2807,225,21,7090,2,8,1,40,41,1,41,0,41,6,False,False,False,0,2,2020-09-17T18:37:40.577,41,,0.0
2020,1,2807,240,25,4587,3,46,3,-2,0,0,0,0,0,0,True,False,False,0,1,2021-02-08T22:41:58.57,0,,0.0
2020,1,2807,250,25,181,13,32,5,1,0,0,0,0,0,0,False,False,False,0,4,2020-09-17T20:01:59.177,0,,0.0
2020,1,2807,260,21,4422,13,5,10,1,0,0,0,0,0,0,False,False,False,0,4,2021-03-04T21:49:00.69,0,,0.0
2020,1,2807,280,25,609,2,35,6,16,18,2,16,2,16,0,True,False,False,0,3,2020-09-16T19:56:03.167,18,,2.0
2020,1,2807,285,25,7060,13,12,3,13,0,0,0,0,0,0,False,False,False,0,2,2020-09-15T15:17:53.463,0,,0.0
2020,1,2807,290,25,181,2,12,4,2,3,1,2,1,2,0,False,False,False,0,2,2021-03-08T16:51:26.407,3,,1.0
2020,1,2807,295,25,4583,2,35,3,10,10,0,10,0,10,6,False,False,False,0,3,2020-09-17T20:18:25.483,10,,0.0
2020,1,2807,320,21,6228,2,48,10,-4,38,42,24,14,24,0,False,False,False,2,1,2020-09-17T20:19:06.2,38,,14.0
2020,1,2807,325,21,4422,2,17,8,21,24,3,21,3,21,0,False,False,False,0,4,2020-09-15T19:35:48.24,24,,
2020,1,2807,340,21,4405,2,16,9,0,14,14,10,4,10,0,False,False,False,0,1,2020-09-15T15:47:32.247,14,,4.0
2020,1,2807,360,25,609,13,12,1,23,0,0,0,0,0,0,True,False,False,0,4,2020-09-16T19:57:15.39,0,,0.0
2020,1,2807,405,25,7060,2,34,4,-4,2,6,-5,7,-5,0,True,False,False,0,3,2020-09-16T19:58:53.067,2,,7.0
2020,1,2807,410,25,6486,2,29,2,15,21,6,16,5,16,0,False,False,False,0,2,2021-02-25T17:37:54.287,21,,5.0
2020,1,2807,415,25,7060,13,7,6,22,0,0,0,0,0,0,False,False,False,0,3,2020-09-15T16:18:31.74,0,,0.0
2020,1,2807,420,25,4583,2,13,10,2,17,15,13,4,13,0,False,False,False,0,3,2020-09-15T16:20:40.893,17,,4.0
2020,1,2807,425,25,7060,3,2,9,2,0,0,0,0,0,0,False,False,False,0,2,2020-09-15T16:23:09.26,0,,0.0
2020,1,2807,430,25,4583,2,26,9,1,14,13,14,0,14,0,False,False,False,0,3,2020-09-15T16:25:51.613,14,,0.0
2020,1,2807,450,25,6486,2,2,10,3,13,10,10,3,10,6,False,False,False,1,2,2020-09-16T19:47:10.733,13,,3.0
2020,1,2807,500,25,6486,13,19,2,24,0,0,0,0,0,0,False,False,False,0,3,2020-09-15T19:38:41.047,0,,0.0
2020,1,2807,515,21,4422,13,5,9,7,0,0,0,0,0,0,False,False,False,0,3,2020-10-19T17:47:57.193,0,,0.0
2020,1,2807,520,21,7090,2,4,8,18,18,0,18,0,18,0,False,False,False,0,2,2020-09-15T17:08:35.39,18,,0.0
2020,1,2807,525,21,3680,2,46,3,2,5,3,3,2,3,0,False,False,False,0,3,2020-09-15T17:14:59.32,5,,2.0
2020,1,2807,535,21,720,2,38,3,4,13,9,10,3,10,0,False,False,False,0,4,2021-02-08T22:42:38.21,13,,3.0
2020,1,2807,540,21,7090,2,13,3,4,10,6,9,1,9,0,False,False,False,0,2,2020-09-15T17:17:47.777,10,,1.0
2020,1,2807,550,21,6228,2,4,4,4,4,0,4,0,4,0,False,False,False,0,1,2020-09-15T17:22:48.357,4,,0.0
2020,1,2807,560,21,6228,2,12,9,1,3,2,2,1,2,0,False,False,False,1,1,2021-03-08T16:51:56.033,3,,1.0
2020,1,2807,565,21,4422,2,46,3,0,4,4,2,2,2,0,False,False,False,0,4,2020-09-17T20:41:42.333,4,,2.0
2020,1,2807,570,21,2288,13,5,9,1,0,0,0,0,0,0,False,False,False,0,1,2020-09-15T17:36:21.207,0,,0.0
2020,1,2807,580,21,7226,2,32,10,2,5,3,4,1,4,0,False,False,False,0,4,2020-09-15T17:41:47.937,5,,1.0
2020,1,2807,590,21,3680,2,26,9,1,5,4,5,0,5,0,False,False,False,0,3,2020-09-17T21:10:43.873,5,,0.0
2020,1,2807,600,21,7090,13,13,9,4,0,0,0,0,0,0,False,False,False,0,3,2020-09-15T17:54:27.803,0,,0.0
2020,1,2807,605,25,4583,2,47,5,1,9,8,7,2,7,0,False,False,False,0,3,2020-09-15T17:57:17.71,9,,2.0
2020,1,2807,615,25,7060,2,2,9,2,10,8,8,2,8,0,False,False,False,0,2,2021-03-03T13:02:25.41,10,,2.0
2020,1,2807,620,25,7060,13,12,5,2,0,0,0,0,0,0,False,False,False,0,2,2020-09-15T18:09:20.533,0,,0.0
2020,1,2807,625,25,7060,2,29,3,10,18,8,11,7,11,0,False,False,False,1,2,2021-02-24T21:15:41.36,18,,7.0
2020,1,2807,635,25,6490,2,48,4,-4,1,5,-2,3,-2,0,False,False,False,0,1,2020-09-15T18:15:02.86,1,,3.0
2020,1,2807,645,25,7666,2,4,9,4,11,7,9,2,9,0,False,False,False,0,3,2020-09-15T18:19:46.483,11,,2.0
2020,1,2807,660,21,3680,2,5,5,4,4,0,4,0,4,0,False,False,False,0,3,2020-09-15T18:23:27.237,4,,0.0
2020,1,2807,685,25,7060,2,13,9,1,5,4,5,0,5,0,False,False,False,0,2,2020-09-15T18:29:18.34,5,,0.0
2020,1,2807,690,25,7060,2,3,3,11,11,0,11,0,11,0,False,False,False,0,2,2020-09-15T18:32:01.457,11,,0.0
2020,1,2807,705,25,7060,2,13,10,1,11,10,11,0,11,0,False,False,False,0,2,2020-09-16T19:52:21.297,11,,0.0
2020,1,2807,735,25,4583,2,29,3,8,8,0,8,0,8,6,False,False,False,0,3,2020-09-17T20:42:14.523,8,,0.0
2020,1,2807,750,21,7090,2,6,7,15,15,0,15,0,15,0,False,False,False,0,2,2020-09-15T18:50:03.07,15,,0.0
2020,1,2807,755,21,5015,2,3,5,10,10,0,10,0,10,0,False,False,False,0,2,2020-09-15T19:23:54.683,10,,0.0
2020,1,2807,765,21,4422,3,4,10,7,0,0,0,0,0,0,False,False,False,0,3,2020-09-15T19:23:32.187,0,,0.0
2020,1,2807,770,21,4422,13,13,3,4,0,0,0,0,0,0,False,False,False,0,3,2020-09-17T20:37:37.897,0,,
2020,1,2807,775,21,3680,2,2,10,6,6,0,6,0,6,0,False,False,False,0,3,2020-09-15T18:58:54.943,6,,0.0
2020,1,2807,780,21,6228,13,11,5,12,0,0,0,0,0,0,False,False,False,0,1,2020-09-15T19:00:17.12,0,,0.0
2020,1,2807,785,21,6228,2,4,10,6,7,1,7,0,7,0,False,False,False,0,3,2020-09-15T19:02:46.477,7,,0.0
2020,1,2807,790,21,6228,2,42,10,5,7,2,6,1,6,0,False,False,False,0,3,2020-09-15T19:07:49.22,7,,1.0
2020,1,2807,800,21,4422,2,5,10,4,5,1,5,0,5,0,False,False,False,0,3,2020-09-15T19:10:22.193,5,,0.0
2020,1,2807,805,21,6228,13,5,5,7,0,0,0,0,0,0,False,False,False,0,3,2020-09-15T19:11:42.32,0,,0.0
2020,1,2807,820,21,7090,2,2,9,7,7,0,7,0,7,6,False,False,False,0,2,2020-09-15T19:14:00.607,7,,0.0
2020,1,2808,30,31,5096,2,53,10,-2,22,24,20,2,20,0,True,False,False,0,4,2020-09-17T21:08:00.727,22,,2.0
2020,1,2808,45,31,6793,13,5,5,8,0,0,0,0,0,0,False,False,False,0,3,2021-02-05T19:06:30.007,0,,0.0
2020,1,2808,60,10,6840,2,32,10,-2,17,19,16,1,16,0,False,False,False,0,4,2020-09-15T12:03:54.017,17,,1.0
2020,1,2808,70,10,4930,2,4,3,5,3,-2,3,0,3,0,False,False,False,0,2,2020-09-15T12:09:17.977,3,,0.0
2020,1,2808,75,10,7700,13,24,2,33,0,0,0,0,0,0,False,False,False,0,3,2020-09-15T12:11:02.927,0,,0.0
2020,1,2808,90,31,5080,2,35,10,13,16,3,15,1,15,0,False,False,False,0,3,2020-09-15T12:16:23.717,16,,1.0
2020,1,2808,105,31,5080,2,35,6,15,20,5,18,2,18,0,False,False,False,0,3,2020-09-15T12:23:40.477,20,,2.0
2020,1,2808,120,31,5096,13,38,4,1,0,0,0,0,0,0,False,False,False,0,4,2020-09-17T19:35:06.033,0,,0.0
2020,1,2808,140,10,7700,2,4,9,12,12,0,12,0,12,0,False,False,False,0,2,2020-09-15T12:35:22.373,12,,0.0
2020,1,2808,150,10,6840,2,39,10,7,8,1,8,0,8,0,False,False,False,0,3,2020-09-17T17:03:07.11,8,,0.0
2020,1,2808,160,10,3848,2,53,10,-6,-6,0,-6,0,-6,0,False,False,False,0,4,2020-09-17T22:05:02.427,-6,,0.0
2020,1,2808,175,10,6840,2,12,10,9,9,0,9,0,9,6,False,False,False,0,4,2021-03-08T16:55:05.28,9,,0.0
2020,1,2808,200,31,3504,2,48,3,-3,4,7,1,3,1,0,False,False,False,0,1,2020-09-15T12:55:29.093,4,,3.0
2020,1,2808,205,31,4037,3,5,5,10,0,0,0,0,0,0,False,False,False,0,3,2020-09-15T12:57:24.32,0,,0.0
2020,1,2808,225,10,4930,2,12,5,6,6,0,6,0,6,0,False,False,False,0,3,2021-03-08T16:55:38.993,6,,0.0
2020,1,2808,230,10,282,2,49,5,-2,2,4,2,0,2,0,False,True,True,0,2,2020-09-15T17:06:04.917,2,,0.0
2020,1,2808,240,31,5096,2,13,9,4,5,1,5,0,5,0,False,False,False,0,4,2020-09-15T13:09:02.57,5,,0.0
2020,1,2808,260,31,2901,2,33,10,1,1,0,1,0,1,6,False,False,False,0,4,2021-03-05T18:01:41.547,1,,0.0
2020,1,2808,280,10,6840,2,6,9,7,16,9,10,6,10,0,False,False,False,0,4,2021-02-05T18:53:15.177,16,,6.0
2020,1,2808,290,10,5105,3,13,9,4,0,0,0,0,0,0,False,False,False,0,4,2020-09-15T13:23:44.78,0,,0.0
2020,1,2808,295,10,6840,2,32,5,1,31,30,23,8,23,0,False,False,False,1,4,2020-09-15T13:25:56.63,31,,8.0
2020,1,2808,310,10,6481,2,16,4,4,11,7,8,3,8,0,False,False,False,0,1,2021-02-05T19:11:04.493,11,,3.0
2020,1,2808,320,10,3848,13,38,9,1,0,0,0,0,0,0,False,False,False,0,4,2020-09-15T13:35:45.74,0,,0.0
2020,1,2808,330,10,5105,2,55,10,-1,0,1,0,0,0,0,False,False,False,0,4,2020-09-15T13:38:16.567,0,,0.0
2020,1,2808,340,31,5080,2,35,9,13,23,10,22,1,22,0,False,False,False,0,3,2020-09-15T13:43:18.037,23,,1.0
2020,1,2808,360,31,2675,2,5,10,10,10,0,10,0,10,0,False,False,False,0,3,2021-02-05T18:53:15.177,10,,0.0
2020,1,2808,365,31,5080,2,5,10,13,13,0,13,0,13,0,False,False,False,0,3,2020-09-15T13:53:10.617,13,,0.0
2020,1,2808,375,31,2675,2,2,4,6,9,3,8,1,8,0,False,False,False,0,3,2020-09-15T13:55:17.857,9,,1.0
2020,1,2808,385,31,6793,2,5,3,9,12,3,9,3,9,0,False,False,False,0,3,2021-02-05T18:53:15.177,12,,3.0
2020,1,2808,390,31,4545,13,4,4,3,0,0,0,0,0,0,False,False,False,0,1,2020-09-15T13:58:29.467,0,,0.0
2020,1,2808,405,31,4037,13,6,10,12,0,0,0,0,0,0,False,False,False,0,2,2021-02-05T19:11:58.057,0,,0.0
2020,1,2808,415,10,282,2,12,10,0,8,8,7,1,7,0,False,False,False,0,1,2021-03-08T16:56:15.563,8,,1.0
2020,1,2808,425,10,7700,2,17,10,12,25,13,24,1,24,0,True,True,False,2,3,2020-09-15T14:07:28.957,25,,1.0
2020,1,2808,440,10,4930,13,21,2,35,0,0,0,0,0,0,False,False,False,0,2,2021-02-05T18:53:15.177,0,,0.0
2020,1,2808,445,10,7702,2,18,5,-3,7,10,0,7,0,0,False,False,False,1,2,2020-09-15T14:13:07.99,7,,7.0
2020,1,2808,450,10,7700,3,6,1,15,0,0,0,0,0,0,False,False,False,0,3,2020-09-15T14:14:52.42,0,,0.0
2020,1,2808,460,31,6793,2,4,10,3,4,1,4,0,4,0,False,False,False,0,3,2020-09-15T14:17:21.11,4,,0.0
2020,1,2808,480,31,4037,13,7,6,29,0,0,0,0,0,0,False,False,False,0,3,2021-03-04T21:52:03.77,0,,
2020,1,2808,490,31,2675,2,4,9,4,7,3,6,1,6,0,False,False,False,0,3,2020-09-15T14:27:35.08,7,,1.0
2020,1,2808,495,31,6793,2,2,9,2,5,3,2,3,2,0,False,False,False,1,2,2020-09-15T14:30:58.323,5,,3.0
2020,1,2808,500,31,6793,2,50,3,1,7,6,5,2,5,0,False,False,False,0,2,2020-09-15T16:56:16.513,7,,2.0
2020,1,2808,510,31,6724,2,26,10,3,6,3,4,2,4,0,False,False,False,0,3,2020-09-15T14:35:39.94,6,,2.0
2020,1,2808,515,31,6724,2,30,9,-1,-1,0,-1,0,-1,0,False,False,False,0,4,2021-02-05T19:13:56.103,-1,,0.0
2020,1,2808,525,31,2675,13,39,4,10,0,0,0,0,0,0,False,False,False,0,3,2020-09-17T21:43:54.71,0,,0.0
2020,1,2808,540,10,282,2,44,3,-3,-2,1,-2,0,-2,0,False,False,False,0,1,2020-09-15T14:49:48.067,-2,,0.0
2020,1,2808,545,10,7700,13,35,6,19,0,0,0,0,0,0,False,False,False,0,3,2020-09-17T21:44:12.523,0,,0.0
2020,1,2808,555,31,5096,2,28,10,-2,8,10,7,1,7,0,False,False,False,0,4,2020-09-17T17:08:28.213,8,,1.0
2020,1,2808,560,31,5096,13,13,9,4,0,0,0,0,0,0,False,False,False,0,4,2020-09-17T19:45:54.9,0,,0.0
2020,1,2808,565,31,5080,2,13,5,4,7,3,7,0,7,0,False,False,False,0,3,2021-02-05T19:15:04.497,7,,0.0
2020,1,2808,580,31,4545,2,48,9,-4,4,8,-4,8,-4,0,False,False,False,1,1,2020-09-17T21:26:21.203,4,,
2020,1,2808,595,31,5080,2,33,9,13,13,0,13,0,13,0,False,False,False,0,3,2020-09-17T22:05:39.1,13,,0.0
2020,1,2808,610,31,2675,2,4,10,6,7,1,7,0,7,0,False,False,False,0,3,2020-09-15T15:11:17.883,7,,0.0
2020,1,2808,625,31,3504,2,47,5,1,5,4,2,3,2,0,False,False,False,0,1,2020-09-15T15:14:28.953,5,,3.0
2020,1,2808,635,31,5096,2,7,5,1,1,0,1,0,1,6,False,False,False,0,4,2020-09-15T15:18:20.233,1,,0.0
2020,1,2808,660,10,7700,2,2,4,6,21,15,13,8,13,0,False,False,False,2,3,2020-09-15T15:25:38.613,21,,8.0
2020,1,2808,665,10,7700,2,44,3,-3,-2,1,-3,1,-3,0,True,False,False,0,3,2020-09-15T15:27:35.023,-2,,1.0
2020,1,2808,670,10,4930,2,2,9,8,15,7,13,2,13,0,False,False,False,0,2,2020-09-17T21:44:36.113,15,,2.0
2020,1,2808,680,10,6282,2,46,3,3,12,9,8,4,8,0,False,False,False,0,1,2020-09-15T15:32:26.67,12,,4.0
2020,1,2808,710,31,6888,2,47,10,0,5,5,1,4,1,0,False,False,False,0,1,2020-09-17T22:05:54.79,5,,4.0
2020,1,2808,730,10,4930,2,4,5,5,5,0,5,0,5,0,False,False,False,0,2,2021-02-05T19:16:06.09,5,,0.0
2020,1,2808,750,10,6285,13,9,2,18,0,0,0,0,0,0,False,False,False,0,3,2020-09-17T21:17:24.663,0,,0.0
2020,1,2808,765,31,5096,13,5,5,6,0,0,0,0,0,0,False,False,False,0,3,2020-09-15T15:52:55.547,0,,0.0
2020,1,2808,770,31,5080,13,35,10,14,0,0,0,0,0,0,False,False,False,0,2,2020-09-15T15:54:39.49,0,,0.0
2020,1,2808,780,10,7700,3,2,10,7,0,0,0,0,0,0,False,False,False,0,3,2020-09-18T21:23:27.27,0,,0.0
2020,1,2808,790,10,6285,13,19,6,42,0,0,0,0,0,0,False,False,False,0,3,2020-09-17T21:19:15.443,0,,0.0
2020,1,2808,800,31,2675,2,5,3,8,8,0,8,0,8,0,False,False,False,0,3,2020-09-15T16:08:15.63,8,,0.0
2020,1,2808,805,31,5080,2,2,10,8,9,1,8,1,8,0,False,False,False,0,2,2020-09-17T19:37:00.483,9,,1.0
2020,1,2808,815,31,3504,2,4,10,4,6,2,4,2,4,0,False,False,False,0,1,2020-09-15T16:11:43.003,6,,2.0
2020,1,2808,820,31,6793,2,2,9,10,11,1,10,1,10,0,False,False,False,0,2,2021-02-25T17:42:18.683,11,,1.0
2020,1,2808,830,31,6793,13,2,9,7,0,0,0,0,0,0,False,False,False,0,3,2020-09-15T16:16:02.75,0,,0.0
2020,1,2808,835,31,6793,13,5,6,17,0,0,0,0,0,0,False,False,False,0,2,2020-09-15T16:17:14.42,0,,
2020,1,2808,840,31,2675,2,4,9,5,6,1,6,0,6,0,False,False,False,0,3,2020-09-15T16:18:58.917,6,,0.0
2020,1,2808,865,31,6793,13,9,3,7,0,0,0,0,0,0,False,False,False,0,3,2020-09-15T16:25:06.083,0,,0.0
2020,1,2808,880,10,6840,13,12,2,33,0,0,0,0,0,0,False,False,False,0,3,2021-02-05T19:16:55.423,0,,0.0
2020,1,2808,885,10,6285,2,6,8,16,18,2,17,1,17,0,False,False,False,0,2,2020-09-15T16:29:12.717,18,,1.0
2020,2,2809,10,7,910,13,19,6,35,0,0,0,0,0,0,False,False,False,0,2,2020-09-18T19:49:19.327,0,,0.0
2020,2,2809,15,7,3521,2,2,10,5,10,5,7,3,7,0,False,False,False,1,3,2021-03-02T19:02:16.917,10,,3.0
2020,2,2809,25,7,3445,2,26,10,3,3,0,3,0,3,0,False,False,False,0,3,2020-09-23T16:17:35.933,3,,0.0
2020,2,2809,35,7,931,2,47,10,1,3,2,2,1,2,0,False,False,False,0,1,2020-09-23T16:17:42.593,3,,1.0
2020,2,2809,50,7,3521,2,29,3,5,7,2,6,1,6,0,False,False,False,0,3,2020-09-18T11:51:42.18,7,,1.0
2020,2,2809,60,7,2631,2,5,9,5,8,3,5,3,5,0,True,False,False,0,3,2020-09-23T14:13:52.02,8,,3.0
2020,2,2809,65,7,910,13,8,4,14,0,0,0,0,0,0,False,False,False,0,2,2020-09-18T11:57:56.683,0,,0.0
2020,2,2809,90,8,232,2,13,3,5,9,4,8,1,8,0,False,False,False,0,3,2020-09-18T12:09:34.107,9,,1.0
2020,2,2809,95,8,6633,2,7,2,25,26,1,25,1,25,0,False,False,False,0,3,2020-09-18T12:14:21.863,26,,1.0
2020,2,2809,105,8,3883,2,5,3,5,11,6,9,2,9,0,False,False,False,0,4,2020-09-23T15:19:51.857,11,,2.0
2020,2,2809,120,8,6439,2,5,5,5,9,4,6,3,6,0,False,False,False,0,1,2020-09-18T12:34:23.697,9,,3.0
2020,2,2809,150,7,910,2,4,5,7,8,1,7,1,7,0,False,False,False,0,2,2020-09-18T20:13:40.527,8,,1.0
2020,2,2809,170,7,4679,2,47,5,0,13,13,3,10,3,0,False,False,False,1,1,2020-09-23T16:17:54.993,13,,10.0
2020,2,2809,195,8,1067,2,21,6,41,43,2,42,1,42,6,False,False,False,0,2,2020-09-18T13:25:33.427,43,,1.0
2020,2,2809,210,7,4679,2,4,9,-1,4,5,0,4,0,0,False,False,False,1,1,2020-09-18T13:35:41.347,4,,4.0
2020,2,2809,215,7,4679,2,48,3,-6,5,11,-4,9,-4,0,False,False,False,1,1,2020-09-19T21:08:15.797,5,,9.0
2020,2,2809,220,7,6975,2,13,9,2,7,5,6,1,6,0,False,False,False,0,4,2020-09-23T16:18:06.883,7,,1.0
2020,2,2809,225,7,4674,13,3,6,17,0,0,0,0,0,0,False,False,False,0,2,2020-09-19T21:10:37.593,0,,0.0
2020,2,2809,230,7,4679,2,16,9,5,18,13,13,5,13,0,False,False,False,0,1,2020-09-18T13:49:34.507,18,,5.0
2020,2,2809,235,7,2631,2,29,6,22,23,1,22,1,22,6,False,False,False,0,4,2020-09-19T21:10:53.297,23,,1.0
2020,2,2809,255,8,1067,2,13,4,0,7,7,7,0,7,0,False,False,False,0,3,2020-09-18T14:05:40.277,7,,0.0
2020,2,2809,260,8,232,2,4,4,14,16,2,15,1,15,0,False,False,False,0,3,2020-09-18T14:08:58.643,16,,1.0
2020,2,2809,280,7,910,13,9,2,25,0,0,0,0,0,0,False,False,False,0,3,2021-02-15T20:18:17.387,0,,0.0
2020,2,2809,285,7,931,2,53,10,-5,5,10,3,2,3,0,True,False,False,0,4,2020-12-20T01:26:17.98,5,,2.0
2020,2,2809,300,8,1067,2,12,4,6,18,12,8,10,8,0,False,False,False,2,2,2021-03-08T16:37:31.94,18,,10.0
2020,2,2809,310,8,1067,13,19,6,35,0,0,0,0,0,0,False,False,False,0,2,2020-09-19T22:19:37.44,0,,0.0
2020,2,2809,320,8,5053,2,12,5,8,9,1,9,0,9,0,False,False,False,0,1,2020-09-19T22:19:57.617,9,,0.0
2020,2,2809,345,8,6633,2,5,5,12,13,1,13,0,13,0,False,False,False,0,3,2020-09-18T14:48:44.023,13,,0.0
2020,2,2809,365,8,5053,2,11,5,6,6,0,6,0,6,6,False,False,False,0,1,2020-09-18T14:53:20.96,6,,0.0
2020,2,2809,380,7,3521,2,26,9,4,11,7,11,0,11,0,False,False,False,0,3,2020-09-23T15:24:09.027,11,,0.0
2020,2,2809,385,7,2631,2,5,3,4,6,2,5,1,5,0,False,False,False,0,4,2020-09-23T15:25:20.887,6,,1.0
2020,2,2809,390,7,931,13,5,9,-2,0,0,0,0,0,0,False,False,False,0,1,2020-09-23T15:26:04.907,0,,
2020,2,2809,395,7,7659,2,12,2,18,18,0,18,0,18,0,False,False,False,0,2,2020-09-19T21:28:17.99,18,,0.0
2020,2,2809,400,7,2631,13,12,5,6,0,0,0,0,0,0,False,False,False,0,4,2020-09-18T15:05:36.383,0,,0.0
2020,2,2809,405,7,4674,13,13,9,6,0,0,0,0,0,0,False,False,False,0,3,2020-09-18T15:08:13.923,0,,0.0
2020,2,2809,410,7,910,2,5,5,8,7,-1,7,0,7,0,False,False,False,0,2,2020-09-19T21:28:49.697,7,,
2020,2,2809,415,7,910,2,2,10,6,6,0,6,0,6,0,False,False,False,0,2,2020-09-18T20:14:14.953,6,,0.0
2020,2,2809,430,7,910,3,9,2,16,0,0,0,0,0,0,False,False,False,0,2,2020-09-18T15:18:59.237,0,,0.0
2020,2,2809,435,7,3445,2,4,9,13,14,1,13,1,13,0,False,False,False,0,2,2020-09-23T14:19:11.08,14,,1.0
2020,2,2809,450,7,910,13,19,6,25,0,0,0,0,0,0,False,False,False,0,2,2020-09-19T21:20:08.833,0,,0.0
2020,2,2809,480,8,4000,2,46,9,0,0,0,0,0,0,0,False,False,False,0,1,2021-02-15T17:46:03.94,0,,0.0
2020,2,2809,495,8,3883,2,2,9,8,11,3,8,3,8,0,False,False,False,0,3,2021-02-15T20:21:17.09,11,,3.0
2020,2,2809,505,8,3883,3,12,9,-1,0,0,0,0,0,0,False,False,False,0,4,2021-03-08T16:38:14.667,0,,0.0
2020,2,2809,515,8,1067,2,13,4,4,6,2,5,1,5,0,False,False,False,0,2,2020-09-18T15:51:16.497,6,,1.0
2020,2,2809,520,8,232,2,46,3,1,21,20,19,2,19,0,True,False,False,0,3,2020-09-18T15:53:08.057,21,,2.0
2020,2,2809,540,8,1067,13,5,5,2,0,0,0,0,0,0,False,False,False,0,2,2021-02-15T20:21:17.09,0,,0.0
2020,2,2809,575,7,910,13,2,10,5,0,0,0,0,0,0,False,False,False,0,2,2020-09-18T19:31:34.713,0,,0.0
2020,2,2809,590,8,3883,13,7,5,1,0,0,0,0,0,0,False,False,False,0,4,2020-09-23T15:30:01.737,0,,0.0
2020,2,2809,610,7,3521,2,6,9,4,5,1,5,0,5,0,False,False,False,0,3,2020-09-23T15:41:17.43,5,,0.0
2020,2,2809,615,7,910,2,35,9,14,15,1,15,0,15,0,False,False,False,0,3,2020-09-23T16:18:53.883,15,,0.0
2020,2,2809,620,7,7659,13,4,3,10,0,0,0,0,0,0,True,False,False,0,2,2020-09-23T16:19:04.443,0,,0.0
2020,2,2809,645,7,931,2,4,9,3,4,1,4,0,4,0,False,False,False,0,1,2020-09-23T16:19:12.473,4,,0.0
2020,2,2809,660,7,6975,13,5,10,4,0,0,0,0,0,0,False,False,False,0,4,2020-09-18T20:16:54.51,0,,
2020,2,2809,665,7,3521,3,5,3,1,0,0,0,0,0,0,False,False,False,0,3,2020-09-23T16:19:28.473,0,,0.0
2020,2,2809,675,7,2631,13,17,4,9,0,0,0,0,0,0,False,False,False,0,3,2020-09-18T19:28:54.297,0,,0.0
2020,2,2809,705,8,7652,2,2,4,3,14,11,14,0,14,0,True,False,False,0,3,2020-09-18T17:01:07.06,14,,0.0
2020,2,2809,725,8,7652,13,8,7,24,0,0,0,0,0,0,False,False,False,0,4,2020-09-19T22:20:34.95,0,,0.0
2020,2,2809,745,7,7659,2,12,3,5,12,7,10,2,10,0,False,False,False,0,3,2020-09-18T17:15:45.787,12,,2.0
2020,2,2809,750,7,6975,2,46,3,1,5,4,3,2,3,0,False,False,False,0,4,2020-09-18T17:17:40.66,5,,2.0
2020,2,2809,755,7,910,13,5,3,8,0,0,0,0,0,0,False,False,False,0,2,2020-09-23T14:26:25.633,0,,0.0
2020,2,2809,760,7,910,13,6,9,10,0,0,0,0,0,0,False,False,False,0,2,2020-09-23T16:19:38.893,0,,0.0
2020,2,2809,765,7,3521,2,4,10,11,13,2,12,1,12,0,False,False,False,0,3,2020-09-18T19:31:48.607,13,,1.0
2020,2,2809,775,7,2631,2,5,10,4,5,1,5,0,5,0,False,False,False,0,3,2020-09-18T17:27:53.117,5,,0.0
2020,2,2809,780,7,910,13,12,2,29,0,0,0,0,0,0,False,False,False,0,3,2020-09-18T17:31:02.317,0,,0.0
2020,2,2809,790,7,6975,13,39,4,4,0,0,0,0,0,0,False,False,False,0,4,2020-09-18T17:36:26.02,0,,0.0
2020,2,2809,795,7,6975,2,4,9,5,9,4,7,2,7,0,False,False,False,0,3,2020-09-23T14:20:47.493,9,,2.0
2020,2,2809,805,7,3445,2,2,4,4,4,0,4,0,4,6,False,False,False,0,2,2020-09-23T14:22:20.943,4,,0.0
2020,2,2809,875,7,931,3,4,9,4,0,0,0,0,0,0,False,False,False,0,3,2020-09-23T16:19:47.113,0,,0.0
2020,2,2809,880,7,7659,2,4,10,5,5,0,5,0,5,0,False,False,False,0,3,2020-09-18T18:08:51.54,5,,0.0
2020,2,2809,885,7,7659,13,6,4,12,0,0,0,0,0,0,False,False,False,0,3,2020-09-23T14:23:38.763,0,,0.0
2020,2,2809,890,7,3521,2,2,10,5,17,12,14,3,14,0,False,False,False,0,3,2020-09-18T18:19:09.463,17,,3.0
2020,2,2809,895,7,931,2,31,10,0,6,6,3,3,3,0,False,False,False,0,1,2020-09-23T15:50:48.667,6,,3.0
2020,2,2809,900,7,6975,2,32,3,0,3,3,2,1,2,0,False,False,False,0,4,2020-09-23T16:19:56.723,3,,1.0
2020,2,2809,905,7,6975,2,4,10,5,6,1,5,1,5,0,False,False,False,0,3,2020-09-18T18:27:26.603,6,,1.0
2020,2,2809,915,7,931,13,12,5,7,0,0,0,0,0,0,False,False,False,0,3,2021-02-15T20:16:56.233,0,,0.0
2020,2,2809,920,7,6975,2,47,5,3,5,2,5,0,5,0,False,False,False,0,4,2020-09-23T16:20:08.053,5,,0.0
2020,2,2809,925,7,931,2,28,10,3,4,1,3,1,3,0,False,False,False,0,1,2020-09-18T18:32:37.44,4,,1.0
2020,2,2809,930,7,3445,2,5,3,5,10,5,5,5,5,0,False,False,False,1,3,2020-09-18T18:34:20.063,10,,5.0
2020,2,2809,940,7,7659,13,19,2,19,0,0,0,0,0,0,False,False,False,0,2,2020-09-19T21:23:31.047,0,,0.0
2020,2,2809,945,7,6975,2,5,10,10,10,0,10,0,10,0,False,False,False,0,4,2020-09-23T16:20:16.633,10,,0.0
2020,2,2809,950,7,6975,13,17,10,9,0,0,0,0,0,0,False,False,False,0,4,2020-09-23T16:20:29.517,0,,0.0
2020,2,2809,955,7,910,13,5,5,9,0,0,0,0,0,0,False,False,False,0,3,2020-09-23T15:40:04.09,0,,0.0
2020,2,2809,960,7,3521,2,8,4,9,9,0,9,0,9,6,False,False,False,0,3,2020-09-23T16:20:37.037,9,,0.0
2020,2,2810,20,6,464,2,8,8,15,17,2,17,0,17,0,False,False,False,0,2,2020-09-21T10:25:49.003,17,,0.0
2020,2,2810,30,6,4471,2,50,9,-4,15,19,15,0,15,0,True,False,False,0,3,2021-02-15T17:18:44.587,15,,0.0
2020,2,2810,60,6,464,2,13,4,3,2,-1,2,0,2,0,False,False,False,0,3,2020-09-21T10:43:57.36,2,,0.0
2020,2,2810,70,6,6786,2,12,5,7,28,21,18,10,18,6,False,False,False,4,1,2021-02-15T20:19:30.053,28,,10.0
2020,2,2810,90,21,3680,2,4,10,5,5,0,5,0,5,0,False,False,False,0,3,2020-09-21T11:00:45.667,5,,0.0
2020,2,2810,115,6,6328,3,11,6,16,0,0,0,0,0,0,False,False,False,0,3,2020-09-21T17:46:56.863,0,,0.0
2020,2,2810,135,21,3680,13,4,5,6,0,0,0,0,0,0,False,False,False,0,2,2020-09-21T11:19:34.993,0,,0.0
2020,2,2810,145,21,3680,13,2,10,6,0,0,0,0,0,0,False,False,False,0,2,2021-02-03T18:11:29.653,0,,0.0
2020,2,2810,160,6,464,13,5,5,5,0,0,0,0,0,0,False,False,False,0,2,2020-09-21T11:30:10.33,0,,0.0
2020,2,2810,170,6,666,2,7,2,15,18,3,17,1,17,0,False,False,False,0,3,2020-09-21T11:35:15.05,18,,1.0
2020,2,2810,180,6,811,2,49,4,-3,9,12,6,3,6,0,False,False,False,0,2,2020-09-24T14:27:54.83,9,,3.0
2020,2,2810,185,6,6328,13,7,2,18,0,0,0,0,0,0,False,False,False,0,3,2020-09-21T17:57:57.113,0,,0.0
2020,2,2810,220,21,7090,2,4,8,17,17,0,17,0,17,0,False,False,False,0,3,2020-09-23T16:42:27.267,17,,0.0
2020,2,2810,235,21,4422,13,26,10,5,0,0,0,0,0,0,False,False,False,0,3,2021-03-04T21:57:58.973,0,,0.0
2020,2,2810,245,6,464,13,4,9,13,0,0,0,0,0,0,False,False,False,0,3,2020-09-21T17:59:30.35,0,,0.0
2020,2,2810,270,6,811,2,50,3,-3,-1,2,-2,1,-2,0,False,False,False,1,2,2021-03-04T13:15:28.84,-1,,1.0
2020,2,2810,280,21,2288,2,6,4,3,15,12,13,2,13,0,False,False,False,0,1,2020-09-21T12:44:34.543,15,,2.0
2020,2,2810,325,6,464,2,6,10,14,14,0,14,0,14,0,False,False,False,0,2,2020-09-24T11:55:50.23,14,,0.0
2020,2,2810,335,6,7725,2,4,7,16,16,0,16,0,16,0,False,False,False,0,3,2020-09-24T14:28:08.213,16,,0.0
2020,2,2810,345,6,7728,2,4,10,12,12,0,12,0,12,0,False,False,False,0,4,2021-02-15T15:31:29.86,12,,0.0
2020,2,2810,360,6,6337,2,44,3,-1,2,3,0,2,0,0,False,False,False,0,1,2020-09-21T13:15:49.99,2,,2.0
2020,2,2810,365,6,6331,2,4,9,11,12,1,12,0,12,0,False,False,False,0,3,2020-09-24T14:28:22.577,12,,0.0
2020,2,2810,375,6,464,13,5,5,3,0,0,0,0,0,0,False,False,False,0,3,2020-09-21T13:23:26.743,0,,0.0
2020,2,2810,380,6,7725,2,12,6,15,15,0,15,0,15,6,False,False,False,0,2,2021-02-17T17:31:15.313,15,,0.0
2020,2,2810,395,21,3680,2,8,7,21,24,3,22,2,22,0,False,False,False,0,2,2020-09-21T17:48:53.127,24,,2.0
2020,2,2810,405,21,576,2,4,9,11,12,1,11,1,11,0,False,False,False,0,3,2020-09-21T13:33:19.2,12,,1.0
2020,2,2810,430,21,7090,2,3,4,13,13,0,13,0,13,0,False,False,False,0,2,2020-09-23T16:48:03.26,13,,0.0
2020,2,2810,465,6,464,13,6,9,13,0,0,0,0,0,0,False,False,False,0,2,2020-09-22T18:49:16.023,0,,0.0
2020,2,2810,470,21,7226,2,53,4,-6,-3,3,-5,2,-5,0,False,False,False,0,4,2020-09-24T14:48:02.803,-3,,2.0
2020,2,2810,475,21,576,2,13,4,6,7,1,7,0,7,0,False,False,False,0,3,2020-09-21T14:08:35.453,7,,0.0
2020,2,2810,480,21,7090,3,2,4,6,0,0,0,0,0,0,False,False,False,0,3,2021-01-28T20:55:40.753,0,,0.0
2020,2,2810,505,6,7725,2,47,5,2,4,2,3,1,3,0,False,True,False,0,3,2021-02-15T20:19:45.19,5,,1.0
2020,2,2810,510,6,6786,2,47,5,1,8,7,2,6,2,0,False,False,False,1,1,2020-09-21T14:24:41.383,8,,6.0
2020,2,2810,530,6,6331,2,12,5,5,5,0,5,0,5,0,False,False,False,0,2,2020-09-21T14:36:13.92,5,,0.0
2020,2,2810,545,6,6328,3,5,3,6,0,0,0,0,0,0,False,False,False,0,3,2020-09-21T14:44:44.313,0,,0.0
2020,2,2810,560,21,4422,2,5,9,6,7,1,6,1,6,0,False,False,False,0,3,2021-02-17T17:31:53.65,7,,1.0
2020,2,2810,565,21,4422,13,3,3,7,0,0,0,0,0,0,False,False,False,0,3,2021-01-28T20:58:19.707,0,,0.0
2020,2,2810,570,21,2288,2,28,10,-1,11,12,4,7,4,0,False,False,False,0,1,2020-09-21T14:53:13.393,11,,7.0
2020,2,2810,580,21,576,2,8,8,15,20,5,20,0,20,0,False,False,False,0,3,2020-09-21T14:56:32.25,20,,0.0
2020,2,2810,585,21,5015,2,13,10,4,12,8,9,3,9,0,False,False,False,0,3,2020-09-24T14:28:37.813,12,,3.0
2020,2,2810,595,21,2288,2,6,10,4,7,3,7,0,7,0,False,False,False,0,1,2020-09-21T15:12:58.81,7,,
2020,2,2810,600,21,4422,2,4,10,6,6,0,6,0,6,0,False,False,False,0,2,2020-09-21T15:15:07.15,6,,0.0
2020,2,2810,605,21,576,2,2,9,3,4,1,4,0,4,0,False,False,False,0,2,2020-09-21T15:17:16.543,4,,0.0
2020,2,2810,615,21,7226,2,46,3,2,2,0,2,0,2,0,True,False,False,0,3,2021-02-15T17:23:31.707,2,,0.0
2020,2,2810,645,6,6786,2,46,9,2,9,7,7,2,7,0,False,False,False,0,1,2020-09-21T15:28:22.197,9,,2.0
2020,2,2810,655,6,2071,13,43,7,26,0,0,0,0,0,0,False,False,False,0,4,2020-09-21T15:33:24.347,0,,0.0
2020,2,2810,665,6,464,13,19,2,21,0,0,0,0,0,0,False,False,False,0,2,2021-03-04T21:58:25.147,0,,0.0
2020,2,2810,670,21,4422,2,28,4,3,12,9,9,3,9,0,False,False,False,0,4,2020-09-24T14:33:37.783,12,,3.0
2020,2,2810,680,21,4422,2,4,9,8,10,2,8,2,8,0,False,False,False,0,3,2020-09-21T15:46:19.647,10,,2.0
2020,2,2810,685,21,7226,13,4,4,9,0,0,0,0,0,0,False,False,False,0,3,2020-09-21T15:55:30.307,0,,
2020,2,2810,690,21,5015,2,2,4,11,11,0,11,0,11,0,False,False,False,0,2,2020-09-24T14:31:54.853,11,,0.0
2020,2,2810,700,21,4422,2,46,3,1,8,7,7,1,7,0,False,False,False,0,3,2020-09-21T16:01:21.08,8,,1.0
2020,2,2810,710,21,7226,13,5,3,11,0,0,0,0,0,0,False,False,False,0,3,2020-09-21T16:05:18.56,0,,0.0
2020,2,2810,715,21,6444,13,6,9,14,0,0,0,0,0,0,False,False,False,0,2,2020-09-23T16:50:46.447,0,,0.0
2020,2,2810,775,6,464,13,2,4,4,0,0,0,0,0,0,False,False,False,0,3,2020-09-21T16:36:03.583,0,,0.0
2020,2,2810,780,6,536,2,12,4,3,4,1,4,0,4,0,False,False,False,0,5,2021-02-15T20:20:22.747,4,,0.0
2020,2,2810,820,21,6444,13,4,5,5,0,0,0,0,0,0,False,False,False,0,2,2020-09-21T16:49:47.477,0,,0.0
2020,2,2810,830,21,2288,3,45,5,-2,0,0,0,0,0,0,False,False,False,0,1,2020-09-21T16:53:37.147,0,,0.0
2020,2,2810,835,21,4422,2,4,9,8,22,14,8,14,8,0,False,False,False,1,3,2020-09-21T18:00:25.75,22,,14.0
2020,2,2810,840,21,7090,13,5,3,12,0,0,0,0,0,0,False,False,False,0,2,2020-09-21T17:04:20.51,0,,0.0
2020,2,2810,850,21,576,2,4,3,5,4,-1,5,-1,5,0,False,False,False,0,3,2020-09-21T17:08:56.33,4,,-1.0
2020,2,2810,855,21,2288,2,4,4,5,6,1,6,0,6,0,False,False,False,0,1,2020-09-21T17:12:35.27,6,,0.0
2020,2,2810,865,21,7090,13,3,5,12,0,0,0,0,0,0,False,False,False,0,2,2020-09-21T17:50:07.94,0,,0.0
2020,2,2810,870,21,5015,2,3,5,9,9,0,9,0,9,0,False,False,False,0,2,2020-09-21T17:18:53.453,9,,0.0
2020,2,2810,875,21,7090,2,4,9,3,3,0,3,0,3,0,False,False,False,0,3,2020-09-21T17:22:12.55,3,,0.0
2020,2,2810,885,21,2288,2,46,3,3,4,1,4,0,4,0,False,False,False,0,1,2020-09-21T17:25:32.507,4,,0.0
2020,2,2810,890,21,576,13,12,10,10,0,0,0,0,0,0,False,False,False,0,3,2021-03-08T16:40:29.983,0,,
2020,2,2811,20,2,6247,3,2,4,7,0,0,0,0,0,0,False,False,False,0,3,2020-09-21T09:54:07.12,0,,0.0
2020,2,2811,40,9,6446,13,5,10,4,0,0,0,0,0,0,False,False,False,0,4,2021-03-01T22:52:23.247,0,,0.0
2020,2,2811,55,2,5214,13,35,7,15,0,0,0,0,0,0,False,False,False,0,4,2020-09-21T10:11:06.577,0,,0.0
2020,2,2811,60,2,6247,13,8,1,17,0,0,0,0,0,0,False,False,False,0,2,2020-09-21T17:33:34.967,0,,0.0
2020,2,2811,75,9,322,13,9,2,19,0,0,0,0,0,0,False,False,False,0,3,2020-09-21T10:19:36.83,0,,0.0
2020,2,2811,85,2,5223,2,22,6,19,22,3,22,0,22,6,False,False,False,0,2,2021-02-16T12:25:03.92,22,,0.0
2020,2,2811,100,9,6446,2,46,3,3,15,12,13,2,13,0,False,False,False,0,4,2020-09-21T17:49:33.313,15,,2.0
2020,2,2811,110,9,4202,2,48,10,-3,8,11,1,7,1,0,False,False,False,1,1,2021-02-16T12:27:11.783,8,,7.0
2020,2,2811,125,2,5214,2,53,9,-1,2,3,0,2,0,0,False,False,False,0,4,2020-09-24T18:10:42.653,2,,2.0
2020,2,2811,135,2,5214,2,33,6,22,42,20,42,0,42,6,False,False,False,0,4,2020-09-21T17:30:14.367,42,,0.0
2020,2,2811,150,9,6446,2,4,3,6,10,4,8,2,8,0,False,False,False,0,3,2020-09-21T17:49:53.067,10,,2.0
2020,2,2811,160,9,7816,2,5,3,9,10,1,9,1,9,0,False,False,False,0,3,2020-09-21T10:57:06.44,10,,1.0
2020,2,2811,165,9,4202,13,28,9,0,0,0,0,0,0,0,False,False,False,0,1,2020-09-21T11:00:12.337,0,,0.0
2020,2,2811,170,9,3755,13,4,3,10,0,0,0,0,0,0,False,False,False,0,2,2020-09-21T17:26:07.57,0,,0.0
2020,2,2811,180,2,5223,13,9,6,27,0,0,0,0,0,0,False,False,False,0,2,2020-09-21T11:09:29.593,0,,0.0
2020,2,2811,185,2,4670,2,4,4,2,4,2,4,0,4,0,False,False,False,0,1,2020-09-21T11:11:09.777,4,,0.0
2020,2,2811,200,9,6446,2,53,10,-3,9,12,8,1,8,0,False,True,True,0,4,2020-09-24T15:32:17.937,8,,1.0
2020,2,2811,215,2,5214,13,6,10,11,0,0,0,0,0,0,False,False,False,0,3,2021-02-25T14:07:57.79,0,,0.0
2020,2,2811,220,2,661,13,9,2,25,0,0,0,0,0,0,False,False,False,0,2,2020-09-21T17:10:47.18,0,,
2020,2,2811,250,9,322,2,5,5,5,11,6,11,0,11,0,False,False,False,0,2,2020-09-21T11:36:38.53,11,,0.0
2020,2,2811,265,9,7816,2,30,5,-2,9,11,6,3,6,0,False,False,False,0,4,2020-09-24T18:11:38.93,9,,3.0
2020,2,2811,285,9,4202,2,49,10,-4,-3,1,-3,0,-3,0,False,False,False,0,2,2020-09-21T11:48:21.91,-3,,0.0
2020,2,2811,290,9,2568,2,4,4,6,10,4,8,2,8,0,False,False,False,0,3,2020-09-21T11:51:14.827,10,,2.0
2020,2,2811,320,2,5223,2,3,2,22,25,3,23,2,23,0,False,False,False,0,3,2020-09-21T12:01:23.21,25,,2.0
2020,2,2811,325,2,2835,3,12,5,4,0,0,0,0,0,0,False,False,False,0,1,2021-03-08T16:42:15.9,0,,0.0
2020,2,2811,345,2,661,2,30,10,2,5,3,4,1,4,0,False,False,False,0,3,2020-09-21T17:12:46.457,5,,1.0
2020,2,2811,360,2,6247,2,30,5,3,4,1,4,0,4,0,True,False,False,0,4,2021-02-16T12:27:55.03,4,,0.0
2020,2,2811,380,2,5223,2,5,5,3,3,0,3,0,3,6,True,False,False,0,3,2020-09-21T12:23:10.16,3,,0.0
2020,2,2811,405,9,4202,2,48,9,-1,11,12,4,7,4,0,False,False,False,1,1,2020-09-24T16:22:25.42,11,,7.0
2020,2,2811,415,9,7183,2,44,3,-5,3,8,-2,5,-2,0,False,False,False,1,1,2020-09-21T12:32:35.667,3,,5.0
2020,2,2811,420,9,6446,2,4,9,5,8,3,7,1,7,0,True,False,False,0,3,2021-02-24T16:11:34.863,8,,1.0
2020,2,2811,425,9,322,2,5,5,5,12,7,5,7,5,0,False,False,False,1,3,2020-09-21T12:36:57.523,12,,7.0
2020,2,2811,430,9,6436,2,6,7,19,20,1,19,1,19,0,False,False,False,0,3,2020-09-22T18:33:03.223,20,,1.0
2020,2,2811,440,9,6436,13,2,9,9,0,0,0,0,0,0,False,False,False,0,2,2020-09-21T12:46:41.44,0,,0.0
2020,2,2811,450,9,4202,2,46,3,3,6,3,6,0,6,0,False,False,False,0,1,2020-09-21T12:49:09.37,6,,0.0
2020,2,2811,490,2,6247,2,2,9,8,14,6,14,0,14,0,False,False,False,0,3,2020-09-21T12:59:12.62,14,,0.0
2020,2,2811,495,2,5223,2,3,10,12,11,-1,11,0,11,0,False,False,False,0,3,2020-09-21T13:01:35.477,11,,0.0
2020,2,2811,505,2,5223,2,35,6,20,24,4,23,1,23,0,False,False,False,0,3,2020-09-21T13:06:11.933,24,,1.0
2020,2,2811,510,2,661,13,7,2,23,0,0,0,0,0,0,False,False,False,0,3,2020-09-21T13:07:50.027,0,,0.0
2020,2,2811,515,2,6247,13,32,3,4,0,0,0,0,0,0,False,False,False,0,3,2020-09-21T13:09:46.65,0,,0.0
2020,2,2811,545,9,322,13,24,6,17,0,0,0,0,0,0,True,False,False,0,3,2020-09-22T18:34:59.273,0,,0.0
2020,2,2811,550,9,322,2,6,10,4,4,0,4,0,4,0,False,False,False,0,2,2020-09-21T13:17:56.673,4,,0.0
2020,2,2811,555,9,7816,2,8,1,20,37,17,37,0,37,0,False,False,False,0,3,2020-09-21T13:20:19.79,37,,0.0
2020,2,2811,560,9,6446,2,32,10,2,18,16,15,3,15,0,False,False,False,0,4,2020-09-21T17:51:02.887,18,,3.0
2020,2,2811,585,2,2835,2,30,10,-2,1,3,0,1,0,0,False,False,False,0,1,2020-09-21T13:29:54.677,1,,1.0
2020,2,2811,595,2,5223,2,5,5,6,10,4,9,1,9,0,True,False,False,0,3,2020-09-21T13:34:04.843,10,,1.0
2020,2,2811,600,2,5214,2,31,4,1,2,1,1,1,1,0,False,False,False,0,4,2020-09-21T13:36:07.35,2,,1.0
2020,2,2811,610,2,6247,2,13,9,5,6,1,6,0,6,0,False,False,False,0,2,2020-09-21T13:39:54.38,6,,0.0
2020,2,2811,620,2,4670,2,48,5,-4,7,11,6,1,6,0,False,False,False,0,1,2020-09-21T13:45:45.86,7,,1.0
2020,2,2811,625,2,661,3,17,7,38,0,0,0,0,0,0,False,False,False,0,3,2021-02-16T12:28:57.587,0,,0.0
2020,2,2811,640,9,4202,2,48,10,-3,8,11,0,8,0,0,False,False,False,1,1,2021-03-02T19:28:40.507,8,,8.0
2020,2,2811,645,9,322,2,8,7,44,58,14,54,4,54,0,False,False,False,0,3,2020-09-21T14:02:49.637,58,,4.0
2020,2,2811,660,9,6446,2,32,10,4,5,1,5,0,5,0,True,False,False,0,4,2020-09-24T17:49:05.753,5,,0.0
2020,2,2811,700,2,5214,2,13,4,2,22,20,19,3,19,0,False,False,False,0,3,2020-09-21T14:28:40.087,22,,3.0
2020,2,2811,710,2,5223,13,17,8,41,0,0,0,0,0,0,False,False,False,0,3,2020-09-21T18:00:05.117,0,,0.0
2020,2,2811,720,2,6247,2,5,5,2,2,0,2,0,2,0,False,False,False,0,3,2020-09-21T14:34:41.463,2,,0.0
2020,2,2811,725,2,661,2,5,3,11,19,8,17,2,17,0,False,False,False,0,3,2021-02-16T12:25:25.287,19,,2.0
2020,2,2811,750,2,6247,2,2,9,8,8,0,8,0,8,6,True,False,False,0,3,2020-09-21T14:45:15.51,8,,0.0
2020,2,2811,770,9,322,3,5,2,17,0,0,0,0,0,0,False,False,False,0,2,2020-09-24T16:22:25.42,0,,0.0
2020,2,2811,780,9,2568,13,13,3,2,0,0,0,0,0,0,False,False,False,0,4,2020-09-21T14:54:40.273,0,,0.0
2020,2,2811,795,2,5214,2,5,3,3,4,1,4,0,4,0,True,False,False,0,3,2020-09-21T15:02:44.623,4,,0.0
2020,2,2811,800,2,6247,2,38,9,4,12,8,10,2,10,0,False,False,False,0,3,2020-09-21T15:04:44.047,12,,2.0
2020,2,2811,815,2,5223,2,2,10,12,14,2,12,2,12,0,False,False,False,0,2,2020-09-21T15:12:52.133,14,,2.0
2020,2,2811,830,2,5214,13,12,5,7,0,0,0,0,0,0,False,False,False,0,3,2020-09-21T15:17:58.09,0,,0.0
2020,2,2811,850,9,6446,2,4,9,5,6,1,5,1,5,0,False,False,False,0,3,2020-09-21T17:51:46.853,6,,1.0
2020,2,2811,855,9,7816,13,4,4,9,0,0,0,0,0,0,False,False,False,0,3,2020-09-21T15:27:15.493,0,,0.0
2020,2,2811,860,9,2568,2,12,6,24,24,0,24,0,24,0,False,False,False,0,3,2021-03-08T16:42:58.787,24,,0.0
2020,2,2811,870,9,6436,13,29,6,18,0,0,0,0,0,0,False,False,False,0,2,2020-09-24T18:12:36.037,0,,0.0
2020,2,2811,875,9,7816,2,35,3,11,12,1,11,1,11,0,False,False,False,0,3,2020-09-21T15:36:02.04,12,,1.0
2020,2,2811,880,9,322,2,4,10,4,4,0,4,0,4,0,False,False,False,0,3,2020-09-21T15:37:54.127,4,,0.0
2020,2,2811,885,9,6446,2,4,4,5,8,3,6,2,6,0,False,False,False,0,3,2020-09-24T15:28:26.907,8,,2.0
2020,2,2811,890,9,4446,2,2,9,7,8,1,8,0,8,0,False,False,False,0,2,2020-09-21T15:41:29.64,8,,0.0
2020,2,2811,895,9,6446,2,35,4,10,10,0,10,0,10,6,False,False,False,0,3,2020-09-24T16:22:25.42,10,,0.0
2020,2,2811,940,2,7303,2,4,9,7,10,3,8,2,8,0,False,False,False,0,2,2020-09-21T15:58:40.35,10,,2.0
2020,2,2811,950,9,322,2,5,5,6,11,5,10,1,10,0,False,False,False,0,3,2020-09-24T18:15:37.757,11,,1.0
2020,2,2811,955,9,4202,2,4,10,-3,3,6,3,0,3,0,False,False,False,0,1,2020-09-24T16:22:25.42,3,,0.0
2020,2,2811,960,9,7816,13,4,3,11,0,0,0,0,0,0,False,False,False,0,3,2021-02-17T17:34:34.407,0,,0.0
2020,2,2811,965,9,4446,2,6,4,14,47,33,27,20,27,0,False,False,False,0,3,2020-09-21T17:26:48.053,20,,20.0
2020,2,2811,970,9,7816,2,51,3,0,14,14,12,2,12,0,False,False,False,0,3,2020-09-21T16:14:11.227,14,,2.0
2020,2,2811,975,9,6436,2,19,6,35,38,3,36,2,36,0,False,False,False,0,2,2020-09-24T16:22:25.42,38,,2.0
2020,2,2811,990,9,6436,13,9,3,1,0,0,0,0,0,0,False,False,False,0,2,2021-02-25T14:34:17.327,0,,
2020,2,2811,995,9,7816,13,47,5,1,0,0,0,0,0,0,False,False,False,0,3,2020-09-21T16:23:59.53,0,,0.0
2020,2,2811,1020,9,6436,13,20,2,21,0,0,0,0,0,0,False,False,False,0,2,2020-09-24T16:22:25.42,0,,0.0
2020,2,2811,1025,9,7816,2,5,5,9,24,15,23,1,23,0,False,False,False,0,3,2020-09-21T16:36:04.743,24,,1.0
2020,2,2812,10,11,914,2,39,10,5,5,0,5,0,5,0,True,False,False,0,3,2020-09-23T00:24:09.96,5,,0.0
2020,2,2812,15,11,6810,2,7,6,15,29,14,15,14,15,0,False,False,False,2,4,2020-09-21T17:44:58.533,29,,14.0
2020,2,2812,35,11,914,2,26,9,4,6,2,4,2,4,0,False,False,False,0,3,2020-09-21T10:45:47.887,6,,2.0
2020,2,2812,80,12,6357,2,13,9,3,15,12,15,0,15,0,False,False,False,0,3,2020-09-24T15:13:58.023,15,,0.0
2020,2,2812,90,12,467,2,32,10,1,4,3,3,1,3,0,True,False,False,0,4,2021-02-25T14:37:59.23,4,,1.0
2020,2,2812,95,12,6876,3,30,10,-1,0,0,0,0,0,0,False,False,False,0,4,2020-09-21T11:23:26.29,0,,0.0
2020,2,2812,100,12,4511,13,12,6,26,0,0,0,0,0,0,False,False,False,0,2,2021-03-09T15:29:29.48,0,,0.0
2020,2,2812,105,12,6691,2,6,4,10,10,0,10,0,10,0,False,False,False,0,2,2020-09-21T16:45:36.227,10,,0.0
2020,2,2812,115,12,4537,13,44,3,-2,0,0,0,0,0,0,False,False,False,0,1,2020-09-24T18:29:26.09,0,,0.0
2020,2,2812,120,12,4537,13,20,6,24,0,0,0,0,0,0,False,False,False,0,2,2020-09-24T18:42:59.267,0,,0.0
2020,2,2812,140,11,7732,2,16,10,5,9,4,7,2,7,0,False,False,False,0,1,2020-09-21T11:49:02.727,9,,2.0
2020,2,2812,150,11,914,2,4,10,4,8,4,7,1,7,0,True,False,False,0,3,2020-09-21T17:26:16.12,8,,1.0
2020,2,2812,170,11,7732,2,16,9,5,14,9,11,3,11,0,False,False,False,0,1,2020-09-21T11:59:52.817,14,,3.0
2020,2,2812,185,11,3820,3,26,5,3,0,0,0,0,0,0,False,False,False,0,2,2020-09-24T18:53:21.12,0,,0.0
2020,2,2812,195,11,914,2,4,10,4,4,0,4,0,4,6,False,False,False,0,3,2020-09-24T18:55:07.327,4,,0.0
2020,2,2812,220,12,6691,13,22,6,30,0,0,0,0,0,0,False,False,False,0,3,2021-03-09T15:31:05.987,0,,
2020,2,2812,230,12,4537,2,13,4,4,22,18,18,4,18,0,False,False,False,0,3,2020-09-22T17:36:57.75,22,,4.0
2020,2,2812,235,12,556,2,5,5,3,11,8,11,0,11,0,False,False,False,0,3,2020-09-21T12:24:21.15,11,,0.0
2020,2,2812,240,12,3965,2,26,10,4,4,0,4,0,4,0,False,False,False,0,3,2020-09-24T17:29:34.833,4,,0.0
2020,2,2812,245,12,6691,2,13,10,4,10,6,6,4,6,0,False,False,False,0,3,2020-09-24T15:13:58.023,10,,4.0
2020,2,2812,260,12,4537,2,46,9,1,7,6,7,0,7,6,False,False,False,0,1,2021-02-17T17:40:32.607,7,,0.0
2020,2,2812,290,11,914,3,35,6,27,0,0,0,0,0,0,True,False,False,0,3,2021-03-09T15:32:31.547,0,,0.0
2020,2,2812,295,11,100,13,11,2,23,0,0,0,0,0,0,False,False,False,0,3,2021-03-09T15:33:29.4,0,,0.0
2020,2,2812,300,11,100,2,5,3,11,13,2,13,0,13,0,False,False,False,0,3,2020-09-21T12:49:51.66,13,,0.0
2020,2,2812,305,11,914,3,30,10,-6,0,0,0,0,0,0,True,False,False,0,4,2020-09-24T19:25:41.42,0,,0.0
2020,2,2812,310,11,4487,2,51,10,-3,0,3,-1,1,-1,0,False,False,False,0,3,2020-09-24T17:13:31.547,0,,1.0
2020,2,2812,315,11,6810,2,53,9,-2,10,12,8,2,8,0,False,False,False,0,4,2020-09-21T12:57:57.623,10,,2.0
2020,2,2812,340,12,556,2,6,10,11,17,6,17,0,17,0,False,False,False,0,3,2020-09-24T19:19:46.967,17,,0.0
2020,2,2812,345,12,3965,2,45,10,-7,4,11,1,3,1,0,True,False,False,0,3,2021-03-09T15:35:14.71,4,,
2020,2,2812,350,12,6357,2,12,3,5,8,3,8,0,8,0,False,False,False,0,2,2020-09-21T17:27:48.783,8,,0.0
2020,2,2812,365,12,6357,13,24,2,35,0,0,0,0,0,0,False,False,False,0,2,2020-09-21T13:20:01.427,0,,0.0
2020,2,2812,410,12,6357,13,9,2,26,0,0,0,0,0,0,False,False,False,0,2,2021-03-09T15:36:44.37,0,,
2020,2,2812,415,12,556,2,2,10,4,8,4,7,1,7,0,False,False,False,0,3,2020-09-21T16:57:21.08,8,,1.0
2020,2,2812,425,12,6357,13,4,5,5,0,0,0,0,0,0,False,False,False,0,2,2020-09-24T15:32:33.09,0,,0.0
2020,2,2812,430,12,4511,2,4,5,11,11,0,11,0,11,6,False,False,False,0,3,2020-09-21T13:37:55.153,11,,0.0
2020,2,2812,445,11,7732,2,31,10,-1,12,13,10,2,10,0,False,False,False,0,1,2020-09-21T13:41:03.75,12,,2.0
2020,2,2812,455,11,6810,2,2,4,6,19,13,19,0,19,0,False,False,False,0,3,2020-09-21T13:43:07.563,19,,0.0
2020,2,2812,505,11,6810,2,13,9,2,4,2,4,0,4,0,False,False,False,0,4,2020-09-24T15:13:58.023,4,,0.0
2020,2,2812,510,11,100,3,4,10,7,0,0,0,0,0,0,True,False,False,0,3,2020-09-21T13:59:24.2,0,,0.0
2020,2,2812,530,12,4537,3,5,5,5,0,0,0,0,0,0,False,False,False,0,2,2021-02-17T17:43:52.63,0,,0.0
2020,2,2812,535,12,4537,2,19,2,27,30,3,29,1,29,0,False,False,False,0,2,2020-09-22T17:52:04.557,30,,1.0
2020,2,2812,545,12,4511,2,35,10,10,14,4,14,0,14,0,False,False,False,0,4,2020-09-21T17:29:29.067,14,,0.0
2020,2,2812,550,12,6876,3,12,5,13,0,0,0,0,0,0,False,False,False,0,3,2021-02-25T14:41:28.113,0,,
2020,2,2812,555,12,6691,13,9,6,28,0,0,0,0,0,0,False,False,False,0,3,2021-03-09T15:38:52.123,0,,0.0
2020,2,2812,560,12,6691,3,6,10,13,0,0,0,0,0,0,False,False,False,0,3,2020-09-21T14:18:07.377,0,,0.0
2020,2,2812,575,11,100,13,46,3,2,0,0,0,0,0,0,True,False,False,0,3,2021-03-04T21:59:54.033,0,,0.0
2020,2,2812,590,11,6341,3,16,9,4,0,0,0,0,0,0,False,False,False,0,1,2020-09-21T14:26:57.857,0,,0.0
2020,2,2812,595,11,7733,2,2,9,5,9,4,8,1,8,0,False,False,False,1,2,2020-09-24T15:13:58.023,9,,1.0
2020,2,2812,600,11,100,13,11,2,16,0,0,0,0,0,0,False,False,False,0,3,2020-09-24T15:13:58.023,0,,0.0
2020,2,2812,625,12,6691,2,13,10,5,25,20,22,3,22,0,False,False,False,0,2,2020-09-24T15:13:58.023,25,,3.0
2020,2,2812,650,12,6691,13,2,10,5,0,0,0,0,0,0,False,False,False,0,2,2021-02-25T14:42:41,0,,
2020,2,2812,655,12,6357,3,18,5,0,0,0,0,0,0,0,False,False,False,0,2,2020-09-24T15:13:58.023,0,,0.0
2020,2,2812,660,12,6357,13,20,2,17,0,0,0,0,0,0,False,False,False,0,3,2021-03-09T15:40:00.053,0,,0.0
2020,2,2812,670,12,4537,13,11,3,2,0,0,0,0,0,0,False,False,False,0,1,2021-02-25T14:44:10.427,0,,0.0
2020,2,2812,685,11,7732,2,47,5,0,8,8,8,0,8,0,True,False,False,0,3,2020-09-21T14:56:55.877,8,,0.0
2020,2,2812,695,11,7733,2,46,3,0,9,9,9,0,9,0,True,False,False,0,4,2020-09-21T14:59:31.09,9,,0.0
2020,2,2812,700,11,7732,2,4,4,2,17,15,14,3,14,0,False,False,False,1,1,2020-09-21T15:00:59.07,17,,3.0
2020,2,2812,710,11,100,2,4,9,4,8,4,6,2,6,0,False,False,False,0,3,2020-09-21T15:33:06.523,8,,2.0
2020,2,2812,725,11,3820,2,8,2,24,24,0,24,0,24,6,False,False,False,0,3,2020-09-21T15:39:53.153,24,,0.0
2020,2,2812,745,12,467,2,4,3,6,8,2,7,1,7,0,False,False,False,0,2,2020-09-24T19:08:55.767,8,,
2020,2,2812,755,12,6357,2,9,2,36,41,5,25,16,25,0,False,False,False,0,3,2020-09-21T17:28:30.05,41,,16.0
2020,2,2812,770,12,4537,2,46,3,3,9,6,8,1,8,0,False,False,False,0,1,2021-02-17T17:47:20.37,9,,1.0
2020,2,2812,825,12,494,2,12,5,-6,-6,0,-6,0,-6,0,False,False,False,0,6,2021-02-17T17:48:22.307,-6,,0.0
2020,2,2812,840,11,7733,2,6,8,15,36,21,24,12,24,0,False,False,False,0,2,2020-09-24T15:13:58.023,36,,12.0
2020,2,2812,845,11,100,13,35,7,19,0,0,0,0,0,0,False,False,False,0,3,2020-09-24T17:38:43.537,0,,0.0
2020,2,2812,860,11,6812,13,19,6,50,0,0,0,0,0,0,False,False,False,0,2,2020-09-21T16:19:23.85,0,,0.0
2020,2,2813,10,18,1381,2,30,9,0,0,0,0,0,0,0,False,False,False,0,2,2020-09-21T10:19:41.45,0,,0.0
2020,2,2813,15,18,1381,2,5,2,18,18,0,18,0,18,0,False,False,False,0,3,2020-09-23T13:48:23.16,18,,0.0
2020,2,2813,20,18,6907,13,30,5,-4,0,0,0,0,0,0,False,False,False,0,4,2020-09-21T16:58:16.32,0,,0.0
2020,2,2813,30,18,1381,2,5,5,13,13,0,13,0,13,0,False,False,False,0,3,2020-09-21T10:29:56.677,13,,0.0
2020,2,2813,40,18,6897,13,12,10,11,0,0,0,0,0,0,False,False,False,0,2,2020-09-24T15:13:39.623,0,,0.0
2020,2,2813,45,18,6907,13,5,9,11,0,0,0,0,0,0,False,False,False,0,4,2020-09-24T13:52:16.31,0,,
2020,2,2813,85,14,7582,2,51,9,-6,5,11,2,3,2,0,False,False,False,0,1,2020-09-21T10:59:55.853,5,,3.0
2020,2,2813,120,14,4449,2,45,10,1,3,2,3,0,3,0,True,False,False,0,1,2020-09-21T11:14:09.657,3,,0.0
2020,2,2813,130,14,7584,2,2,10,4,7,3,5,2,5,0,False,False,False,0,2,2020-09-21T11:17:35.89,7,,2.0
2020,2,2813,165,14,7582,2,32,9,-4,5,9,3,2,3,0,False,False,False,1,1,2020-09-24T15:11:32.2,5,,
2020,2,2813,180,14,5197,13,2,10,6,0,0,0,0,0,0,False,False,False,0,3,2021-03-04T22:02:25.34,0,,0.0
2020,2,2813,190,18,813,13,17,7,24,0,0,0,0,0,0,False,False,False,0,4,2020-09-22T14:13:46.697,0,,0.0
2020,2,2813,205,14,7584,2,4,9,11,16,5,13,3,13,0,False,False,False,0,3,2020-09-24T13:52:16.31,16,,3.0
2020,2,2813,210,14,7584,2,2,9,5,9,4,6,3,6,0,False,False,False,0,2,2020-09-21T11:46:48.67,9,,3.0
2020,2,2813,240,18,6900,2,12,9,2,3,1,3,0,3,0,False,False,False,0,1,2020-09-22T14:14:17.65,3,,0.0
2020,2,2813,245,18,6907,2,4,10,13,19,6,17,2,17,0,True,False,False,0,3,2020-09-21T16:59:52.7,19,,
2020,2,2813,260,14,5197,2,53,9,-4,16,20,14,2,14,0,False,False,False,0,4,2020-09-24T15:15:17.917,16,,2.0
2020,2,2813,275,14,1114,13,4,9,14,0,0,0,0,0,0,False,False,False,0,3,2020-09-21T12:25:20.743,0,,
2020,2,2813,280,14,1114,3,9,6,42,0,0,0,0,0,0,False,False,False,0,3,2021-02-25T14:49:17.007,0,,0.0
2020,2,2813,290,14,1114,13,7,2,33,0,0,0,0,0,0,False,False,False,0,2,2020-09-22T18:29:26.357,0,,0.0
2020,2,2813,300,18,6907,2,30,5,1,3,2,3,0,3,0,False,False,False,0,4,2020-09-21T12:38:56.563,3,,0.0
2020,2,2813,310,18,1381,13,7,2,20,0,0,0,0,0,0,False,False,False,0,2,2020-09-21T12:48:30.273,0,,0.0
2020,2,2813,325,14,6543,2,16,4,4,4,0,4,0,4,0,False,False,False,0,1,2020-09-21T12:52:52.83,4,,0.0
2020,2,2813,335,14,5197,2,4,10,12,14,2,13,1,13,0,False,False,False,0,3,2020-09-21T12:55:55.333,14,,1.0
2020,2,2813,340,14,5197,2,7,2,20,33,13,33,0,33,0,False,False,False,0,4,2020-09-24T14:45:16.407,33,,0.0
2020,2,2813,360,14,4449,13,8,4,10,0,0,0,0,0,0,False,False,False,0,3,2020-09-21T13:01:50.61,0,,0.0
2020,2,2813,375,18,6907,13,8,1,19,0,0,0,0,0,0,False,False,False,0,4,2020-09-21T13:05:02.42,0,,0.0
2020,2,2813,380,18,6907,13,5,5,5,0,0,0,0,0,0,False,False,False,0,4,2020-09-21T13:06:40.653,0,,0.0
2020,2,2813,390,18,1381,13,8,7,47,0,0,0,0,0,0,False,False,False,0,3,2021-03-04T22:03:47.853,0,,0.0
2020,2,2813,395,14,7584,13,39,4,7,0,0,0,0,0,0,False,False,False,0,3,2020-09-24T15:18:00.343,0,,0.0
2020,2,2813,400,14,7582,2,45,5,-4,4,8,2,2,2,0,False,False,False,0,1,2020-09-21T13:13:46.723,4,,2.0
2020,2,2813,410,14,7584,2,2,9,4,5,1,5,0,5,0,False,False,False,0,2,2020-09-21T13:15:47.9,5,,0.0
2020,2,2813,435,18,6900,3,48,9,-2,0,0,0,0,0,0,False,False,False,0,1,2020-09-21T13:19:31.42,0,,0.0
2020,2,2813,440,18,7711,2,8,1,22,22,0,22,0,22,0,False,False,False,0,3,2020-09-24T13:52:16.31,22,,0.0
2020,2,2813,450,18,6897,13,35,2,45,0,0,0,0,0,0,False,False,False,0,2,2021-03-08T16:49:46.447,0,,0.0
2020,2,2813,470,14,5197,2,7,2,18,21,3,21,0,21,0,False,False,False,0,4,2020-09-21T13:54:22.73,21,,0.0
2020,2,2813,480,14,1114,2,44,3,-7,-7,0,-7,0,-7,0,True,False,False,0,3,2020-09-24T15:40:45.9,-7,,0.0
2020,2,2813,490,14,1114,2,50,3,-1,7,8,0,7,0,0,False,False,False,0,2,2020-09-21T14:03:13.603,7,,7.0
2020,2,2813,500,18,1381,13,4,5,7,0,0,0,0,0,0,False,False,False,0,2,2020-09-22T14:15:15.89,0,,0.0
2020,2,2813,505,18,6897,13,2,10,14,0,0,0,0,0,0,False,False,False,0,2,2021-03-04T22:04:14.58,0,,0.0
2020,2,2813,520,14,7584,13,3,5,14,0,0,0,0,0,0,False,False,False,0,2,2020-09-24T13:52:16.31,0,,0.0
2020,2,2813,540,18,1381,2,3,6,15,14,-1,14,0,14,0,False,False,False,0,2,2021-02-17T20:11:26.167,14,,
2020,2,2813,570,18,1381,3,2,10,6,0,0,0,0,0,0,False,False,False,0,2,2020-09-24T13:52:16.31,0,,0.0
2020,2,2813,600,14,1114,13,4,9,14,0,0,0,0,0,0,False,False,False,0,2,2020-09-21T17:05:03.007,0,,
2020,2,2813,610,14,4449,2,39,4,7,14,7,7,7,7,0,False,False,False,1,3,2020-09-21T15:03:34.93,14,,7.0
2020,2,2813,645,14,5197,2,7,7,23,27,4,24,3,24,0,False,False,False,0,4,2020-09-21T15:16:20.1,27,,3.0
2020,2,2813,650,14,4449,2,47,5,1,2,1,2,0,2,6,False,False,False,0,3,2020-09-24T14:48:46.58,2,,0.0
2020,2,2813,670,18,4572,2,44,3,-5,2,7,1,1,1,0,False,False,False,1,1,2020-09-21T15:25:14.373,2,,1.0
2020,2,2813,675,18,1381,13,9,2,20,0,0,0,0,0,0,False,False,False,0,3,2021-02-17T20:11:37.983,0,,0.0
2020,2,2813,690,14,1114,2,6,8,18,28,10,25,3,25,0,False,False,False,0,2,2020-09-24T15:21:53.343,28,,3.0
2020,2,2813,725,18,1381,13,6,8,18,0,0,0,0,0,0,False,False,False,0,2,2021-02-25T14:52:44.613,0,,
2020,2,2813,730,18,4572,2,28,9,2,6,4,6,0,6,0,False,False,False,0,1,2020-09-21T16:01:40.037,6,,0.0
2020,2,2813,740,18,6897,2,12,2,20,24,4,21,3,21,0,False,False,False,0,2,2020-09-21T16:53:36.513,24,,3.0
2020,2,2813,750,18,7711,2,6,4,14,17,3,15,2,15,0,False,False,False,0,3,2020-09-24T13:27:49.707,17,,2.0
2020,2,2813,755,18,7711,2,4,3,5,5,0,5,0,5,0,False,False,False,0,2,2020-09-21T16:18:00.21,5,,0.0
2020,2,2813,790,14,7495,2,34,4,-4,6,10,6,0,6,0,True,False,False,0,2,2020-09-22T18:33:06.307,6,,0.0
2020,2,2814,20,4,2853,2,5,5,1,5,4,2,3,2,0,False,False,False,0,3,2020-09-21T10:53:13.89,5,,3.0
2020,2,2814,25,4,2853,13,35,2,23,0,0,0,0,0,0,False,False,False,0,3,2020-09-22T20:32:35.97,0,,0.0
2020,2,2814,40,17,6274,2,8,9,10,17,7,15,2,15,0,False,False,False,0,3,2020-09-22T19:23:41.753,17,,2.0
2020,2,2814,45,17,4305,2,34,4,-5,2,7,0,2,0,0,True,False,False,0,3,2020-09-22T19:34:31.46,2,,2.0
2020,2,2814,50,17,2253,13,4,3,10,0,0,0,0,0,0,False,False,False,0,2,2020-09-21T16:46:40.273,0,,0.0
2020,2,2814,70,4,2853,2,35,8,17,25,8,21,4,21,0,True,False,False,0,3,2020-09-22T17:00:16.103,25,,4.0
2020,2,2814,75,4,6953,13,12,3,12,0,0,0,0,0,0,False,False,False,0,4,2021-03-08T16:51:44.88,0,,0.0
2020,2,2814,80,4,2853,13,5,5,1,0,0,0,0,0,0,False,False,False,0,3,2020-09-21T11:18:12.163,0,,0.0
2020,2,2814,85,4,1412,2,35,7,15,15,0,15,0,15,0,False,False,False,0,3,2020-09-21T11:21:40.573,15,,0.0
2020,2,2814,95,4,594,2,35,6,26,26,0,26,0,26,0,False,False,False,0,3,2021-02-17T14:30:31.217,26,,0.0
2020,2,2814,100,4,2853,2,5,10,1,8,7,1,7,1,0,False,False,False,1,3,2020-09-22T19:25:20.207,8,,7.0
2020,2,2814,110,4,594,2,5,5,5,5,0,5,0,5,0,False,False,False,0,3,2020-09-21T11:33:05.287,5,,0.0
2020,2,2814,115,4,7937,2,32,10,1,1,0,1,0,1,6,False,False,False,0,1,2021-01-28T20:39:58.183,1,,0.0
2020,2,2814,130,17,4752,2,4,9,12,13,1,12,1,12,0,False,False,False,0,3,2020-09-21T11:40:58.767,13,,1.0
2020,2,2814,140,17,7024,2,48,9,-3,13,16,12,1,12,0,False,False,False,0,1,2020-09-21T11:44:44.72,13,,1.0
2020,2,2814,160,17,7087,13,2,10,0,0,0,0,0,0,0,False,False,False,0,2,2020-09-24T17:35:46.767,0,,0.0
2020,2,2814,165,17,7087,2,9,2,24,26,2,26,0,26,0,False,False,False,0,2,2021-03-05T12:56:20.513,26,,0.0
2020,2,2814,170,17,4484,13,7,5,2,0,0,0,0,0,0,False,False,False,0,3,2021-02-25T14:59:56.79,0,,0.0
2020,2,2814,175,17,2253,2,2,4,2,2,0,2,0,2,6,True,False,False,0,3,2020-09-24T17:35:58.167,2,,0.0
2020,2,2814,190,4,6953,2,32,9,6,36,30,32,4,32,0,True,True,True,0,1,2021-02-17T14:29:15.15,36,False,4.0
2020,2,2814,195,17,4484,2,32,10,-2,4,6,0,4,0,0,True,False,False,1,4,2021-03-02T20:13:41.903,4,,4.0
2020,2,2814,205,17,2253,13,9,2,20,0,0,0,0,0,0,False,False,False,0,2,2020-09-22T18:57:43.463,0,,0.0
2020,2,2814,210,17,7087,13,8,4,12,0,0,0,0,0,0,False,False,False,0,2,2020-09-22T19:01:01.53,0,,0.0
2020,2,2814,220,4,594,2,49,10,-4,4,8,1,3,1,0,False,False,False,0,2,2020-09-22T19:02:16.027,4,,3.0
2020,2,2814,230,4,594,2,46,3,2,11,9,9,2,9,0,True,False,False,0,3,2020-09-22T17:11:23.433,11,,2.0
2020,2,2814,235,4,5119,2,12,8,16,46,30,30,16,30,0,False,False,False,2,3,2020-09-22T19:03:24.537,46,,16.0
2020,2,2814,240,4,2853,2,35,8,17,22,5,22,0,22,6,True,False,False,0,3,2020-09-22T19:03:50.417,22,,0.0
2020,2,2814,255,17,4913,13,48,4,-3,0,0,0,0,0,0,False,False,False,0,1,2020-09-24T17:52:22.5,0,,0.0
2020,2,2814,265,17,4752,2,4,9,7,14,7,11,3,11,0,True,False,False,0,3,2020-09-22T19:14:35.863,14,,3.0
2020,2,2814,270,17,4913,2,48,9,-2,2,4,1,1,1,0,False,False,False,1,1,2020-09-22T19:10:28.357,2,,1.0
2020,2,2814,275,17,7687,2,50,10,-1,-1,0,-1,0,-1,0,False,False,False,0,3,2020-09-21T12:23:34.077,-1,,0.0
2020,2,2814,280,17,4752,13,4,9,13,0,0,0,0,0,0,False,False,False,0,3,2020-09-21T12:26:31.513,0,,0.0
2020,2,2814,310,4,2853,2,22,6,16,16,0,16,0,16,0,False,False,False,0,3,2020-09-21T12:36:21.317,16,,0.0
2020,2,2814,320,4,1412,13,5,3,10,0,0,0,0,0,0,False,False,False,0,3,2020-09-21T12:42:39.3,0,,0.0
2020,2,2814,325,4,6983,3,48,9,-6,0,0,0,0,0,0,False,False,False,0,1,2020-09-21T12:44:28.94,0,,0.0
2020,2,2814,335,4,6953,13,17,9,11,0,0,0,0,0,0,True,False,False,0,4,2020-09-22T19:34:01.163,0,,0.0
2020,2,2814,350,4,1412,2,35,2,15,15,0,15,0,15,0,False,False,False,0,3,2020-09-21T13:00:33.39,15,,0.0
2020,2,2814,365,17,2253,2,4,5,6,7,1,6,1,6,0,False,False,False,0,2,2020-09-21T13:05:34.303,7,,1.0
2020,2,2814,370,17,4752,13,26,9,5,0,0,0,0,0,0,False,False,False,0,3,2020-09-21T13:09:35.803,0,,0.0
2020,2,2814,390,4,6983,2,48,10,-3,12,15,10,2,10,0,False,False,False,0,1,2020-09-21T13:16:45.823,12,,2.0
2020,2,2814,400,4,2853,13,5,2,16,0,0,0,0,0,0,False,False,False,0,2,2020-09-22T20:32:35.97,0,,0.0
2020,2,2814,420,17,7024,3,4,9,6,0,0,0,0,0,0,False,False,False,0,3,2020-09-24T15:01:35.203,0,,0.0
2020,2,2814,435,17,6274,2,8,7,18,27,9,25,2,25,0,False,False,False,0,3,2020-09-21T13:29:10.76,27,,2.0
2020,2,2814,475,17,2253,13,4,5,6,0,0,0,0,0,0,False,False,False,0,2,2020-09-21T13:38:14.56,0,,0.0
2020,2,2814,480,17,2253,2,8,10,11,15,4,12,3,12,0,False,False,False,0,3,2020-09-21T13:40:17.36,15,,3.0
2020,2,2814,485,17,6274,2,2,9,9,12,3,9,3,9,0,False,False,False,0,3,2021-02-25T15:01:22.873,12,,3.0
2020,2,2814,490,17,2253,2,2,9,10,20,10,15,5,15,0,False,False,False,0,2,2020-09-21T13:45:17.683,20,,5.0
2020,2,2814,510,17,7087,13,19,10,13,0,0,0,0,0,0,False,False,False,0,2,2020-09-21T13:54:03.123,0,,0.0
2020,2,2814,525,4,2853,2,4,5,6,9,3,4,5,4,0,False,False,False,1,2,2021-03-02T20:14:52.673,9,,5.0
2020,2,2814,535,4,6983,2,5,10,2,8,6,5,3,5,0,False,False,False,0,1,2020-09-22T19:26:32.897,8,,3.0
2020,2,2814,545,4,2853,13,13,9,5,0,0,0,0,0,0,True,False,False,0,3,2020-09-22T17:00:51.873,0,,0.0
2020,2,2814,555,17,4752,2,2,4,11,14,3,12,2,12,0,False,False,False,1,3,2020-09-21T14:07:19.437,14,,2.0
2020,2,2814,560,17,6274,2,7,6,20,23,3,20,3,20,0,False,False,False,0,3,2020-09-22T19:24:15.783,23,,3.0
2020,2,2814,565,17,2253,2,3,3,10,9,-1,9,0,9,0,False,False,False,0,2,2020-09-24T15:40:22.723,9,,0.0
2020,2,2814,570,17,7024,2,48,3,-4,0,4,-2,2,-2,0,False,False,False,0,1,2020-09-21T14:24:20.057,0,,2.0
2020,2,2814,590,17,6274,2,2,10,9,12,3,9,3,9,0,False,False,False,0,3,2020-09-21T14:31:53.137,12,,3.0
2020,2,2814,610,17,6274,13,7,3,1,0,0,0,0,0,0,False,False,False,0,3,2021-02-25T15:02:32.347,0,,0.0
2020,2,2814,615,17,7087,13,13,9,1,0,0,0,0,0,0,False,False,False,0,2,2020-09-24T17:36:12.577,0,,0.0
2020,2,2814,625,4,1412,2,2,9,5,6,1,6,0,6,0,False,False,False,0,2,2021-03-04T15:38:28.333,6,,0.0
2020,2,2814,635,4,2853,13,47,5,-1,0,0,0,0,0,0,True,False,False,0,3,2020-09-22T16:59:41.013,0,,0.0
2020,2,2814,655,17,4752,2,2,4,10,11,1,11,0,11,0,False,False,False,0,3,2020-09-21T14:57:39.317,11,,0.0
2020,2,2814,670,17,4752,2,46,3,0,3,3,0,3,0,0,True,False,False,0,1,2020-09-24T17:56:03.763,3,,3.0
2020,2,2814,685,17,6274,13,5,3,7,0,0,0,0,0,0,False,False,False,0,4,2021-02-25T15:04:15.213,0,,0.0
2020,2,2814,710,4,2853,2,19,2,36,47,11,47,0,47,0,False,False,False,0,3,2020-09-22T19:27:14.287,47,,0.0
2020,2,2814,715,4,7645,2,48,10,-4,7,11,4,3,4,0,False,False,False,0,1,2020-09-21T15:17:10.983,7,,
2020,2,2814,725,4,594,2,8,7,15,24,9,24,0,24,0,False,False,False,0,3,2020-09-21T15:20:46.41,24,,0.0
2020,2,2814,740,4,594,13,5,5,3,0,0,0,0,0,0,False,False,False,0,3,2020-09-21T16:50:01.867,0,,0.0
2020,2,2814,745,4,7646,2,12,10,6,6,0,6,0,6,6,False,False,False,1,2,2020-09-24T17:39:50.983,6,,0.0
2020,2,2814,760,17,2253,13,9,3,14,0,0,0,0,0,0,False,False,False,0,2,2020-09-21T16:50:19.57,0,,
2020,2,2814,770,17,6274,13,7,3,10,0,0,0,0,0,0,False,False,False,0,3,2020-09-21T15:35:34.26,0,,0.0
2020,2,2814,775,17,7024,2,52,9,-1,10,11,8,2,8,0,False,False,False,0,1,2021-03-04T13:20:58.403,10,,2.0
2020,2,2814,790,4,2853,2,35,2,21,21,0,21,0,21,0,False,False,False,0,3,2020-09-21T15:42:26.41,21,,0.0
2020,2,2814,795,4,5119,2,34,4,-5,1,6,-2,3,-2,0,True,False,False,1,3,2020-09-24T17:40:04.217,1,,3.0
2020,2,2814,805,4,1412,13,8,1,31,0,0,0,0,0,0,False,False,False,0,2,2020-09-21T15:48:18.677,0,,0.0
2020,2,2814,810,4,1412,2,8,7,44,46,2,45,1,45,6,False,False,False,0,2,2020-09-22T19:30:58.747,46,,1.0
2020,2,2814,825,17,7024,2,4,10,3,8,5,7,1,7,0,False,False,False,0,1,2020-09-21T15:54:07.317,8,,1.0
2020,2,2814,830,17,4752,2,2,4,6,8,2,7,1,7,0,False,False,False,0,3,2020-09-21T15:55:59.133,8,,1.0
2020,2,2814,835,17,6274,2,35,8,17,19,2,17,2,17,0,False,False,False,0,3,2020-09-24T17:56:17.673,19,,2.0
2020,2,2814,840,17,7024,2,31,5,1,3,2,3,0,3,0,False,False,False,0,1,2020-09-21T16:00:15.517,3,,0.0
2020,2,2814,855,17,4752,2,4,4,7,13,6,11,2,11,0,False,False,False,0,3,2020-09-21T16:03:07.403,13,,2.0
2020,2,2814,860,17,7024,2,4,3,-3,2,5,2,0,2,0,False,False,False,0,1,2020-09-21T16:51:28.873,2,,0.0
2020,2,2814,865,17,6274,2,2,9,5,12,7,8,4,8,0,False,False,False,0,3,2021-02-17T21:36:38.057,12,,4.0
2020,2,2814,880,17,6274,2,4,10,8,8,0,8,0,8,6,False,False,False,0,3,2020-09-21T16:11:34.367,8,,0.0
2020,2,2815,30,22,1113,13,4,10,2,0,0,0,0,0,0,False,False,False,0,1,2020-09-21T10:13:07.593,0,,0.0
2020,2,2815,35,22,1361,2,4,10,5,9,4,9,0,9,0,False,False,False,0,3,2021-01-28T21:03:58.343,9,,0.0
2020,2,2815,45,22,1361,13,4,5,9,0,0,0,0,0,0,False,False,False,0,2,2020-09-21T13:56:31.51,0,,0.0
2020,2,2815,60,28,969,2,30,10,-2,4,6,4,0,4,0,True,False,False,0,4,2020-09-22T17:32:26.04,4,,0.0
2020,2,2815,90,22,256,2,5,3,7,9,2,9,0,9,0,False,False,False,0,3,2021-01-28T21:04:47.917,9,,0.0
2020,2,2815,95,22,6270,2,11,3,5,7,2,7,0,7,0,False,False,False,0,1,2021-01-28T21:05:44.61,7,,0.0
2020,2,2815,115,22,256,2,51,5,-3,3,6,1,2,1,0,False,False,False,0,3,2021-01-28T21:05:59.06,3,,2.0
2020,2,2815,120,22,1361,2,46,3,2,8,6,8,0,8,0,False,False,False,0,3,2020-09-21T11:16:16.65,8,,0.0
2020,2,2815,160,28,743,2,17,8,18,18,0,18,0,18,0,False,False,False,0,3,2020-09-21T11:37:22.513,18,,0.0
2020,2,2815,175,28,7619,2,12,5,8,8,0,8,0,8,0,False,False,False,0,2,2021-02-25T15:09:21.683,8,,0.0
2020,2,2815,190,28,969,2,4,3,4,4,0,4,0,4,0,False,False,False,0,3,2020-09-21T11:56:12.063,4,,0.0
2020,2,2815,195,28,969,2,4,9,9,11,2,11,0,11,0,False,False,False,0,3,2020-09-24T20:51:00.647,11,,0.0
2020,2,2815,205,28,3264,2,16,9,5,10,5,9,1,9,0,False,False,False,0,1,2020-09-21T12:01:19.413,10,,1.0
2020,2,2815,210,28,262,2,48,4,-5,4,9,4,0,4,0,False,False,False,2,1,2020-09-24T20:52:14.4,4,,0.0
2020,2,2815,220,28,969,2,5,3,4,18,14,13,5,13,6,False,False,False,1,3,2020-09-24T20:39:55.06,18,,5.0
2020,2,2815,240,22,1361,2,50,9,-1,8,9,6,2,6,0,False,False,False,0,2,2020-09-22T17:49:53.723,8,,2.0
2020,2,2815,250,22,6262,2,30,10,-3,5,8,1,4,1,0,False,False,False,1,4,2020-09-21T12:24:55.283,5,,4.0
2020,2,2815,260,22,1361,2,46,3,2,5,3,5,0,5,0,False,False,False,0,2,2020-09-21T12:28:40.377,5,,0.0
2020,2,2815,265,22,6270,2,5,3,4,11,7,9,2,9,0,False,False,False,0,3,2020-09-22T17:50:22.63,11,,2.0
2020,2,2815,290,28,4912,3,21,6,33,0,0,0,0,0,0,False,False,False,0,2,2020-09-24T20:54:19.577,0,,0.0
2020,2,2815,300,28,4912,2,4,3,5,18,13,5,13,5,0,False,False,False,1,2,2020-09-21T12:46:46.237,18,,13.0
2020,2,2815,315,28,969,2,5,3,3,8,5,8,0,8,0,True,False,False,0,3,2020-09-21T12:52:37.16,8,,0.0
2020,2,2815,320,28,4932,2,5,3,5,9,4,9,0,9,0,False,False,False,0,3,2020-09-21T12:54:25.243,9,,0.0
2020,2,2815,335,28,3264,2,4,10,2,5,3,4,1,4,0,False,False,False,0,1,2020-09-21T12:59:28.473,5,,1.0
2020,2,2815,340,28,7619,13,12,10,7,0,0,0,0,0,0,False,False,False,0,2,2020-09-21T17:36:27.763,0,,
2020,2,2815,355,28,743,2,45,5,-4,10,14,4,6,4,0,False,False,False,2,1,2020-09-21T13:10:41.167,10,,6.0
2020,2,2815,370,28,969,13,2,4,4,0,0,0,0,0,0,False,False,False,0,4,2020-09-21T13:15:45.367,0,,0.0
2020,2,2815,375,28,969,2,5,3,2,4,2,2,2,2,6,False,False,False,0,3,2021-02-17T21:43:40.41,4,,2.0
2020,2,2815,415,22,4715,2,5,5,1,1,0,1,0,1,0,False,False,False,0,3,2020-09-22T18:15:55.887,1,,0.0
2020,2,2815,425,28,743,2,12,9,0,0,0,0,0,0,0,False,False,False,0,1,2021-03-08T16:53:50.427,0,,
2020,2,2815,455,28,4912,2,4,4,7,10,3,10,0,10,0,False,False,False,1,3,2020-09-21T13:50:07.907,10,,0.0
2020,2,2815,460,28,4932,13,5,2,16,0,0,0,0,0,0,True,False,False,0,2,2020-09-21T13:53:24.503,0,,0.0
2020,2,2815,475,22,1361,2,7,6,18,18,0,18,0,18,0,False,False,False,0,3,2021-02-17T21:44:26.45,18,,0.0
2020,2,2815,485,22,4715,3,4,10,12,0,0,0,0,0,0,False,False,False,0,2,2020-09-21T14:05:22.297,0,,0.0
2020,2,2815,490,22,4715,13,51,10,1,0,0,0,0,0,0,False,False,False,0,3,2020-09-24T19:38:01.89,0,,0.0
2020,2,2815,505,28,4912,2,4,4,9,15,6,14,1,14,0,False,False,False,0,3,2020-09-24T19:38:01.89,15,,1.0
2020,2,2815,515,28,6627,2,39,4,3,5,2,3,2,3,0,False,False,False,0,4,2020-09-21T14:23:55.62,5,,2.0
2020,2,2815,520,28,797,13,2,10,6,0,0,0,0,0,0,False,False,False,0,2,2021-03-04T22:07:12.403,0,,0.0
2020,2,2815,535,22,6270,2,47,5,1,1,0,1,0,1,0,True,False,False,0,3,2020-09-21T14:35:27.497,1,,0.0
2020,2,2815,540,22,6262,3,12,5,7,0,0,0,0,0,0,True,False,False,0,3,2021-01-15T21:05:36.697,0,,0.0
2020,2,2815,565,28,969,2,4,9,1,1,0,1,0,1,0,False,False,False,0,4,2020-09-21T14:48:19.223,1,,0.0
2020,2,2815,585,22,4715,2,4,10,13,13,0,13,0,13,0,False,False,False,0,2,2020-09-21T14:57:36.34,13,,0.0
2020,2,2815,590,22,1113,13,46,3,2,0,0,0,0,0,0,False,False,False,0,1,2021-01-12T23:20:20.733,0,,0.0
2020,2,2815,595,22,6262,13,35,9,8,0,0,0,0,0,0,False,False,False,0,4,2021-02-25T15:11:12.4,0,,0.0
2020,2,2815,600,22,6270,2,51,3,-3,5,8,5,0,5,0,False,False,False,1,3,2021-02-17T21:46:39.94,5,,0.0
2020,2,2815,615,28,4912,2,6,7,17,24,7,24,0,24,0,True,False,False,0,3,2021-02-17T21:47:41.823,24,,0.0
2020,2,2815,625,28,7619,2,30,10,-2,13,15,-1,14,-1,0,False,False,False,1,3,2020-09-21T15:21:40.277,13,,14.0
2020,2,2815,635,28,262,2,30,9,-4,2,6,0,2,0,0,False,False,False,0,1,2021-02-17T21:50:57.403,2,,2.0
2020,2,2815,660,22,6262,13,29,2,19,0,0,0,0,0,0,False,False,False,0,2,2020-09-21T16:57:31.97,0,,
2020,2,2815,665,22,6262,13,12,4,3,0,0,0,0,0,0,False,False,False,0,4,2021-03-08T16:54:18.953,0,,0.0
2020,2,2815,675,22,6270,13,6,9,7,0,0,0,0,0,0,False,False,False,0,3,2021-01-28T21:06:36.34,0,,0.0
2020,2,2815,680,22,1361,13,5,3,7,0,0,0,0,0,0,False,False,False,0,2,2020-09-21T15:51:21.343,0,,0.0
2020,2,2815,695,28,4932,2,50,9,-4,1,5,-3,4,-3,0,False,False,False,0,3,2021-03-04T13:25:59.18,1,,4.0
2020,2,2815,710,22,6270,13,5,9,5,0,0,0,0,0,0,False,False,False,0,3,2021-02-17T21:49:19.43,0,,0.0
2020,2,2815,715,22,2391,2,29,2,24,27,3,24,3,24,0,False,False,False,0,2,2020-09-21T17:07:30.72,27,,
2020,2,2815,725,22,4715,2,49,9,-3,0,3,-1,1,-1,0,False,False,False,0,3,2020-09-21T16:14:45.4,0,,1.0
2020,2,2815,745,28,7619,13,50,10,-4,0,0,0,0,0,0,False,False,False,0,3,2021-03-04T13:26:11.557,0,,0.0
2020,2,2815,755,22,1361,2,5,6,16,27,11,27,0,27,0,False,False,False,0,3,2020-09-21T16:28:45.873,27,,0.0
2020,2,2815,760,22,4715,2,49,10,-2,2,4,0,2,0,0,False,False,False,0,2,2020-09-24T20:38:15.213,2,,2.0
2020,2,2815,765,22,6277,2,47,5,0,4,4,2,2,2,0,False,False,False,0,1,2020-09-24T20:59:18.383,4,,2.0
2020,2,2815,770,22,6277,2,28,10,-4,8,12,4,4,4,0,False,False,False,1,1,2021-03-02T20:40:38.593,8,,4.0
2020,2,2815,775,22,4715,13,19,2,24,0,0,0,0,0,0,False,False,False,0,2,2020-09-21T16:38:33.217,0,,
2020,2,2815,790,22,6270,2,13,10,4,5,1,5,0,5,0,False,False,False,0,2,2020-09-24T19:38:01.89,5,,0.0
2020,2,2815,795,22,6270,2,12,7,20,30,10,30,0,30,6,False,False,False,0,3,2020-09-21T16:45:27.56,30,,0.0
2020,2,2816,15,24,6937,2,44,9,-1,12,13,12,0,12,0,False,False,False,0,1,2020-09-21T10:25:09.88,12,,0.0
2020,2,2816,40,29,4866,2,2,4,7,24,17,21,3,21,0,False,False,False,0,3,2020-09-21T10:33:36.913,24,,3.0
2020,2,2816,50,29,3398,2,47,5,3,4,1,4,0,4,6,False,False,False,0,4,2020-09-24T15:06:52.763,4,,0.0
2020,2,2816,75,24,894,2,6,4,12,12,0,12,0,12,0,False,False,False,0,3,2020-09-21T10:42:21.147,12,,0.0
2020,2,2816,80,24,7798,2,30,9,1,14,13,14,0,14,0,True,False,False,0,2,2020-09-22T17:12:58.087,14,,0.0
2020,2,2816,95,24,894,2,31,9,0,4,4,4,0,4,0,False,False,False,0,4,2020-09-24T15:08:53.193,4,,0.0
2020,2,2816,100,24,6373,13,8,4,12,0,0,0,0,0,0,False,False,False,0,3,2021-03-10T18:07:21.237,0,,0.0
2020,2,2816,105,24,6937,2,5,10,0,2,2,1,1,1,0,False,False,False,0,1,2020-09-24T14:46:19.717,2,,1.0
2020,2,2816,130,29,7828,2,4,3,3,10,7,3,7,3,0,False,False,False,1,2,2020-09-24T16:34:51.42,10,,7.0
2020,2,2816,135,29,7828,2,6,10,6,8,2,7,1,7,0,False,False,False,0,3,2020-09-24T16:34:58.85,8,,1.0
2020,2,2816,145,29,4866,2,5,5,5,5,0,5,0,5,0,False,False,False,0,2,2020-09-21T11:06:35.753,5,,0.0
2020,2,2816,150,29,4866,2,31,4,0,19,19,19,0,19,0,False,False,False,0,3,2020-09-24T16:35:08.58,19,,0.0
2020,2,2816,155,29,7828,2,7,6,21,21,0,21,0,21,0,False,False,False,0,3,2020-09-24T15:14:05.38,21,,0.0
2020,2,2816,180,24,6937,13,47,10,3,0,0,0,0,0,0,False,False,False,0,1,2020-09-24T16:07:12.763,0,,0.0
2020,2,2816,185,24,894,2,6,4,4,8,4,5,3,5,0,False,False,False,1,3,2020-09-24T14:50:29.017,8,,3.0
2020,2,2816,190,24,7003,3,2,10,4,0,0,0,0,0,0,False,False,False,0,2,2020-09-24T15:15:52.533,0,,0.0
2020,2,2816,200,29,3398,2,12,5,4,13,9,13,0,13,0,False,False,False,0,4,2021-03-08T16:55:44.693,13,,0.0
2020,2,2816,205,29,7378,2,48,3,-7,12,19,7,5,7,0,False,False,False,0,1,2020-09-24T15:17:57.183,12,,5.0
2020,2,2816,210,29,3398,2,26,10,3,6,3,5,1,5,0,False,False,False,1,4,2020-09-24T15:19:46.133,6,,1.0
2020,2,2816,220,29,1958,2,50,9,-1,0,1,-2,2,-2,0,False,False,False,0,3,2020-09-24T14:41:32.503,0,,
2020,2,2816,230,29,4875,2,4,9,12,20,8,16,4,16,0,False,False,False,1,3,2020-09-24T15:21:58.963,20,,4.0
2020,2,2816,245,29,3398,2,46,3,1,3,2,1,2,1,6,False,False,False,1,3,2021-03-02T20:50:05.143,3,,2.0
2020,2,2816,260,24,7798,2,6,4,13,16,3,16,0,16,0,False,False,False,0,2,2020-09-23T19:37:23.557,16,,0.0
2020,2,2816,275,24,4382,2,39,4,4,5,1,5,0,5,0,False,False,False,0,3,2020-09-21T11:50:20.297,5,,0.0
2020,2,2816,285,24,6389,2,48,10,-4,8,12,8,0,8,0,False,False,False,0,1,2020-09-21T11:53:28.263,8,,0.0
2020,2,2816,290,24,6389,2,44,9,0,12,12,12,0,12,0,False,False,False,1,1,2020-09-24T16:07:12.763,12,,0.0
2020,2,2816,295,24,6373,2,33,4,4,10,6,8,2,8,0,False,False,False,0,4,2020-09-21T11:58:59.687,10,,2.0
2020,2,2816,305,24,7798,3,2,9,2,0,0,0,0,0,0,False,False,False,0,2,2020-09-21T15:36:24.653,0,,
2020,2,2816,335,29,4875,2,35,10,9,13,4,11,2,11,0,False,False,False,0,2,2021-02-25T15:14:38.063,13,,2.0
2020,2,2816,355,29,1958,13,3,5,11,0,0,0,0,0,0,False,False,False,0,3,2021-02-25T15:16:12.75,0,,0.0
2020,2,2816,370,24,7798,2,50,10,1,8,7,6,2,6,0,False,False,False,0,3,2020-09-24T15:51:45.51,8,,2.0
2020,2,2816,380,24,6937,3,5,5,3,0,0,0,0,0,0,False,False,False,0,1,2020-09-21T12:23:38.423,0,,0.0
2020,2,2816,390,24,894,13,6,1,15,0,0,0,0,0,0,False,False,False,0,3,2021-02-17T18:05:59.06,0,,0.0
2020,2,2816,395,24,6373,2,5,10,4,5,1,3,2,3,0,False,False,False,1,3,2021-03-02T20:50:57.21,5,,2.0
2020,2,2816,400,24,894,13,5,3,5,0,0,0,0,0,0,False,False,False,0,3,2020-09-24T15:31:15.733,0,,0.0
2020,2,2816,460,29,1958,13,5,6,17,0,0,0,0,0,0,False,False,False,0,3,2020-09-24T15:52:45.63,0,,0.0
2020,2,2816,475,24,967,2,4,9,5,5,0,5,0,5,0,False,False,False,0,3,2020-09-24T15:32:29.95,5,,0.0
2020,2,2816,480,24,967,3,50,3,-2,0,0,0,0,0,0,True,False,False,0,2,2020-09-24T14:43:45.317,0,,0.0
2020,2,2816,485,24,894,2,13,4,5,6,1,6,0,6,0,False,False,False,0,3,2020-09-21T12:50:45.497,6,,0.0
2020,2,2816,490,24,967,2,5,5,9,9,0,9,0,9,0,True,False,False,0,2,2020-09-24T15:33:28.493,9,,0.0
2020,2,2816,495,24,894,2,6,9,12,12,0,12,0,12,0,True,False,False,0,3,2020-09-24T14:55:03.563,12,,0.0
2020,2,2816,515,24,6373,13,12,10,3,0,0,0,0,0,0,False,False,False,0,4,2021-03-08T16:56:46.753,0,,0.0
2020,2,2816,520,24,967,2,5,3,8,9,1,9,0,9,0,True,False,False,0,2,2020-09-21T13:01:53.947,9,,0.0
2020,2,2816,525,24,7003,13,8,1,21,0,0,0,0,0,0,False,False,False,0,2,2020-09-21T15:05:54.71,0,,0.0
2020,2,2816,535,29,1958,13,7,2,23,0,0,0,0,0,0,False,False,False,0,4,2020-09-24T15:49:16.11,0,,0.0
2020,2,2816,540,29,7828,2,13,4,6,6,0,6,0,6,0,False,False,False,0,3,2020-09-24T16:07:12.763,6,,0.0
2020,2,2816,555,29,4866,2,13,10,4,21,17,9,12,9,0,False,False,False,1,3,2021-03-02T20:51:56.943,21,,12.0
2020,2,2816,560,29,4866,13,38,9,1,0,0,0,0,0,0,False,False,False,0,4,2020-09-24T16:07:12.763,0,,0.0
2020,2,2816,570,29,4866,2,2,9,4,12,8,9,3,9,0,False,False,False,0,3,2020-09-21T13:19:23.15,12,,3.0
2020,2,2816,580,29,1958,2,30,10,-1,1,2,1,0,1,0,False,False,False,0,3,2020-09-21T13:24:26.663,1,,0.0
2020,2,2816,585,29,1958,2,35,9,13,13,0,13,0,13,0,False,False,False,0,3,2020-09-24T14:48:48.97,13,,0.0
2020,2,2816,600,29,7378,13,17,4,12,0,0,0,0,0,0,False,False,False,0,1,2020-09-24T14:49:00.663,0,,0.0
2020,2,2816,605,29,7828,13,35,10,10,0,0,0,0,0,0,False,False,False,0,3,2021-02-25T15:17:44.72,0,,0.0
2020,2,2816,620,24,967,2,5,2,21,25,4,25,0,25,0,False,False,False,0,3,2021-02-17T18:10:28.113,25,,0.0
2020,2,2816,635,24,7798,2,50,9,-1,3,4,3,0,3,0,False,False,False,0,3,2021-03-04T14:41:33.377,3,,0.0
2020,2,2816,640,24,6373,2,4,9,5,4,-1,4,0,4,0,False,False,False,0,4,2020-09-24T15:38:49.33,4,,0.0
2020,2,2816,710,29,3398,2,43,6,28,28,0,28,0,28,6,False,False,False,0,4,2021-02-17T18:11:08.463,28,,0.0
2020,2,2816,725,24,967,2,4,10,8,8,0,8,0,8,0,False,False,False,0,3,2020-09-21T14:11:23.803,8,,0.0
2020,2,2816,730,24,967,13,4,3,10,0,0,0,0,0,0,False,False,False,0,2,2020-09-21T14:13:15.177,0,,0.0
2020,2,2816,745,24,6389,2,5,9,1,4,3,4,0,4,0,False,False,False,0,1,2020-09-21T14:17:02.363,4,,0.0
2020,2,2816,750,24,967,3,3,5,8,0,0,0,0,0,0,False,False,False,0,2,2020-09-24T16:07:12.763,0,,0.0
2020,2,2816,755,24,6937,2,44,3,4,22,18,22,0,22,0,False,False,False,1,1,2021-02-17T18:12:25.167,22,,0.0
2020,2,2816,760,24,6937,13,28,4,1,0,0,0,0,0,0,False,False,False,0,1,2020-09-21T14:22:54.563,0,,0.0
2020,2,2816,765,24,6373,13,29,6,18,0,0,0,0,0,0,False,False,False,0,3,2020-09-21T14:24:27.827,0,,0.0
2020,2,2816,770,24,967,2,4,10,4,8,4,5,3,5,0,False,False,False,0,2,2020-09-21T14:26:14.357,8,,3.0
2020,2,2816,775,24,6373,13,2,4,13,0,0,0,0,0,0,True,False,False,0,3,2020-09-24T16:07:12.763,0,,0.0
2020,2,2816,825,29,7378,2,11,6,27,28,1,27,1,27,0,False,False,False,0,3,2020-09-24T16:07:12.763,28,,1.0
2020,2,2816,850,24,6373,2,2,4,8,11,3,11,0,11,0,False,False,False,0,3,2020-09-21T14:51:24.533,11,,0.0
2020,2,2816,855,24,6937,13,6,10,3,0,0,0,0,0,0,False,False,False,0,1,2020-09-24T16:07:12.763,0,,0.0
2020,2,2817,10,10,6281,2,29,6,20,20,0,20,0,20,0,False,False,False,0,2,2020-09-21T18:28:20.243,20,,0.0
2020,2,2817,15,10,7700,3,2,4,12,0,0,0,0,0,0,False,False,False,0,3,2020-09-24T19:33:11.477,0,,0.0
2020,2,2817,25,10,4930,13,4,10,4,0,0,0,0,0,0,False,False,False,0,2,2020-09-21T18:57:30.897,0,,
2020,2,2817,35,10,3848,13,12,2,23,0,0,0,0,0,0,False,False,False,0,4,2020-09-21T10:37:08.007,0,,0.0
2020,2,2817,45,10,6281,13,6,9,12,0,0,0,0,0,0,False,False,False,0,3,2020-09-24T18:58:33.467,0,,0.0
2020,2,2817,65,25,4583,2,5,3,7,8,1,7,1,7,0,True,False,False,0,3,2020-09-22T21:11:54.653,8,,1.0
2020,2,2817,90,10,4930,13,19,6,41,0,0,0,0,0,0,False,False,False,0,3,2020-09-23T20:26:40.677,0,,0.0
2020,2,2817,105,25,609,2,13,10,3,15,12,15,0,15,0,False,False,False,0,3,2020-09-21T11:11:13.203,15,,0.0
2020,2,2817,110,25,4583,2,45,10,-3,8,11,2,6,2,0,True,False,False,0,2,2020-09-24T18:40:05.737,8,,6.0
2020,2,2817,115,25,6486,2,5,5,5,5,0,5,0,5,0,False,False,False,0,2,2020-09-21T11:16:32.443,5,,0.0
2020,2,2817,120,25,7060,13,13,9,2,0,0,0,0,0,0,True,False,False,0,2,2021-03-02T13:48:56.503,0,,0.0
2020,2,2817,130,25,609,3,13,10,2,0,0,0,0,0,0,False,False,False,0,4,2020-09-21T11:23:36.683,0,,0.0
2020,2,2817,135,25,7060,13,9,6,23,0,0,0,0,0,0,False,False,False,0,2,2020-09-21T11:28:11.023,0,,0.0
2020,2,2817,140,25,4583,2,50,9,0,18,18,6,12,6,0,False,False,False,1,3,2021-03-04T14:46:13.797,18,,12.0
2020,2,2817,165,10,7700,2,6,9,11,20,9,11,9,11,0,False,False,False,1,3,2020-09-21T19:05:10.443,20,,9.0
2020,2,2817,180,10,6281,13,12,2,18,0,0,0,0,0,0,False,False,False,0,2,2020-09-24T19:23:08.373,0,,0.0
2020,2,2817,200,25,6490,3,48,4,-3,0,0,0,0,0,0,False,False,False,0,1,2020-09-21T12:05:35.633,0,,0.0
2020,2,2817,215,10,7700,2,35,6,17,19,2,17,2,17,0,False,False,False,0,3,2020-09-24T19:33:11.477,19,,2.0
2020,2,2817,235,10,6281,2,49,3,-2,1,3,0,1,0,0,False,False,False,0,2,2020-09-21T19:06:52.17,1,,1.0
2020,2,2817,250,25,6486,2,4,3,5,7,2,6,1,6,0,False,False,False,0,2,2020-09-21T12:19:34.127,7,,1.0
2020,2,2817,260,25,7060,2,46,3,1,10,9,10,0,10,0,False,False,False,0,3,2020-09-21T12:24:31.007,10,,0.0
2020,2,2817,270,25,7060,2,47,5,1,18,17,2,16,2,0,False,False,False,2,2,2020-09-24T18:41:03.967,18,,16.0
2020,2,2817,275,25,181,13,12,4,11,0,0,0,0,0,0,False,False,False,0,4,2021-03-17T18:55:56.03,0,,0.0
2020,2,2817,280,25,609,13,6,10,3,0,0,0,0,0,0,False,False,False,0,4,2020-09-24T19:33:11.477,0,,0.0
2020,2,2817,285,25,7060,13,6,10,10,0,0,0,0,0,0,False,False,False,0,2,2020-09-24T20:04:42.763,0,,0.0
2020,2,2817,305,10,7700,2,6,9,13,15,2,13,2,13,0,False,False,False,0,2,2020-09-24T18:59:31.82,15,,2.0
2020,2,2817,310,10,4930,13,4,10,10,0,0,0,0,0,0,False,False,False,0,2,2020-09-24T18:49:31.187,0,,0.0
2020,2,2817,330,25,7666,2,19,6,37,84,47,84,0,84,6,False,False,False,0,2,2020-09-24T18:15:27.017,84,,0.0
2020,2,2817,345,10,6281,2,19,2,40,45,5,45,0,45,0,False,False,False,0,2,2020-09-21T19:08:38.167,45,,0.0
2020,2,2817,360,10,6285,13,4,9,5,0,0,0,0,0,0,False,False,False,0,2,2020-09-24T18:59:55.83,0,,0.0
2020,2,2817,365,10,7701,13,2,4,8,0,0,0,0,0,0,False,False,False,0,3,2020-09-21T19:09:14.6,0,,0.0
2020,2,2817,390,25,7060,2,52,4,0,9,9,7,2,7,0,False,False,False,0,3,2021-02-24T17:44:28.637,9,,2.0
2020,2,2817,405,10,6281,3,6,8,15,0,0,0,0,0,0,False,False,False,0,2,2021-03-09T19:06:43.447,0,,0.0
2020,2,2817,415,25,4587,2,4,9,5,6,1,5,1,5,0,False,False,False,0,1,2021-02-17T18:38:51.667,6,,1.0
2020,2,2817,450,10,7701,2,5,6,16,17,1,16,1,16,0,False,False,False,0,3,2020-09-24T19:33:11.477,17,,1.0
2020,2,2817,455,10,7701,13,19,2,50,0,0,0,0,0,0,False,False,False,0,3,2021-03-10T18:01:53.717,0,,0.0
2020,2,2817,470,10,4930,13,19,6,38,0,0,0,0,0,0,False,False,False,0,2,2020-09-24T18:15:51.673,0,,0.0
2020,2,2817,500,25,4587,2,16,10,0,9,9,7,2,7,0,False,False,False,0,1,2020-09-24T19:33:11.477,9,,2.0
2020,2,2817,510,25,7081,2,48,4,-8,-4,4,-7,3,-7,0,False,False,False,0,1,2020-09-21T14:22:08.337,-4,,3.0
2020,2,2817,515,25,4583,13,12,8,16,0,0,0,0,0,0,False,False,False,0,3,2021-03-04T22:08:57.193,0,,0.0
2020,2,2817,525,10,3848,3,32,5,-2,0,0,0,0,0,0,False,False,False,0,4,2020-09-24T19:33:11.477,0,,0.0
2020,2,2817,530,10,7701,2,2,4,12,13,1,13,0,13,0,False,False,False,0,3,2020-09-24T19:33:11.477,13,,0.0
2020,2,2817,545,10,6840,2,38,10,1,14,13,8,6,8,0,False,False,False,0,4,2020-09-24T19:33:11.477,14,,6.0
2020,2,2817,555,10,6840,13,17,10,10,0,0,0,0,0,0,False,False,False,0,3,2021-01-15T20:57:58.1,0,,0.0
2020,2,2817,560,10,282,3,2,9,2,0,0,0,0,0,0,False,False,False,0,1,2020-09-21T17:55:00.527,0,,0.0
2020,2,2817,575,25,6486,3,5,3,5,0,0,0,0,0,0,False,False,False,0,3,2020-09-21T15:04:43.63,0,,0.0
2020,2,2817,580,25,7060,2,6,10,3,2,-1,2,0,2,0,False,False,False,0,3,2020-09-24T19:33:11.477,2,,0.0
2020,2,2817,590,25,6490,2,52,10,0,4,4,2,2,2,0,True,False,False,0,3,2020-09-24T18:50:40.54,4,,2.0
2020,2,2817,595,25,7060,2,5,3,11,11,0,11,0,11,0,False,False,False,0,2,2020-09-21T15:12:07.84,11,,0.0
2020,2,2817,600,25,6486,2,4,3,5,10,5,9,1,9,0,False,False,False,0,2,2020-09-21T15:17:54.87,10,,1.0
2020,2,2817,605,25,7060,2,49,5,-2,2,4,0,2,0,0,False,False,False,0,2,2020-09-21T15:17:35.577,2,,2.0
2020,2,2817,610,25,4583,2,5,3,6,6,0,6,0,6,0,False,False,False,0,3,2020-09-21T15:19:49.03,6,,0.0
2020,2,2817,615,25,4583,2,51,10,-2,0,2,0,0,0,0,False,False,False,0,3,2020-09-21T15:21:53.477,0,,0.0
2020,2,2817,625,25,609,13,5,7,20,0,0,0,0,0,0,False,False,False,0,4,2021-02-17T18:22:52.77,0,,0.0
2020,2,2817,635,10,7700,2,32,3,3,8,5,3,5,3,0,False,False,False,2,3,2021-03-03T14:33:11.037,8,,5.0
2020,2,2817,640,10,7700,13,4,10,4,0,0,0,0,0,0,False,False,False,0,3,2020-09-21T19:02:20.173,0,,
2020,2,2817,655,10,7700,3,2,4,8,0,0,0,0,0,0,False,False,False,0,3,2020-09-24T18:51:39.467,0,,0.0
2020,2,2817,660,10,3848,13,12,10,4,0,0,0,0,0,0,False,False,False,0,4,2021-03-08T16:59:42.943,0,,
2020,2,2817,665,10,6840,2,7,6,17,20,3,20,0,20,6,False,False,False,0,3,2020-09-21T18:31:01.16,20,,0.0
2020,2,2817,680,25,609,2,8,1,19,21,2,19,2,19,0,False,False,False,0,3,2020-09-21T15:59:11.723,21,,2.0
2020,2,2817,695,25,7666,2,5,3,8,8,0,8,0,8,0,False,False,False,0,3,2020-09-21T16:05:23.65,8,,0.0
2020,2,2817,700,25,7666,2,18,5,-4,-4,0,-4,0,-4,0,False,False,False,0,2,2020-09-24T18:16:34.76,-4,,0.0
2020,2,2817,705,25,4583,2,12,9,5,5,0,5,0,5,0,False,False,False,0,3,2020-09-24T18:16:51.32,5,,0.0
2020,2,2817,710,25,609,2,4,4,5,7,2,6,1,6,0,False,False,False,0,4,2020-09-21T16:17:02.897,7,,1.0
2020,2,2817,715,25,4583,2,54,4,0,3,3,2,1,2,0,False,False,False,0,3,2020-09-24T18:07:37.487,3,,1.0
2020,2,2817,725,25,7060,2,12,8,28,28,0,28,0,28,6,False,False,False,0,3,2021-02-17T18:26:35.81,28,,0.0
2020,2,2817,740,10,7701,13,4,10,10,0,0,0,0,0,0,False,False,False,0,2,2021-03-10T18:02:05.257,0,,0.0
2020,2,2817,745,10,282,2,48,9,-6,-2,4,-3,1,-3,0,False,False,False,0,1,2020-09-24T18:17:33.303,-2,,1.0
2020,2,2817,750,10,6840,2,38,4,0,1,1,0,1,0,0,False,False,False,0,4,2020-09-21T16:37:14.797,1,,1.0
2020,2,2817,775,10,7701,2,5,2,18,18,0,18,0,18,0,False,False,False,0,3,2020-09-21T16:49:58.953,18,,0.0
2020,2,2817,780,10,3848,3,5,10,9,0,0,0,0,0,0,False,False,False,0,4,2020-09-21T19:02:48.087,0,,
2020,2,2817,790,10,6285,3,13,9,4,0,0,0,0,0,0,False,False,False,0,4,2020-09-24T19:00:35.227,0,,0.0
2020,2,2817,795,10,4930,2,35,4,14,17,3,15,2,15,0,False,False,False,2,2,2020-09-24T18:53:18.637,17,,2.0
2020,2,2817,800,10,282,2,11,2,16,16,0,16,0,16,6,False,False,False,0,1,2020-09-24T18:54:16.78,16,,0.0
2020,2,2817,815,25,7060,2,4,5,12,12,0,12,0,12,0,False,False,False,0,2,2020-09-21T17:08:50.087,12,,0.0
2020,2,2817,820,25,181,2,46,3,1,3,2,1,2,1,0,False,False,False,1,3,2020-09-24T18:17:57.153,3,,2.0
2020,2,2817,825,25,7060,13,13,10,1,0,0,0,0,0,0,False,False,False,0,2,2020-09-21T17:12:17.047,0,,0.0
2020,2,2817,830,25,7060,3,6,9,10,0,0,0,0,0,0,False,False,False,0,2,2020-09-24T19:39:51.443,0,,0.0
2020,2,2817,850,10,4930,2,32,3,-1,7,8,7,0,7,0,False,False,False,0,3,2020-09-21T17:21:01.163,7,,0.0
2020,2,2817,860,10,7700,13,9,2,33,0,0,0,0,0,0,False,False,False,0,2,2020-09-24T18:18:14.427,0,,0.0
2020,2,2817,870,10,4930,13,8,1,16,0,0,0,0,0,0,False,False,False,0,3,2020-09-21T19:03:11.317,0,,
2020,2,2817,875,10,6840,2,7,6,20,22,2,22,0,22,0,False,False,False,0,4,2021-03-05T12:58:15.76,22,,0.0
2020,2,2817,880,10,6285,2,6,10,4,5,1,5,0,5,0,False,False,False,0,3,2020-09-21T17:34:17.48,5,,0.0
2020,2,2817,895,10,7701,3,13,9,3,0,0,0,0,0,0,False,False,False,0,3,2021-02-03T18:16:19.69,0,,0.0
2020,2,2818,10,30,7268,2,4,3,7,6,-1,6,0,6,0,False,False,False,0,2,2020-09-21T10:20:28.003,6,,0.0
2020,2,2818,20,30,793,13,26,10,4,0,0,0,0,0,0,False,False,False,0,3,2021-03-02T16:50:25.253,0,,0.0
2020,2,2818,30,5,5220,2,5,3,5,6,1,5,1,5,0,True,False,False,0,3,2020-09-22T18:50:37.79,6,,1.0
2020,2,2818,45,5,4799,2,5,5,2,10,8,10,0,10,0,True,False,False,0,3,2021-02-17T17:53:17.247,10,,0.0
2020,2,2818,55,5,5220,2,6,1,16,19,3,18,1,18,0,True,False,False,0,2,2020-09-21T10:48:58.117,19,,1.0
2020,2,2818,60,5,4799,13,48,9,0,0,0,0,0,0,0,False,False,False,0,1,2021-03-04T22:11:53.89,0,,0.0
2020,2,2818,70,30,793,13,5,3,5,0,0,0,0,0,0,False,False,False,0,3,2020-09-21T10:55:04.483,0,,0.0
2020,2,2818,75,30,119,2,4,4,4,7,3,5,2,5,0,False,False,False,0,1,2020-09-21T10:58:42.86,7,,2.0
2020,2,2818,80,30,119,2,46,3,1,2,1,2,0,2,0,False,False,False,0,1,2020-09-21T11:00:52.12,2,,0.0
2020,2,2818,85,30,119,2,50,10,-3,16,19,13,3,13,0,True,False,False,1,2,2020-09-22T16:54:45.1,4,,3.0
2020,2,2818,90,30,793,2,17,1,23,50,27,48,2,48,0,False,False,False,0,3,2020-09-21T18:00:54.557,50,,2.0
2020,2,2818,95,30,7268,3,35,2,21,0,0,0,0,0,0,False,False,False,0,2,2020-09-21T11:14:29.307,0,,0.0
2020,2,2818,105,30,119,2,48,4,-5,6,11,4,2,4,0,False,False,False,0,1,2020-09-21T17:52:39.57,6,,2.0
2020,2,2818,135,30,793,2,21,6,20,23,3,23,0,23,6,False,False,False,0,2,2020-09-21T18:01:30.567,23,,0.0
2020,2,2818,150,5,3477,2,50,5,-2,-1,1,-3,2,-3,0,False,False,False,0,3,2020-09-24T18:24:38.723,-1,,2.0
2020,2,2818,155,5,3750,2,5,9,7,8,1,8,0,8,0,False,False,False,0,4,2020-09-24T18:56:52.437,8,,0.0
2020,2,2818,160,5,4799,2,18,3,-2,9,11,5,4,5,0,True,False,False,0,2,2020-09-21T11:50:48.05,9,,4.0
2020,2,2818,165,5,5220,13,2,9,7,0,0,0,0,0,0,False,False,False,0,2,2020-09-21T11:54:09.42,0,,0.0
2020,2,2818,175,5,4799,2,48,9,-4,7,11,4,3,4,0,False,False,False,0,1,2020-09-24T18:24:51.547,7,,3.0
2020,2,2818,190,30,4937,2,51,9,-5,2,7,1,1,1,0,False,False,False,0,1,2020-09-21T12:04:49.153,2,,1.0
2020,2,2818,200,30,119,2,31,9,1,7,6,5,2,5,0,False,False,False,1,1,2020-09-21T12:07:24.223,7,,2.0
2020,2,2818,220,30,793,2,5,9,4,4,0,4,0,4,0,False,False,False,0,3,2021-02-17T17:54:10.683,4,,0.0
2020,2,2818,235,30,793,2,5,5,6,6,0,6,0,6,0,False,False,False,0,3,2020-09-21T12:23:03.173,6,,0.0
2020,2,2818,240,30,793,3,3,5,13,0,0,0,0,0,0,False,False,False,0,2,2021-03-02T16:56:04.403,0,,0.0
2020,2,2818,245,30,6419,2,5,3,12,12,0,12,0,12,0,False,False,False,0,2,2020-09-21T12:28:01.093,12,,0.0
2020,2,2818,265,5,3477,2,4,9,13,13,0,13,0,13,0,False,False,False,0,3,2020-09-21T17:45:38.26,13,,0.0
2020,2,2818,280,5,5220,13,6,9,10,0,0,0,0,0,0,False,False,False,0,2,2020-09-24T16:40:58.73,0,,0.0
2020,2,2818,310,30,793,2,4,5,5,8,3,7,1,7,0,False,False,False,0,2,2020-09-24T19:01:50.81,8,,1.0
2020,2,2818,315,30,6419,2,19,8,29,36,7,35,1,35,0,False,False,False,0,4,2020-09-24T19:02:25.473,36,,1.0
2020,2,2818,325,30,4523,3,4,10,3,0,0,0,0,0,0,False,False,False,0,4,2020-09-24T19:03:23.61,0,,0.0
2020,2,2818,330,30,4937,2,5,3,6,12,6,10,2,10,0,False,False,False,0,3,2020-09-24T19:05:11.193,12,,2.0
2020,2,2818,350,5,3477,2,6,9,3,12,9,12,0,12,0,False,False,False,1,3,2020-09-24T18:28:13.947,12,,0.0
2020,2,2818,365,5,4803,2,51,9,-3,3,6,2,1,2,0,False,False,False,0,3,2020-09-24T17:33:11.297,3,,1.0
2020,2,2818,380,5,4799,2,2,10,1,3,2,2,1,2,0,False,False,False,0,2,2020-09-24T19:07:41.233,3,,1.0
2020,2,2818,395,30,4523,2,4,4,8,11,3,10,1,10,0,False,False,False,0,3,2020-09-24T17:41:26.297,11,,1.0
2020,2,2818,405,30,119,3,6,4,5,0,0,0,0,0,0,False,False,False,0,1,2020-09-24T19:11:47.593,0,,0.0
2020,2,2818,410,30,6414,2,51,10,-6,2,8,2,0,2,0,False,False,False,0,1,2020-09-21T14:01:21.623,2,,0.0
2020,2,2818,425,5,5220,13,5,6,16,0,0,0,0,0,0,False,False,False,0,2,2020-09-24T19:13:44.023,0,,0.0
2020,2,2818,450,5,3477,2,2,10,3,6,3,5,1,5,0,False,True,True,0,2,2020-09-21T17:46:39.423,6,,1.0
2020,2,2818,455,30,63,13,35,7,18,0,0,0,0,0,0,False,False,False,0,4,2021-03-04T22:12:54.327,0,,0.0
2020,2,2818,470,5,2554,2,48,9,-4,4,8,0,4,0,0,False,False,False,1,1,2020-09-21T14:24:46.18,4,,4.0
2020,2,2818,475,5,5220,2,6,4,14,15,1,15,0,15,0,False,False,False,0,2,2020-09-21T14:28:22.01,15,,0.0
2020,2,2818,500,5,3477,13,9,5,8,0,0,0,0,0,0,False,False,False,0,3,2020-09-21T17:53:43.963,0,,
2020,2,2818,530,30,7268,13,19,2,28,0,0,0,0,0,0,False,False,False,0,2,2020-09-21T18:06:55.153,0,,
2020,2,2818,540,30,4937,2,51,10,-5,0,5,-3,3,-3,0,False,False,False,0,1,2020-09-24T18:25:42.233,0,,3.0
2020,2,2818,550,30,793,13,4,4,14,0,0,0,0,0,0,False,False,False,0,3,2020-09-24T16:40:24.853,0,,
2020,2,2818,555,30,793,2,18,5,0,5,5,2,3,2,0,False,False,False,0,2,2020-09-24T17:33:26.497,5,,3.0
2020,2,2818,565,30,5056,3,19,6,26,0,0,0,0,0,0,False,False,False,0,2,2020-09-21T15:08:27.353,0,,0.0
2020,2,2818,570,30,4937,13,50,9,-1,0,0,0,0,0,0,False,False,False,0,1,2020-09-24T17:21:23.673,0,,0.0
2020,2,2818,585,5,3477,2,5,3,3,5,2,4,1,4,0,False,False,False,0,3,2020-09-22T18:55:34.907,5,,1.0
2020,2,2818,590,5,4803,2,4,4,10,10,0,10,0,10,0,False,False,False,0,3,2020-09-21T15:46:00.007,10,,0.0
2020,2,2818,595,5,5220,13,2,10,5,0,0,0,0,0,0,False,False,False,0,2,2020-09-24T17:33:37.897,0,,0.0
2020,2,2818,600,5,3477,2,3,3,12,11,-1,11,0,11,0,False,False,False,0,2,2021-02-25T22:35:02.397,11,,0.0
2020,2,2818,610,5,5220,2,29,6,28,30,2,29,1,29,0,False,False,False,0,2,2020-09-22T18:55:56.33,30,,1.0
2020,2,2818,670,30,6414,2,31,10,0,2,2,1,1,1,0,False,False,False,0,1,2020-09-21T16:19:16.973,2,,1.0
2020,2,2818,675,30,63,13,17,7,15,0,0,0,0,0,0,False,False,False,0,4,2020-09-21T17:55:49.173,0,,
2020,2,2818,680,30,4523,13,5,10,11,0,0,0,0,0,0,False,False,False,0,4,2020-09-24T16:40:24.853,0,,0.0
2020,2,2818,685,30,7268,2,4,3,4,5,1,5,0,5,0,False,False,False,0,2,2020-09-21T16:25:07.497,5,,0.0
2020,2,2818,690,30,6419,13,6,4,6,0,0,0,0,0,0,True,False,False,0,3,2021-03-10T17:46:45.683,0,,0.0
2020,2,2818,700,5,3477,2,19,6,33,39,6,39,0,39,0,True,False,False,2,2,2020-09-24T18:26:09.817,39,,0.0
2020,2,2818,710,5,2554,13,45,5,-5,0,0,0,0,0,0,True,False,False,0,1,2021-03-10T17:46:55.053,0,,
2020,2,2818,715,5,5220,13,6,8,18,0,0,0,0,0,0,True,False,False,0,2,2020-09-21T16:40:47.283,0,,0.0
2020,2,2818,720,30,793,2,18,3,0,8,8,2,6,2,0,False,False,False,1,2,2020-09-24T17:33:50.867,8,,6.0
2020,2,2818,745,30,4937,2,45,5,-4,-1,3,-2,1,-2,0,False,False,False,0,1,2020-09-21T16:54:08.89,-1,,1.0
2020,2,2818,750,30,119,3,12,2,15,0,0,0,0,0,0,True,False,False,0,2,2021-03-08T17:08:51.993,0,,0.0
2020,2,2818,765,5,2554,2,46,3,1,16,15,5,11,5,0,False,False,False,1,1,2020-09-21T16:59:47.743,16,,11.0
2020,2,2818,770,5,5220,2,7,6,18,18,0,18,0,18,0,False,False,False,0,3,2020-09-21T17:01:41.28,18,,0.0
2020,2,2818,775,5,2554,2,4,9,3,8,5,4,4,4,0,False,False,False,0,1,2020-09-24T18:26:22.467,8,,4.0
2020,2,2818,780,5,2554,2,48,9,-5,7,12,4,3,4,0,False,False,False,0,1,2020-09-21T17:05:37.56,7,,3.0
2020,2,2818,785,5,5220,2,4,9,5,5,0,5,0,5,0,False,False,False,0,3,2020-09-21T17:08:12.013,5,,0.0
2020,2,2818,790,5,3477,2,4,10,10,12,2,12,0,12,0,False,False,False,0,3,2020-09-21T17:11:14.067,12,,0.0
2020,2,2818,800,5,3477,2,13,4,4,12,8,11,1,11,0,False,False,False,0,3,2020-09-24T16:40:24.853,12,,1.0
2020,2,2818,805,5,2554,2,4,4,2,2,0,2,0,2,0,False,False,False,0,1,2020-09-21T17:17:56.223,2,,0.0
2020,2,2818,840,5,2554,2,12,5,1,22,21,11,11,11,0,False,False,False,1,4,2021-03-08T17:09:23.56,22,,11.0
2020,2,2818,845,5,5220,2,5,3,13,14,1,14,0,14,0,False,False,False,0,2,2020-09-24T16:40:24.853,14,,0.0
2020,2,2818,860,5,2554,2,31,9,1,8,7,8,0,8,0,False,False,False,0,4,2020-09-21T18:05:55.673,8,,0.0
2020,2,2818,865,5,5220,2,4,9,10,13,3,13,0,13,0,False,False,False,0,3,2020-09-24T16:40:24.853,13,,0.0
2020,2,2818,870,5,2554,2,4,9,3,7,4,6,1,6,0,False,False,False,0,1,2020-09-21T17:37:46.427,7,,1.0
2020,2,2818,880,5,3477,13,12,7,18,0,0,0,0,0,0,False,False,False,0,3,2021-03-08T17:09:55.987,0,,0.0
2020,2,2818,885,5,4719,2,32,3,5,14,9,12,2,12,0,False,False,False,0,3,2021-02-25T15:48:09.287,14,,2.0
2020,2,2819,10,31,5096,2,33,6,19,63,44,63,0,63,0,False,False,False,0,4,2021-03-09T19:09:14.43,63,,0.0
2020,2,2819,20,31,5096,2,16,10,13,13,0,13,0,13,6,True,False,False,0,3,2021-03-08T15:20:21.843,13,,0.0
2020,2,2819,35,15,922,13,35,6,25,0,0,0,0,0,0,False,False,False,0,4,2020-09-24T19:34:27.243,0,,0.0
2020,2,2819,45,15,7591,2,4,5,8,12,4,12,0,12,0,False,False,False,0,2,2020-09-21T10:49:06.247,12,,0.0
2020,2,2819,55,15,152,3,18,3,-1,0,0,0,0,0,0,False,False,False,0,2,2020-09-24T18:10:42.873,0,,0.0
2020,2,2819,60,15,4997,2,4,9,9,11,2,11,0,11,0,False,False,False,0,3,2020-09-21T10:56:43.143,11,,0.0
2020,2,2819,75,15,7591,13,12,3,12,0,0,0,0,0,0,False,False,False,0,2,2020-09-24T18:09:54.607,0,,0.0
2020,2,2819,90,15,7592,13,26,5,11,0,0,0,0,0,0,False,False,False,0,3,2021-03-04T22:15:08.657,0,,0.0
2020,2,2819,100,31,3504,13,48,3,-2,0,0,0,0,0,0,False,False,False,0,1,2021-02-25T15:50:50.443,0,,0.0
2020,2,2819,105,31,6724,2,7,5,14,14,0,14,0,14,0,False,False,False,0,3,2020-09-24T19:35:09.73,14,,0.0
2020,2,2819,115,31,5080,2,6,10,9,9,0,9,0,9,6,True,False,False,0,3,2021-02-08T23:35:02.43,9,,0.0
2020,2,2819,135,15,922,2,5,3,6,9,3,9,0,9,0,False,False,False,0,4,2020-09-21T11:34:43.58,9,,0.0
2020,2,2819,140,15,6501,2,23,7,43,45,2,44,1,44,0,False,False,False,0,3,2020-09-24T20:28:05.943,45,,1.0
2020,2,2819,145,15,2407,13,29,3,8,0,0,0,0,0,0,False,False,False,0,2,2021-02-25T15:52:08.503,0,,0.0
2020,2,2819,150,15,1561,13,16,9,5,0,0,0,0,0,0,True,False,False,0,1,2020-09-22T16:33:44.81,0,,0.0
2020,2,2819,155,15,922,2,17,1,18,19,1,19,0,19,6,False,False,False,0,3,2020-09-24T20:34:27.667,19,,0.0
2020,2,2819,185,31,6390,2,6,10,7,8,1,7,1,7,0,False,False,False,0,2,2020-09-24T18:47:24.897,8,,1.0
2020,2,2819,195,31,2675,2,50,9,-3,12,15,12,0,12,0,False,False,False,0,3,2021-02-08T23:36:38.19,12,,0.0
2020,2,2819,200,31,6724,2,4,4,8,10,2,10,0,10,0,False,False,False,0,3,2020-09-24T19:36:46.527,10,,0.0
2020,2,2819,210,31,5080,13,12,2,23,0,0,0,0,0,0,False,False,False,0,3,2021-03-08T17:12:12.197,0,,0.0
2020,2,2819,220,31,5080,2,39,4,7,10,3,8,2,8,0,False,False,False,0,3,2020-09-24T19:38:00.69,10,,2.0
2020,2,2819,235,31,2675,2,4,10,8,8,0,8,0,8,0,False,False,False,0,2,2020-09-24T19:38:34.06,8,,0.0
2020,2,2819,260,15,6501,2,35,8,15,17,2,16,1,16,0,False,False,False,0,3,2021-02-08T23:41:30,17,,1.0
2020,2,2819,270,15,7592,13,35,5,13,0,0,0,0,0,0,False,False,False,0,3,2021-02-25T15:53:52.933,0,,0.0
2020,2,2819,280,15,6501,2,52,4,2,12,10,12,0,12,0,False,False,False,0,2,2020-09-24T19:40:10.833,12,,0.0
2020,2,2819,295,15,4997,2,50,3,-2,7,9,6,1,6,0,False,False,False,0,3,2021-03-04T14:49:17.377,7,,1.0
2020,2,2819,315,31,2675,2,4,9,5,5,0,5,0,5,0,False,False,False,0,3,2020-09-21T12:56:52.603,5,,0.0
2020,2,2819,330,31,5096,13,19,2,30,0,0,0,0,0,0,False,False,False,0,3,2020-09-24T19:41:26.85,0,,
2020,2,2819,385,31,5096,2,13,4,2,4,2,3,1,3,6,True,False,False,0,3,2020-09-24T19:11:08.703,4,,1.0
2020,2,2819,400,15,922,2,4,4,7,8,1,7,1,7,0,False,False,False,0,4,2020-09-24T19:41:56.053,8,,1.0
2020,2,2819,405,15,7591,2,3,5,14,14,0,14,0,14,0,False,False,False,0,2,2020-09-24T19:42:15.973,14,,0.0
2020,2,2819,410,15,1561,2,48,10,-3,-3,0,-3,0,-3,0,False,False,False,0,1,2020-09-21T13:31:13.043,-3,,0.0
2020,2,2819,415,15,1561,2,4,4,4,9,5,8,1,8,0,False,False,False,0,1,2020-09-24T19:42:50.25,9,,1.0
2020,2,2819,425,15,4997,2,5,3,4,7,3,7,0,7,0,False,False,False,0,3,2020-09-24T19:43:58.753,7,,0.0
2020,2,2819,430,15,4997,2,9,2,19,23,4,23,0,23,0,False,False,False,0,3,2020-09-24T19:44:49.827,23,,0.0
2020,2,2819,440,15,7592,13,17,7,17,0,0,0,0,0,0,False,False,False,0,3,2020-09-24T18:13:18.903,0,,0.0
2020,2,2819,450,15,922,13,9,2,17,0,0,0,0,0,0,False,False,False,0,2,2020-09-24T19:45:27.677,0,,0.0
2020,2,2819,465,31,6724,2,35,10,14,16,2,15,1,15,0,False,False,False,0,3,2020-09-24T19:11:39.197,16,,1.0
2020,2,2819,490,15,8099,2,48,9,-4,6,10,6,0,6,0,False,False,False,0,1,2020-09-22T16:46:23.097,6,,0.0
2020,2,2819,505,15,2757,2,39,10,4,4,0,4,0,4,0,False,False,False,0,4,2020-09-24T19:45:52.567,4,,0.0
2020,2,2819,520,15,4997,2,39,4,7,8,1,7,1,7,0,False,False,False,0,3,2020-09-24T17:35:20.247,8,,1.0
2020,2,2819,530,15,2757,2,5,3,13,13,0,13,0,13,0,False,False,False,0,4,2020-09-24T20:23:25.21,13,,0.0
2020,2,2819,540,15,7591,2,5,5,9,9,0,9,0,9,0,True,False,False,0,3,2020-09-24T19:17:15.017,9,,0.0
2020,2,2819,550,15,2407,2,4,3,7,7,0,7,0,7,0,False,False,False,0,2,2020-09-21T14:29:20.39,7,,0.0
2020,2,2819,595,31,5080,2,13,9,6,17,11,14,3,14,0,False,False,False,0,4,2020-09-24T19:46:55.663,17,,3.0
2020,2,2819,620,31,5096,2,32,9,-3,4,7,3,1,3,0,True,False,False,0,4,2020-09-24T18:13:37.247,4,,1.0
2020,2,2819,625,31,2675,2,8,7,18,18,0,18,0,18,6,False,False,False,0,3,2020-09-24T19:47:32.333,18,,0.0
2020,2,2819,640,15,6501,2,2,4,8,10,2,9,1,9,0,False,False,False,0,2,2020-09-24T18:47:38.1,10,,1.0
2020,2,2819,645,15,8099,2,6,4,5,6,1,6,0,6,0,False,False,False,0,1,2020-09-24T19:48:39.737,6,,0.0
2020,2,2819,655,15,2757,2,6,5,11,12,1,11,1,11,0,False,False,False,0,3,2020-09-24T19:48:54.973,12,,1.0
2020,2,2819,665,15,2407,13,13,5,8,0,0,0,0,0,0,False,False,False,0,2,2021-01-15T20:59:14.97,0,,0.0
2020,2,2819,670,15,8099,2,51,9,-4,6,10,2,4,2,0,False,False,False,0,1,2020-09-24T17:35:20.247,6,,4.0
2020,2,2819,675,15,4997,2,12,5,2,2,0,2,0,2,6,False,False,False,0,3,2021-03-08T17:13:03.99,2,,0.0
2020,2,2819,730,15,2407,2,13,10,2,24,22,22,2,22,0,False,False,False,0,3,2021-02-08T23:45:44.99,24,,2.0
2020,2,2819,740,15,2407,2,2,9,4,8,4,7,1,7,0,False,False,False,0,2,2020-09-24T18:47:49.28,8,,1.0
2020,2,2819,750,15,922,13,9,6,16,0,0,0,0,0,0,False,False,False,0,4,2020-09-24T19:50:26.923,0,,0.0
2020,2,2819,755,15,1561,2,11,5,12,14,2,14,0,14,6,False,False,False,0,1,2020-09-24T19:50:47.43,14,,0.0
2020,2,2819,780,31,6390,2,6,1,17,18,1,18,0,18,0,False,False,False,0,2,2020-09-22T19:53:51.91,18,,0.0
2020,2,2819,790,31,5080,13,13,9,6,0,0,0,0,0,0,False,False,False,0,3,2021-02-25T15:56:24.22,0,,0.0
2020,2,2819,800,31,5096,13,48,10,-2,0,0,0,0,0,0,False,False,False,0,1,2020-09-21T16:11:35.923,0,,0.0
2020,2,2819,815,15,2757,2,2,9,9,11,2,10,1,10,0,True,False,False,0,3,2020-09-24T20:28:46.72,11,,1.0
2020,2,2819,825,15,8099,3,46,3,1,0,0,0,0,0,0,False,False,False,0,1,2020-09-24T19:32:43.603,0,,0.0
2020,2,2819,830,15,2407,13,9,3,14,0,0,0,0,0,0,False,False,False,0,2,2020-09-24T19:32:30.7,0,,0.0
2020,2,2819,850,31,2675,2,4,9,4,5,1,4,1,4,0,False,False,False,0,3,2020-09-24T19:32:11.57,5,,1.0
2020,2,2819,860,31,3504,13,4,10,2,0,0,0,0,0,0,False,False,False,0,1,2020-09-24T19:31:56.6,0,,0.0
2020,2,2819,865,31,6724,13,6,9,7,0,0,0,0,0,0,False,False,False,0,3,2020-09-24T19:31:18.903,0,,
2020,2,2819,880,31,2675,13,5,6,17,0,0,0,0,0,0,False,False,False,0,3,2020-09-24T19:30:58.843,0,,0.0
2020,2,2819,885,31,6724,2,5,5,5,5,0,5,0,5,0,True,False,False,0,3,2020-09-24T19:29:49.19,5,,0.0
2020,2,2819,910,15,2407,2,3,5,9,9,0,8,1,8,0,False,False,False,0,2,2020-09-24T19:30:23.437,9,,1.0
2020,2,2819,915,15,4997,13,6,4,-6,0,0,0,0,0,0,False,False,False,0,3,2021-03-04T22:16:09.11,0,,0.0
2020,2,2820,10,32,1427,2,26,9,4,4,0,4,0,4,0,False,False,False,0,3,2021-02-15T11:59:53.633,4,,0.0
2020,2,2820,20,32,1427,13,19,2,22,0,0,0,0,0,0,False,False,False,0,2,2020-09-21T10:31:16.65,0,,0.0
2020,2,2820,30,1,525,2,49,10,-2,4,6,2,2,2,0,False,False,False,0,3,2021-02-15T15:06:40.99,4,,2.0
2020,2,2820,50,1,6405,2,49,5,-1,4,5,1,3,1,0,False,False,False,0,2,2020-09-21T17:40:25.58,4,,
2020,2,2820,55,1,6406,2,18,10,2,9,7,7,2,7,0,True,False,False,0,2,2021-03-08T15:23:29.307,9,,2.0
2020,2,2820,60,1,245,2,26,9,1,12,11,10,2,10,0,True,False,False,1,2,2020-09-24T17:43:16.84,12,,2.0
2020,2,2820,70,1,5152,13,9,3,11,0,0,0,0,0,0,False,False,False,0,2,2020-09-21T18:15:51.487,0,,
2020,2,2820,85,1,245,2,2,4,4,4,0,4,0,4,6,False,False,False,0,2,2020-09-21T18:07:47,4,,0.0
2020,2,2820,105,32,7494,2,13,10,2,8,6,5,3,5,0,False,False,False,0,3,2020-09-21T11:09:37.783,8,,3.0
2020,2,2820,120,32,7494,13,8,1,18,0,0,0,0,0,0,False,False,False,0,3,2020-09-24T22:04:12.067,0,,0.0
2020,2,2820,130,1,245,2,34,4,-3,2,5,1,1,1,0,True,False,False,0,3,2020-09-24T19:18:14.95,2,,1.0
2020,2,2820,140,1,7315,13,35,4,11,0,0,0,0,0,0,False,False,False,0,3,2021-03-04T22:17:36.047,0,,0.0
2020,2,2820,145,32,7330,2,47,5,0,2,2,1,1,1,0,False,False,False,0,4,2020-09-22T17:07:11.72,2,,1.0
2020,2,2820,165,1,245,3,2,9,8,0,0,0,0,0,0,False,False,False,0,2,2021-02-15T12:02:48.403,0,,0.0
2020,2,2820,170,1,525,2,52,4,2,10,8,8,2,8,0,False,False,False,0,3,2020-09-24T15:19:31.297,10,,2.0
2020,2,2820,185,1,245,2,49,3,-3,8,11,3,5,3,0,False,False,False,1,2,2020-09-21T18:08:38.903,8,,5.0
2020,2,2820,200,1,525,2,5,5,8,5,-3,5,0,5,0,False,False,False,0,3,2020-09-21T11:47:27.127,5,,0.0
2020,2,2820,235,32,1791,13,4,3,2,0,0,0,0,0,0,False,False,False,0,2,2021-02-15T12:00:14.99,0,,0.0
2020,2,2820,245,1,7315,2,19,7,50,54,4,51,3,51,0,False,False,False,0,3,2020-09-24T14:28:00.16,54,,3.0
2020,2,2820,265,1,6406,2,51,10,-7,3,10,3,0,3,0,False,False,False,0,1,2021-02-18T19:46:05.637,3,,0.0
2020,2,2820,285,32,7128,2,4,9,5,25,20,10,15,10,0,False,False,False,1,3,2020-09-21T12:21:40.273,25,,15.0
2020,2,2820,290,32,7128,2,2,9,6,9,3,8,1,8,0,False,False,False,0,2,2020-09-21T12:23:24.983,9,,1.0
2020,2,2820,295,32,7807,2,44,3,-4,-3,1,-3,0,-3,0,False,False,False,0,1,2020-09-21T12:25:25.39,-3,,0.0
2020,2,2820,300,32,1791,2,13,9,3,3,0,3,0,3,0,False,False,False,0,3,2020-09-21T12:27:16.893,3,,0.0
2020,2,2820,320,32,7128,13,19,2,16,0,0,0,0,0,0,False,False,False,0,2,2020-09-22T17:07:43.24,0,,0.0
2020,2,2820,325,32,1427,13,4,9,4,0,0,0,0,0,0,False,False,False,0,4,2020-09-21T12:36:36.263,0,,0.0
2020,2,2820,345,1,525,2,5,5,3,10,7,10,0,10,0,False,False,False,1,3,2021-02-17T17:29:15.163,10,,0.0
2020,2,2820,355,1,6405,2,4,5,8,8,0,8,0,8,0,False,False,False,0,2,2020-09-24T19:27:46.577,8,,0.0
2020,2,2820,360,1,525,2,2,3,5,5,0,5,0,5,0,False,False,False,0,3,2020-09-21T12:51:24.483,5,,0.0
2020,2,2820,365,1,6405,2,19,2,49,49,0,49,0,49,0,False,False,False,0,2,2021-02-15T15:07:38.507,49,,0.0
2020,2,2820,375,1,245,2,50,9,-2,0,2,-1,1,-1,0,False,False,False,0,2,2021-02-15T15:04:20.893,0,,1.0
2020,2,2820,390,1,4307,2,48,9,-5,6,11,5,1,5,0,False,False,False,0,1,2020-09-21T12:59:29.503,6,,1.0
2020,2,2820,415,32,1427,2,39,4,5,5,0,5,0,5,0,False,False,False,0,3,2020-09-24T16:21:11.917,5,,0.0
2020,2,2820,435,32,7128,2,2,9,5,13,8,11,2,11,0,False,False,False,0,2,2020-09-21T13:08:42.86,13,,2.0
2020,2,2820,445,32,1427,13,5,5,2,0,0,0,0,0,0,False,False,False,0,3,2020-09-21T13:12:14.717,0,,0.0
2020,2,2820,450,32,1427,13,35,9,14,0,0,0,0,0,0,False,False,False,0,3,2020-09-24T19:28:32.137,0,,0.0
2020,2,2820,480,1,4307,2,44,3,-4,3,7,2,1,2,0,True,False,False,0,1,2021-02-15T15:05:29.12,3,,1.0
2020,2,2820,485,1,6406,2,51,5,-1,-1,0,-1,0,-1,0,True,True,False,0,1,2021-02-18T19:46:40,-3,,0.0
2020,2,2820,500,32,7128,2,2,3,5,18,13,12,6,12,0,False,False,False,0,2,2020-09-21T17:35:52.75,18,,6.0
2020,2,2820,505,32,7128,13,35,8,18,0,0,0,0,0,0,True,False,False,0,3,2021-02-15T15:05:38.12,0,,0.0
2020,2,2820,515,32,1791,13,47,5,2,0,0,0,0,0,0,True,False,False,0,3,2021-02-15T15:06:00.59,0,,0.0
2020,2,2820,525,1,6405,13,11,6,22,0,0,0,0,0,0,False,False,False,0,3,2020-09-24T14:32:19.147,0,,0.0
2020,2,2820,530,1,245,2,5,3,9,9,0,9,0,9,0,False,False,False,0,3,2021-02-15T12:06:21.097,9,,0.0
2020,2,2820,580,32,7808,2,13,9,2,3,1,2,1,2,0,False,False,False,0,3,2020-09-22T17:07:59.223,3,,1.0
2020,2,2820,585,32,7494,2,50,10,-2,15,17,1,14,1,0,False,False,False,0,2,2021-03-04T14:53:10.913,15,,14.0
2020,2,2820,595,32,1427,2,30,10,2,10,8,8,2,8,0,False,False,False,0,4,2020-09-21T14:29:01.363,10,,2.0
2020,2,2820,615,32,1427,2,4,10,3,7,4,4,3,4,0,False,False,False,0,3,2020-09-24T19:50:18.56,7,,3.0
2020,2,2820,620,32,1427,13,17,4,6,0,0,0,0,0,0,False,False,False,0,3,2020-09-21T14:40:29.367,0,,0.0
2020,2,2820,640,1,525,2,4,9,3,4,1,3,1,3,0,False,False,False,0,3,2021-02-17T17:29:54.77,4,,1.0
2020,2,2820,645,1,245,2,29,3,14,25,11,14,11,14,0,False,False,False,1,2,2020-09-24T18:05:06.453,25,,11.0
2020,2,2820,650,1,5152,2,44,3,-2,6,8,5,1,5,0,False,False,False,0,4,2021-02-15T15:09:39.52,6,,1.0
2020,2,2820,655,1,6405,13,21,2,34,0,0,0,0,0,0,False,False,False,0,2,2020-09-24T14:49:14.08,0,,0.0
2020,2,2820,660,1,5152,13,21,1,18,0,0,0,0,0,0,False,False,False,0,3,2020-09-24T22:07:04.787,0,,0.0
2020,2,2820,665,1,525,2,2,9,8,12,4,9,3,9,0,False,False,False,0,3,2020-09-21T15:04:15.893,12,,3.0
2020,2,2820,670,1,6406,13,17,1,25,0,0,0,0,0,0,False,False,False,0,1,2020-09-21T15:06:27.3,0,,0.0
2020,2,2820,700,1,5152,2,5,3,4,6,2,5,1,5,0,False,False,False,0,3,2020-09-24T18:45:22.787,6,,
2020,2,2820,720,32,7128,2,13,4,6,26,20,9,17,9,0,False,False,False,2,2,2020-09-21T15:32:13.197,26,,17.0
2020,2,2820,730,32,7128,2,2,9,6,10,4,7,3,7,0,False,False,False,1,2,2021-03-03T14:56:38.493,10,,3.0
2020,2,2820,735,32,7494,13,24,2,20,0,0,0,0,0,0,True,False,False,0,3,2020-09-24T20:00:19.313,0,,
2020,2,2820,740,32,7494,13,11,7,24,0,0,0,0,0,0,True,False,False,0,2,2020-09-24T22:08:23.853,0,,0.0
2020,2,2820,745,32,7128,2,2,10,6,24,18,24,0,24,6,False,False,False,0,3,2020-09-22T17:08:12.877,24,,0.0
2020,2,2820,790,32,7128,3,19,6,31,0,0,0,0,0,0,False,False,False,0,2,2020-09-21T15:54:38.323,0,,0.0
2020,2,2820,795,32,7807,13,11,5,14,0,0,0,0,0,0,False,False,False,0,1,2020-09-24T21:59:21.287,0,,0.0
2020,2,2820,800,32,1791,2,2,9,13,14,1,13,1,13,0,False,False,False,0,2,2020-09-24T19:01:16.69,14,,1.0
2020,2,2820,815,32,7128,13,2,9,6,0,0,0,0,0,0,False,False,False,0,2,2020-09-21T16:15:24.36,0,,
2020,2,2820,820,32,1791,3,6,8,20,0,0,0,0,0,0,False,False,False,0,2,2020-09-24T20:08:30.08,0,,0.0
2020,2,2820,830,32,7494,2,13,10,1,1,0,1,0,1,0,False,False,False,0,3,2020-09-21T16:10:56.843,1,,
2020,2,2820,835,32,7494,2,7,2,20,30,10,30,0,30,0,False,False,False,0,3,2020-09-24T20:12:38.797,30,,0.0
2020,2,2820,855,1,7315,2,2,10,9,13,4,12,1,12,0,False,False,False,0,3,2020-09-21T16:24:38.877,13,,1.0
2020,2,2820,865,1,245,2,5,3,9,8,-1,10,-2,10,0,False,False,False,0,3,2020-09-24T19:04:41.01,8,,-2.0
2020,2,2820,870,1,5152,2,17,8,16,20,4,20,0,20,0,False,False,False,0,4,2021-02-15T15:04:20.893,20,,0.0
2020,2,2820,880,1,5032,13,11,5,13,0,0,0,0,0,0,False,False,False,0,1,2020-09-21T16:38:26.11,0,,0.0
2020,2,2821,20,13,6528,2,46,3,-1,4,5,0,4,0,0,True,False,False,0,1,2021-02-17T17:54:19.41,4,,4.0
2020,2,2821,30,3,6935,2,4,10,4,6,2,6,0,6,0,False,False,False,0,3,2020-09-21T10:31:17.23,6,,0.0
2020,2,2821,35,3,6936,2,34,4,-5,-3,2,-3,0,-3,0,True,False,False,0,3,2020-09-21T10:33:13.913,-3,,0.0
2020,2,2821,50,13,6528,2,30,10,0,7,7,4,3,4,0,True,False,False,0,1,2021-02-18T12:20:03.893,7,,3.0
2020,2,2821,55,13,876,2,13,10,8,13,5,12,1,12,0,False,False,False,0,3,2020-09-22T18:36:30.7,13,,1.0
2020,2,2821,60,13,496,13,5,3,4,0,0,0,0,0,0,False,False,False,0,2,2020-09-24T13:09:38.253,0,,0.0
2020,2,2821,85,3,6936,2,2,10,3,4,1,4,0,4,0,False,False,False,0,2,2020-09-21T11:01:03.623,4,,0.0
2020,2,2821,90,3,6454,2,6,9,13,29,16,27,2,27,0,False,False,False,0,3,2020-09-21T11:06:16.263,29,,2.0
2020,2,2821,100,3,6935,2,2,9,9,14,5,13,1,13,0,False,False,False,0,2,2020-09-21T11:09:56.883,14,,1.0
2020,2,2821,125,3,902,13,12,2,18,0,0,0,0,0,0,False,False,False,0,1,2020-09-21T15:40:30.697,0,,0.0
2020,2,2821,130,3,902,2,16,4,2,4,2,3,1,3,0,False,False,False,0,1,2020-09-21T11:20:28.193,4,,1.0
2020,2,2821,165,13,1430,13,30,10,-1,0,0,0,0,0,0,False,False,False,0,4,2020-09-24T13:20:21.677,0,,0.0
2020,2,2821,175,3,902,2,48,9,-3,18,21,18,0,18,0,False,False,False,0,1,2020-09-21T11:34:06.12,18,,0.0
2020,2,2821,185,3,2976,2,13,10,5,11,6,9,2,9,0,True,False,False,0,4,2020-09-21T11:36:55.807,11,,2.0
2020,2,2821,190,3,5017,2,46,9,1,1,0,1,0,1,6,False,False,False,0,1,2020-09-24T13:23:28.7,1,,0.0
2020,2,2821,205,13,6528,2,6,9,5,6,1,6,0,6,0,False,False,False,0,4,2020-09-21T11:47:59.603,6,,0.0
2020,2,2821,210,13,6529,2,34,4,-4,6,10,4,2,4,0,True,False,False,0,3,2020-09-23T20:19:23.347,6,,2.0
2020,2,2821,225,13,1430,2,4,10,5,13,8,7,6,7,0,False,False,False,1,4,2021-02-18T12:20:42.403,13,,6.0
2020,2,2821,230,13,876,2,35,2,30,38,8,36,2,36,0,False,False,False,0,3,2020-09-21T11:57:33.007,38,,2.0
2020,2,2821,235,13,2455,13,12,5,10,0,0,0,0,0,0,False,False,False,0,1,2020-09-21T12:00:17.467,0,,0.0
2020,2,2821,240,13,1430,2,7,5,10,10,0,10,0,10,6,False,False,False,0,3,2021-02-17T20:08:08.923,10,,0.0
2020,2,2821,255,3,7672,2,6,8,16,19,3,18,1,18,0,False,False,False,0,3,2020-09-24T13:29:28.597,19,,1.0
2020,2,2821,280,3,6936,2,6,7,22,25,3,23,2,23,0,False,False,False,0,2,2020-09-23T20:20:17.97,25,,2.0
2020,2,2821,290,3,6454,13,6,10,9,0,0,0,0,0,0,False,False,False,0,4,2020-09-23T19:44:26.897,0,,0.0
2020,2,2821,295,3,6936,13,7,2,21,0,0,0,0,0,0,False,False,False,0,3,2020-09-21T12:17:28.127,0,,0.0
2020,2,2821,310,13,6529,2,26,10,4,6,2,6,0,6,0,False,True,True,0,3,2020-09-21T12:21:17.78,5,,0.0
2020,2,2821,335,13,876,2,4,3,5,5,0,5,0,5,0,False,False,False,0,3,2020-09-21T12:26:48.17,5,,0.0
2020,2,2821,350,13,876,13,35,6,17,0,0,0,0,0,0,False,False,False,0,3,2021-03-04T22:19:12.667,0,,0.0
2020,2,2821,355,3,6936,2,13,9,4,11,7,11,0,11,0,False,False,False,0,2,2020-09-22T18:50:22.163,11,,0.0
2020,2,2821,375,3,2688,2,6,4,5,7,2,7,0,7,0,False,False,False,0,3,2021-02-17T17:58:02.69,7,,0.0
2020,2,2821,395,13,6528,2,5,10,3,12,9,12,0,12,0,False,False,False,0,4,2020-09-23T21:10:07.323,12,,0.0
2020,2,2821,400,13,2455,2,28,9,-3,9,12,8,1,8,0,False,False,False,0,1,2020-09-21T12:41:21.95,9,,1.0
2020,2,2821,405,13,2136,2,5,3,13,13,0,13,0,13,0,False,False,False,0,2,2020-09-21T12:43:06.437,13,,0.0
2020,2,2821,415,13,876,2,12,2,15,15,0,15,0,15,0,False,False,False,0,2,2020-09-21T12:54:26.517,15,,0.0
2020,2,2821,425,13,496,2,2,10,3,9,6,7,2,7,0,False,False,False,0,3,2020-09-21T12:56:10.127,9,,2.0
2020,2,2821,455,3,6935,2,12,10,11,13,2,13,0,13,0,False,False,False,0,3,2021-03-08T17:05:19.557,13,,0.0
2020,2,2821,460,3,6935,2,4,5,2,5,3,4,1,4,0,False,False,False,0,2,2020-09-23T00:36:43.613,5,,1.0
2020,2,2821,500,3,7671,2,45,10,-1,13,14,2,11,2,0,True,False,False,1,1,2020-09-23T00:37:18.877,13,,11.0
2020,2,2821,510,3,6454,13,11,6,19,0,0,0,0,0,0,True,False,False,0,3,2020-09-23T20:13:01.783,0,,0.0
2020,2,2821,540,13,2455,13,20,6,27,0,0,0,0,0,0,False,False,False,0,2,2020-09-21T13:36:31.657,0,,0.0
2020,2,2821,545,13,496,2,50,9,-3,6,9,4,2,4,0,False,False,False,0,3,2020-09-21T15:47:05.56,6,,2.0
2020,2,2821,550,13,496,2,2,10,4,6,2,5,1,5,0,False,False,False,0,3,2020-09-21T13:52:04.847,6,,1.0
2020,2,2821,560,13,496,2,39,9,8,15,7,13,2,13,0,False,False,False,0,3,2020-09-21T14:02:28.92,15,,2.0
2020,2,2821,570,13,6528,2,46,3,-1,4,5,3,1,3,0,True,False,False,0,4,2020-09-21T14:09:14.117,4,,1.0
2020,2,2821,575,13,876,2,35,7,22,24,2,24,0,24,0,False,False,False,0,3,2020-09-21T14:11:07.523,24,,0.0
2020,2,2821,585,13,1430,13,17,8,17,0,0,0,0,0,0,False,False,False,0,3,2020-09-21T14:14:55.397,0,,0.0
2020,2,2821,600,13,2136,13,35,2,22,0,0,0,0,0,0,False,False,False,0,3,2020-09-21T14:18:05.05,0,,
2020,2,2821,605,13,876,13,8,4,13,0,0,0,0,0,0,False,False,False,0,2,2021-02-17T20:08:08.923,0,,0.0
2020,2,2821,625,3,2688,2,2,4,8,22,14,14,8,14,0,False,False,False,1,3,2020-09-21T14:25:11.767,22,,8.0
2020,2,2821,630,3,6935,13,4,9,9,0,0,0,0,0,0,False,False,False,0,2,2020-09-21T14:26:53.573,0,,0.0
2020,2,2821,640,3,6936,2,13,10,3,5,2,4,1,4,0,False,False,False,0,3,2020-09-21T14:30:03.35,5,,1.0
2020,2,2821,660,13,2136,13,2,9,6,0,0,0,0,0,0,False,False,False,0,2,2020-09-22T18:48:12.43,0,,0.0
2020,2,2821,665,13,6528,2,5,9,6,11,5,9,2,9,0,False,False,False,0,4,2021-02-25T19:18:11.7,11,,2.0
2020,2,2821,670,13,2455,2,32,3,1,7,6,1,6,1,0,False,False,False,0,1,2020-09-24T14:03:17.777,7,,6.0
2020,2,2821,675,13,6528,2,4,4,6,11,5,11,0,11,0,False,False,False,1,4,2020-09-22T18:48:23.467,11,,0.0
2020,2,2821,685,13,496,2,5,8,17,23,6,23,0,23,0,False,False,False,0,3,2020-09-21T14:45:35.453,23,,0.0
2020,2,2821,695,13,876,13,8,10,13,0,0,0,0,0,0,False,False,False,0,2,2021-02-17T20:08:08.923,0,,0.0
2020,2,2821,805,13,2136,2,2,9,3,3,0,3,0,3,0,False,False,False,0,3,2020-09-21T15:09:56.11,3,,0.0
2020,2,2822,20,26,309,13,11,2,20,0,0,0,0,0,0,True,False,False,0,4,2020-09-23T00:24:20.083,0,,0.0
2020,2,2822,25,26,7695,2,45,10,-8,35,43,23,12,23,0,False,False,False,0,1,2020-09-21T10:29:54.843,35,,12.0
2020,2,2822,35,26,7453,3,4,5,6,0,0,0,0,0,0,False,False,False,0,2,2020-09-25T13:24:37.79,0,,0.0
2020,2,2822,40,26,4616,2,11,3,13,16,3,14,2,14,0,True,False,False,0,3,2020-09-21T14:00:00.443,16,,2.0
2020,2,2822,70,16,3938,13,19,6,24,0,0,0,0,0,0,False,False,False,0,2,2020-09-21T10:49:17.637,0,,0.0
2020,2,2822,75,16,3938,3,4,4,5,0,0,0,0,0,0,False,False,False,0,3,2020-09-24T19:13:44.11,0,,0.0
2020,2,2822,85,26,309,2,50,9,-2,14,16,1,13,1,0,False,False,False,0,2,2020-09-21T17:17:23.82,14,,13.0
2020,2,2822,95,26,4616,2,51,5,-4,10,14,-1,11,-1,0,True,False,False,1,2,2020-09-24T19:36:25.567,10,,11.0
2020,2,2822,120,16,374,2,31,10,6,13,7,10,3,10,0,False,False,False,0,4,2020-09-24T17:02:29.313,13,,3.0
2020,2,2822,135,16,374,13,35,8,16,0,0,0,0,0,0,False,False,False,0,3,2020-09-24T20:57:17.133,0,,0.0
2020,2,2822,150,26,4282,2,4,10,7,12,5,10,2,10,0,False,False,False,0,3,2020-09-21T11:16:36.06,12,,2.0
2020,2,2822,155,26,4619,13,5,6,25,0,0,0,0,0,0,False,False,False,0,3,2020-09-24T20:57:28.11,0,,
2020,2,2822,170,26,4619,13,8,1,39,0,0,0,0,0,0,False,False,False,0,2,2021-02-17T20:14:15.063,0,,0.0
2020,2,2822,180,26,309,13,5,3,6,0,0,0,0,0,0,False,False,False,0,3,2020-09-21T17:06:19.153,0,,0.0
2020,2,2822,185,26,4282,13,35,7,21,0,0,0,0,0,0,False,False,False,0,4,2021-02-17T20:14:58.693,0,,0.0
2020,2,2822,195,16,7681,2,44,3,-6,1,7,0,1,0,0,False,False,False,0,1,2020-09-24T20:58:14.64,1,,1.0
2020,2,2822,200,16,3938,13,46,3,-1,0,0,0,0,0,0,False,False,False,0,1,2020-09-24T17:07:57.643,0,,0.0
2020,2,2822,205,16,374,13,31,9,12,0,0,0,0,0,0,False,False,False,0,3,2020-09-24T17:08:33.16,0,,0.0
2020,2,2822,225,26,309,2,6,10,3,5,2,3,2,3,0,True,False,False,0,2,2021-02-24T21:25:47.163,5,,2.0
2020,2,2822,230,26,4282,13,13,3,2,0,0,0,0,0,0,False,False,False,0,4,2020-09-21T11:50:47.8,0,,0.0
2020,2,2822,240,16,6499,2,46,3,2,12,10,10,2,10,0,False,False,False,0,1,2020-09-21T11:56:59.387,12,,2.0
2020,2,2822,255,16,374,13,12,9,-2,0,0,0,0,0,0,False,False,False,0,4,2021-03-08T17:29:39.303,0,,0.0
2020,2,2822,265,16,374,2,54,10,0,5,5,3,2,3,0,False,False,False,0,4,2020-09-24T18:32:07.857,5,,2.0
2020,2,2822,270,16,7681,13,47,5,1,0,0,0,0,0,0,False,False,False,0,1,2020-09-21T12:07:47.337,0,,0.0
2020,2,2822,285,16,374,2,7,5,10,10,0,10,0,10,6,True,False,False,0,3,2020-09-23T02:29:52.347,10,,0.0
2020,2,2822,330,26,4616,2,4,4,3,22,19,4,18,4,0,False,False,False,2,1,2020-09-21T12:27:29.197,22,,18.0
2020,2,2822,350,26,309,13,8,4,10,0,0,0,0,0,0,True,False,False,0,4,2020-09-24T19:13:56.977,0,,
2020,2,2822,355,26,309,2,50,10,-3,6,9,2,4,2,0,False,False,False,0,2,2020-09-21T17:18:36.25,6,,4.0
2020,2,2822,360,26,7453,2,9,3,14,14,0,14,0,14,6,False,False,False,0,2,2020-09-21T12:46:36.1,14,,0.0
2020,2,2822,380,16,7681,2,48,10,0,6,6,5,1,5,0,False,False,False,0,1,2020-09-24T17:11:48.733,6,,1.0
2020,2,2822,390,16,374,2,4,10,6,7,1,6,1,6,0,False,False,False,0,2,2020-09-21T12:53:30.617,7,,1.0
2020,2,2822,395,16,3938,13,5,5,10,0,0,0,0,0,0,False,False,False,0,2,2020-09-21T12:55:08.93,0,,0.0
2020,2,2822,400,16,4143,2,46,3,4,6,2,5,1,5,0,False,False,False,0,3,2020-09-24T19:08:43.573,6,,1.0
2020,2,2822,410,16,3938,13,22,8,31,0,0,0,0,0,0,False,False,False,0,3,2020-09-24T17:13:17.71,0,,
2020,2,2822,415,16,374,13,6,4,11,0,0,0,0,0,0,False,False,False,0,3,2020-09-21T13:03:46.267,0,,0.0
2020,2,2822,445,26,4282,2,39,4,5,11,6,9,2,9,0,False,False,False,0,4,2020-09-24T20:58:59.58,11,,2.0
2020,2,2822,455,26,7695,2,28,4,4,14,10,12,2,12,0,False,False,False,0,1,2020-09-24T20:59:08.56,14,,2.0
2020,2,2822,465,26,4619,2,12,10,4,8,4,6,2,6,0,False,False,False,0,2,2020-09-21T13:16:39.277,8,,2.0
2020,2,2822,490,26,309,2,4,7,19,32,13,32,0,32,0,False,True,False,0,2,2021-02-17T20:18:05.043,28,,0.0
2020,2,2822,505,16,374,2,5,5,10,20,10,10,10,10,0,False,False,False,1,3,2020-09-21T13:32:32.683,20,,10.0
2020,2,2822,510,16,121,13,2,10,10,0,0,0,0,0,0,False,False,False,0,2,2020-09-21T13:34:22.527,0,,0.0
2020,2,2822,520,16,7210,13,48,9,-6,0,0,0,0,0,0,False,False,False,0,1,2020-09-21T13:38:45.65,0,,0.0
2020,2,2822,535,26,309,2,4,5,8,17,9,8,9,8,0,False,False,False,0,2,2020-09-21T17:14:39.997,17,,9.0
2020,2,2822,560,26,4282,2,17,9,13,14,1,13,1,13,0,False,False,False,0,4,2020-09-21T16:48:52.527,14,,1.0
2020,2,2822,565,26,309,2,35,7,22,25,3,22,3,22,0,False,False,False,0,3,2020-09-25T13:25:00.567,25,,3.0
2020,2,2822,570,26,4619,13,8,1,15,0,0,0,0,0,0,False,False,False,0,3,2021-02-17T20:20:21.857,0,,0.0
2020,2,2822,595,16,374,2,4,3,9,9,0,9,0,9,0,False,False,False,0,3,2020-09-21T14:01:58.723,9,,0.0
2020,2,2822,605,16,3938,2,5,5,9,14,5,9,5,9,0,False,False,False,1,3,2020-09-24T19:32:31.873,14,,5.0
2020,2,2822,610,16,121,3,2,9,9,0,0,0,0,0,0,False,False,False,0,2,2020-09-23T02:28:24.35,0,,0.0
2020,2,2822,615,16,374,2,12,10,12,13,1,13,0,13,0,False,False,False,0,2,2021-03-08T17:30:47.11,13,,0.0
2020,2,2822,635,16,7681,2,31,9,-1,10,11,8,2,8,0,False,False,False,0,1,2020-09-24T19:32:49.733,10,,2.0
2020,2,2822,665,26,4282,2,4,4,6,22,16,7,15,7,0,False,False,False,1,4,2020-09-21T14:22:48.483,22,,15.0
2020,2,2822,675,26,309,13,12,1,24,0,0,0,0,0,0,True,False,False,0,3,2020-09-23T16:35:53.133,0,,0.0
2020,2,2822,690,16,7176,13,19,1,50,0,0,0,0,0,0,False,False,False,0,3,2021-03-04T22:20:38.37,0,,
2020,2,2822,695,16,3938,3,4,3,4,0,0,0,0,0,0,False,False,False,0,2,2020-09-21T14:36:57.863,0,,0.0
2020,2,2822,700,16,121,2,4,10,3,11,8,3,8,3,0,False,False,False,1,2,2020-09-21T14:39:00.533,11,,8.0
2020,2,2822,705,16,7176,2,35,9,13,22,9,13,9,13,0,False,False,False,1,3,2020-09-21T14:41:26.143,22,,9.0
2020,2,2822,710,16,374,2,46,3,0,2,2,1,1,1,0,True,False,False,0,3,2020-09-24T22:07:01.21,2,,1.0
2020,2,2822,715,16,3938,2,22,8,45,54,9,54,0,54,6,False,False,False,0,3,2020-09-23T16:38:07.563,54,,0.0
2020,2,2822,730,26,4616,2,51,10,-5,7,12,3,4,3,0,True,False,False,0,2,2020-09-21T14:52:20.89,7,,4.0
2020,2,2822,745,26,4282,2,6,4,5,5,0,5,0,5,0,False,False,False,0,4,2021-02-25T20:02:43.03,5,,0.0
2020,2,2822,760,26,4282,2,8,4,13,19,6,15,4,15,0,False,False,False,0,4,2020-09-24T22:23:57.487,19,,4.0
2020,2,2822,790,26,4619,13,6,4,12,0,0,0,0,0,0,False,False,False,0,3,2020-09-24T22:25:01.827,0,,
2020,2,2822,830,16,374,2,4,10,5,11,6,5,6,5,0,False,False,False,1,3,2020-09-24T19:33:16.317,11,,6.0
2020,2,2822,835,16,3938,2,4,4,14,16,2,15,1,15,0,False,False,False,0,3,2020-09-24T17:18:55.01,16,,1.0
2020,2,2822,850,16,374,3,5,10,8,0,0,0,0,0,0,False,False,False,0,3,2021-01-12T23:21:21.843,0,,0.0
2020,2,2822,855,16,7176,2,4,5,8,8,0,8,0,8,0,False,False,False,0,4,2020-09-24T19:14:26.57,8,,0.0
2020,2,2822,860,16,3938,2,13,9,2,10,8,7,3,7,0,True,False,False,0,3,2020-09-23T02:30:41.22,10,,3.0
2020,2,2822,865,16,7681,2,17,8,19,25,6,19,6,19,0,False,False,False,0,1,2020-09-24T17:20:16.287,25,,
2020,2,2822,870,16,7176,13,4,5,11,0,0,0,0,0,0,False,False,False,0,4,2020-09-24T19:14:37.803,0,,0.0
2020,2,2822,875,16,3938,13,35,7,18,0,0,0,0,0,0,False,False,False,0,3,2020-09-25T13:27:10.17,0,,0.0
2020,2,2822,890,16,7681,2,16,9,5,7,2,5,2,5,0,False,False,False,0,1,2020-09-24T21:01:59.657,7,,2.0
2020,2,2822,900,16,4143,2,4,5,12,14,2,13,1,13,0,False,False,False,0,2,2020-09-24T20:20:40.767,14,,1.0
2020,2,2822,930,26,309,2,50,3,-2,1,3,-1,2,-1,0,False,False,False,0,2,2020-09-24T20:18:15.907,1,,2.0
2020,2,2822,940,26,4619,2,4,5,6,6,0,6,0,6,0,False,False,False,0,2,2020-09-25T13:27:52.367,6,,0.0
2020,2,2822,955,16,4143,2,4,3,1,8,7,8,0,8,0,False,False,False,0,2,2020-09-21T16:04:41.07,8,,0.0
2020,2,2822,965,16,7681,13,44,3,-5,0,0,0,0,0,0,False,False,False,0,1,2020-09-21T16:07:32.213,0,,0.0
2020,2,2822,970,16,7176,13,19,8,54,0,0,0,0,0,0,False,False,False,0,3,2020-09-21T16:08:51.127,0,,
2020,2,2822,985,16,7681,2,5,10,4,4,0,4,0,4,0,False,False,False,0,1,2020-09-24T22:26:52.247,4,,0.0
2020,2,2822,1000,16,4143,3,12,4,14,0,0,0,0,0,0,False,False,False,0,3,2021-02-17T20:33:07.823,0,,0.0
2020,2,2822,1010,16,3938,2,13,4,3,5,2,5,0,5,0,True,False,False,0,2,2020-09-24T19:12:30.143,5,,0.0
2020,2,2822,1015,16,7681,2,6,9,4,4,0,4,0,4,0,False,False,False,0,1,2020-09-21T16:25:32.637,4,,0.0
2020,2,2823,10,27,6397,2,39,4,5,9,4,6,3,6,0,False,False,False,0,4,2020-09-21T10:30:21.92,9,,3.0
2020,2,2823,20,27,505,3,13,9,5,0,0,0,0,0,0,False,False,False,0,4,2021-04-01T19:46:51.247,0,,0.0
2020,2,2823,45,27,153,2,44,3,-5,6,11,1,5,1,0,False,False,False,0,1,2020-09-21T10:42:42.747,6,,5.0
2020,2,2823,60,27,650,2,13,9,3,9,6,8,1,8,0,False,False,False,1,3,2020-09-21T10:47:49.777,9,,1.0
2020,2,2823,70,27,650,2,6,9,14,16,2,16,0,16,0,False,False,False,0,3,2020-09-21T10:52:35.4,16,,0.0
2020,2,2823,80,27,5069,2,44,3,1,6,5,5,1,5,0,True,False,False,0,2,2020-09-21T15:56:10.52,6,,1.0
2020,2,2823,105,27,650,2,12,10,4,4,0,4,0,4,6,False,False,False,0,2,2020-09-21T11:06:51.7,4,,0.0
2020,2,2823,125,19,3233,2,4,3,13,15,2,15,0,15,0,False,False,False,0,2,2020-09-21T11:13:16.033,15,,0.0
2020,2,2823,140,19,3233,2,4,3,10,14,4,12,2,12,0,False,False,False,0,2,2020-09-21T11:18:32.847,14,,2.0
2020,2,2823,160,19,7173,2,2,4,11,13,2,12,1,12,0,False,False,False,0,3,2020-09-21T16:02:31.873,13,,1.0
2020,2,2823,195,27,153,2,45,5,-3,9,12,4,5,4,0,False,False,False,0,1,2020-09-21T11:38:31.4,9,,5.0
2020,2,2823,210,27,7408,2,13,10,3,7,4,5,2,5,0,False,False,False,1,2,2020-09-24T14:20:35.95,7,,2.0
2020,2,2823,240,19,3233,13,5,3,6,0,0,0,0,0,0,False,False,False,0,3,2020-09-24T16:02:15.893,0,,0.0
2020,2,2823,255,27,650,2,5,5,4,7,3,6,1,6,0,True,False,False,0,3,2020-09-24T15:04:51.52,7,,1.0
2020,2,2823,260,27,7408,2,2,9,6,12,6,9,3,9,0,False,False,False,0,2,2020-09-21T12:01:44.287,12,,3.0
2020,2,2823,270,27,7408,2,22,2,43,54,11,43,11,43,6,False,False,False,1,3,2020-09-24T15:08:43.847,54,,11.0
2020,2,2823,285,19,3233,13,6,7,19,0,0,0,0,0,0,False,False,False,0,2,2020-09-21T12:14:02.347,0,,0.0
2020,2,2823,290,19,54,2,46,3,2,8,6,4,4,4,0,True,False,False,0,3,2020-09-24T15:10:04.27,8,,4.0
2020,2,2823,295,19,1510,2,47,10,2,19,17,19,0,19,0,False,False,False,0,1,2020-09-21T12:18:15.953,19,,0.0
2020,2,2823,300,19,1510,2,48,10,-3,18,21,16,2,16,0,False,False,False,0,1,2020-09-21T12:19:58.633,18,,2.0
2020,2,2823,305,19,1510,13,12,5,-3,0,0,0,0,0,0,False,False,False,0,1,2021-03-08T17:33:09.847,0,,0.0
2020,2,2823,315,19,1510,2,34,4,-4,-2,2,-3,1,-3,0,True,False,False,0,2,2020-09-21T12:24:59.573,-2,,1.0
2020,2,2823,325,27,5050,2,44,3,1,9,8,5,4,5,0,False,False,False,0,1,2020-09-21T12:38:30.377,9,,4.0
2020,2,2823,335,27,5069,2,47,10,1,4,3,1,3,1,0,True,False,False,0,3,2020-09-21T15:56:36.093,4,,3.0
2020,2,2823,350,27,7408,13,29,3,13,0,0,0,0,0,0,False,False,False,0,2,2020-09-21T12:44:36.337,0,,0.0
2020,2,2823,360,27,650,13,8,8,21,0,0,0,0,0,0,False,False,False,0,3,2020-09-21T12:54:33.883,0,,
2020,2,2823,385,27,7408,13,3,6,15,0,0,0,0,0,0,False,False,False,0,2,2021-02-17T19:04:51.797,0,,0.0
2020,2,2823,420,19,6266,13,46,9,0,0,0,0,0,0,0,False,False,False,0,1,2020-09-24T14:39:38.32,0,,0.0
2020,2,2823,425,19,7173,13,11,3,9,0,0,0,0,0,0,True,False,False,0,3,2020-09-24T14:06:29.66,0,,0.0
2020,2,2823,430,19,54,2,12,10,14,16,2,15,1,15,0,False,False,False,0,3,2020-09-24T14:21:01.61,16,,1.0
2020,2,2823,440,19,54,3,30,10,0,0,0,0,0,0,0,True,False,False,0,3,2020-09-21T13:23:09.34,0,,0.0
2020,2,2823,445,19,7175,2,5,5,7,7,0,7,0,7,0,False,False,False,0,3,2020-09-21T13:24:40.493,7,,0.0
2020,2,2823,450,19,54,2,35,2,25,26,1,26,0,26,0,False,False,False,0,3,2020-09-21T13:26:16.58,26,,0.0
2020,2,2823,460,19,1510,2,48,9,-6,12,18,11,1,11,0,False,False,False,0,1,2020-09-21T13:29:20.107,12,,1.0
2020,2,2823,470,19,54,3,2,4,4,0,0,0,0,0,0,False,False,False,0,3,2020-09-24T16:04:36.833,0,,0.0
2020,2,2823,490,27,5050,2,18,3,-1,9,10,0,9,0,0,True,False,False,1,2,2021-03-03T14:59:14.24,9,,9.0
2020,2,2823,515,27,5069,2,21,6,38,38,0,38,0,38,6,False,False,False,0,2,2021-02-17T19:06:29.257,38,,0.0
2020,2,2823,535,19,54,2,8,4,12,17,5,15,2,15,0,False,False,False,0,3,2020-09-21T13:54:24.617,17,,2.0
2020,2,2823,540,19,7173,2,51,9,-3,4,7,-3,7,-3,0,False,False,False,0,3,2020-09-21T14:06:04.247,4,,7.0
2020,2,2823,545,19,3233,2,5,3,9,9,0,9,0,9,0,False,False,False,0,3,2021-02-24T18:03:02.99,9,,0.0
2020,2,2823,550,19,7173,2,30,10,-3,2,5,0,2,0,0,False,False,False,0,3,2021-02-17T21:12:25.8,2,,2.0
2020,2,2823,555,19,3233,13,5,3,5,0,0,0,0,0,0,False,False,False,0,2,2021-03-04T22:22:31.803,0,,0.0
2020,2,2823,565,27,650,2,13,10,1,14,13,10,4,10,0,False,False,False,0,3,2020-09-21T14:11:26.687,14,,4.0
2020,2,2823,580,27,7852,2,13,9,2,21,19,21,0,21,6,False,False,False,0,3,2020-09-24T15:23:35.827,21,,0.0
2020,2,2823,595,19,54,2,12,7,47,49,2,49,0,49,0,True,False,False,0,3,2020-09-24T13:42:25.287,49,,0.0
2020,2,2823,600,19,6273,2,17,4,13,16,3,15,1,15,0,False,False,False,0,4,2020-09-24T14:50:03.693,16,,1.0
2020,2,2823,610,19,7173,2,51,9,-3,3,6,2,1,2,0,False,False,False,0,3,2020-09-21T14:27:42.343,3,,1.0
2020,2,2823,625,19,7456,2,47,10,1,1,0,1,0,1,6,True,False,False,0,1,2020-09-22T18:39:32.977,1,,0.0
2020,2,2823,640,27,505,2,12,5,5,5,0,5,0,5,0,True,False,False,0,3,2020-09-21T14:35:34.34,5,,
2020,2,2823,665,19,7173,13,8,9,14,0,0,0,0,0,0,False,False,False,0,2,2020-09-21T14:45:56.603,0,,0.0
2020,2,2823,675,19,3233,2,12,6,20,20,0,20,0,20,0,False,False,False,0,2,2020-09-24T15:25:58.677,20,,0.0
2020,2,2823,680,19,7173,2,51,10,-2,8,10,5,3,5,0,False,False,False,0,3,2020-09-21T14:50:57.687,8,,3.0
2020,2,2823,685,19,3233,2,50,9,-3,-2,1,-2,0,-2,0,True,False,False,1,2,2020-09-24T15:30:53.583,-2,,0.0
2020,2,2823,700,27,650,2,4,9,6,9,3,9,0,9,0,False,False,False,0,3,2020-09-21T14:55:36.42,9,,0.0
2020,2,2823,715,27,7408,2,4,3,8,19,11,12,7,12,0,False,False,False,0,2,2020-09-21T14:59:52.443,19,,7.0
2020,2,2823,730,27,650,2,13,9,5,8,3,7,1,7,0,False,False,False,0,2,2021-02-17T19:08:14.807,8,,1.0
2020,2,2823,740,27,5050,2,9,2,18,18,0,18,0,18,6,False,False,False,0,1,2020-09-21T15:10:59.063,18,,0.0
2020,2,2823,760,19,7173,13,44,9,-5,0,0,0,0,0,0,True,False,False,0,2,2020-09-21T15:18:28.927,0,,0.0
2020,2,2823,765,19,54,2,13,4,4,12,8,9,3,9,0,False,False,False,0,3,2020-09-21T15:20:40.837,12,,3.0
2020,2,2823,770,19,3233,2,12,1,16,16,0,16,0,16,0,False,False,False,0,2,2021-03-08T17:34:20.803,16,,0.0
2020,2,2823,775,19,1510,3,31,10,-4,0,0,0,0,0,0,True,False,False,0,1,2020-09-22T18:40:29.66,0,,0.0
2020,2,2823,780,19,54,2,8,1,28,33,5,30,3,30,0,True,False,False,0,3,2020-09-24T15:33:07.36,33,,3.0
2020,2,2823,825,27,650,13,7,2,30,0,0,0,0,0,0,False,False,False,0,3,2020-09-21T15:34:44.023,0,,0.0
2020,2,2823,835,19,7173,2,4,10,13,13,0,13,0,13,0,False,False,False,0,3,2020-09-24T14:51:44.863,13,,0.0
2020,2,2823,840,19,6273,2,32,5,-1,3,4,1,2,1,0,False,False,False,0,4,2020-09-24T15:35:32.62,3,,2.0
2020,2,2823,845,19,7173,2,35,10,14,17,3,17,0,17,0,False,False,False,0,3,2020-09-21T15:41:42.757,17,,0.0
2020,2,2823,850,19,7173,13,3,2,16,0,0,0,0,0,0,False,False,False,0,2,2020-09-21T15:41:28.46,0,,0.0
2020,2,2823,865,19,54,13,9,2,29,0,0,0,0,0,0,True,False,False,0,3,2020-09-21T15:45:49.453,0,,
2020,2,2823,870,19,54,2,12,6,16,18,2,17,1,17,0,False,False,False,0,3,2021-03-08T17:34:48.527,18,,1.0
2020,2,2823,875,19,54,13,17,10,13,0,0,0,0,0,0,False,False,False,0,3,2020-09-21T15:49:12.18,0,,0.0
2020,2,2823,885,19,7173,2,35,3,11,12,1,11,1,11,0,False,False,False,0,3,2020-09-21T15:50:48.437,12,,1.0
2020,2,2824,15,20,958,13,35,7,19,0,0,0,0,0,0,False,False,False,0,3,2020-09-24T19:04:21.723,0,,0.0
2020,2,2824,35,20,213,3,46,3,2,0,0,0,0,0,0,False,False,False,0,3,2020-09-22T10:22:02.497,0,,0.0
2020,2,2824,40,20,6388,2,4,9,13,18,5,16,2,16,0,False,False,False,0,2,2020-09-24T14:26:58.47,18,,2.0
2020,2,2824,50,20,5140,2,4,9,4,7,3,5,2,5,0,False,False,False,0,1,2020-09-22T10:37:02.607,7,,2.0
2020,2,2824,55,20,6388,13,6,9,9,0,0,0,0,0,0,False,False,False,0,3,2020-09-24T16:43:58.953,0,,0.0
2020,2,2824,85,23,2994,13,7,6,16,0,0,0,0,0,0,False,False,False,0,2,2020-09-24T16:44:12.98,0,,0.0
2020,2,2824,95,23,2994,2,4,9,5,9,4,5,4,5,0,False,False,False,0,3,2020-09-24T13:38:14.093,9,,4.0
2020,2,2824,125,20,213,3,4,10,4,0,0,0,0,0,0,False,False,False,0,2,2020-09-22T11:03:11.603,0,,0.0
2020,2,2824,130,20,6388,2,6,4,13,29,16,13,16,13,0,False,False,False,2,3,2021-03-03T15:03:18.187,29,,16.0
2020,2,2824,180,23,7689,2,35,8,18,22,4,19,3,19,0,False,False,False,0,3,2020-09-22T11:21:45.063,22,,3.0
2020,2,2824,185,23,7688,13,22,6,47,0,0,0,0,0,0,False,False,False,0,3,2021-02-18T19:04:06.957,0,,0.0
2020,2,2824,210,20,7353,3,42,4,5,0,0,0,0,0,0,False,False,False,0,3,2020-09-22T11:30:06.99,0,,0.0
2020,2,2824,215,20,958,3,7,6,15,0,0,0,0,0,0,False,False,False,0,3,2020-09-24T18:30:01.88,0,,0.0
2020,2,2824,225,23,7241,2,44,9,-4,9,13,7,2,7,0,False,False,False,0,1,2020-09-24T16:48:07.747,9,,2.0
2020,2,2824,240,23,596,2,38,9,3,3,0,3,0,3,0,False,False,False,0,4,2021-02-18T15:43:00.27,3,,0.0
2020,2,2824,245,23,7241,2,46,3,0,6,6,3,3,3,0,False,False,False,0,1,2020-09-22T11:41:01.903,6,,3.0
2020,2,2824,255,23,2994,2,47,5,0,9,9,5,4,5,0,True,False,False,0,1,2020-09-24T19:27:31.077,9,,4.0
2020,2,2824,265,23,7688,13,5,5,12,0,0,0,0,0,0,False,False,False,0,3,2020-09-22T11:54:09.647,0,,
2020,2,2824,270,23,2994,2,4,9,7,13,6,12,1,12,0,False,False,False,0,3,2020-09-24T16:48:35.793,13,,1.0
2020,2,2824,280,23,2994,2,16,10,6,13,7,10,3,10,0,False,False,False,0,4,2020-09-22T12:00:54.987,13,,3.0
2020,2,2824,285,23,7240,2,47,10,1,3,2,3,0,3,6,False,False,False,0,1,2021-02-18T12:13:34.39,3,,0.0
2020,2,2824,300,20,5140,2,48,9,-4,16,20,16,0,16,0,False,False,False,0,1,2020-09-24T18:30:30.383,16,,0.0
2020,2,2824,305,20,306,2,46,3,4,10,6,8,2,8,0,False,False,False,0,1,2021-02-18T12:14:11.483,10,,2.0
2020,2,2824,310,20,6388,2,6,4,14,25,11,21,4,21,0,True,False,False,1,3,2021-02-18T15:45:22.63,25,,4.0
2020,2,2824,315,20,7888,2,7,2,17,17,0,17,0,17,0,False,False,False,0,4,2020-09-22T12:16:19.347,17,,0.0
2020,2,2824,330,20,958,2,2,10,6,6,0,6,0,6,6,False,False,False,0,2,2020-09-22T12:20:42.533,6,,0.0
2020,2,2824,355,23,2256,2,26,10,1,19,18,14,5,14,0,True,False,False,1,2,2020-09-23T19:14:30.523,19,,5.0
2020,2,2824,360,23,7250,2,4,10,12,15,3,12,3,12,0,False,False,False,1,3,2021-02-25T16:12:05.7,15,,3.0
2020,2,2824,365,23,2994,13,5,9,5,0,0,0,0,0,0,False,False,False,0,3,2020-09-22T12:29:48.177,0,,0.0
2020,2,2824,375,23,7689,2,4,3,6,20,14,16,4,16,0,False,False,False,0,2,2021-02-18T15:45:48.107,20,,4.0
2020,2,2824,405,23,4949,2,7,6,15,15,0,15,0,15,6,False,False,False,0,3,2021-02-18T12:14:59.227,15,,0.0
2020,2,2824,425,20,2408,3,46,9,-2,0,0,0,0,0,0,False,False,False,0,1,2020-09-24T18:32:45.27,0,,0.0
2020,2,2824,430,20,6388,2,2,9,5,8,3,5,3,5,0,False,False,False,2,2,2020-09-22T12:45:56.093,8,,3.0
2020,2,2824,435,20,7353,13,6,4,8,0,0,0,0,0,0,False,False,False,0,3,2021-03-04T22:23:56.54,0,,0.0
2020,2,2824,440,23,7250,2,5,3,3,5,2,5,0,5,0,False,False,False,0,3,2020-09-22T12:52:32.617,5,,0.0
2020,2,2824,445,23,7688,2,45,10,4,4,0,4,0,4,0,False,False,False,0,3,2021-02-18T15:43:00.27,4,,0.0
2020,2,2824,455,23,7240,2,47,5,2,2,0,2,0,2,0,False,False,False,0,1,2020-09-22T12:55:50.043,2,,0.0
2020,2,2824,460,23,2994,2,5,5,4,12,8,12,0,12,0,False,False,False,0,3,2020-09-24T19:06:04.333,12,,0.0
2020,2,2824,505,23,7688,13,2,10,6,0,0,0,0,0,0,True,False,False,0,2,2020-09-24T16:49:50.397,0,,0.0
2020,2,2824,510,23,2994,2,47,5,1,4,3,3,1,3,0,False,False,False,0,4,2020-09-24T17:08:58.953,4,,1.0
2020,2,2824,515,23,7689,13,29,6,20,0,0,0,0,0,0,False,False,False,0,3,2020-09-24T20:29:11.337,0,,
2020,2,2824,525,23,2994,2,2,4,4,10,6,4,6,4,0,True,False,False,0,3,2020-09-23T19:14:56.697,10,,6.0
2020,2,2824,530,23,7246,2,11,2,20,31,11,25,6,25,0,True,False,False,0,4,2021-02-18T19:04:34.553,31,,6.0
2020,2,2824,555,23,2994,2,32,5,1,1,0,1,0,1,6,False,False,False,0,4,2020-09-22T13:26:30.73,1,,0.0
2020,2,2824,570,20,5140,2,28,5,-1,20,21,20,0,20,0,False,False,False,1,1,2020-09-24T18:35:04.06,20,,0.0
2020,2,2824,575,20,1162,2,53,10,-4,16,20,6,10,6,0,False,False,False,0,4,2020-09-24T18:35:18.443,16,,10.0
2020,2,2824,585,20,5140,2,4,9,4,4,0,4,0,4,0,False,False,False,0,1,2020-09-22T13:36:59.423,4,,0.0
2020,2,2824,590,20,5140,2,12,5,7,12,5,12,0,12,0,False,False,False,0,1,2021-02-25T16:13:35.927,12,,
2020,2,2824,595,20,5140,2,32,9,-1,15,16,14,1,14,0,False,False,False,0,1,2020-09-24T18:35:45.45,10,,1.0
2020,2,2824,600,20,306,2,46,3,3,9,6,6,3,6,0,False,False,False,0,1,2020-09-24T16:52:34.977,9,,3.0
2020,2,2824,605,20,2408,2,48,9,-6,8,14,5,3,5,0,False,False,False,0,1,2020-09-24T16:53:37.393,8,,3.0
2020,2,2824,615,23,7241,2,51,9,-5,6,11,-1,7,-1,0,False,False,False,0,1,2021-02-18T15:49:10.863,2,,7.0
2020,2,2824,625,23,3957,2,5,5,0,6,6,0,6,0,0,True,False,False,0,3,2020-09-23T19:15:10.457,6,,6.0
2020,2,2824,635,23,2994,2,28,10,0,6,6,1,5,1,0,False,False,False,1,4,2021-02-18T12:16:22.397,6,,5.0
2020,2,2824,650,23,7250,13,7,6,17,0,0,0,0,0,0,False,False,False,0,4,2021-02-18T15:49:22.75,0,,
2020,2,2824,680,23,2994,2,46,3,-1,8,9,0,8,0,0,True,False,False,1,4,2020-09-23T19:15:25.433,8,,8.0
2020,2,2824,685,23,2994,13,29,6,17,0,0,0,0,0,0,True,False,False,0,3,2020-09-23T19:15:36.45,0,,0.0
2020,2,2824,700,20,7353,2,13,10,0,5,5,3,2,3,0,False,False,False,0,3,2020-09-22T14:27:16.653,5,,2.0
2020,2,2824,705,20,1162,13,35,5,11,0,0,0,0,0,0,False,False,False,0,4,2021-02-18T15:48:22.203,0,,0.0
2020,2,2824,715,20,6388,3,26,4,8,0,0,0,0,0,0,False,False,False,0,3,2020-09-24T18:36:11.533,0,,0.0
2020,2,2824,725,23,2994,2,35,7,17,18,1,17,1,17,0,False,False,False,0,4,2020-09-24T19:28:53.107,18,,1.0
2020,2,2824,730,23,2994,2,30,3,1,2,1,2,0,2,0,False,False,False,0,4,2020-09-22T14:45:05.2,2,,0.0
2020,2,2824,740,23,2994,13,35,8,15,0,0,0,0,0,0,False,False,False,0,3,2020-09-22T14:49:01.437,0,,0.0
2020,2,2824,750,23,7250,2,2,4,9,17,8,14,3,14,0,False,False,False,0,3,2020-09-22T14:53:43.66,17,,3.0
2020,2,2824,785,20,7353,2,5,3,2,9,7,2,7,2,0,False,False,False,1,3,2020-09-24T16:56:57.45,9,,7.0
2020,2,2824,795,20,5140,2,28,3,-4,3,7,-3,6,-3,0,False,False,False,1,1,2020-09-22T15:06:58.113,3,,6.0
2020,2,2824,800,20,6388,2,13,10,6,6,0,6,0,6,0,False,False,False,0,3,2020-09-22T15:08:47.61,6,,0.0
2020,2,2824,805,20,7353,2,26,10,1,9,8,7,2,7,0,False,False,False,0,3,2020-09-22T15:10:43.723,9,,2.0
2020,2,2824,810,20,2408,2,13,9,4,17,13,12,5,12,0,False,False,False,0,3,2020-09-22T15:12:47.607,17,,5.0
2020,2,2824,815,20,5140,2,16,9,4,12,8,10,2,10,0,False,False,False,0,1,2020-09-22T16:21:06.623,12,,2.0
2020,2,2824,850,23,7688,13,19,2,36,0,0,0,0,0,0,False,False,False,0,3,2020-09-24T14:26:58.47,0,,
2020,2,2824,895,20,213,2,6,8,17,18,1,18,0,18,0,False,False,False,0,2,2020-09-24T18:36:42.297,18,,0.0
2020,2,2824,900,20,958,13,4,5,7,0,0,0,0,0,0,False,False,False,0,3,2020-09-22T15:43:15.627,0,,0.0
2020,2,2824,905,20,5140,2,48,9,-5,8,13,6,2,6,0,False,False,False,1,1,2020-09-22T15:42:48.247,8,,2.0
2020,2,2824,910,20,958,2,4,10,5,7,2,6,1,6,0,False,False,False,0,3,2020-09-22T15:42:40.403,7,,1.0
2020,2,2824,915,20,5140,2,4,4,3,15,12,12,3,12,0,False,False,False,0,1,2020-09-22T15:44:47.407,15,,3.0
2020,3,2825,10,17,6276,2,46,3,2,7,5,4,3,4,0,True,False,False,0,4,2020-09-25T11:51:47.393,7,,3.0
2020,3,2825,20,17,2253,2,35,7,16,20,4,18,2,18,0,False,False,False,0,3,2020-10-01T15:02:21.383,20,,2.0
2020,3,2825,35,17,4305,2,3,5,14,19,5,18,1,18,0,True,False,False,1,3,2020-10-01T15:18:58.057,19,,1.0
2020,3,2825,65,17,7087,2,2,9,3,3,0,3,0,3,6,False,False,False,0,3,2020-09-25T12:41:51.76,3,,0.0
2020,3,2825,80,15,8099,2,28,9,-1,24,25,17,7,17,0,False,False,False,2,1,2020-10-01T15:19:14.253,24,,7.0
2020,3,2825,90,15,2407,3,5,3,10,0,0,0,0,0,0,False,False,False,0,3,2020-09-25T12:51:15.123,0,,0.0
2020,3,2825,95,15,7591,2,26,10,2,2,0,2,0,2,0,False,False,False,0,3,2020-10-01T16:26:10.957,2,,0.0
2020,3,2825,105,17,7024,2,5,10,3,11,8,6,5,6,0,False,False,False,0,1,2020-10-01T16:50:05.187,11,,5.0
2020,3,2825,115,17,7024,2,4,10,6,8,2,7,1,7,0,False,False,False,0,3,2020-10-01T16:50:05.187,8,,1.0
2020,3,2825,130,17,2253,13,2,9,6,0,0,0,0,0,0,False,False,False,0,2,2020-10-01T15:03:55.057,0,,
2020,3,2825,165,15,7591,2,39,4,4,16,12,4,12,4,0,False,False,False,2,3,2020-10-01T15:19:23.92,16,,12.0
2020,3,2825,180,15,7592,2,13,9,2,3,1,2,1,2,0,False,False,False,0,2,2020-09-25T13:49:26.603,3,,1.0
2020,3,2825,190,15,4997,2,5,3,9,11,2,10,1,10,0,False,False,False,0,2,2020-10-01T15:05:41.333,11,,1.0
2020,3,2825,210,17,2253,2,4,2,15,17,2,15,2,15,0,False,False,False,0,2,2020-09-25T14:29:47.697,17,,2.0
2020,3,2825,220,17,4752,2,12,4,9,11,2,9,2,9,0,True,False,False,0,3,2020-09-25T14:34:30.773,11,,2.0
2020,3,2825,245,17,7024,2,48,9,-5,4,9,1,3,1,0,False,False,False,0,1,2020-09-25T14:47:25.937,4,,3.0
2020,3,2825,250,17,2253,2,6,9,6,8,2,6,2,6,0,False,False,False,0,2,2021-02-25T14:13:21.38,8,,2.0
2020,3,2825,265,17,4913,13,11,3,14,0,0,0,0,0,0,False,False,False,0,1,2020-10-01T14:50:18.453,0,,
2020,3,2825,270,17,6274,2,7,5,13,15,2,15,0,15,6,False,False,False,0,3,2020-10-01T16:50:05.187,15,,0.0
2020,3,2825,285,15,2757,2,4,10,6,9,3,8,1,8,0,False,False,False,0,4,2020-09-25T15:00:51.757,9,,1.0
2020,3,2825,295,15,2407,13,19,7,50,0,0,0,0,0,0,False,False,False,0,2,2021-02-15T22:25:43.517,0,,0.0
2020,3,2825,300,15,922,13,7,2,17,0,0,0,0,0,0,False,False,False,0,4,2020-09-25T15:15:27.933,0,,
2020,3,2825,310,15,7591,2,13,9,0,6,6,4,2,4,0,False,False,False,0,3,2020-10-01T16:26:20.707,6,,2.0
2020,3,2825,340,17,7087,2,4,3,4,4,0,4,0,4,0,False,False,False,0,3,2020-09-25T15:24:12.197,4,,0.0
2020,3,2825,345,17,6274,3,35,9,8,0,0,0,0,0,0,False,False,False,0,3,2020-09-25T15:25:45.83,0,,0.0
2020,3,2825,350,17,6274,13,9,2,20,0,0,0,0,0,0,False,False,False,0,3,2020-10-01T16:50:05.187,0,,0.0
2020,3,2825,360,15,4997,13,32,3,1,0,0,0,0,0,0,False,False,False,0,3,2020-09-25T15:30:49.317,0,,0.0
2020,3,2825,365,15,1561,2,4,10,6,6,0,6,0,6,0,False,False,False,0,1,2020-09-25T15:32:24.33,6,,0.0
2020,3,2825,380,15,922,2,31,9,5,6,1,6,0,6,0,False,False,False,0,4,2020-09-25T15:35:10.917,6,,0.0
2020,3,2825,390,15,922,13,31,9,9,0,0,0,0,0,0,False,False,False,0,4,2020-10-01T15:49:46.597,0,,0.0
2020,3,2825,400,15,1561,13,12,3,4,0,0,0,0,0,0,False,False,False,0,1,2021-03-08T16:58:55.883,0,,0.0
2020,3,2825,420,15,4997,2,51,10,-2,7,9,0,7,0,0,False,False,False,1,3,2020-10-01T16:50:05.187,7,,7.0
2020,3,2825,425,15,7591,2,4,10,5,3,-2,3,0,3,0,False,False,False,0,3,2020-09-30T16:14:51.673,3,,0.0
2020,3,2825,435,15,2407,3,7,6,28,0,0,0,0,0,0,False,False,False,0,2,2021-02-15T22:25:27.793,0,,0.0
2020,3,2825,450,17,7024,2,46,9,3,3,0,3,0,3,0,False,False,False,0,1,2020-09-25T16:13:35.89,3,,0.0
2020,3,2825,455,17,4752,2,5,5,3,3,0,3,0,3,0,False,False,False,0,2,2020-09-25T16:25:26.15,3,,0.0
2020,3,2825,460,17,2253,2,4,6,17,16,-1,16,0,16,0,False,False,False,0,2,2021-02-15T22:29:20.357,16,,0.0
2020,3,2825,470,17,2253,2,2,10,5,8,3,7,1,7,0,False,False,False,0,2,2020-09-25T16:39:02.873,8,,1.0
2020,3,2825,495,15,8099,2,28,4,1,10,9,5,5,5,0,False,False,False,0,1,2020-10-01T16:26:30.807,10,,5.0
2020,3,2825,500,15,4997,13,12,3,14,0,0,0,0,0,0,False,False,False,0,3,2020-09-25T16:47:39.257,0,,0.0
2020,3,2825,505,15,8099,2,48,10,-6,7,13,4,3,4,0,False,False,False,0,1,2020-09-25T16:49:21.53,7,,3.0
2020,3,2825,510,15,2407,2,5,5,3,12,9,10,2,10,0,False,False,False,0,3,2020-09-25T16:50:58.483,12,,
2020,3,2825,525,17,6274,13,5,5,4,0,0,0,0,0,0,False,False,False,0,4,2020-09-25T17:01:37.443,0,,
2020,3,2825,555,15,2407,2,13,10,4,11,7,7,4,7,0,False,False,False,0,3,2020-10-01T16:26:54.617,11,,4.0
2020,3,2825,560,15,8099,2,4,10,5,16,11,13,3,13,0,False,False,False,0,1,2020-10-01T15:50:26.263,16,,3.0
2020,3,2825,565,15,8099,2,4,4,2,16,14,3,13,3,0,False,False,False,2,1,2020-10-01T16:50:05.203,16,,13.0
2020,3,2825,575,15,2407,13,19,2,28,0,0,0,0,0,0,False,False,False,0,2,2021-02-15T22:30:02.77,0,,0.0
2020,3,2825,590,15,7591,13,12,2,22,0,0,0,0,0,0,False,False,False,0,2,2020-10-01T16:37:26.61,0,,0.0
2020,3,2825,595,15,8099,2,12,9,5,10,5,9,1,9,0,False,False,False,0,1,2020-09-25T17:30:02.637,10,,1.0
2020,3,2825,610,17,7024,2,4,4,2,3,1,2,1,2,0,False,False,False,0,1,2020-09-25T17:49:34.6,3,,1.0
2020,3,2825,620,15,1561,2,50,9,-4,8,12,5,3,5,0,False,False,False,0,3,2021-03-04T14:58:01.027,8,,3.0
2020,3,2825,625,15,2757,13,12,10,4,0,0,0,0,0,0,False,False,False,0,3,2020-10-01T16:32:30.847,0,,0.0
2020,3,2825,630,15,2407,2,4,9,5,5,0,5,0,5,0,False,False,False,0,3,2020-09-25T17:56:37.017,5,,0.0
2020,3,2825,635,15,1561,2,4,9,4,6,2,3,3,3,0,False,False,False,1,1,2020-09-25T17:58:31.647,6,,3.0
2020,3,2825,640,15,2757,2,6,9,5,12,7,10,2,10,0,False,False,False,0,3,2020-10-01T16:50:05.203,12,,2.0
2020,3,2825,645,15,1561,2,46,3,1,9,8,2,7,2,0,False,False,False,2,1,2020-09-25T18:06:05.007,9,,7.0
2020,3,2825,650,15,922,2,13,9,5,5,0,5,0,5,0,False,False,False,0,3,2020-09-25T18:08:01.197,5,,0.0
2020,3,2825,655,15,7592,13,9,5,6,0,0,0,0,0,0,False,False,False,0,2,2020-09-25T18:09:13.167,0,,0.0
2020,3,2825,660,15,4940,2,13,9,4,4,0,4,0,4,0,False,False,False,0,3,2020-09-25T18:11:45.063,4,,0.0
2020,3,2825,665,15,4940,13,9,5,2,0,0,0,0,0,0,False,False,False,0,3,2020-09-25T18:13:58.657,0,,
2020,3,2825,700,17,1240,2,12,3,-4,0,4,-2,2,-2,0,False,False,False,0,6,2021-02-17T16:11:15.57,0,,2.0
2020,3,2825,710,15,2757,2,4,9,7,8,1,7,1,7,0,False,False,False,0,3,2020-09-25T18:24:47.96,8,,1.0
2020,3,2825,720,15,1561,2,46,3,0,6,6,6,0,6,0,False,False,False,0,1,2020-09-25T18:26:58.35,6,,0.0
2020,3,2825,775,15,7591,2,4,10,4,6,2,5,1,5,0,False,False,False,0,3,2020-09-30T16:15:08.673,6,,1.0
2020,3,2825,780,15,4997,2,4,10,10,16,6,12,4,12,0,False,False,False,0,3,2020-09-25T18:43:12.863,16,,4.0
2020,3,2825,785,15,4997,2,2,9,4,9,5,9,0,9,0,False,False,False,0,3,2020-09-25T18:43:52.223,9,,0.0
2020,3,2825,790,15,2407,2,5,6,17,18,1,17,1,17,0,False,False,False,0,2,2020-10-01T15:10:21.87,18,,1.0
2020,3,2825,795,15,2407,13,19,6,24,0,0,0,0,0,0,False,False,False,0,2,2021-03-04T22:01:00.55,0,,0.0
2020,3,2826,15,6,2071,2,4,10,7,8,1,7,1,7,0,False,False,False,0,3,2020-09-28T10:09:20.033,8,,1.0
2020,3,2826,20,6,666,2,30,9,-2,11,13,8,3,8,0,False,False,False,0,4,2021-02-15T18:00:42.65,11,,3.0
2020,3,2826,25,6,509,13,17,7,30,0,0,0,0,0,0,False,False,False,0,3,2021-02-25T14:17:03.763,0,,0.0
2020,3,2826,40,6,464,2,5,5,5,5,0,5,0,5,0,False,False,False,0,3,2020-09-28T10:24:01.113,5,,0.0
2020,3,2826,45,6,464,13,2,10,3,0,0,0,0,0,0,False,False,False,0,2,2020-09-30T20:25:03.663,0,,0.0
2020,3,2826,55,2,5223,2,19,8,45,63,18,60,3,60,0,False,False,False,0,3,2021-02-15T18:02:16.08,63,,3.0
2020,3,2826,65,2,5214,2,33,10,1,1,0,1,0,1,6,False,False,False,0,4,2021-02-15T18:04:46.913,1,,0.0
2020,3,2826,85,6,464,2,4,10,3,7,4,7,0,7,0,False,False,False,0,3,2020-09-28T10:47:43.05,7,,0.0
2020,3,2826,90,6,2071,2,38,10,2,5,3,1,4,1,0,False,False,False,0,3,2021-02-15T18:07:30.087,5,,4.0
2020,3,2826,100,6,464,2,2,4,6,19,13,12,7,12,0,False,False,False,1,3,2020-09-30T20:41:19.2,19,,7.0
2020,3,2826,110,6,6328,2,4,5,7,13,6,12,1,12,0,False,False,False,0,3,2020-09-29T20:29:26.427,13,,1.0
2020,3,2826,135,6,6328,13,39,4,6,0,0,0,0,0,0,False,False,False,0,4,2020-09-28T11:08:03.463,0,,0.0
2020,3,2826,150,2,5223,2,4,7,16,16,0,16,0,16,0,False,False,False,0,2,2020-09-30T20:46:34.793,16,,0.0
2020,3,2826,155,2,990,2,46,3,2,2,0,2,0,2,0,False,False,False,0,1,2020-09-28T11:12:45.247,2,,0.0
2020,3,2826,165,2,6247,13,2,4,5,0,0,0,0,0,0,False,False,False,0,3,2020-09-28T11:17:12.39,0,,0.0
2020,3,2826,175,6,509,13,19,2,42,0,0,0,0,0,0,False,False,False,0,2,2020-09-28T11:21:14.93,0,,0.0
2020,3,2826,185,6,4471,13,19,6,23,0,0,0,0,0,0,False,False,False,0,2,2020-09-30T21:01:54.653,0,,0.0
2020,3,2826,205,2,7303,2,2,9,4,9,5,7,2,7,0,False,False,False,0,2,2021-02-15T18:10:49.54,9,,2.0
2020,3,2826,210,2,6247,2,4,9,5,14,9,11,3,11,0,False,False,False,0,3,2020-09-28T11:30:52.917,14,,3.0
2020,3,2826,225,2,2223,2,12,10,3,6,3,6,0,6,0,False,False,False,0,4,2021-03-08T16:54:07.553,6,,0.0
2020,3,2826,235,2,6247,2,12,5,12,12,0,12,0,12,0,False,False,False,0,3,2021-03-08T16:54:58.89,12,,0.0
2020,3,2826,245,2,5223,3,3,5,4,0,0,0,0,0,0,False,False,False,0,2,2021-01-15T21:08:40.443,0,,0.0
2020,3,2826,270,6,7725,2,5,3,12,12,0,12,0,12,0,False,False,False,0,3,2021-02-15T18:11:46.723,12,,0.0
2020,3,2826,290,2,5223,13,12,6,19,0,0,0,0,0,0,False,False,False,0,2,2021-03-08T16:56:05.703,0,,0.0
2020,3,2826,305,2,5214,13,4,10,6,0,0,0,0,0,0,False,False,False,0,4,2020-09-29T19:35:09.433,0,,0.0
2020,3,2826,310,2,5223,13,6,10,13,0,0,0,0,0,0,False,False,False,0,2,2021-02-15T18:13:41.913,0,,0.0
2020,3,2826,315,2,5223,13,2,9,6,0,0,0,0,0,0,False,False,False,0,2,2020-09-28T12:10:09.85,0,,
2020,3,2826,340,6,464,2,2,10,10,17,7,15,2,15,0,False,False,False,0,2,2020-09-28T12:17:15.603,17,,2.0
2020,3,2826,345,6,4471,3,6,9,5,0,0,0,0,0,0,False,False,False,0,2,2020-09-28T12:22:22.557,0,,0.0
2020,3,2826,355,6,464,2,2,9,13,16,3,16,0,16,0,False,False,False,0,2,2021-01-29T14:44:05.437,16,,0.0
2020,3,2826,380,6,666,2,47,5,0,2,2,2,0,2,6,True,False,False,0,3,2020-10-01T12:16:09.733,2,,0.0
2020,3,2826,395,2,5223,2,2,10,5,5,0,5,0,5,0,False,False,False,0,2,2020-09-30T20:25:36.73,5,,0.0
2020,3,2826,405,2,5223,2,13,4,2,2,0,2,0,2,0,True,False,False,0,3,2020-09-28T12:37:20.193,2,,0.0
2020,3,2826,420,6,7725,13,19,6,27,0,0,0,0,0,0,False,False,False,0,2,2020-09-30T21:01:54.653,0,,0.0
2020,3,2826,425,6,4471,2,5,5,3,8,5,5,3,5,0,False,False,False,0,1,2020-10-01T12:17:14.047,8,,3.0
2020,3,2826,430,6,6328,13,35,8,42,0,0,0,0,0,0,False,False,False,0,3,2020-09-28T12:44:44.55,0,,0.0
2020,3,2826,450,2,7303,2,4,9,10,13,3,13,0,13,0,False,False,False,0,2,2020-10-01T12:18:28.207,13,,0.0
2020,3,2826,460,2,5223,13,9,6,31,0,0,0,0,0,0,False,False,False,0,2,2020-09-28T12:53:03.963,0,,0.0
2020,3,2826,500,2,6342,2,26,10,2,2,0,2,0,2,0,True,False,False,0,2,2020-09-30T20:25:48.383,2,,0.0
2020,3,2826,505,2,990,13,48,9,-7,0,0,0,0,0,0,False,False,False,0,1,2020-09-28T13:06:56.73,0,,0.0
2020,3,2826,515,2,5223,2,5,2,24,24,0,24,0,24,0,False,False,False,0,2,2020-09-28T13:10:51.77,24,,0.0
2020,3,2826,535,6,464,2,4,9,5,5,0,5,0,5,0,False,False,False,0,3,2020-09-28T13:16:00.12,5,,0.0
2020,3,2826,545,6,666,13,13,10,2,0,0,0,0,0,0,False,False,False,0,3,2021-03-04T22:06:14.31,0,,0.0
2020,3,2826,555,2,5223,13,7,6,28,0,0,0,0,0,0,True,False,False,0,3,2021-02-15T18:19:18.35,0,,0.0
2020,3,2826,560,2,6342,13,9,6,18,0,0,0,0,0,0,False,False,False,0,3,2020-09-28T13:26:41.14,0,,0.0
2020,3,2826,580,6,666,2,4,9,7,11,4,10,1,10,0,False,False,False,0,3,2020-09-28T14:08:41.677,11,,1.0
2020,3,2826,590,6,4471,2,48,9,-6,20,26,18,2,18,0,False,False,False,0,1,2020-09-28T14:09:03.913,20,,2.0
2020,3,2826,605,6,464,13,9,2,21,0,0,0,0,0,0,False,False,False,0,2,2020-09-28T16:58:37.043,0,,0.0
2020,3,2826,610,2,7303,2,6,9,13,13,0,13,0,13,0,False,False,False,0,3,2020-09-28T13:50:14.46,13,,0.0
2020,3,2826,615,2,4670,2,48,10,-3,22,25,21,1,21,0,True,False,False,0,1,2020-09-30T20:42:38.337,22,,1.0
2020,3,2826,620,2,2835,2,46,3,3,3,0,3,0,3,0,False,False,False,0,1,2020-09-28T13:49:46.19,3,,0.0
2020,3,2826,630,2,4670,3,5,3,5,0,0,0,0,0,0,False,False,False,0,1,2021-02-15T18:20:14.873,0,,0.0
2020,3,2826,645,6,6786,2,46,3,2,3,1,3,0,3,0,False,False,False,0,1,2020-09-29T20:29:52.057,3,,0.0
2020,3,2826,650,6,7725,13,35,3,14,0,0,0,0,0,0,False,False,False,0,3,2020-09-30T21:01:54.653,0,,0.0
2020,3,2826,685,2,5223,13,4,9,8,0,0,0,0,0,0,False,False,False,0,2,2020-09-28T14:12:07.807,0,,0.0
2020,3,2826,705,6,4471,13,47,5,0,0,0,0,0,0,0,False,False,False,0,1,2020-09-28T14:43:35.35,0,,0.0
2020,3,2826,710,6,464,2,5,5,6,7,1,7,0,7,0,False,False,False,0,3,2020-09-28T17:42:16.953,7,,0.0
2020,3,2826,715,6,7725,2,13,9,0,7,7,7,0,7,0,False,False,False,0,2,2021-02-15T18:22:06.453,7,,0.0
2020,3,2826,720,6,666,13,4,10,5,0,0,0,0,0,0,False,False,False,0,3,2020-09-28T14:42:51.91,0,,0.0
2020,3,2826,725,6,7725,13,19,2,28,0,0,0,0,0,0,False,False,False,0,2,2020-10-16T20:34:18.143,0,,
2020,3,2826,730,6,666,2,12,6,21,30,9,28,2,28,0,False,True,False,0,3,2020-09-28T16:45:27.343,29,,2.0
2020,3,2826,745,6,4471,2,48,9,-8,-8,0,-8,0,-8,0,False,False,False,0,1,2020-09-28T14:41:59.487,-8,,0.0
2020,3,2826,750,6,666,13,8,7,17,0,0,0,0,0,0,False,False,False,0,3,2020-09-28T14:41:32.63,0,,0.0
2020,3,2826,754,6,6328,3,8,7,17,0,0,0,0,0,0,False,False,False,0,3,2021-01-29T14:55:46.857,0,,0.0
2020,3,2826,770,2,7303,13,7,2,28,0,0,0,0,0,0,False,False,False,0,3,2020-10-01T12:32:24.63,0,,0.0
2020,3,2826,780,6,7725,13,29,2,21,0,0,0,0,0,0,False,False,False,0,2,2020-09-30T21:01:54.653,0,,0.0
2020,3,2826,785,6,464,2,51,3,-2,4,6,-1,5,-1,0,False,False,False,1,3,2020-09-30T20:43:10.92,4,,5.0
2020,3,2826,790,6,464,13,29,6,17,0,0,0,0,0,0,False,False,False,0,3,2020-09-28T15:10:24.58,0,,0.0
2020,3,2826,795,6,509,2,7,2,21,29,8,29,0,29,0,False,False,False,0,3,2020-09-28T15:12:25.877,29,,0.0
2020,3,2826,800,6,6331,13,29,2,20,0,0,0,0,0,0,False,False,False,0,2,2020-09-28T15:14:25.1,0,,0.0
2020,3,2826,810,6,6786,13,45,5,2,0,0,0,0,0,0,False,False,False,0,1,2020-09-30T19:09:12.177,0,,
2020,3,2826,815,6,6786,2,47,5,-1,6,7,-1,7,-1,0,False,False,False,1,1,2020-09-28T17:01:30.973,6,,7.0
2020,3,2826,820,6,666,13,4,10,3,0,0,0,0,0,0,True,False,False,0,4,2021-01-15T21:09:24.607,0,,0.0
2020,3,2826,825,6,666,2,29,5,3,3,0,3,0,3,6,False,False,False,0,2,2021-01-29T14:56:27.76,3,,0.0
2020,3,2826,845,2,5223,13,8,8,26,0,0,0,0,0,0,False,False,False,0,3,2020-09-28T17:25:17.737,0,,0.0
2020,3,2826,850,2,5214,13,38,4,1,0,0,0,0,0,0,False,False,False,0,4,2020-09-30T21:01:54.653,0,,0.0
2020,3,2826,870,6,666,2,5,10,4,4,0,4,0,4,0,False,False,False,0,3,2020-09-28T15:38:03.893,4,,0.0
2020,3,2826,875,6,464,2,4,3,8,37,29,8,29,8,6,False,False,False,2,2,2020-09-30T20:25:59.71,37,,29.0
2020,3,2826,890,2,4670,13,4,4,0,0,0,0,0,0,0,False,False,False,0,1,2020-09-28T15:45:00.483,0,,0.0
2020,3,2826,895,2,6472,3,50,5,-1,0,0,0,0,0,0,True,False,False,0,2,2020-09-28T15:46:46.95,0,,0.0
2020,3,2826,905,2,7303,13,21,7,46,0,0,0,0,0,0,False,False,False,0,2,2020-09-28T17:23:15.443,0,,0.0
2020,3,2826,915,6,464,2,2,9,6,6,0,6,0,6,0,False,False,False,0,3,2020-09-28T15:56:26.21,6,,0.0
2020,3,2826,925,6,6786,13,9,2,28,0,0,0,0,0,0,False,False,False,0,2,2020-09-28T15:59:46.943,0,,0.0
2020,3,2826,930,6,2071,2,50,5,-1,2,3,0,2,0,0,False,False,False,0,2,2021-02-15T18:21:13,2,,2.0
2020,3,2826,945,6,6328,2,8,8,28,28,0,28,0,28,6,False,False,False,0,3,2020-10-01T12:22:50.463,28,,0.0
2020,3,2826,960,2,6342,2,2,10,12,12,0,12,0,12,0,False,False,False,0,3,2020-09-28T16:12:43.203,12,,0.0
2020,3,2826,965,2,6342,2,32,3,3,13,10,13,0,13,0,False,False,False,0,3,2020-09-28T16:15:10.297,13,,0.0
2020,3,2826,970,2,7303,2,6,10,6,6,0,6,0,6,0,False,False,False,0,2,2020-09-28T16:16:28.547,6,,0.0
2020,3,2826,975,2,5223,13,7,2,20,0,0,0,0,0,0,False,False,False,0,3,2021-03-04T22:08:55.453,0,,0.0
2020,3,2827,15,4,1412,13,12,9,13,0,0,0,0,0,0,False,False,False,0,2,2021-03-08T17:01:20.237,0,,0.0
2020,3,2827,20,4,1412,13,19,8,45,0,0,0,0,0,0,False,False,False,0,2,2020-09-28T10:21:03.147,0,,0.0
2020,3,2827,40,29,1958,2,32,10,3,12,9,10,2,10,0,False,False,False,0,4,2020-10-01T17:18:00.613,12,,2.0
2020,3,2827,50,29,4866,2,5,3,11,20,9,16,4,16,0,False,False,False,1,3,2020-10-01T16:09:33.893,20,,4.0
2020,3,2827,55,29,4875,2,2,9,13,13,0,13,0,13,0,False,False,False,0,3,2020-10-01T14:58:04.803,13,,0.0
2020,3,2827,85,4,6983,2,4,10,4,4,0,4,0,4,0,False,False,False,0,1,2020-09-28T10:50:25.01,4,,0.0
2020,3,2827,105,4,7646,2,12,4,11,12,1,12,0,12,0,False,False,False,0,3,2021-03-08T17:03:18.66,12,,0.0
2020,3,2827,110,4,6983,2,47,10,-1,5,6,2,3,2,0,False,False,False,0,1,2020-09-28T11:01:57.287,5,,3.0
2020,3,2827,125,4,2853,13,50,9,-2,0,0,0,0,0,0,True,False,False,0,2,2020-09-28T11:08:21.543,0,,0.0
2020,3,2827,130,4,2853,2,35,9,1,1,0,1,0,1,6,False,False,False,0,3,2020-09-28T12:38:21.22,1,,
2020,3,2827,140,4,1377,2,13,10,1,1,0,1,0,1,6,False,False,False,0,4,2020-09-28T11:16:10.923,1,,0.0
2020,3,2827,160,29,4866,2,26,9,3,3,0,3,0,3,0,False,False,False,0,3,2020-09-28T11:21:05.293,3,,0.0
2020,3,2827,165,29,4850,2,5,8,15,16,1,16,0,16,0,False,False,False,0,2,2020-10-01T14:58:04.803,16,,0.0
2020,3,2827,180,29,7378,13,32,9,-4,0,0,0,0,0,0,False,False,False,0,1,2020-09-28T11:26:31.393,0,,0.0
2020,3,2827,190,29,7828,13,4,9,10,0,0,0,0,0,0,False,False,False,0,2,2020-10-01T17:19:25.783,0,,0.0
2020,3,2827,195,4,7646,2,7,6,39,39,0,39,0,39,0,False,False,False,0,3,2021-02-15T17:36:28.687,39,,0.0
2020,3,2827,200,4,7646,2,50,5,-2,9,11,4,5,4,0,False,False,False,0,2,2020-09-28T11:43:54.197,9,,5.0
2020,3,2827,210,4,2629,2,30,10,-2,5,7,5,0,5,0,True,False,False,0,4,2020-09-28T11:47:07.76,5,,0.0
2020,3,2827,240,29,4875,2,5,3,6,7,1,7,0,7,0,False,False,False,0,3,2020-10-01T16:20:54.847,7,,0.0
2020,3,2827,275,29,4866,2,26,9,0,5,5,3,2,3,0,False,False,False,0,4,2020-10-01T16:27:06.04,5,,2.0
2020,3,2827,280,29,4866,2,38,9,2,8,6,5,3,5,0,False,False,False,0,4,2020-09-28T12:08:57.25,8,,3.0
2020,3,2827,335,4,7646,2,6,4,14,21,7,21,0,21,0,False,False,False,0,3,2020-09-28T12:24:25.013,21,,0.0
2020,3,2827,340,4,594,2,11,2,21,29,8,29,0,29,0,False,False,False,0,3,2020-09-29T16:24:55.987,29,,0.0
2020,3,2827,355,4,2629,2,47,5,0,3,3,3,0,3,6,True,False,False,0,1,2020-09-28T12:29:21.603,3,,0.0
2020,3,2827,370,29,4866,2,4,4,10,10,0,10,0,10,0,False,False,False,0,3,2020-09-28T12:32:59.11,10,,0.0
2020,3,2827,375,29,3356,13,28,9,-4,0,0,0,0,0,0,False,False,False,0,1,2020-10-01T14:58:04.803,0,,0.0
2020,3,2827,420,29,7378,2,46,3,2,6,4,6,0,6,0,False,False,False,0,1,2020-09-28T12:46:08.693,6,,0.0
2020,3,2827,430,29,1958,13,54,9,-8,0,0,0,0,0,0,True,False,False,0,3,2020-10-01T17:20:38.037,0,,0.0
2020,3,2827,435,29,4866,13,39,4,7,0,0,0,0,0,0,False,False,False,0,3,2021-01-12T23:23:21.313,0,,0.0
2020,3,2827,440,29,4875,13,12,5,14,0,0,0,0,0,0,True,False,False,0,3,2021-03-08T17:04:19.307,0,,0.0
2020,3,2827,445,4,6983,2,48,9,-6,34,40,28,6,28,0,False,False,False,1,1,2021-02-15T17:43:05.62,34,,6.0
2020,3,2827,455,4,7646,2,51,10,-6,3,9,3,0,3,0,False,False,False,0,3,2021-02-15T17:45:26.72,3,,
2020,3,2827,460,4,594,2,13,9,6,12,6,12,0,12,0,True,False,False,0,3,2021-01-29T15:23:35.9,12,,0.0
2020,3,2827,465,4,2629,2,6,4,9,13,4,13,0,13,0,False,False,False,0,3,2020-09-29T16:13:14.807,13,,0.0
2020,3,2827,475,4,594,2,5,3,0,0,0,0,0,0,0,False,False,False,0,3,2020-09-29T16:24:55.987,0,,0.0
2020,3,2827,480,4,2853,2,6,9,4,4,0,4,0,4,6,False,False,False,0,2,2020-09-28T13:11:16.647,4,,0.0
2020,3,2827,500,29,3398,2,53,10,-3,9,12,8,1,8,0,False,False,False,0,4,2020-09-28T13:26:57.253,9,,1.0
2020,3,2827,515,29,4866,2,42,4,5,20,15,5,15,5,0,False,False,False,1,3,2020-10-01T16:30:35.47,20,,15.0
2020,3,2827,520,29,4850,2,33,10,4,18,14,17,1,17,0,False,False,False,0,4,2020-09-28T13:49:18.843,18,,1.0
2020,3,2827,550,4,2629,13,9,6,38,0,0,0,0,0,0,False,False,False,0,3,2020-09-28T16:20:44.403,0,,0.0
2020,3,2827,560,29,3398,2,7,2,22,31,9,26,5,26,0,False,False,False,0,4,2020-09-28T14:04:43.917,31,,5.0
2020,3,2827,565,29,1958,2,26,10,-1,25,26,25,0,25,6,False,False,False,2,4,2020-09-28T14:07:33.47,25,,0.0
2020,3,2827,580,4,2853,3,12,10,4,0,0,0,0,0,0,False,False,False,0,3,2021-03-08T17:05:24.057,0,,0.0
2020,3,2827,585,4,6983,2,46,3,3,7,4,3,4,3,0,False,False,False,1,1,2020-10-01T16:12:51.563,7,,4.0
2020,3,2827,600,29,4875,2,8,9,13,17,4,16,1,16,0,False,False,False,0,2,2020-09-28T14:21:41.707,17,,1.0
2020,3,2827,615,29,1958,2,51,3,-6,-6,0,-6,0,-6,0,True,False,False,0,3,2020-09-28T14:34:49.857,-6,,0.0
2020,3,2827,620,29,4866,2,4,8,17,17,0,17,0,17,0,False,False,False,0,3,2020-10-01T16:32:25.467,17,,0.0
2020,3,2827,625,29,3356,13,28,10,0,0,0,0,0,0,0,False,False,False,0,1,2020-09-28T14:38:46.077,0,,0.0
2020,3,2827,645,29,4866,2,4,3,4,8,4,7,1,7,0,False,False,False,0,3,2020-09-28T14:45:57.107,8,,1.0
2020,3,2827,650,29,1958,2,8,1,15,31,16,27,4,27,0,False,False,False,0,3,2021-02-15T17:51:06.877,31,,4.0
2020,3,2827,655,29,4866,2,35,9,10,16,6,16,0,16,6,False,False,False,0,4,2020-10-01T16:34:21.813,16,,0.0
2020,3,2827,680,4,2853,2,9,3,14,23,9,17,6,17,0,False,False,False,0,3,2020-09-29T16:13:33.913,23,,6.0
2020,3,2827,690,4,2853,2,12,9,4,5,1,5,0,5,0,False,False,False,0,3,2020-09-28T15:04:00.41,5,,0.0
2020,3,2827,710,29,4875,2,35,6,16,23,7,23,0,23,0,False,False,False,0,3,2020-10-01T16:54:55.257,23,,0.0
2020,3,2827,750,4,594,2,13,9,6,18,12,15,3,15,0,False,False,False,1,3,2021-02-25T14:23:18.843,18,,3.0
2020,3,2827,760,4,594,13,12,3,14,0,0,0,0,0,0,True,False,False,0,1,2021-02-15T17:52:32.81,0,,0.0
2020,3,2827,765,4,594,2,4,1,18,22,4,20,2,20,0,False,False,False,0,3,2020-09-29T16:24:55.987,22,,2.0
2020,3,2827,770,4,5119,2,50,9,-4,6,10,0,6,0,0,True,False,False,1,2,2021-03-03T15:14:01.48,6,,6.0
2020,3,2827,785,4,594,2,2,9,10,19,9,17,2,17,0,False,False,False,0,3,2020-09-28T15:41:26.583,19,,2.0
2020,3,2827,790,4,5119,13,12,5,0,0,0,0,0,0,0,True,False,False,0,3,2020-09-28T15:43:53.287,0,,0.0
2020,3,2827,805,4,6983,13,12,2,24,0,0,0,0,0,0,False,False,False,0,2,2020-09-28T16:18:48.98,0,,0.0
2020,3,2827,810,4,2853,2,4,1,17,17,0,17,0,17,0,False,False,False,0,3,2020-09-28T15:50:06.147,17,,0.0
2020,3,2827,820,4,7646,13,8,9,12,0,0,0,0,0,0,False,False,False,0,2,2020-09-28T16:14:01.83,0,,
2020,3,2827,825,4,2629,2,13,3,3,3,0,3,0,3,6,True,False,False,0,4,2021-02-15T17:53:05.787,3,,0.0
2020,3,2827,840,29,1958,2,50,10,-2,13,15,12,1,12,0,False,True,False,0,3,2021-01-29T15:24:33.417,12,,1.0
2020,3,2828,10,8,3883,2,53,9,-5,10,15,8,2,8,0,True,False,False,0,4,2021-02-15T21:21:11.557,10,,2.0
2020,3,2828,20,8,232,2,5,5,7,12,5,9,3,9,0,False,False,False,0,3,2020-09-28T11:23:40.86,12,,3.0
2020,3,2828,25,8,3883,2,26,9,0,7,7,4,3,4,0,False,False,False,0,4,2020-09-28T10:26:21.597,7,,3.0
2020,3,2828,40,8,5053,3,4,9,2,0,0,0,0,0,0,False,False,False,0,1,2020-09-28T10:34:49.493,0,,0.0
2020,3,2828,55,32,1427,2,6,9,6,8,2,6,2,6,0,False,False,False,0,4,2020-09-28T11:24:03.007,8,,2.0
2020,3,2828,60,32,8237,2,51,5,-3,7,10,6,1,6,0,False,False,False,0,3,2021-02-15T21:21:49.677,7,,1.0
2020,3,2828,65,32,3885,2,5,5,4,12,8,10,2,10,0,False,False,False,0,3,2020-09-28T18:01:02.033,12,,2.0
2020,3,2828,70,32,7128,13,21,6,24,0,0,0,0,0,0,False,False,False,0,2,2020-10-01T15:47:29.273,0,,0.0
2020,3,2828,80,32,7128,13,2,9,10,0,0,0,0,0,0,False,False,False,0,2,2020-09-28T10:55:36.21,0,,0.0
2020,3,2828,100,8,232,2,4,4,3,6,3,5,1,5,0,False,False,False,1,3,2020-09-28T11:03:32.013,6,,1.0
2020,3,2828,105,8,1067,2,12,2,16,18,2,16,2,16,0,False,False,False,0,2,2020-09-28T11:06:54.81,18,,2.0
2020,3,2828,110,8,1067,13,3,5,13,0,0,0,0,0,0,False,False,False,0,2,2020-09-28T11:08:56.987,0,,0.0
2020,3,2828,140,32,8237,13,7,2,22,0,0,0,0,0,0,False,False,False,0,3,2021-02-15T21:25:20.29,0,,0.0
2020,3,2828,145,32,7128,2,5,3,5,21,16,5,16,5,0,False,False,False,2,3,2020-09-29T16:27:51.33,21,,16.0
2020,3,2828,155,32,8237,2,5,5,5,6,1,6,0,6,0,False,False,False,0,2,2020-09-28T11:34:02.66,6,,0.0
2020,3,2828,165,32,1791,2,8,8,17,17,0,17,0,17,6,False,False,False,0,3,2020-09-28T11:40:20.707,17,,0.0
2020,3,2828,185,8,6439,2,5,10,1,2,1,1,1,1,0,False,False,False,0,1,2020-10-21T15:08:55.803,2,,1.0
2020,3,2828,190,8,232,2,4,9,7,10,3,8,2,8,0,False,False,False,0,2,2020-09-28T11:50:36.627,10,,2.0
2020,3,2828,210,8,1067,13,23,7,34,0,0,0,0,0,0,False,False,False,0,3,2020-10-21T15:08:15.987,0,,0.0
2020,3,2828,220,8,3883,13,5,3,9,0,0,0,0,0,0,False,False,False,0,3,2020-09-29T17:56:58.847,0,,0.0
2020,3,2828,225,8,3883,2,32,5,2,8,6,6,2,6,0,False,False,False,0,4,2020-10-01T17:14:50.623,8,,2.0
2020,3,2828,240,8,7652,3,6,9,5,0,0,0,0,0,0,False,False,False,0,2,2020-09-28T12:16:53.167,0,,0.0
2020,3,2828,260,32,7128,2,4,9,13,14,1,14,0,14,0,False,False,False,0,2,2020-09-30T16:02:54.783,14,,0.0
2020,3,2828,270,32,7808,13,5,5,5,0,0,0,0,0,0,False,False,False,0,3,2020-09-28T12:31:47.62,0,,0.0
2020,3,2828,275,32,7128,2,13,10,3,33,30,28,5,28,0,False,False,False,0,3,2020-09-28T12:34:48.487,33,,5.0
2020,3,2828,285,32,7807,2,51,4,-6,-5,1,-5,0,-5,0,False,False,False,0,1,2020-09-28T12:48:58.067,-5,,0.0
2020,3,2828,290,32,1427,13,35,7,25,0,0,0,0,0,0,False,False,False,0,3,2021-03-04T22:11:38.527,0,,0.0
2020,3,2828,300,8,1067,2,2,10,5,11,6,10,1,10,0,False,False,False,0,3,2021-02-15T21:32:26.953,11,,1.0
2020,3,2828,320,32,3885,13,48,3,-2,0,0,0,0,0,0,False,False,False,0,1,2021-02-15T21:33:05.663,0,,0.0
2020,3,2828,325,32,8237,2,51,3,-1,5,6,4,1,4,0,True,False,False,0,3,2020-09-28T13:12:43.463,5,,1.0
2020,3,2828,345,8,232,2,2,10,7,8,1,7,1,7,0,False,False,False,0,3,2020-09-28T13:20:21.34,8,,1.0
2020,3,2828,365,32,1791,13,4,10,10,0,0,0,0,0,0,False,False,False,0,2,2021-03-04T16:06:15.723,0,,0.0
2020,3,2828,380,32,1791,13,4,10,7,0,0,0,0,0,0,False,False,False,0,3,2021-03-04T22:12:36.97,0,,0.0
2020,3,2828,395,8,5053,2,6,5,5,9,4,7,2,7,6,True,False,False,1,2,2020-09-28T13:43:27.1,9,,2.0
2020,3,2828,415,32,7807,2,16,10,2,12,10,10,2,10,0,False,True,True,0,1,2021-01-15T22:23:23.127,12,,2.0
2020,3,2828,465,32,8237,13,11,5,11,0,0,0,0,0,0,True,False,False,0,3,2020-09-29T15:27:18.667,0,,0.0
2020,3,2828,470,32,7128,2,50,9,-2,15,17,11,4,11,0,False,False,False,0,2,2021-02-15T21:33:38.887,15,,4.0
2020,3,2828,475,32,7808,3,5,5,14,0,0,0,0,0,0,False,False,False,0,3,2021-03-09T19:14:20.36,0,,0.0
2020,3,2828,480,32,7807,2,45,10,-4,4,8,3,1,3,0,False,False,False,0,1,2021-02-15T21:39:53.467,4,,1.0
2020,3,2828,485,32,3885,2,13,9,4,26,22,25,1,25,0,True,False,False,0,2,2020-09-28T14:51:29.983,26,,1.0
2020,3,2828,520,8,6633,13,12,2,33,0,0,0,0,0,0,False,False,False,0,2,2020-09-28T15:06:20.503,0,,0.0
2020,3,2828,535,32,8237,2,51,3,-1,6,7,5,1,5,0,False,False,False,1,3,2020-09-28T15:12:00.713,6,,1.0
2020,3,2828,560,32,7128,13,8,4,13,0,0,0,0,0,0,False,False,False,0,2,2020-09-28T15:23:41.533,0,,0.0
2020,3,2828,565,32,1427,2,5,10,4,5,1,4,1,4,0,False,False,False,0,3,2020-09-28T15:25:33.44,5,,1.0
2020,3,2828,570,32,1427,2,26,10,2,4,2,2,2,2,0,False,False,False,0,3,2021-02-15T21:41:05.06,4,,2.0
2020,3,2828,580,32,7128,13,7,3,11,0,0,0,0,0,0,False,False,False,0,3,2020-09-28T15:43:28.82,0,,0.0
2020,3,2828,585,32,1791,2,8,4,11,11,0,11,0,11,6,False,False,False,0,2,2021-01-15T21:14:05.433,11,,0.0
2020,3,2828,610,8,1067,2,4,4,14,15,1,15,0,15,0,False,False,False,0,3,2020-09-28T15:58:16.567,15,,0.0
2020,3,2828,615,8,4000,2,46,3,1,13,12,4,9,4,0,False,False,False,1,1,2021-03-03T15:20:48.23,13,,9.0
2020,3,2828,655,8,7652,2,12,10,3,3,0,3,0,3,6,False,False,False,0,2,2021-03-08T17:28:21.123,3,,0.0
2020,3,2828,670,32,7128,2,3,3,10,9,-1,9,0,9,0,False,False,False,0,2,2020-09-28T16:22:04.75,9,,
2020,3,2828,680,32,1427,13,38,9,4,0,0,0,0,0,0,False,False,False,0,3,2020-09-28T16:27:12.117,0,,0.0
2020,3,2828,685,32,1791,13,6,1,15,0,0,0,0,0,0,False,False,False,0,3,2020-09-28T16:31:08.58,0,,0.0
2020,3,2828,695,8,1067,2,5,2,15,15,0,15,0,15,0,False,False,False,0,2,2020-09-28T16:35:41.863,15,,0.0
2020,3,2828,715,32,1427,13,5,9,5,0,0,0,0,0,0,False,False,False,0,3,2020-09-28T16:41:58.027,0,,0.0
2020,3,2828,720,32,3885,2,45,5,-4,-1,3,-3,2,-3,0,False,False,False,1,1,2021-02-15T21:54:00.247,-1,,2.0
2020,3,2828,725,32,1427,2,5,3,12,14,2,14,0,14,0,False,False,False,0,3,2020-09-28T16:47:52.503,14,,0.0
2020,3,2828,730,32,1791,2,4,5,7,10,3,12,-2,12,0,False,True,False,0,2,2021-01-15T22:30:54.237,10,,-2.0
2020,3,2828,755,8,5053,2,12,3,8,9,1,9,0,9,0,False,False,False,0,1,2021-02-25T14:52:57.173,9,,0.0
2020,3,2829,15,31,4037,2,21,6,40,44,4,44,0,44,0,False,False,False,0,2,2020-10-01T14:01:11.543,44,,0.0
2020,3,2829,25,31,5096,2,47,10,-1,-1,0,-1,0,-1,0,True,False,False,0,4,2020-09-28T10:23:12.573,-1,,0.0
2020,3,2829,30,31,5096,2,17,4,13,16,3,15,1,15,0,False,False,False,0,4,2020-09-28T10:26:01.437,16,,1.0
2020,3,2829,35,31,225,2,12,10,0,0,0,0,0,0,0,False,False,False,0,6,2020-09-28T10:28:53.273,0,,0.0
2020,3,2829,55,18,4572,13,48,4,-5,0,0,0,0,0,0,False,False,False,0,1,2020-09-28T10:33:46.053,0,,0.0
2020,3,2829,85,31,5096,13,11,5,14,0,0,0,0,0,0,True,False,False,0,3,2020-09-28T16:13:05.137,0,,0.0
2020,3,2829,115,31,5096,13,17,10,13,0,0,0,0,0,0,False,False,False,0,4,2020-10-01T15:56:57.357,0,,0.0
2020,3,2829,125,31,2675,13,9,3,13,0,0,0,0,0,0,True,False,False,0,3,2020-09-29T22:55:04.553,0,,0.0
2020,3,2829,140,18,813,13,32,5,5,0,0,0,0,0,0,False,False,False,0,4,2021-02-17T18:47:24.813,0,,0.0
2020,3,2829,155,18,7711,2,5,3,5,11,6,7,4,7,0,False,False,False,0,3,2021-02-17T18:48:56.96,11,,4.0
2020,3,2829,165,18,7711,2,3,3,7,9,2,7,2,7,0,False,False,False,0,2,2020-09-28T11:08:08.617,9,,2.0
2020,3,2829,185,31,4037,2,2,10,11,13,2,13,0,13,0,True,False,False,0,3,2020-09-29T22:55:23.67,13,,0.0
2020,3,2829,195,31,2901,2,5,9,4,10,6,6,4,6,0,False,False,False,0,3,2020-09-28T11:16:10.523,10,,4.0
2020,3,2829,210,31,5080,2,5,3,9,9,0,9,0,9,0,False,False,False,0,3,2020-09-28T11:24:16.373,9,,0.0
2020,3,2829,220,31,7913,13,19,7,28,0,0,0,0,0,0,False,False,False,0,3,2020-10-16T20:45:36.85,0,,0.0
2020,3,2829,225,18,7711,2,6,10,9,12,3,10,2,10,0,False,False,False,0,3,2021-02-17T18:49:34.557,12,,2.0
2020,3,2829,235,18,7711,2,5,3,7,8,1,7,1,7,0,False,False,False,0,3,2020-09-28T11:33:35.84,8,,1.0
2020,3,2829,245,18,1381,2,18,3,1,6,5,4,2,4,0,False,False,False,1,2,2020-10-01T14:28:45.093,6,,2.0
2020,3,2829,255,18,4572,2,4,4,3,3,0,3,0,3,0,False,False,False,0,1,2020-09-28T15:51:02.683,3,,0.0
2020,3,2829,265,18,7711,2,9,6,27,31,4,27,4,27,0,False,False,False,0,2,2020-09-28T11:43:25.833,31,,4.0
2020,3,2829,270,18,1381,2,12,2,16,16,0,16,0,16,6,False,False,False,0,3,2020-09-29T14:50:55.73,16,,0.0
2020,3,2829,300,31,5096,13,4,10,7,0,0,0,0,0,0,False,False,False,0,3,2020-10-01T14:52:57.457,0,,0.0
2020,3,2829,305,31,2675,2,3,3,13,12,-1,12,0,12,0,False,False,False,0,3,2021-03-08T17:54:38.17,12,,0.0
2020,3,2829,320,31,2675,2,7,2,15,23,8,23,0,23,0,True,False,False,0,3,2020-09-28T12:04:44.877,23,,0.0
2020,3,2829,335,31,4545,2,16,9,4,5,1,4,1,4,0,False,False,False,0,1,2020-09-28T12:08:57.897,5,,1.0
2020,3,2829,355,18,7711,2,4,10,9,33,24,29,4,29,0,False,False,False,0,3,2020-09-28T12:13:08.927,33,,4.0
2020,3,2829,360,18,4572,2,46,9,1,15,14,14,1,14,0,False,False,False,0,1,2020-09-28T12:15:20.183,15,,1.0
2020,3,2829,370,18,7711,13,35,6,25,0,0,0,0,0,0,False,False,False,0,3,2020-09-28T12:17:08.023,0,,0.0
2020,3,2829,385,18,1381,13,9,6,23,0,0,0,0,0,0,False,False,False,0,2,2020-10-01T15:20:52.227,0,,0.0
2020,3,2829,400,31,5080,2,4,5,5,6,1,5,1,5,0,False,False,False,0,2,2020-09-28T12:22:53.09,6,,1.0
2020,3,2829,405,31,3504,2,4,10,4,5,1,4,1,4,0,False,False,False,0,1,2020-10-01T15:21:00.4,5,,1.0
2020,3,2829,415,31,2675,2,5,3,5,5,0,5,0,5,0,False,False,False,0,3,2020-09-28T12:38:37.747,5,,0.0
2020,3,2829,420,31,2675,13,4,4,7,0,0,0,0,0,0,False,False,False,0,3,2020-09-28T12:40:22.403,0,,0.0
2020,3,2829,455,18,7711,13,4,5,6,0,0,0,0,0,0,False,False,False,0,2,2021-03-04T22:15:45.127,0,,0.0
2020,3,2829,510,18,6706,13,12,6,25,0,0,0,0,0,0,False,False,False,0,2,2021-02-17T18:57:45.203,0,,0.0
2020,3,2829,530,31,5096,2,17,1,20,21,1,20,1,20,0,True,False,False,0,3,2020-09-29T22:55:39.5,21,,1.0
2020,3,2829,545,31,3504,13,6,9,6,0,0,0,0,0,0,False,False,False,0,2,2020-09-28T13:17:50.867,0,,0.0
2020,3,2829,565,18,7711,2,35,2,32,71,39,48,23,48,6,False,False,False,2,3,2020-10-01T14:43:11.04,71,,23.0
2020,3,2829,585,31,2901,2,32,3,4,6,2,4,2,4,0,False,False,False,0,4,2020-10-01T14:57:14.423,6,,2.0
2020,3,2829,600,31,5080,2,6,4,13,38,25,29,9,29,0,False,False,False,1,2,2020-10-01T14:38:16.58,38,,9.0
2020,3,2829,640,18,6706,2,47,5,5,7,2,6,1,6,0,False,False,False,0,3,2020-10-01T14:39:14.51,7,,1.0
2020,3,2829,650,31,4037,2,23,1,45,61,16,56,5,56,0,False,False,False,0,3,2020-10-01T14:58:11.393,61,,5.0
2020,3,2829,695,18,4152,2,5,5,3,11,8,8,3,8,0,False,False,False,0,1,2020-09-28T14:29:29.42,11,,3.0
2020,3,2829,730,18,813,2,36,9,3,3,0,3,0,3,6,False,False,False,0,4,2021-02-25T14:55:03.213,3,,0.0
2020,3,2829,750,31,3504,2,4,10,6,6,0,6,0,6,0,False,False,False,0,1,2020-09-28T14:44:45.96,6,,0.0
2020,3,2829,770,31,5080,2,26,5,3,8,5,8,0,8,0,False,False,False,0,3,2020-10-01T15:41:30.613,8,,0.0
2020,3,2829,780,31,7913,13,5,5,8,0,0,0,0,0,0,False,False,False,0,3,2020-09-28T14:54:56.85,0,,0.0
2020,3,2829,800,18,1381,2,5,5,4,7,3,6,1,6,0,False,False,False,0,3,2020-09-28T16:09:21.777,7,,1.0
2020,3,2829,825,18,813,2,32,5,-3,8,11,6,2,6,0,False,False,False,0,4,2020-09-28T15:11:38.403,8,,2.0
2020,3,2829,845,31,5096,2,17,4,10,11,1,10,1,10,0,False,False,False,0,4,2020-09-28T15:16:22.813,11,,1.0
2020,3,2829,850,31,5096,2,2,4,8,14,6,10,4,10,0,False,False,False,0,3,2020-09-28T15:18:22.053,14,,4.0
2020,3,2829,855,31,5080,2,5,5,7,8,1,8,0,8,0,False,False,False,0,2,2020-09-28T15:20:58.747,8,,0.0
2020,3,2829,870,31,5080,13,5,3,6,0,0,0,0,0,0,False,False,False,0,3,2020-10-01T14:19:19.937,0,,0.0
2020,3,2829,875,31,2675,2,50,10,-3,1,4,0,1,0,0,False,False,False,0,3,2020-09-28T15:26:43.597,1,,1.0
2020,3,2829,885,31,2675,13,5,3,14,0,0,0,0,0,0,False,False,False,0,3,2020-09-28T15:29:04.58,0,,0.0
2020,3,2829,900,18,4572,13,16,4,1,0,0,0,0,0,0,False,False,False,0,1,2020-10-01T14:10:01.88,0,,
2020,3,2829,905,18,4572,13,26,10,0,0,0,0,0,0,0,False,False,False,0,1,2020-09-28T15:34:32.22,0,,0.0
2020,3,2829,915,18,4572,13,6,9,-4,0,0,0,0,0,0,False,False,False,0,1,2020-10-01T15:55:55.757,0,,0.0
2020,3,2829,920,18,1381,13,19,2,45,0,0,0,0,0,0,False,False,False,0,3,2021-03-04T22:16:59.447,0,,0.0
2020,3,2830,20,19,54,13,2,4,6,0,0,0,0,0,0,False,False,False,0,2,2020-09-28T10:21:29.483,0,,0.0
2020,3,2830,35,23,7689,13,4,5,5,0,0,0,0,0,0,False,False,False,0,2,2020-09-28T10:28:59.86,0,,0.0
2020,3,2830,50,23,7250,13,12,6,37,0,0,0,0,0,0,False,False,False,0,3,2020-10-02T17:28:18.133,0,,0.0
2020,3,2830,70,19,1510,2,5,3,3,3,0,3,0,3,0,False,False,False,0,1,2020-10-02T14:58:52.653,3,,0.0
2020,3,2830,85,19,1510,2,48,9,-5,3,8,1,2,1,0,False,False,False,0,1,2020-09-28T10:51:55.053,3,,2.0
2020,3,2830,105,23,2256,2,6,4,13,18,5,17,1,17,0,True,False,False,0,3,2020-10-02T17:54:39.627,18,,1.0
2020,3,2830,110,23,7250,2,13,9,4,22,18,20,2,20,0,True,False,False,0,3,2021-02-17T19:09:44.15,22,,2.0
2020,3,2830,130,23,2256,2,5,3,14,14,0,14,0,14,0,False,False,False,0,2,2021-02-17T19:11:30.33,14,,0.0
2020,3,2830,145,19,6266,2,5,10,4,14,10,9,5,9,0,False,False,False,0,1,2021-02-17T19:18:06.847,14,,5.0
2020,3,2830,155,19,54,13,17,1,24,0,0,0,0,0,0,False,False,False,0,3,2020-09-28T11:26:44.05,0,,0.0
2020,3,2830,160,19,1510,13,12,5,9,0,0,0,0,0,0,False,False,False,0,1,2020-09-28T11:31:10.12,0,,0.0
2020,3,2830,170,23,3843,2,16,9,4,6,2,6,0,6,0,False,False,False,0,1,2020-10-21T02:28:57.777,6,,0.0
2020,3,2830,175,23,116,2,12,3,3,3,0,3,0,3,0,False,False,False,0,1,2021-03-08T17:58:33.533,3,,
2020,3,2830,180,23,7250,13,13,9,4,0,0,0,0,0,0,False,False,False,0,3,2021-03-08T17:59:52.837,0,,0.0
2020,3,2830,210,19,54,2,35,7,15,15,0,15,0,15,0,False,False,False,0,3,2020-10-02T15:00:06.663,15,,0.0
2020,3,2830,225,19,7173,13,2,4,8,0,0,0,0,0,0,False,False,False,0,3,2020-09-28T12:07:28.41,0,,0.0
2020,3,2830,230,19,1510,13,48,9,-4,0,0,0,0,0,0,False,False,False,0,1,2020-09-28T12:12:32.34,0,,0.0
2020,3,2830,235,19,7173,13,8,7,15,0,0,0,0,0,0,False,False,False,0,2,2020-09-28T12:16:46.82,0,,0.0
2020,3,2830,260,19,1510,2,44,9,-3,0,3,0,0,0,0,True,False,False,0,1,2021-02-24T18:26:59.107,0,,0.0
2020,3,2830,290,19,6273,3,12,5,5,0,0,0,0,0,0,False,False,False,0,4,2021-03-08T18:01:26.813,0,,0.0
2020,3,2830,295,19,54,13,13,5,4,0,0,0,0,0,0,False,False,False,0,3,2020-10-02T17:28:46.963,0,,0.0
2020,3,2830,315,23,7241,13,16,10,2,0,0,0,0,0,0,False,False,False,0,1,2020-09-28T13:05:12.473,0,,0.0
2020,3,2830,345,19,6266,2,48,10,-4,9,13,1,8,1,0,False,False,False,1,1,2020-09-28T13:22:34.587,9,,8.0
2020,3,2830,360,19,3233,2,21,3,13,23,10,20,3,20,0,False,False,False,1,2,2020-09-28T13:29:56.72,23,,3.0
2020,3,2830,375,19,3233,2,50,9,-3,5,8,5,0,5,0,False,False,False,0,3,2020-09-28T13:36:01.853,5,,0.0
2020,3,2830,390,19,7173,2,46,3,2,7,5,7,0,7,0,False,False,False,0,3,2020-10-02T17:46:55.073,7,,0.0
2020,3,2830,395,19,1510,13,7,5,11,0,0,0,0,0,0,False,False,False,0,1,2020-09-28T17:53:05.663,0,,0.0
2020,3,2830,400,19,1510,2,48,10,-5,11,16,10,1,10,6,False,False,False,1,1,2020-10-02T17:46:55.073,11,,1.0
2020,3,2830,415,23,7689,2,3,3,14,14,0,14,0,14,0,False,False,False,0,2,2020-09-28T13:52:50.25,14,,0.0
2020,3,2830,425,23,2256,13,21,2,32,0,0,0,0,0,0,False,False,False,0,2,2020-09-28T13:57:37.98,0,,
2020,3,2830,430,23,7250,2,12,5,4,6,2,5,1,5,0,True,False,False,0,4,2021-03-08T18:02:28.157,6,,1.0
2020,3,2830,440,23,7250,2,43,2,23,26,3,25,1,25,0,False,False,False,0,3,2020-09-28T14:10:47.25,26,,1.0
2020,3,2830,445,23,7246,2,32,9,1,1,0,1,0,1,6,False,False,False,0,4,2020-09-28T14:15:28.603,1,,0.0
2020,3,2830,485,23,3843,13,28,4,0,0,0,0,0,0,0,False,False,False,0,1,2020-09-28T14:28:53.507,0,,
2020,3,2830,490,23,7241,2,46,3,-3,4,7,3,1,3,0,False,False,False,0,1,2020-09-28T14:31:45.69,4,,1.0
2020,3,2830,495,23,7689,2,6,1,16,34,18,26,8,26,0,False,False,False,1,3,2020-10-21T02:17:12.19,34,,8.0
2020,3,2830,510,23,2994,13,35,9,13,0,0,0,0,0,0,False,False,False,0,3,2020-10-02T17:33:21.693,0,,0.0
2020,3,2830,515,23,3843,2,28,9,0,0,0,0,0,0,0,False,False,False,0,1,2020-09-28T14:44:41.747,0,,0.0
2020,3,2830,525,19,7456,2,46,3,5,6,1,6,0,6,0,False,False,False,0,4,2020-10-02T13:37:49.653,6,,0.0
2020,3,2830,540,19,1510,2,45,5,2,15,13,15,0,15,0,True,False,False,0,3,2021-02-17T19:19:27.623,15,,0.0
2020,3,2830,575,23,7241,2,44,3,3,3,0,3,0,3,0,False,False,False,0,1,2021-03-15T13:54:13.03,3,,0.0
2020,3,2830,585,23,2256,13,5,3,6,0,0,0,0,0,0,True,False,False,0,3,2020-09-28T15:13:45.433,0,,0.0
2020,3,2830,595,19,1510,2,48,9,-4,6,10,6,0,6,0,False,False,False,0,1,2020-09-28T15:16:33.193,6,,0.0
2020,3,2830,600,19,54,2,4,10,4,8,4,8,0,8,0,True,False,False,0,3,2020-09-28T15:18:45.17,8,,0.0
2020,3,2830,615,19,8001,3,48,4,-2,0,0,0,0,0,0,False,False,False,0,1,2020-09-28T15:27:42.183,0,,0.0
2020,3,2830,635,23,7246,2,29,7,19,24,5,24,0,24,0,False,False,False,0,4,2020-09-28T15:33:42.973,24,,0.0
2020,3,2830,645,23,7240,2,44,3,-1,11,12,11,0,11,0,False,False,False,1,1,2021-03-15T13:54:24.65,11,,0.0
2020,3,2830,655,23,4949,2,13,10,5,13,8,11,2,11,0,False,False,False,0,3,2020-10-02T17:46:55.073,13,,2.0
2020,3,2830,665,23,7241,2,45,5,-2,5,7,3,2,3,0,True,False,False,1,1,2020-10-02T13:58:25.71,5,,2.0
2020,3,2830,685,23,2994,13,2,9,9,0,0,0,0,0,0,True,False,False,0,3,2020-10-02T17:54:53.817,0,,0.0
2020,3,2830,690,23,3843,2,26,3,3,2,-1,2,0,2,0,False,False,False,0,2,2020-10-02T17:29:09.723,2,,0.0
2020,3,2830,715,19,3233,2,50,9,-2,-1,1,-1,0,-1,0,False,False,False,0,3,2020-09-28T16:05:52.54,-1,,0.0
2020,3,2830,720,19,7173,2,3,3,13,27,14,20,7,20,0,False,False,False,1,2,2020-10-02T17:29:18.953,27,,7.0
2020,3,2830,725,19,54,13,35,6,16,0,0,0,0,0,0,False,False,False,0,3,2020-09-28T16:15:47.387,0,,0.0
2020,3,2830,730,19,1510,2,48,9,-5,11,16,-3,14,-3,0,False,False,False,1,1,2020-09-28T16:20:31.327,11,,14.0
2020,3,2830,780,23,7250,2,2,4,5,7,2,7,0,7,0,False,False,False,0,3,2020-09-28T16:49:40.237,7,,0.0
2020,3,2830,785,23,7250,2,26,9,1,10,9,10,0,10,0,False,False,False,0,3,2020-10-02T13:38:01.663,10,,0.0
2020,3,2830,790,23,7250,13,24,6,23,0,0,0,0,0,0,False,False,False,0,3,2020-10-21T03:10:54.133,0,,0.0
2020,3,2830,795,23,2994,2,12,5,9,8,-1,8,0,8,0,False,False,False,0,4,2021-03-08T18:05:32.193,8,,0.0
2020,3,2830,805,23,4949,2,26,5,5,12,7,9,3,9,0,False,False,False,0,2,2020-09-28T17:03:36.847,12,,3.0
2020,3,2830,810,23,2994,2,30,9,0,1,1,1,0,1,0,False,False,False,0,4,2020-09-28T17:05:46.057,1,,0.0
2020,3,2830,820,23,4949,2,39,9,3,7,4,7,0,7,0,False,False,False,0,3,2020-10-02T17:41:45.653,7,,0.0
2020,3,2830,835,23,7250,2,5,3,3,13,10,10,3,10,6,False,False,False,1,3,2020-09-28T17:15:41.397,13,,3.0
2020,3,2831,20,28,4932,2,13,9,4,20,16,17,3,17,0,False,False,False,0,3,2020-09-28T17:07:45.56,20,,3.0
2020,3,2831,45,28,4912,2,5,3,10,14,4,12,2,12,0,False,False,False,0,2,2020-09-28T17:08:02.23,14,,2.0
2020,3,2831,50,28,4912,13,13,10,4,0,0,0,0,0,0,False,False,False,0,2,2020-09-28T17:08:12.79,0,,0.0
2020,3,2831,70,21,4405,2,28,4,2,2,0,2,0,2,0,False,False,False,0,1,2020-09-28T10:31:43.607,2,,0.0
2020,3,2831,75,21,576,2,35,7,16,18,2,18,0,18,0,False,False,False,0,3,2020-09-28T10:34:32.923,18,,0.0
2020,3,2831,85,21,4422,2,5,10,6,9,3,8,1,8,0,False,False,False,0,3,2020-09-28T10:40:28.713,9,,1.0
2020,3,2831,100,28,969,2,2,9,9,11,2,11,0,11,0,False,False,False,0,4,2020-09-28T17:44:32.26,11,,0.0
2020,3,2831,105,28,969,13,30,10,-7,0,0,0,0,0,0,False,False,False,0,4,2020-10-01T21:23:31.563,0,,0.0
2020,3,2831,110,28,969,13,9,2,17,0,0,0,0,0,0,False,False,False,0,3,2020-10-01T20:25:26.563,0,,0.0
2020,3,2831,120,28,969,2,2,10,11,12,1,12,0,12,0,False,False,False,0,2,2020-09-28T17:09:14.863,12,,0.0
2020,3,2831,135,28,917,2,2,10,5,9,4,5,4,5,0,False,False,False,0,2,2020-09-28T17:09:30.31,9,,4.0
2020,3,2831,140,28,6627,2,13,10,0,1,1,1,0,1,0,False,False,False,0,4,2021-02-19T14:51:34.417,1,,0.0
2020,3,2831,145,28,7619,13,13,5,4,0,0,0,0,0,0,False,False,False,0,3,2021-02-25T14:58:34.373,0,,0.0
2020,3,2831,150,28,797,2,12,5,4,4,0,4,0,4,6,False,False,False,0,1,2020-09-28T11:19:29.503,4,,
2020,3,2831,155,28,969,3,8,9,14,0,0,0,0,0,0,False,False,False,0,4,2020-09-28T11:24:41.817,0,,0.0
2020,3,2831,170,21,7226,2,13,10,4,13,9,9,4,9,0,False,False,False,0,4,2020-09-28T11:28:57.977,13,,4.0
2020,3,2831,200,21,7090,13,9,6,26,0,0,0,0,0,0,False,False,False,0,2,2020-09-29T20:54:43.603,0,,0.0
2020,3,2831,220,28,6627,2,38,4,1,14,13,12,2,12,0,False,False,False,0,4,2020-10-01T21:26:41.667,14,,2.0
2020,3,2831,235,28,262,2,4,10,3,7,4,5,2,5,0,True,False,False,0,1,2020-09-28T12:06:43.123,7,,2.0
2020,3,2831,245,28,4912,13,6,8,16,0,0,0,0,0,0,False,False,False,0,2,2020-09-28T17:59:15.017,0,,0.0
2020,3,2831,255,28,969,3,6,10,11,0,0,0,0,0,0,False,False,False,0,3,2020-09-28T12:19:48.037,0,,0.0
2020,3,2831,270,21,7090,2,29,2,23,23,0,23,0,23,0,False,False,False,0,2,2020-09-28T17:30:14.733,23,,0.0
2020,3,2831,275,21,7090,13,5,3,5,0,0,0,0,0,0,False,False,False,0,2,2020-09-28T17:31:03.44,0,,
2020,3,2831,285,21,7090,13,2,10,5,0,0,0,0,0,0,False,False,False,0,2,2020-09-28T12:37:36.697,0,,0.0
2020,3,2831,290,21,6444,13,13,4,4,0,0,0,0,0,0,False,False,False,0,2,2020-10-02T18:38:31.66,0,,0.0
2020,3,2831,305,28,7619,13,4,7,15,0,0,0,0,0,0,False,False,False,0,2,2021-03-09T19:16:53.96,0,,0.0
2020,3,2831,310,28,4912,2,5,5,10,14,4,14,0,14,0,False,False,False,0,2,2020-09-28T12:50:33.08,14,,0.0
2020,3,2831,320,28,4912,2,35,8,16,17,1,16,1,16,0,True,False,False,0,4,2020-09-29T16:56:19.673,17,,1.0
2020,3,2831,325,28,797,13,48,5,-7,0,0,0,0,0,0,False,False,False,0,1,2020-10-01T21:52:21.827,0,,0.0
2020,3,2831,340,28,969,2,13,9,5,7,2,7,0,7,0,False,False,False,0,3,2020-09-28T13:14:46.54,7,,
2020,3,2831,350,28,6627,2,8,9,13,20,7,16,4,16,0,False,False,False,0,4,2020-09-28T13:17:25.427,20,,4.0
2020,3,2831,370,28,6627,2,4,10,5,14,9,3,11,3,0,False,False,False,1,3,2020-09-29T16:55:38.773,14,,11.0
2020,3,2831,400,21,2288,13,28,9,1,0,0,0,0,0,0,False,False,False,0,1,2020-09-28T13:33:00.517,0,,0.0
2020,3,2831,405,21,4422,13,4,10,8,0,0,0,0,0,0,False,False,False,0,3,2020-09-28T13:43:00.957,0,,0.0
2020,3,2831,410,28,797,2,7,7,25,26,1,26,0,26,0,True,False,False,0,3,2021-02-25T15:00:20.01,26,,0.0
2020,3,2831,420,28,797,2,6,3,2,8,6,7,1,7,0,False,False,False,1,1,2021-03-08T18:22:22.643,8,,1.0
2020,3,2831,435,28,7619,13,6,9,8,0,0,0,0,0,0,False,False,False,0,3,2020-09-28T13:57:38.527,0,,0.0
2020,3,2831,460,21,7090,13,3,3,10,0,0,0,0,0,0,False,False,False,0,2,2021-03-08T18:22:36.48,0,,0.0
2020,3,2831,475,21,576,2,50,9,-2,0,2,0,0,0,0,False,False,False,0,2,2020-09-28T14:15:10.367,0,,0.0
2020,3,2831,480,21,576,2,4,10,10,11,1,11,0,11,0,False,False,False,0,3,2020-09-28T14:18:04.923,11,,0.0
2020,3,2831,485,21,4422,2,13,3,5,9,4,7,2,7,0,False,False,False,0,3,2020-09-29T20:55:17.717,9,,2.0
2020,3,2831,495,21,576,2,51,10,-1,2,3,2,0,2,0,False,False,False,0,3,2020-09-28T14:29:30.317,2,,0.0
2020,3,2831,505,21,4422,13,5,6,15,0,0,0,0,0,0,False,False,False,0,4,2020-09-28T14:36:02.493,0,,0.0
2020,3,2831,520,21,576,13,26,5,3,0,0,0,0,0,0,False,False,False,0,3,2020-09-28T14:46:19.76,0,,0.0
2020,3,2831,535,28,7619,2,2,9,7,14,7,12,2,12,0,False,False,False,0,2,2020-09-28T14:50:34.107,14,,2.0
2020,3,2831,550,28,7619,2,6,9,12,19,7,17,2,17,0,False,False,False,0,2,2020-09-28T14:58:17.423,19,,2.0
2020,3,2831,560,28,7619,2,5,3,6,6,0,6,0,6,0,False,False,False,0,3,2020-09-28T15:02:50.247,6,,0.0
2020,3,2831,565,28,797,2,4,9,4,5,1,5,0,5,0,False,False,False,0,1,2020-09-28T15:05:21.883,5,,0.0
2020,3,2831,610,21,7226,13,31,10,6,0,0,0,0,0,0,False,False,False,0,4,2020-09-28T15:24:53.91,0,,0.0
2020,3,2831,615,21,5015,2,3,5,9,9,0,9,0,9,0,False,False,False,0,2,2020-09-28T15:27:03.63,9,,0.0
2020,3,2831,635,28,7619,2,6,9,11,11,0,12,-1,12,0,False,False,False,0,3,2020-09-28T15:35:22.55,11,,-1.0
2020,3,2831,645,28,6624,2,48,10,-2,19,21,18,1,18,6,False,False,False,0,1,2021-02-19T14:56:12.85,19,,1.0
2020,3,2831,660,21,7090,2,2,9,6,8,2,8,0,8,0,False,False,False,0,2,2020-09-29T20:55:32.397,8,,0.0
2020,3,2831,670,21,4405,2,12,3,5,5,0,5,0,5,0,False,False,False,0,2,2021-03-08T18:21:21.807,5,,0.0
2020,3,2831,675,21,576,2,2,4,5,5,0,5,0,5,0,False,False,False,0,3,2020-09-28T15:50:47.457,5,,0.0
2020,3,2831,680,21,4405,13,13,4,2,0,0,0,0,0,0,False,False,False,0,3,2020-09-28T15:52:24.757,0,,0.0
2020,3,2831,685,21,576,13,2,10,6,0,0,0,0,0,0,False,False,False,0,3,2020-09-28T15:54:06.2,0,,0.0
2020,3,2831,690,21,7090,13,6,9,12,0,0,0,0,0,0,False,False,False,0,2,2020-09-28T15:56:01.023,0,,0.0
2020,3,2831,710,28,6624,2,28,5,3,19,16,9,10,9,0,False,False,False,1,1,2020-10-01T21:18:04.433,19,,10.0
2020,3,2831,720,28,4912,2,26,10,8,18,10,10,8,10,0,False,True,False,1,3,2020-10-22T18:49:34.89,18,False,8.0
2020,3,2831,735,28,7751,2,2,10,3,9,6,9,0,9,0,True,False,False,0,3,2020-09-29T16:56:56.743,9,,0.0
2020,3,2831,740,28,7619,2,4,1,20,20,0,20,0,20,0,False,False,False,0,3,2020-09-28T18:02:28.91,20,,0.0
2020,3,2831,770,28,6624,2,2,10,8,16,8,14,2,14,0,False,False,False,0,3,2020-09-28T16:35:10.943,16,,2.0
2020,3,2831,790,21,5015,13,19,8,45,0,0,0,0,0,0,False,False,False,0,2,2020-09-28T16:44:31.93,0,,0.0
2020,3,2831,795,21,2288,2,6,10,3,10,7,7,3,7,0,False,False,False,0,1,2021-03-08T18:22:53.103,10,,3.0
2020,3,2831,800,21,2288,13,28,10,1,0,0,0,0,0,0,False,False,False,0,1,2020-09-28T16:50:05.337,0,,0.0
2020,3,2831,810,21,6444,2,7,2,25,29,4,26,3,26,0,False,True,False,0,2,2020-09-28T16:55:46.157,29,False,3.0
2020,3,2831,815,21,4422,2,31,9,1,4,3,2,2,2,0,False,False,False,0,4,2020-10-01T21:18:40.167,4,,2.0
2020,3,2831,825,21,7090,2,6,8,18,22,4,22,0,22,0,False,True,True,0,2,2020-09-29T02:09:08.493,22,False,0.0
2020,3,2832,15,7,7659,2,4,10,5,8,3,6,2,6,0,False,False,False,0,3,2020-10-01T21:56:52.613,8,,2.0
2020,3,2832,30,7,3445,2,50,3,0,2,2,2,0,2,0,False,False,False,0,2,2020-09-28T11:49:31.01,2,,0.0
2020,3,2832,45,24,967,13,19,2,47,0,0,0,0,0,0,False,False,False,0,2,2020-10-01T18:26:51.027,0,,0.0
2020,3,2832,60,24,894,2,35,9,7,7,0,7,0,7,0,False,False,False,0,3,2020-10-01T14:53:14.79,7,,0.0
2020,3,2832,70,24,967,13,4,10,8,0,0,0,0,0,0,False,False,False,0,2,2021-03-04T22:21:55.663,0,,0.0
2020,3,2832,75,7,3521,13,35,6,15,0,0,0,0,0,0,False,False,False,0,3,2021-03-17T18:57:53.123,0,,0.0
2020,3,2832,85,7,910,2,13,10,5,5,0,5,0,5,0,False,False,False,0,3,2020-10-01T16:41:59.987,5,,0.0
2020,3,2832,105,24,967,2,4,5,8,9,1,8,1,8,0,False,False,False,0,2,2020-09-28T12:05:26.587,9,,1.0
2020,3,2832,110,24,6373,2,4,4,0,7,7,5,2,5,0,False,False,False,0,4,2020-10-01T18:29:40.74,7,,2.0
2020,3,2832,120,24,4382,2,2,10,5,12,7,8,4,8,0,False,False,False,0,3,2020-10-01T16:43:35.133,12,,4.0
2020,3,2832,135,24,967,2,51,3,-2,2,4,0,2,0,0,False,False,False,0,3,2020-10-01T16:31:10.187,2,,2.0
2020,3,2832,150,24,4382,2,47,5,3,6,3,5,1,5,0,False,False,False,0,3,2020-10-01T18:31:38.563,6,,1.0
2020,3,2832,215,24,6937,13,48,5,-5,0,0,0,0,0,0,False,False,False,0,1,2020-09-28T12:35:00.973,0,,0.0
2020,3,2832,220,24,6937,2,4,4,1,3,2,3,0,3,0,False,False,False,0,1,2020-10-01T18:36:02.39,3,,0.0
2020,3,2832,235,7,3521,2,47,10,1,3,2,3,0,3,0,True,False,False,0,3,2020-09-30T02:18:13.42,3,,0.0
2020,3,2832,240,7,3521,2,12,10,5,9,4,7,2,7,0,False,False,False,0,3,2021-03-08T18:28:55.23,9,,2.0
2020,3,2832,250,7,4679,13,45,5,-1,0,0,0,0,0,0,False,False,False,0,1,2020-10-01T18:39:46.4,0,,0.0
2020,3,2832,265,24,4382,2,49,10,-2,0,2,0,0,0,0,False,False,False,0,3,2020-09-28T13:14:03.233,0,,0.0
2020,3,2832,270,24,4382,13,9,6,24,0,0,0,0,0,0,False,False,False,0,3,2020-09-28T13:16:20.197,0,,0.0
2020,3,2832,295,7,3521,2,2,4,7,9,2,7,2,7,0,False,False,False,0,3,2020-09-28T13:29:14.84,9,,2.0
2020,3,2832,330,24,565,2,13,9,4,12,8,11,1,11,0,False,False,False,0,4,2020-09-28T13:53:19.49,12,,1.0
2020,3,2832,345,24,894,3,6,4,10,0,0,0,0,0,0,False,False,False,0,4,2021-02-19T15:15:27.873,0,,0.0
2020,3,2832,350,24,4382,2,2,4,5,16,11,11,5,11,0,False,False,False,1,3,2020-10-01T21:59:47.413,16,,5.0
2020,3,2832,360,24,6937,13,5,3,3,0,0,0,0,0,0,False,False,False,0,1,2020-09-28T14:10:16.12,0,,0.0
2020,3,2832,365,24,894,2,32,5,1,3,2,2,1,2,0,False,False,False,0,3,2020-09-28T14:12:05.093,3,,1.0
2020,3,2832,380,7,3521,2,6,10,13,15,2,13,2,13,0,False,False,False,0,3,2021-02-19T15:18:04.867,15,,2.0
2020,3,2832,385,7,7659,13,24,2,25,0,0,0,0,0,0,False,False,False,0,3,2020-10-01T16:47:35.59,0,,0.0
2020,3,2832,390,7,6383,2,12,2,19,19,0,19,0,19,0,False,False,False,0,2,2020-10-01T16:47:41.883,19,,0.0
2020,3,2832,400,7,3521,13,5,3,5,0,0,0,0,0,0,True,False,False,0,3,2020-10-01T16:48:56.31,0,,0.0
2020,3,2832,405,7,7659,2,3,2,15,16,1,15,1,15,0,False,False,False,0,2,2020-10-01T18:42:14.533,16,,1.0
2020,3,2832,415,7,931,2,48,10,-3,5,8,-1,6,-1,0,False,False,False,1,1,2021-03-03T15:28:55.503,5,,6.0
2020,3,2832,420,7,6383,13,29,2,23,0,0,0,0,0,0,False,False,False,0,3,2020-10-01T17:33:53.837,0,,
2020,3,2832,435,7,7659,2,7,10,1,1,0,1,0,1,6,False,False,False,0,3,2021-02-19T15:22:36.573,1,,0.0
2020,3,2832,455,24,6673,2,2,4,7,10,3,10,0,10,0,False,False,False,0,3,2020-09-28T14:48:11.5,10,,0.0
2020,3,2832,460,24,7799,2,18,3,1,8,7,8,0,8,0,False,False,False,0,2,2020-09-28T14:49:39.733,8,,0.0
2020,3,2832,475,24,4382,2,9,2,17,29,12,29,0,29,6,False,False,False,0,2,2020-09-28T18:26:31.013,29,,0.0
2020,3,2832,490,7,4679,2,45,5,-3,2,5,0,2,0,0,False,False,False,0,1,2020-10-01T15:50:40.353,2,,2.0
2020,3,2832,520,24,894,2,2,10,6,9,3,7,2,7,0,False,False,False,0,3,2020-09-28T15:03:23.547,9,,2.0
2020,3,2832,540,24,894,2,16,9,5,10,5,8,2,8,0,False,False,False,0,4,2020-10-01T15:15:13.06,10,,2.0
2020,3,2832,555,24,4382,2,50,9,-2,0,2,0,0,0,0,False,False,False,0,3,2021-03-04T15:05:59.857,0,,0.0
2020,3,2832,570,7,910,2,2,10,5,7,2,7,0,7,0,False,False,False,0,2,2020-09-28T15:17:53.527,7,,0.0
2020,3,2832,580,7,3521,2,46,9,2,5,3,4,1,4,0,False,False,False,0,3,2020-10-01T18:46:24.72,5,,1.0
2020,3,2832,595,7,3445,2,50,3,0,7,7,5,2,5,0,False,False,False,0,2,2020-09-30T02:17:31.04,7,,2.0
2020,3,2832,600,7,3521,2,2,10,6,13,7,11,2,11,0,True,False,False,0,3,2020-10-01T22:02:23.823,13,,2.0
2020,3,2832,605,7,3521,2,6,10,13,17,4,17,0,17,0,False,False,False,0,2,2020-10-01T22:02:35.86,17,,0.0
2020,3,2832,615,7,3521,2,22,6,16,25,9,24,1,24,0,False,False,False,0,3,2020-10-01T22:02:54.773,25,,1.0
2020,3,2832,620,7,7659,2,35,9,4,4,0,4,0,4,6,False,False,False,0,3,2021-02-19T15:24:57.773,4,,0.0
2020,3,2832,640,24,4382,13,30,3,0,0,0,0,0,0,0,True,False,False,0,3,2020-10-01T18:51:50.4,0,,0.0
2020,3,2832,645,24,894,13,29,2,16,0,0,0,0,0,0,False,False,False,0,3,2021-03-09T19:22:42.653,0,,0.0
2020,3,2832,650,7,910,2,2,9,12,12,0,12,0,12,0,False,False,False,0,3,2020-10-01T18:57:37.35,12,,0.0
2020,3,2832,660,7,6383,2,5,10,7,10,3,8,2,8,0,False,False,False,0,3,2020-10-01T22:03:30.77,10,,2.0
2020,3,2832,665,7,6383,13,9,5,13,0,0,0,0,0,0,False,False,False,0,2,2020-09-28T15:52:32.287,0,,0.0
2020,3,2832,680,7,6383,13,29,3,13,0,0,0,0,0,0,False,False,False,0,3,2021-03-09T19:23:28.987,0,,0.0
2020,3,2832,695,24,565,2,26,10,-2,3,5,-2,5,-2,0,False,False,False,1,4,2020-10-01T16:53:06.743,3,,5.0
2020,3,2832,705,24,894,2,5,10,9,11,2,11,0,11,0,False,False,False,0,3,2020-10-01T22:03:50,11,,0.0
2020,3,2832,725,24,6673,2,13,9,3,3,0,3,0,3,0,False,False,False,0,3,2020-10-01T15:35:21.817,3,,0.0
2020,3,2832,730,24,6937,13,20,6,27,0,0,0,0,0,0,False,False,False,0,2,2020-10-01T15:35:21.817,0,,0.0
2020,3,2832,740,7,6975,2,46,9,-1,1,2,1,0,1,0,False,False,False,0,4,2020-09-30T02:18:33.03,1,,0.0
2020,3,2832,745,7,4679,2,48,9,-3,14,17,12,2,12,0,True,False,False,0,1,2020-10-01T22:04:20.4,14,,2.0
2020,3,2832,750,7,3521,2,35,6,18,18,0,18,0,18,0,False,False,False,0,3,2020-10-01T22:04:36.967,18,,0.0
2020,3,2832,760,7,7659,13,12,2,20,0,0,0,0,0,0,False,False,False,0,3,2021-03-24T19:55:52.557,0,,0.0
2020,3,2832,765,7,931,2,48,10,-2,42,44,38,4,38,0,False,False,False,0,1,2020-10-01T22:05:20.69,42,,4.0
2020,3,2832,780,7,7659,2,2,9,8,11,3,9,2,9,0,False,False,False,0,2,2020-10-01T22:22:01.33,11,,2.0
2020,3,2832,790,7,4716,2,32,9,1,1,0,1,0,1,0,False,False,False,0,4,2021-02-19T15:26:12.92,1,,0.0
2020,3,2832,800,7,931,2,47,10,3,8,5,6,2,6,0,False,False,False,0,3,2020-09-30T02:17:43.62,8,,2.0
2020,3,2832,815,24,6937,2,44,9,-2,-2,0,-3,1,-3,0,False,False,False,0,1,2020-09-28T16:43:30.61,-2,,1.0
2020,3,2832,825,24,7799,13,9,6,18,0,0,0,0,0,0,False,False,False,0,2,2020-09-28T16:46:44.807,0,,
2020,3,2832,835,24,7799,13,21,2,25,0,0,0,0,0,0,False,False,False,0,2,2020-09-28T16:50:28.493,0,,
2020,3,2832,840,24,7799,2,2,9,5,11,6,11,0,11,0,False,False,False,0,2,2020-10-01T22:11:24.85,11,,0.0
2020,3,2832,850,24,6389,13,48,9,-3,0,0,0,0,0,0,False,False,False,0,1,2020-10-01T19:18:22.63,0,,0.0
2020,3,2832,855,24,4382,2,2,4,4,4,0,4,0,4,0,False,False,False,0,3,2020-09-28T16:54:41.027,4,,0.0
2020,3,2832,875,24,6673,13,5,10,13,0,0,0,0,0,0,False,False,False,0,3,2021-02-18T16:57:17.333,0,,0.0
2020,3,2832,880,24,4382,2,47,5,3,5,2,3,2,3,0,False,False,False,0,3,2020-10-01T22:11:59.5,5,,2.0
2020,3,2832,885,24,894,2,47,5,-1,0,1,0,0,0,0,False,False,False,0,3,2020-09-28T17:02:38.533,0,,0.0
2020,3,2832,920,7,910,2,2,10,8,12,4,8,4,8,0,False,False,False,0,2,2020-10-01T22:12:40.28,12,,4.0
2020,3,2832,930,7,910,13,2,10,13,0,0,0,0,0,0,False,False,False,0,2,2020-10-01T19:25:34.48,0,,0.0
2020,3,2832,935,7,910,2,13,9,0,0,0,0,0,0,0,False,False,False,0,3,2021-02-19T15:30:32.657,0,,0.0
2020,3,2832,945,24,7799,13,6,8,20,0,0,0,0,0,0,False,False,False,0,3,2020-10-01T19:26:47.107,0,,0.0
2020,3,2832,955,24,6937,13,51,10,-5,0,0,0,0,0,0,True,False,False,0,1,2020-10-01T16:54:25.273,0,,0.0
2020,3,2832,970,7,7659,2,12,5,12,12,0,12,0,12,0,False,False,False,0,3,2020-10-01T17:48:40.8,12,,
2020,3,2832,975,7,3521,13,35,10,13,0,0,0,0,0,0,False,False,False,0,3,2020-10-01T19:39:13.297,0,,0.0
2020,3,2832,980,7,7659,13,24,2,39,0,0,0,0,0,0,False,False,False,0,2,2020-10-01T15:35:21.817,0,,0.0
2020,3,2832,990,24,6937,2,45,5,-5,4,9,3,1,3,0,False,False,False,0,1,2020-09-28T17:29:19.183,4,,1.0
2020,3,2832,995,24,894,2,7,2,31,30,-1,30,0,30,0,False,False,False,0,3,2020-10-01T22:13:19.803,30,,0.0
2020,3,2832,1005,24,6673,2,4,4,6,6,0,5,1,5,0,False,False,False,0,3,2020-10-01T17:29:10.793,6,,1.0
2020,3,2832,1025,24,6937,13,9,6,22,0,0,0,0,0,0,False,False,False,0,1,2020-09-29T21:50:02.003,0,,0.0
2020,3,2832,1035,7,3521,2,3,3,11,11,0,11,0,11,0,False,False,False,0,3,2020-10-01T22:13:46.537,11,,0.0
2020,3,2832,1050,7,7659,13,9,2,26,0,0,0,0,0,0,False,False,False,0,3,2020-10-01T17:30:01.803,0,,0.0
2020,3,2832,1070,24,6937,2,47,5,-1,7,8,7,0,7,0,False,False,False,0,1,2020-09-28T17:45:49.677,7,,0.0
2020,3,2832,1105,24,4382,13,2,9,4,0,0,0,0,0,0,False,False,False,0,3,2020-10-01T17:31:13.147,0,,0.0
2020,3,2833,10,13,2455,13,47,10,-1,0,0,0,0,0,0,False,False,False,0,1,2020-09-28T10:42:09.743,0,,0.0
2020,3,2833,20,13,6528,13,13,4,6,0,0,0,0,0,0,False,False,False,0,3,2020-10-02T14:03:52.157,0,,0.0
2020,3,2833,30,25,609,13,5,5,5,0,0,0,0,0,0,True,False,False,0,3,2020-09-28T10:52:27.693,0,,0.0
2020,3,2833,35,25,609,13,2,10,8,0,0,0,0,0,0,False,False,False,0,3,2020-10-02T14:58:53.663,0,,0.0
2020,3,2833,40,25,4583,2,13,9,3,11,8,8,3,8,0,False,False,False,0,2,2020-09-29T18:10:45.473,11,,3.0
2020,3,2833,50,25,4583,13,19,2,29,0,0,0,0,0,0,False,False,False,0,2,2020-09-29T18:11:05.807,0,,0.0
2020,3,2833,60,25,4583,13,4,3,7,0,0,0,0,0,0,False,False,False,0,2,2020-10-02T14:06:52.753,0,,
2020,3,2833,65,25,4587,2,46,3,4,13,9,11,2,11,0,False,False,False,0,1,2020-09-29T18:13:01.653,13,,2.0
2020,3,2833,75,25,181,2,13,10,3,6,3,5,1,5,0,False,False,False,0,3,2020-09-28T11:25:40.207,6,,1.0
2020,3,2833,105,13,876,2,13,5,7,20,13,20,0,20,0,False,False,False,0,3,2021-03-15T14:39:25.693,20,,0.0
2020,3,2833,109,13,3951,2,6,8,16,17,1,16,1,16,0,False,False,False,0,3,2021-03-17T20:29:25.98,17,,1.0
2020,3,2833,120,13,876,13,9,6,28,0,0,0,0,0,0,False,False,False,0,3,2020-09-28T11:47:29.62,0,,0.0
2020,3,2833,125,13,496,2,22,3,14,28,14,28,0,28,6,False,False,False,0,3,2020-09-28T17:56:58.937,28,,0.0
2020,3,2833,165,13,2136,2,50,9,-3,-1,2,-1,0,-1,0,True,False,False,0,2,2021-03-04T15:09:03.847,-1,,0.0
2020,3,2833,170,13,6528,2,12,5,2,8,6,6,2,6,0,False,False,False,0,3,2021-03-08T18:32:39.953,8,,2.0
2020,3,2833,190,25,7060,13,24,8,31,0,0,0,0,0,0,False,False,False,0,3,2020-09-28T12:16:26.243,0,,0.0
2020,3,2833,195,25,7060,13,8,7,45,0,0,0,0,0,0,False,False,False,0,2,2020-09-29T02:03:15.703,0,,0.0
2020,3,2833,215,13,2455,2,19,6,15,20,5,20,0,20,0,False,False,False,0,2,2020-09-29T16:22:50.14,20,,0.0
2020,3,2833,230,13,2136,2,6,7,16,20,4,20,0,20,0,False,False,False,0,2,2020-10-02T16:25:56.41,20,,0.0
2020,3,2833,240,13,1430,13,17,4,10,0,0,0,0,0,0,False,False,False,0,4,2021-01-20T22:47:36.393,0,,0.0
2020,3,2833,245,13,3951,2,12,9,10,9,-1,9,0,9,0,False,False,False,0,3,2020-09-28T12:48:26.89,9,,0.0
2020,3,2833,265,25,7665,3,2,10,4,0,0,0,0,0,0,True,False,False,0,2,2020-09-29T18:19:07.563,0,,0.0
2020,3,2833,275,25,181,2,46,3,0,15,15,0,15,0,0,False,False,False,0,4,2020-09-28T13:05:32.21,15,,15.0
2020,3,2833,295,25,609,2,2,4,9,17,8,17,0,17,0,False,False,False,0,4,2020-09-28T18:07:28.3,17,,0.0
2020,3,2833,320,25,609,2,9,5,10,10,0,10,0,10,6,False,False,False,0,2,2020-09-28T13:32:52.883,10,,0.0
2020,3,2833,345,13,6878,2,32,10,-2,6,8,5,1,5,0,False,False,False,0,1,2020-09-28T13:44:49.65,6,,1.0
2020,3,2833,370,25,4583,2,2,4,5,6,1,5,1,5,0,True,False,False,0,3,2020-10-02T15:02:46.147,6,,1.0
2020,3,2833,375,25,4587,2,5,9,1,12,11,12,0,12,0,False,False,False,0,1,2020-09-28T13:56:37.5,12,,0.0
2020,3,2833,380,25,609,2,5,3,5,6,1,5,1,5,0,False,False,False,0,3,2020-10-02T15:42:08.357,6,,1.0
2020,3,2833,385,25,6486,2,5,3,6,6,0,6,0,6,0,False,False,False,0,2,2021-03-15T14:39:50.317,6,,0.0
2020,3,2833,390,25,4583,2,13,3,6,26,20,26,0,26,6,False,False,False,0,3,2020-09-28T17:57:21.26,26,,0.0
2020,3,2833,405,13,876,2,4,5,6,8,2,7,1,7,0,False,False,False,1,2,2020-09-28T14:11:03.013,8,,1.0
2020,3,2833,410,13,496,2,4,7,16,18,2,18,0,18,0,False,False,False,0,3,2020-10-02T14:00:36.06,18,,0.0
2020,3,2833,420,13,6528,2,12,5,11,20,9,20,0,20,0,False,False,False,0,3,2020-09-28T17:57:44.317,20,,0.0
2020,3,2833,430,13,496,2,8,10,13,15,2,15,0,15,0,False,False,False,0,3,2020-10-02T16:34:22.27,15,,0.0
2020,3,2833,440,13,3951,2,19,3,14,14,0,14,0,14,6,False,False,False,0,2,2020-10-02T16:35:09.357,14,,0.0
2020,3,2833,480,25,7665,2,48,10,-4,7,11,6,1,6,0,False,False,False,1,1,2020-10-02T14:54:16,7,,1.0
2020,3,2833,495,25,6486,2,2,3,5,7,2,6,1,6,0,False,False,False,0,2,2020-10-02T17:08:04.773,7,,1.0
2020,3,2833,500,25,6486,13,19,1,48,0,0,0,0,0,0,False,False,False,0,2,2020-09-28T14:46:53.037,0,,0.0
2020,3,2833,510,25,7666,13,8,1,39,0,0,0,0,0,0,False,False,False,0,2,2020-10-02T17:09:09.733,0,,
2020,3,2833,515,25,7666,13,35,9,10,0,0,0,0,0,0,False,False,False,0,3,2020-09-28T15:01:53.383,0,,
2020,3,2833,520,25,6486,3,13,4,1,0,0,0,0,0,0,False,False,False,0,2,2020-09-28T17:58:57.783,0,,0.0
2020,3,2833,525,25,4587,3,12,3,13,0,0,0,0,0,0,False,False,False,0,3,2020-09-28T15:08:07.117,0,,0.0
2020,3,2833,530,25,4587,2,4,4,4,7,3,6,1,6,0,True,False,False,0,1,2020-09-29T18:19:31.707,7,,1.0
2020,3,2833,555,13,2455,2,32,10,3,3,0,3,0,3,0,False,False,False,0,1,2020-09-28T15:22:04.183,3,,0.0
2020,3,2833,575,25,6486,2,4,6,15,15,0,15,0,15,0,False,False,False,0,2,2021-05-07T21:19:02.237,15,,0.0
2020,3,2833,615,25,7666,13,12,2,20,0,0,0,0,0,0,False,False,False,0,3,2020-09-28T17:53:26.353,0,,0.0
2020,3,2833,620,25,7666,13,4,8,15,0,0,0,0,0,0,False,False,False,0,3,2020-10-02T15:42:58.017,0,,0.0
2020,3,2833,635,13,3951,2,2,10,9,14,5,9,5,9,0,False,False,False,0,2,2021-03-15T14:40:03.843,14,,5.0
2020,3,2833,650,13,3951,13,6,4,0,0,0,0,0,0,0,False,False,False,0,2,2020-10-02T14:00:36.06,0,,0.0
2020,3,2833,655,13,496,2,12,8,17,34,17,32,2,32,0,False,False,False,0,3,2020-10-02T17:13:26.067,34,,2.0
2020,3,2833,660,13,876,2,34,4,-5,-5,0,-5,0,-5,0,True,False,False,0,3,2020-09-29T15:26:50.927,-5,,0.0
2020,3,2833,665,13,1430,3,5,10,4,0,0,0,0,0,0,False,False,False,0,4,2020-10-02T17:14:06.143,0,,0.0
2020,3,2833,670,13,2136,13,12,2,30,0,0,0,0,0,0,False,False,False,0,3,2021-03-05T14:28:45.42,0,,0.0
2020,3,2833,675,25,609,2,4,4,4,5,1,5,0,5,0,False,False,False,0,4,2020-10-02T17:25:41.283,5,,0.0
2020,3,2833,680,25,4583,2,46,9,0,0,0,0,0,0,0,False,False,False,0,3,2020-10-02T15:05:48.62,0,,0.0
2020,3,2833,685,25,609,2,7,3,13,14,1,13,1,13,0,False,False,False,0,3,2020-09-28T16:38:43.057,14,,1.0
2020,3,2833,700,25,6486,2,49,5,-2,1,3,1,0,1,0,False,False,False,0,2,2021-03-04T16:13:21.423,1,,0.0
2020,3,2833,710,25,7666,13,19,2,23,0,0,0,0,0,0,False,False,False,0,2,2020-09-28T16:53:41.187,0,,0.0
2020,3,2833,715,25,4587,2,48,9,-2,8,10,8,0,8,0,False,False,False,0,1,2020-10-02T14:00:36.06,8,,0.0
2020,3,2833,720,25,181,2,31,4,5,14,9,8,6,8,0,False,False,False,1,4,2020-10-02T17:26:56.223,14,,6.0
2020,3,2833,750,13,876,13,6,10,11,0,0,0,0,0,0,False,False,False,0,3,2020-10-02T17:29:32.443,0,,0.0
2020,3,2833,760,13,2136,2,4,1,16,16,0,16,0,16,0,False,False,False,0,3,2020-09-28T17:14:05.29,16,,0.0
2020,3,2833,795,25,6486,2,2,4,2,7,5,5,2,5,0,False,False,False,1,2,2020-10-02T15:07:13.147,7,,2.0
2020,3,2833,820,25,7666,2,18,3,0,24,24,4,20,4,0,False,False,False,2,2,2020-10-02T15:07:48.817,24,,20.0
2020,3,2834,20,22,6270,13,35,9,10,0,0,0,0,0,0,False,False,False,0,3,2020-09-28T11:12:27.643,0,,
2020,3,2834,35,22,7950,13,4,3,8,0,0,0,0,0,0,False,False,False,0,2,2020-09-28T14:48:02.517,0,,0.0
2020,3,2834,50,22,1113,2,4,4,3,5,2,4,1,4,0,False,False,False,0,1,2020-09-28T11:21:32.317,5,,1.0
2020,3,2834,60,22,2391,13,43,7,26,0,0,0,0,0,0,True,False,False,0,4,2020-09-28T11:25:38.6,0,,0.0
2020,3,2834,65,22,6277,2,48,4,-4,21,25,13,8,13,0,False,False,False,1,1,2020-09-28T15:56:22.68,21,,8.0
2020,3,2834,75,22,6262,2,51,9,-4,3,7,2,1,2,0,False,False,False,0,3,2020-09-28T11:33:49.477,3,,1.0
2020,3,2834,95,22,6277,2,45,5,-5,4,9,4,0,4,0,True,False,False,0,1,2020-10-01T17:33:40.317,4,,0.0
2020,3,2834,105,22,6270,2,5,3,5,11,6,10,1,10,0,True,False,False,0,2,2020-10-01T16:19:12.797,11,,1.0
2020,3,2834,120,22,6270,2,12,2,16,16,0,16,0,16,6,False,False,False,0,3,2020-09-28T11:49:05.377,16,,0.0
2020,3,2834,140,14,1114,2,4,9,6,10,4,7,3,7,0,False,False,False,1,3,2020-09-28T11:59:53.047,10,,3.0
2020,3,2834,145,14,4449,2,5,2,20,20,0,20,0,20,0,False,False,False,0,4,2020-10-01T17:40:30.333,20,,0.0
2020,3,2834,160,14,7584,2,26,3,2,9,7,7,2,7,0,False,False,False,0,2,2020-09-28T12:06:14.513,9,,2.0
2020,3,2834,190,14,1114,13,9,5,4,0,0,0,0,0,0,False,False,False,0,2,2020-09-28T12:16:31.957,0,,
2020,3,2834,195,14,5197,2,32,10,1,1,0,1,0,1,6,False,False,False,0,4,2020-10-01T16:19:12.797,1,,0.0
2020,3,2834,210,22,7950,2,2,4,13,19,6,17,2,17,0,False,False,False,0,2,2021-02-15T22:10:31.537,19,,2.0
2020,3,2834,225,22,6277,2,48,9,-2,8,10,7,1,7,0,False,False,False,0,1,2020-09-28T12:33:17.543,8,,1.0
2020,3,2834,235,14,4449,13,5,6,18,0,0,0,0,0,0,False,False,False,0,3,2020-09-28T12:36:53.5,0,,0.0
2020,3,2834,240,14,5197,2,6,1,16,45,29,45,0,45,0,False,False,False,0,3,2020-09-28T12:40:10.233,45,,0.0
2020,3,2834,270,22,6262,2,5,5,4,9,5,7,2,7,0,False,False,False,0,4,2020-10-01T16:19:12.797,9,,2.0
2020,3,2834,280,22,1361,13,35,8,16,0,0,0,0,0,0,False,False,False,0,3,2020-09-28T16:04:20.327,0,,0.0
2020,3,2834,285,22,6270,2,11,2,17,28,11,28,0,28,0,False,False,False,0,3,2020-09-28T12:54:10.793,28,,0.0
2020,3,2834,300,22,7950,13,7,3,7,0,0,0,0,0,0,False,False,False,0,2,2021-02-25T15:05:50.69,0,,0.0
2020,3,2834,305,14,7584,13,6,8,17,0,0,0,0,0,0,False,False,False,0,2,2021-03-10T18:34:35.183,0,,
2020,3,2834,310,14,1114,2,5,6,15,25,10,18,7,18,0,False,False,False,1,2,2020-09-28T13:07:09.843,25,,7.0
2020,3,2834,320,14,6545,2,4,10,12,12,0,12,0,12,0,False,False,False,0,3,2020-10-01T18:28:47.177,12,,0.0
2020,3,2834,335,14,7495,13,38,10,2,0,0,0,0,0,0,False,False,False,0,3,2020-09-28T13:14:44.55,0,,0.0
2020,3,2834,355,22,6277,2,48,9,-2,6,8,2,4,2,0,False,False,False,1,1,2020-09-28T13:20:55.67,6,,4.0
2020,3,2834,380,22,6262,13,13,3,6,0,0,0,0,0,0,False,False,False,0,3,2020-09-28T13:33:55.607,0,,0.0
2020,3,2834,385,22,1361,13,19,6,25,0,0,0,0,0,0,False,False,False,0,2,2020-09-28T13:36:53.017,0,,0.0
2020,3,2834,395,14,4449,2,4,4,12,14,2,13,1,13,0,False,False,False,0,3,2020-09-28T13:39:21.92,14,,1.0
2020,3,2834,405,14,6545,2,4,3,11,11,0,11,0,11,0,False,False,False,0,2,2020-10-01T16:19:12.797,11,,0.0
2020,3,2834,410,14,6543,2,4,4,4,11,7,9,2,9,0,False,False,False,0,1,2020-09-28T13:43:25,11,,2.0
2020,3,2834,435,14,7582,2,47,10,0,3,3,3,0,3,0,False,False,False,0,1,2020-09-28T13:51:46.61,3,,0.0
2020,3,2834,445,14,6546,2,28,9,-2,6,8,5,1,5,0,False,False,False,0,1,2020-09-28T13:56:07.483,6,,1.0
2020,3,2834,455,14,4449,13,26,9,4,0,0,0,0,0,0,False,False,False,0,2,2021-01-12T23:24:53.347,0,,0.0
2020,3,2834,475,22,2391,3,13,5,0,0,0,0,0,0,0,False,False,False,0,3,2020-09-28T14:07:10.297,0,,0.0
2020,3,2834,485,14,6543,2,47,5,0,12,12,10,2,10,0,False,False,False,0,1,2020-09-28T14:09:53.707,12,,2.0
2020,3,2834,500,14,1114,2,4,7,15,17,2,17,0,17,0,False,False,False,0,3,2020-09-28T14:14:37.573,17,,0.0
2020,3,2834,520,14,6543,2,48,10,-5,5,10,3,2,3,0,False,False,False,2,1,2020-09-28T14:21:38.227,5,,2.0
2020,3,2834,545,22,7950,2,2,4,10,16,6,13,3,13,0,False,False,False,0,2,2020-09-28T14:29:23.26,16,,3.0
2020,3,2834,570,14,6543,2,44,3,1,12,11,10,2,10,0,True,False,False,0,1,2020-09-28T14:35:43.633,12,,2.0
2020,3,2834,580,14,6543,3,48,10,-6,0,0,0,0,0,0,False,False,False,0,1,2020-09-28T14:38:19.857,0,,0.0
2020,3,2834,585,14,5197,2,13,10,4,4,0,4,0,4,0,False,False,False,0,3,2020-09-28T14:39:54.867,4,,0.0
2020,3,2834,600,22,7609,2,28,4,2,3,1,3,0,3,0,False,False,False,0,1,2021-02-15T22:15:12.127,3,,0.0
2020,3,2834,605,22,1361,13,3,2,16,0,0,0,0,0,0,False,False,False,0,2,2021-03-05T14:34:24.027,0,,0.0
2020,3,2834,630,22,6262,2,51,10,0,9,9,7,2,7,0,True,False,False,0,4,2021-01-29T15:27:30.343,9,,2.0
2020,3,2834,660,22,6277,2,45,10,-6,5,11,5,0,5,0,False,False,False,0,1,2020-09-28T15:11:48.97,5,,0.0
2020,3,2834,680,14,7584,2,12,3,5,13,8,10,3,10,0,False,False,False,0,2,2020-09-28T15:56:58.947,13,,3.0
2020,3,2834,690,14,7584,13,12,10,6,0,0,0,0,0,0,False,False,False,0,3,2020-09-29T18:11:55.2,0,,0.0
2020,3,2834,695,14,7584,2,50,10,-4,4,8,0,4,0,0,False,False,False,0,2,2021-03-04T15:11:58.69,4,,4.0
2020,3,2834,700,14,8222,3,32,5,3,0,0,0,0,0,0,False,False,False,0,4,2020-09-28T15:55:02.337,0,,0.0
2020,3,2834,765,22,7609,2,45,5,-4,-4,0,-4,0,-4,0,False,False,False,0,1,2020-09-28T15:45:57.327,-4,,0.0
2020,3,2834,775,22,6270,2,4,4,5,9,4,9,0,9,0,False,False,False,0,3,2020-10-01T16:19:12.797,9,,0.0
2020,3,2834,790,22,6262,13,12,6,19,0,0,0,0,0,0,False,False,False,0,3,2020-10-01T18:33:53.193,0,,0.0
2020,3,2835,10,5,6425,13,30,10,-2,0,0,0,0,0,0,False,False,False,0,4,2020-09-28T10:16:52.31,0,,0.0
2020,3,2835,20,5,5220,13,6,7,16,0,0,0,0,0,0,False,False,False,0,2,2020-09-28T11:09:28.247,0,,0.0
2020,3,2835,30,26,309,13,5,5,5,0,0,0,0,0,0,False,False,False,0,3,2020-10-01T14:16:53.95,0,,0.0
2020,3,2835,50,5,2847,2,46,3,3,12,9,9,3,9,0,False,False,False,1,3,2021-01-28T21:23:52.323,12,,3.0
2020,3,2835,55,5,3477,2,13,9,4,18,14,16,2,16,0,True,False,False,0,2,2020-09-28T15:37:05.133,18,,2.0
2020,3,2835,65,5,2554,2,47,5,-1,-1,0,-1,0,-1,0,False,False,False,0,1,2020-09-28T15:37:15.963,-1,,0.0
2020,3,2835,105,5,2554,2,48,9,-4,9,13,6,3,6,0,False,False,False,0,1,2020-09-28T15:36:21.863,9,,3.0
2020,3,2835,110,5,4803,2,2,4,7,24,17,13,11,13,0,False,False,False,2,3,2020-09-28T12:02:22.54,24,,11.0
2020,3,2835,120,5,2554,2,32,3,2,2,0,2,0,2,0,False,False,False,0,4,2020-10-01T15:17:02.57,2,,0.0
2020,3,2835,125,5,2554,13,46,3,2,0,0,0,0,0,0,False,False,False,0,1,2020-09-28T11:11:02.707,0,,0.0
2020,3,2835,145,26,309,2,50,3,0,4,4,1,3,1,0,False,False,False,1,2,2020-09-28T11:15:33.333,4,,3.0
2020,3,2835,150,26,4282,2,17,7,15,16,1,16,0,16,0,True,False,False,0,3,2020-10-01T16:25:55.4,16,,0.0
2020,3,2835,165,26,4616,2,48,9,-7,28,35,26,2,26,0,False,False,False,0,1,2020-09-28T11:24:57.323,28,,2.0
2020,3,2835,185,26,309,2,3,5,6,6,0,6,0,6,0,False,False,False,0,2,2020-09-28T11:36:00.963,6,,0.0
2020,3,2835,230,5,6425,2,4,9,6,9,3,9,0,9,0,False,False,False,0,3,2020-09-28T15:35:40.593,9,,0.0
2020,3,2835,270,26,309,2,39,4,7,11,4,9,2,9,0,False,False,False,1,3,2021-02-17T18:28:33.077,11,,2.0
2020,3,2835,280,5,3477,2,2,9,10,14,4,12,2,12,0,False,False,False,0,2,2021-01-28T21:25:12.53,14,,2.0
2020,3,2835,285,5,2847,13,6,1,17,0,0,0,0,0,0,False,False,False,0,2,2021-01-28T21:25:34.937,0,,0.0
2020,3,2835,295,5,3477,2,13,10,2,13,11,6,7,6,0,False,False,False,0,3,2020-09-28T12:15:14.207,13,,7.0
2020,3,2835,305,5,2554,2,45,5,-2,8,10,4,4,4,0,False,False,False,0,1,2020-09-28T12:18:44.227,8,,4.0
2020,3,2835,320,5,2554,2,48,9,-2,13,15,7,6,7,6,False,False,False,1,1,2020-10-01T14:27:54.59,13,,6.0
2020,3,2835,335,26,309,2,26,5,3,9,6,6,3,6,0,False,False,False,1,3,2020-10-01T14:14:09.607,9,,3.0
2020,3,2835,350,26,4619,2,8,1,42,45,3,44,1,44,0,False,False,False,0,2,2020-10-01T15:22:47.173,45,,
2020,3,2835,360,26,4616,2,48,9,-6,9,15,2,7,2,0,False,False,False,1,1,2020-09-28T12:42:11.483,9,,7.0
2020,3,2835,365,26,4282,2,4,4,7,10,3,8,2,8,0,False,False,False,0,3,2020-09-28T12:43:09.737,10,,2.0
2020,3,2835,375,26,4616,2,45,10,-7,6,13,0,6,0,0,False,False,False,0,1,2020-09-28T12:45:56.363,6,,6.0
2020,3,2835,390,26,309,13,5,3,12,0,0,0,0,0,0,False,False,False,0,3,2021-03-05T14:44:31.417,0,,0.0
2020,3,2835,395,5,3477,2,4,9,4,4,0,4,0,4,0,True,False,False,0,3,2020-10-01T14:19:05.103,4,,0.0
2020,3,2835,425,26,309,2,4,10,5,9,4,8,1,8,0,False,False,False,0,2,2020-09-28T12:59:33.077,9,,1.0
2020,3,2835,435,26,7695,2,45,5,-6,3,9,-4,7,-4,0,True,False,False,1,2,2020-09-28T13:03:33.44,3,,7.0
2020,3,2835,440,26,309,13,26,10,3,0,0,0,0,0,0,False,False,False,0,2,2020-10-01T16:26:15.367,0,,0.0
2020,3,2835,450,5,5220,3,30,10,0,0,0,0,0,0,0,False,False,False,0,3,2020-10-01T14:16:37.093,0,,0.0
2020,3,2835,460,5,4803,2,50,10,-3,10,13,8,2,8,0,True,False,False,0,3,2020-09-28T15:34:32.903,10,,2.0
2020,3,2835,470,26,4619,2,12,5,14,17,3,16,1,16,0,False,False,False,0,2,2021-03-08T18:41:52.417,17,,1.0
2020,3,2835,475,26,7453,13,19,2,39,0,0,0,0,0,0,False,False,False,0,2,2021-02-17T18:30:45.773,0,,0.0
2020,3,2835,480,26,309,2,4,9,4,5,1,4,1,4,0,False,False,False,0,3,2020-10-01T16:26:40.4,5,,1.0
2020,3,2835,485,26,4282,2,26,9,4,11,7,6,5,6,0,False,False,False,0,3,2020-09-28T13:19:42.647,11,,5.0
2020,3,2835,500,26,4616,2,50,5,-1,8,9,5,3,5,0,False,False,False,0,2,2020-09-28T13:26:26.693,8,,3.0
2020,3,2835,515,5,2847,2,46,3,1,4,3,4,0,4,0,False,False,False,0,3,2021-01-28T21:26:50.16,4,,0.0
2020,3,2835,530,26,309,2,49,9,-4,12,16,9,3,9,0,False,False,False,2,3,2020-10-01T14:28:32.01,12,,3.0
2020,3,2835,535,26,4616,2,12,4,-8,1,9,-5,6,-5,0,False,False,False,2,1,2021-03-08T18:44:23,1,,6.0
2020,3,2835,540,26,1900,13,17,7,20,0,0,0,0,0,0,False,False,False,0,4,2020-09-28T15:54:07.363,0,,0.0
2020,3,2835,545,26,309,2,4,4,13,22,9,20,2,20,0,False,False,False,0,3,2020-09-28T13:51:02.147,22,,2.0
2020,3,2835,550,26,309,2,51,3,-3,-1,2,-1,0,-1,0,False,False,False,0,3,2020-09-28T13:54:05.137,-1,,0.0
2020,3,2835,555,26,7453,2,6,8,16,16,0,16,0,16,0,False,False,False,0,3,2020-09-28T13:55:47.677,16,,0.0
2020,3,2835,560,26,309,13,7,3,10,0,0,0,0,0,0,False,False,False,0,3,2020-09-28T13:56:48.167,0,,0.0
2020,3,2835,565,26,7695,2,47,5,2,5,3,4,1,4,0,False,False,False,0,1,2020-10-01T16:26:58.81,5,,
2020,3,2835,570,26,7697,13,13,9,5,0,0,0,0,0,0,False,False,False,0,2,2021-02-17T18:35:46.207,0,,0.0
2020,3,2835,575,26,4616,2,50,5,-2,-3,-1,-3,0,-3,0,False,False,False,0,2,2020-10-01T16:27:08.45,-3,,0.0
2020,3,2835,590,5,2554,2,4,10,2,4,2,3,1,3,0,False,False,False,1,1,2020-09-28T15:34:57.623,4,,1.0
2020,3,2835,595,5,5220,2,19,6,33,38,5,36,2,36,0,False,False,False,0,2,2020-09-28T15:35:11.133,38,,2.0
2020,3,2835,605,5,2554,2,48,9,-6,1,7,-2,3,-2,0,False,False,False,0,1,2020-10-01T14:28:57.107,1,,3.0
2020,3,2835,610,5,3477,2,2,9,2,6,4,5,1,5,0,False,False,False,0,2,2020-10-01T16:27:20.337,6,,1.0
2020,3,2835,625,5,4803,2,13,9,4,5,1,5,0,5,0,True,False,False,0,2,2020-09-28T14:16:58.46,5,,0.0
2020,3,2835,635,5,4803,2,39,4,6,6,0,6,0,6,0,False,False,False,0,3,2020-09-28T14:23:12.7,6,,0.0
2020,3,2835,655,26,4616,2,16,9,3,7,4,5,2,5,0,False,False,False,0,1,2020-10-01T16:27:31.053,7,,2.0
2020,3,2835,665,26,4282,2,4,10,6,6,0,6,0,6,0,False,False,False,0,3,2020-09-28T14:29:57.48,6,,0.0
2020,3,2835,670,26,4282,2,4,9,6,7,1,6,1,6,0,False,False,False,0,3,2020-09-28T14:30:59.863,7,,1.0
2020,3,2835,680,26,4282,13,4,9,7,0,0,0,0,0,0,False,False,False,0,3,2020-09-28T14:35:53.097,0,,0.0
2020,3,2835,685,26,7695,2,4,4,5,6,1,6,0,6,0,False,False,False,0,1,2020-10-01T16:27:44.283,6,,0.0
2020,3,2835,690,26,4616,2,45,10,-6,10,16,7,3,7,0,False,False,False,0,1,2020-09-28T14:37:22.407,10,,3.0
2020,3,2835,710,26,7697,3,13,9,5,0,0,0,0,0,0,False,False,False,0,2,2020-10-01T16:27:52.943,0,,0.0
2020,3,2835,715,26,309,2,4,10,6,11,5,10,1,10,0,False,False,False,0,2,2020-09-28T14:57:44.737,11,,1.0
2020,3,2835,720,26,4282,2,47,5,5,5,0,5,0,5,0,False,False,False,0,4,2020-09-28T14:59:19.767,5,,
2020,3,2835,730,26,7697,13,13,9,4,0,0,0,0,0,0,False,False,False,0,2,2020-09-28T15:02:18.787,0,,0.0
2020,3,2835,735,26,309,2,8,10,14,14,0,14,0,14,6,False,False,False,0,3,2021-02-17T18:40:57.87,14,,0.0
2020,3,2835,750,5,5220,2,35,6,23,27,4,27,0,27,0,False,False,False,0,3,2020-09-28T15:08:24.857,27,,0.0
2020,3,2835,760,5,2554,2,46,3,1,9,8,9,0,9,0,True,False,False,0,3,2020-09-29T17:33:01.42,9,,0.0
2020,3,2835,800,26,4282,3,4,10,5,0,0,0,0,0,0,False,False,False,0,3,2020-09-28T15:18:33.347,0,,0.0
2020,3,2835,805,26,7453,2,4,10,5,7,2,6,1,6,0,True,False,False,0,2,2020-09-28T15:19:42.77,7,,1.0
2020,3,2835,810,26,4616,2,4,10,2,5,3,4,1,4,0,False,False,False,0,1,2020-09-28T15:20:37.577,5,,1.0
2020,3,2835,815,26,7697,2,12,7,15,15,0,15,0,15,0,False,False,False,0,3,2021-03-08T18:48:56.397,15,,0.0
2020,3,2835,820,26,4616,2,4,4,1,2,1,1,1,1,0,False,False,False,0,1,2020-09-28T15:23:12.197,2,,1.0
2020,3,2835,830,26,4616,2,12,3,1,11,10,9,2,9,0,False,False,False,0,1,2021-03-08T18:57:28.527,11,,2.0
2020,3,2835,835,26,309,2,6,8,19,21,2,20,1,20,0,False,False,False,0,2,2020-09-28T15:47:43.253,21,,1.0
2020,3,2835,850,26,309,13,24,2,28,0,0,0,0,0,0,True,False,False,0,2,2020-10-01T16:49:15.777,0,,0.0
2020,3,2835,855,26,309,2,6,9,14,14,0,14,0,14,0,False,True,True,0,2,2020-09-29T00:17:01.45,9,,0.0
2020,3,2836,10,11,100,2,5,3,2,18,16,3,15,3,0,False,False,False,1,3,2020-09-28T10:38:16.823,18,,15.0
2020,3,2836,35,11,100,13,4,8,17,0,0,0,0,0,0,False,False,False,0,3,2021-03-09T19:27:24.473,0,,
2020,3,2836,40,11,6810,13,35,10,12,0,0,0,0,0,0,False,False,False,0,3,2020-09-28T10:49:44.793,0,,0.0
2020,3,2836,50,11,914,2,4,9,11,11,0,11,0,11,0,False,False,False,0,3,2021-03-10T18:27:40.957,11,,0.0
2020,3,2836,90,1,525,2,47,5,0,0,0,0,0,0,0,True,False,False,0,3,2020-09-28T11:09:42.527,0,,0.0
2020,3,2836,100,1,245,2,9,6,24,30,6,30,0,30,0,False,False,False,0,2,2020-09-28T11:15:19.833,30,,0.0
2020,3,2836,110,1,7316,3,8,10,13,0,0,0,0,0,0,True,False,False,0,3,2020-09-28T11:21:51.217,0,,0.0
2020,3,2836,115,1,5152,13,35,7,19,0,0,0,0,0,0,False,False,False,0,3,2021-03-09T19:28:09.013,0,,0.0
2020,3,2836,120,11,4492,13,19,6,27,0,0,0,0,0,0,False,False,False,0,2,2020-09-29T19:56:49.437,0,,0.0
2020,3,2836,130,11,914,13,19,6,42,0,0,0,0,0,0,False,False,False,0,3,2020-09-28T11:33:39.617,0,,
2020,3,2836,135,11,100,13,35,4,14,0,0,0,0,0,0,False,False,False,0,3,2020-09-28T11:36:04.163,0,,0.0
2020,3,2836,150,1,6406,2,4,9,2,6,4,6,0,6,0,False,False,False,0,2,2020-09-28T11:41:32.82,6,,0.0
2020,3,2836,155,1,7315,2,9,6,20,26,6,25,1,25,0,True,False,False,0,3,2021-02-15T17:07:27.063,26,,1.0
2020,3,2836,160,1,7315,2,5,3,3,4,1,3,1,3,0,False,False,False,0,3,2020-09-28T11:46:18.963,4,,1.0
2020,3,2836,170,1,5032,2,32,10,1,15,14,16,-1,16,0,False,False,False,0,3,2020-09-28T11:53:53.337,15,,-1.0
2020,3,2836,180,1,525,13,2,4,6,0,0,0,0,0,0,False,False,False,0,3,2020-09-28T11:56:45.633,0,,
2020,3,2836,185,1,245,2,49,3,-3,-3,0,-3,0,-3,0,False,False,False,0,2,2020-09-28T11:59:15.08,-3,,0.0
2020,3,2836,190,1,7315,2,7,5,13,13,0,13,0,13,6,False,False,False,0,3,2020-09-28T12:00:27.073,13,,0.0
2020,3,2836,220,11,2714,2,38,9,2,15,13,13,2,13,0,True,False,False,0,4,2020-10-01T14:53:46.56,15,,2.0
2020,3,2836,230,11,4487,2,51,9,-9,0,9,-3,3,-3,0,True,False,False,0,3,2020-10-01T15:09:08.113,0,,3.0
2020,3,2836,265,1,525,13,4,10,8,0,0,0,0,0,0,False,False,False,0,3,2020-09-28T12:29:11.313,0,,0.0
2020,3,2836,290,11,4492,2,13,9,1,1,0,1,0,1,0,False,False,False,0,3,2020-09-28T12:44:40.563,1,,0.0
2020,3,2836,295,11,2714,2,5,10,1,5,4,4,1,4,6,False,False,False,0,3,2020-10-01T14:53:55.7,5,,1.0
2020,3,2836,310,1,245,2,4,9,14,18,4,13,5,13,0,False,False,False,1,3,2020-09-28T12:50:12.2,18,,5.0
2020,3,2836,315,1,245,2,4,3,10,11,1,11,0,11,0,False,False,False,0,2,2020-09-28T12:52:05.877,11,,0.0
2020,3,2836,325,1,5152,2,4,5,8,11,3,10,1,10,0,False,False,False,0,3,2020-09-28T12:54:39.417,11,,1.0
2020,3,2836,345,1,6406,2,13,4,1,15,14,13,2,13,0,True,False,False,0,3,2021-02-15T17:07:36.973,15,,2.0
2020,3,2836,370,11,4487,2,13,5,4,20,16,19,1,19,0,True,False,False,0,2,2020-09-28T13:05:09.787,20,,1.0
2020,3,2836,380,11,6810,2,35,9,9,11,2,11,0,11,0,False,False,False,0,4,2020-09-28T13:07:21.03,11,,0.0
2020,3,2836,385,11,4492,2,4,3,8,10,2,10,0,10,0,False,False,False,0,2,2020-09-28T13:08:28.95,10,,0.0
2020,3,2836,395,11,7732,2,44,3,-3,19,22,14,5,14,0,False,False,False,0,1,2020-09-28T13:11:43.243,19,,5.0
2020,3,2836,405,11,4492,2,8,9,13,15,2,13,2,13,6,False,False,False,0,3,2020-09-28T13:15:23.027,15,,2.0
2020,3,2836,420,1,7316,2,13,9,2,10,8,9,1,9,0,False,False,False,0,3,2020-09-28T13:17:50.227,10,,1.0
2020,3,2836,445,1,5032,2,47,5,3,9,6,6,3,6,0,False,False,False,1,1,2020-10-01T14:55:14.73,9,,3.0
2020,3,2836,455,1,245,2,3,3,13,21,8,14,7,14,0,False,False,False,1,2,2020-09-28T13:28:05.783,21,,7.0
2020,3,2836,470,1,7316,2,4,10,14,14,0,14,0,14,0,False,False,False,0,3,2020-09-28T13:34:05.193,14,,0.0
2020,3,2836,500,11,4492,2,13,3,1,1,0,1,0,1,0,True,False,False,0,3,2020-09-28T13:42:48.213,1,,0.0
2020,3,2836,505,11,100,13,35,7,18,0,0,0,0,0,0,False,False,False,0,3,2020-09-28T13:49:46.553,0,,0.0
2020,3,2836,515,1,4307,2,46,9,2,6,4,2,4,2,0,False,False,False,0,1,2020-09-28T13:53:47.203,6,,4.0
2020,3,2836,525,1,245,13,13,10,7,0,0,0,0,0,0,False,False,False,0,3,2020-09-28T13:56:59.097,0,,0.0
2020,3,2836,530,1,245,13,5,3,14,0,0,0,0,0,0,False,False,False,0,2,2020-09-28T13:58:35.207,0,,
2020,3,2836,540,1,7316,13,3,5,13,0,0,0,0,0,0,False,False,False,0,2,2020-09-28T14:02:15.483,0,,0.0
2020,3,2836,545,1,245,13,12,8,20,0,0,0,0,0,0,False,False,False,0,2,2021-03-05T15:03:08.753,0,,0.0
2020,3,2836,565,11,2714,13,7,5,6,0,0,0,0,0,0,False,False,False,0,4,2021-02-25T15:08:04.6,0,,0.0
2020,3,2836,570,11,100,13,35,10,6,0,0,0,0,0,0,False,False,False,0,3,2020-09-28T14:12:39.17,0,,0.0
2020,3,2836,590,1,245,2,5,3,5,15,10,8,7,8,0,False,False,False,1,3,2020-09-28T14:16:35.043,15,,7.0
2020,3,2836,595,1,245,2,5,3,11,12,1,12,0,12,0,False,False,False,0,2,2020-09-28T14:17:50.6,12,,0.0
2020,3,2836,600,1,525,13,6,4,14,0,0,0,0,0,0,False,False,False,0,3,2021-02-15T17:13:23.75,0,,0.0
2020,3,2836,615,1,245,2,51,9,-3,11,14,0,11,0,0,False,False,False,1,3,2021-02-15T14:39:03.723,11,,11.0
2020,3,2836,625,1,245,2,13,9,7,10,3,8,2,8,0,True,False,False,0,3,2020-09-28T14:39:50.74,10,,2.0
2020,3,2836,635,1,7315,2,5,5,1,4,3,2,2,2,6,False,False,False,1,3,2020-10-01T14:55:46.37,4,,2.0
2020,3,2836,660,11,7732,13,11,10,0,0,0,0,0,0,0,False,False,False,0,1,2021-02-25T15:09:34.91,0,,0.0
2020,3,2836,665,11,4492,2,8,8,17,19,2,18,1,18,0,True,False,False,0,3,2020-10-01T14:54:08.783,19,,1.0
2020,3,2836,670,11,6810,2,7,10,14,27,13,19,8,19,0,False,False,False,0,4,2020-09-28T15:08:08.333,27,,8.0
2020,3,2836,680,11,6810,13,5,5,11,0,0,0,0,0,0,False,False,False,0,4,2020-09-28T15:12:03.723,0,,0.0
2020,3,2836,685,11,6341,2,31,10,0,14,14,11,3,11,0,False,False,False,1,1,2020-10-01T14:55:59.473,14,,3.0
2020,3,2836,705,1,7316,13,5,5,5,0,0,0,0,0,0,False,False,False,0,3,2021-02-15T14:42:00.197,0,,0.0
2020,3,2836,725,11,6810,2,13,10,5,8,3,6,2,6,0,False,False,False,0,4,2020-10-01T15:15:56.713,8,,2.0
2020,3,2836,730,11,6810,2,2,10,5,7,2,6,1,6,0,True,False,False,0,3,2020-10-01T15:11:04.937,7,,1.0
2020,3,2836,735,11,2714,2,38,10,4,8,4,7,1,7,0,False,False,False,0,4,2020-09-28T15:43:47.81,8,,1.0
2020,3,2836,750,11,6810,13,9,5,8,0,0,0,0,0,0,False,False,False,0,2,2020-09-28T15:50:18.727,0,,0.0
2020,3,2836,770,1,245,2,50,9,-1,12,13,5,7,5,0,False,False,False,0,2,2020-09-28T15:55:29.133,12,,7.0
2020,3,2836,785,1,7316,13,29,2,20,0,0,0,0,0,0,False,False,False,0,2,2020-09-28T16:00:42.533,0,,0.0
2020,3,2836,790,1,7316,13,19,8,47,0,0,0,0,0,0,False,False,False,0,2,2020-09-28T16:02:12.68,0,,0.0
2020,3,2836,805,11,792,2,44,3,-4,10,14,8,2,8,0,True,False,False,0,1,2020-09-28T16:27:35.253,10,,2.0
2020,3,2836,810,11,914,2,5,2,20,20,0,20,0,20,0,True,False,False,0,3,2020-09-28T16:29:31.59,20,,0.0
2020,3,2836,820,11,3820,2,7,6,47,52,5,48,4,48,0,False,False,False,0,3,2020-10-01T15:15:56.713,52,,
2020,3,2836,830,11,6810,13,11,2,20,0,0,0,0,0,0,False,False,False,0,4,2020-09-28T16:37:49.227,0,,
2020,3,2836,840,11,4492,2,5,3,7,11,4,11,0,11,0,False,False,False,0,3,2020-09-28T16:40:49.147,11,,0.0
2020,3,2836,855,11,914,2,5,5,5,20,15,5,15,5,0,False,False,False,1,3,2020-10-01T14:54:25.673,20,,15.0
2020,3,2837,20,10,7701,2,4,3,7,9,2,9,0,9,0,False,False,False,0,2,2021-02-15T21:55:17.943,9,,0.0
2020,3,2837,40,10,6840,2,32,3,1,6,5,3,3,3,0,False,False,False,0,4,2020-09-28T17:20:28.847,6,,3.0
2020,3,2837,55,30,6414,13,5,5,5,0,0,0,0,0,0,False,False,False,0,1,2020-09-28T10:44:46.58,0,,0.0
2020,3,2837,60,30,4516,2,5,9,6,10,4,8,2,8,6,True,False,False,1,3,2021-02-15T21:55:26.83,10,,2.0
2020,3,2837,85,10,7700,13,4,8,15,0,0,0,0,0,0,False,False,False,0,3,2021-02-15T21:57:35.997,0,,0.0
2020,3,2837,95,30,4523,2,31,10,-2,5,7,2,3,2,0,False,False,False,0,4,2020-09-28T11:08:42.27,5,,3.0
2020,3,2837,100,30,63,2,6,10,5,9,4,6,3,6,0,False,False,False,0,4,2020-09-28T11:11:12.067,9,,3.0
2020,3,2837,105,30,63,2,5,9,4,7,3,5,2,5,0,False,False,False,0,4,2020-09-28T11:13:21.367,7,,2.0
2020,3,2837,120,30,119,13,6,4,3,0,0,0,0,0,0,False,False,False,0,1,2020-09-28T11:20:45.307,0,,0.0
2020,3,2837,130,10,282,2,47,5,0,2,2,1,1,1,0,False,False,False,0,1,2020-09-28T11:24:03.593,2,,1.0
2020,3,2837,135,10,282,13,46,3,2,0,0,0,0,0,0,False,False,False,0,1,2020-09-28T11:26:01.35,0,,0.0
2020,3,2837,140,10,7700,13,5,6,23,0,0,0,0,0,0,False,False,False,0,3,2020-10-01T19:28:59.757,0,,0.0
2020,3,2837,155,30,4937,2,46,3,3,3,0,4,-1,4,0,False,False,False,0,3,2020-09-28T16:51:08.77,3,,-1.0
2020,3,2837,160,30,119,2,5,10,5,9,4,9,0,9,0,False,False,False,0,1,2021-03-05T13:01:32.987,9,,0.0
2020,3,2837,180,30,7268,2,5,5,9,10,1,10,0,10,0,False,False,False,0,2,2020-09-28T11:42:55.957,10,,0.0
2020,3,2837,190,30,4516,2,50,9,-4,10,14,8,2,8,0,False,False,False,0,3,2021-02-15T21:59:39.967,10,,2.0
2020,3,2837,200,30,119,13,5,3,6,0,0,0,0,0,0,False,False,False,0,3,2020-09-30T15:53:11.903,0,,0.0
2020,3,2837,225,10,7700,2,39,4,5,15,10,15,0,15,0,False,False,False,0,3,2020-09-28T12:01:36.44,15,,0.0
2020,3,2837,230,10,6840,2,43,9,14,18,4,14,4,14,0,True,False,False,0,4,2020-09-29T18:54:44.003,18,,4.0
2020,3,2837,245,10,6840,2,39,4,3,7,4,3,4,3,0,False,False,False,1,4,2020-09-28T12:11:25.56,7,,4.0
2020,3,2837,265,30,4523,13,17,7,18,0,0,0,0,0,0,False,False,False,0,3,2020-09-28T12:17:27.45,0,,0.0
2020,3,2837,270,30,7268,2,35,8,43,47,4,43,4,43,0,False,False,False,0,3,2020-10-01T20:25:58.637,47,,4.0
2020,3,2837,280,30,63,13,7,2,21,0,0,0,0,0,0,False,False,False,0,4,2020-09-28T12:23:39.423,0,,0.0
2020,3,2837,285,30,4516,2,13,9,4,6,2,6,0,6,0,True,False,False,0,3,2020-10-01T20:27:10.65,6,,0.0
2020,3,2837,300,30,63,2,39,4,5,6,1,6,0,6,0,False,False,False,0,4,2020-09-28T12:31:33.66,6,,0.0
2020,3,2837,305,30,4516,3,2,10,3,0,0,0,0,0,0,False,False,False,0,3,2020-09-28T12:33:57.233,0,,0.0
2020,3,2837,315,30,793,2,49,9,-1,1,2,-1,2,-1,6,True,False,False,0,2,2020-10-01T19:28:59.757,1,,2.0
2020,3,2837,340,10,282,2,48,10,-5,-2,3,-5,3,-5,0,False,False,False,0,1,2020-09-28T12:44:37.363,-2,,3.0
2020,3,2837,350,30,4523,2,43,2,26,33,7,28,5,28,0,False,False,False,0,4,2020-09-28T12:49:14.183,33,,5.0
2020,3,2837,355,30,793,13,22,3,13,0,0,0,0,0,0,False,False,False,0,2,2020-09-28T12:52:07.593,0,,0.0
2020,3,2837,360,30,63,2,32,9,2,9,7,6,3,6,0,False,False,False,0,4,2020-09-28T12:54:41.207,9,,3.0
2020,3,2837,375,30,793,2,9,3,1,1,0,1,0,1,6,False,False,False,0,2,2021-02-15T22:03:05.197,1,,0.0
2020,3,2837,390,10,4930,13,4,10,11,0,0,0,0,0,0,False,False,False,0,2,2021-02-15T22:04:02.437,0,,
2020,3,2837,405,10,7701,3,6,9,13,0,0,0,0,0,0,False,False,False,0,2,2020-10-01T20:48:16.413,0,,0.0
2020,3,2837,410,10,4930,2,6,8,23,27,4,23,4,23,0,False,False,False,0,2,2020-09-28T13:13:04.087,27,,4.0
2020,3,2837,415,10,282,2,4,4,3,6,3,6,0,6,0,False,False,False,0,1,2020-09-28T13:14:51.05,6,,0.0
2020,3,2837,420,10,7701,2,6,4,14,17,3,17,0,17,0,False,False,False,0,3,2020-09-28T13:17:08.747,17,,0.0
2020,3,2837,425,10,7700,2,2,4,11,11,0,11,0,11,0,False,False,False,0,3,2020-10-01T19:28:59.757,11,,0.0
2020,3,2837,435,10,6840,2,2,4,4,6,2,5,1,5,0,False,False,False,0,3,2020-09-28T13:22:34.253,6,,1.0
2020,3,2837,440,10,4930,2,6,5,4,7,3,7,0,7,6,False,False,False,1,2,2020-09-28T13:23:59.933,7,,0.0
2020,3,2837,480,30,63,2,47,5,1,10,9,6,4,6,0,False,False,False,0,4,2020-09-28T13:38:30.463,10,,4.0
2020,3,2837,485,30,7268,13,5,3,14,0,0,0,0,0,0,True,False,False,0,3,2020-10-01T20:28:16.233,0,,0.0
2020,3,2837,490,30,4516,2,6,4,4,8,4,7,1,7,0,False,False,False,0,3,2020-09-28T13:43:26.28,8,,1.0
2020,3,2837,495,30,793,3,2,9,2,0,0,0,0,0,0,False,False,False,0,2,2020-09-28T13:45:07.2,0,,0.0
2020,3,2837,505,10,6840,3,6,9,11,0,0,0,0,0,0,False,False,False,0,3,2021-02-25T15:20:40.333,0,,0.0
2020,3,2837,515,10,6840,3,5,10,3,0,0,0,0,0,0,False,False,False,0,4,2020-09-28T13:53:10.71,0,,0.0
2020,3,2837,530,30,4523,2,5,3,9,11,2,9,2,9,0,False,False,False,1,4,2020-09-28T14:00:55.273,11,,2.0
2020,3,2837,545,30,6414,2,5,3,4,11,7,11,0,11,0,False,False,False,0,1,2020-09-28T14:07:16.977,11,,0.0
2020,3,2837,550,30,63,2,38,9,2,7,5,7,0,7,0,False,False,False,0,4,2020-09-28T14:09:07.663,7,,0.0
2020,3,2837,560,10,7700,13,4,10,4,0,0,0,0,0,0,False,False,False,0,3,2020-09-28T14:12:40.007,0,,0.0
2020,3,2837,570,10,282,13,47,10,2,0,0,0,0,0,0,False,False,False,0,1,2020-10-01T20:31:05.717,0,,0.0
2020,3,2837,585,30,4937,2,47,5,2,4,2,2,2,2,0,False,False,False,0,1,2020-09-28T14:21:19.147,4,,2.0
2020,3,2837,590,30,7268,13,19,6,45,0,0,0,0,0,0,False,False,False,0,3,2020-10-01T20:32:18.63,0,,0.0
2020,3,2837,595,30,119,2,32,5,3,15,12,13,2,13,0,False,False,False,1,6,2020-09-28T14:26:04.867,15,,2.0
2020,3,2837,610,10,6840,13,35,10,13,0,0,0,0,0,0,False,False,False,0,4,2020-09-28T14:34:08.837,0,,0.0
2020,3,2837,615,10,6282,2,11,5,6,28,22,22,6,22,0,False,False,False,0,1,2020-09-28T14:36:37.973,28,,6.0
2020,3,2837,625,10,5105,2,47,5,4,5,1,5,0,5,0,False,False,False,0,3,2020-09-28T14:40:42.827,5,,0.0
2020,3,2837,630,10,7701,13,8,10,5,0,0,0,0,0,0,False,False,False,0,3,2021-02-25T15:27:07.027,0,,0.0
2020,3,2837,635,30,4516,2,24,2,25,30,5,25,5,25,0,False,False,False,0,3,2020-09-28T14:46:27.54,30,,5.0
2020,3,2837,640,30,6414,2,47,5,5,9,4,9,0,9,0,False,False,False,0,1,2020-09-28T16:49:52.95,9,,0.0
2020,3,2837,650,30,6414,3,44,9,-5,0,0,0,0,0,0,True,False,False,0,1,2020-09-29T16:16:35.357,0,,0.0
2020,3,2837,680,10,6840,2,5,5,4,9,5,6,3,6,0,False,False,False,1,4,2020-10-01T19:51:05.327,9,,3.0
2020,3,2837,685,10,6840,13,4,10,6,0,0,0,0,0,0,False,False,False,0,4,2020-09-28T15:22:55.52,0,,0.0
2020,3,2837,700,10,7700,2,13,10,3,5,2,4,1,4,0,False,False,False,0,3,2020-09-28T15:27:37.097,5,,1.0
2020,3,2837,705,10,6840,13,7,2,26,0,0,0,0,0,0,False,False,False,0,4,2020-09-28T15:29:23.013,0,,0.0
2020,3,2837,720,30,7893,3,2,4,4,0,0,0,0,0,0,False,False,False,0,3,2020-09-28T15:35:36.097,0,,
2020,3,2837,730,30,7268,2,35,7,18,26,8,20,6,20,0,False,False,False,1,3,2020-09-28T15:40:55.17,26,,6.0
2020,3,2837,745,10,4930,2,4,3,4,5,1,4,1,4,0,False,False,False,0,2,2020-09-28T16:55:54.257,5,,1.0
2020,3,2837,760,10,7701,2,13,4,4,4,0,4,0,4,0,False,False,False,0,3,2020-09-28T16:53:44.213,4,,0.0
2020,3,2837,765,10,4930,2,6,9,4,4,0,4,0,4,0,False,False,False,0,2,2021-02-25T15:28:36.65,4,,0.0
2020,3,2837,770,10,7700,2,5,5,2,2,0,2,0,2,0,False,False,False,0,3,2021-03-08T15:31:05.32,2,,0.0
2020,3,2837,775,10,7700,2,17,9,13,22,9,22,0,22,0,False,False,False,0,3,2020-09-28T16:01:04.76,22,,0.0
2020,3,2837,785,10,7082,2,4,9,8,7,-1,7,0,7,0,False,False,False,0,3,2020-09-28T16:00:48.223,7,,0.0
2020,3,2837,790,10,4930,2,18,5,-1,3,4,1,2,1,0,False,False,False,0,2,2020-09-28T17:47:05.07,3,,
2020,3,2837,795,10,282,2,44,3,-2,6,8,4,2,4,0,False,False,False,0,1,2020-09-28T16:12:17.657,6,,2.0
2020,3,2837,800,10,6840,13,7,2,16,0,0,0,0,0,0,False,False,False,0,3,2020-10-16T20:58:33.467,0,,
2020,3,2837,810,10,6282,2,16,4,0,3,3,1,2,1,0,False,False,False,0,1,2020-09-28T16:52:49.743,3,,2.0
2020,3,2837,815,10,7700,13,17,10,12,0,0,0,0,0,0,False,False,False,0,3,2020-09-28T16:23:52.64,0,,0.0
2020,3,2838,10,27,7408,13,2,9,7,0,0,0,0,0,0,False,False,False,0,2,2020-09-28T10:15:27.417,0,,0.0
2020,3,2838,30,9,322,2,4,9,4,6,2,5,1,5,0,False,False,False,0,3,2020-09-28T16:32:06.263,6,,1.0
2020,3,2838,35,9,322,13,4,9,7,0,0,0,0,0,0,True,False,False,0,3,2020-09-28T10:21:04.51,0,,0.0
2020,3,2838,40,9,7816,2,5,5,4,5,1,5,0,5,0,False,False,False,0,3,2020-10-02T18:41:15.143,5,,0.0
2020,3,2838,45,9,6436,2,49,3,-1,4,5,2,2,2,0,False,False,False,0,2,2020-09-28T10:23:20.303,4,,2.0
2020,3,2838,50,9,7816,13,30,3,-1,0,0,0,0,0,0,False,False,False,0,3,2020-09-28T10:24:52.8,0,,0.0
2020,3,2838,55,9,322,2,13,9,4,7,3,6,1,6,0,True,False,False,0,3,2020-09-28T10:26:42.03,7,,1.0
2020,3,2838,75,9,6446,2,13,9,5,28,23,10,18,10,0,False,False,False,1,3,2021-02-15T15:12:41.847,28,,18.0
2020,3,2838,85,9,7816,13,4,3,12,0,0,0,0,0,0,False,False,False,0,2,2020-09-30T00:24:28.543,0,,0.0
2020,3,2838,90,9,6446,13,17,8,21,0,0,0,0,0,0,False,False,False,0,3,2020-09-28T10:36:45.527,0,,0.0
2020,3,2838,110,27,650,2,4,10,6,7,1,6,1,6,0,True,False,False,0,2,2020-09-28T10:40:58.5,7,,1.0
2020,3,2838,120,27,650,2,8,7,43,43,0,43,0,43,6,False,False,False,0,3,2020-09-28T10:43:22.06,43,,0.0
2020,3,2838,155,27,7404,13,28,10,3,0,0,0,0,0,0,False,False,False,0,1,2020-09-28T10:49:31.763,0,,0.0
2020,3,2838,165,9,322,2,49,3,-4,0,4,0,0,0,0,False,False,False,0,2,2020-09-28T10:51:15.973,0,,0.0
2020,3,2838,175,9,7816,2,17,1,20,28,8,25,3,25,0,False,False,False,0,3,2020-09-28T16:22:47.13,28,,3.0
2020,3,2838,180,9,6436,3,5,3,4,0,0,0,0,0,0,False,False,False,0,3,2020-09-28T10:55:16.827,0,,0.0
2020,3,2838,185,9,322,2,23,7,25,28,3,28,0,28,0,True,False,False,0,2,2020-09-28T10:59:49.233,28,,0.0
2020,3,2838,220,27,7852,2,26,4,5,13,8,10,3,10,0,False,False,False,0,4,2020-09-28T11:10:14.777,13,,3.0
2020,3,2838,230,27,7408,2,21,8,56,62,6,61,1,61,0,False,True,True,0,2,2020-09-28T11:13:47.83,62,False,1.0
2020,3,2838,235,9,4202,13,12,3,0,0,0,0,0,0,0,False,False,False,0,1,2020-10-02T20:34:24.703,0,,0.0
2020,3,2838,240,9,6436,13,2,9,7,0,0,0,0,0,0,False,False,False,0,2,2020-10-02T17:53:12.783,0,,0.0
2020,3,2838,245,9,322,13,12,1,32,0,0,0,0,0,0,False,False,False,0,2,2020-09-28T11:21:03.263,0,,0.0
2020,3,2838,270,27,650,13,47,5,6,0,0,0,0,0,0,True,False,False,0,3,2020-10-02T18:49:26.573,0,,0.0
2020,3,2838,285,9,7183,2,34,4,-4,-5,-1,-5,0,-5,0,True,False,False,0,3,2020-10-02T20:47:15.643,-5,False,0.0
2020,3,2838,300,27,650,2,45,5,1,4,3,3,1,3,0,True,False,False,0,3,2020-10-02T18:19:15.257,4,,1.0
2020,3,2838,310,27,650,3,35,5,8,0,0,0,0,0,0,False,False,False,0,3,2020-09-28T11:46:22.987,0,,0.0
2020,3,2838,315,27,7408,2,4,5,3,10,7,6,4,6,0,False,False,False,0,2,2020-09-29T21:22:50.657,10,,4.0
2020,3,2838,320,27,650,13,12,4,13,0,0,0,0,0,0,False,False,False,0,3,2021-03-08T19:16:36.257,0,,0.0
2020,3,2838,325,27,7408,3,19,2,20,0,0,0,0,0,0,False,False,False,0,3,2020-09-28T11:53:15.103,0,,0.0
2020,3,2838,335,27,5069,2,34,4,-4,2,6,0,2,0,0,True,False,False,0,3,2020-09-28T11:55:41.863,2,,2.0
2020,3,2838,340,27,650,2,4,1,15,15,0,15,0,15,0,False,False,False,0,2,2020-09-30T17:09:05.987,15,,0.0
2020,3,2838,350,27,650,13,21,8,22,0,0,0,0,0,0,False,False,False,0,3,2021-03-05T15:19:03.653,0,,
2020,3,2838,355,27,505,13,12,7,15,0,0,0,0,0,0,False,False,False,0,3,2020-09-28T12:03:09.583,0,,
2020,3,2838,365,27,650,2,47,5,1,1,0,1,0,1,6,False,False,False,0,4,2020-09-28T12:06:12.583,1,,0.0
2020,3,2838,380,9,322,2,4,4,12,13,1,12,1,12,0,False,False,False,0,3,2020-09-28T12:08:17.76,13,,1.0
2020,3,2838,385,9,322,2,4,10,11,22,11,13,9,13,0,False,False,False,0,3,2020-10-02T20:47:43.027,22,,9.0
2020,3,2838,390,9,6441,2,2,4,6,40,34,26,14,26,6,False,False,False,1,3,2020-09-28T12:18:25.213,40,,14.0
2020,3,2838,415,27,5050,2,28,10,-5,2,7,-4,6,-4,0,False,False,False,1,1,2020-10-02T20:48:07.68,2,,6.0
2020,3,2838,420,27,505,2,32,3,2,5,3,4,1,4,0,False,False,False,0,3,2020-09-28T12:25:45.54,5,,1.0
2020,3,2838,465,9,322,2,4,5,5,5,0,5,0,5,0,False,False,False,0,2,2020-09-28T12:42:04.713,5,,0.0
2020,3,2838,470,9,322,13,6,10,13,0,0,0,0,0,0,False,False,False,0,2,2020-10-02T18:19:15.257,0,,0.0
2020,3,2838,475,27,7408,2,4,5,9,9,0,9,0,9,0,False,False,False,0,2,2020-09-28T12:45:39.177,9,,0.0
2020,3,2838,485,27,505,2,12,5,8,8,0,8,0,8,0,False,False,False,0,2,2021-03-08T19:17:21.29,8,,0.0
2020,3,2838,490,27,650,3,13,10,5,0,0,0,0,0,0,False,False,False,0,3,2021-02-15T15:15:42.687,0,,0.0
2020,3,2838,495,27,505,2,12,2,16,16,0,16,0,16,0,True,False,False,0,3,2020-09-28T12:50:40.353,16,,0.0
2020,3,2838,505,27,650,2,13,9,1,1,0,1,0,1,6,False,False,False,0,3,2020-09-28T12:53:08.213,1,,0.0
2020,3,2838,545,27,4835,2,47,5,1,1,0,1,0,1,6,False,False,False,0,1,2020-09-28T12:58:09.327,1,,0.0
2020,3,2838,560,9,6446,2,4,9,5,10,5,5,5,5,0,False,False,False,0,2,2020-09-28T13:08:46.07,10,,5.0
2020,3,2838,570,9,4202,2,45,5,-4,-4,0,-4,0,-4,0,True,False,False,0,1,2020-09-28T13:11:11.253,-4,,0.0
2020,3,2838,575,9,6436,2,4,5,10,10,0,10,0,10,0,False,False,False,0,2,2020-10-02T17:54:00.263,10,,0.0
2020,3,2838,585,9,4202,3,47,5,0,0,0,0,0,0,0,False,False,False,0,1,2020-09-28T13:15:00.62,0,,0.0
2020,3,2838,590,9,4202,3,47,10,-8,0,0,0,0,0,0,False,False,False,0,1,2021-02-15T15:16:49.147,0,,0.0
2020,3,2838,595,9,322,2,26,9,1,1,0,1,0,1,0,True,False,False,0,2,2020-09-28T13:24:34.38,1,,0.0
2020,3,2838,610,27,6397,2,53,10,-3,-1,2,-1,0,-1,0,False,False,False,0,4,2020-10-02T20:36:22.533,-1,,0.0
2020,3,2838,620,27,650,2,3,3,8,8,0,8,0,8,0,True,False,False,0,2,2020-09-28T13:28:39.497,8,,0.0
2020,3,2838,645,9,6436,2,19,2,40,52,12,46,6,46,0,False,False,False,0,2,2021-02-15T15:28:18.4,52,,6.0
2020,3,2838,650,9,4202,3,48,9,-5,0,0,0,0,0,0,False,False,False,0,1,2020-09-28T13:37:24.4,0,,0.0
2020,3,2838,655,9,6441,2,6,7,20,42,22,42,0,42,6,False,False,False,0,3,2020-10-02T18:19:15.257,42,,0.0
2020,3,2838,670,27,153,2,46,3,0,11,11,11,0,11,0,False,False,False,0,1,2020-09-28T13:45:13.247,11,,0.0
2020,3,2838,680,27,4835,13,12,2,19,0,0,0,0,0,0,False,False,False,0,3,2020-10-02T17:54:12.243,0,,0.0
2020,3,2838,685,27,650,2,12,1,16,16,0,16,0,16,0,False,False,False,0,3,2020-09-28T13:49:06.967,16,,0.0
2020,3,2838,695,27,6397,2,12,5,5,6,1,6,0,6,0,False,False,False,0,4,2020-10-02T17:54:26.543,6,,0.0
2020,3,2838,715,9,7816,2,35,2,18,20,2,20,0,20,0,True,False,False,0,3,2021-11-16T16:43:54.94,20,,0.0
2020,3,2838,725,9,7816,2,4,3,12,10,-2,10,0,10,0,True,False,False,0,3,2021-02-15T15:28:33.83,10,,0.0
2020,3,2838,735,9,4202,13,48,3,-7,0,0,0,0,0,0,False,False,False,0,1,2020-09-28T14:01:39.163,0,,0.0
2020,3,2838,740,9,4446,2,2,9,6,9,3,6,3,6,0,False,False,False,0,2,2020-09-28T14:02:54.067,9,,3.0
2020,3,2838,745,9,2568,13,32,10,-1,0,0,0,0,0,0,False,False,False,0,4,2020-10-02T17:54:44.197,0,,0.0
2020,3,2838,760,9,6436,2,19,6,35,43,8,38,5,38,6,False,False,False,0,2,2020-09-28T14:12:14.907,43,,5.0
2020,3,2838,775,27,505,3,46,3,1,0,0,0,0,0,0,False,False,False,0,3,2020-10-02T17:54:58.937,0,,0.0
2020,3,2838,780,27,5050,2,6,9,1,6,5,5,1,5,0,False,False,False,0,1,2020-09-28T14:17:06.88,6,,1.0
2020,3,2838,795,27,5050,2,48,3,-5,4,9,2,2,2,0,False,False,False,0,1,2020-09-28T14:24:36.573,4,,2.0
2020,3,2838,800,27,7408,13,9,2,36,0,0,0,0,0,0,False,False,False,0,3,2020-09-28T14:38:18.907,0,,0.0
2020,3,2838,815,9,6446,13,2,10,10,0,0,0,0,0,0,False,False,False,0,4,2020-09-28T14:42:22.877,0,,0.0
2020,3,2838,820,9,6436,2,3,3,10,19,9,11,8,11,0,False,False,False,0,2,2020-10-02T17:55:40.49,19,,8.0
2020,3,2838,830,9,4202,2,48,9,-2,-2,0,-2,0,-2,0,False,False,False,0,1,2020-10-02T17:56:19.43,-2,,0.0
2020,3,2838,840,9,6436,2,3,3,10,10,0,10,0,10,0,False,False,False,0,2,2020-09-28T15:06:59.347,10,,0.0
2020,3,2838,845,9,6441,2,51,5,-1,8,9,6,2,6,0,False,False,False,0,3,2020-09-28T15:09:10.983,8,,2.0
2020,3,2838,850,9,6441,2,49,3,-2,3,5,-2,5,-2,0,False,False,False,1,2,2021-02-15T15:30:55.313,3,,5.0
2020,3,2838,865,9,4202,2,28,9,-1,6,7,3,3,3,0,True,False,False,0,1,2020-09-28T15:27:00.6,6,,3.0
2020,3,2838,870,9,6441,13,9,2,26,0,0,0,0,0,0,True,False,False,0,3,2020-10-02T17:56:43.96,0,,0.0
2020,3,2838,885,9,7816,2,51,5,-1,2,3,2,0,2,0,False,False,False,0,3,2020-09-30T00:27:19.483,2,,0.0
2020,3,2838,890,9,4446,13,11,2,19,0,0,0,0,0,0,True,False,False,0,3,2020-09-28T15:32:50.543,0,,0.0
2020,3,2838,895,9,6436,13,19,2,24,0,0,0,0,0,0,False,False,False,0,2,2020-09-28T15:39:34.047,0,,0.0
2020,3,2838,910,27,505,2,12,5,14,21,7,17,4,17,0,False,False,False,0,4,2020-10-02T17:56:59.937,21,,4.0
2020,3,2838,915,27,650,2,5,5,5,5,0,5,0,5,0,True,False,False,0,2,2020-10-02T18:55:34.397,5,,0.0
2020,3,2838,925,27,7408,3,2,10,5,0,0,0,0,0,0,False,False,False,0,2,2020-09-28T15:45:09.003,0,,0.0
2020,3,2838,930,27,505,2,17,10,10,11,1,11,0,11,0,False,False,False,0,3,2020-10-02T20:38:14.657,11,,0.0
2020,3,2838,950,27,7408,2,35,2,29,29,0,29,0,29,6,False,False,False,0,2,2021-02-25T21:56:19.017,29,,0.0
2020,3,2838,975,9,4202,2,4,4,3,10,7,7,3,7,0,False,False,False,0,1,2020-09-28T15:54:55.737,10,,3.0
2020,3,2838,980,9,4202,2,28,5,0,6,6,6,0,6,0,False,False,False,0,1,2020-09-28T15:56:19.413,6,,0.0
2020,3,2838,990,9,6446,2,5,5,2,2,0,2,0,2,0,False,False,False,0,3,2020-09-28T15:58:19.257,2,,0.0
2020,3,2838,995,9,322,2,6,9,4,4,0,4,0,4,0,False,False,False,0,2,2021-03-08T15:33:56.203,4,,0.0
2020,3,2838,1000,9,6446,2,6,9,6,8,2,6,2,6,0,False,False,False,0,3,2020-09-28T16:00:52.18,8,,2.0
2020,3,2838,1010,9,4202,2,13,4,3,8,5,6,2,6,0,False,False,False,0,2,2020-09-28T16:13:11.357,8,,2.0
2020,3,2838,1020,9,4202,2,48,10,-2,-2,0,-2,0,-2,0,True,False,False,0,1,2020-09-30T00:28:08.853,-2,,
2020,3,2838,1025,9,6441,2,5,3,12,14,2,13,1,13,0,False,False,False,0,3,2020-09-30T00:27:39.68,14,,1.0
2020,3,2838,1030,9,6441,13,6,9,4,0,0,0,0,0,0,False,False,False,0,3,2020-09-28T16:17:21.577,0,,0.0
2020,3,2838,1045,9,6436,13,12,6,26,0,0,0,0,0,0,False,False,False,0,3,2020-09-28T16:19:27.347,0,,0.0
2020,3,2839,20,20,7353,2,5,5,4,3,-1,3,0,3,0,False,False,False,0,3,2020-09-28T10:43:13.993,3,,0.0
2020,3,2839,35,12,6691,2,30,3,1,9,8,8,1,8,0,False,False,False,0,3,2020-09-28T10:50:27.053,9,,1.0
2020,3,2839,55,12,6691,2,51,9,-2,5,7,2,3,2,0,False,False,False,1,3,2020-09-28T11:06:04.317,5,,3.0
2020,3,2839,60,12,4537,2,32,3,-1,12,13,3,9,3,0,False,False,False,1,1,2021-02-19T14:34:27.16,12,,9.0
2020,3,2839,65,12,6691,13,26,10,4,0,0,0,0,0,0,False,False,False,0,3,2020-09-28T11:06:15.03,0,,0.0
2020,3,2839,75,12,4511,2,32,5,1,9,8,6,3,6,0,False,False,False,0,4,2020-09-29T18:56:18.46,9,,3.0
2020,3,2839,105,20,5140,2,16,9,5,11,6,9,2,9,6,False,False,False,0,1,2020-09-29T16:23:09.147,11,,2.0
2020,3,2839,120,12,4511,2,4,9,9,10,1,10,0,10,0,False,False,False,0,4,2020-09-28T11:13:37.237,10,,0.0
2020,3,2839,125,12,4537,2,48,9,-3,5,8,3,2,3,0,False,False,False,0,1,2020-09-28T11:15:19.753,5,,2.0
2020,3,2839,150,12,6869,13,8,1,31,0,0,0,0,0,0,False,False,False,0,3,2020-09-29T02:41:38.797,0,,0.0
2020,3,2839,160,12,3965,2,51,10,-2,3,5,1,2,1,0,True,False,False,0,3,2020-09-28T11:25:53.58,3,,2.0
2020,3,2839,195,20,5140,2,45,5,-5,-2,3,-3,1,-3,0,False,False,False,0,1,2020-09-28T11:33:40.097,-2,,1.0
2020,3,2839,210,12,6691,2,7,6,42,48,6,48,0,48,0,False,False,False,0,4,2021-02-19T14:39:22.163,48,,0.0
2020,3,2839,220,12,6691,2,35,10,5,5,0,5,0,5,6,False,False,False,0,4,2020-10-01T14:25:05.55,5,,0.0
2020,3,2839,240,20,5140,2,51,10,-6,6,12,6,0,6,0,False,False,False,0,1,2020-09-29T16:23:57.177,6,,
2020,3,2839,250,20,5140,2,6,9,2,21,19,4,17,4,0,False,False,False,2,1,2020-09-28T11:49:24.04,21,,17.0
2020,3,2839,275,20,6388,13,4,10,4,0,0,0,0,0,0,False,False,False,0,2,2020-09-29T02:50:40.553,0,,0.0
2020,3,2839,280,20,7888,2,39,4,5,7,2,6,1,6,0,False,False,False,0,3,2020-09-28T11:58:47.72,7,,1.0
2020,3,2839,285,20,4535,2,49,9,-3,1,4,0,1,0,0,True,False,False,0,3,2020-09-28T12:00:20.47,1,,1.0
2020,3,2839,305,12,6357,13,5,2,21,0,0,0,0,0,0,True,False,False,0,3,2020-09-28T14:42:12.02,0,,0.0
2020,3,2839,315,12,6357,13,19,2,28,0,0,0,0,0,0,False,False,False,0,2,2020-09-28T12:06:23.883,0,,0.0
2020,3,2839,330,20,5140,2,5,9,4,3,-1,3,0,3,0,False,False,False,0,1,2020-09-28T12:09:17.1,3,,
2020,3,2839,340,20,958,2,4,5,8,8,0,8,0,8,0,False,False,False,0,2,2020-09-28T12:11:08.237,8,,0.0
2020,3,2839,345,20,6388,2,2,9,6,7,1,7,0,7,0,False,False,False,0,2,2020-09-28T12:12:28.86,7,,0.0
2020,3,2839,350,20,7353,13,2,4,8,0,0,0,0,0,0,False,False,False,0,3,2020-09-29T02:52:36.967,0,,0.0
2020,3,2839,355,20,5140,2,5,10,3,4,1,3,1,3,0,False,False,False,0,1,2020-09-28T12:15:06.9,4,,1.0
2020,3,2839,365,20,6388,2,38,10,4,7,3,5,2,5,0,False,False,False,0,3,2020-09-28T12:17:22.68,7,,2.0
2020,3,2839,370,20,5140,2,4,10,2,7,5,7,0,7,0,False,False,False,0,1,2020-09-28T12:18:48.77,7,,0.0
2020,3,2839,375,20,5140,2,4,9,3,12,9,3,9,3,0,True,False,False,1,1,2020-09-28T12:21:22.59,12,,9.0
2020,3,2839,385,20,5140,2,4,9,3,8,5,3,5,3,0,False,False,False,3,1,2020-10-01T14:43:10.41,8,,5.0
2020,3,2839,395,20,958,13,17,9,10,0,0,0,0,0,0,False,False,False,0,4,2020-09-28T14:42:51.99,0,,0.0
2020,3,2839,400,20,213,2,2,9,10,10,0,10,0,10,6,False,False,False,0,2,2020-09-28T12:30:26.97,10,,0.0
2020,3,2839,425,12,6357,13,8,2,36,0,0,0,0,0,0,False,False,False,0,3,2020-09-29T02:43:03.917,0,,0.0
2020,3,2839,430,12,6691,3,2,9,10,0,0,0,0,0,0,False,False,False,0,3,2021-02-19T14:40:56.24,0,,0.0
2020,3,2839,435,12,6691,2,8,8,43,72,29,69,3,69,0,False,False,False,0,3,2020-09-28T14:43:19.633,72,,3.0
2020,3,2839,440,12,4537,13,46,3,3,0,0,0,0,0,0,False,False,False,0,1,2020-09-28T12:43:35.05,0,,0.0
2020,3,2839,450,12,467,13,12,5,1,0,0,0,0,0,0,False,False,False,0,4,2021-03-08T19:23:20.01,0,,0.0
2020,3,2839,480,20,213,2,5,3,8,10,2,10,0,10,0,True,False,False,0,2,2020-09-28T12:54:40.413,10,,0.0
2020,3,2839,485,20,958,2,5,5,13,13,0,13,0,13,0,False,False,False,0,4,2020-09-28T13:04:56.82,13,,0.0
2020,3,2839,505,20,5140,2,45,5,-3,14,17,14,0,14,0,False,False,False,0,1,2020-09-28T13:02:57.083,14,,0.0
2020,3,2839,515,20,6388,13,6,9,8,0,0,0,0,0,0,False,False,False,0,3,2020-09-29T02:43:53.237,0,,0.0
2020,3,2839,520,20,5140,2,48,4,-5,6,11,2,4,2,0,False,False,False,0,1,2020-09-28T13:09:13.56,6,,4.0
2020,3,2839,540,12,4511,2,30,10,-1,16,17,14,2,14,0,True,False,False,0,4,2020-09-28T13:12:03.45,16,,2.0
2020,3,2839,545,12,6357,2,5,5,4,5,1,5,0,5,0,False,False,False,0,3,2020-10-01T14:09:15.383,5,,0.0
2020,3,2839,555,12,3965,13,11,6,20,0,0,0,0,0,0,True,False,False,0,3,2020-09-28T13:17:43.61,0,,
2020,3,2839,570,12,467,2,12,3,14,18,4,18,0,18,6,False,False,False,0,4,2020-09-29T02:45:37.783,18,,0.0
2020,3,2839,600,20,213,2,5,6,18,18,0,18,0,18,0,False,False,False,0,3,2020-09-29T02:46:27.853,18,,0.0
2020,3,2839,605,20,5140,2,44,3,-5,52,57,-5,57,-5,6,False,False,False,4,1,2020-10-01T14:44:24.667,52,,57.0
2020,3,2839,620,12,4511,2,30,3,2,14,12,12,2,12,0,True,False,False,0,4,2020-09-28T13:35:11.41,14,,2.0
2020,3,2839,630,12,3965,2,45,10,-8,5,13,2,3,2,0,True,False,False,0,3,2020-09-28T13:36:54.29,5,,3.0
2020,3,2839,650,20,306,2,4,4,2,7,5,5,2,5,0,False,False,False,0,1,2020-09-28T13:45:59.857,7,,2.0
2020,3,2839,660,12,6691,2,4,9,6,7,1,7,0,7,0,False,False,False,0,3,2020-09-28T13:56:28.287,7,,0.0
2020,3,2839,665,12,4561,2,47,10,0,3,3,2,1,2,0,True,False,False,0,1,2020-09-28T13:58:44.027,3,,1.0
2020,3,2839,670,12,6876,2,30,10,-2,12,14,11,1,11,0,True,False,False,0,4,2021-02-19T14:42:46.74,12,,1.0
2020,3,2839,685,12,6876,2,47,5,0,1,1,1,0,1,0,False,False,False,0,3,2020-10-01T14:25:44.07,1,,0.0
2020,3,2839,700,20,5140,2,4,10,2,3,1,3,0,3,0,False,False,False,0,1,2020-09-29T02:48:53.847,3,,0.0
2020,3,2839,705,20,7353,2,13,10,2,2,0,1,1,1,0,True,False,False,0,2,2020-09-28T14:09:18.027,2,,1.0
2020,3,2839,710,20,5140,2,51,9,-3,0,3,0,0,0,0,False,False,False,0,2,2020-09-28T14:10:42.807,0,,0.0
2020,3,2839,720,12,6876,2,11,6,20,23,3,23,0,23,0,False,False,False,0,4,2020-09-29T19:00:10.34,23,,0.0
2020,3,2839,740,12,6691,13,9,2,15,0,0,0,0,0,0,True,False,False,0,2,2020-09-28T14:19:05.127,0,,
2020,3,2839,750,12,6357,13,5,3,1,0,0,0,0,0,0,False,False,False,0,2,2021-03-03T13:08:51.49,0,,
2020,3,2839,760,12,4511,2,32,10,1,1,0,1,0,1,6,False,False,False,0,4,2020-10-01T13:26:45.263,1,,0.0
2020,3,2839,775,20,213,13,4,5,7,0,0,0,0,0,0,False,False,False,0,2,2020-09-28T14:26:39.557,0,,0.0
2020,3,2839,780,20,213,2,6,8,18,18,0,18,0,18,0,False,False,False,0,2,2020-09-29T02:49:35.333,18,,0.0
2020,3,2839,785,20,5140,2,5,9,0,3,3,2,1,2,0,False,False,False,0,1,2020-09-28T14:29:19.137,3,,1.0
2020,3,2839,790,20,7888,2,4,10,9,10,1,9,1,9,0,False,False,False,0,3,2020-09-28T14:30:38.453,10,,1.0
2020,3,2839,800,20,5140,3,48,10,-5,0,0,0,0,0,0,False,False,False,0,1,2021-02-19T14:45:34.27,0,,0.0
2020,3,2839,805,20,6388,2,4,9,7,9,2,9,0,9,0,False,False,False,0,3,2020-09-28T14:34:13.367,9,,0.0
2020,3,2839,810,20,6388,2,8,1,16,19,3,19,0,19,0,False,False,False,0,3,2020-09-28T14:35:47.487,19,,0.0
2020,3,2840,25,3,6936,3,4,9,13,0,0,0,0,0,0,False,False,False,0,2,2020-09-29T10:08:08.713,0,,0.0
2020,3,2840,45,3,7672,2,34,4,-4,7,11,7,0,7,0,True,False,False,0,3,2020-09-29T10:18:58.56,7,,0.0
2020,3,2840,55,3,2688,2,47,5,0,0,0,0,0,0,0,False,False,False,0,3,2020-10-01T18:07:15.56,0,,0.0
2020,3,2840,75,16,7681,13,13,10,2,0,0,0,0,0,0,False,False,False,0,2,2020-09-29T10:36:48.18,0,,
2020,3,2840,85,16,374,2,5,3,5,11,6,9,2,9,0,False,False,False,0,3,2020-09-29T10:46:46.003,11,,2.0
2020,3,2840,90,16,3938,2,3,2,16,33,17,16,17,16,0,False,False,False,1,2,2020-10-01T18:56:41.287,33,,17.0
2020,3,2840,95,16,7681,13,47,5,1,0,0,0,0,0,0,False,False,False,0,3,2020-09-29T10:54:35.163,0,,0.0
2020,3,2840,120,3,7672,2,50,3,0,0,0,0,0,0,0,False,False,False,0,2,2020-09-29T11:00:17.82,0,,0.0
2020,3,2840,125,3,6454,2,5,3,7,7,0,7,0,7,0,False,True,False,0,3,2020-09-29T11:01:37.31,5,,0.0
2020,3,2840,155,16,7681,2,48,9,-5,15,20,15,0,15,0,False,False,False,1,1,2020-09-29T11:18:39.16,15,,0.0
2020,3,2840,160,16,7210,13,47,5,-1,0,0,0,0,0,0,False,False,False,0,1,2020-09-29T11:19:57.793,0,,0.0
2020,3,2840,165,16,374,2,33,10,1,11,10,8,3,8,0,False,False,False,0,4,2020-09-29T11:23:18.303,11,,3.0
2020,3,2840,175,16,374,2,2,10,8,13,5,9,4,9,0,False,False,False,1,2,2020-09-29T11:27:41.78,13,,4.0
2020,3,2840,180,16,7210,13,48,10,-4,0,0,0,0,0,0,False,False,False,0,1,2020-09-29T11:32:05.727,0,,0.0
2020,3,2840,195,16,121,2,12,9,10,15,5,14,1,14,0,False,False,False,0,3,2020-10-01T19:32:07.183,15,,1.0
2020,3,2840,200,16,3938,2,5,3,2,2,0,2,0,2,0,False,False,False,0,1,2020-09-29T16:29:29.63,2,,0.0
2020,3,2840,210,16,2035,2,53,4,-3,5,8,5,0,5,6,False,False,False,0,4,2020-09-29T11:40:01.157,5,,0.0
2020,3,2840,240,16,7176,2,4,3,5,7,2,7,0,7,0,False,False,False,0,2,2020-09-29T11:53:59.1,7,,0.0
2020,3,2840,245,16,374,13,5,5,7,0,0,0,0,0,0,False,False,False,0,3,2020-09-29T11:56:07.88,0,,0.0
2020,3,2840,255,3,2688,2,5,5,3,4,1,4,0,4,0,False,False,False,0,3,2020-09-29T12:00:02.017,4,,0.0
2020,3,2840,260,3,6454,3,17,8,24,0,0,0,0,0,0,False,False,False,0,3,2020-09-29T12:02:10.513,0,,0.0
2020,3,2840,265,3,6936,3,13,4,3,0,0,0,0,0,0,False,False,False,0,3,2020-09-29T12:03:34.32,0,,0.0
2020,3,2840,275,16,374,2,35,10,14,29,15,18,11,18,0,False,False,False,1,4,2020-10-01T18:34:56.32,29,,11.0
2020,3,2840,280,16,121,2,4,9,2,5,3,5,0,5,0,False,False,False,0,3,2020-09-29T16:30:35.047,5,,0.0
2020,3,2840,290,16,7176,2,12,9,12,18,6,18,0,18,0,False,False,False,0,4,2020-10-01T19:32:18.333,18,,0.0
2020,3,2840,295,16,6499,2,48,10,-4,-4,0,-4,0,-4,0,False,False,False,1,1,2020-09-29T12:19:52.04,-4,,0.0
2020,3,2840,305,16,3938,2,7,2,20,20,0,20,0,20,6,False,False,False,0,3,2020-09-29T12:23:39.333,20,,0.0
2020,3,2840,325,3,2976,2,30,5,-1,-1,0,-1,0,-1,0,False,False,False,0,1,2020-09-29T12:28:52.44,-1,,
2020,3,2840,335,3,6454,13,2,10,11,0,0,0,0,0,0,False,False,False,0,3,2021-02-15T17:28:39.863,0,,0.0
2020,3,2840,340,3,6454,13,12,5,11,0,0,0,0,0,0,False,False,False,0,3,2020-09-29T12:39:21.503,0,,0.0
2020,3,2840,355,16,121,2,4,4,10,10,0,10,0,10,0,False,False,False,0,3,2020-09-29T16:30:55.417,10,,0.0
2020,3,2840,385,16,3938,13,7,2,35,0,0,0,0,0,0,False,False,False,0,3,2020-10-01T18:57:29.127,0,,0.0
2020,3,2840,390,16,7176,2,24,2,44,49,5,49,0,49,6,False,False,False,0,4,2020-10-01T18:57:57.997,49,,0.0
2020,3,2840,405,3,7671,2,16,4,3,6,3,6,0,6,0,False,False,False,0,1,2020-10-01T19:32:27.933,6,,0.0
2020,3,2840,410,3,6454,2,6,9,13,13,0,13,0,13,0,False,False,False,0,3,2020-09-29T13:04:18.083,13,,0.0
2020,3,2840,430,16,3938,2,13,10,2,9,7,9,0,9,0,False,False,False,0,3,2020-09-29T13:15:46.17,9,,0.0
2020,3,2840,440,16,121,2,6,9,5,5,0,5,0,5,0,False,False,False,0,2,2020-09-29T16:31:50.053,5,,0.0
2020,3,2840,450,16,7176,3,8,1,30,0,0,0,0,0,0,False,False,False,0,3,2020-10-01T20:08:01.943,0,,0.0
2020,3,2840,455,16,121,2,12,10,7,7,0,7,0,7,0,True,False,False,0,2,2021-03-08T19:27:34.843,7,,0.0
2020,3,2840,470,3,7672,13,52,10,2,0,0,0,0,0,0,False,False,False,0,2,2020-09-29T13:29:18.6,0,,0.0
2020,3,2840,475,3,6454,3,4,10,7,0,0,0,0,0,0,False,False,False,0,3,2020-09-29T13:31:30.373,0,,0.0
2020,3,2840,490,16,7681,2,7,3,14,24,10,24,0,24,0,False,False,False,0,1,2020-09-29T13:34:06.197,24,,0.0
2020,3,2840,500,16,7681,2,44,3,-2,7,9,7,0,7,0,True,False,False,1,2,2020-10-01T18:35:16.16,7,,0.0
2020,3,2840,510,3,902,13,48,9,-5,0,0,0,0,0,0,False,False,False,0,1,2020-09-29T16:36:17.383,0,,0.0
2020,3,2840,530,3,6936,2,39,4,7,7,0,7,0,7,0,True,False,False,0,3,2020-09-29T14:05:09.527,7,,0.0
2020,3,2840,535,3,6936,13,19,6,33,0,0,0,0,0,0,False,False,False,0,2,2020-09-29T14:06:27.137,0,,0.0
2020,3,2840,565,3,6454,3,21,2,26,0,0,0,0,0,0,False,False,False,0,3,2020-09-29T14:14:54.06,0,,0.0
2020,3,2840,570,3,7671,2,2,9,2,7,5,5,2,5,0,True,False,False,0,2,2020-10-01T19:32:48.083,7,,2.0
2020,3,2840,590,16,374,2,4,9,5,6,1,6,0,6,0,False,False,False,0,3,2020-09-29T14:20:19.19,6,,0.0
2020,3,2840,595,16,121,2,6,10,9,9,0,9,0,9,0,False,False,False,0,3,2020-09-29T16:32:14.097,9,,0.0
2020,3,2840,605,16,7176,2,4,5,4,7,3,7,0,7,0,False,False,False,0,2,2020-09-29T14:25:47.32,7,,0.0
2020,3,2840,620,3,6935,2,12,5,8,8,0,8,0,8,0,False,False,False,0,3,2021-03-08T19:29:22.29,8,,0.0
2020,3,2840,650,3,2976,2,6,9,5,5,0,5,0,5,6,False,False,False,0,4,2020-10-01T19:08:50.977,5,,0.0
2020,3,2840,665,16,7681,2,4,3,1,6,5,5,1,5,0,True,False,False,0,2,2020-09-30T18:39:05.54,6,,1.0
2020,3,2840,675,16,7681,2,44,3,0,18,18,16,2,16,0,False,False,False,0,1,2021-02-25T15:36:53.553,18,,2.0
2020,3,2840,685,16,3938,2,2,4,12,13,1,13,0,13,0,False,False,False,0,3,2020-10-01T16:51:58.003,13,,0.0
2020,3,2840,690,16,121,13,2,10,4,0,0,0,0,0,0,False,False,False,0,3,2020-09-29T15:09:17.77,0,,0.0
2020,3,2840,695,16,7176,13,9,6,26,0,0,0,0,0,0,False,False,False,0,2,2020-09-29T15:10:44.473,0,,0.0
2020,3,2840,725,16,121,2,12,3,8,11,3,11,0,11,0,True,False,False,0,2,2020-09-29T16:32:32.687,11,,0.0
2020,3,2840,730,16,1173,2,32,3,1,2,1,2,0,2,6,False,False,False,0,4,2020-09-29T15:32:47.357,2,,0.0
2020,3,2840,745,3,902,13,16,4,6,0,0,0,0,0,0,False,False,False,0,1,2020-09-29T15:36:14.63,0,,
2020,3,2840,750,3,7671,2,12,10,13,19,6,16,3,16,0,False,False,False,0,2,2020-09-29T15:37:44.86,19,,3.0
2020,3,2840,755,3,6936,13,19,2,21,0,0,0,0,0,0,False,False,False,0,2,2020-09-29T15:39:02.54,0,,0.0
2020,3,2840,765,3,7671,2,2,10,1,6,5,6,0,6,0,True,False,False,0,2,2020-09-29T15:42:51.077,6,,0.0
2020,3,2840,770,3,6936,2,2,10,5,6,1,5,1,5,0,False,False,False,0,2,2020-09-29T15:48:01.26,6,,1.0
2020,3,2840,775,3,6454,2,6,10,4,4,0,4,0,4,0,False,False,False,0,3,2020-09-29T15:49:06,4,,0.0
2020,3,2840,790,3,6935,13,19,6,31,0,0,0,0,0,0,False,False,False,0,2,2020-09-29T15:57:45.263,0,,0.0
2020,3,2840,815,16,374,2,4,10,5,17,12,17,0,17,0,False,False,False,1,3,2020-09-29T16:05:25.877,17,,0.0
2020,3,2840,835,16,6499,2,46,3,-3,5,8,0,5,0,0,False,False,False,0,1,2020-09-29T16:12:18.5,5,,5.0
2020,3,2840,865,16,7182,13,11,5,9,0,0,0,0,0,0,True,False,False,0,4,2020-09-29T16:16:25.85,0,,0.0
2020,4,2841,15,22,1361,2,4,10,10,10,0,10,0,10,0,False,False,False,0,2,2020-10-02T12:05:41.11,10,,
2020,4,2841,25,22,3170,13,2,4,10,0,0,0,0,0,0,False,False,False,0,3,2020-10-02T12:08:28.847,0,,
2020,4,2841,30,22,1113,2,16,4,2,6,4,5,1,5,0,False,False,False,0,1,2020-10-02T12:10:58.22,6,,
2020,4,2841,40,22,6270,13,35,8,16,0,0,0,0,0,0,False,False,False,0,3,2020-10-02T12:13:24.503,0,,
2020,4,2841,80,10,282,2,44,3,-1,1,2,0,1,0,0,False,False,False,0,1,2020-10-02T12:24:18.57,1,,
2020,4,2841,85,10,7701,13,4,3,8,0,0,0,0,0,0,False,False,False,0,2,2020-10-02T12:26:18.383,0,,
2020,4,2841,90,10,6285,13,7,2,19,0,0,0,0,0,0,True,False,False,0,4,2020-10-02T12:28:02.78,0,,
2020,4,2841,100,10,4930,2,7,6,20,21,1,20,1,20,0,False,False,False,0,3,2020-10-02T17:18:29.423,21,,
2020,4,2841,110,10,6840,2,53,10,-5,6,11,-4,10,-4,0,False,False,False,1,4,2020-10-08T18:34:07.593,6,,
2020,4,2841,120,10,6282,2,50,5,-1,-2,-1,-2,0,-2,0,False,False,False,0,2,2020-10-02T12:36:50.61,-2,,
2020,4,2841,140,22,2391,2,47,5,2,3,1,3,0,3,0,False,False,False,0,4,2020-10-02T12:39:27.943,3,,
2020,4,2841,145,22,3170,2,5,3,9,9,0,9,0,9,0,False,False,False,0,3,2020-10-02T17:17:51.423,9,,
2020,4,2841,150,22,1361,2,5,3,5,5,0,5,0,5,0,False,False,False,0,3,2020-10-02T12:42:27.567,5,,
2020,4,2841,155,22,7118,2,35,3,14,18,4,16,2,16,0,False,False,False,0,3,2020-10-02T12:43:51.447,18,,
2020,4,2841,180,22,7118,2,52,4,3,11,8,10,1,10,0,False,False,False,0,2,2020-10-02T12:52:30.887,11,,
2020,4,2841,200,10,3848,2,38,4,5,7,2,7,0,7,0,False,False,False,0,4,2020-10-02T13:01:06.22,7,,
2020,4,2841,205,10,4930,13,7,6,21,0,0,0,0,0,0,False,False,False,0,3,2020-10-02T13:02:52.96,0,,
2020,4,2841,210,10,7700,2,19,2,41,48,7,41,7,41,6,False,False,False,0,2,2020-10-02T13:07:10.37,48,,
2020,4,2841,230,22,7118,2,4,3,5,5,0,5,0,5,0,False,False,False,0,2,2020-10-03T14:56:52.46,5,,
2020,4,2841,249,10,6285,13,12,5,13,0,0,0,0,0,0,False,False,False,0,2,2021-02-01T14:35:47.497,0,,
2020,4,2841,255,22,2391,2,46,3,0,3,3,2,1,2,0,False,False,False,0,4,2020-10-02T13:19:22.73,3,,
2020,4,2841,270,22,7118,2,12,2,20,21,1,21,0,21,0,False,False,False,0,2,2021-03-08T18:45:00.993,21,,
2020,4,2841,275,22,7950,13,19,2,31,0,0,0,0,0,0,False,False,False,0,3,2020-10-02T13:23:59.613,0,,
2020,4,2841,285,22,7950,13,29,6,18,0,0,0,0,0,0,False,False,False,0,2,2020-10-02T13:26:15.77,0,,
2020,4,2841,310,22,1361,13,12,3,8,0,0,0,0,0,0,False,False,False,0,3,2020-10-02T13:35:04.03,0,,
2020,4,2841,335,10,4930,2,19,2,33,40,7,36,4,36,0,False,False,False,0,2,2020-10-02T13:38:58.363,40,,
2020,4,2841,350,10,6840,2,47,5,4,11,7,9,2,9,0,False,False,False,0,4,2020-10-02T13:43:16.137,11,,
2020,4,2841,355,10,6285,2,4,5,8,9,1,8,1,8,0,False,False,False,0,2,2020-10-02T13:44:26.35,9,,
2020,4,2841,395,22,6262,13,39,4,6,0,0,0,0,0,0,False,False,False,0,4,2020-10-02T13:55:43.277,0,,
2020,4,2841,400,22,3170,2,6,7,15,27,12,25,2,25,0,False,False,False,0,3,2020-10-02T13:57:13.07,27,,
2020,4,2841,405,22,7118,13,21,6,29,0,0,0,0,0,0,False,False,False,0,2,2020-10-02T13:58:11.803,0,,
2020,4,2841,410,22,6277,2,46,3,2,4,2,4,0,4,0,False,False,False,0,1,2020-10-02T13:59:15.63,4,,
2020,4,2841,415,22,3170,2,5,5,11,10,-1,10,0,10,0,False,False,False,0,3,2020-10-02T14:00:36.493,10,,
2020,4,2841,420,22,1361,2,4,10,3,3,0,3,0,3,0,False,False,False,0,3,2020-10-02T14:01:47.223,3,,
2020,4,2841,425,22,6262,2,46,3,2,11,9,11,0,11,0,False,False,False,0,4,2020-10-02T14:03:03.43,11,,
2020,4,2841,435,22,6277,13,11,6,18,0,0,0,0,0,0,False,False,False,0,1,2020-10-02T14:05:34.19,0,,
2020,4,2841,440,22,1361,13,21,2,20,0,0,0,0,0,0,False,False,False,0,2,2020-10-02T14:06:38.86,0,,
2020,4,2841,450,22,1361,13,29,6,17,0,0,0,0,0,0,False,False,False,0,2,2020-10-02T14:08:42.007,0,,
2020,4,2841,485,10,6840,2,5,5,3,3,0,3,0,3,0,False,False,False,0,4,2020-10-02T14:49:49.85,3,,
2020,4,2841,490,10,4930,13,13,10,1,0,0,0,0,0,0,False,False,False,0,2,2020-10-02T14:30:16.24,0,,
2020,4,2841,510,22,7118,13,19,6,44,0,0,0,0,0,0,False,False,False,0,2,2020-10-02T14:38:49.103,0,,
2020,4,2841,525,22,1113,13,11,5,14,0,0,0,0,0,0,False,False,False,0,1,2020-10-02T14:43:11.513,0,,
2020,4,2841,540,10,6840,13,39,4,6,0,0,0,0,0,0,False,False,False,0,4,2020-10-02T14:49:37.027,0,,
2020,4,2841,555,10,6282,2,4,9,4,8,4,7,1,7,0,False,False,False,0,1,2020-10-02T14:53:09.477,8,,
2020,4,2841,570,10,6840,2,31,10,2,6,4,5,1,5,0,False,False,False,0,3,2020-10-02T14:56:05.683,6,,
2020,4,2841,575,10,7700,2,6,10,13,13,0,13,0,13,0,False,False,False,0,3,2020-10-02T14:57:23.01,13,,
2020,4,2841,585,10,7700,13,46,3,2,0,0,0,0,0,0,False,False,False,0,3,2021-02-16T19:50:19.607,0,,
2020,4,2841,590,10,6840,2,13,9,5,9,4,8,1,8,0,False,False,False,0,4,2020-10-02T15:03:01.387,9,,
2020,4,2841,605,10,4930,2,17,10,7,7,0,7,0,7,6,False,False,False,0,3,2020-10-02T15:06:58.94,7,,
2020,4,2841,620,22,6270,13,47,5,1,0,0,0,0,0,0,False,False,False,0,3,2020-10-02T15:13:29.54,0,,
2020,4,2841,630,22,3170,2,4,10,5,9,4,8,1,8,0,False,False,False,0,3,2020-10-02T15:16:18.093,9,,
2020,4,2841,635,22,7118,2,4,10,4,8,4,7,1,7,0,False,False,False,0,3,2020-10-02T15:17:21.38,8,,
2020,4,2841,650,22,6270,13,4,9,9,0,0,0,0,0,0,False,False,False,0,3,2020-10-02T15:20:26.787,0,,
2020,4,2841,680,10,4930,2,13,9,3,7,4,5,2,5,0,False,False,False,0,3,2020-10-02T15:27:37.547,7,,
2020,4,2841,695,22,3170,2,35,6,30,35,5,30,5,30,0,False,False,False,0,2,2020-10-02T15:46:07.823,35,,
2020,4,2841,705,22,7118,2,4,10,7,7,0,7,0,7,0,False,False,False,0,2,2020-10-02T15:48:10.987,7,,
2020,4,2841,715,22,3170,13,12,6,17,0,0,0,0,0,0,False,False,False,0,3,2021-03-10T21:07:01.26,0,,
2020,4,2841,735,10,5105,13,4,9,7,0,0,0,0,0,0,False,False,False,0,3,2020-10-02T16:00:14.873,0,,
2020,4,2841,745,10,7700,13,5,5,10,0,0,0,0,0,0,False,False,False,0,3,2021-03-05T15:30:58.533,0,,
2020,4,2841,765,10,282,2,47,10,1,10,9,9,1,9,0,False,False,False,0,1,2020-10-02T16:05:31.593,10,,
2020,4,2841,775,10,3848,13,35,5,7,0,0,0,0,0,0,False,False,False,0,4,2021-03-05T15:33:31.047,0,,
2020,4,2841,780,22,1361,2,5,3,5,5,0,5,0,5,0,False,False,False,0,3,2020-10-02T16:09:02.14,5,,
2020,4,2841,785,22,7118,2,4,10,9,11,2,9,2,9,0,False,False,False,0,2,2020-10-02T16:10:45.657,11,,
2020,4,2841,795,22,2391,2,51,9,0,4,4,2,2,2,0,False,False,False,0,3,2020-10-02T16:14:56.35,4,,
2020,4,2841,800,22,3170,2,13,9,3,4,1,3,1,3,0,False,False,False,0,2,2020-10-02T16:16:59.43,4,,
2020,4,2841,820,10,4930,2,4,9,5,7,2,7,0,7,0,False,False,False,0,3,2020-10-02T16:24:14.487,7,,
2020,4,2841,835,10,6285,13,19,6,47,0,0,0,0,0,0,False,False,False,0,2,2020-10-02T16:28:24.193,0,,
2020,4,2841,840,10,4930,2,29,6,28,31,3,31,0,31,0,False,False,False,0,2,2020-10-02T16:29:52.843,31,,
2020,4,2841,850,10,282,3,16,9,6,0,0,0,0,0,0,False,False,False,0,1,2020-10-02T17:17:21.187,0,,
2020,4,2841,875,22,1361,13,2,10,7,0,0,0,0,0,0,False,False,False,0,2,2020-10-02T16:44:23.68,0,,
2020,4,2841,880,22,3170,2,2,10,6,10,4,8,2,8,0,False,False,False,0,3,2020-10-02T16:45:59.937,10,,
2020,4,2841,885,22,6262,3,4,4,7,0,0,0,0,0,0,False,False,False,0,1,2020-10-02T16:47:12.33,0,,
2020,4,2841,890,22,6277,2,46,3,3,7,4,7,0,7,0,False,False,False,0,1,2020-10-02T16:48:27.737,7,,
2020,4,2841,895,22,7118,13,5,5,9,0,0,0,0,0,0,False,False,False,0,2,2020-10-08T18:45:59.15,0,,
2020,4,2841,940,22,3170,13,4,9,5,0,0,0,0,0,0,False,False,False,0,3,2020-10-02T16:58:53.627,0,,
2020,4,2842,20,1,525,13,6,8,16,0,0,0,0,0,0,False,False,False,0,3,2020-10-06T19:57:29.807,0,,
2020,4,2842,25,1,7315,2,34,4,-5,2,7,0,2,0,0,True,False,False,0,3,2021-02-15T15:26:49.243,2,,
2020,4,2842,30,1,6405,13,8,6,28,0,0,0,0,0,0,False,False,False,0,3,2021-02-15T19:51:13.353,0,,
2020,4,2842,40,5,5220,3,2,9,7,0,0,0,0,0,0,False,False,False,0,2,2020-10-05T10:36:15.83,0,,
2020,4,2842,50,5,3477,2,5,3,14,14,0,14,0,14,0,False,False,False,0,3,2021-02-15T19:55:41.997,14,,
2020,4,2842,55,5,5220,13,19,6,35,0,0,0,0,0,0,False,False,False,0,2,2021-02-15T15:45:14.163,0,,
2020,4,2842,60,5,3477,2,13,9,3,3,0,3,0,3,0,False,False,False,0,2,2020-10-05T10:48:19.01,3,,
2020,4,2842,65,5,2554,2,48,3,-5,3,8,3,0,3,0,False,False,False,0,1,2020-10-05T10:50:51.223,3,,
2020,4,2842,75,5,3750,2,38,3,3,17,14,6,11,6,0,True,False,False,1,3,2021-02-15T15:51:25.41,17,,
2020,4,2842,90,5,3477,13,35,2,35,0,0,0,0,0,0,False,False,False,0,3,2021-02-15T16:01:07.35,0,,
2020,4,2842,95,5,5220,2,13,9,4,12,8,7,5,7,0,False,False,False,0,3,2020-10-05T11:08:46.46,12,,
2020,4,2842,105,5,3477,3,47,5,0,0,0,0,0,0,0,False,False,False,0,1,2020-10-05T11:14:08.17,0,,
2020,4,2842,140,1,7315,3,19,6,29,0,0,0,0,0,0,True,False,False,0,3,2020-10-06T19:57:56.917,0,,
2020,4,2842,155,5,5220,2,5,6,19,23,4,21,2,21,0,False,False,False,0,3,2021-02-15T16:28:17.61,23,,
2020,4,2842,160,5,3477,2,51,3,-4,24,28,15,9,15,0,True,False,False,0,3,2021-02-15T16:31:28.77,24,,
2020,4,2842,170,5,5220,2,4,9,5,6,1,6,0,6,0,False,False,False,0,3,2020-10-05T11:50:24.437,6,,
2020,4,2842,180,5,6425,13,6,4,10,0,0,0,0,0,0,False,False,False,0,3,2021-02-15T16:36:19.537,0,,
2020,4,2842,210,1,245,2,5,3,5,7,2,7,0,7,0,False,False,False,0,2,2020-10-05T12:05:53.46,7,,
2020,4,2842,215,1,245,2,50,3,-2,-3,-1,-3,0,-3,0,False,False,False,0,2,2020-10-05T12:08:02.303,-3,,
2020,4,2842,220,1,6405,13,4,10,10,0,0,0,0,0,0,False,False,False,0,2,2020-10-05T12:11:00.733,0,,
2020,4,2842,245,5,4803,3,13,9,3,0,0,0,0,0,0,False,False,False,0,3,2020-10-08T13:26:46.857,0,,
2020,4,2842,255,5,6425,13,7,2,24,0,0,0,0,0,0,False,False,False,0,3,2021-03-05T15:38:52.97,0,,
2020,4,2842,265,1,5152,2,4,10,5,8,3,6,2,6,0,False,False,False,0,3,2020-10-08T13:27:11.373,8,,
2020,4,2842,270,1,245,2,50,3,-2,3,5,2,1,2,0,False,False,False,0,2,2021-02-15T14:36:45.22,3,,
2020,4,2842,275,1,6405,2,5,5,5,8,3,6,2,6,0,False,False,False,0,3,2020-10-05T12:39:16.957,8,,
2020,4,2842,290,1,6406,2,47,5,-2,7,9,1,6,1,0,False,False,False,1,1,2020-10-05T12:46:14.29,7,,
2020,4,2842,315,1,6531,2,6,9,3,3,0,3,0,3,6,True,False,False,0,4,2020-10-08T13:27:41.547,3,,
2020,4,2842,330,5,4803,2,30,5,0,11,11,5,6,5,0,True,False,False,1,4,2021-03-03T15:59:15.067,11,,
2020,4,2842,335,5,2847,2,4,10,9,10,1,10,0,10,0,False,False,False,0,3,2020-10-05T13:04:06.643,10,,
2020,4,2842,340,5,2554,2,48,4,-7,-1,6,-4,3,-4,0,False,False,False,1,1,2020-10-05T13:06:50.65,-1,,
2020,4,2842,345,5,3477,2,6,10,5,16,11,15,1,15,0,False,False,False,1,2,2021-02-15T17:20:43.307,16,,
2020,4,2842,355,5,3477,2,2,9,7,17,10,16,1,16,0,False,False,False,0,3,2020-10-05T13:15:00.303,17,,
2020,4,2842,380,5,6573,2,47,5,3,3,0,3,0,3,6,False,False,False,0,1,2020-10-05T13:25:05.097,3,,
2020,4,2842,395,1,245,2,18,3,0,2,2,2,0,2,0,False,False,False,0,2,2020-10-05T13:30:30.753,2,,
2020,4,2842,400,1,525,2,4,4,4,6,2,4,2,4,0,False,False,False,0,3,2020-10-05T13:33:26.363,6,,
2020,4,2842,410,1,6406,2,4,4,3,8,5,5,3,5,0,False,False,False,0,1,2020-10-05T17:35:57.8,8,,
2020,4,2842,415,1,6406,2,48,9,-5,-5,0,-5,0,-5,0,False,False,False,0,1,2020-10-05T13:39:53.247,-5,,
2020,4,2842,425,1,245,2,4,3,7,8,1,8,0,8,0,False,False,False,0,2,2020-10-05T13:42:07.18,8,,
2020,4,2842,435,1,245,13,9,6,37,0,0,0,0,0,0,False,False,False,0,2,2020-10-05T13:48:04.487,0,,
2020,4,2842,460,5,2554,2,47,5,1,20,19,20,0,20,0,False,False,False,0,1,2021-02-15T14:44:50.433,20,,
2020,4,2842,470,5,6425,13,6,4,11,0,0,0,0,0,0,False,False,False,0,3,2020-10-05T14:03:51.65,0,,
2020,4,2842,480,5,5220,13,4,10,11,0,0,0,0,0,0,False,False,False,0,3,2020-10-05T14:07:59.583,0,,
2020,4,2842,490,1,5152,2,12,10,5,9,4,8,1,8,0,False,False,False,0,4,2021-03-08T18:50:51.707,9,,
2020,4,2842,495,1,525,2,44,3,-2,-2,0,-2,0,-2,0,False,False,False,0,3,2020-10-05T14:14:16.133,-2,,
2020,4,2842,500,1,245,2,6,4,11,11,0,11,0,11,0,False,False,False,0,3,2020-10-05T14:17:09.67,11,,
2020,4,2842,510,1,5152,2,35,1,19,25,6,25,0,25,0,True,False,False,0,3,2021-02-15T14:50:00.107,25,,
2020,4,2842,535,5,3477,13,19,2,30,0,0,0,0,0,0,False,False,False,0,3,2020-10-06T21:13:13.29,0,,
2020,4,2842,540,5,4803,2,5,2,15,24,9,24,0,24,0,True,False,False,0,3,2021-02-15T19:54:12.11,24,,
2020,4,2842,555,5,3477,2,35,9,13,20,7,20,0,20,0,True,False,False,0,4,2021-02-15T14:57:44.677,20,,
2020,4,2842,560,5,2554,2,51,10,-7,-3,4,-5,2,-5,0,False,False,False,2,1,2021-03-03T15:59:53.813,-3,,
2020,4,2842,565,5,3750,13,33,10,13,0,0,0,0,0,0,False,False,False,0,4,2020-10-05T14:52:55.447,0,,
2020,4,2842,570,5,6425,2,47,5,2,2,0,2,0,2,6,False,False,False,0,3,2020-10-05T14:55:27.583,2,,
2020,4,2842,600,1,5152,2,51,10,-3,-3,0,-3,0,-3,0,False,False,False,0,4,2020-10-08T13:28:27.677,-3,,
2020,4,2842,605,1,245,2,4,9,5,13,8,11,2,11,0,False,False,False,2,2,2020-10-08T13:25:38.03,13,,
2020,4,2842,615,1,6405,2,5,5,3,3,0,3,0,3,6,True,False,False,0,2,2020-10-05T15:13:36.243,3,,
2020,4,2842,650,5,4803,2,6,8,15,16,1,15,1,15,0,False,False,False,0,3,2020-10-05T15:43:40.573,16,,
2020,4,2842,660,5,2554,2,4,4,1,8,7,2,6,2,0,False,False,False,1,1,2021-02-15T18:49:36.477,8,,
2020,4,2842,670,5,6425,2,46,3,1,3,2,2,1,2,0,False,False,False,0,4,2020-10-05T15:54:09.653,3,,
2020,4,2842,675,5,3477,2,2,9,2,5,3,3,2,3,0,True,False,False,0,2,2020-10-05T15:56:27.2,5,,
2020,4,2842,690,5,5220,2,2,9,6,8,2,7,1,7,0,False,False,False,0,2,2020-10-05T16:03:26.76,8,,
2020,4,2842,710,5,2554,13,30,5,5,0,0,0,0,0,0,False,False,False,0,1,2021-02-25T14:23:15.17,0,,
2020,4,2842,725,1,7315,2,51,10,-4,1,5,-1,2,-1,0,False,False,False,0,3,2020-10-05T16:18:46.357,1,,
2020,4,2842,730,1,6406,3,4,10,3,0,0,0,0,0,0,False,False,False,0,1,2020-10-08T11:56:28.663,0,,
2020,4,2842,740,1,245,13,12,5,8,0,0,0,0,0,0,False,False,False,0,3,2021-03-08T18:51:23.427,0,,
2020,4,2842,750,5,4803,13,30,3,-3,0,0,0,0,0,0,True,False,False,0,4,2021-02-15T15:04:55.777,0,,
2020,4,2842,755,5,6573,2,48,10,-6,15,21,14,1,14,0,False,False,False,0,1,2020-10-05T16:30:50.133,15,,
2020,4,2842,790,5,3477,2,30,10,-2,0,2,0,0,0,0,True,False,False,0,4,2021-02-15T19:12:40.337,0,,
2020,4,2842,820,1,6406,2,4,10,11,12,1,12,0,12,0,False,False,False,0,3,2020-10-05T16:57:18.527,12,,
2020,4,2842,825,1,6405,2,4,5,7,8,1,8,0,8,0,False,False,False,0,2,2020-10-05T16:58:49.993,8,,
2020,4,2842,835,1,6405,13,9,5,5,0,0,0,0,0,0,False,False,False,0,2,2020-10-05T17:23:39.59,0,,
2020,4,2842,845,1,6406,2,47,5,2,2,0,2,0,2,6,True,False,False,0,1,2021-02-15T19:21:25.75,2,,
2020,4,2843,15,6,7725,2,4,5,8,8,0,8,0,8,0,True,False,False,0,2,2020-10-05T09:59:36.337,8,,
2020,4,2843,25,6,811,2,51,3,-4,0,4,-1,1,-1,0,True,False,False,0,3,2020-10-08T17:32:37.52,0,,
2020,4,2843,35,6,464,13,2,9,8,0,0,0,0,0,0,False,False,False,0,2,2020-10-05T15:28:57.873,0,,
2020,4,2843,50,14,1114,13,3,5,9,0,0,0,0,0,0,False,False,False,0,2,2020-10-05T10:15:13.493,0,,
2020,4,2843,60,14,4449,2,4,9,9,11,2,9,2,9,0,False,False,False,0,3,2020-10-05T10:21:33.437,11,,
2020,4,2843,65,14,895,3,26,3,3,0,0,0,0,0,0,False,False,False,0,2,2020-10-05T10:25:27.7,0,,
2020,4,2843,70,14,4449,2,22,6,26,36,10,35,1,35,0,False,False,False,0,2,2020-10-08T19:56:58.12,36,,
2020,4,2843,85,14,5197,2,13,9,3,13,10,11,2,11,6,False,False,False,0,3,2020-10-08T20:49:51.1,13,,
2020,4,2843,100,6,509,2,6,9,6,6,0,6,0,6,0,False,False,False,0,2,2021-02-17T21:22:01.867,6,,
2020,4,2843,105,6,464,2,2,10,4,5,1,4,1,4,0,False,False,False,0,3,2020-10-08T17:32:37.52,5,,
2020,4,2843,115,6,666,13,5,5,5,0,0,0,0,0,0,False,False,False,0,3,2020-10-08T19:49:59.813,0,,
2020,4,2843,125,6,7725,13,5,5,7,0,0,0,0,0,0,True,False,False,0,3,2021-02-17T21:18:39.553,0,,
2020,4,2843,140,14,6545,13,8,6,15,0,0,0,0,0,0,False,False,False,0,2,2020-10-08T17:32:37.52,0,,
2020,4,2843,145,14,895,13,13,5,4,0,0,0,0,0,0,False,False,False,0,3,2020-10-05T10:59:17.167,0,,
2020,4,2843,155,6,2071,13,7,2,18,0,0,0,0,0,0,False,False,False,0,4,2021-02-17T14:29:30.463,0,,
2020,4,2843,160,6,2071,2,32,10,0,6,6,3,3,3,0,False,False,False,0,4,2020-10-05T11:06:14.077,6,,
2020,4,2843,175,6,6786,13,44,9,-4,0,0,0,0,0,0,False,False,False,0,1,2020-10-05T15:29:58.21,0,,
2020,4,2843,185,6,7725,13,5,3,5,0,0,0,0,0,0,False,False,False,0,3,2020-10-05T15:30:12.53,0,,
2020,4,2843,200,14,6543,2,5,5,6,15,9,5,10,5,0,False,False,False,2,3,2020-10-08T19:50:46.067,15,,
2020,4,2843,205,14,895,13,35,3,14,0,0,0,0,0,0,False,False,False,0,4,2020-10-05T11:23:09.057,0,,
2020,4,2843,220,14,7582,2,32,9,2,11,9,5,6,5,0,False,False,False,1,1,2020-10-05T11:34:08.05,11,,
2020,4,2843,235,6,7725,2,19,6,29,33,4,30,3,30,0,False,False,False,0,2,2020-10-06T20:37:56.687,33,,
2020,4,2843,245,6,464,2,8,8,24,27,3,27,0,27,0,False,False,False,0,2,2020-10-06T20:34:42.003,27,,
2020,4,2843,250,6,6328,2,51,3,-4,0,4,-1,1,-1,0,True,False,False,0,1,2020-10-05T11:47:29.987,0,,
2020,4,2843,255,6,6786,2,44,3,0,17,17,5,12,5,0,False,False,False,1,1,2021-02-17T21:22:01.867,17,,
2020,4,2843,260,6,6786,2,4,4,2,5,3,4,1,4,0,False,False,False,0,1,2020-10-05T11:52:02.997,5,,
2020,4,2843,275,6,2071,13,6,9,5,0,0,0,0,0,0,False,False,False,0,2,2020-10-05T15:30:35.49,0,,
2020,4,2843,300,14,1114,2,7,3,12,13,1,11,2,11,0,False,False,False,0,3,2020-10-08T18:15:40.073,13,,
2020,4,2843,330,14,4449,13,21,3,13,0,0,0,0,0,0,False,False,False,0,2,2020-10-08T18:15:40.073,0,,
2020,4,2843,335,14,1119,2,4,4,10,12,2,11,1,11,0,False,False,False,0,3,2020-10-08T18:15:40.073,12,,
2020,4,2843,345,14,5197,13,7,3,3,0,0,0,0,0,0,False,False,False,0,4,2021-02-17T14:37:40.043,0,,
2020,4,2843,350,14,4449,13,2,4,3,0,0,0,0,0,0,False,False,False,0,3,2020-10-05T12:25:32.677,0,,
2020,4,2843,375,6,811,3,17,7,35,0,0,0,0,0,0,False,False,False,0,2,2021-02-17T21:22:01.867,0,,
2020,4,2843,400,14,4449,2,4,4,11,11,0,11,0,11,0,False,False,False,0,3,2020-10-08T18:15:40.073,11,,
2020,4,2843,405,14,895,2,47,5,2,8,6,8,0,8,0,False,False,False,0,4,2020-10-08T18:15:40.073,8,,
2020,4,2843,415,14,1114,13,21,2,37,0,0,0,0,0,0,False,False,False,0,2,2020-10-08T18:15:40.073,0,,
2020,4,2843,430,14,1114,2,45,5,-3,3,6,2,1,2,0,True,False,False,0,3,2021-02-17T14:38:50.753,3,,
2020,4,2843,495,6,7725,13,8,8,40,0,0,0,0,0,0,False,False,False,0,2,2020-10-05T15:31:07.077,0,,
2020,4,2843,500,6,509,2,49,5,-1,5,6,4,1,4,0,False,False,False,0,2,2020-10-05T13:13:21.78,5,,
2020,4,2843,510,14,4449,13,9,6,24,0,0,0,0,0,0,False,False,False,0,3,2020-10-05T13:16:31.65,0,,
2020,4,2843,520,14,1114,13,5,5,10,0,0,0,0,0,0,False,False,False,0,2,2020-10-08T18:15:40.073,0,,
2020,4,2843,535,6,666,2,32,5,3,11,8,9,2,9,0,False,False,False,1,4,2020-10-08T20:14:06.807,11,,
2020,4,2843,540,6,464,13,2,10,8,0,0,0,0,0,0,False,False,False,0,3,2020-10-08T19:50:22.27,0,,
2020,4,2843,545,6,7725,2,4,9,3,3,0,3,0,3,0,False,False,False,2,3,2020-10-08T20:14:21.407,3,,
2020,4,2843,550,6,6328,2,6,4,11,12,1,12,0,12,0,True,False,False,0,3,2021-02-17T21:22:01.867,12,,
2020,4,2843,560,6,6328,2,6,9,4,4,0,4,0,4,0,False,False,False,0,3,2020-10-08T18:15:40.073,4,,
2020,4,2843,565,6,7725,13,5,2,21,0,0,0,0,0,0,False,False,False,0,3,2020-10-05T15:44:18.203,0,,
2020,4,2843,575,14,6543,2,48,9,-6,-6,0,-6,0,-6,0,False,False,False,0,1,2020-10-05T13:41:57.36,-6,,
2020,4,2843,580,14,1114,2,4,10,12,13,1,12,1,12,0,False,False,False,0,2,2020-10-05T13:43:41.84,13,,
2020,4,2843,585,14,4070,2,7,7,24,27,3,25,2,25,0,False,False,False,0,3,2020-10-05T13:45:46.667,27,,
2020,4,2843,600,14,6546,2,11,3,2,16,14,8,8,8,0,True,False,False,0,1,2020-10-08T18:15:40.073,16,,
2020,4,2843,610,14,6543,2,51,5,-5,-1,4,-2,1,-2,0,False,False,False,0,1,2020-10-08T18:15:40.073,-1,,
2020,4,2843,615,14,4449,13,2,9,6,0,0,0,0,0,0,False,False,False,0,2,2020-10-05T13:57:34.56,0,,
2020,4,2843,630,6,666,2,5,10,4,5,1,4,1,4,0,False,False,False,0,3,2020-10-08T18:15:40.073,5,,
2020,4,2843,635,6,7725,2,5,5,4,4,0,4,0,4,0,False,False,False,0,3,2020-10-05T14:04:18.44,4,,
2020,4,2843,655,14,1114,13,35,10,13,0,0,0,0,0,0,False,False,False,0,3,2020-10-08T18:15:40.073,0,,
2020,4,2843,665,14,4449,13,6,8,17,0,0,0,0,0,0,False,False,False,0,2,2020-10-05T14:17:57.16,0,,
2020,4,2843,675,6,6786,2,4,9,2,8,6,5,3,5,0,False,False,False,0,1,2020-10-05T14:20:16.627,8,,
2020,4,2843,680,6,6786,13,4,9,2,0,0,0,0,0,0,False,False,False,0,1,2020-10-05T15:32:16.72,0,,
2020,4,2843,685,6,6328,13,6,4,11,0,0,0,0,0,0,False,False,False,0,3,2020-10-05T15:32:32.94,0,,
2020,4,2843,690,6,6786,13,19,6,39,0,0,0,0,0,0,False,False,False,0,2,2020-10-05T15:32:44.74,0,,
2020,4,2843,695,6,6786,13,48,9,-6,0,0,0,0,0,0,False,False,False,0,1,2020-10-05T15:32:57.067,0,,
2020,4,2843,715,6,7728,13,4,4,11,0,0,0,0,0,0,False,False,False,0,3,2020-10-08T18:15:40.073,0,,
2020,4,2843,720,6,464,13,21,6,26,0,0,0,0,0,0,False,False,False,0,2,2021-02-17T21:22:01.867,0,,
2020,4,2843,725,6,6328,13,6,1,19,0,0,0,0,0,0,False,False,False,0,3,2021-03-09T19:30:58.343,0,,
2020,4,2843,780,14,895,2,4,3,5,8,3,5,3,5,0,True,False,False,0,2,2021-03-05T21:35:57.94,8,,
2020,4,2843,815,6,464,2,4,9,3,4,1,4,0,4,0,False,False,False,0,2,2020-10-08T20:17:53.193,4,,
2020,4,2843,820,6,666,2,4,10,6,7,1,5,2,5,0,False,False,False,0,3,2020-10-05T15:06:50.713,7,,
2020,4,2843,825,6,464,2,29,6,24,25,1,24,1,24,0,False,False,False,0,2,2020-10-05T15:09:49.207,25,,
2020,4,2843,830,6,7725,2,4,10,3,4,1,3,1,3,0,False,False,False,0,2,2020-10-08T18:15:40.073,4,,
2020,4,2843,835,6,464,2,49,3,-2,2,4,2,0,2,0,False,False,False,0,2,2020-10-05T15:12:59.237,2,,
2020,4,2843,840,6,666,2,5,10,5,10,5,7,3,7,0,False,False,False,0,3,2020-10-06T20:35:09.467,10,,
2020,4,2843,850,6,464,2,8,1,18,22,4,22,0,22,0,False,False,False,1,3,2021-03-05T21:36:10.737,22,,
2020,4,2843,860,6,464,2,29,2,16,16,0,16,0,16,6,False,False,False,0,2,2020-10-05T15:19:12.253,16,,
2020,4,2844,20,15,6501,13,19,2,40,0,0,0,0,0,0,False,False,False,0,2,2020-10-09T15:53:05.72,0,,
2020,4,2844,30,15,922,13,39,9,2,0,0,0,0,0,0,False,False,False,0,3,2020-10-09T16:56:31.193,0,,
2020,4,2844,35,7,910,2,4,5,3,3,0,3,0,3,0,False,False,False,0,2,2020-10-05T10:26:29.037,3,,
2020,4,2844,45,7,910,13,12,2,32,0,0,0,0,0,0,False,False,False,0,2,2020-10-09T15:54:14.453,0,,
2020,4,2844,60,15,7591,13,4,5,7,0,0,0,0,0,0,False,False,False,0,2,2020-10-05T18:10:34.73,0,,
2020,4,2844,65,15,7591,2,6,8,16,22,6,19,3,19,0,False,False,False,0,2,2020-10-05T18:10:52.23,22,,
2020,4,2844,70,15,2757,13,5,3,13,0,0,0,0,0,0,True,False,False,0,3,2021-02-15T20:08:42.803,0,,
2020,4,2844,80,15,2407,2,2,10,6,7,1,6,1,6,0,False,False,False,0,2,2020-10-05T10:56:31.53,7,,
2020,4,2844,85,15,2407,2,4,10,4,4,0,4,0,4,0,False,False,False,0,3,2020-10-06T21:36:33.453,4,,
2020,4,2844,115,7,6383,2,29,3,13,15,2,14,1,14,0,False,False,False,0,2,2020-10-05T17:20:53.217,15,,
2020,4,2844,125,7,3521,2,35,7,19,20,1,20,0,20,0,False,False,False,0,3,2020-10-05T11:31:37.427,20,,
2020,4,2844,135,7,4679,2,48,10,-3,0,3,-2,2,-2,0,False,False,False,0,1,2020-10-05T11:34:41.743,0,,
2020,4,2844,140,7,3521,2,7,6,16,16,0,16,0,16,6,False,False,False,0,3,2021-03-09T21:04:01.087,16,,
2020,4,2844,145,7,4341,2,26,3,4,9,5,8,1,8,0,False,False,False,0,3,2020-10-06T21:48:51.38,9,,
2020,4,2844,160,15,7591,13,5,2,16,0,0,0,0,0,0,False,False,False,0,3,2021-02-15T20:10:56.627,0,,
2020,4,2844,165,15,6501,2,5,5,7,8,1,8,0,8,0,False,False,False,0,2,2020-10-05T11:52:07.427,8,,
2020,4,2844,175,15,8099,2,46,3,-3,7,10,3,4,3,0,False,False,False,0,1,2020-10-09T15:59:02.39,7,,
2020,4,2844,180,15,6501,2,8,9,14,14,0,14,0,14,0,False,False,False,0,2,2021-02-25T14:36:34.823,14,,
2020,4,2844,190,15,6501,2,22,3,11,11,0,11,0,11,6,False,False,False,0,2,2020-10-05T12:08:04.683,11,,
2020,4,2844,205,7,7659,2,35,6,15,15,0,15,0,15,0,False,False,False,0,3,2020-10-09T16:57:18.713,15,,
2020,4,2844,215,7,4679,2,6,9,5,7,2,7,0,7,0,False,False,False,0,2,2020-10-05T12:14:28.717,7,,
2020,4,2844,235,7,6975,2,53,10,-3,16,19,12,4,12,0,False,False,False,0,4,2020-10-09T18:46:38.907,16,,
2020,4,2844,245,7,910,13,21,6,32,0,0,0,0,0,0,False,False,False,0,2,2021-02-15T20:12:12.537,0,,
2020,4,2844,250,7,7659,3,9,2,35,0,0,0,0,0,0,False,False,False,0,2,2021-02-15T20:16:13.337,0,,
2020,4,2844,255,7,7659,2,6,10,13,30,17,27,3,27,0,False,False,False,0,2,2020-10-09T16:58:18.53,30,,
2020,4,2844,270,7,6975,13,7,3,1,0,0,0,0,0,0,False,False,False,0,4,2020-10-09T15:15:22.667,0,,
2020,4,2844,285,15,8099,2,4,9,2,14,12,6,8,6,0,False,False,False,1,1,2020-10-09T16:59:02.61,14,,
2020,4,2844,290,15,4997,2,35,3,14,20,6,19,1,19,0,False,False,False,0,2,2020-10-05T13:02:29.577,20,,
2020,4,2844,315,15,922,13,26,10,8,0,0,0,0,0,0,False,False,False,0,3,2020-10-09T17:04:10.54,0,,
2020,4,2844,320,15,922,2,4,9,6,9,3,6,3,6,0,False,False,False,0,3,2020-10-09T21:09:05.733,9,,
2020,4,2844,335,7,6975,2,35,7,19,23,4,20,3,20,0,False,False,False,0,3,2020-10-09T16:01:41.137,23,,
2020,4,2844,355,7,3521,2,4,9,6,14,8,13,1,13,0,False,False,False,1,3,2020-10-09T18:42:17.66,14,,
2020,4,2844,370,7,6975,2,4,10,4,8,4,4,4,4,0,False,False,False,1,4,2020-10-05T13:45:17.78,8,,
2020,4,2844,390,7,6975,3,7,5,9,0,0,0,0,0,0,False,False,False,0,4,2020-10-09T17:00:19.167,0,,
2020,4,2844,395,7,4679,2,45,5,-4,9,13,9,0,9,6,False,False,False,1,1,2020-10-09T21:09:20.88,9,,
2020,4,2844,415,15,7591,2,5,3,3,22,19,16,6,16,0,False,False,False,1,3,2020-10-05T18:41:28.61,22,,
2020,4,2844,420,15,4997,2,5,3,7,7,0,7,0,7,0,False,False,False,0,3,2020-10-09T17:02:02.043,7,,
2020,4,2844,430,15,7591,2,6,9,13,28,15,28,0,28,0,False,False,False,0,3,2021-02-25T14:41:20.92,28,,
2020,4,2844,440,15,7591,2,52,10,2,9,7,6,3,6,0,False,False,False,0,2,2020-10-09T16:03:24.427,9,,
2020,4,2844,480,7,4679,2,47,5,-1,14,15,-1,15,-1,0,False,False,False,1,1,2020-10-09T18:42:39.377,14,,
2020,4,2844,490,7,3521,2,6,9,12,12,0,12,0,12,0,False,False,False,0,4,2020-10-09T21:15:27.94,12,,
2020,4,2844,525,15,4997,13,50,5,-1,0,0,0,0,0,0,False,False,False,0,3,2020-10-05T14:38:19.917,0,,
2020,4,2844,535,7,910,13,5,6,24,0,0,0,0,0,0,False,False,False,0,2,2020-10-09T16:04:58.263,0,,
2020,4,2844,540,7,3521,2,6,10,12,13,1,13,0,13,0,False,False,False,0,3,2020-10-09T16:05:34.42,13,,
2020,4,2844,550,7,4679,2,4,10,2,3,1,3,0,3,0,False,False,False,0,1,2020-10-05T14:48:35.317,3,,
2020,4,2844,560,7,3521,13,17,8,20,0,0,0,0,0,0,False,False,False,0,3,2021-02-15T20:19:09.343,0,,
2020,4,2844,565,7,7659,2,6,9,6,9,3,8,1,8,0,False,False,False,0,2,2020-10-05T14:54:15.03,9,,
2020,4,2844,585,15,2757,13,6,9,6,0,0,0,0,0,0,False,False,False,0,3,2020-10-05T15:01:01.367,0,,
2020,4,2844,590,15,6501,2,39,10,5,7,2,5,2,5,0,False,False,False,0,3,2020-10-09T16:07:10.02,7,,
2020,4,2844,605,7,4716,2,35,2,18,24,6,19,5,19,0,True,False,False,0,4,2020-10-06T20:47:47.1,24,,
2020,4,2844,630,7,3521,2,50,3,0,0,0,0,0,0,0,False,False,False,0,2,2020-10-09T16:08:42.78,0,,
2020,4,2844,635,7,7659,13,12,2,22,0,0,0,0,0,0,False,False,False,0,2,2020-10-09T17:07:01.48,0,,
2020,4,2844,640,7,910,13,5,2,18,0,0,0,0,0,0,False,False,False,0,3,2020-10-05T17:02:02.75,0,,
2020,4,2844,670,15,922,2,46,3,3,13,10,8,5,8,0,False,False,False,0,4,2020-10-06T21:37:05.607,13,,
2020,4,2844,675,15,6501,2,4,5,6,13,7,10,3,10,0,False,False,False,0,2,2020-10-06T21:37:16.663,13,,
2020,4,2844,685,15,922,13,9,2,20,0,0,0,0,0,0,False,False,False,0,3,2020-10-09T17:20:12.337,0,,
2020,4,2844,710,7,3445,2,5,3,5,5,0,5,0,5,0,False,False,False,0,3,2020-10-09T17:19:31.127,5,,
2020,4,2844,720,7,3521,2,4,10,9,16,7,12,4,12,0,False,False,False,0,3,2020-10-05T15:49:58.413,16,,
2020,4,2844,725,7,7659,3,11,6,21,0,0,0,0,0,0,True,False,False,0,3,2020-10-09T21:15:47.263,0,,
2020,4,2844,730,7,3521,2,35,8,15,15,0,15,0,15,0,False,False,False,0,3,2020-10-09T17:19:39.533,15,,
2020,4,2844,735,7,4679,2,48,10,-7,-3,4,-3,0,-3,0,False,False,False,0,1,2020-10-05T15:56:44.35,-3,,
2020,4,2844,740,7,7659,2,2,10,13,23,10,13,10,13,0,False,False,False,0,3,2020-10-09T18:44:49.457,23,,
2020,4,2844,750,7,910,13,7,2,25,0,0,0,0,0,0,False,False,False,0,2,2020-10-05T16:04:13.877,0,,
2020,4,2844,770,15,7591,2,4,5,5,5,0,5,0,5,0,False,False,False,0,2,2020-10-05T17:43:34.483,5,,
2020,4,2844,775,15,8099,2,4,10,4,4,0,4,0,4,0,False,False,False,0,1,2020-10-05T18:25:24.03,4,,
2020,4,2844,785,15,6501,2,29,2,22,22,0,22,0,22,0,False,False,False,0,2,2020-10-09T21:20:44.883,22,,
2020,4,2844,790,15,8099,2,6,9,2,7,5,4,3,4,0,False,False,False,1,1,2020-10-09T18:45:02.517,7,,
2020,4,2844,795,15,922,13,13,10,4,0,0,0,0,0,0,False,False,False,0,3,2020-10-05T18:29:55.937,0,,
2020,4,2844,800,15,2407,2,13,10,1,33,32,30,3,30,0,False,False,False,0,2,2020-10-09T16:10:17.57,33,,
2020,4,2844,805,15,2407,13,9,5,2,0,0,0,0,0,0,False,False,False,0,3,2020-10-05T16:27:06.35,0,,
2020,4,2844,810,15,6501,2,2,10,2,2,0,2,0,2,6,False,False,False,0,2,2020-10-05T16:28:19.84,2,,
2020,4,2844,900,15,6501,2,5,6,17,18,1,18,0,18,0,False,False,False,0,2,2020-10-05T16:48:04.52,18,,
2020,4,2844,905,15,2757,2,17,8,18,26,8,22,4,22,0,False,False,False,0,3,2020-10-05T16:50:02.677,26,,
2020,4,2844,910,15,4997,2,2,9,8,9,1,9,0,9,0,False,False,False,0,2,2020-10-05T16:51:34.52,9,,
2020,4,2844,915,15,4997,2,6,9,5,10,5,7,3,7,0,False,False,False,0,3,2020-10-05T16:53:25.773,10,,
2020,4,2844,920,15,922,13,13,5,4,0,0,0,0,0,0,False,False,False,0,3,2020-10-09T16:11:06.697,0,,
2020,4,2845,20,9,4202,2,12,5,5,12,7,10,2,10,0,True,False,False,1,1,2021-03-08T18:54:33.89,12,,
2020,4,2845,35,8,3883,13,5,3,4,0,0,0,0,0,0,False,False,False,0,4,2020-10-21T15:17:07.323,0,,
2020,4,2845,40,8,3883,2,13,3,5,11,6,11,0,11,0,False,False,False,0,4,2020-10-06T17:40:46.937,11,,
2020,4,2845,45,8,1067,2,7,6,37,37,0,37,0,37,6,False,False,False,0,2,2021-03-08T18:54:59.307,37,,
2020,4,2845,60,9,6446,2,47,10,3,25,22,12,13,12,0,True,False,False,0,4,2021-02-15T21:55:37.953,25,,
2020,4,2845,70,9,4202,2,48,10,-3,18,21,16,2,16,0,False,False,False,0,1,2020-10-08T18:00:43.633,18,,
2020,4,2845,80,9,7816,2,17,1,42,43,1,43,0,43,6,False,False,False,0,3,2021-02-15T21:55:37.953,43,,
2020,4,2845,100,8,7652,2,13,4,3,16,13,14,2,14,0,False,False,False,1,4,2021-02-15T21:55:37.953,16,,
2020,4,2845,120,8,1067,13,2,10,9,0,0,0,0,0,0,False,False,False,0,3,2020-10-05T11:10:56.763,0,,
2020,4,2845,140,9,322,2,30,10,-1,10,11,10,0,10,0,True,False,False,0,4,2020-10-08T18:33:49.15,10,,
2020,4,2845,150,9,322,2,2,9,6,13,7,8,5,8,0,False,False,False,0,2,2020-10-08T15:31:37.45,13,,
2020,4,2845,155,9,4446,2,2,4,8,9,1,9,0,9,0,False,False,False,0,3,2020-10-08T15:32:36.517,9,,
2020,4,2845,160,9,7816,2,8,1,19,19,0,19,0,19,0,False,False,False,0,3,2020-10-08T15:33:54.357,19,,
2020,4,2845,165,9,6446,13,51,5,1,0,0,0,0,0,0,False,False,False,0,3,2021-02-15T21:55:37.953,0,,
2020,4,2845,175,9,7816,2,51,5,0,5,5,4,1,4,0,False,False,False,0,3,2021-02-15T21:55:37.953,5,,
2020,4,2845,185,9,322,2,17,10,12,20,8,20,0,20,6,True,False,False,0,4,2021-02-15T21:55:37.953,20,,
2020,4,2845,210,8,232,13,12,2,27,0,0,0,0,0,0,False,False,False,0,3,2021-02-15T21:08:02.49,0,,
2020,4,2845,215,8,3883,2,5,3,4,5,1,4,1,4,0,False,False,False,0,4,2021-02-15T21:09:07.62,5,,
2020,4,2845,225,8,1067,2,5,2,16,16,0,16,0,16,0,False,False,False,0,3,2020-10-08T15:36:23.983,16,,
2020,4,2845,245,8,232,2,5,3,7,10,3,10,0,10,0,False,False,False,0,3,2020-10-05T12:21:47.703,10,,
2020,4,2845,250,8,1067,2,2,9,4,4,0,4,0,4,6,False,False,False,0,2,2020-10-06T17:41:25.46,4,,
2020,4,2845,285,8,1067,2,3,3,12,11,-1,11,0,11,0,False,False,False,0,2,2020-10-08T19:10:54.03,11,,
2020,4,2845,300,8,3883,2,46,3,1,1,0,1,0,1,6,False,False,False,0,4,2020-10-05T12:52:50.29,1,,
2020,4,2845,325,8,3883,13,35,9,10,0,0,0,0,0,0,False,False,False,0,4,2020-10-08T15:09:02.47,0,,
2020,4,2845,330,8,1067,13,7,2,20,0,0,0,0,0,0,False,False,False,0,2,2020-10-05T13:04:36.753,0,,
2020,4,2845,335,8,232,2,5,5,10,11,1,11,0,11,0,False,False,False,0,3,2020-10-08T18:26:18.817,11,,
2020,4,2845,370,9,6441,2,5,5,5,6,1,5,1,5,0,True,False,False,0,2,2020-10-08T18:14:05.397,6,,
2020,4,2845,375,9,6436,2,5,6,17,17,0,17,0,17,0,False,False,False,0,2,2021-02-15T21:55:37.953,17,,
2020,4,2845,380,9,7183,3,6,9,3,0,0,0,0,0,0,False,False,False,0,1,2021-02-15T21:55:37.953,0,,
2020,4,2845,385,9,4202,2,48,9,-3,0,3,-1,1,-1,0,False,False,False,0,1,2021-02-15T21:11:23.037,0,,
2020,4,2845,395,9,6441,13,35,6,38,0,0,0,0,0,0,False,False,False,0,3,2020-10-08T18:15:03.12,0,,
2020,4,2845,435,8,232,2,5,5,9,9,0,9,0,9,0,True,False,False,0,3,2020-10-05T14:01:14.567,9,,
2020,4,2845,445,8,1067,2,6,4,11,13,2,12,1,12,0,False,False,False,0,2,2021-02-15T21:55:37.953,13,,
2020,4,2845,450,8,3883,2,5,3,12,12,0,12,0,12,0,False,False,False,0,4,2020-10-05T14:08:50.253,12,,
2020,4,2845,460,8,232,13,24,2,32,0,0,0,0,0,0,False,False,False,0,2,2021-02-15T21:55:37.953,0,,
2020,4,2845,465,8,7652,2,4,10,5,6,1,6,0,6,0,False,False,False,0,2,2020-10-05T14:17:00.22,6,,
2020,4,2845,475,8,232,2,2,10,7,7,0,7,0,7,0,True,False,False,0,3,2020-10-05T14:18:54.93,7,,
2020,4,2845,500,8,7652,2,35,3,9,14,5,12,2,12,0,False,False,False,1,4,2021-03-03T16:20:10.063,14,,
2020,4,2845,510,8,232,2,12,10,5,11,6,5,6,5,0,False,False,False,0,3,2020-10-08T16:21:55.147,11,,
2020,4,2845,550,9,322,13,12,2,30,0,0,0,0,0,0,False,False,False,0,2,2020-10-05T14:58:08.803,0,,
2020,4,2845,570,8,7652,2,31,10,1,1,0,1,0,1,0,False,False,False,0,4,2020-10-05T15:04:10.95,1,,
2020,4,2845,585,9,322,2,4,9,5,7,2,6,1,6,0,False,False,False,0,2,2021-02-15T21:55:37.953,7,,
2020,4,2845,590,9,7816,13,5,5,10,0,0,0,0,0,0,False,False,False,0,3,2020-10-08T15:09:43.333,0,,
2020,4,2845,595,9,322,2,5,5,3,3,0,3,0,3,0,True,False,False,0,2,2020-10-05T15:20:03.897,3,,
2020,4,2845,600,9,7816,2,5,3,7,7,0,7,0,7,0,False,False,False,0,3,2020-10-05T15:24:02.867,7,,
2020,4,2845,605,9,4202,2,48,9,-4,6,10,4,2,4,0,False,False,False,0,1,2020-10-05T15:25:50.18,6,,
2020,4,2845,610,9,6446,13,17,1,17,0,0,0,0,0,0,False,False,False,0,3,2021-02-15T21:55:37.953,0,,
2020,4,2845,615,9,6441,13,2,4,7,0,0,0,0,0,0,False,False,False,0,3,2020-10-08T15:39:49.153,0,,
2020,4,2845,620,9,6446,2,32,5,5,7,2,5,2,5,0,False,False,False,0,3,2021-02-15T21:55:37.953,7,,
2020,4,2845,625,9,7816,13,2,4,4,0,0,0,0,0,0,False,False,False,0,3,2021-02-15T21:43:37.95,0,,
2020,4,2845,640,8,6722,2,11,5,2,2,0,2,0,2,0,False,False,False,0,1,2021-02-25T14:49:23.9,2,,
2020,4,2845,660,8,3883,2,12,9,3,5,2,3,2,3,0,False,False,False,0,4,2021-03-08T18:56:22.447,5,,
2020,4,2845,680,9,322,2,4,3,5,10,5,8,2,8,0,False,False,False,0,2,2021-02-15T21:55:37.953,10,,
2020,4,2845,685,9,4202,2,38,9,0,11,11,1,10,1,0,False,False,False,1,1,2021-03-03T16:20:35.763,11,,
2020,4,2845,695,9,6436,13,4,3,11,0,0,0,0,0,0,False,False,False,0,2,2020-10-05T16:12:33.67,0,,
2020,4,2845,700,9,322,2,6,9,5,14,9,13,1,13,0,True,False,False,0,2,2020-10-06T16:53:29.51,14,,
2020,4,2845,705,9,4202,2,38,4,-1,13,14,9,4,9,0,False,False,False,0,1,2020-10-05T16:16:47.2,13,,
2020,4,2845,710,9,4446,2,2,9,8,18,10,10,8,10,0,False,False,False,0,2,2020-10-05T16:19:46.937,18,,
2020,4,2845,715,9,4446,2,2,9,6,7,1,7,0,7,0,False,False,False,0,2,2021-02-15T21:55:37.953,7,,
2020,4,2845,730,9,7816,13,9,5,2,0,0,0,0,0,0,False,False,False,0,3,2021-03-05T18:00:07.017,0,,
2020,4,2845,785,9,7183,2,44,3,-5,16,21,4,12,4,0,False,False,False,3,1,2020-10-08T16:25:00.123,16,,
2020,4,2845,790,9,322,2,13,10,3,11,8,11,0,11,0,True,False,False,0,3,2020-10-08T18:34:17.743,11,,
2020,4,2845,800,9,2568,2,6,4,12,12,0,12,0,12,0,False,False,False,0,3,2020-10-05T16:54:44.717,12,,
2020,4,2845,805,9,6441,13,13,9,2,0,0,0,0,0,0,False,False,False,0,2,2020-10-08T18:34:31.517,0,,
2020,4,2845,810,9,4446,2,4,3,7,9,2,7,2,7,0,False,False,False,0,2,2020-10-05T16:59:13.83,9,,
2020,4,2845,820,9,6446,2,8,1,21,26,5,23,3,23,6,False,False,False,1,3,2020-10-05T17:02:56.643,26,,
2020,4,2845,855,8,1067,13,21,6,26,0,0,0,0,0,0,False,False,False,0,2,2021-02-15T21:55:37.953,0,,
2020,4,2845,865,9,6441,2,2,4,7,12,5,12,0,12,0,True,False,False,0,3,2020-10-05T17:15:24.61,12,,
2020,4,2845,870,9,4202,2,48,10,-5,5,10,3,2,3,0,False,False,False,0,1,2020-10-05T17:16:49.883,5,,
2020,4,2845,875,9,6446,2,5,3,14,14,0,14,0,14,0,False,False,False,0,3,2020-10-08T18:26:44.65,14,,
2020,4,2845,880,9,6436,13,23,7,46,0,0,0,0,0,0,False,False,False,0,3,2021-02-15T21:55:37.953,0,,
2020,4,2845,885,9,322,2,4,3,7,9,2,7,2,7,0,False,False,False,0,2,2020-10-05T17:22:01.347,9,,
2020,4,2845,895,9,322,2,2,9,5,16,11,4,12,4,0,False,False,False,1,2,2020-10-08T16:25:24.15,16,,
2020,4,2845,905,9,6446,13,36,7,16,0,0,0,0,0,0,False,False,False,0,4,2021-02-15T21:55:37.953,0,,
2020,4,2845,915,9,322,13,7,5,5,0,0,0,0,0,0,False,False,False,0,3,2021-04-01T18:55:36.047,0,,
2020,4,2845,920,9,7816,2,7,5,5,5,0,5,0,5,6,False,False,False,0,3,2020-10-08T18:27:08.6,5,,
2020,4,2845,950,9,6436,2,4,3,10,12,2,10,2,10,0,False,False,False,0,2,2020-10-08T18:28:16.87,12,,
2020,4,2845,955,9,322,2,4,5,10,10,0,10,0,10,0,False,False,False,0,2,2020-10-05T17:47:43.097,10,,
2020,4,2845,960,9,6446,13,17,1,19,0,0,0,0,0,0,False,False,False,0,3,2021-02-15T21:55:37.953,0,,
2020,4,2845,965,9,2568,2,13,9,4,12,8,6,6,6,0,False,False,False,0,3,2020-10-05T17:52:05.303,12,,
2020,4,2845,970,9,4202,2,31,4,2,6,4,6,0,6,0,False,False,False,0,1,2021-02-15T21:55:37.953,6,,
2020,4,2845,980,9,322,2,5,5,11,11,0,11,0,11,0,False,False,False,0,3,2021-02-15T21:55:37.953,11,,
2020,4,2845,985,9,322,13,17,7,23,0,0,0,0,0,0,False,False,False,0,3,2020-10-05T18:42:05.413,0,,
2020,4,2845,990,9,6441,2,3,6,16,16,0,16,0,16,0,False,False,False,0,2,2021-02-15T21:55:37.953,16,,
2020,4,2845,995,9,322,13,2,10,4,0,0,0,0,0,0,False,False,False,0,2,2021-03-05T16:02:15.427,0,,
2020,4,2846,10,11,4492,3,6,1,16,0,0,0,0,0,0,False,False,False,0,2,2020-10-09T17:01:30.39,0,,
2020,4,2846,15,11,792,3,44,9,-4,0,0,0,0,0,0,True,False,False,0,1,2020-10-06T21:43:53.44,0,,
2020,4,2846,30,11,792,13,46,3,2,0,0,0,0,0,0,False,False,False,0,1,2021-02-15T22:00:33.98,0,,
2020,4,2846,35,11,100,2,35,10,13,50,37,46,4,46,0,False,False,False,2,3,2021-02-15T22:01:09.447,50,,
2020,4,2846,45,11,7732,2,16,9,7,7,0,7,0,7,6,False,False,False,0,1,2020-10-05T10:43:44.587,7,,
2020,4,2846,60,20,213,13,2,9,5,0,0,0,0,0,0,False,False,False,0,3,2020-10-05T10:48:52.607,0,,
2020,4,2846,75,11,4492,2,5,6,15,15,0,15,0,15,6,False,False,False,0,2,2020-10-05T10:56:46.867,15,,
2020,4,2846,90,20,8131,2,35,10,11,16,5,12,4,12,0,False,False,False,1,3,2020-10-05T11:03:00.467,16,,
2020,4,2846,110,20,5140,13,19,2,24,0,0,0,0,0,0,False,False,False,0,2,2020-10-05T11:12:52.767,0,,
2020,4,2846,125,20,213,2,29,6,15,18,3,15,3,15,0,False,False,False,0,2,2020-10-05T11:56:26.087,18,,
2020,4,2846,170,11,6810,13,5,2,15,0,0,0,0,0,0,False,False,False,0,4,2020-10-05T11:34:55.72,0,,
2020,4,2846,175,11,7732,2,16,9,5,14,9,10,4,10,0,False,False,False,0,1,2020-10-09T17:01:53.91,14,,
2020,4,2846,185,11,4492,13,2,10,3,0,0,0,0,0,0,False,False,False,0,2,2020-10-05T11:50:19.327,0,,
2020,4,2846,215,20,213,2,4,7,17,19,2,18,1,18,0,False,False,False,0,3,2020-10-09T17:02:15.753,19,,
2020,4,2846,230,20,4535,2,39,4,6,8,2,6,2,6,0,False,False,False,0,3,2021-03-08T15:46:46.017,8,,
2020,4,2846,235,20,5140,2,11,2,18,29,11,26,3,26,0,True,False,False,0,3,2020-10-06T16:42:58.03,29,,
2020,4,2846,245,20,306,2,6,10,1,19,18,7,12,7,0,False,False,False,1,1,2020-10-05T12:20:34.39,19,,
2020,4,2846,265,11,2714,2,12,2,29,31,2,29,2,29,0,False,False,False,0,4,2020-10-05T15:57:39.757,31,,
2020,4,2846,275,11,914,13,7,6,30,0,0,0,0,0,0,False,False,False,0,3,2020-10-09T17:10:16.92,0,,
2020,4,2846,280,11,6810,13,12,5,11,0,0,0,0,0,0,False,False,False,0,4,2020-10-09T16:08:37.953,0,,
2020,4,2846,295,20,213,2,5,6,21,25,4,24,1,24,0,False,False,False,0,3,2021-03-17T20:31:12.427,25,,
2020,4,2846,300,20,7353,2,51,3,-4,10,14,3,7,3,0,True,False,False,2,3,2020-10-06T16:28:44.947,10,,
2020,4,2846,325,20,6388,2,5,5,2,2,0,2,0,2,6,False,False,False,0,3,2020-10-05T15:59:45.35,2,,
2020,4,2846,355,11,100,13,5,5,4,0,0,0,0,0,0,True,False,False,0,2,2020-10-05T13:03:36.617,0,,
2020,4,2846,365,20,213,13,5,3,10,0,0,0,0,0,0,False,False,False,0,3,2020-10-07T14:36:51.35,0,,
2020,4,2846,375,20,6388,2,5,10,12,13,1,11,2,11,0,False,False,False,0,2,2020-10-09T15:58:10.023,13,,
2020,4,2846,380,20,6388,2,35,2,20,20,0,20,0,20,6,False,False,False,0,2,2021-02-15T22:03:15.813,20,,
2020,4,2846,395,11,4492,13,2,9,7,0,0,0,0,0,0,False,False,False,0,3,2020-10-05T13:21:14.953,0,,
2020,4,2846,400,11,4492,2,6,8,16,16,0,16,0,16,0,False,False,False,0,2,2020-10-07T14:39:14.23,16,,
2020,4,2846,415,11,7732,2,48,10,-4,0,4,-2,2,-2,0,False,False,False,0,1,2020-10-05T13:24:54.953,0,,
2020,4,2846,425,11,4487,13,8,8,41,0,0,0,0,0,0,False,False,False,0,3,2020-10-05T13:26:34.72,0,,
2020,4,2846,445,20,213,2,6,4,13,15,2,15,0,15,0,False,False,False,0,3,2020-10-05T13:37:12.153,15,,
2020,4,2846,465,20,1162,2,31,10,3,7,4,7,0,7,0,False,True,False,0,4,2020-10-05T13:44:37.933,7,,
2020,4,2846,470,20,213,2,12,5,5,4,-1,4,0,4,0,False,False,False,0,2,2020-10-05T13:49:33.1,4,,
2020,4,2846,475,20,7353,13,17,7,19,0,0,0,0,0,0,False,False,False,0,3,2020-10-05T13:50:58.677,0,,
2020,4,2846,480,20,213,2,4,10,4,12,8,4,8,4,0,False,False,False,1,3,2020-10-05T13:52:50.187,12,,
2020,4,2846,490,20,5140,2,51,9,-6,-2,4,-2,0,-2,0,True,False,False,0,1,2020-10-09T17:02:31.72,-2,,
2020,4,2846,515,11,100,2,4,10,6,7,1,6,1,6,0,True,False,False,0,3,2020-10-06T21:44:42.84,7,,
2020,4,2846,520,11,914,2,6,4,9,9,0,9,0,9,0,False,False,False,0,3,2020-10-05T14:10:37.423,9,,
2020,4,2846,530,11,100,13,4,3,10,0,0,0,0,0,0,False,False,False,0,2,2021-03-08T15:05:06.18,0,,
2020,4,2846,540,11,6810,2,16,9,4,8,4,4,4,4,0,False,False,False,0,3,2020-10-07T14:51:48.46,8,,
2020,4,2846,560,11,914,13,17,1,34,0,0,0,0,0,0,False,False,False,0,3,2020-10-09T17:10:16.92,0,,
2020,4,2846,570,11,6810,2,32,9,1,1,0,1,0,1,6,False,False,False,0,4,2020-10-05T16:00:56.683,1,,
2020,4,2846,590,20,5140,2,6,10,1,9,8,6,3,6,0,False,False,False,0,1,2020-10-09T17:02:45.52,9,,
2020,4,2846,635,20,213,13,8,1,15,0,0,0,0,0,0,False,False,False,0,2,2020-10-07T14:55:56.59,0,,
2020,4,2846,650,11,6629,2,47,10,0,4,4,1,3,1,0,False,False,False,0,1,2020-10-05T14:51:35.827,4,,
2020,4,2846,655,11,4492,2,2,10,7,17,10,15,2,15,0,False,False,False,0,3,2020-10-09T15:45:20.78,17,,
2020,4,2846,685,20,306,3,28,10,3,0,0,0,0,0,0,False,False,False,0,1,2020-10-05T15:09:06.92,0,,
2020,4,2846,700,11,3820,13,8,1,43,0,0,0,0,0,0,False,False,False,0,2,2020-10-05T15:13:37.247,0,,
2020,4,2846,715,11,6341,2,47,5,0,3,3,3,0,3,0,False,False,False,0,1,2020-10-05T15:17:48.527,3,,
2020,4,2846,730,11,4487,2,50,9,-3,1,4,-2,3,-2,0,False,False,False,0,3,2020-10-09T15:45:38.64,1,,
2020,4,2846,735,11,914,13,19,2,33,0,0,0,0,0,0,False,False,False,0,2,2020-10-05T15:23:51.797,0,,
2020,4,2846,740,11,4492,2,6,9,13,14,1,14,0,14,0,False,False,False,0,2,2020-10-05T15:25:25.077,14,,
2020,4,2846,750,11,4492,13,8,1,19,0,0,0,0,0,0,False,False,False,0,2,2020-10-09T17:02:59.45,0,,
2020,4,2846,755,11,4492,13,17,4,14,0,0,0,0,0,0,False,False,False,0,3,2020-10-05T15:29:40.917,0,,
2020,4,2846,760,11,2714,13,8,9,14,0,0,0,0,0,0,False,False,False,0,4,2020-10-05T15:30:44.653,0,,
2020,4,2846,765,11,7732,2,2,3,8,9,1,9,0,9,0,False,False,False,0,2,2020-10-07T14:57:08.407,9,,
2020,4,2846,785,20,568,2,28,4,3,3,0,3,0,3,0,False,False,False,0,1,2020-10-05T15:36:06.173,3,,
2020,4,2846,805,20,6388,2,35,6,17,19,2,18,1,18,0,False,False,False,0,3,2020-10-05T15:41:37.66,19,,
2020,4,2847,15,13,6528,2,30,5,-1,6,7,4,2,4,0,True,False,False,0,1,2021-02-17T21:55:00.04,6,,
2020,4,2847,20,13,496,13,6,4,5,0,0,0,0,0,0,False,False,False,0,3,2021-01-08T01:25:50.32,0,,
2020,4,2847,45,18,1381,2,5,6,18,18,0,18,0,18,0,False,False,False,0,3,2020-10-05T10:05:45.687,18,,
2020,4,2847,70,13,2455,13,46,9,3,0,0,0,0,0,0,False,False,False,0,1,2020-10-05T10:16:57.21,0,,
2020,4,2847,90,18,7711,2,6,6,20,29,9,27,2,27,0,False,False,False,0,3,2021-01-08T01:18:47.667,29,,
2020,4,2847,100,18,4572,2,51,10,-6,11,17,9,2,9,0,False,False,False,0,1,2020-10-05T16:07:42.46,11,,
2020,4,2847,140,13,3951,2,2,10,10,10,0,10,0,10,0,False,False,False,0,3,2020-10-05T10:39:07.213,10,,
2020,4,2847,150,13,876,13,35,9,12,0,0,0,0,0,0,False,False,False,0,3,2021-02-18T20:20:13.617,0,,
2020,4,2847,160,13,2136,13,9,2,15,0,0,0,0,0,0,False,False,False,0,3,2021-01-08T01:25:39.157,0,,
2020,4,2847,170,18,1381,13,4,7,16,0,0,0,0,0,0,False,False,False,0,2,2021-02-17T21:27:31.677,0,,
2020,4,2847,210,18,6907,13,12,6,20,0,0,0,0,0,0,False,False,False,0,4,2020-10-05T11:25:04.23,0,,
2020,4,2847,225,18,1381,2,39,4,3,3,0,3,0,3,0,False,False,False,0,3,2020-10-09T15:12:01.027,3,,
2020,4,2847,240,13,3951,2,2,9,5,8,3,5,3,5,0,False,False,False,1,2,2020-10-05T11:31:31.037,8,,
2020,4,2847,265,13,404,2,12,3,6,15,9,14,1,14,0,False,False,False,0,1,2021-03-08T19:02:55.477,15,,
2020,4,2847,275,13,496,13,5,10,2,0,0,0,0,0,0,False,False,False,0,3,2020-10-09T15:16:48.437,0,,
2020,4,2847,280,13,876,13,12,10,12,0,0,0,0,0,0,False,False,False,0,3,2020-10-05T11:45:43.36,0,,
2020,4,2847,295,18,813,2,13,3,1,8,7,8,0,8,0,False,False,False,0,4,2020-10-05T11:48:12.313,8,,
2020,4,2847,305,18,7711,2,22,6,22,26,4,24,2,24,0,False,False,False,0,3,2020-10-05T11:51:18.093,26,,
2020,4,2847,315,18,6897,13,19,6,30,0,0,0,0,0,0,False,False,False,0,2,2021-01-08T01:18:47.667,0,,
2020,4,2847,320,18,1381,2,39,4,6,8,2,8,0,8,0,False,False,False,0,3,2020-10-05T12:05:22.55,8,,
2020,4,2847,330,18,1381,2,5,5,5,5,0,5,0,5,0,False,False,False,0,3,2020-10-05T12:08:05.65,5,,
2020,4,2847,375,13,6528,2,13,9,5,14,9,10,4,10,0,False,False,False,0,4,2020-10-05T12:18:22.78,14,,
2020,4,2847,385,13,2136,13,5,3,8,0,0,0,0,0,0,False,False,False,0,3,2020-10-21T02:58:37.757,0,,
2020,4,2847,390,13,6528,2,17,1,21,26,5,24,2,24,0,False,False,False,0,4,2020-10-09T15:22:18.507,26,,
2020,4,2847,400,13,496,13,12,5,10,0,0,0,0,0,0,False,False,False,0,3,2020-10-06T21:07:39.397,0,,
2020,4,2847,405,13,404,13,5,3,6,0,0,0,0,0,0,False,False,False,0,1,2020-10-06T21:08:01.803,0,,
2020,4,2847,445,18,4572,2,48,10,-4,5,9,-4,9,-4,0,False,False,False,1,1,2020-10-09T15:26:09.427,5,,
2020,4,2847,455,13,496,2,2,9,5,13,8,12,1,12,0,False,False,False,0,3,2020-10-06T21:08:30.083,13,,
2020,4,2847,460,13,1430,2,5,9,4,7,3,6,1,6,0,False,False,False,0,3,2020-10-05T12:53:49.2,7,,
2020,4,2847,475,13,404,2,46,3,-1,6,7,6,0,6,0,False,False,False,0,1,2020-10-06T15:28:39.14,6,,
2020,4,2847,485,13,3951,2,17,7,18,24,6,24,0,24,6,False,False,False,0,3,2021-02-25T14:55:54.393,24,,
2020,4,2847,500,18,1381,2,35,6,18,39,21,39,0,39,0,False,False,False,0,3,2020-10-05T13:04:31.957,39,,
2020,4,2847,515,18,1381,13,35,2,27,0,0,0,0,0,0,True,False,False,0,3,2020-10-06T13:58:24.48,0,,
2020,4,2847,520,18,7711,13,5,3,12,0,0,0,0,0,0,False,False,False,0,2,2020-10-05T13:24:56.997,0,,
2020,4,2847,535,13,3951,2,9,2,37,43,6,41,2,41,0,False,False,False,0,3,2021-02-19T13:47:21.503,43,,
2020,4,2847,580,18,7711,2,35,2,17,23,6,21,2,21,0,False,False,False,0,3,2021-02-17T21:29:12.213,23,,
2020,4,2847,585,18,813,2,35,2,18,19,1,19,0,19,0,False,False,False,0,4,2020-10-09T14:39:41.963,19,,
2020,4,2847,600,18,1381,2,36,4,9,9,0,9,0,9,6,False,False,False,0,3,2021-01-08T01:18:47.667,9,,
2020,4,2847,620,13,3951,2,26,10,4,4,0,4,0,4,0,False,False,False,0,3,2020-10-05T13:49:28.813,4,,
2020,4,2847,650,18,7711,2,29,6,19,25,6,24,1,24,0,False,False,False,0,2,2020-10-06T21:11:25.317,25,,
2020,4,2847,655,18,1381,2,7,2,25,25,0,25,0,25,0,False,False,False,0,3,2020-10-09T13:44:32.69,25,,
2020,4,2847,685,13,1430,2,6,4,14,14,0,14,0,14,0,False,False,False,0,3,2020-10-05T14:40:25.693,14,,
2020,4,2847,695,13,3951,2,8,9,13,19,6,18,1,18,0,False,False,False,0,3,2021-02-19T14:51:46.42,19,,
2020,4,2847,720,13,404,2,50,3,-4,0,4,0,0,0,0,False,False,False,0,3,2021-02-17T21:32:55.243,0,,
2020,4,2847,725,13,2455,2,32,3,4,13,9,8,5,8,0,False,False,False,0,1,2020-10-05T14:55:30.007,13,,
2020,4,2847,730,13,2136,2,9,2,24,24,0,24,0,24,6,False,False,False,0,2,2021-02-19T15:00:28.15,24,,
2020,4,2847,745,18,1381,2,13,3,3,7,4,7,0,7,0,False,False,False,0,3,2020-10-05T15:01:25.563,7,,
2020,4,2847,790,18,1381,13,19,6,30,0,0,0,0,0,0,False,False,False,0,2,2020-10-05T15:16:02.96,0,,
2020,4,2847,800,13,876,3,4,5,6,0,0,0,0,0,0,False,False,False,0,2,2020-10-05T15:19:31.063,0,,
2020,4,2847,810,13,3951,3,5,3,11,0,0,0,0,0,0,False,False,False,0,2,2021-02-19T14:51:46.42,0,,
2020,4,2847,820,13,496,2,13,10,4,23,19,22,1,22,0,False,False,False,0,3,2020-10-06T21:14:34.72,23,,
2020,4,2847,825,13,2136,2,3,2,15,15,0,15,0,15,0,False,False,False,0,2,2020-10-05T15:28:20.617,15,,
2020,4,2847,830,13,2455,2,7,5,10,16,6,14,2,14,0,False,False,False,0,1,2020-10-05T15:30:30.74,16,,
2020,4,2847,865,13,3951,13,5,3,5,0,0,0,0,0,0,False,False,False,0,2,2021-01-08T01:26:17.34,0,,
2020,4,2848,10,17,2253,2,4,3,9,9,0,9,0,9,0,False,False,False,0,2,2020-10-05T10:27:45.73,9,,
2020,4,2848,20,17,2253,2,4,10,4,5,1,5,0,5,0,False,False,False,0,3,2020-10-07T00:50:45.22,5,,
2020,4,2848,25,17,6276,13,4,7,16,0,0,0,0,0,0,False,False,False,0,4,2021-03-09T19:33:41.767,0,,
2020,4,2848,30,27,505,2,47,5,2,5,3,4,1,4,0,True,False,False,0,4,2021-02-19T15:56:18.947,5,,
2020,4,2848,35,27,7408,2,19,2,32,37,5,33,4,33,0,False,False,False,0,2,2021-02-19T15:59:26.12,37,,
2020,4,2848,45,27,5050,2,32,5,-2,5,7,1,4,1,0,True,False,False,0,3,2020-10-09T19:37:40.86,5,,
2020,4,2848,90,27,7852,2,45,5,-2,23,25,23,0,23,0,True,False,False,0,3,2021-02-22T16:03:23.037,23,,
2020,4,2848,105,27,7408,13,35,6,22,0,0,0,0,0,0,False,False,False,0,2,2020-10-05T11:28:21.633,0,,
2020,4,2848,115,17,7087,13,4,5,13,0,0,0,0,0,0,False,False,False,0,2,2020-10-05T18:17:09.337,0,,
2020,4,2848,120,17,4305,2,6,9,6,9,3,7,2,7,0,False,False,False,0,2,2021-02-22T15:57:41.863,9,,
2020,4,2848,125,17,6276,2,38,4,3,18,15,16,2,16,0,False,False,False,0,4,2021-02-19T17:11:57.413,18,,
2020,4,2848,130,17,6274,2,7,6,15,15,0,15,0,15,0,False,False,False,0,3,2020-10-05T11:45:16.36,15,,
2020,4,2848,135,17,7087,2,8,1,15,15,0,15,0,15,0,False,False,False,0,2,2021-02-22T15:57:41.863,15,,
2020,4,2848,150,17,4752,13,24,5,13,0,0,0,0,0,0,False,False,False,0,3,2020-10-09T19:39:15.477,0,,
2020,4,2848,155,17,7024,13,51,3,-3,0,0,0,0,0,0,False,False,False,0,1,2021-02-22T15:57:41.863,0,,
2020,4,2848,170,27,6397,2,4,10,6,14,8,13,1,13,0,False,False,False,0,4,2020-10-09T19:39:41.36,14,,
2020,4,2848,175,27,5050,2,46,3,1,4,3,3,1,3,0,False,False,False,0,1,2020-10-09T19:56:13.897,4,,
2020,4,2848,180,27,7408,2,35,7,17,19,2,18,1,18,0,False,False,False,0,3,2020-10-09T19:57:56.693,19,,
2020,4,2848,190,27,650,3,12,7,18,0,0,0,0,0,0,False,False,False,0,3,2021-03-08T19:07:52.35,0,,
2020,4,2848,195,27,5069,13,3,7,19,0,0,0,0,0,0,True,False,False,0,2,2021-02-22T15:43:50.617,0,,
2020,4,2848,210,17,4913,2,4,4,4,26,22,14,12,14,0,False,False,False,1,1,2020-10-09T19:40:13.593,26,,
2020,4,2848,225,17,2253,2,6,10,6,11,5,7,4,7,0,True,False,False,0,2,2021-02-22T15:57:41.863,11,,
2020,4,2848,230,17,2253,2,2,4,6,17,11,7,10,7,0,False,False,False,2,3,2021-02-19T15:15:35.463,17,,
2020,4,2848,245,17,4752,13,2,4,9,0,0,0,0,0,0,False,False,False,0,3,2021-02-19T15:16:47.457,0,,
2020,4,2848,260,27,7408,2,2,9,12,18,6,18,0,18,0,False,False,False,0,2,2020-10-09T19:40:26.183,18,,
2020,4,2848,270,27,6397,2,30,3,1,1,0,1,0,1,0,False,False,False,0,4,2020-10-09T19:59:09.497,1,,
2020,4,2848,275,27,505,2,5,3,4,4,0,4,0,4,0,False,False,False,0,3,2020-10-05T13:02:42.723,4,,
2020,4,2848,280,27,7852,2,4,5,8,9,1,9,0,9,0,False,False,False,0,2,2020-10-09T19:40:42.337,9,,
2020,4,2848,300,27,5050,13,32,3,-3,0,0,0,0,0,0,False,False,False,0,1,2021-02-22T16:02:20.86,0,,
2020,4,2848,305,27,505,2,35,10,8,11,3,9,2,9,0,False,False,False,0,3,2021-02-22T15:57:41.863,11,,
2020,4,2848,315,27,7850,2,4,4,2,6,4,2,4,2,0,False,False,False,1,1,2020-10-06T16:37:52.273,6,,
2020,4,2848,320,27,505,13,12,2,18,0,0,0,0,0,0,False,False,False,0,3,2021-03-08T19:08:25.94,0,,
2020,4,2848,330,17,7024,2,46,3,1,9,8,7,2,7,0,False,False,False,0,1,2021-02-19T15:20:58.317,9,,
2020,4,2848,335,17,4484,13,35,10,8,0,0,0,0,0,0,False,False,False,0,4,2021-02-25T15:00:54.187,0,,
2020,4,2848,340,17,7010,2,47,5,0,3,3,2,1,2,0,False,False,False,0,1,2020-10-09T19:41:06.793,3,,
2020,4,2848,345,17,6276,2,4,9,6,12,6,9,3,9,0,False,False,False,0,2,2020-10-05T14:02:32.48,12,,
2020,4,2848,360,17,2253,2,6,1,16,21,5,17,4,17,0,False,False,False,1,2,2021-02-19T15:23:03.117,21,,
2020,4,2848,365,17,4752,13,4,9,4,0,0,0,0,0,0,False,False,False,0,3,2020-10-05T14:10:51.217,0,,
2020,4,2848,370,17,2253,2,6,9,6,6,0,6,0,6,0,False,False,False,0,2,2020-10-05T14:12:56.253,6,,
2020,4,2848,375,17,4305,13,20,2,24,0,0,0,0,0,0,False,False,False,0,2,2021-02-22T15:57:41.863,0,,
2020,4,2848,390,27,505,2,4,5,11,11,0,11,0,11,0,False,False,False,0,3,2020-10-05T14:22:54.513,11,,
2020,4,2848,400,27,5069,2,12,6,44,57,13,55,2,55,0,False,False,False,0,2,2021-03-08T19:08:53.227,57,,
2020,4,2848,410,27,505,2,13,9,4,4,0,4,0,4,0,False,False,False,0,3,2021-02-19T15:28:49.77,4,,
2020,4,2848,425,27,7404,2,28,4,3,3,0,3,0,3,6,False,False,False,0,1,2020-10-05T14:28:43.267,3,,
2020,4,2848,455,27,650,13,7,6,32,0,0,0,0,0,0,False,False,False,0,3,2021-02-19T21:57:17.933,0,,
2020,4,2848,475,27,5069,2,34,4,-4,21,25,-4,25,-4,0,True,False,False,1,2,2021-02-19T15:30:44.363,21,,
2020,4,2848,480,27,5050,2,47,5,1,11,10,9,2,9,0,False,False,False,0,1,2021-02-22T13:46:15.37,11,,
2020,4,2848,500,27,505,13,7,5,6,0,0,0,0,0,0,True,False,False,0,3,2020-10-06T16:54:39.61,0,,
2020,4,2848,505,27,7852,13,6,4,6,0,0,0,0,0,0,False,False,False,0,2,2021-02-22T15:57:41.863,0,,
2020,4,2848,510,27,7408,13,2,4,6,0,0,0,0,0,0,False,False,False,0,2,2020-10-05T15:10:33.677,0,,
2020,4,2848,515,17,7024,2,48,9,-5,5,10,5,0,5,0,False,False,False,0,1,2021-02-22T13:55:50.197,5,,
2020,4,2848,540,17,4913,2,4,4,3,12,9,3,9,3,0,False,False,False,1,1,2020-10-05T15:29:22.513,12,,
2020,4,2848,545,17,4913,2,48,10,-4,1,5,-1,2,-1,0,False,False,False,0,1,2020-10-09T19:45:44.017,1,,
2020,4,2848,550,17,2253,2,5,5,4,4,0,4,0,4,0,True,False,False,0,3,2021-02-22T15:44:41.697,4,,
2020,4,2848,555,17,2253,3,2,10,5,0,0,0,0,0,0,False,False,False,0,2,2020-10-05T15:36:56.42,0,,
2020,4,2848,600,17,4752,2,13,10,4,17,13,14,3,14,0,False,False,False,0,3,2020-10-09T20:09:02.903,17,,
2020,4,2848,605,17,4752,2,13,9,4,4,0,4,0,4,0,False,False,False,0,3,2020-10-05T15:57:06.013,4,,
2020,4,2848,620,17,4305,2,2,4,4,9,5,7,2,7,0,False,False,False,1,3,2020-10-05T16:02:24.733,9,,
2020,4,2848,630,17,3476,2,48,10,-4,-4,0,-4,0,-4,0,False,True,False,0,1,2021-02-22T14:22:12.493,-3,,
2020,4,2848,635,17,7087,13,35,1,22,0,0,0,0,0,0,False,False,False,0,3,2021-02-22T14:24:00.9,0,,
2020,4,2848,640,17,4752,2,4,7,16,16,0,16,0,16,0,False,False,False,0,3,2020-10-05T18:43:37.447,16,,
2020,4,2848,645,17,2253,13,5,3,9,0,0,0,0,0,0,False,False,False,0,3,2021-02-22T14:28:14.287,0,,
2020,4,2848,650,17,6274,13,2,9,10,0,0,0,0,0,0,False,False,False,0,3,2020-10-09T18:50:59.76,0,,
2020,4,2848,670,17,6274,13,8,1,16,0,0,0,0,0,0,False,False,False,0,3,2020-10-09T20:06:24.777,0,,
2020,4,2848,695,27,650,2,46,3,3,9,6,8,1,8,0,True,False,False,0,3,2020-10-05T16:45:09.103,9,,
2020,4,2848,705,27,650,2,35,6,15,30,15,30,0,30,0,False,False,False,0,3,2020-10-05T16:50:34.747,30,,
2020,4,2848,715,27,7850,2,28,4,1,9,8,5,4,5,0,False,False,False,1,1,2020-10-05T18:45:02.657,9,,
2020,4,2848,720,27,5069,2,9,2,17,17,0,17,0,17,6,False,False,False,0,2,2020-10-05T16:58:22.317,17,,
2020,4,2848,735,17,2253,2,2,9,8,9,1,9,0,9,0,False,False,False,0,2,2020-10-05T17:06:18.413,9,,
2020,4,2848,740,17,4752,13,4,10,4,0,0,0,0,0,0,False,False,False,0,3,2020-10-05T17:08:26.513,0,,
2020,4,2848,750,17,4752,13,17,10,13,0,0,0,0,0,0,False,False,False,0,3,2021-03-09T19:34:23.673,0,,
2020,4,2848,755,27,7408,2,49,5,-1,32,33,2,30,2,0,False,False,False,3,2,2020-10-05T17:20:10.337,32,,
2020,4,2848,775,17,4752,2,4,9,9,11,2,9,2,9,0,False,False,False,0,3,2020-10-05T17:27:13.17,11,,
2020,4,2848,780,17,4752,13,2,4,5,0,0,0,0,0,0,False,False,False,0,3,2020-10-05T17:28:47.913,0,,
2020,4,2848,785,17,2253,2,2,9,9,10,1,9,1,9,0,False,False,False,0,2,2020-10-05T17:30:28.743,10,,
2020,4,2848,790,17,4305,2,8,8,18,18,0,18,0,18,0,False,False,False,0,2,2021-02-22T15:57:41.88,18,,
2020,4,2848,795,17,2253,2,6,9,7,18,11,13,5,13,0,False,False,False,0,2,2020-10-05T17:39:29.45,18,,
2020,4,2848,800,17,7024,2,4,9,0,8,8,8,0,8,0,False,False,False,0,1,2020-10-09T20:13:45.96,8,,
2020,4,2848,805,17,7087,13,12,5,10,0,0,0,0,0,0,False,False,False,0,2,2021-02-19T15:32:37.243,0,,
2020,4,2849,10,30,6414,2,48,9,-2,3,5,3,0,3,0,False,False,False,0,1,2020-10-05T10:13:16.907,3,,
2020,4,2849,20,30,6414,2,44,3,-5,7,12,5,2,5,0,False,False,False,0,1,2020-10-05T10:17:12.577,7,,
2020,4,2849,30,30,793,2,17,1,22,24,2,24,0,24,0,False,False,False,0,3,2020-10-05T10:20:52.643,24,,
2020,4,2849,40,30,793,2,4,3,12,17,5,15,2,15,0,False,False,False,0,2,2020-10-05T10:25:04.54,17,,
2020,4,2849,50,30,6414,13,46,3,1,0,0,0,0,0,0,False,False,False,0,1,2020-10-05T10:28:22.71,0,,
2020,4,2849,55,30,2290,2,4,10,3,3,0,3,0,3,6,True,False,False,0,3,2021-01-29T15:35:00.833,3,,
2020,4,2849,70,26,4616,2,31,10,-5,2,7,-1,3,-1,0,False,False,False,1,1,2021-03-03T16:42:17.91,2,,
2020,4,2849,80,26,309,2,49,5,-1,10,11,7,3,7,0,False,False,False,0,2,2021-02-16T21:14:39.88,10,,
2020,4,2849,85,26,7514,2,35,6,51,53,2,53,0,53,6,False,False,False,0,3,2021-02-16T21:17:37.04,53,,
2020,4,2849,105,30,793,2,4,10,6,6,0,6,0,6,0,False,False,False,0,3,2020-10-05T10:46:30.417,6,,
2020,4,2849,110,30,6414,3,6,10,2,0,0,0,0,0,0,False,False,False,0,1,2020-10-05T15:32:20.117,0,,
2020,4,2849,125,30,6414,2,48,9,-6,-2,4,-2,0,-2,0,False,False,False,0,1,2020-10-05T10:55:02.633,-2,,
2020,4,2849,130,30,6419,2,13,9,7,15,8,15,0,15,0,False,False,False,0,3,2020-10-08T15:05:55.643,15,,
2020,4,2849,140,30,6419,13,5,3,10,0,0,0,0,0,0,False,False,False,0,3,2021-03-05T16:26:33.683,0,,
2020,4,2849,160,30,6419,3,6,4,11,0,0,0,0,0,0,False,False,False,0,3,2020-10-05T11:11:17.99,0,,
2020,4,2849,165,30,6414,2,4,9,1,3,2,3,0,3,0,False,False,False,0,1,2020-10-08T16:27:49.707,3,,
2020,4,2849,170,30,119,2,48,9,-4,3,7,3,0,3,0,False,False,False,0,1,2020-10-08T14:48:53.367,3,,
2020,4,2849,185,26,4282,13,17,10,9,0,0,0,0,0,0,False,False,False,0,4,2021-02-25T15:16:47.213,0,,
2020,4,2849,190,26,309,13,5,5,12,0,0,0,0,0,0,False,False,False,0,2,2020-10-06T20:39:52.663,0,,
2020,4,2849,205,30,4523,13,4,4,4,0,0,0,0,0,0,False,False,False,0,4,2020-10-08T16:17:58.537,0,,
2020,4,2849,210,30,4523,13,5,5,10,0,0,0,0,0,0,True,False,False,0,3,2020-10-08T16:18:23.017,0,,
2020,4,2849,235,26,8177,2,47,10,2,5,3,4,1,4,0,False,False,False,1,1,2020-10-08T16:21:24.74,5,,
2020,4,2849,250,26,6301,2,28,10,-3,9,12,9,0,9,0,False,False,False,0,1,2020-10-06T20:50:01.893,9,,
2020,4,2849,260,26,7695,2,44,3,-2,1,3,1,0,1,0,False,False,False,0,1,2020-10-05T15:08:35.503,1,,
2020,4,2849,270,26,309,13,21,6,19,0,0,0,0,0,0,False,False,False,0,3,2020-10-08T15:05:55.643,0,,
2020,4,2849,275,26,4282,13,43,6,17,0,0,0,0,0,0,False,False,False,0,4,2021-02-18T15:22:16.69,0,,
2020,4,2849,290,26,7695,2,11,3,2,17,15,17,0,17,0,False,False,False,0,1,2021-02-16T21:20:13.423,17,,
2020,4,2849,300,26,7491,2,29,6,19,19,0,19,0,19,6,False,False,False,0,2,2020-10-06T20:40:12.14,19,,
2020,4,2849,315,30,6419,2,6,4,5,5,0,5,0,5,0,False,False,False,0,3,2020-10-05T12:03:45.167,5,,
2020,4,2849,320,30,6414,2,46,9,0,1,1,1,0,1,0,False,False,False,0,1,2020-10-05T12:05:00.703,1,,
2020,4,2849,325,30,4523,2,4,9,5,5,0,5,0,5,0,True,False,False,0,3,2020-10-08T16:19:39.89,5,,
2020,4,2849,345,30,6414,3,47,5,0,0,0,0,0,0,0,False,False,False,0,1,2020-10-05T12:24:39.527,0,,
2020,4,2849,350,30,7268,13,19,2,26,0,0,0,0,0,0,False,False,False,0,2,2020-10-05T12:26:34.303,0,,
2020,4,2849,365,26,309,2,49,9,-3,7,10,7,0,7,0,True,False,False,0,3,2020-10-05T12:30:00.6,7,,
2020,4,2849,375,26,309,2,35,6,17,17,0,17,0,17,0,False,False,False,0,3,2020-10-07T13:28:27.327,17,,
2020,4,2849,390,26,309,13,50,3,-2,0,0,0,0,0,0,True,False,False,0,2,2021-02-16T21:22:23.65,0,,
2020,4,2849,405,26,309,2,13,4,3,8,5,8,0,8,0,True,False,False,0,3,2020-10-06T20:40:43.267,8,,
2020,4,2849,420,30,7268,13,19,2,30,0,0,0,0,0,0,False,False,False,0,2,2020-10-05T12:46:13.857,0,,
2020,4,2849,425,30,6419,2,4,10,9,10,1,10,0,10,0,False,False,False,0,3,2020-10-05T12:47:25.307,10,,
2020,4,2849,430,30,2185,13,6,10,3,0,0,0,0,0,0,False,False,False,0,1,2021-02-25T15:37:23.633,0,,
2020,4,2849,435,30,6414,3,6,10,4,0,0,0,0,0,0,False,False,False,0,1,2020-10-05T12:51:37.38,0,,
2020,4,2849,440,30,4523,13,17,8,15,0,0,0,0,0,0,False,False,False,0,3,2020-10-08T16:19:58.04,0,,
2020,4,2849,445,30,793,13,4,4,12,0,0,0,0,0,0,False,False,False,0,3,2020-10-08T16:18:45.74,0,,
2020,4,2849,460,30,63,13,6,4,6,0,0,0,0,0,0,False,False,False,0,4,2020-10-05T13:00:14.41,0,,
2020,4,2849,470,30,793,2,12,4,6,6,0,6,0,6,6,True,False,False,0,3,2020-10-05T13:02:47.057,6,,
2020,4,2849,525,30,793,2,4,3,7,9,2,9,0,9,0,False,False,False,0,2,2020-10-08T16:20:10.07,9,,
2020,4,2849,530,30,6414,2,48,9,-4,5,9,5,0,5,0,False,False,False,0,1,2020-10-05T13:20:55.48,5,,
2020,4,2849,540,30,6419,2,2,10,7,10,3,10,0,10,0,False,False,False,0,2,2020-10-05T13:23:16.703,10,,
2020,4,2849,545,30,793,2,4,3,11,12,1,12,0,12,0,False,False,False,0,2,2020-10-05T13:24:50.2,12,,
2020,4,2849,555,30,4523,2,17,8,28,28,0,28,0,28,6,False,False,False,0,4,2020-10-05T13:27:21.577,28,,
2020,4,2849,570,26,4282,2,53,9,-3,29,32,21,8,21,0,False,False,False,0,4,2020-10-08T16:38:24.83,29,,
2020,4,2849,580,26,4282,2,17,9,7,10,3,10,0,10,0,False,False,False,0,4,2020-10-05T14:59:49.61,10,,
2020,4,2849,585,26,309,2,3,5,9,9,0,9,0,9,0,False,False,False,0,3,2020-10-08T15:05:55.66,9,,
2020,4,2849,610,26,309,2,4,3,6,9,3,6,3,6,0,False,False,False,1,2,2021-03-03T16:43:18.643,9,,
2020,4,2849,615,26,309,2,50,5,-1,1,2,1,0,1,0,False,False,False,0,2,2021-02-16T21:25:33.44,1,,
2020,4,2849,620,26,309,2,13,10,4,7,3,7,0,7,0,False,False,False,0,3,2020-10-05T13:48:43.377,7,,
2020,4,2849,630,30,7268,2,19,2,43,44,1,44,0,44,0,False,False,False,0,4,2020-10-08T16:20:43.33,44,,
2020,4,2849,635,30,7268,2,35,1,16,19,3,19,0,19,6,False,False,False,0,3,2020-10-05T13:53:00.593,19,,
2020,4,2849,650,26,309,2,30,10,-2,3,5,3,0,3,0,True,False,False,0,4,2021-02-16T21:26:31.27,3,,
2020,4,2849,655,26,309,13,17,9,12,0,0,0,0,0,0,False,False,False,0,3,2020-10-08T15:05:55.66,0,,
2020,4,2849,660,26,7453,2,19,8,30,72,42,33,39,33,6,False,False,False,1,3,2020-10-08T16:40:57.497,72,,
2020,4,2849,680,30,7268,2,6,9,5,6,1,6,0,6,0,False,False,False,0,2,2020-10-05T15:36:22.19,6,,
2020,4,2849,685,30,7268,2,51,10,-2,7,9,2,5,2,0,False,False,False,1,3,2021-02-16T21:27:13.19,7,,
2020,4,2849,690,30,4523,2,35,10,14,17,3,17,0,17,0,True,False,False,0,4,2020-10-05T14:09:03.43,17,,
2020,4,2849,695,30,793,3,19,6,42,0,0,0,0,0,0,False,False,False,0,2,2020-10-05T15:22:37.11,0,,
2020,4,2849,700,30,63,13,17,8,30,0,0,0,0,0,0,False,False,False,0,4,2020-10-05T15:36:38.787,0,,
2020,4,2849,705,30,793,2,9,2,40,48,8,48,0,48,0,False,False,False,0,3,2020-10-05T14:15:00.983,48,,
2020,4,2849,720,30,7891,2,46,3,2,9,7,7,2,7,6,False,False,False,1,1,2020-10-21T15:21:13.853,9,,
2020,4,2849,745,26,7695,2,46,3,2,8,6,8,0,8,0,False,False,False,0,1,2020-10-08T16:43:12.527,8,,
2020,4,2849,760,30,7268,2,18,3,-2,7,9,7,0,7,0,False,False,False,0,2,2020-10-08T16:43:46.12,7,,
2020,4,2849,775,30,7891,2,4,9,2,13,11,10,3,10,0,True,False,False,0,1,2020-10-05T14:33:16.777,13,,
2020,4,2849,785,30,63,2,9,2,27,29,2,29,0,29,0,False,False,False,0,4,2020-10-05T14:36:18.077,29,,
2020,4,2849,810,30,7891,3,6,4,2,0,0,0,0,0,0,False,False,False,0,1,2020-10-05T14:41:38.607,0,,
2020,4,2849,830,26,6301,2,44,3,-5,3,8,3,0,3,0,False,False,False,0,1,2020-10-05T14:45:40.61,3,,
2020,4,2849,835,26,309,13,6,8,24,0,0,0,0,0,0,False,False,False,0,3,2020-10-06T00:27:41.933,0,,
2020,7,2850,10,25,4583,13,4,10,5,0,0,0,0,0,0,False,False,False,0,3,2020-10-30T18:49:49.137,0,,0.0
2020,7,2850,15,25,4583,2,4,10,5,7,2,7,0,7,0,True,False,False,0,3,2020-10-26T10:02:28.363,7,,0.0
2020,7,2850,20,25,7060,2,5,3,3,14,11,14,0,14,0,False,False,False,0,3,2020-10-26T10:05:50.537,14,,0.0
2020,7,2850,25,25,4583,2,5,5,6,6,0,6,0,6,0,False,False,False,0,3,2020-10-26T10:08:16.38,6,,0.0
2020,7,2850,30,25,6259,2,34,4,-4,9,13,9,0,9,0,True,False,False,0,3,2020-10-26T10:11:39.067,9,,0.0
2020,7,2850,40,25,4587,2,2,9,3,4,1,4,0,4,0,False,False,False,0,2,2020-10-26T17:47:20.38,4,,0.0
2020,7,2850,50,25,181,2,50,9,-2,5,7,2,3,2,0,False,False,False,0,3,2020-10-26T10:21:23.013,5,,3.0
2020,7,2850,55,25,7060,2,13,9,1,14,13,11,3,11,0,False,False,False,1,2,2020-10-26T10:26:02.337,14,,3.0
2020,7,2850,75,25,7060,13,29,3,11,0,0,0,0,0,0,False,False,False,0,2,2021-02-25T14:33:51.423,0,,0.0
2020,7,2850,80,25,609,2,46,9,1,9,8,4,5,4,0,False,False,False,0,4,2020-10-27T21:32:22.93,9,,5.0
2020,7,2850,90,25,4587,2,47,10,0,1,1,1,0,1,6,False,False,False,0,1,2021-02-17T13:14:00.443,1,,
2020,7,2850,95,25,609,2,12,3,3,5,2,3,2,3,0,False,False,False,0,4,2020-10-26T10:48:40.037,5,,2.0
2020,7,2850,100,25,7060,2,19,3,11,11,0,11,0,11,6,False,False,False,0,2,2020-10-26T10:55:10.237,11,,0.0
2020,7,2850,120,31,6793,13,2,10,10,0,0,0,0,0,0,False,False,False,0,3,2020-10-30T19:47:12.653,0,,0.0
2020,7,2850,130,31,5080,13,5,5,8,0,0,0,0,0,0,False,False,False,0,2,2020-10-30T20:31:02.657,0,,0.0
2020,7,2850,150,25,609,2,35,7,19,22,3,19,3,19,0,False,False,False,0,3,2021-02-17T13:14:56.087,22,,3.0
2020,7,2850,160,25,4583,2,46,3,2,2,0,2,0,2,0,False,False,False,0,3,2020-10-26T11:31:49.727,2,,0.0
2020,7,2850,175,25,7060,3,4,10,2,0,0,0,0,0,0,True,False,False,0,2,2020-10-27T21:30:44.747,0,,0.0
2020,7,2850,180,25,7666,2,34,4,-4,-5,-1,-5,0,-5,0,True,True,False,0,2,2020-10-26T17:33:09.59,-2,,0.0
2020,7,2850,185,25,4583,2,17,7,19,21,2,21,0,21,0,False,False,False,0,3,2021-02-17T13:15:48.47,21,,0.0
2020,7,2850,200,25,4587,3,47,5,-1,0,0,0,0,0,0,False,False,False,0,1,2020-10-26T11:50:55.03,0,,0.0
2020,7,2850,220,31,5096,13,35,4,9,0,0,0,0,0,0,False,False,False,0,4,2020-10-26T12:04:07.29,0,,0.0
2020,7,2850,235,31,6793,2,2,9,6,13,7,10,3,10,0,False,False,False,0,2,2021-02-17T13:16:44.307,13,,3.0
2020,7,2850,250,31,2675,2,4,4,14,19,5,19,0,19,0,False,False,False,0,2,2021-02-17T13:18:39.88,19,,0.0
2020,7,2850,260,31,5080,2,2,4,6,7,1,6,1,6,0,False,False,False,0,3,2020-10-26T12:25:13.59,7,,1.0
2020,7,2850,280,31,5080,2,13,10,4,4,0,4,0,4,6,True,False,False,0,3,2020-10-26T12:33:06.23,4,,0.0
2020,7,2850,305,25,4587,2,44,3,5,18,13,17,1,17,0,False,False,False,0,1,2020-10-26T12:43:11.183,18,,1.0
2020,7,2850,310,25,4587,13,44,3,-3,0,0,0,0,0,0,False,False,False,0,1,2020-10-30T20:34:15.743,0,,0.0
2020,7,2850,315,25,7060,13,19,2,25,0,0,0,0,0,0,False,False,False,0,2,2020-10-26T12:45:25.98,0,,
2020,7,2850,320,25,609,13,24,6,16,0,0,0,0,0,0,False,False,False,0,4,2020-10-26T17:16:53.93,0,,0.0
2020,7,2850,325,25,4583,13,11,5,14,0,0,0,0,0,0,False,False,False,0,3,2020-10-26T12:52:34.68,0,,0.0
2020,7,2850,360,31,5080,13,4,4,10,0,0,0,0,0,0,False,False,False,0,3,2020-10-26T13:00:59.557,0,,0.0
2020,7,2850,375,25,7060,2,18,3,-1,6,7,3,3,3,0,False,False,False,0,2,2020-10-26T13:21:18.157,6,,3.0
2020,7,2850,380,25,7060,2,13,10,2,9,7,3,6,3,6,False,False,False,1,2,2020-10-26T13:23:12.847,9,,6.0
2020,7,2850,395,31,5080,2,4,10,4,4,0,4,0,4,0,False,False,False,0,2,2020-10-26T13:25:52.99,4,,0.0
2020,7,2850,400,31,6793,13,20,6,30,0,0,0,0,0,0,False,False,False,0,2,2020-10-30T20:36:53.403,0,,0.0
2020,7,2850,405,31,6724,2,32,9,1,3,2,3,0,3,0,False,False,False,0,4,2020-10-26T13:31:09.003,3,,0.0
2020,7,2850,415,31,2865,13,12,7,17,0,0,0,0,0,0,False,False,False,0,4,2020-10-30T18:11:00.723,0,,0.0
2020,7,2850,430,25,7060,13,19,2,37,0,0,0,0,0,0,False,False,False,0,2,2020-10-26T13:47:58.83,0,,0.0
2020,7,2850,450,31,5080,13,6,8,16,0,0,0,0,0,0,False,False,False,0,2,2020-10-30T20:38:50.53,0,,0.0
2020,7,2850,470,25,7060,2,4,3,6,7,1,7,0,7,0,False,False,False,0,2,2020-10-26T14:04:15.753,7,,0.0
2020,7,2850,475,25,7666,13,19,2,26,0,0,0,0,0,0,False,False,False,0,2,2020-10-26T14:04:57.967,0,,
2020,7,2850,495,25,609,13,8,10,12,0,0,0,0,0,0,False,False,False,0,3,2020-10-30T19:38:12.137,0,,0.0
2020,7,2850,515,31,6793,2,2,4,8,73,65,73,0,73,6,False,False,False,1,2,2020-10-26T14:18:56.717,73,,0.0
2020,7,2850,530,25,7665,3,48,10,-3,0,0,0,0,0,0,False,False,False,0,1,2020-10-30T18:55:32.577,0,,0.0
2020,7,2850,540,25,7060,2,13,9,1,7,6,5,2,5,0,False,False,False,0,2,2021-02-17T13:19:41.833,7,,2.0
2020,7,2850,560,31,6724,2,31,4,4,4,0,4,0,4,0,False,False,False,0,4,2020-10-30T20:39:32.247,4,,0.0
2020,7,2850,570,25,609,2,13,9,3,5,2,4,1,4,0,False,False,False,0,4,2020-10-26T17:15:52.623,5,,1.0
2020,7,2850,575,25,4583,2,47,5,0,2,2,0,2,0,0,False,False,False,0,3,2020-10-26T14:37:12.717,2,,2.0
2020,7,2850,580,25,4583,2,51,9,-1,7,8,1,6,1,0,False,False,False,0,3,2020-10-26T14:39:18.47,7,,6.0
2020,7,2850,585,25,7060,13,4,9,0,0,0,0,0,0,0,False,False,False,0,2,2021-03-05T19:31:00,0,,0.0
2020,7,2850,595,31,5096,13,5,10,3,0,0,0,0,0,0,True,False,False,0,4,2020-10-26T14:44:35.323,0,,0.0
2020,7,2850,600,31,2675,13,4,8,16,0,0,0,0,0,0,False,False,False,0,3,2020-10-26T14:47:18.15,0,,0.0
2020,7,2850,620,25,181,2,46,3,2,9,7,7,2,7,0,False,False,False,0,4,2020-10-26T14:51:32.463,9,,2.0
2020,7,2850,630,25,7060,13,4,9,10,0,0,0,0,0,0,False,False,False,0,2,2020-10-26T14:54:29.637,0,,0.0
2020,7,2850,635,25,4583,13,4,10,9,0,0,0,0,0,0,False,False,False,0,3,2020-10-30T20:45:56.487,0,,0.0
2020,7,2850,665,31,5080,2,5,5,6,6,0,6,0,6,0,False,False,False,0,3,2020-10-30T20:08:40.33,6,,0.0
2020,7,2850,680,31,6793,2,2,4,10,20,10,15,5,15,0,False,False,False,0,2,2020-10-26T15:16:42.003,20,,5.0
2020,7,2850,695,31,5096,13,7,10,1,0,0,0,0,0,0,False,False,False,0,4,2021-02-25T14:34:41.36,0,,0.0
2020,7,2850,710,31,5080,13,31,9,1,0,0,0,0,0,0,False,False,False,0,3,2020-10-26T15:31:11.853,0,,
2020,7,2850,730,25,609,2,46,3,2,2,0,2,0,2,0,False,False,False,0,4,2020-10-26T15:39:31.263,2,,0.0
2020,7,2850,735,25,609,2,5,3,6,7,1,7,0,7,0,False,False,False,0,2,2020-10-26T15:41:31.817,7,,0.0
2020,7,2850,740,25,4583,2,13,9,1,5,4,3,2,3,0,False,False,False,0,3,2020-10-30T19:02:59.993,5,,2.0
2020,7,2850,750,25,4583,13,4,10,11,0,0,0,0,0,0,False,False,False,0,3,2020-10-30T18:58:38.793,0,,0.0
2020,7,2850,755,25,4583,2,13,10,3,7,4,5,2,5,0,False,False,False,0,3,2020-10-30T19:40:39.583,7,,2.0
2020,7,2850,760,25,4583,2,9,6,16,28,12,23,5,23,0,False,False,False,0,3,2020-10-26T16:00:21.947,28,,5.0
2020,7,2850,765,25,7060,13,29,3,10,0,0,0,0,0,0,False,False,False,0,2,2020-10-30T20:23:34.537,0,,0.0
2020,7,2850,770,25,4587,2,48,10,-4,7,11,7,0,7,0,False,False,False,0,1,2020-10-28T18:04:20.81,7,,0.0
2020,7,2850,775,25,7060,2,13,10,2,4,2,3,1,3,0,False,False,False,0,3,2020-10-30T20:24:50.92,4,,1.0
2020,7,2850,780,25,6259,2,34,4,-4,3,7,0,3,0,0,True,False,False,0,2,2020-10-28T18:03:59.027,3,,3.0
2020,7,2850,785,25,6486,3,4,5,5,0,0,0,0,0,0,False,False,False,0,2,2020-10-28T18:03:44.64,0,,0.0
2020,7,2850,790,25,7060,2,2,9,3,8,5,6,2,6,0,False,False,False,0,2,2020-10-26T16:12:52.573,8,,2.0
2020,7,2850,810,25,7666,2,52,10,0,1,1,1,0,1,0,False,False,False,0,3,2021-03-04T16:14:10.017,1,,
2020,7,2850,815,25,4583,13,19,1,19,0,0,0,0,0,0,False,False,False,0,4,2020-10-26T16:25:58.913,0,,0.0
2020,7,2850,820,31,6793,2,2,10,9,9,0,9,0,9,0,False,False,False,0,3,2020-10-30T20:25:35.657,9,,0.0
2020,7,2850,830,31,6793,2,4,3,7,17,10,17,0,17,0,False,False,False,0,2,2020-10-26T16:32:34.27,17,,0.0
2020,7,2850,835,31,5096,2,4,10,4,9,5,6,3,6,0,False,False,False,0,3,2020-10-26T16:32:59.613,9,,3.0
2020,7,2850,845,31,3504,2,47,5,-1,-1,0,-1,0,-1,0,False,False,False,0,1,2020-10-26T16:34:36.88,-1,,0.0
2020,7,2850,850,31,5080,2,4,5,5,7,2,7,0,7,0,False,False,False,0,2,2020-10-26T16:36:27.937,7,,0.0
2020,7,2850,855,31,3504,2,48,10,-2,-2,0,-2,0,-2,0,False,False,False,0,1,2020-10-26T16:38:22.6,-2,,0.0
2020,7,2850,860,31,2675,13,35,10,9,0,0,0,0,0,0,False,False,False,0,3,2020-10-26T16:40:22.907,0,,0.0
2020,7,2850,865,31,6793,2,7,2,17,21,4,21,0,21,0,False,False,False,0,3,2020-10-26T16:42:48.26,21,,0.0
2020,7,2850,875,31,5080,2,16,10,5,7,2,5,2,5,0,False,False,False,0,3,2020-10-26T16:48:54.407,7,,2.0
2020,7,2850,880,31,5080,13,19,2,28,0,0,0,0,0,0,False,False,False,0,2,2020-10-26T16:50:20.947,0,,0.0
2020,4,2851,15,32,3885,2,5,5,4,6,2,6,0,6,0,True,False,False,0,3,2021-02-15T14:53:46.583,6,,
2020,4,2851,25,32,7807,13,47,5,-1,0,0,0,0,0,0,False,False,False,0,1,2020-10-05T10:29:03.29,0,,
2020,4,2851,30,32,7128,13,20,2,24,0,0,0,0,0,0,False,False,False,0,2,2020-10-05T10:31:12.677,0,,
2020,4,2851,35,32,6430,2,50,5,0,9,9,7,2,7,0,False,False,False,0,2,2021-02-15T14:54:50.697,9,,
2020,4,2851,70,3,6454,2,5,5,10,10,0,10,0,10,0,False,False,False,0,3,2020-10-09T18:48:29.22,10,,
2020,4,2851,95,3,7671,2,12,9,-3,1,4,0,1,0,0,False,False,False,0,1,2021-03-03T15:29:39.787,1,,
2020,4,2851,115,32,7807,2,13,9,3,17,14,16,1,16,0,False,False,False,1,3,2020-10-05T11:09:11.473,17,,
2020,4,2851,125,32,3885,2,45,5,-2,-2,0,-2,0,-2,0,True,True,True,0,2,2020-10-05T11:12:39.14,0,,
2020,4,2851,130,3,6936,2,12,8,27,33,6,27,6,27,0,False,False,False,1,2,2021-03-08T19:12:14.69,33,,
2020,4,2851,155,32,8237,2,45,5,-3,3,6,2,1,2,0,True,False,False,0,2,2020-10-05T11:26:28.83,3,,
2020,4,2851,160,32,1427,13,39,4,4,0,0,0,0,0,0,False,False,False,0,3,2021-02-18T15:52:08.19,0,,
2020,4,2851,180,3,6936,13,8,7,47,0,0,0,0,0,0,False,False,False,0,2,2020-10-05T11:36:17.27,0,,
2020,4,2851,185,3,6935,13,19,2,22,0,0,0,0,0,0,False,False,False,0,2,2020-10-05T11:38:57.247,0,,
2020,4,2851,195,32,7128,2,3,3,11,11,0,11,0,11,0,False,False,False,0,3,2020-10-05T11:45:19.233,11,,
2020,4,2851,210,32,1427,2,13,4,3,8,5,6,2,6,0,False,False,False,0,3,2020-10-05T11:53:38.613,8,,
2020,4,2851,215,32,7807,2,50,5,-1,18,19,10,8,10,0,False,False,False,1,2,2020-10-09T18:42:44.93,18,,
2020,4,2851,225,32,1427,3,35,8,15,0,0,0,0,0,0,False,False,False,0,3,2021-02-15T15:02:51.787,0,,
2020,4,2851,230,32,7128,13,4,10,5,0,0,0,0,0,0,False,False,False,0,3,2020-10-05T12:02:08.647,0,,
2020,4,2851,265,32,7128,2,2,9,5,11,6,11,0,11,0,False,False,False,0,2,2020-10-05T12:13:14.5,11,,
2020,4,2851,270,32,8237,2,45,5,-7,1,8,-1,2,-1,0,False,False,False,0,3,2021-02-15T15:04:50.573,1,,
2020,4,2851,275,32,1791,2,4,4,12,13,1,13,0,13,0,False,False,False,0,3,2020-10-09T17:44:46.997,13,,
2020,4,2851,280,32,7128,2,50,9,-3,-1,2,-3,2,-3,0,False,False,False,0,2,2020-10-05T12:20:32.227,-1,,
2020,4,2851,285,32,3885,13,9,6,18,0,0,0,0,0,0,False,False,False,0,3,2020-10-05T12:23:01.157,0,,
2020,4,2851,290,32,7807,2,50,3,-2,40,42,37,3,37,0,True,False,False,0,2,2020-10-09T19:09:20.94,40,,
2020,4,2851,325,3,6936,2,6,7,23,31,8,31,0,31,0,False,False,False,0,2,2020-10-09T18:56:06.443,31,,
2020,4,2851,335,3,7672,13,12,2,17,0,0,0,0,0,0,False,False,False,0,2,2020-10-05T12:42:51.233,0,,
2020,4,2851,340,3,6936,13,7,6,26,0,0,0,0,0,0,False,False,False,0,3,2020-10-09T17:44:46.997,0,,
2020,4,2851,345,3,6935,2,4,5,9,15,6,13,2,13,0,False,False,False,0,2,2020-10-05T16:05:41.977,15,,
2020,4,2851,355,3,902,2,4,4,3,3,0,3,0,3,0,False,False,False,0,1,2020-10-09T18:57:19.43,3,,
2020,4,2851,365,3,7671,3,51,10,-5,0,0,0,0,0,0,True,False,False,0,3,2020-10-05T12:52:44.87,0,,
2020,4,2851,370,3,6454,2,12,6,25,25,0,25,0,25,6,False,False,False,0,3,2020-10-05T12:54:42.447,25,,
2020,4,2851,390,32,7128,2,4,3,4,4,0,4,0,4,0,False,False,False,0,2,2020-10-05T13:01:10.347,4,,
2020,4,2851,395,32,7128,2,13,10,3,3,0,3,0,3,0,False,False,False,0,3,2020-10-05T13:00:45.197,3,,
2020,4,2851,430,3,6936,13,19,8,43,0,0,0,0,0,0,False,False,False,0,3,2020-10-05T13:07:17.7,0,,
2020,4,2851,435,3,6935,13,5,3,14,0,0,0,0,0,0,False,False,False,0,2,2020-10-09T19:08:18.737,0,,
2020,4,2851,440,32,3885,2,6,9,1,12,11,10,2,10,0,False,False,False,0,1,2020-10-05T13:12:00.1,12,,
2020,4,2851,450,32,3885,2,51,10,-6,0,6,-2,2,-2,0,False,False,False,0,1,2020-10-05T13:14:22.59,0,,
2020,4,2851,470,3,6935,2,4,10,5,13,8,10,3,10,0,False,False,False,0,3,2020-10-09T19:09:10.017,13,,
2020,4,2851,480,3,2976,2,5,9,6,9,3,7,2,7,0,True,False,False,0,3,2020-10-09T17:44:46.997,9,,
2020,4,2851,505,3,6936,2,4,9,6,18,12,18,0,18,0,False,False,False,0,2,2020-10-05T13:55:09.107,18,,
2020,4,2851,515,3,6454,2,17,8,17,22,5,22,0,22,6,False,False,False,0,4,2021-02-25T15:45:24.307,22,,
2020,4,2851,535,32,7807,2,4,10,0,7,7,7,0,7,0,False,False,False,0,1,2020-10-05T14:04:57.497,7,,
2020,4,2851,540,32,3708,13,46,9,0,0,0,0,0,0,0,False,False,False,0,1,2020-10-05T14:06:25.193,0,,
2020,4,2851,545,32,7128,13,12,9,3,0,0,0,0,0,0,False,False,False,0,3,2020-10-05T14:09:38.843,0,,
2020,4,2851,550,32,3885,2,32,5,1,4,3,4,0,4,0,False,False,False,0,3,2020-10-05T14:12:13.583,4,,
2020,4,2851,565,3,6936,2,2,10,3,4,1,4,0,4,0,False,False,False,0,2,2020-10-05T14:15:12.977,4,,
2020,4,2851,590,32,7128,13,2,9,7,0,0,0,0,0,0,False,False,False,0,3,2020-10-05T14:22:58.257,0,,
2020,4,2851,595,32,1791,2,4,9,4,4,0,4,0,4,0,False,False,False,0,2,2020-10-05T14:25:14.267,4,,
2020,4,2851,600,32,7128,2,35,1,18,19,1,18,1,18,0,False,False,False,1,3,2021-02-15T15:04:34.617,19,,
2020,4,2851,605,32,3885,2,50,10,-1,4,5,3,1,3,0,True,False,False,0,2,2020-10-05T14:29:46.97,4,,
2020,4,2851,610,32,7128,2,2,9,2,13,11,11,2,11,0,False,False,False,0,2,2020-10-05T14:31:01.387,13,,
2020,4,2851,620,32,6430,2,6,9,8,8,0,8,0,8,0,False,False,False,0,2,2020-10-05T14:34:02.5,8,,
2020,4,2851,625,32,8237,13,13,10,5,0,0,0,0,0,0,False,False,False,0,3,2020-10-05T14:36:05.047,0,,
2020,4,2851,630,32,7128,2,47,5,3,3,0,3,0,3,0,False,False,False,0,3,2020-10-05T14:37:26.097,3,,
2020,4,2851,635,32,1791,2,50,9,-3,8,11,5,3,5,0,False,False,False,0,3,2021-03-04T15:21:53.393,8,,
2020,4,2851,650,32,8237,2,6,10,5,11,6,8,3,8,0,False,False,False,0,3,2020-10-05T14:44:03.547,11,,
2020,4,2851,665,32,3885,2,50,3,-1,11,12,6,5,6,0,True,False,False,1,2,2021-03-03T16:49:58.763,11,,
2020,4,2851,670,32,3885,2,13,4,4,9,5,7,2,7,0,True,False,False,0,2,2020-10-05T14:49:58.343,9,,
2020,4,2851,675,32,8237,2,26,5,4,5,1,3,2,3,0,False,False,False,1,2,2020-10-05T15:59:10.237,5,,
2020,4,2851,690,3,7672,2,4,10,2,4,2,2,2,2,0,True,False,False,0,3,2020-10-05T14:59:34.113,4,,
2020,4,2851,695,3,2688,2,6,4,10,10,0,10,0,10,0,False,False,False,0,3,2021-02-15T15:06:18.793,10,,
2020,4,2851,725,3,2688,2,2,4,10,10,0,10,0,10,0,False,False,False,0,3,2020-10-09T17:44:46.997,10,,
2020,4,2851,740,32,7128,2,2,9,8,16,8,14,2,14,0,False,False,False,0,2,2020-10-05T15:20:01.877,16,,
2020,4,2851,745,32,1791,3,6,1,15,0,0,0,0,0,0,False,False,False,0,2,2020-10-05T15:23:00.71,0,,
2020,4,2851,750,32,1791,2,50,5,0,4,4,4,0,4,0,False,False,False,0,2,2020-10-05T15:24:57.1,4,,
2020,4,2851,755,32,1427,13,5,5,10,0,0,0,0,0,0,False,False,False,0,3,2020-10-05T15:27:11.693,0,,
2020,4,2851,775,3,6936,13,19,6,37,0,0,0,0,0,0,False,False,False,0,2,2021-03-05T17:38:23.687,0,,
2020,4,2851,780,32,7128,2,9,6,37,39,2,37,2,37,0,False,False,False,0,3,2020-10-05T15:35:58.78,39,,
2020,4,2852,10,21,4422,3,30,10,0,0,0,0,0,0,0,True,False,False,0,4,2021-02-16T18:51:27.83,0,,
2020,4,2852,20,21,4422,2,12,10,-7,-7,0,-7,0,-7,0,False,False,False,0,4,2021-03-08T19:14:25.643,-7,,
2020,4,2852,30,29,4866,2,32,10,1,9,8,5,4,5,0,False,False,False,0,4,2020-10-09T20:17:27.42,9,,
2020,4,2852,40,29,7378,2,44,3,-3,16,19,16,0,16,0,False,False,False,1,1,2020-10-05T10:45:45.093,16,,
2020,4,2852,50,29,4866,3,8,9,14,0,0,0,0,0,0,True,False,False,0,3,2020-10-06T20:43:06.17,0,,
2020,4,2852,55,29,3356,2,44,3,5,8,3,5,3,5,0,False,False,False,0,2,2020-10-09T15:39:03.253,8,,
2020,4,2852,60,29,3356,2,45,5,0,8,8,8,0,8,0,False,False,False,0,1,2020-10-05T10:56:30.337,8,,
2020,4,2852,70,29,3398,2,30,3,0,8,8,7,1,7,0,False,False,False,0,4,2020-10-09T14:43:13.26,8,,
2020,4,2852,125,21,4422,2,53,10,-4,8,12,5,3,5,0,False,False,False,0,4,2020-10-05T11:19:56.683,8,,
2020,4,2852,135,29,4850,2,32,10,3,10,7,8,2,8,0,False,True,True,0,4,2020-10-05T11:23:34.66,10,,
2020,4,2852,145,21,6444,2,6,8,16,17,1,17,0,17,0,False,False,False,0,3,2020-10-09T15:40:44.44,17,,
2020,4,2852,155,21,713,2,47,5,-2,-2,0,-2,0,-2,0,False,False,False,0,1,2020-10-05T11:33:31.487,-2,,
2020,4,2852,170,21,2288,13,6,10,8,0,0,0,0,0,0,False,False,False,0,2,2020-10-09T21:22:13.923,0,,
2020,4,2852,190,29,7828,13,7,6,33,0,0,0,0,0,0,False,False,False,0,3,2020-10-09T20:57:03.12,0,,
2020,4,2852,230,29,4906,2,32,9,3,5,2,3,2,3,0,False,False,False,0,4,2020-10-05T12:10:12.8,5,,
2020,4,2852,235,29,4875,2,4,3,4,7,3,7,0,7,0,False,True,False,0,2,2020-10-05T16:36:50.537,7,,
2020,4,2852,240,29,4875,2,5,3,11,11,0,11,0,11,0,False,False,False,0,3,2020-10-05T12:12:57.423,11,,
2020,4,2852,245,29,3398,2,5,5,5,5,0,5,0,5,0,False,False,False,0,3,2020-10-09T15:47:27.853,5,,
2020,4,2852,250,29,3398,13,4,10,5,0,0,0,0,0,0,False,False,False,0,3,2020-10-09T15:47:52.21,0,,
2020,4,2852,255,29,1958,2,39,4,4,4,0,4,0,4,0,False,False,False,0,3,2020-10-05T12:18:06.547,4,,
2020,4,2852,290,29,3356,2,48,9,-5,-2,3,-2,0,-2,0,False,False,False,0,1,2020-10-05T12:30:51.713,-2,,
2020,4,2852,295,29,1958,2,50,10,-4,0,4,0,0,0,0,False,False,False,0,3,2021-03-04T15:28:11.387,0,,
2020,4,2852,320,21,576,2,5,5,3,10,7,10,0,10,0,False,False,False,1,3,2020-10-05T12:43:17.64,10,,
2020,4,2852,345,21,576,2,39,4,5,12,7,9,3,9,0,False,False,False,0,3,2020-10-05T12:47:12.69,12,,
2020,4,2852,350,21,7090,13,4,3,9,0,0,0,0,0,0,False,False,False,0,2,2020-10-05T12:49:12.53,0,,
2020,4,2852,355,21,5015,3,3,3,11,0,0,0,0,0,0,False,False,False,0,2,2020-10-05T12:51:51.41,0,,
2020,4,2852,370,21,2288,2,44,3,1,4,3,4,0,4,0,False,False,False,0,1,2020-10-05T12:55:33.86,4,,
2020,4,2852,375,21,4422,2,13,5,4,6,2,6,0,6,0,False,False,False,0,3,2020-10-05T12:57:06.87,6,,
2020,4,2852,380,21,4422,13,5,5,10,0,0,0,0,0,0,False,False,False,0,3,2020-10-09T20:57:13.04,0,,
2020,4,2852,395,29,1958,13,4,10,11,0,0,0,0,0,0,False,False,False,0,3,2020-10-09T21:18:42.167,0,,
2020,4,2852,400,29,1958,2,8,7,15,15,0,15,0,15,0,False,False,False,0,2,2020-10-05T13:07:31.923,15,,
2020,4,2852,405,29,4866,2,26,10,-1,-1,0,-1,0,-1,0,False,False,False,0,4,2020-10-05T13:14:57.873,-1,,
2020,4,2852,415,29,3356,2,28,4,2,4,2,4,0,4,0,False,False,False,0,1,2020-10-05T13:17:35.613,4,,
2020,4,2852,430,21,4422,2,46,3,1,11,10,2,9,2,0,False,False,False,1,4,2020-10-06T20:56:03.007,11,,
2020,4,2852,435,21,576,2,51,5,-1,-1,0,-1,0,-1,0,False,False,False,0,3,2020-10-05T13:30:58.287,-1,,
2020,4,2852,440,21,6444,2,4,5,6,8,2,6,2,6,0,False,False,False,0,2,2020-10-05T13:32:20.533,8,,
2020,4,2852,445,21,4422,2,13,9,2,12,10,12,0,12,0,False,False,False,0,3,2020-10-05T13:38:51.15,12,,
2020,4,2852,460,21,7090,13,35,7,25,0,0,0,0,0,0,False,False,False,0,3,2020-10-05T13:45:56.26,0,,
2020,4,2852,475,29,1958,2,13,9,5,7,2,6,1,6,0,False,False,False,0,3,2020-10-09T14:42:00.53,7,,
2020,4,2852,485,29,4866,2,31,4,-1,-1,0,-1,0,-1,0,True,False,False,0,4,2020-10-06T20:43:35.533,-1,,
2020,4,2852,490,29,4875,13,7,6,21,0,0,0,0,0,0,False,False,False,0,2,2020-10-09T20:15:31.1,0,,
2020,4,2852,505,21,7090,13,3,5,12,0,0,0,0,0,0,False,False,False,0,2,2020-10-05T14:04:16.897,0,,
2020,4,2852,515,21,7226,2,31,9,8,10,2,10,0,10,0,False,False,False,0,4,2020-10-06T20:56:24.3,10,,
2020,4,2852,525,21,7090,2,2,9,7,8,1,8,0,8,0,False,False,False,0,2,2020-10-09T20:57:21.77,8,,
2020,4,2852,540,21,713,2,44,3,-3,9,12,9,0,9,0,False,False,False,0,1,2020-10-05T14:18:54.173,9,,
2020,4,2852,555,21,7090,2,4,10,6,7,1,7,0,7,0,False,False,False,0,3,2020-10-05T14:27:50.653,7,,
2020,4,2852,560,21,7090,13,9,5,9,0,0,0,0,0,0,False,False,False,0,2,2020-10-05T14:29:15.11,0,,
2020,4,2852,580,29,3356,2,47,5,0,1,1,1,0,1,0,False,False,False,0,1,2020-10-05T14:37:22.443,1,,
2020,4,2852,585,29,4866,13,5,6,15,0,0,0,0,0,0,False,False,False,0,3,2020-10-09T15:02:20.43,0,,
2020,4,2852,610,21,576,2,51,3,-6,-1,5,-1,0,-1,0,True,False,False,0,2,2020-10-09T20:57:32.2,-1,,
2020,4,2852,620,29,1958,2,44,3,-5,2,7,-1,3,-1,0,True,False,False,0,3,2020-10-05T14:54:52.18,2,,
2020,4,2852,625,29,4866,2,5,3,7,7,0,7,0,7,0,True,False,False,0,3,2020-10-05T14:55:59.367,7,,
2020,4,2852,635,29,1958,2,39,4,7,8,1,8,0,8,0,False,False,False,0,3,2020-10-09T14:45:46.49,8,,
2020,4,2852,640,29,3398,2,4,10,5,7,2,8,-1,8,0,False,False,False,0,4,2020-10-09T14:43:54.79,7,,
2020,4,2852,645,29,3356,13,6,10,6,0,0,0,0,0,0,False,False,False,0,2,2020-10-09T15:03:34.32,0,,
2020,4,2852,650,29,4875,2,4,5,7,7,0,7,0,7,0,False,False,False,0,2,2020-10-05T15:06:22.047,7,,
2020,4,2852,655,29,4866,2,2,9,14,55,41,55,0,55,6,False,False,False,1,3,2020-10-09T15:04:26.067,55,,
2020,4,2852,670,21,6444,2,4,3,6,9,3,6,3,6,0,False,False,False,0,2,2020-10-05T15:30:35.79,9,,
2020,4,2852,685,21,713,2,4,4,4,15,11,13,2,13,0,False,False,False,0,1,2020-10-05T15:51:36.06,15,,
2020,4,2852,695,21,713,2,47,10,0,13,13,13,0,13,0,False,False,False,0,1,2020-10-09T20:57:44.29,13,,
2020,4,2852,705,21,4422,13,4,10,4,0,0,0,0,0,0,False,False,False,0,2,2020-10-05T15:52:55.63,0,,
2020,4,2852,710,21,2288,2,4,4,2,4,2,4,0,4,0,False,False,False,0,1,2020-10-05T15:55:56.283,4,,
2020,4,2852,715,21,576,13,4,10,10,0,0,0,0,0,0,False,False,False,0,3,2020-10-05T15:58:24.773,0,,
2020,4,2852,750,21,7090,2,6,8,18,33,15,33,0,33,0,False,False,False,0,2,2020-10-09T16:04:02.373,33,,
2020,4,2852,760,21,576,3,2,10,5,0,0,0,0,0,0,False,False,False,0,3,2020-10-09T21:24:27.29,0,,
2020,4,2852,770,21,4422,13,6,10,12,0,0,0,0,0,0,False,False,False,0,3,2020-10-05T16:19:15.503,0,,
2020,4,2852,780,21,4422,2,5,5,5,5,0,5,0,5,0,False,False,False,0,3,2020-10-05T16:22:14.81,5,,
2020,4,2852,785,21,6444,13,7,5,13,0,0,0,0,0,0,False,False,False,0,2,2020-10-05T16:25:34.08,0,,
2020,4,2853,15,16,121,2,4,5,4,8,4,7,1,7,0,False,False,False,0,2,2020-10-06T10:22:09.54,8,,
2020,4,2853,20,16,121,13,7,2,27,0,0,0,0,0,0,False,False,False,0,2,2021-02-16T14:55:32.1,0,,
2020,4,2853,30,16,3938,2,35,8,18,22,4,21,1,21,0,False,False,False,0,3,2020-10-06T10:30:00.253,22,,
2020,4,2853,35,16,3938,2,12,10,4,17,13,17,0,17,0,False,False,False,0,3,2020-10-09T11:42:43.243,17,,
2020,4,2853,40,16,7681,2,44,3,3,11,8,9,2,9,0,True,False,False,0,2,2021-02-16T14:56:38.62,11,,
2020,4,2853,45,16,374,13,12,5,6,0,0,0,0,0,0,True,False,False,0,4,2021-03-10T21:21:14.103,0,,
2020,4,2853,55,16,121,13,13,3,5,0,0,0,0,0,0,False,False,False,0,3,2020-10-06T10:41:40.15,0,,
2020,4,2853,75,19,6273,13,7,2,19,0,0,0,0,0,0,False,False,False,0,4,2020-10-06T10:45:44.28,0,,
2020,4,2853,80,19,3233,2,2,9,6,7,1,7,0,7,0,False,False,False,0,2,2020-10-06T10:49:13.813,7,,
2020,4,2853,95,16,7681,2,48,4,-6,2,8,0,2,0,0,False,False,False,0,1,2021-02-16T15:01:30.01,2,,
2020,4,2853,100,16,3938,13,9,6,35,0,0,0,0,0,0,False,False,False,0,3,2020-10-06T11:02:41.537,0,,
2020,4,2853,110,19,3233,2,6,10,5,6,1,5,1,5,0,False,False,False,0,2,2020-10-06T11:06:57.57,6,,
2020,4,2853,130,19,3233,3,3,5,5,0,0,0,0,0,0,False,False,False,0,2,2020-10-06T11:17:58.09,0,,
2020,4,2853,145,16,7681,2,45,5,-2,14,16,9,5,9,0,False,False,False,0,1,2020-10-06T11:23:10.12,14,,
2020,4,2853,150,16,121,2,13,4,4,21,17,13,8,13,0,False,False,False,0,2,2020-10-06T11:25:53.007,21,,
2020,4,2853,155,16,374,2,7,7,17,24,7,21,3,21,0,True,False,False,0,3,2020-10-09T11:36:03.667,24,,
2020,4,2853,175,16,6499,13,12,3,13,0,0,0,0,0,0,False,False,False,0,1,2021-02-16T15:03:46.75,0,,
2020,4,2853,195,19,6273,13,17,8,15,0,0,0,0,0,0,False,False,False,0,4,2020-10-06T15:41:30.973,0,,
2020,4,2853,200,16,121,13,6,4,3,0,0,0,0,0,0,False,False,False,0,3,2020-10-06T11:44:47.493,0,,
2020,4,2853,210,16,121,2,4,9,5,8,3,8,0,8,0,False,False,False,0,3,2020-10-06T11:47:07.957,8,,
2020,4,2853,220,19,1328,2,48,10,-4,13,17,11,2,11,0,False,False,False,0,1,2021-02-16T17:55:08.573,13,,
2020,4,2853,225,19,3233,13,2,9,5,0,0,0,0,0,0,False,False,False,0,2,2020-10-06T11:54:59.59,0,,
2020,4,2853,235,19,7177,2,6,4,11,11,0,11,0,11,0,False,False,False,0,3,2020-10-09T11:43:29.35,11,,
2020,4,2853,250,19,1328,2,51,9,-5,0,5,-3,3,-3,0,False,False,False,0,1,2020-10-09T11:36:03.667,0,,
2020,4,2853,270,19,7173,13,29,3,10,0,0,0,0,0,0,False,False,False,0,2,2021-02-25T15:49:29.383,0,,
2020,4,2853,285,16,7176,2,34,4,-3,5,8,5,0,5,0,True,False,False,0,3,2020-10-07T15:34:40.83,5,,
2020,4,2853,305,16,6565,2,47,5,4,5,1,5,0,5,0,True,False,False,0,4,2020-10-09T12:49:01.437,5,,
2020,4,2853,325,19,1328,2,4,10,4,8,4,6,2,6,0,True,False,False,0,2,2020-10-07T15:35:02.373,8,,
2020,4,2853,335,19,7173,2,13,10,1,8,7,2,6,2,0,True,False,False,1,3,2020-10-09T13:21:58.727,8,,
2020,4,2853,345,19,7173,2,2,9,7,9,2,7,2,7,0,False,False,False,0,2,2020-10-06T12:41:26.363,9,,
2020,4,2853,380,19,1328,2,2,9,5,15,10,14,1,14,0,True,False,False,0,2,2020-10-07T15:35:29.103,15,,
2020,4,2853,400,19,1328,2,44,3,-4,-4,0,-4,0,-4,0,False,False,False,0,1,2020-10-06T12:59:42.01,-4,,
2020,4,2853,425,19,7173,13,6,9,6,0,0,0,0,0,0,False,False,False,0,2,2021-02-16T18:32:42.497,0,,
2020,4,2853,430,19,3233,13,21,6,30,0,0,0,0,0,0,False,False,False,0,3,2021-02-16T18:36:59.093,0,,
2020,4,2853,445,16,7176,2,4,3,7,10,3,8,2,8,0,False,False,False,0,2,2020-10-06T13:11:31.01,10,,
2020,4,2853,450,16,121,2,12,5,0,6,6,2,4,2,0,True,False,False,0,2,2021-03-08T19:15:34.9,6,,
2020,4,2853,460,16,7182,13,6,9,4,0,0,0,0,0,0,False,False,False,0,4,2020-10-06T13:24:06.33,0,,
2020,4,2853,470,19,1510,2,4,4,3,5,2,5,0,5,0,False,False,False,0,1,2020-10-07T16:52:32.587,5,,
2020,4,2853,485,19,3233,13,29,6,15,0,0,0,0,0,0,False,False,False,0,2,2020-10-06T13:31:16.54,0,,
2020,4,2853,495,19,54,2,5,5,8,8,0,8,0,8,0,False,False,False,0,3,2020-10-06T16:15:52.537,8,,
2020,4,2853,505,19,54,2,17,9,14,19,5,19,0,19,0,False,False,False,0,3,2020-10-06T13:38:39.953,19,,
2020,4,2853,510,19,1328,2,47,5,0,0,0,0,0,0,0,False,False,False,0,1,2020-10-06T13:40:09.613,0,,
2020,4,2853,515,19,3233,2,8,7,23,25,2,25,0,25,0,False,False,False,0,3,2020-10-06T13:41:57.957,25,,
2020,4,2853,540,16,3938,2,35,8,18,19,1,19,0,19,0,False,False,False,0,3,2020-10-06T13:53:09.413,19,,
2020,4,2853,545,16,374,13,12,10,9,0,0,0,0,0,0,False,False,False,0,2,2020-10-06T13:55:06.323,0,,
2020,4,2853,550,16,374,2,7,2,17,45,28,41,4,41,0,False,False,False,0,3,2020-10-09T12:53:13.933,45,,
2020,4,2853,565,16,374,13,12,3,4,0,0,0,0,0,0,False,False,False,0,3,2021-03-08T19:16:02.983,0,,
2020,4,2853,570,16,3938,2,55,9,-4,6,10,6,0,6,6,False,False,False,0,2,2020-10-06T14:26:35.02,6,,
2020,4,2853,605,19,7173,13,8,7,24,0,0,0,0,0,0,True,False,False,0,3,2020-10-06T16:08:04.45,0,,
2020,4,2853,615,19,7173,13,5,5,4,0,0,0,0,0,0,False,False,False,0,4,2020-10-06T14:18:32.48,0,,
2020,4,2853,620,19,7173,2,9,3,4,4,0,4,0,4,6,False,False,False,0,2,2020-10-06T14:19:41.4,4,,
2020,4,2853,645,16,374,13,5,8,19,0,0,0,0,0,0,False,False,False,0,2,2020-10-06T14:28:48.247,0,,
2020,4,2853,660,16,3938,13,7,6,34,0,0,0,0,0,0,False,False,False,0,3,2021-02-16T18:33:01.543,0,,
2020,4,2853,670,16,7176,2,54,3,-1,6,7,4,2,4,0,True,False,False,0,3,2020-10-09T11:36:03.667,6,,
2020,4,2853,680,16,7176,2,34,4,-3,6,9,4,2,4,6,True,False,False,0,3,2020-10-07T15:35:48.883,6,,
2020,4,2853,695,19,54,3,46,3,0,0,0,0,0,0,0,False,False,False,0,3,2021-03-05T17:41:25.43,0,,
2020,4,2853,715,19,3233,2,12,3,5,12,7,11,1,11,0,False,False,False,0,2,2020-10-09T11:57:33.407,12,,
2020,4,2853,720,19,6273,3,17,1,15,0,0,0,0,0,0,False,False,False,0,4,2020-10-06T14:50:56.343,0,,
2020,4,2853,730,19,1328,13,28,9,-2,0,0,0,0,0,0,False,False,False,0,1,2020-10-06T14:53:52.503,0,,
2020,4,2853,740,19,54,2,4,9,7,8,1,7,1,7,0,True,False,False,0,3,2020-10-07T16:53:21.84,8,,
2020,4,2853,765,19,3233,13,19,7,35,0,0,0,0,0,0,False,False,False,0,3,2020-10-09T13:21:06.993,0,,
2020,4,2853,785,16,374,2,46,3,1,1,0,1,0,1,0,False,False,False,0,4,2020-10-06T15:10:56.093,1,,
2020,4,2853,800,19,3233,2,12,2,17,30,13,30,0,30,0,False,False,False,0,2,2020-10-09T11:58:16.04,30,,
2020,4,2853,820,19,54,13,5,3,8,0,0,0,0,0,0,False,False,False,0,3,2021-03-02T19:25:56.66,0,,
2020,4,2853,825,19,54,13,5,5,7,0,0,0,0,0,0,True,False,False,0,3,2021-02-16T18:02:18.883,0,,
2020,4,2853,830,19,1328,2,48,10,-5,6,11,2,4,2,0,False,False,False,1,1,2020-10-06T15:21:17.663,6,,
2020,4,2854,15,4,6983,2,12,5,1,2,1,2,0,2,0,False,False,False,0,1,2020-10-09T19:26:00.543,2,,
2020,4,2854,25,4,2853,2,35,2,18,21,3,21,0,21,0,True,False,False,0,3,2020-10-06T16:49:55.373,21,,
2020,4,2854,30,4,2853,3,51,9,-2,0,0,0,0,0,0,False,False,False,0,3,2020-10-09T18:09:54.407,0,,
2020,4,2854,35,4,2853,2,8,10,13,15,2,14,1,14,0,False,False,False,0,2,2020-10-05T13:39:06.817,15,,
2020,4,2854,40,4,6983,2,4,10,1,6,5,2,4,2,0,False,False,False,0,1,2020-10-05T13:40:55.273,6,,
2020,4,2854,50,4,7646,2,35,2,26,26,0,26,0,26,6,False,False,False,0,3,2020-10-05T13:44:41.05,26,,
2020,4,2854,65,23,4949,2,5,3,6,9,3,8,1,8,0,False,False,False,0,3,2020-10-05T13:46:53.217,9,,
2020,4,2854,75,23,7250,13,2,9,12,0,0,0,0,0,0,False,False,False,0,3,2020-10-05T13:49:02.84,0,,
2020,4,2854,90,23,7250,13,2,10,4,0,0,0,0,0,0,False,False,False,0,3,2020-10-09T19:27:34.753,0,,
2020,4,2854,95,23,4949,2,50,9,-2,-1,1,-1,0,-1,0,False,False,False,0,2,2020-10-09T18:37:47.177,-1,,
2020,4,2854,100,23,4949,2,6,1,16,16,0,16,0,16,0,False,False,False,0,2,2020-10-05T13:56:07.703,16,,
2020,4,2854,110,23,7240,2,47,5,1,12,11,10,2,10,0,False,False,False,0,1,2020-10-05T13:58:32.127,12,,
2020,4,2854,135,4,594,2,4,10,4,7,3,7,0,7,0,False,False,False,0,3,2020-10-09T19:03:13.257,7,,
2020,4,2854,140,4,2853,2,5,5,10,10,0,10,0,10,0,False,False,False,0,3,2020-10-05T14:11:54.813,10,,
2020,4,2854,155,4,5119,2,52,4,3,18,15,15,3,15,0,False,False,False,0,3,2020-10-05T14:15:29.94,18,,
2020,4,2854,160,4,1028,2,5,3,5,6,1,6,0,6,0,False,False,False,0,3,2021-02-16T19:10:18.957,6,,
2020,4,2854,185,4,594,2,17,10,10,11,1,11,0,11,6,False,False,False,0,3,2020-10-05T14:22:00.883,11,,
2020,4,2854,205,23,4949,13,6,9,14,0,0,0,0,0,0,False,False,False,0,3,2020-10-09T18:39:24.373,0,,
2020,4,2854,215,23,2994,2,13,9,2,9,7,6,3,6,0,False,False,False,0,3,2020-10-09T18:39:42.893,9,,
2020,4,2854,220,23,2256,2,8,7,49,49,0,49,0,49,6,False,False,False,0,3,2020-10-09T16:56:26.737,49,,
2020,4,2854,225,23,4949,2,51,10,-1,8,9,3,5,3,0,False,False,False,0,3,2020-10-05T14:39:27.283,8,,
2020,4,2854,240,23,2256,2,6,10,14,14,0,14,0,14,0,False,False,False,0,3,2020-10-09T19:05:07.067,14,,
2020,4,2854,245,23,2256,2,2,4,10,12,2,12,0,12,0,False,False,False,0,3,2020-10-05T14:43:54.213,12,,
2020,4,2854,255,23,2994,3,6,5,11,0,0,0,0,0,0,False,False,False,0,3,2020-10-05T14:46:00.863,0,,
2020,4,2854,260,23,3843,13,16,10,5,0,0,0,0,0,0,False,False,False,0,1,2020-10-09T18:40:47.83,0,,
2020,4,2854,275,4,6983,2,47,5,0,7,7,4,3,4,0,False,False,False,1,1,2020-10-05T14:49:20.667,7,,
2020,4,2854,290,4,1412,2,5,3,8,9,1,9,0,9,0,False,False,False,0,3,2020-10-05T14:54:07.5,9,,
2020,4,2854,300,4,6983,2,48,10,-2,1,3,-2,3,-2,0,False,False,False,1,1,2020-10-05T14:56:26.06,1,,
2020,4,2854,305,4,1412,2,13,9,1,5,4,5,0,5,0,False,False,False,0,3,2020-10-06T16:40:58.77,5,,
2020,4,2854,310,4,2251,13,48,9,-4,0,0,0,0,0,0,False,False,False,0,1,2021-02-16T19:13:32.51,0,,
2020,4,2854,315,4,2629,13,28,3,2,0,0,0,0,0,0,False,False,False,0,1,2020-10-06T16:49:55.373,0,,
2020,4,2854,325,4,2853,2,12,3,7,8,1,7,1,7,0,False,False,False,0,3,2020-10-05T15:03:37.82,8,,
2020,4,2854,340,23,2994,2,54,9,-3,22,25,17,5,17,0,False,False,False,0,4,2020-10-09T18:41:05,22,,
2020,4,2854,350,23,7250,2,44,3,-3,0,3,0,0,0,0,True,False,False,1,3,2020-10-05T15:10:19.21,0,,
2020,4,2854,355,23,2256,2,4,9,9,11,2,9,2,9,0,False,False,False,0,3,2020-10-05T15:11:37.707,11,,
2020,4,2854,365,23,2994,2,4,3,6,7,1,6,1,6,0,False,False,False,0,2,2020-10-05T15:12:37.95,7,,
2020,4,2854,370,23,596,2,5,2,15,15,0,15,0,15,0,False,False,False,0,4,2020-10-05T15:13:47.817,15,,
2020,4,2854,375,23,3843,13,47,5,0,0,0,0,0,0,0,False,False,False,0,1,2020-10-05T15:14:37.537,0,,
2020,4,2854,380,23,3843,2,31,4,2,5,3,4,1,4,0,False,False,False,0,1,2020-10-09T18:02:19.843,5,,
2020,4,2854,390,23,2994,2,4,10,9,11,2,10,1,10,0,False,False,False,0,3,2020-10-05T15:17:03.397,11,,
2020,4,2854,405,23,596,2,12,10,3,3,0,3,0,3,6,False,False,False,0,3,2021-03-03T15:57:00.79,3,,
2020,4,2854,440,23,7241,2,16,9,4,10,6,8,2,8,0,False,False,False,0,1,2021-02-16T19:20:48.977,10,,
2020,4,2854,450,23,2256,2,51,9,-2,8,10,6,2,6,0,False,False,False,0,3,2021-03-04T14:18:24.817,8,,
2020,4,2854,470,23,7240,2,4,5,5,17,12,15,2,15,0,False,False,False,0,2,2020-10-05T15:47:44.013,17,,
2020,4,2854,480,23,7241,13,9,5,13,0,0,0,0,0,0,False,False,False,0,2,2020-10-05T15:50:52.167,0,,
2020,4,2854,485,23,2994,2,5,5,4,6,2,6,0,6,0,False,False,False,0,3,2020-10-09T19:33:19.253,6,,
2020,4,2854,505,4,2629,2,6,10,10,12,2,12,0,12,0,False,False,False,0,3,2020-10-06T16:49:55.373,12,,
2020,4,2854,515,4,6983,2,28,10,-1,5,6,4,1,4,0,False,False,False,0,1,2020-10-05T15:59:59.103,5,,
2020,4,2854,530,4,2629,3,16,10,3,0,0,0,0,0,0,True,False,False,0,1,2020-10-06T16:32:44.143,0,,
2020,4,2854,540,4,6983,3,50,3,-3,0,0,0,0,0,0,False,False,False,0,2,2020-10-05T16:12:06.057,0,,
2020,4,2854,545,4,1412,3,13,4,5,0,0,0,0,0,0,False,False,False,0,2,2020-10-05T16:15:58.45,0,,
2020,4,2854,560,23,2994,2,30,5,1,7,6,2,5,2,0,False,False,False,1,4,2020-10-05T16:19:18.113,7,,
2020,4,2854,570,23,4949,3,35,8,18,0,0,0,0,0,0,True,False,False,0,3,2021-02-16T19:23:49.4,0,,
2020,4,2854,590,4,6953,2,46,3,2,7,5,6,1,6,0,False,False,False,0,4,2020-10-05T16:30:09.07,7,,
2020,4,2854,595,4,2853,2,4,3,8,12,4,11,1,11,0,False,False,False,0,2,2021-02-16T19:24:55.81,12,,
2020,4,2854,600,4,594,2,5,5,13,14,1,14,0,14,0,False,False,False,0,3,2020-10-05T16:34:02.737,14,,
2020,4,2854,605,4,1412,2,35,5,14,14,0,14,0,14,0,False,False,False,0,2,2020-10-05T16:37:42.417,14,,
2020,4,2854,635,23,2994,2,6,9,13,14,1,14,0,14,0,False,False,False,0,2,2020-10-05T16:50:02.57,14,,
2020,4,2854,640,23,7250,2,46,3,3,12,9,10,2,10,0,False,False,False,1,3,2020-10-09T18:03:27.89,12,,
2020,4,2854,650,23,7241,2,48,9,-5,9,14,-5,14,-5,0,False,False,False,1,1,2020-10-05T16:55:06.903,9,,
2020,4,2854,655,23,2994,2,47,5,2,4,2,2,2,2,0,False,True,True,0,3,2020-10-05T16:57:53.92,3,,
2020,4,2854,660,4,2853,2,23,7,45,49,4,45,4,45,0,False,False,False,0,2,2020-10-05T17:01:09.07,49,,
2020,4,2854,665,4,6953,13,30,9,-1,0,0,0,0,0,0,True,False,False,0,4,2020-10-06T16:32:57.543,0,,
2020,4,2854,670,4,6953,2,53,9,-4,9,13,6,3,6,0,False,False,False,0,4,2020-10-05T18:16:19.95,9,,
2020,4,2854,690,23,2994,13,4,10,5,0,0,0,0,0,0,False,False,False,0,4,2020-10-09T19:35:16.363,0,,
2020,4,2854,695,23,7250,2,4,9,3,4,1,4,0,4,0,False,False,False,0,3,2020-10-09T19:10:49.933,4,,
2020,4,2854,700,23,3843,2,28,10,-1,5,6,4,1,4,0,False,False,False,1,1,2020-10-05T18:03:48.493,5,,
2020,4,2854,710,4,1412,2,35,4,9,14,5,13,1,13,0,False,False,False,0,3,2020-10-06T16:49:55.373,14,,
2020,4,2854,720,4,594,13,26,10,4,0,0,0,0,0,0,False,False,False,0,3,2020-10-09T19:36:28.06,0,,
2020,4,2854,740,23,2994,2,32,5,3,9,6,7,2,7,0,False,False,False,0,4,2020-10-05T17:21:58.837,9,,
2020,4,2854,750,23,7250,2,12,2,30,37,7,30,7,30,0,False,False,False,0,3,2020-10-09T19:14:43.423,37,,
2020,4,2854,755,23,7241,2,16,10,4,15,11,13,2,13,0,False,False,False,0,1,2021-02-16T19:31:52.977,15,,
2020,4,2854,795,23,7241,2,16,4,4,6,2,6,0,6,0,False,False,False,0,1,2020-10-05T17:39:16.493,6,,
2020,4,2854,800,23,2256,13,8,1,46,0,0,0,0,0,0,False,False,False,0,3,2020-10-05T17:41:16.717,0,,
2020,4,2854,805,23,7250,3,2,10,5,0,0,0,0,0,0,False,False,False,0,3,2020-10-05T17:42:56.367,0,,
2020,4,2854,810,23,7246,2,38,9,3,8,5,6,2,6,0,False,False,False,0,3,2020-10-09T18:43:36.053,8,,
2020,4,2854,815,23,7250,2,5,5,3,4,1,4,0,4,0,False,False,False,0,3,2020-10-05T17:46:59.32,4,,
2020,4,2854,840,23,4949,13,12,3,7,0,0,0,0,0,0,False,False,False,0,3,2021-02-17T20:44:19.527,0,,
2020,4,2854,845,23,2256,2,7,3,7,7,0,7,0,7,6,False,False,False,0,3,2020-10-05T17:52:05.693,7,,
2020,4,2855,20,24,6937,13,44,3,-2,0,0,0,0,0,0,False,False,False,0,1,2020-10-21T15:23:25.24,0,,
2020,4,2855,30,28,4912,13,2,9,7,0,0,0,0,0,0,False,False,False,0,2,2021-03-05T22:11:10.293,0,,
2020,4,2855,35,28,262,13,11,3,11,0,0,0,0,0,0,False,False,False,0,1,2020-10-05T12:35:48.523,0,,
2020,4,2855,40,28,4922,2,2,4,6,9,3,7,2,7,0,False,False,False,0,3,2020-10-09T17:23:50.557,9,,
2020,4,2855,50,24,894,2,30,9,-5,-4,1,-5,1,-5,0,False,False,False,0,4,2020-10-09T18:26:36.28,-4,,
2020,4,2855,65,24,4382,2,2,9,5,6,1,5,1,5,0,False,False,False,0,3,2020-10-05T17:40:17.243,6,,
2020,4,2855,70,24,4382,2,35,10,9,20,11,17,3,17,0,False,False,False,0,4,2020-10-09T17:44:00.677,20,,
2020,4,2855,75,24,4382,13,12,8,15,0,0,0,0,0,0,False,False,False,0,3,2021-03-05T17:44:38.617,0,,
2020,4,2855,115,24,894,13,12,5,11,0,0,0,0,0,0,False,False,False,0,3,2021-03-08T19:22:56.687,0,,
2020,4,2855,120,24,565,13,7,6,27,0,0,0,0,0,0,False,False,False,0,4,2020-10-09T17:24:09.087,0,,
2020,4,2855,140,24,6937,2,44,9,-1,28,29,23,5,23,0,False,False,False,0,1,2020-10-06T17:02:19.79,28,,
2020,4,2855,160,28,4922,2,13,9,1,17,16,7,10,7,0,False,False,False,1,4,2020-10-09T17:30:12.607,17,,
2020,4,2855,165,28,4922,2,53,9,-3,7,10,5,2,5,0,True,False,False,0,4,2020-10-05T13:36:38.337,7,,
2020,4,2855,215,24,894,13,5,3,8,0,0,0,0,0,0,True,False,False,0,3,2020-10-06T17:05:47.357,0,,
2020,4,2855,230,28,4922,2,46,3,-1,13,14,0,13,0,0,False,False,False,2,4,2020-10-09T17:29:18.277,13,,
2020,4,2855,235,28,7619,3,12,10,-6,0,0,0,0,0,0,False,False,False,0,3,2020-10-05T14:04:27.557,0,,
2020,4,2855,245,28,797,2,48,10,-7,0,7,-4,4,-4,0,False,False,False,0,1,2020-10-09T17:30:36.187,0,,
2020,4,2855,255,24,4382,2,13,10,3,7,4,4,3,4,0,True,False,False,1,3,2020-10-09T17:46:53.533,7,,
2020,4,2855,265,24,894,2,53,10,-4,8,12,2,6,2,0,False,False,False,0,4,2020-10-09T17:47:38.787,8,,
2020,4,2855,275,24,894,2,39,9,3,4,1,4,0,4,0,False,False,False,0,3,2020-10-05T14:20:44.02,4,,
2020,4,2855,280,24,4382,2,2,10,4,5,1,5,0,5,0,False,False,False,0,3,2021-02-16T20:16:06.933,5,,
2020,4,2855,305,28,7224,2,50,9,-2,17,19,6,11,6,0,False,False,False,0,2,2020-10-09T17:30:46.687,17,,
2020,4,2855,320,28,4922,2,9,2,27,38,11,33,5,33,0,False,False,False,0,3,2020-10-05T14:44:26.5,38,,
2020,4,2855,330,28,4932,13,35,5,8,0,0,0,0,0,0,False,False,False,0,4,2020-10-09T17:50:11.787,0,,
2020,4,2855,335,24,6808,2,3,3,11,15,4,14,1,14,0,False,False,False,0,2,2020-10-05T14:49:11.797,15,,
2020,4,2855,340,24,7799,2,12,10,11,13,2,13,0,13,0,False,False,False,0,2,2021-03-08T19:23:22.607,13,,
2020,4,2855,395,28,262,2,46,3,0,13,13,10,3,10,0,False,False,False,1,1,2020-10-05T15:02:26.497,13,,
2020,4,2855,400,28,797,3,4,9,3,0,0,0,0,0,0,False,False,False,0,1,2020-10-05T15:03:24.78,0,,
2020,4,2855,405,28,4922,2,39,4,5,5,0,5,0,5,0,True,False,False,0,3,2020-10-09T17:24:56.057,5,,
2020,4,2855,425,28,7619,13,5,3,11,0,0,0,0,0,0,False,False,False,0,3,2020-10-05T15:16:41.973,0,,
2020,4,2855,430,28,7619,2,13,5,5,4,-1,5,-1,5,0,False,False,False,1,3,2020-10-09T17:25:08.077,4,,
2020,4,2855,440,28,797,2,46,3,3,10,7,9,1,9,0,False,False,False,0,1,2020-10-05T17:31:19.253,10,,
2020,4,2855,455,28,4922,2,17,4,11,12,1,12,0,12,0,False,False,False,0,4,2020-10-05T15:25:33.407,12,,
2020,4,2855,460,28,6624,2,55,9,-2,13,15,1,12,1,0,False,False,False,2,1,2020-10-09T17:51:07.087,13,,
2020,4,2855,470,28,4922,2,12,3,1,2,1,2,0,2,0,False,False,False,0,4,2021-03-08T19:24:08.2,2,,
2020,4,2855,475,28,4922,2,7,3,5,5,0,5,0,5,6,False,False,False,0,4,2020-10-09T18:06:45.24,5,,
2020,4,2855,495,24,565,2,32,5,1,23,22,16,7,16,0,False,False,False,0,4,2020-10-05T15:34:44.037,23,,
2020,4,2855,500,24,4382,13,12,9,12,0,0,0,0,0,0,False,False,False,0,3,2021-03-08T19:24:30.89,0,,
2020,4,2855,505,24,565,2,5,10,4,9,5,6,3,6,0,True,False,False,0,4,2020-10-06T17:06:12.753,9,,
2020,4,2855,510,24,565,2,32,10,3,3,0,3,0,3,0,False,False,False,0,4,2020-10-05T15:39:42.667,3,,
2020,4,2855,515,24,894,2,13,10,1,1,0,1,0,1,0,False,False,False,0,4,2020-10-05T15:40:58.597,1,,
2020,4,2855,520,24,6937,3,16,10,3,0,0,0,0,0,0,False,False,False,0,1,2020-10-05T15:42:38.227,0,,
2020,4,2855,535,24,8216,2,45,5,-5,2,7,0,2,0,0,True,False,False,0,3,2020-10-05T15:46:42.37,2,,
2020,4,2855,560,24,6808,13,6,10,11,0,0,0,0,0,0,False,False,False,0,3,2020-10-05T15:56:14.39,0,,
2020,4,2855,580,28,4922,2,35,7,18,20,2,18,2,18,0,False,False,False,0,4,2020-10-05T17:32:13.957,20,,
2020,4,2855,595,28,797,2,4,10,4,5,1,5,0,5,0,True,False,False,0,3,2020-10-09T18:25:57.46,5,,
2020,4,2855,600,28,797,2,4,10,3,10,7,5,5,5,0,False,False,False,1,4,2020-10-05T16:06:44.53,10,,
2020,4,2855,635,28,4912,3,5,3,8,0,0,0,0,0,0,True,False,False,0,3,2020-10-05T16:15:48.65,0,,
2020,4,2855,650,24,4382,13,42,10,4,0,0,0,0,0,0,False,False,False,0,3,2020-10-09T18:06:45.24,0,,
2020,4,2855,655,24,6937,2,51,9,-6,2,8,2,0,2,0,True,False,False,0,1,2020-10-06T17:06:29.62,2,,
2020,4,2855,660,24,7799,2,2,10,5,9,4,6,3,6,0,False,False,False,0,2,2020-10-05T16:23:43.707,9,,
2020,4,2855,670,24,6389,2,12,2,15,17,2,16,1,16,0,False,False,False,0,1,2020-10-06T17:03:28.58,17,,
2020,4,2855,680,24,6808,2,19,6,33,42,9,33,9,33,6,False,False,False,0,2,2020-10-09T18:06:45.24,42,,
2020,4,2855,695,28,4912,13,4,3,5,0,0,0,0,0,0,False,False,False,0,2,2021-03-05T17:45:31.003,0,,
2020,4,2855,705,28,797,2,48,9,-6,8,14,5,3,5,0,True,False,False,0,1,2020-10-09T17:31:02.467,8,,
2020,4,2855,710,28,4922,2,5,10,4,7,3,4,3,4,0,False,False,False,0,3,2020-10-05T16:37:15.563,7,,
2020,4,2855,715,28,797,2,4,9,4,5,1,4,1,4,0,False,False,False,0,3,2021-02-16T20:22:21.46,5,,
2020,4,2855,720,28,4912,2,5,5,11,11,0,11,0,11,0,False,False,False,0,3,2020-10-05T16:40:38.933,11,,
2020,4,2855,725,28,4922,2,2,10,5,13,8,10,3,10,0,False,False,False,0,3,2020-10-05T16:41:49.743,13,,
2020,4,2855,730,28,7224,2,5,5,4,4,0,4,0,4,0,False,False,False,0,3,2020-10-09T17:55:34.647,4,,
2020,4,2855,735,28,7224,2,35,4,12,14,2,13,1,13,0,False,False,False,0,3,2020-10-07T17:01:21.53,14,,
2020,4,2855,750,28,4912,13,6,10,14,0,0,0,0,0,0,False,False,False,0,3,2020-10-05T16:48:44.263,0,,
2020,4,2855,755,28,7619,2,8,10,13,14,1,14,0,14,0,False,False,False,0,2,2020-10-05T16:50:27.343,14,,
2020,4,2855,760,28,7619,13,5,3,3,0,0,0,0,0,0,False,False,False,0,2,2020-10-05T16:51:30.833,0,,
2020,4,2855,765,28,4912,2,26,3,1,2,1,1,1,1,0,False,False,False,0,2,2020-10-05T16:53:44.61,2,,
2020,4,2855,825,28,4912,2,4,5,12,20,8,14,6,14,0,False,False,False,1,2,2020-10-09T18:06:45.24,20,,
2020,4,2855,830,28,4922,2,13,4,4,13,9,7,6,7,0,False,False,False,0,3,2020-10-05T17:04:44.067,13,,
2020,4,2855,835,28,797,2,4,9,4,5,1,4,1,4,0,False,False,False,0,1,2020-10-05T17:05:57.63,5,,
2020,4,2855,840,28,4922,2,4,4,10,10,0,10,0,10,0,False,False,False,0,3,2020-10-09T18:06:45.24,10,,
2020,4,2855,845,28,4922,2,4,4,11,12,1,11,1,11,0,False,False,False,0,3,2020-10-09T18:06:45.24,12,,
2020,4,2855,870,28,4922,13,19,2,33,0,0,0,0,0,0,False,False,False,0,2,2020-10-05T17:11:37.537,0,,
2020,4,2856,20,2,5223,13,20,2,21,0,0,0,0,0,0,False,False,False,0,2,2020-10-09T15:09:03.013,0,,
2020,4,2856,30,12,6357,13,9,6,26,0,0,0,0,0,0,False,False,False,0,2,2021-02-16T14:13:19.007,0,,
2020,4,2856,35,12,4511,2,35,7,15,27,12,23,4,23,0,False,False,False,0,4,2020-10-08T01:21:53.7,27,,
2020,4,2856,40,12,4537,2,51,5,-5,8,13,4,4,4,0,True,False,False,0,1,2021-02-16T14:14:14.043,8,,
2020,4,2856,60,12,4537,2,46,3,5,6,1,6,0,6,6,False,False,False,0,4,2020-10-09T14:38:21.673,6,,
2020,4,2856,75,2,5223,13,3,3,12,0,0,0,0,0,0,False,False,False,0,2,2020-10-06T13:33:05.493,0,,
2020,4,2856,85,2,5223,13,8,7,39,0,0,0,0,0,0,False,False,False,0,2,2020-10-06T13:35:24.73,0,,
2020,4,2856,95,12,4561,2,48,9,-6,9,15,0,9,0,0,False,False,False,2,1,2020-10-06T13:43:33.707,9,,
2020,4,2856,100,12,4561,2,9,2,24,29,5,27,2,27,0,False,False,False,0,3,2020-10-06T13:46:01.74,29,,
2020,4,2856,115,12,6869,2,8,8,18,19,1,19,0,19,0,False,False,False,0,3,2020-10-09T15:09:03.013,19,,
2020,4,2856,130,12,6869,2,5,5,2,2,0,2,0,2,0,False,False,False,0,3,2020-10-09T15:09:03.013,2,,
2020,4,2856,140,2,661,2,18,5,-1,8,9,-1,9,-1,0,True,False,False,1,2,2020-10-06T13:57:17.637,8,,
2020,4,2856,165,2,5214,2,47,5,4,5,1,5,0,5,0,False,False,False,0,4,2020-10-06T14:05:52.5,5,,
2020,4,2856,175,2,6247,2,5,3,11,13,2,12,1,12,0,False,False,False,0,3,2020-10-06T14:11:43.923,13,,
2020,4,2856,180,2,5214,2,30,10,2,14,12,11,3,11,0,False,False,False,1,4,2020-10-06T14:15:16.663,14,,
2020,4,2856,185,2,5214,13,17,8,40,0,0,0,0,0,0,False,False,False,0,4,2020-10-06T14:18:06.64,0,,
2020,4,2856,190,2,7303,2,4,5,4,6,2,5,1,5,0,False,False,False,0,2,2021-02-16T14:15:35.93,6,,
2020,4,2856,200,2,661,2,39,4,10,19,9,13,6,13,0,False,False,False,1,3,2020-10-09T15:12:28.203,19,,
2020,4,2856,210,2,661,2,4,5,-1,1,2,-1,2,-1,0,False,False,False,0,2,2020-10-06T17:20:14.88,1,,
2020,4,2856,215,2,6247,2,4,9,9,9,0,9,0,9,0,False,False,False,0,3,2020-10-06T14:27:48.747,9,,
2020,4,2856,240,2,6247,13,12,4,5,0,0,0,0,0,0,False,False,False,0,3,2020-10-06T14:32:59.437,0,,
2020,4,2856,255,12,6357,2,6,4,12,17,5,15,2,15,0,False,False,False,0,2,2021-02-16T14:20:56.193,17,,
2020,4,2856,265,12,3965,2,51,9,-1,8,9,4,4,4,0,False,False,False,0,3,2020-10-06T14:42:43.473,8,,
2020,4,2856,275,12,6357,13,2,9,5,0,0,0,0,0,0,False,False,False,0,2,2020-10-06T14:45:26.633,0,,
2020,4,2856,280,12,6357,13,12,2,47,0,0,0,0,0,0,False,False,False,0,3,2020-10-06T14:47:44.353,0,,
2020,4,2856,285,12,6357,2,4,3,10,14,4,10,4,10,0,False,False,False,0,2,2020-10-06T14:50:50.237,14,,
2020,4,2856,295,12,4561,2,46,3,2,15,13,12,3,12,0,False,False,False,0,1,2020-10-06T14:53:19.907,15,,
2020,4,2856,305,12,6357,13,29,2,19,0,0,0,0,0,0,False,False,False,0,2,2020-10-06T17:22:43.867,0,,
2020,4,2856,310,12,4511,2,7,6,16,19,3,18,1,18,6,True,False,False,0,4,2020-10-06T14:56:25.5,19,,
2020,4,2856,335,2,661,2,47,5,3,4,1,4,0,4,0,True,False,False,0,3,2020-10-06T17:17:54.937,4,,
2020,4,2856,365,12,4561,2,47,5,1,9,8,9,0,9,0,False,False,False,0,1,2020-10-06T15:03:27.567,9,,
2020,4,2856,370,12,4511,2,51,5,0,3,3,1,2,1,0,False,False,False,0,4,2021-02-16T14:25:01.303,3,,
2020,4,2856,380,12,4561,2,4,10,0,2,2,2,0,2,0,False,False,False,0,1,2020-10-06T15:07:36.397,2,,
2020,4,2856,385,12,4561,2,48,10,-3,13,16,12,1,12,0,False,False,False,0,1,2020-10-06T15:08:39.143,13,,
2020,4,2856,395,12,7460,2,26,9,1,20,19,20,0,20,0,False,False,False,0,3,2020-10-06T15:11:51.423,20,,
2020,4,2856,400,12,4511,2,2,9,8,8,0,8,0,8,6,False,False,False,0,3,2020-10-06T15:13:07.35,8,,
2020,4,2856,415,2,7303,2,13,4,3,10,7,9,1,9,0,False,False,False,0,2,2020-10-06T15:15:32.937,10,,
2020,4,2856,420,2,4670,2,6,9,3,9,6,7,2,7,0,False,False,False,0,1,2020-10-09T15:09:03.013,9,,
2020,4,2856,455,12,6357,2,3,5,8,8,0,8,0,8,0,False,False,False,0,2,2021-02-16T14:27:37.767,8,,
2020,4,2856,470,12,6869,13,19,2,40,0,0,0,0,0,0,False,False,False,0,2,2020-10-06T15:33:02.243,0,,
2020,4,2856,480,2,5214,2,7,7,17,18,1,18,0,18,0,False,False,False,0,4,2020-10-06T15:40:50.453,18,,
2020,4,2856,485,2,7303,2,35,2,16,16,0,16,0,16,0,False,False,False,0,2,2021-03-09T19:37:35.81,16,,
2020,4,2856,510,2,5223,13,4,5,10,0,0,0,0,0,0,False,False,False,0,2,2021-03-17T19:00:10.993,0,,
2020,4,2856,535,12,4537,2,9,2,20,23,3,22,1,22,0,True,False,False,0,2,2020-10-06T15:55:06.42,23,,
2020,4,2856,550,12,4511,2,12,2,21,21,0,21,0,21,6,False,False,False,0,3,2021-03-08T19:31:23.763,21,,
2020,4,2856,565,2,6472,2,45,5,-5,6,11,6,0,6,0,False,False,False,0,1,2020-10-09T14:34:04.103,6,,
2020,4,2856,580,2,7303,2,2,10,6,6,0,6,0,6,0,False,False,False,0,2,2020-10-06T16:03:56.917,6,,
2020,4,2856,585,2,6472,2,47,10,2,11,9,6,5,6,0,False,False,False,0,1,2020-10-06T16:05:44.31,11,,
2020,4,2856,590,2,5214,13,33,6,19,0,0,0,0,0,0,True,False,False,0,4,2021-02-16T14:29:14.82,0,,
2020,4,2856,610,2,5223,13,19,2,30,0,0,0,0,0,0,True,False,False,0,2,2020-10-09T14:40:19.173,0,,
2020,4,2856,615,2,2835,2,30,9,0,4,4,4,0,4,0,False,False,False,0,4,2020-10-06T16:12:46.927,4,,
2020,4,2856,620,2,7303,2,30,10,0,16,16,14,2,14,0,False,False,False,0,3,2020-10-06T16:13:53.39,16,,
2020,4,2856,630,2,4670,2,28,4,1,4,3,3,1,3,0,False,False,False,0,1,2020-10-06T16:25:15.013,4,,
2020,4,2856,665,12,4537,2,46,3,1,6,5,5,1,5,0,False,False,False,0,1,2020-10-06T16:30:27.24,6,,
2020,4,2856,670,12,6357,2,49,10,0,6,6,4,2,4,0,False,False,False,0,2,2020-10-06T17:23:32.757,6,,
2020,4,2856,685,12,4561,2,47,5,0,5,5,3,2,3,0,False,False,False,0,1,2020-10-06T16:34:49.263,5,,
2020,4,2856,700,12,4537,2,48,10,-3,-3,0,-3,0,-3,0,False,False,False,0,1,2020-10-06T16:38:13.943,-3,,
2020,4,2856,710,12,4561,2,4,4,2,13,11,11,2,11,0,False,False,False,0,1,2020-10-06T16:40:44.347,13,,
2020,4,2856,725,2,990,2,12,5,6,6,0,6,0,6,0,False,False,False,0,1,2021-03-08T19:31:53.937,6,,
2020,4,2856,730,2,7303,2,2,10,11,13,2,11,2,11,0,False,False,False,1,3,2020-10-06T16:44:20.897,13,,
2020,4,2856,735,2,7303,2,6,4,11,11,0,11,0,11,0,False,False,False,0,3,2020-10-06T16:45:30.867,11,,
2020,4,2856,740,2,6240,2,7,2,17,19,2,19,0,19,0,False,False,False,0,3,2020-10-06T16:47:00.923,19,,
2020,4,2856,750,2,6240,3,8,7,17,0,0,0,0,0,0,False,False,False,0,2,2020-10-06T16:50:00.17,0,,
2020,4,2856,760,2,5223,13,8,1,26,0,0,0,0,0,0,False,False,False,0,2,2020-10-09T14:35:06.713,0,,
2020,4,2856,785,12,4511,2,13,9,4,20,16,19,1,19,0,False,False,False,0,4,2021-02-16T14:30:35.37,20,,
2020,4,2856,810,12,6357,13,35,2,34,0,0,0,0,0,0,False,False,False,0,2,2020-10-06T16:58:55.393,0,,
2020,4,2856,820,2,5214,2,4,4,12,14,2,13,1,13,0,False,False,False,0,3,2020-10-06T17:00:47.677,14,,
2020,4,2856,825,2,6240,2,4,7,19,21,2,20,1,20,0,False,False,False,0,2,2020-10-06T17:01:56.563,21,,
2020,4,2856,830,2,6472,2,4,4,3,7,4,6,1,6,0,False,False,False,0,1,2020-10-06T17:02:52.493,7,,
2020,4,2856,835,2,6240,2,4,3,4,7,3,7,0,7,0,False,False,False,0,2,2020-10-06T17:03:43.803,7,,
2020,4,2856,845,2,7303,13,4,5,9,0,0,0,0,0,0,False,False,False,0,2,2021-02-03T18:19:44.263,0,,
2020,4,2856,850,2,7303,2,13,10,4,8,4,5,3,5,0,False,False,False,1,2,2020-10-06T17:07:06.717,8,,
2020,4,2856,855,2,6240,13,5,5,12,0,0,0,0,0,0,False,False,False,0,2,2020-10-06T17:08:06.85,0,,
2020,5,2857,15,30,793,13,19,2,42,0,0,0,0,0,0,False,False,False,0,3,2020-10-09T16:25:52.3,0,,0.0
2020,5,2857,20,30,3823,2,13,9,5,11,6,8,3,8,0,False,False,False,0,3,2020-10-09T16:36:56.367,11,,3.0
2020,5,2857,30,30,63,2,35,9,10,13,3,11,2,11,0,False,False,False,0,4,2020-10-14T19:51:44.887,13,,2.0
2020,5,2857,35,30,6414,2,48,3,-3,3,6,1,2,1,0,False,False,False,0,1,2020-10-09T09:57:58.473,3,,
2020,5,2857,45,30,7893,2,35,3,12,17,5,17,0,17,0,False,False,False,0,3,2021-02-25T14:51:08.31,17,,0.0
2020,5,2857,50,30,6570,13,23,1,25,0,0,0,0,0,0,False,False,False,0,4,2020-10-09T10:04:22.577,0,,0.0
2020,5,2857,60,30,6570,13,33,4,8,0,0,0,0,0,0,False,False,False,0,4,2021-02-03T18:21:59.33,0,,0.0
2020,5,2857,80,6,7725,2,5,5,7,10,3,10,0,10,0,False,False,False,0,3,2020-10-09T16:37:23.253,10,,0.0
2020,5,2857,90,6,811,2,4,3,5,5,0,5,0,5,0,False,False,False,0,2,2020-10-15T15:54:46.867,5,,0.0
2020,5,2857,95,6,464,13,47,5,1,0,0,0,0,0,0,False,False,False,0,3,2021-02-16T19:53:02.643,0,,0.0
2020,5,2857,110,30,6414,2,46,3,2,2,0,2,0,2,0,False,False,False,0,3,2020-10-09T16:17:42.683,2,,0.0
2020,5,2857,115,30,6570,13,24,6,25,0,0,0,0,0,0,False,False,False,0,3,2020-10-09T10:25:11.467,0,,0.0
2020,5,2857,125,6,464,2,24,2,24,24,0,24,0,24,0,False,False,False,0,3,2021-02-16T21:16:12.923,24,,0.0
2020,5,2857,135,6,666,2,12,5,13,13,0,13,0,13,0,True,False,False,0,3,2021-02-16T21:42:34.493,13,,0.0
2020,5,2857,140,6,464,13,29,2,20,0,0,0,0,0,0,False,False,False,0,2,2021-03-05T17:48:41.05,0,,0.0
2020,5,2857,150,30,7893,2,8,7,15,35,20,18,17,18,0,True,False,False,2,3,2020-10-09T16:37:57.483,35,,17.0
2020,5,2857,160,30,6414,2,16,4,5,9,4,9,0,9,0,False,False,False,0,1,2021-02-16T21:18:57,9,,0.0
2020,5,2857,165,30,793,2,2,9,2,2,0,2,0,2,6,False,False,False,0,2,2020-10-09T16:38:10.02,2,,0.0
2020,5,2857,180,6,464,2,18,5,0,8,8,3,5,3,0,False,False,False,1,2,2020-10-14T18:35:20.137,8,,5.0
2020,5,2857,195,6,7725,13,22,2,36,0,0,0,0,0,0,False,False,False,0,2,2020-10-15T15:55:51.66,0,,0.0
2020,5,2857,210,6,464,13,6,10,12,0,0,0,0,0,0,False,False,False,0,3,2021-02-16T20:24:35.427,0,,0.0
2020,5,2857,230,30,7893,2,50,10,-5,0,5,-3,3,-3,0,False,False,False,0,3,2021-03-04T15:31:58.403,0,,3.0
2020,5,2857,235,30,7893,2,5,3,10,9,-1,10,-1,10,0,False,False,False,0,3,2020-10-09T16:28:14.84,9,,-1.0
2020,5,2857,255,30,2290,2,5,5,4,4,0,4,0,4,0,False,False,False,0,4,2020-10-14T19:14:51.503,4,,0.0
2020,5,2857,260,30,6570,2,2,10,3,9,6,5,4,5,0,False,False,False,0,2,2021-02-16T20:32:01.07,9,,4.0
2020,5,2857,270,30,2290,2,6,4,6,10,4,9,1,9,0,False,False,False,0,4,2020-10-09T11:19:09.463,10,,1.0
2020,5,2857,280,30,5056,13,19,6,36,0,0,0,0,0,0,False,False,False,0,2,2020-10-09T16:40:57.107,0,,
2020,5,2857,285,30,63,13,26,4,4,0,0,0,0,0,0,False,False,False,0,4,2020-10-09T11:26:06.393,0,,0.0
2020,5,2857,295,30,793,13,17,7,17,0,0,0,0,0,0,False,False,False,0,3,2020-10-15T15:55:59.693,0,,0.0
2020,5,2857,310,6,6328,2,4,5,7,7,0,7,0,7,0,True,False,False,0,2,2020-10-09T11:33:06.93,7,,0.0
2020,5,2857,315,6,2071,2,2,10,8,9,1,9,0,9,0,False,False,False,0,2,2020-10-09T16:41:21.63,9,,0.0
2020,5,2857,320,6,6786,2,45,5,-6,-6,0,-6,0,-6,0,False,False,False,2,1,2020-10-15T15:56:42.197,-6,,0.0
2020,5,2857,325,6,6786,2,44,9,-5,4,9,1,3,1,0,True,False,False,0,2,2020-10-14T19:51:44.887,4,,3.0
2020,5,2857,335,6,6786,2,28,9,-4,12,16,9,3,9,0,False,False,False,0,1,2020-10-09T16:41:45.373,12,,3.0
2020,5,2857,345,6,464,2,2,9,11,13,2,11,2,11,0,False,False,False,0,2,2020-10-09T16:41:57.903,13,,2.0
2020,5,2857,350,6,811,2,11,3,7,25,18,20,5,20,0,True,False,False,0,1,2020-10-09T16:42:06.413,25,,5.0
2020,5,2857,360,6,464,13,5,5,3,0,0,0,0,0,0,False,False,False,0,3,2021-02-25T14:53:16.837,0,,0.0
2020,5,2857,380,30,63,13,8,9,12,0,0,0,0,0,0,False,False,False,0,4,2020-10-09T11:59:45.807,0,,0.0
2020,5,2857,385,30,7891,13,46,3,5,0,0,0,0,0,0,False,False,False,0,1,2020-10-14T18:47:12.217,0,,0.0
2020,5,2857,390,30,7891,2,6,10,1,1,0,1,0,1,0,False,True,True,0,1,2020-10-15T16:16:47.243,1,,0.0
2020,5,2857,395,6,464,2,2,10,3,7,4,5,2,5,0,False,False,False,0,3,2020-10-14T18:35:59.773,7,,2.0
2020,5,2857,400,6,666,13,24,6,20,0,0,0,0,0,0,False,False,False,0,3,2020-10-09T12:10:06.447,0,,0.0
2020,5,2857,405,6,811,2,44,3,0,8,8,4,4,4,0,False,False,False,1,1,2020-10-14T19:51:44.887,8,,4.0
2020,5,2857,415,6,666,2,29,3,12,12,0,12,0,12,6,False,False,False,0,2,2020-10-09T16:42:45.14,12,,0.0
2020,5,2857,435,30,6414,2,6,4,4,8,4,6,2,6,0,False,False,False,1,1,2020-10-14T19:51:44.887,8,,2.0
2020,5,2857,445,30,7893,13,6,6,15,0,0,0,0,0,0,False,False,False,0,2,2021-03-15T13:55:18.33,0,,0.0
2020,5,2857,465,6,6786,2,47,5,-1,0,1,0,0,0,0,True,False,False,0,1,2020-10-09T12:52:12.523,0,,0.0
2020,5,2857,470,6,464,2,50,9,-4,0,4,0,0,0,0,False,False,False,0,3,2021-03-04T15:32:29.85,0,,
2020,5,2857,475,6,464,2,4,3,3,3,0,3,0,3,0,True,False,False,0,2,2020-10-09T13:05:10.107,3,,0.0
2020,5,2857,480,6,6328,2,4,10,6,9,3,6,3,6,0,True,False,False,1,3,2020-10-15T15:56:49.94,9,,3.0
2020,5,2857,500,30,7893,2,50,10,-5,1,6,1,0,1,0,False,False,False,0,3,2021-03-04T15:33:10.053,1,,
2020,5,2857,505,30,793,2,4,5,6,6,0,6,0,6,0,False,False,False,0,2,2020-10-09T16:23:53.083,6,,0.0
2020,5,2857,510,30,793,2,13,10,14,14,0,14,0,14,0,False,False,False,0,2,2021-03-08T16:01:11.55,14,,0.0
2020,5,2857,535,6,6786,13,12,9,2,0,0,0,0,0,0,False,False,False,0,1,2021-03-08T18:40:25.193,0,,0.0
2020,5,2857,545,30,2290,2,32,9,0,1,1,0,1,0,0,False,False,False,0,4,2021-03-15T13:55:28.087,1,,1.0
2020,5,2857,555,30,2290,2,12,6,17,20,3,19,1,19,0,False,False,False,0,4,2020-10-15T15:57:01.443,20,,1.0
2020,5,2857,565,30,63,2,12,4,7,16,9,13,3,13,0,False,False,False,0,4,2020-10-09T14:02:54.943,16,,
2020,5,2857,575,30,3823,2,50,3,0,11,11,9,2,9,0,False,False,False,0,2,2020-10-15T15:57:18.967,11,,2.0
2020,5,2857,580,30,793,2,4,3,6,7,1,6,1,6,0,False,False,False,0,2,2020-10-09T16:24:26.087,7,,1.0
2020,5,2857,585,30,793,13,19,6,44,0,0,0,0,0,0,False,False,False,0,2,2021-03-15T13:55:37.24,0,,0.0
2020,5,2857,595,6,666,2,4,9,5,8,3,6,2,6,0,False,False,False,0,3,2020-10-15T15:57:31.83,8,,2.0
2020,5,2857,600,6,464,2,2,9,8,9,1,8,1,8,0,False,False,False,0,2,2020-10-09T16:43:41.303,9,,1.0
2020,5,2857,605,6,464,2,2,10,8,8,0,8,0,8,0,False,False,False,0,3,2020-10-09T14:28:26.833,8,,0.0
2020,5,2857,610,6,464,2,4,5,6,6,0,6,0,6,0,False,False,False,0,2,2020-10-09T16:43:53.103,6,,0.0
2020,5,2857,625,6,6786,2,11,5,1,4,3,3,1,3,0,True,False,False,0,1,2020-10-09T14:47:09.343,4,,1.0
2020,5,2857,630,6,464,13,9,6,22,0,0,0,0,0,0,False,False,False,0,2,2020-10-14T19:51:44.887,0,,
2020,5,2857,640,6,464,2,4,3,4,8,4,6,2,6,0,False,False,False,1,2,2020-10-09T16:44:25.653,8,,2.0
2020,5,2857,660,6,7725,2,4,5,4,5,1,5,0,5,0,False,False,False,0,2,2020-10-09T15:07:10.513,5,,0.0
2020,5,2857,685,30,63,13,6,9,9,0,0,0,0,0,0,False,False,False,0,4,2020-10-09T16:44:57.403,0,,
2020,5,2857,695,30,63,2,53,10,-5,23,28,10,13,10,0,False,False,False,1,4,2020-10-15T15:57:50.063,23,,13.0
2020,5,2857,705,30,2290,2,26,4,5,9,4,7,2,7,0,False,False,False,0,4,2021-03-15T13:55:49.287,9,,2.0
2020,5,2857,715,30,6414,13,5,3,4,0,0,0,0,0,0,False,False,False,0,3,2020-10-09T15:28:37.47,0,,0.0
2020,5,2857,720,30,63,2,6,9,13,16,3,13,3,13,0,False,False,False,0,4,2020-10-09T15:30:03.233,16,,3.0
2020,5,2857,735,6,7725,13,4,5,2,0,0,0,0,0,0,False,False,False,0,2,2020-10-09T15:33:55.99,0,,0.0
2020,5,2857,745,6,509,13,7,2,21,0,0,0,0,0,0,False,False,False,0,2,2020-10-09T16:45:32.443,0,,
2020,5,2857,750,6,6328,2,47,5,2,2,0,2,0,2,0,False,False,False,0,3,2020-10-15T16:02:15.903,2,,0.0
2020,5,2857,755,6,7725,13,19,6,37,0,0,0,0,0,0,False,False,False,0,2,2021-03-15T13:55:58.41,0,,0.0
2020,5,2857,760,6,464,13,4,9,14,0,0,0,0,0,0,False,False,False,0,3,2021-03-15T13:56:05.623,0,,0.0
2020,5,2857,780,30,6414,13,28,4,3,0,0,0,0,0,0,False,False,False,0,1,2020-10-15T16:02:33.64,0,,0.0
2020,5,2857,785,30,7893,13,4,10,11,0,0,0,0,0,0,False,False,False,0,3,2020-10-14T19:17:53.597,0,,0.0
2020,5,2857,805,6,666,13,6,1,17,0,0,0,0,0,0,False,False,False,0,3,2020-10-09T15:49:19.907,0,,0.0
2020,5,2857,810,6,6328,2,5,3,3,10,7,10,0,10,0,False,False,False,0,3,2020-10-09T16:45:47.477,10,,0.0
2020,5,2857,815,6,6786,2,48,9,-5,-1,4,-3,2,-3,0,True,False,False,0,1,2020-10-09T15:52:20.87,-1,,2.0
2020,5,2857,825,6,6786,2,11,3,12,17,5,14,3,14,0,False,False,False,0,1,2020-10-09T16:45:56.123,17,,3.0
2020,5,2857,840,6,464,13,21,2,15,0,0,0,0,0,0,False,False,False,0,2,2020-10-09T15:57:13.23,0,,0.0
2020,5,2857,845,6,464,2,13,10,3,4,1,3,1,3,0,False,False,False,0,3,2020-10-09T15:59:20.86,4,,1.0
2020,5,2857,865,30,793,2,3,3,12,12,0,12,0,12,0,False,False,False,0,2,2020-10-15T16:02:59.88,12,,0.0
2020,5,2857,870,30,793,13,3,2,15,0,0,0,0,0,0,False,False,False,0,2,2020-10-09T16:25:28.59,0,,0.0
2020,5,2857,875,30,7891,2,16,9,2,4,2,3,1,3,0,False,False,False,0,1,2020-10-15T16:08:53.777,4,,1.0
2020,5,2857,880,30,63,13,35,9,12,0,0,0,0,0,0,False,False,False,0,4,2020-10-09T16:05:43.593,0,,0.0
2020,5,2857,885,30,2290,13,17,7,20,0,0,0,0,0,0,False,False,False,0,3,2020-10-09T16:07:12.48,0,,0.0
2020,5,2858,10,5,3477,2,2,9,3,12,9,4,8,4,0,True,False,False,1,2,2020-10-12T10:49:40.347,12,,8.0
2020,5,2858,15,5,5220,2,30,10,-2,10,12,4,6,4,0,False,False,False,0,3,2020-10-12T17:28:48.877,10,,6.0
2020,5,2858,30,5,3477,3,13,4,4,0,0,0,0,0,0,False,False,False,0,3,2020-10-15T18:52:08.767,0,,0.0
2020,5,2858,40,2,990,2,28,9,3,4,1,4,0,4,0,False,False,False,0,1,2020-10-15T21:13:19.657,4,,0.0
2020,5,2858,45,2,2223,2,12,4,0,2,2,0,2,0,0,False,False,False,0,4,2020-10-15T18:06:38.203,2,,2.0
2020,5,2858,50,2,7303,2,2,5,5,13,8,9,4,9,0,False,False,False,0,2,2020-10-12T11:12:18.61,13,,4.0
2020,5,2858,70,2,7303,13,2,9,9,0,0,0,0,0,0,False,False,False,0,2,2020-10-12T11:18:55.873,0,,0.0
2020,5,2858,80,2,7303,13,12,2,22,0,0,0,0,0,0,False,False,False,0,2,2020-10-15T16:23:59.243,0,,0.0
2020,5,2858,85,2,6249,2,39,4,6,7,1,7,0,7,0,False,False,False,0,3,2020-10-15T16:23:09.46,7,,0.0
2020,5,2858,115,5,4803,2,12,5,8,8,0,8,0,8,0,False,False,False,0,1,2020-10-15T13:59:05.973,8,,0.0
2020,5,2858,120,5,2554,2,46,3,3,13,10,8,5,8,0,False,False,False,1,1,2020-10-12T11:44:13.427,13,,5.0
2020,5,2858,125,5,2554,2,44,3,-2,7,9,6,1,6,0,False,False,False,0,1,2020-10-12T11:49:01.683,7,,1.0
2020,5,2858,135,5,4803,2,16,9,6,7,1,6,1,6,0,True,False,False,0,1,2020-10-12T17:29:56.647,7,,1.0
2020,5,2858,140,5,4803,2,5,3,4,5,1,5,0,5,0,False,False,False,0,3,2020-10-15T18:08:08.61,5,,0.0
2020,5,2858,145,5,3477,13,2,9,9,0,0,0,0,0,0,False,False,False,0,2,2020-10-15T18:16:18.737,0,,0.0
2020,5,2858,160,5,4803,2,6,8,17,17,0,17,0,17,0,False,False,False,0,2,2020-10-12T12:03:11.027,17,,0.0
2020,5,2858,175,5,3477,13,4,9,6,0,0,0,0,0,0,False,False,False,0,3,2020-10-15T16:28:32.79,0,,0.0
2020,5,2858,190,2,5223,2,5,5,5,8,3,8,0,8,0,False,False,False,0,2,2020-10-15T16:29:50.817,8,,0.0
2020,5,2858,205,2,5214,2,54,4,-2,-1,1,-1,0,-1,0,True,False,False,0,4,2020-10-12T12:21:24.96,-1,,0.0
2020,5,2858,210,2,6247,3,12,6,22,0,0,0,0,0,0,False,False,False,0,3,2021-03-08T18:43:12.427,0,,0.0
2020,5,2858,215,2,990,3,47,5,0,0,0,0,0,0,0,True,False,False,0,1,2020-10-13T16:41:13.097,0,,0.0
2020,5,2858,225,5,4803,2,50,9,-3,-1,2,-1,0,-1,0,True,False,False,0,3,2020-10-12T12:34:45.737,-1,,0.0
2020,5,2858,230,5,3477,2,9,6,24,29,5,24,5,24,0,False,False,False,0,2,2020-10-12T12:37:04.857,29,,5.0
2020,5,2858,240,5,3477,2,2,10,6,14,8,8,6,8,0,False,False,False,0,2,2020-10-12T12:44:24.863,14,,6.0
2020,5,2858,250,5,3477,2,30,3,0,1,1,1,0,1,0,True,False,False,0,4,2020-10-15T16:33:27.65,1,,0.0
2020,5,2858,275,2,5223,2,4,5,4,20,16,18,2,18,0,False,False,False,0,2,2020-10-12T17:16:32.563,20,,2.0
2020,5,2858,280,2,4670,2,48,9,-5,6,11,-1,7,-1,0,False,False,False,0,1,2020-10-15T18:04:19.243,6,,7.0
2020,5,2858,300,2,4670,2,4,4,2,9,7,8,1,8,0,False,False,False,0,1,2020-10-15T18:54:56.587,9,,1.0
2020,5,2858,310,5,3389,2,35,9,8,12,4,10,2,10,0,True,False,False,0,4,2020-10-13T16:33:18.767,12,,2.0
2020,5,2858,330,5,5220,2,26,9,3,57,54,57,0,57,6,False,False,False,0,3,2020-10-15T21:13:35.547,57,,0.0
2020,5,2858,345,2,990,2,45,10,-6,6,12,2,4,2,0,False,False,False,0,1,2020-10-15T18:02:19.93,6,,4.0
2020,5,2858,350,2,6247,2,4,3,8,8,0,8,0,8,0,False,False,False,0,3,2020-10-15T21:13:47.05,8,,0.0
2020,5,2858,360,2,5214,13,17,10,12,0,0,0,0,0,0,False,False,False,0,3,2020-10-15T21:17:10.103,0,,0.0
2020,5,2858,365,2,6247,13,6,9,5,0,0,0,0,0,0,False,False,False,0,3,2020-10-15T21:14:08.79,0,,0.0
2020,5,2858,385,5,3477,3,2,10,4,0,0,0,0,0,0,False,False,False,0,2,2021-02-16T16:36:14.29,0,,
2020,5,2858,390,5,2554,2,47,5,0,2,2,1,1,1,0,False,False,False,0,1,2021-01-12T23:25:56.437,2,,1.0
2020,5,2858,395,5,3477,2,39,4,3,8,5,8,0,8,0,False,False,False,0,3,2020-10-12T13:56:37.817,8,,0.0
2020,5,2858,400,5,5220,2,4,3,11,12,1,12,0,12,0,False,False,False,0,2,2020-10-12T13:59:00.387,12,,0.0
2020,5,2858,405,5,2554,2,48,10,-4,23,27,3,20,3,0,True,False,False,1,1,2020-10-15T18:02:34.767,23,,20.0
2020,5,2858,410,5,5220,13,19,2,29,0,0,0,0,0,0,False,False,False,0,2,2020-10-15T18:16:18.737,0,,0.0
2020,5,2858,415,5,3477,2,29,2,18,22,4,22,0,22,0,False,False,False,0,2,2020-10-12T14:06:32.7,22,,0.0
2020,5,2858,435,5,2554,2,47,5,2,3,1,3,0,3,6,False,False,False,0,1,2020-10-15T15:23:37.78,3,,0.0
2020,5,2858,490,2,5223,13,4,5,4,0,0,0,0,0,0,False,False,False,0,3,2020-10-12T14:35:56.91,0,,0.0
2020,5,2858,495,2,5214,13,4,10,5,0,0,0,0,0,0,False,False,False,0,3,2020-10-15T21:14:49.62,0,,0.0
2020,5,2858,510,5,2554,2,47,5,-2,1,3,-1,2,-1,0,False,False,False,0,1,2020-10-15T18:02:57.44,1,,2.0
2020,5,2858,520,5,3477,2,5,6,17,17,0,17,0,17,0,True,False,False,0,2,2020-10-15T16:40:28.017,17,,0.0
2020,5,2858,525,5,5220,2,2,10,6,14,8,6,8,6,0,False,False,False,1,2,2020-10-12T14:54:00.837,14,,8.0
2020,5,2858,535,5,2554,2,4,4,3,3,0,3,0,3,0,False,False,False,0,1,2020-10-15T16:41:14.217,3,,0.0
2020,5,2858,550,5,2554,2,47,5,-1,-1,0,-1,0,-1,0,False,False,False,0,1,2020-10-15T16:42:01.477,-1,,0.0
2020,5,2858,570,2,990,2,28,4,5,8,3,3,5,3,0,False,False,False,1,1,2020-10-15T16:44:23.273,8,,5.0
2020,5,2858,580,2,5223,2,12,2,17,17,0,17,0,17,0,False,False,False,0,2,2020-10-15T18:56:31.907,17,,0.0
2020,5,2858,585,2,5223,2,4,5,4,4,0,4,0,4,0,False,False,False,0,2,2020-10-12T17:17:22.657,4,,0.0
2020,5,2858,600,2,5223,2,7,2,24,26,2,26,0,26,0,True,False,False,0,2,2020-10-15T16:46:37.443,26,,0.0
2020,5,2858,615,2,5223,2,3,10,12,13,1,13,0,13,0,False,False,False,0,3,2020-10-15T18:57:02.747,13,,0.0
2020,5,2858,630,2,5214,13,17,10,13,0,0,0,0,0,0,False,False,False,0,4,2020-10-15T18:57:15.56,0,,0.0
2020,5,2858,635,2,7303,13,12,4,4,0,0,0,0,0,0,False,False,False,0,2,2020-10-15T18:57:28.643,0,,0.0
2020,5,2858,650,5,2554,13,4,4,2,0,0,0,0,0,0,False,False,False,0,1,2020-10-12T15:46:50.78,0,,0.0
2020,5,2858,655,5,6425,3,4,9,11,0,0,0,0,0,0,False,False,False,0,3,2020-10-12T15:48:54.993,0,,0.0
2020,5,2858,660,5,3477,13,7,2,22,0,0,0,0,0,0,False,False,False,0,2,2020-10-15T16:48:32.64,0,,0.0
2020,5,2858,670,2,5223,2,5,6,24,26,2,26,0,26,0,False,False,False,0,2,2020-10-12T17:18:42.05,26,,0.0
2020,5,2858,700,2,990,2,55,4,-1,11,12,8,3,8,0,False,False,False,0,1,2021-02-15T15:34:29.26,11,,3.0
2020,5,2858,715,2,6247,13,17,9,5,0,0,0,0,0,0,False,False,False,0,3,2020-10-15T21:15:02.97,0,,0.0
2020,5,2858,725,5,3477,2,2,10,4,9,5,6,3,6,0,False,False,False,0,2,2020-10-12T16:18:00.3,9,,3.0
2020,5,2858,745,5,2554,2,51,9,-6,9,15,2,7,2,0,True,False,False,1,1,2020-10-15T18:03:32.403,9,,7.0
2020,5,2858,830,2,5214,2,32,3,8,9,1,9,0,9,0,False,False,False,0,4,2020-10-12T16:43:47.12,9,,0.0
2020,5,2858,835,2,6247,2,46,3,3,8,5,8,0,8,0,False,False,False,0,3,2020-10-15T17:14:41.2,8,,0.0
2020,5,2858,840,2,5223,3,6,1,17,0,0,0,0,0,0,False,False,False,0,2,2020-10-12T16:49:30.26,0,,0.0
2020,5,2858,845,2,6342,13,4,3,12,0,0,0,0,0,0,False,False,False,0,2,2020-10-12T16:52:08.38,0,,0.0
2020,5,2858,850,2,5214,13,6,9,13,0,0,0,0,0,0,False,False,False,0,2,2021-03-08T18:44:34.36,0,,0.0
2020,5,2858,855,2,5223,2,9,6,19,22,3,20,2,20,0,False,False,False,0,2,2021-02-25T14:56:51.557,22,,2.0
2020,5,2859,10,7,6975,2,8,4,13,14,1,14,0,14,0,False,False,False,0,3,2020-10-15T13:31:51.66,14,,0.0
2020,5,2859,20,7,7659,13,5,3,7,0,0,0,0,0,0,False,False,False,0,3,2021-02-15T19:16:50.91,0,,0.0
2020,5,2859,35,3,5017,2,47,5,1,7,6,5,2,5,0,False,False,False,0,1,2020-10-15T15:45:21.683,7,,2.0
2020,5,2859,45,3,6936,13,12,8,31,0,0,0,0,0,0,False,False,False,0,3,2021-03-08T19:00:34.54,0,,0.0
2020,5,2859,55,3,6454,13,17,8,21,0,0,0,0,0,0,False,False,False,0,3,2020-10-14T02:16:37.01,0,,0.0
2020,5,2859,75,7,7659,2,3,2,18,26,8,22,4,22,0,False,False,False,0,3,2020-10-12T10:28:47.11,26,,4.0
2020,5,2859,85,7,3521,13,8,4,14,0,0,0,0,0,0,False,False,False,0,3,2020-10-12T10:31:35.177,0,,0.0
2020,5,2859,100,7,3521,13,12,2,22,0,0,0,0,0,0,False,False,False,0,3,2021-03-08T19:01:34.847,0,,0.0
2020,5,2859,115,3,6936,2,26,10,3,16,13,14,2,14,0,False,False,False,0,2,2020-10-15T15:48:42.14,16,,2.0
2020,5,2859,120,3,6936,13,23,1,41,0,0,0,0,0,0,False,False,False,0,3,2020-10-15T15:50:35.697,0,,0.0
2020,5,2859,125,3,7672,2,4,5,8,9,1,8,1,8,0,False,False,False,0,3,2020-10-15T15:24:28.13,9,,1.0
2020,5,2859,140,3,6935,13,13,5,5,0,0,0,0,0,0,False,False,False,0,2,2020-10-15T16:26:35.94,0,,0.0
2020,5,2859,145,3,6454,2,2,4,5,9,4,7,2,7,0,False,False,False,0,3,2020-10-12T10:54:15.52,9,,2.0
2020,5,2859,155,3,6659,13,12,5,12,0,0,0,0,0,0,True,False,False,0,2,2021-02-25T15:07:45.077,0,,0.0
2020,5,2859,160,3,6454,2,8,3,14,14,0,14,0,14,0,False,False,False,0,3,2020-10-12T10:59:13.833,14,,0.0
2020,5,2859,180,3,6454,2,16,4,5,5,0,5,0,5,6,False,False,False,0,3,2020-10-12T11:06:03.203,5,,0.0
2020,5,2859,195,7,7659,13,8,7,38,0,0,0,0,0,0,False,False,False,0,2,2020-10-13T21:36:02.577,0,,0.0
2020,5,2859,205,7,910,13,6,8,18,0,0,0,0,0,0,False,False,False,0,2,2021-03-05T17:50:17.353,0,,0.0
2020,5,2859,215,3,6454,2,4,9,10,14,4,11,3,11,0,False,False,False,0,3,2020-10-12T11:17:23.603,14,,3.0
2020,5,2859,225,3,6936,2,5,10,2,2,0,2,0,2,6,False,False,False,0,3,2020-10-12T11:23:26.533,2,,0.0
2020,5,2859,245,7,6383,2,4,10,4,12,8,8,4,8,0,False,False,False,0,2,2020-10-12T11:27:34.983,12,,4.0
2020,5,2859,255,7,4679,2,12,10,-8,-2,6,-3,1,-3,0,False,False,False,0,1,2021-03-08T19:03:55.407,-2,,1.0
2020,5,2859,260,7,3521,2,5,3,14,14,0,14,0,14,0,False,False,False,0,3,2020-10-12T11:33:43.02,14,,0.0
2020,5,2859,265,7,3521,2,47,5,0,6,6,3,3,3,0,False,False,False,1,3,2020-10-15T15:30:13.97,6,,3.0
2020,5,2859,280,7,910,13,12,2,24,0,0,0,0,0,0,False,False,False,0,2,2021-03-08T19:04:31.747,0,,
2020,5,2859,295,3,6659,13,11,3,5,0,0,0,0,0,0,True,False,False,0,3,2021-02-25T15:11:15.273,0,,0.0
2020,5,2859,300,3,6454,2,31,4,5,7,2,6,1,6,0,True,False,False,0,4,2020-10-12T11:46:02.757,7,,1.0
2020,5,2859,305,3,2976,2,13,4,2,2,0,2,0,2,0,False,False,False,0,4,2020-10-15T16:28:12.89,2,,0.0
2020,5,2859,310,3,6454,13,9,2,19,0,0,0,0,0,0,False,False,False,0,3,2020-10-12T11:52:07.203,0,,0.0
2020,5,2859,315,7,4679,2,48,10,-2,7,9,7,0,7,0,False,False,False,0,1,2020-10-12T15:26:38.673,3,,0.0
2020,5,2859,325,7,4679,13,47,5,-3,0,0,0,0,0,0,False,False,False,0,1,2020-10-12T11:57:50.707,0,,0.0
2020,5,2859,330,7,3521,2,2,4,6,10,4,8,2,8,0,False,False,False,0,3,2020-10-12T11:59:27.007,10,,2.0
2020,5,2859,355,3,6454,13,7,2,15,0,0,0,0,0,0,False,False,False,0,4,2020-10-15T16:28:35.6,0,,0.0
2020,5,2859,360,3,2976,13,4,10,4,0,0,0,0,0,0,True,False,False,0,4,2020-10-15T14:53:48.977,0,,0.0
2020,5,2859,385,7,931,13,48,9,-3,0,0,0,0,0,0,False,False,False,0,1,2020-10-15T15:56:31.37,0,,0.0
2020,5,2859,395,3,7671,2,16,10,4,9,5,7,2,7,0,False,False,False,1,1,2020-10-15T15:30:58.97,9,,2.0
2020,5,2859,405,3,6936,13,8,1,27,0,0,0,0,0,0,False,False,False,0,2,2020-10-12T12:26:37.83,0,,0.0
2020,5,2859,410,3,6659,13,11,3,-5,0,0,0,0,0,0,False,False,False,0,1,2020-10-15T15:57:09.473,0,,0.0
2020,5,2859,415,3,2688,13,2,4,3,0,0,0,0,0,0,False,False,False,0,3,2020-10-12T12:33:16.37,0,,0.0
2020,5,2859,420,7,7659,13,5,3,10,0,0,0,0,0,0,False,False,False,0,3,2020-10-12T12:35:10.713,0,,0.0
2020,5,2859,425,7,7659,13,13,10,-4,0,0,0,0,0,0,False,False,False,0,2,2020-10-12T12:37:27.02,0,,0.0
2020,5,2859,430,7,931,2,5,3,1,4,3,4,0,4,0,True,False,False,0,3,2020-10-12T12:39:10.073,4,,0.0
2020,5,2859,440,3,6936,2,5,5,5,12,7,8,4,8,0,False,False,False,1,2,2020-10-12T12:41:26.22,12,,4.0
2020,5,2859,455,3,7671,2,47,5,-1,9,10,9,0,9,0,False,False,False,0,1,2020-10-15T15:59:11.437,9,,0.0
2020,5,2859,465,3,6936,2,5,5,12,12,0,12,0,12,0,False,False,False,0,3,2020-10-15T15:03:40.92,12,,0.0
2020,5,2859,470,3,7671,2,47,5,-1,3,4,3,0,3,0,False,False,False,0,1,2020-10-12T12:48:54.293,3,,0.0
2020,5,2859,475,3,6454,2,2,4,5,7,2,6,1,6,0,False,False,False,0,3,2020-10-12T12:50:15.183,7,,1.0
2020,5,2859,505,3,5017,13,12,4,5,0,0,0,0,0,0,False,False,False,0,1,2021-03-15T14:16:29.207,0,,0.0
2020,5,2859,510,3,6936,2,12,9,4,5,1,4,1,4,0,False,False,False,0,3,2021-03-08T19:05:28.65,5,,1.0
2020,5,2859,520,7,7659,2,2,4,12,16,4,13,3,13,0,False,False,False,0,3,2020-10-12T13:16:40.943,16,,3.0
2020,5,2859,545,3,6936,13,5,5,6,0,0,0,0,0,0,False,False,False,0,3,2020-10-12T13:24:11.37,0,,0.0
2020,5,2859,550,3,7672,2,51,9,-3,8,11,5,3,5,0,False,False,False,0,3,2021-02-15T19:19:42.18,8,,3.0
2020,5,2859,560,3,6936,2,12,10,12,30,18,11,19,11,0,False,False,False,1,3,2021-03-08T19:06:00.3,30,,19.0
2020,5,2859,575,3,2688,13,2,4,2,0,0,0,0,0,0,False,False,False,0,3,2020-10-12T13:39:22.893,0,,0.0
2020,5,2859,595,7,6975,2,2,10,6,8,2,6,2,6,0,False,False,False,1,3,2020-10-12T15:17:45.923,8,,2.0
2020,5,2859,630,3,6935,13,9,2,21,0,0,0,0,0,0,False,False,False,0,2,2021-04-01T19:05:34.663,0,,0.0
2020,5,2859,650,7,4679,13,12,10,5,0,0,0,0,0,0,False,False,False,0,1,2021-03-08T19:06:26.343,0,,0.0
2020,5,2859,655,7,7659,2,6,4,6,11,5,7,4,7,0,False,False,False,0,3,2020-10-12T13:59:20.127,11,,4.0
2020,5,2859,665,7,4679,2,45,5,-4,3,7,2,1,2,0,False,False,False,0,1,2020-10-12T15:29:10.86,3,,1.0
2020,5,2859,670,7,6975,13,19,6,25,0,0,0,0,0,0,False,False,False,0,2,2020-10-12T14:04:31.783,0,,
2020,5,2859,695,7,4679,2,48,10,-7,5,12,2,3,2,0,False,False,False,1,1,2020-10-12T15:29:27.46,5,,3.0
2020,5,2859,705,3,2688,13,5,10,6,0,0,0,0,0,0,False,False,False,0,3,2020-10-12T14:23:28.277,0,,0.0
2020,5,2859,735,7,3521,2,26,4,9,12,3,10,2,10,0,False,False,False,0,3,2020-10-15T13:30:56.38,12,,2.0
2020,5,2859,745,7,7659,2,4,5,5,9,4,6,3,6,0,False,False,False,0,2,2020-10-13T21:37:26.783,9,,3.0
2020,5,2859,750,7,3445,2,4,3,9,9,0,9,0,9,0,False,True,True,0,2,2020-10-13T21:37:51.34,6,,0.0
2020,5,2859,780,7,4679,2,50,5,-4,7,11,1,6,1,0,True,False,False,1,2,2020-10-12T15:30:08.347,7,,6.0
2020,5,2859,790,7,4679,2,29,3,13,19,6,16,3,16,0,False,False,False,0,3,2020-10-13T21:38:09.71,19,,3.0
2020,5,2860,15,15,2757,2,26,10,0,6,6,4,2,4,0,False,False,False,0,4,2021-02-16T15:28:52.097,6,,2.0
2020,5,2860,20,15,7591,13,35,7,15,0,0,0,0,0,0,True,False,False,0,3,2020-10-15T15:13:18.98,0,,0.0
2020,5,2860,35,13,876,2,9,2,25,36,11,28,8,28,0,False,False,False,0,3,2020-10-15T14:55:55.997,36,,8.0
2020,5,2860,45,13,876,2,50,9,-3,-2,1,-2,0,-2,0,False,False,False,0,3,2020-10-12T10:40:33.517,-2,,0.0
2020,5,2860,50,13,4662,2,32,5,-2,4,6,-2,6,-2,0,False,False,False,0,4,2021-02-16T15:42:47.17,4,,6.0
2020,5,2860,85,15,8099,13,51,5,-4,0,0,0,0,0,0,True,False,False,0,1,2020-10-12T17:43:20.96,0,,0.0
2020,5,2860,90,15,1561,2,28,9,2,8,6,6,2,6,0,False,False,False,0,1,2020-10-12T11:03:38.507,8,,2.0
2020,5,2860,100,13,3951,13,2,4,10,0,0,0,0,0,0,False,False,False,0,3,2021-02-16T19:08:44.62,0,,0.0
2020,5,2860,120,13,876,13,43,2,17,0,0,0,0,0,0,False,False,False,0,3,2021-03-15T14:25:47.483,0,,0.0
2020,5,2860,125,13,2136,2,5,3,4,14,10,10,4,10,0,True,False,False,0,3,2021-02-16T15:55:25.377,14,,4.0
2020,5,2860,135,13,496,2,5,9,4,6,2,5,1,5,0,False,False,False,0,3,2020-10-12T11:23:06.537,6,,1.0
2020,5,2860,140,13,2455,2,44,3,-1,3,4,0,3,0,0,False,False,False,0,1,2021-02-16T15:59:40.27,3,,3.0
2020,5,2860,150,13,1430,2,12,5,13,13,0,13,0,13,0,False,False,False,0,4,2020-10-12T11:41:08.427,13,,0.0
2020,5,2860,175,13,876,13,35,10,8,0,0,0,0,0,0,False,False,False,0,3,2020-10-12T11:49:31.533,0,,0.0
2020,5,2860,180,13,2455,2,48,9,-4,4,8,-2,6,-2,0,True,False,False,0,1,2020-10-13T15:05:29.787,4,,6.0
2020,5,2860,195,15,7591,2,50,9,-2,15,17,10,5,10,0,False,False,False,0,3,2021-02-16T19:10:48.43,15,,5.0
2020,5,2860,205,15,8099,2,45,10,-5,3,8,1,2,1,0,False,False,False,0,1,2020-10-12T12:03:59.97,3,,2.0
2020,5,2860,220,15,2407,2,39,4,5,7,2,6,1,6,0,False,False,False,0,3,2020-10-12T12:12:14.927,7,,1.0
2020,5,2860,225,15,922,2,46,3,0,13,13,8,5,8,0,True,False,False,0,1,2020-10-12T12:14:40.81,13,,5.0
2020,5,2860,235,15,8099,2,28,10,-1,3,4,2,1,2,0,False,False,False,0,1,2020-10-13T18:07:02.69,3,,1.0
2020,5,2860,240,15,8099,2,4,10,1,4,3,4,0,4,0,False,False,False,0,1,2020-10-12T12:25:12.443,4,,0.0
2020,5,2860,245,15,6501,13,9,2,22,0,0,0,0,0,0,False,False,False,0,2,2020-10-12T18:01:31.053,0,,
2020,5,2860,250,15,6501,2,4,9,4,4,0,4,0,4,0,False,False,False,0,2,2020-10-12T12:41:47.903,4,,0.0
2020,5,2860,260,15,4997,2,7,5,13,13,0,13,0,13,6,False,False,False,0,3,2020-10-12T17:29:17.357,13,,0.0
2020,5,2860,275,13,496,2,35,10,13,17,4,16,1,16,0,False,False,False,0,3,2020-10-15T16:10:53.907,17,,1.0
2020,5,2860,285,13,3951,2,3,3,11,11,0,11,0,11,0,False,False,False,0,2,2020-10-15T15:13:01.63,11,,0.0
2020,5,2860,290,13,1430,2,35,9,14,44,30,43,1,43,6,False,False,False,0,3,2020-10-12T17:29:50.633,44,,1.0
2020,5,2860,310,15,7591,2,35,7,21,25,4,22,3,22,0,False,False,False,0,3,2020-10-12T13:04:29.617,25,,3.0
2020,5,2860,320,15,922,2,46,3,2,2,0,2,0,2,0,True,False,False,0,4,2021-02-16T16:52:57.08,2,,0.0
2020,5,2860,330,15,7591,2,26,3,2,13,11,5,8,5,0,True,False,False,2,2,2020-10-13T18:11:39.783,13,,8.0
2020,5,2860,345,15,7592,2,12,7,15,19,4,15,4,15,0,False,False,False,0,3,2021-02-16T21:48:32.817,19,,4.0
2020,5,2860,350,15,6501,13,26,5,6,0,0,0,0,0,0,False,False,False,0,2,2020-10-12T13:18:06.06,0,,0.0
2020,5,2860,365,15,7591,2,51,9,-6,-3,3,-3,0,-3,0,False,False,False,0,1,2020-10-15T16:50:11.503,-3,,0.0
2020,5,2860,380,13,3951,13,6,7,16,0,0,0,0,0,0,False,False,False,0,2,2021-03-05T17:53:34.113,0,,0.0
2020,5,2860,395,15,7591,2,4,3,5,11,6,8,3,8,0,False,False,False,0,2,2020-10-12T13:31:00.423,11,,3.0
2020,5,2860,405,15,922,13,17,1,21,0,0,0,0,0,0,False,False,False,0,3,2020-10-12T13:33:22.517,0,,0.0
2020,5,2860,410,15,7592,13,9,2,21,0,0,0,0,0,0,False,False,False,0,2,2020-10-12T17:32:31.707,0,,
2020,5,2860,435,13,3951,2,2,10,5,9,4,8,1,8,0,False,False,False,0,2,2020-10-12T13:41:26.183,9,,1.0
2020,5,2860,445,13,876,13,2,9,12,0,0,0,0,0,0,False,False,False,0,3,2020-10-12T13:48:17.85,0,,0.0
2020,5,2860,450,13,876,2,9,6,20,23,3,23,0,23,0,False,False,False,0,2,2020-10-12T13:50:57.61,23,,0.0
2020,5,2860,455,13,496,2,32,10,3,6,3,5,1,5,0,False,False,False,0,3,2020-10-15T16:12:12.637,6,,1.0
2020,5,2860,465,13,2455,13,7,2,15,0,0,0,0,0,0,True,False,False,0,1,2021-02-16T17:18:59.467,0,,0.0
2020,5,2860,490,15,1561,2,50,5,-4,15,19,13,2,13,0,False,False,False,0,3,2020-10-15T14:21:25.413,15,,2.0
2020,5,2860,500,13,3951,2,7,2,18,19,1,19,0,19,0,False,False,False,0,3,2020-10-13T15:03:47.57,19,,0.0
2020,5,2860,505,13,876,13,5,3,4,0,0,0,0,0,0,False,False,False,0,3,2020-10-15T14:22:09.03,0,,0.0
2020,5,2860,510,13,876,2,39,10,5,9,4,8,1,8,0,False,False,False,0,3,2020-10-12T14:27:48.47,9,,1.0
2020,5,2860,520,13,496,2,13,5,4,9,5,8,1,8,0,True,False,False,0,3,2020-10-12T14:31:22.993,9,,1.0
2020,5,2860,525,13,3951,13,7,6,37,0,0,0,0,0,0,False,False,False,0,2,2021-03-05T17:54:09.147,0,,0.0
2020,5,2860,535,15,8099,2,44,9,-6,7,13,7,0,7,0,False,False,False,0,1,2021-02-16T19:13:02.043,7,,0.0
2020,5,2860,550,15,922,2,47,10,1,1,0,1,0,1,0,True,False,False,0,1,2020-10-12T14:51:31.76,1,,0.0
2020,5,2860,580,13,876,2,6,6,17,22,5,21,1,21,0,False,False,False,0,3,2021-02-16T17:48:03.097,22,,1.0
2020,5,2860,585,13,496,2,4,9,5,5,0,5,0,5,0,False,False,False,0,3,2020-10-12T15:16:49.653,5,,0.0
2020,5,2860,590,13,876,2,6,9,7,9,2,5,4,5,0,False,False,False,0,2,2020-10-15T14:22:52.51,9,,4.0
2020,5,2860,600,13,404,2,46,3,0,11,11,8,3,8,0,False,False,False,1,1,2020-10-15T14:46:58.72,11,,3.0
2020,5,2860,605,13,3951,2,6,6,17,19,2,19,0,19,6,False,False,False,0,3,2020-10-15T16:13:13.827,19,,0.0
2020,5,2860,620,15,6501,2,4,9,12,11,-1,11,0,11,0,False,False,False,0,2,2020-10-12T15:31:50.73,11,,0.0
2020,5,2860,625,15,2757,2,4,10,5,8,3,7,1,7,0,False,False,False,0,4,2020-10-12T15:34:54.257,8,,1.0
2020,5,2860,630,15,6501,2,13,10,1,1,0,1,0,1,0,False,False,False,0,3,2020-10-12T15:39:25.257,1,,0.0
2020,5,2860,645,15,2407,2,19,8,48,51,3,50,1,50,0,False,False,False,0,2,2020-10-12T15:46:36.943,51,,1.0
2020,5,2860,660,15,7592,13,9,3,4,0,0,0,0,0,0,False,False,False,0,2,2020-10-12T15:52:44.637,0,,0.0
2020,5,2860,665,15,7592,2,13,5,4,4,0,4,0,4,6,False,False,False,0,3,2021-02-16T18:14:57.073,4,,0.0
2020,5,2860,685,13,876,2,9,2,27,36,9,29,7,29,0,False,False,False,0,3,2020-10-12T16:00:12.57,36,,7.0
2020,5,2860,690,13,496,2,4,10,4,4,0,4,0,4,0,False,False,False,0,3,2020-10-15T14:26:00.303,4,,0.0
2020,5,2860,700,13,3951,13,2,10,4,0,0,0,0,0,0,False,False,False,0,2,2020-10-12T16:06:58.997,0,,0.0
2020,5,2860,715,15,4997,2,5,3,12,12,0,12,0,12,0,False,False,False,0,3,2021-02-16T18:38:46.98,12,,0.0
2020,5,2860,720,15,8099,13,12,9,-5,0,0,0,0,0,0,False,False,False,0,1,2021-03-05T18:40:21.173,0,,0.0
2020,5,2860,725,15,7591,2,4,5,6,10,4,8,2,8,0,False,False,False,0,2,2020-10-12T16:17:38.74,10,,2.0
2020,5,2860,730,15,922,13,2,10,7,0,0,0,0,0,0,False,False,False,0,2,2020-10-15T15:42:18.22,0,,0.0
2020,5,2860,760,13,2455,13,16,4,9,0,0,0,0,0,0,False,False,False,0,1,2020-10-12T16:36:50.423,0,,0.0
2020,5,2860,765,13,876,2,2,10,9,28,19,28,0,28,6,False,False,False,0,2,2020-10-15T15:03:54.213,28,,0.0
2020,5,2860,780,15,4997,13,8,8,20,0,0,0,0,0,0,False,False,False,0,3,2021-02-16T18:50:13.597,0,,0.0
2020,5,2860,785,15,8099,2,12,10,-5,5,10,2,3,2,0,False,False,False,0,1,2020-10-15T16:07:03.787,5,,3.0
2020,5,2860,790,15,7592,2,4,5,5,7,2,5,2,5,0,False,False,False,0,2,2021-02-16T18:52:49.137,7,,2.0
2020,5,2860,795,15,2757,2,46,3,3,6,3,4,2,4,0,True,False,False,0,4,2021-02-16T18:54:28.397,6,,2.0
2020,5,2860,800,15,922,13,5,10,7,0,0,0,0,0,0,False,False,False,0,3,2020-10-12T16:57:15.133,0,,0.0
2020,5,2860,805,15,7591,2,13,10,3,8,5,8,0,8,0,False,False,False,0,3,2021-02-16T18:56:03.673,8,,0.0
2020,5,2860,810,15,922,13,8,8,19,0,0,0,0,0,0,False,False,False,0,3,2021-03-15T14:25:58.073,0,,0.0
2020,5,2860,815,15,1561,2,4,10,3,12,9,11,1,11,0,False,False,False,0,1,2020-10-12T17:04:55.37,12,,1.0
2020,5,2860,830,15,4997,13,13,5,3,0,0,0,0,0,0,False,False,False,0,3,2020-10-12T17:09:07.327,0,,0.0
2020,5,2860,835,15,4997,13,7,6,25,0,0,0,0,0,0,False,False,False,0,3,2020-10-15T15:04:20.663,0,,0.0
2020,5,2860,840,15,4997,13,9,6,29,0,0,0,0,0,0,False,False,False,0,2,2021-02-16T19:04:50.197,0,,0.0
2020,5,2861,20,16,3938,2,8,1,58,58,0,58,0,58,6,False,False,False,0,3,2020-10-13T19:25:42.99,58,,
2020,5,2861,25,16,7681,13,47,5,5,0,0,0,0,0,0,True,False,False,0,1,2020-10-13T19:16:09.16,0,,0.0
2020,5,2861,35,16,374,2,53,10,-2,9,11,8,1,8,0,False,False,False,0,4,2020-10-12T10:40:11.893,9,,1.0
2020,5,2861,60,23,2994,2,51,3,1,9,8,2,7,2,0,False,False,False,1,4,2021-03-02T18:57:58.87,9,,7.0
2020,5,2861,75,23,7688,2,11,2,43,46,3,45,1,45,0,False,False,False,0,3,2020-10-12T11:07:10.677,46,,1.0
2020,5,2861,85,23,6630,13,11,2,22,0,0,0,0,0,0,True,False,False,0,3,2020-10-12T11:15:43.717,0,,0.0
2020,5,2861,100,23,3843,2,47,5,3,12,9,9,3,9,0,False,False,False,0,1,2020-10-12T11:19:36.597,12,,3.0
2020,5,2861,125,16,374,2,5,10,10,12,2,11,1,11,0,False,False,False,1,3,2020-10-13T19:30:16.037,12,,1.0
2020,5,2861,135,16,3938,2,7,2,26,26,0,26,0,26,0,False,False,False,0,3,2020-10-12T11:41:22.3,26,,0.0
2020,5,2861,150,16,374,2,5,5,6,32,26,5,27,5,0,False,False,False,0,3,2020-10-13T19:26:25.417,32,,27.0
2020,5,2861,170,23,2994,13,29,2,20,0,0,0,0,0,0,False,False,False,0,2,2020-10-12T18:28:40.607,0,,
2020,5,2861,180,23,2994,2,30,5,2,4,2,4,0,4,0,False,False,False,0,4,2020-10-15T22:05:13.187,4,,0.0
2020,5,2861,185,23,2994,13,35,6,20,0,0,0,0,0,0,False,False,False,0,4,2021-03-05T17:56:31.973,0,,0.0
2020,5,2861,195,16,7176,2,51,9,-5,13,18,13,0,13,0,True,False,False,0,3,2020-10-13T19:30:28.693,13,,0.0
2020,5,2861,205,16,374,2,4,9,5,5,0,5,0,5,0,False,False,False,0,3,2020-10-12T13:14:17.713,5,,0.0
2020,5,2861,240,23,3957,2,4,4,5,5,0,5,0,5,0,False,False,False,0,1,2020-10-12T13:23:08.243,5,,0.0
2020,5,2861,245,23,2256,2,8,8,38,59,21,55,4,55,6,False,False,False,0,3,2020-10-15T22:06:57.843,59,,4.0
2020,5,2861,265,16,121,2,35,6,16,16,0,16,0,16,0,False,False,False,0,3,2020-10-12T13:30:50.767,16,,0.0
2020,5,2861,275,16,3938,2,19,6,36,37,1,37,0,37,0,False,False,False,0,3,2020-10-13T19:19:40.867,37,,0.0
2020,5,2861,280,16,374,13,7,3,9,0,0,0,0,0,0,False,False,False,0,3,2020-10-12T13:40:53.687,0,,0.0
2020,5,2861,290,16,121,2,12,5,8,8,0,8,0,8,6,False,False,False,0,3,2020-10-12T13:44:15.763,8,,0.0
2020,5,2861,315,23,7240,2,7,5,14,23,9,20,3,20,0,False,False,False,0,1,2020-10-15T21:35:31.577,23,,3.0
2020,5,2861,325,23,2994,2,2,4,5,5,0,5,0,5,6,False,False,False,0,3,2021-02-25T15:24:21.47,5,,0.0
2020,5,2861,340,16,7681,2,47,10,-2,4,6,0,4,0,0,True,False,False,1,1,2020-10-13T19:16:35.753,4,,4.0
2020,5,2861,345,16,7681,13,44,3,-5,0,0,0,0,0,0,True,False,False,0,1,2020-10-12T13:57:57.627,0,,0.0
2020,5,2861,350,16,374,2,5,5,7,14,7,8,6,8,0,False,False,False,0,3,2020-10-12T14:01:22.767,14,,6.0
2020,5,2861,360,16,6499,13,48,9,-3,0,0,0,0,0,0,False,False,False,0,1,2020-10-12T14:09:18.483,0,,0.0
2020,5,2861,365,16,3938,13,23,8,60,0,0,0,0,0,0,False,False,False,0,3,2021-03-08T19:11:19.603,0,,0.0
2020,5,2861,375,16,7182,3,12,8,27,0,0,0,0,0,0,False,False,False,0,4,2021-02-15T19:39:42.113,0,,0.0
2020,5,2861,395,23,7688,2,19,1,38,72,34,72,0,72,6,False,False,False,0,3,2020-10-15T22:24:54.793,72,,0.0
2020,5,2861,410,16,3938,13,19,7,45,0,0,0,0,0,0,False,False,False,0,3,2020-10-12T14:30:13.193,0,,0.0
2020,5,2861,415,16,7176,13,6,4,10,0,0,0,0,0,0,False,False,False,0,3,2020-10-12T14:31:55.037,0,,0.0
2020,5,2861,430,16,374,2,12,1,25,23,-2,23,0,23,0,False,False,False,0,3,2020-10-12T14:35:00.137,23,,0.0
2020,5,2861,445,16,3938,2,4,9,11,15,4,12,3,12,0,False,False,False,2,2,2020-10-12T14:59:09.037,15,,3.0
2020,5,2861,455,16,6499,13,32,5,-4,0,0,0,0,0,0,True,False,False,0,1,2020-10-13T19:16:49.563,0,,0.0
2020,5,2861,460,16,6500,2,5,9,10,23,13,19,4,19,0,False,False,False,0,3,2020-10-12T14:44:29.463,23,,4.0
2020,5,2861,470,16,7681,2,46,3,0,4,4,4,0,4,6,False,False,False,0,1,2021-02-15T19:54:02.593,4,,
2020,5,2861,475,16,4143,13,12,10,14,0,0,0,0,0,0,False,False,False,0,3,2021-03-08T19:12:30.96,0,,0.0
2020,5,2861,480,16,3938,13,12,5,14,0,0,0,0,0,0,False,False,False,0,2,2021-02-15T19:40:16.813,0,,0.0
2020,5,2861,495,23,3843,2,48,10,-5,3,8,1,2,1,0,False,False,False,0,1,2020-10-15T22:12:54.567,3,,2.0
2020,5,2861,505,23,2256,2,13,4,3,8,5,7,1,7,0,False,False,False,0,3,2020-10-15T20:56:45.67,8,,1.0
2020,5,2861,530,23,7250,13,6,10,12,0,0,0,0,0,0,False,False,False,0,3,2021-01-12T23:27:00.183,0,,0.0
2020,5,2861,545,16,374,2,4,9,6,6,0,6,0,6,0,False,False,False,0,3,2020-10-12T15:24:56.127,6,,0.0
2020,5,2861,560,23,7240,13,11,2,30,0,0,0,0,0,0,False,False,False,0,3,2020-10-15T20:38:34.55,0,,0.0
2020,5,2861,565,23,3843,2,16,10,6,10,4,9,1,9,0,False,False,False,0,1,2020-10-12T15:32:49.95,10,,1.0
2020,5,2861,570,23,3843,2,34,4,-3,1,4,0,1,0,0,True,False,False,0,3,2020-10-13T17:08:22.59,1,,1.0
2020,5,2861,575,23,2994,13,11,6,25,0,0,0,0,0,0,False,False,False,0,4,2020-10-12T15:36:22.23,0,,0.0
2020,5,2861,585,23,7688,13,5,5,13,0,0,0,0,0,0,False,False,False,0,3,2020-10-15T20:56:45.67,0,,0.0
2020,5,2861,595,16,7681,13,16,10,2,0,0,0,0,0,0,True,False,False,0,1,2020-10-13T19:17:01.907,0,,0.0
2020,5,2861,600,16,7681,2,12,5,9,16,7,11,5,11,0,False,False,False,1,1,2021-02-25T15:25:39.09,16,,5.0
2020,5,2861,615,16,374,13,6,4,11,0,0,0,0,0,0,False,False,False,0,3,2020-10-12T15:48:17.953,0,,0.0
2020,5,2861,630,23,2994,13,12,5,6,0,0,0,0,0,0,False,False,False,0,3,2020-10-12T15:53:50.727,0,,
2020,5,2861,640,23,7241,2,31,10,-2,4,6,2,2,2,0,False,False,False,0,1,2020-10-15T22:14:37.497,4,,2.0
2020,5,2861,645,23,7240,2,46,3,-1,2,3,1,1,1,0,False,False,False,0,1,2020-10-12T16:03:11.84,2,,1.0
2020,5,2861,660,23,7241,2,28,9,-2,4,6,1,3,1,0,False,False,False,1,1,2020-10-15T21:38:42.633,4,,3.0
2020,5,2861,665,23,2994,2,16,10,6,23,17,20,3,20,0,False,False,False,0,4,2021-02-16T21:51:46.167,23,,3.0
2020,5,2861,670,23,2994,2,51,10,-4,7,11,5,2,5,0,False,False,False,0,4,2020-10-15T21:23:47.717,7,,2.0
2020,5,2861,745,23,7241,3,16,9,6,0,0,0,0,0,0,False,False,False,0,1,2020-10-12T16:40:37.72,0,,0.0
2020,5,2861,750,23,596,2,53,10,-4,2,6,1,1,1,0,False,False,False,0,4,2021-02-15T19:44:55.213,2,,1.0
2020,5,2861,755,23,7250,2,35,8,27,42,15,40,2,40,0,False,False,False,0,3,2021-02-16T21:53:15.023,42,,2.0
2020,5,2861,775,23,596,2,13,5,4,4,0,4,0,4,0,False,False,False,0,4,2020-10-12T16:50:22.32,4,,0.0
2020,5,2861,785,23,7240,13,4,5,5,0,0,0,0,0,0,True,False,False,0,2,2021-02-15T19:55:41.967,0,,0.0
2020,5,2861,790,23,3843,13,12,10,-2,0,0,0,0,0,0,False,False,False,0,1,2020-10-12T16:54:58.233,0,,0.0
2020,5,2861,805,16,7681,13,16,4,5,0,0,0,0,0,0,False,False,False,0,1,2020-10-12T17:07:11.453,0,,0.0
2020,5,2861,810,16,4143,2,13,4,3,3,0,3,0,3,0,False,False,False,0,3,2020-10-13T19:27:44.047,3,,0.0
2020,5,2861,815,16,374,13,12,10,7,0,0,0,0,0,0,False,False,False,0,3,2020-10-12T17:10:24.96,0,,0.0
2020,5,2861,820,16,374,13,8,1,21,0,0,0,0,0,0,False,False,False,0,3,2021-03-05T17:57:10.817,0,,0.0
2020,5,2861,840,16,4143,2,44,3,-7,-1,6,-1,0,-1,0,True,False,False,0,3,2020-10-13T19:17:18.283,-1,,0.0
2020,5,2861,845,16,7681,2,46,3,3,20,17,8,12,8,0,False,False,False,1,1,2021-03-15T14:33:21.867,20,,12.0
2020,5,2861,850,16,4143,2,12,2,20,20,0,20,0,20,0,False,False,False,0,2,2020-10-13T19:30:58.163,20,,
2020,5,2861,855,16,6499,13,12,3,0,0,0,0,0,0,0,False,False,False,0,1,2021-03-08T19:13:27.047,0,,0.0
2020,5,2861,860,16,4143,13,12,2,30,0,0,0,0,0,0,False,False,False,0,3,2020-10-12T17:25:45,0,,0.0
2020,5,2861,865,16,6499,2,46,3,0,15,15,12,3,12,0,False,False,False,0,1,2020-10-12T17:27:15.72,15,,3.0
2020,5,2861,870,16,7176,2,4,4,11,37,26,36,1,36,0,False,False,False,0,3,2020-10-13T19:19:40.867,37,,1.0
2020,5,2861,875,16,6499,3,46,3,0,0,0,0,0,0,0,False,False,False,0,1,2020-10-12T17:30:36.417,0,,0.0
2020,5,2861,880,16,4143,13,12,3,14,0,0,0,0,0,0,False,False,False,0,3,2020-10-13T19:27:55.667,0,,
2020,5,2861,885,16,374,2,5,3,7,7,0,7,0,7,6,True,False,False,0,2,2020-10-13T19:28:07.06,7,,0.0
2020,5,2861,935,23,4949,2,46,3,1,2,1,2,0,2,0,True,False,False,0,1,2020-10-13T17:07:41,2,,0.0
2020,6,2862,15,10,4930,2,19,2,31,41,10,41,0,41,0,False,False,False,0,2,2021-02-16T23:05:59.337,41,,
2020,6,2862,25,10,7703,3,11,6,27,0,0,0,0,0,0,False,False,False,0,4,2020-10-23T18:08:38.167,0,,
2020,6,2862,30,10,7700,3,9,2,27,0,0,0,0,0,0,False,False,False,0,2,2020-10-23T18:09:01.373,0,,
2020,6,2862,70,19,1328,13,44,9,-11,0,0,0,0,0,0,False,False,False,0,1,2021-03-05T18:19:55.113,0,,
2020,6,2862,85,10,7703,13,7,2,25,0,0,0,0,0,0,False,False,False,0,2,2020-10-19T10:58:48.1,0,,
2020,6,2862,100,19,1328,2,48,10,-2,13,15,11,2,11,0,False,False,False,0,1,2020-10-19T14:56:49.867,13,,
2020,6,2862,115,19,1328,2,2,9,6,9,3,9,0,9,0,True,False,False,0,3,2020-10-19T14:56:59.47,9,,
2020,6,2862,130,19,1328,2,48,4,-5,7,12,3,4,3,0,False,False,False,1,1,2020-10-22T13:43:10.923,7,,
2020,6,2862,140,10,3848,2,12,9,5,7,2,7,0,7,0,False,False,False,0,4,2020-10-22T17:28:50.573,7,,
2020,6,2862,155,10,6282,2,12,3,2,4,2,4,0,4,0,False,False,False,0,1,2021-03-08T18:59:18.497,4,,
2020,6,2862,170,10,7703,2,13,5,3,18,15,14,4,14,0,False,False,False,0,4,2020-10-19T11:44:48.753,18,,
2020,6,2862,175,10,4930,13,8,1,40,0,0,0,0,0,0,False,False,False,0,3,2020-10-22T14:37:42.593,0,,
2020,6,2862,185,10,7703,2,35,9,14,27,13,16,11,16,0,False,False,False,0,3,2020-10-23T18:06:23.303,27,,
2020,6,2862,195,10,7703,3,36,9,8,0,0,0,0,0,0,False,False,False,0,4,2020-10-22T18:20:10.643,0,,
2020,6,2862,200,10,7700,13,35,9,8,0,0,0,0,0,0,False,False,False,0,3,2020-10-19T11:55:23.45,0,,
2020,6,2862,215,19,3233,2,4,3,9,7,-2,8,-1,8,0,False,True,False,0,2,2020-10-22T18:20:10.643,7,,
2020,6,2862,220,19,6273,2,4,9,4,12,8,5,7,5,0,False,False,False,0,4,2020-10-19T14:57:54.377,12,,
2020,6,2862,230,19,6273,2,6,9,10,10,0,10,0,10,0,False,False,False,0,4,2020-10-19T14:58:06.153,10,,
2020,6,2862,245,19,8005,2,13,9,4,16,12,16,0,16,0,True,False,False,0,3,2020-10-19T14:58:22.497,16,,
2020,6,2862,250,19,7172,2,5,3,3,14,11,4,10,4,0,False,False,False,1,1,2020-10-23T18:07:00.54,14,,
2020,6,2862,260,19,3233,2,3,3,12,12,0,12,0,12,0,True,False,False,0,2,2020-10-22T16:32:36.883,12,,
2020,6,2862,265,19,54,13,5,3,4,0,0,0,0,0,0,True,False,False,0,2,2021-03-02T19:28:25.283,0,,
2020,6,2862,290,10,4930,2,43,1,17,17,0,17,0,17,0,False,False,False,0,4,2020-10-22T16:36:07.007,17,,
2020,6,2862,295,10,7082,13,45,5,-2,0,0,0,0,0,0,False,False,False,0,3,2020-10-22T18:20:10.643,0,,
2020,6,2862,325,10,4930,3,12,5,9,0,0,0,0,0,0,False,False,False,0,3,2020-10-19T12:31:20.653,0,,
2020,6,2862,400,10,7700,2,35,10,13,16,3,16,0,16,0,False,False,False,0,3,2020-10-22T18:20:10.643,16,,
2020,6,2862,415,10,4930,2,9,2,35,35,0,35,0,35,0,False,False,False,0,2,2020-10-19T12:52:44.37,35,,
2020,6,2862,435,10,7700,2,35,8,16,16,0,16,0,16,0,False,False,False,0,2,2021-02-16T23:09:50.283,16,,
2020,6,2862,445,10,7703,13,7,5,8,0,0,0,0,0,0,True,False,False,0,2,2020-10-22T18:00:41.25,0,,
2020,6,2862,450,10,4930,13,7,5,8,0,0,0,0,0,0,False,False,False,0,3,2020-10-22T14:41:34.17,0,,
2020,6,2862,480,19,54,2,2,4,9,10,1,10,0,10,0,False,False,False,0,3,2021-02-16T23:07:13.29,10,,
2020,6,2862,490,19,54,13,5,3,4,0,0,0,0,0,0,False,False,False,0,3,2020-10-22T13:37:58.677,0,,
2020,6,2862,495,19,6273,2,6,4,11,16,5,16,0,16,0,False,True,True,0,3,2020-10-19T13:15:46.743,16,,
2020,6,2862,510,10,6285,13,26,3,2,0,0,0,0,0,0,False,False,False,0,2,2020-10-22T16:48:13.913,0,,
2020,6,2862,525,19,7173,13,6,10,14,0,0,0,0,0,0,False,False,False,0,3,2020-10-19T15:00:34.283,0,,
2020,6,2862,545,10,6285,3,19,2,34,0,0,0,0,0,0,False,False,False,0,2,2020-10-22T16:50:02.46,0,,
2020,6,2862,555,19,1328,2,48,9,-4,5,9,0,5,0,0,False,False,False,0,1,2020-10-19T15:00:50.3,5,,
2020,6,2862,575,10,7700,13,6,4,11,0,0,0,0,0,0,False,False,False,0,3,2020-10-19T13:49:37.537,0,,
2020,6,2862,585,10,4930,2,13,4,3,8,5,8,0,8,0,False,False,False,0,2,2020-10-19T13:56:03.797,8,,
2020,6,2862,605,19,3233,2,3,6,19,19,0,19,0,19,0,False,False,False,0,2,2020-10-19T15:01:05.747,19,,
2020,6,2862,660,10,4930,13,9,6,16,0,0,0,0,0,0,False,False,False,0,2,2021-01-13T21:09:11.09,0,,
2020,6,2862,670,19,54,2,50,3,-5,-2,3,-5,3,-5,0,True,False,False,1,3,2021-03-02T20:29:45.887,-2,,
2020,6,2862,690,10,4930,13,8,1,47,0,0,0,0,0,0,False,False,False,0,3,2021-03-05T18:23:39.913,0,,
2020,6,2862,695,19,54,13,5,5,14,0,0,0,0,0,0,False,False,False,0,3,2020-10-19T15:01:46.45,0,,
2020,6,2862,700,19,1328,2,48,3,-7,22,29,22,0,22,0,False,False,False,0,1,2021-02-16T23:11:13.393,22,,
2020,6,2862,705,19,3233,13,19,6,40,0,0,0,0,0,0,False,False,False,0,2,2020-10-19T15:01:56.457,0,,
2020,6,2862,710,19,1328,2,46,3,2,6,4,6,0,6,0,False,False,False,0,1,2020-10-22T17:03:39.76,6,,
2020,6,2862,730,19,1328,2,48,9,-3,-3,0,-4,1,-4,0,False,False,False,0,1,2020-10-19T15:02:18.457,-3,,
2020,6,2862,735,19,506,2,45,5,1,16,15,1,15,1,0,False,False,False,1,6,2021-02-16T23:11:46.983,16,,
2020,6,2862,740,19,54,13,6,4,6,0,0,0,0,0,0,False,False,False,0,3,2020-10-19T14:45:12.63,0,,
2020,6,2862,755,19,1328,2,44,9,-4,6,10,5,1,5,0,False,False,False,0,1,2020-10-22T17:07:49.18,6,,
2020,6,2862,765,19,7173,13,4,5,14,0,0,0,0,0,0,False,False,False,0,2,2020-10-22T18:07:19.263,0,,
2020,5,2863,10,22,7118,13,6,10,11,0,0,0,0,0,0,False,False,False,0,2,2020-10-12T15:31:34.907,0,,0.0
2020,5,2863,20,22,3170,2,42,4,5,7,2,6,1,6,0,False,False,False,0,2,2020-10-12T10:18:14.86,7,,1.0
2020,5,2863,40,1,6405,13,12,2,32,0,0,0,0,0,0,False,False,False,0,2,2020-10-12T10:24:27.123,0,,0.0
2020,5,2863,50,22,7118,2,5,3,4,4,0,4,0,4,0,False,False,False,0,2,2020-10-15T15:35:30.223,4,,0.0
2020,5,2863,55,22,1361,2,13,10,3,4,1,4,0,4,0,False,False,False,0,2,2020-10-15T13:54:08.1,4,,0.0
2020,5,2863,60,22,7118,3,26,10,1,0,0,0,0,0,0,False,False,False,0,3,2021-02-15T20:21:45.243,0,,0.0
2020,5,2863,70,1,5032,2,46,3,1,6,5,6,0,6,0,False,False,False,0,4,2020-10-12T10:32:50.243,6,,0.0
2020,5,2863,75,1,6405,2,39,9,5,8,3,8,0,8,0,True,False,False,0,2,2020-10-12T10:35:25.013,8,,0.0
2020,5,2863,90,1,6405,2,4,5,12,21,9,17,4,17,0,False,False,False,0,2,2020-10-12T10:41:02.82,21,,4.0
2020,5,2863,100,1,7315,2,45,5,-5,6,11,6,0,6,0,True,False,False,0,3,2020-10-12T10:45:04.207,6,,0.0
2020,5,2863,140,22,3170,13,2,9,7,0,0,0,0,0,0,False,False,False,0,3,2020-10-12T10:54:42.123,0,,0.0
2020,5,2863,150,1,525,2,4,10,5,12,7,9,3,9,0,False,False,False,0,3,2020-10-12T10:57:03.463,12,,3.0
2020,5,2863,160,1,245,2,3,3,12,15,3,15,0,15,0,False,False,False,0,2,2020-10-12T11:03:25.13,15,,0.0
2020,5,2863,165,1,6406,13,48,9,-2,0,0,0,0,0,0,False,False,False,0,1,2020-10-12T11:05:43.937,0,,0.0
2020,5,2863,175,1,6406,2,4,10,1,6,5,6,0,6,0,False,False,False,0,1,2020-10-12T11:09:54.087,6,,0.0
2020,5,2863,190,22,3170,2,2,4,7,12,5,9,3,9,0,False,False,False,0,3,2020-10-12T11:14:21.047,12,,3.0
2020,5,2863,230,22,1113,13,4,4,1,0,0,0,0,0,0,False,False,False,0,1,2020-10-12T15:32:25.35,0,,
2020,5,2863,240,22,34,2,12,5,2,7,5,7,0,7,0,False,False,False,0,1,2021-03-08T19:17:48.453,7,,0.0
2020,5,2863,260,22,7121,2,4,10,5,5,0,5,0,5,0,False,False,False,0,2,2020-10-12T11:31:42.45,5,,0.0
2020,5,2863,275,1,6405,2,2,10,12,15,3,14,1,14,0,False,False,False,0,2,2020-10-12T11:35:22.75,15,,1.0
2020,5,2863,285,1,525,13,4,10,13,0,0,0,0,0,0,False,False,False,0,3,2020-10-12T14:50:01.283,0,,0.0
2020,5,2863,290,1,6405,13,4,5,-1,0,0,0,0,0,0,False,False,False,0,2,2020-10-12T11:40:34.797,0,,0.0
2020,5,2863,305,22,7118,13,2,10,3,0,0,0,0,0,0,False,False,False,0,2,2020-10-12T12:01:08.523,0,,0.0
2020,5,2863,310,22,7118,13,9,5,8,0,0,0,0,0,0,False,False,False,0,3,2020-10-12T12:02:40.18,0,,0.0
2020,5,2863,335,1,525,2,13,4,2,9,7,5,4,5,0,False,False,False,0,3,2020-10-12T12:07:17.957,9,,4.0
2020,5,2863,340,1,7315,3,19,10,12,0,0,0,0,0,0,False,False,False,0,2,2020-10-12T12:08:44.943,0,,0.0
2020,5,2863,350,1,525,13,35,8,15,0,0,0,0,0,0,False,False,False,0,3,2020-10-15T13:54:08.1,0,,0.0
2020,5,2863,355,1,7315,2,12,8,24,24,0,24,0,24,0,False,False,False,0,3,2020-10-12T12:14:31.34,24,,0.0
2020,5,2863,360,1,6405,2,29,2,24,24,0,24,0,24,0,True,False,False,0,3,2020-10-12T12:16:22.42,24,,0.0
2020,5,2863,370,1,5152,13,12,4,7,0,0,0,0,0,0,False,False,False,0,3,2021-03-08T19:18:38.19,0,,
2020,5,2863,400,22,3170,2,39,4,4,4,0,4,0,4,0,False,False,False,0,3,2020-10-12T12:26:34.74,4,,0.0
2020,5,2863,410,22,6262,2,42,10,4,15,11,15,0,15,0,False,False,False,0,4,2020-10-12T12:28:07.663,15,,0.0
2020,5,2863,420,22,6262,2,4,4,8,9,1,8,1,8,0,False,False,False,0,4,2020-10-12T12:32:21.107,9,,1.0
2020,5,2863,435,22,7118,2,52,4,3,11,8,11,0,11,0,False,False,False,0,2,2020-10-15T13:54:08.1,11,,0.0
2020,5,2863,450,1,6406,2,31,10,1,7,6,5,2,5,0,False,False,False,0,1,2020-10-12T12:38:38.507,7,,2.0
2020,5,2863,455,1,6406,2,5,9,4,5,1,5,0,5,0,False,False,False,0,1,2020-10-12T12:39:50.31,5,,0.0
2020,5,2863,465,1,6406,2,17,9,14,30,16,27,3,27,0,False,False,False,0,3,2021-02-15T20:24:31.543,30,,3.0
2020,5,2863,475,1,245,2,5,3,10,10,0,10,0,10,0,False,False,False,0,2,2020-10-12T12:44:12.383,10,,0.0
2020,5,2863,510,1,245,2,2,9,10,11,1,10,1,10,0,False,False,False,0,2,2021-02-15T20:29:45.663,11,,1.0
2020,5,2863,525,1,525,2,6,10,4,7,3,6,1,6,0,False,False,False,1,3,2020-10-12T14:51:32.737,7,,1.0
2020,5,2863,540,22,1361,2,5,3,5,6,1,6,0,6,0,True,False,False,0,3,2020-10-12T14:51:43.077,6,,0.0
2020,5,2863,565,1,245,2,49,3,-2,13,15,13,0,13,0,False,False,False,0,2,2020-10-15T14:54:32.517,13,,0.0
2020,5,2863,570,1,6410,2,6,9,6,6,0,6,0,6,0,False,False,False,0,2,2020-10-12T13:10:11.013,6,,0.0
2020,5,2863,575,1,245,13,2,9,6,0,0,0,0,0,0,False,False,False,0,2,2020-10-12T13:11:45.527,0,,0.0
2020,5,2863,585,22,3170,13,35,9,11,0,0,0,0,0,0,False,False,False,0,3,2021-02-15T20:22:04.113,0,,0.0
2020,5,2863,590,22,3170,2,43,2,32,52,20,52,0,52,0,False,False,False,0,3,2020-10-12T13:15:24.78,52,,0.0
2020,5,2863,595,22,6262,3,35,10,8,0,0,0,0,0,0,False,False,False,0,4,2020-10-15T14:42:28.273,0,,0.0
2020,5,2863,610,22,3170,2,6,10,6,11,5,7,4,7,6,True,False,False,1,3,2020-10-12T13:22:21.333,11,,4.0
2020,5,2863,625,1,4307,2,4,4,4,2,-2,2,0,2,0,False,False,False,0,1,2020-10-12T14:51:58.213,2,,0.0
2020,5,2863,630,1,525,2,5,3,4,7,3,4,3,4,0,False,False,False,0,3,2020-10-12T13:26:30.927,7,,3.0
2020,5,2863,640,1,5032,2,32,5,6,31,25,31,0,31,0,False,False,False,1,4,2021-02-15T20:26:02.423,31,,0.0
2020,5,2863,650,1,6406,2,5,5,4,8,4,7,1,7,0,False,False,False,0,1,2020-10-15T15:38:38.707,8,,1.0
2020,5,2863,685,22,7118,13,11,6,33,0,0,0,0,0,0,True,False,False,0,3,2020-10-15T15:39:02.553,0,,0.0
2020,5,2863,690,22,1113,3,6,9,6,0,0,0,0,0,0,False,False,False,0,2,2021-02-25T15:27:17.1,0,,
2020,5,2863,710,22,3170,2,54,3,-4,12,16,12,0,12,0,True,False,False,0,3,2020-10-15T14:43:55.77,12,,0.0
2020,5,2863,760,1,245,13,12,2,24,0,0,0,0,0,0,False,False,False,0,2,2021-03-08T19:19:19.077,0,,
2020,5,2863,765,1,245,2,29,6,42,45,3,44,1,44,0,False,False,False,0,2,2020-10-12T23:00:37.21,45,,1.0
2020,5,2863,775,1,525,13,5,5,3,0,0,0,0,0,0,False,False,False,0,3,2020-10-13T22:08:55.047,0,,0.0
2020,5,2863,780,1,6405,2,2,10,7,10,3,8,2,8,0,False,False,False,0,2,2020-10-12T14:10:04.583,10,,2.0
2020,5,2863,785,1,6406,13,12,5,0,0,0,0,0,0,0,False,False,False,0,1,2020-10-12T14:11:36.72,0,,
2020,5,2863,790,1,245,2,19,6,33,37,4,33,4,33,6,False,False,False,0,2,2020-10-12T15:14:25.683,37,,4.0
2020,5,2863,810,22,3170,2,5,3,4,14,10,6,8,6,0,False,False,False,1,3,2020-10-15T14:59:12.373,14,,8.0
2020,5,2863,815,22,3170,2,39,4,3,4,1,3,1,3,0,False,False,False,0,3,2020-10-12T14:18:10.92,4,,1.0
2020,5,2863,820,22,7118,2,2,10,8,8,0,8,0,8,0,False,False,False,0,2,2020-10-12T14:19:29.723,8,,0.0
2020,5,2863,835,22,7118,13,21,2,33,0,0,0,0,0,0,False,False,False,0,2,2020-10-12T14:32:54.53,0,,0.0
2020,5,2863,840,22,7118,13,50,3,1,0,0,0,0,0,0,False,False,False,0,2,2021-02-15T20:23:39.143,0,,0.0
2020,5,2863,845,22,1361,2,26,9,5,10,5,9,1,9,0,False,False,False,0,3,2020-10-12T14:52:34.317,10,,1.0
2020,5,2863,850,22,6270,3,12,2,27,0,0,0,0,0,0,False,False,False,0,3,2020-10-12T15:34:07.647,0,,0.0
2020,5,2863,855,22,7118,3,9,6,27,0,0,0,0,0,0,False,False,False,0,2,2021-02-15T20:25:13.003,0,,0.0
2020,5,2863,865,22,6270,13,12,6,30,0,0,0,0,0,0,False,False,False,0,3,2021-02-15T20:22:24.373,0,,0.0
2020,5,2863,885,1,7316,2,30,10,-1,5,6,0,5,0,0,True,False,False,0,3,2020-10-12T14:42:07.843,5,,5.0
2020,5,2864,30,25,6259,2,49,3,-2,2,4,1,1,1,0,False,False,False,0,2,2020-10-12T10:28:27.447,2,,1.0
2020,5,2864,40,25,609,2,2,4,2,4,2,3,1,3,0,False,False,False,0,3,2020-10-12T10:36:32.153,4,,1.0
2020,5,2864,60,25,7060,2,52,9,-1,-2,-1,-2,0,-2,0,False,False,False,2,2,2020-10-15T17:05:45.253,-2,,0.0
2020,5,2864,70,24,4382,2,2,4,5,5,0,5,0,5,0,False,False,False,0,3,2020-10-12T10:48:09.15,5,,0.0
2020,5,2864,75,24,7799,13,19,2,41,0,0,0,0,0,0,False,False,False,0,2,2020-10-12T10:51:19.763,0,,0.0
2020,5,2864,80,24,894,13,5,3,10,0,0,0,0,0,0,False,False,False,0,3,2020-10-15T19:21:15.3,0,,0.0
2020,5,2864,95,25,6486,2,13,9,1,5,4,4,1,4,0,False,False,False,0,3,2020-10-12T11:04:22.15,5,,1.0
2020,5,2864,100,25,7666,2,2,4,4,7,3,4,3,4,0,False,False,False,0,3,2020-10-12T11:08:03.717,7,,3.0
2020,5,2864,115,25,6486,2,13,4,1,12,11,6,6,6,0,False,False,False,0,2,2020-10-12T11:21:40.487,12,,6.0
2020,5,2864,120,25,6259,2,34,4,-4,8,12,8,0,8,0,True,False,False,0,3,2020-10-12T11:24:54.803,8,,0.0
2020,5,2864,125,25,6486,13,2,3,1,0,0,0,0,0,0,False,False,False,0,2,2020-10-15T17:28:20.73,0,,0.0
2020,5,2864,135,25,4583,13,12,2,15,0,0,0,0,0,0,False,False,False,0,2,2020-10-15T18:59:21.983,0,,
2020,5,2864,140,25,181,2,12,5,-3,4,7,2,2,2,0,False,False,False,0,4,2021-03-08T19:21:30.64,4,,2.0
2020,5,2864,145,25,6486,13,9,2,28,0,0,0,0,0,0,False,False,False,0,2,2020-10-12T18:31:34.167,0,,
2020,5,2864,150,25,4583,13,35,3,7,0,0,0,0,0,0,False,False,False,0,3,2021-02-25T15:28:55.857,0,,0.0
2020,5,2864,185,24,7799,13,8,8,49,0,0,0,0,0,0,False,False,False,0,2,2020-10-15T18:58:53.407,0,,0.0
2020,5,2864,215,25,4583,2,50,9,-2,-1,1,-1,0,-1,0,False,False,False,0,3,2021-01-29T15:40:23.267,-1,,0.0
2020,5,2864,220,25,7666,2,3,5,12,15,3,15,0,15,0,False,False,False,0,2,2020-10-12T12:30:48.363,15,,0.0
2020,5,2864,240,25,7666,2,2,9,11,32,21,14,18,14,6,False,False,False,1,2,2020-10-12T12:45:36.33,32,,18.0
2020,5,2864,260,24,6808,2,4,3,6,13,7,11,2,11,0,False,False,False,0,2,2020-10-12T12:56:31.493,13,,2.0
2020,5,2864,265,24,6808,13,4,5,8,0,0,0,0,0,0,False,False,False,0,2,2020-10-12T12:56:20.277,0,,0.0
2020,5,2864,270,24,6808,2,5,5,6,7,1,6,1,6,0,False,False,False,0,3,2020-10-12T13:00:35.17,7,,1.0
2020,5,2864,275,24,6808,2,12,9,9,9,0,9,0,9,0,False,False,False,0,3,2020-10-12T13:08:19,9,,0.0
2020,5,2864,280,24,6808,2,2,10,9,18,9,10,8,10,0,True,False,False,1,4,2020-10-15T17:07:50.503,18,,8.0
2020,5,2864,295,24,894,2,13,4,5,6,1,5,1,5,0,False,False,False,0,3,2020-10-15T19:00:20.11,6,,1.0
2020,5,2864,320,25,6259,13,19,2,37,0,0,0,0,0,0,False,False,False,0,2,2020-10-12T18:20:18.47,0,,
2020,5,2864,330,25,4587,2,48,4,-2,11,13,10,1,10,0,False,False,False,0,1,2020-10-12T13:38:03.983,11,,1.0
2020,5,2864,335,25,609,2,38,4,3,3,0,3,0,3,0,False,False,False,0,4,2020-10-12T13:40:32.23,3,,0.0
2020,5,2864,340,25,609,2,12,6,17,17,0,17,0,17,0,False,False,False,0,4,2021-03-08T19:22:03.663,17,,0.0
2020,5,2864,345,25,7666,13,8,8,29,0,0,0,0,0,0,False,False,False,0,2,2020-10-12T13:47:45.247,0,,0.0
2020,5,2864,355,25,4583,2,29,3,10,12,2,10,2,10,0,False,False,False,0,3,2020-10-12T18:27:26.65,12,,
2020,5,2864,365,25,4587,2,12,3,1,6,5,3,3,3,0,False,False,False,0,1,2021-03-08T19:22:29.277,6,,3.0
2020,5,2864,400,24,6808,2,5,2,20,20,0,20,0,20,0,False,False,False,0,2,2020-10-15T17:08:21.623,20,,0.0
2020,5,2864,405,24,7799,2,4,3,7,9,2,9,0,9,0,False,False,False,0,2,2020-10-12T14:07:19.107,9,,0.0
2020,5,2864,415,24,894,13,5,5,13,0,0,0,0,0,0,False,False,False,0,3,2020-10-12T14:09:50.777,0,,0.0
2020,5,2864,430,24,6937,3,5,3,5,0,0,0,0,0,0,False,False,False,0,1,2020-10-13T19:19:32.483,0,,0.0
2020,5,2864,435,24,7799,13,8,7,49,0,0,0,0,0,0,False,False,False,0,2,2020-10-15T19:28:37.153,0,,0.0
2020,5,2864,440,24,7003,2,7,2,37,37,0,37,0,37,0,False,False,False,0,2,2020-10-15T18:26:18.59,37,,0.0
2020,5,2864,455,25,7666,2,5,3,5,5,0,5,0,5,0,False,False,False,0,2,2020-10-12T18:33:29.747,5,,0.0
2020,5,2864,460,25,7666,13,9,6,17,0,0,0,0,0,0,False,False,False,0,2,2021-02-25T15:31:33.367,0,,0.0
2020,5,2864,465,25,609,2,32,3,0,7,7,0,7,0,0,False,False,False,0,4,2020-10-12T14:33:59.647,7,,7.0
2020,5,2864,475,25,7666,13,39,4,4,0,0,0,0,0,0,False,False,False,0,3,2020-10-12T14:41:59.7,0,,0.0
2020,5,2864,480,25,7666,2,51,3,-2,5,7,5,0,5,6,False,False,False,0,2,2020-10-12T14:44:37.133,5,,0.0
2020,5,2864,495,24,6808,13,4,10,10,0,0,0,0,0,0,False,False,False,0,2,2020-10-12T14:52:02.293,0,,0.0
2020,5,2864,500,24,894,13,4,9,11,0,0,0,0,0,0,False,False,False,0,4,2021-03-05T17:59:14.76,0,,0.0
2020,5,2864,505,25,4583,2,13,10,2,4,2,3,1,3,0,False,False,False,0,3,2020-10-12T14:57:31.853,4,,1.0
2020,5,2864,520,25,6486,13,7,3,12,0,0,0,0,0,0,False,False,False,0,3,2020-10-12T18:32:06.973,0,,
2020,5,2864,555,24,6808,2,17,1,27,31,4,27,4,27,0,False,False,False,0,3,2020-10-12T15:18:35.66,31,,4.0
2020,5,2864,565,24,7800,13,7,2,32,0,0,0,0,0,0,False,False,False,0,2,2020-10-15T18:38:23.893,0,,
2020,5,2864,570,24,6937,2,16,10,4,11,7,4,7,4,0,False,False,False,1,1,2020-10-12T15:26:44.193,11,,7.0
2020,5,2864,580,24,4382,2,5,3,8,8,0,8,0,8,6,False,False,False,0,3,2020-10-15T19:14:24.92,8,,0.0
2020,5,2864,610,25,6486,2,49,10,0,8,8,6,2,6,0,False,False,False,0,2,2020-10-15T17:19:24.153,8,,2.0
2020,5,2864,620,25,7666,13,9,2,33,0,0,0,0,0,0,False,False,False,0,3,2020-10-15T19:31:26.423,0,,0.0
2020,5,2864,630,25,4583,2,52,10,1,11,10,8,3,8,0,False,False,False,0,2,2021-02-16T21:56:38.683,11,,3.0
2020,5,2864,640,24,4382,2,5,9,3,2,-1,2,0,2,0,False,False,False,0,3,2020-10-15T17:28:32.893,2,,0.0
2020,5,2864,645,24,894,13,53,9,-5,0,0,0,0,0,0,True,False,False,0,4,2020-10-13T19:20:22.213,0,,0.0
2020,5,2864,650,24,6808,2,5,6,18,18,0,18,0,18,0,False,False,False,0,3,2020-10-15T18:29:16.36,18,,0.0
2020,5,2864,655,24,6808,2,4,9,12,19,7,17,2,17,0,False,False,False,0,3,2020-10-18T02:33:59.097,19,,2.0
2020,5,2864,665,24,565,2,17,9,13,18,5,16,2,16,0,False,False,False,0,4,2021-02-15T20:41:26.077,18,,2.0
2020,5,2864,675,24,6808,2,5,5,13,13,0,13,0,13,0,False,False,False,0,3,2020-10-12T16:25:40.417,13,,0.0
2020,5,2864,685,24,4382,2,6,4,10,11,1,10,1,10,0,False,False,False,0,3,2020-10-12T16:28:52.063,11,,1.0
2020,5,2864,695,24,6808,2,4,4,4,4,0,4,0,4,6,False,False,False,0,3,2020-10-12T16:37:57.253,4,,0.0
2020,5,2864,715,25,4583,2,5,3,10,14,4,14,0,14,0,False,False,False,0,2,2020-10-12T16:42:58.777,14,,0.0
2020,5,2864,725,25,4587,2,48,9,-4,2,6,0,2,0,0,False,False,False,0,1,2020-10-12T16:47:32,2,,2.0
2020,5,2864,735,25,7666,2,2,10,9,11,2,9,2,9,0,False,False,False,0,2,2020-10-12T18:31:15.39,11,,2.0
2020,5,2864,750,25,7666,2,29,2,15,42,27,15,27,15,6,False,False,False,0,2,2021-02-15T20:45:38.413,42,,
2020,5,2864,760,25,609,2,4,4,11,12,1,11,1,11,0,False,True,True,0,4,2020-10-12T17:19:33.8,12,,1.0
2020,5,2864,765,24,4382,13,2,9,5,0,0,0,0,0,0,False,False,False,0,3,2020-10-12T17:18:41.617,0,,0.0
2020,5,2864,770,24,7799,2,4,5,6,9,3,6,3,6,0,False,False,False,0,2,2020-10-12T17:23:10.927,9,,3.0
2020,5,2864,785,24,6937,2,50,3,-4,8,12,5,3,5,0,True,False,False,0,2,2020-10-18T02:34:30.383,8,,3.0
2020,5,2864,790,24,6808,13,2,10,4,0,0,0,0,0,0,False,False,False,0,2,2020-10-12T17:33:22.003,0,,0.0
2020,5,2864,805,25,6259,2,2,10,2,2,0,2,0,2,0,False,False,False,0,2,2020-10-12T17:46:23.853,2,,0.0
2020,5,2864,815,25,7666,13,2,10,11,0,0,0,0,0,0,False,False,False,0,2,2020-10-12T17:52:17.31,0,,0.0
2020,5,2864,820,25,7666,2,17,1,27,35,8,35,0,35,6,False,False,False,0,3,2020-10-12T17:54:41.14,35,,0.0
2020,5,2864,845,24,6937,13,16,10,5,0,0,0,0,0,0,False,False,False,0,1,2021-03-15T14:40:22.683,0,,0.0
2020,5,2864,850,24,894,13,31,9,4,0,0,0,0,0,0,False,False,False,0,3,2020-10-15T17:36:32.56,0,,0.0
2020,5,2864,855,24,7799,13,12,1,60,0,0,0,0,0,0,False,False,False,0,2,2021-03-05T17:59:59.79,0,,0.0
2020,5,2865,20,4,1028,3,6,7,19,0,0,0,0,0,0,False,False,False,0,2,2021-03-05T18:02:51.207,0,,0.0
2020,5,2865,30,31,6793,2,21,6,16,16,0,16,0,16,6,False,False,False,0,2,2020-10-14T10:05:34.153,16,,0.0
2020,5,2865,45,4,7646,13,8,7,34,0,0,0,0,0,0,False,False,False,0,3,2020-10-14T10:08:00.72,0,,0.0
2020,5,2865,50,4,2853,2,4,9,9,9,0,9,0,9,0,False,False,False,0,2,2020-10-14T10:10:01.083,9,,0.0
2020,5,2865,60,4,2853,2,4,8,17,19,2,19,0,19,0,False,False,False,0,3,2020-10-14T10:14:11.85,19,,0.0
2020,5,2865,70,4,6953,13,31,10,3,0,0,0,0,0,0,False,False,False,0,3,2021-03-09T15:52:27.447,0,,0.0
2020,5,2865,75,4,7646,2,12,2,15,15,0,15,0,15,0,False,False,False,0,2,2021-03-08T19:27:20.163,15,,0.0
2020,5,2865,85,4,2853,3,35,10,10,0,0,0,0,0,0,False,False,False,0,3,2021-03-09T15:53:06.363,0,,0.0
2020,5,2865,105,4,2497,13,12,2,23,0,0,0,0,0,0,False,False,False,0,1,2021-02-25T15:36:38.483,0,,0.0
2020,5,2865,110,4,7646,2,8,1,23,23,0,23,0,23,6,False,False,False,0,3,2020-10-16T15:12:48.433,23,,
2020,5,2865,115,4,1028,2,12,6,16,16,0,16,0,16,0,False,False,False,0,2,2021-03-08T19:27:50.61,16,,0.0
2020,5,2865,120,4,7646,2,35,10,9,9,0,9,0,9,0,False,False,False,0,3,2020-10-14T10:36:57.837,9,,0.0
2020,5,2865,125,4,5119,2,34,4,-3,3,6,3,0,3,6,True,False,False,0,3,2021-03-04T14:26:39.69,3,,0.0
2020,5,2865,140,31,6793,2,13,9,5,11,6,10,1,10,0,False,False,False,0,3,2020-10-16T14:31:34.29,11,,1.0
2020,5,2865,155,31,5096,13,13,3,5,0,0,0,0,0,0,False,False,False,0,3,2021-03-09T15:55:00.88,0,,0.0
2020,5,2865,180,4,2853,13,6,9,6,0,0,0,0,0,0,False,False,False,0,2,2021-03-09T15:55:38.797,0,,0.0
2020,5,2865,190,31,3504,13,48,9,-5,0,0,0,0,0,0,False,False,False,0,1,2021-03-09T15:59:36.99,0,,0.0
2020,5,2865,200,31,5096,2,51,3,-1,13,14,8,5,8,0,False,False,False,0,4,2020-10-16T14:58:58.92,13,,
2020,5,2865,205,31,4037,2,2,4,9,20,11,20,0,20,0,False,False,False,0,3,2021-03-09T16:02:19.5,20,,0.0
2020,5,2865,220,31,6793,2,35,5,8,16,8,13,3,13,0,True,False,False,0,4,2021-03-09T16:03:00.013,16,,3.0
2020,5,2865,245,4,6953,2,32,5,1,15,14,5,10,5,0,False,False,False,0,1,2020-10-16T14:31:57.747,15,,10.0
2020,5,2865,250,4,6953,3,6,9,7,0,0,0,0,0,0,False,False,False,0,1,2021-03-09T16:05:00.55,0,,0.0
2020,5,2865,255,4,2853,2,5,5,14,14,0,14,0,14,0,False,False,False,0,3,2021-03-09T16:05:37.46,14,,0.0
2020,5,2865,265,4,7646,2,5,3,4,12,8,10,2,10,0,False,False,False,0,3,2020-10-15T16:38:29.43,12,,2.0
2020,5,2865,270,4,2853,2,12,5,12,12,0,12,0,12,0,False,False,False,0,3,2021-02-15T21:08:25.267,12,,0.0
2020,5,2865,285,4,2853,3,46,3,0,0,0,0,0,0,0,True,False,False,0,3,2020-10-14T12:25:11.387,0,,0.0
2020,5,2865,300,31,5096,2,2,9,14,14,0,14,0,14,0,False,False,False,0,3,2021-03-09T16:07:28.393,14,,0.0
2020,5,2865,315,31,7913,2,5,3,2,7,5,7,0,7,0,False,False,False,0,3,2021-03-09T16:08:17.753,7,,0.0
2020,5,2865,320,31,5096,2,30,10,-5,6,11,4,2,4,0,False,False,False,0,4,2020-10-14T12:32:43.007,6,,2.0
2020,5,2865,335,31,6793,13,4,10,13,0,0,0,0,0,0,False,False,False,0,2,2021-03-09T16:08:53.21,0,,0.0
2020,5,2865,345,31,6793,13,29,2,17,0,0,0,0,0,0,False,False,False,0,3,2021-03-09T16:13:12.527,0,,0.0
2020,5,2865,365,4,2853,13,4,5,11,0,0,0,0,0,0,False,False,False,0,2,2020-10-16T15:29:32.353,0,,0.0
2020,5,2865,370,4,2853,13,4,5,14,0,0,0,0,0,0,False,False,False,0,2,2021-03-09T16:16:47.653,0,,0.0
2020,5,2865,410,31,5096,2,4,10,5,9,4,9,0,9,0,False,False,False,0,3,2021-03-09T16:17:45.953,9,,0.0
2020,5,2865,415,31,6793,2,2,9,12,12,0,12,0,12,0,False,False,False,0,2,2021-03-09T16:19:07.897,12,,0.0
2020,5,2865,420,31,4037,2,5,3,6,6,0,6,0,6,0,False,False,False,0,3,2021-03-09T16:20:45.733,6,,0.0
2020,5,2865,425,31,6724,13,7,2,26,0,0,0,0,0,0,False,False,False,0,3,2020-10-14T13:11:25.803,0,,0.0
2020,5,2865,435,31,6793,13,4,3,7,0,0,0,0,0,0,False,False,False,0,2,2021-03-09T16:21:44.927,0,,
2020,5,2865,440,31,6724,2,4,10,3,3,0,3,0,3,0,False,False,False,0,3,2021-03-09T16:22:15.95,3,,0.0
2020,5,2865,450,31,4545,2,32,5,0,3,3,3,0,3,0,False,False,False,0,3,2020-10-16T15:30:00.53,3,,0.0
2020,5,2865,460,31,6724,2,4,4,12,12,0,12,0,12,0,False,False,False,0,3,2021-03-09T16:22:47.523,12,,0.0
2020,5,2865,500,31,6793,2,6,10,8,15,7,13,2,13,0,False,False,False,0,2,2021-03-09T16:27:10.603,15,,2.0
2020,5,2865,510,31,6793,2,2,9,5,6,1,6,0,6,0,False,False,False,0,2,2021-03-09T16:27:52.507,6,,0.0
2020,5,2865,525,31,6793,2,4,5,6,6,0,6,0,6,0,False,False,False,0,2,2020-10-16T15:38:02,6,,0.0
2020,5,2865,535,31,3504,2,44,3,2,6,4,6,0,6,0,False,False,False,0,1,2020-10-14T14:25:33.427,6,,0.0
2020,5,2865,540,31,6724,13,5,10,7,0,0,0,0,0,0,True,False,False,0,3,2021-03-09T16:34:47.183,0,,0.0
2020,5,2865,550,4,594,2,4,9,4,8,4,8,0,8,0,False,False,False,1,3,2020-10-14T14:30:59.783,8,,0.0
2020,5,2865,555,4,2853,13,5,5,4,0,0,0,0,0,0,False,False,False,0,3,2020-10-14T14:32:56.56,0,,0.0
2020,5,2865,560,4,594,2,4,5,4,5,1,5,0,5,0,False,False,False,0,3,2021-03-09T16:35:26.45,5,,0.0
2020,5,2865,565,4,2853,2,51,9,-2,9,11,7,2,7,0,False,False,False,0,3,2021-03-09T16:36:14.45,9,,2.0
2020,5,2865,570,4,7646,13,2,9,10,0,0,0,0,0,0,False,False,False,0,2,2021-03-09T16:37:18.713,0,,0.0
2020,5,2865,580,4,594,2,6,4,6,6,0,6,0,6,0,False,False,False,0,3,2021-03-09T17:03:12.787,6,,0.0
2020,5,2865,590,4,594,2,2,9,6,10,4,8,2,8,0,False,False,False,0,3,2021-03-09T17:03:46.333,10,,2.0
2020,5,2865,595,4,2853,2,4,9,7,7,0,7,0,7,0,False,False,False,0,3,2021-03-09T17:04:18.93,7,,0.0
2020,5,2865,600,4,5119,2,51,3,-7,-7,0,-5,-2,-5,0,True,False,False,1,3,2020-10-16T14:33:00.017,-7,,-2.0
2020,5,2865,605,4,2853,2,4,5,14,14,0,14,0,14,0,False,False,False,0,2,2021-03-09T17:04:58.31,14,,0.0
2020,5,2865,610,4,2853,2,5,5,4,6,2,6,0,6,0,False,False,False,0,3,2021-03-09T17:05:37.713,6,,0.0
2020,5,2865,615,4,7646,13,19,3,13,0,0,0,0,0,0,False,False,False,0,2,2021-03-05T18:03:22.047,0,,0.0
2020,5,2865,620,31,6724,2,26,5,4,4,0,4,0,4,0,True,False,False,0,3,2021-03-09T17:06:45.787,4,,0.0
2020,5,2865,630,31,4037,13,7,3,8,0,0,0,0,0,0,False,False,False,0,3,2021-02-25T15:40:19.037,0,,
2020,5,2865,635,31,5096,2,2,9,2,4,2,2,2,2,6,False,False,False,0,2,2021-03-09T17:07:46.283,4,,2.0
2020,5,2865,660,4,7646,2,6,4,10,11,1,10,1,10,0,False,False,False,1,2,2021-03-09T17:08:46.973,11,,1.0
2020,5,2865,685,4,594,2,4,9,5,10,5,4,6,4,0,False,False,False,1,3,2021-03-09T17:09:14.707,10,,6.0
2020,5,2865,690,4,2853,2,39,9,4,6,2,6,0,6,0,False,False,False,0,3,2021-03-09T17:09:41.13,6,,0.0
2020,5,2865,700,4,7646,13,6,8,17,0,0,0,0,0,0,False,False,False,0,2,2021-03-09T17:10:22.56,0,,0.0
2020,5,2865,710,4,6983,2,46,3,2,8,6,7,1,7,0,False,False,False,0,1,2020-10-14T17:04:35.56,8,,1.0
2020,5,2865,715,4,594,2,12,4,8,14,6,14,0,14,0,False,False,False,0,3,2020-10-14T17:07:15.48,14,,0.0
2020,5,2865,725,4,2853,2,4,5,10,10,0,10,0,10,0,False,False,False,0,3,2020-10-14T17:08:46.633,10,,0.0
2020,5,2865,735,4,2251,2,12,7,22,22,0,22,0,22,6,False,False,False,0,2,2020-10-15T16:36:48.007,22,,0.0
2020,5,2865,750,31,5096,3,53,9,-5,0,0,0,0,0,0,False,False,False,0,4,2020-10-14T17:13:11.93,0,,0.0
2020,5,2865,760,31,4834,2,12,5,9,12,3,12,0,12,0,True,False,False,0,2,2020-10-16T15:06:58.317,12,,0.0
2020,5,2865,865,31,5096,2,13,5,7,7,0,7,0,7,6,False,False,False,0,4,2020-10-16T14:04:37.17,7,,0.0
2020,5,2865,880,4,2251,13,48,10,-2,0,0,0,0,0,0,False,False,False,0,1,2021-03-09T17:11:37.53,0,,0.0
2020,5,2865,890,4,5119,2,4,4,6,9,3,9,0,9,0,False,False,False,0,3,2021-03-09T17:12:10.537,9,,0.0
2020,5,2865,900,4,2251,3,5,5,3,0,0,0,0,0,0,False,False,False,0,1,2021-03-09T17:12:42.273,0,,0.0
2020,5,2865,905,4,5119,2,39,4,2,2,0,2,0,2,0,False,False,False,0,3,2021-03-09T17:13:10.97,2,,0.0
2020,5,2865,910,4,7646,2,2,4,10,11,1,11,0,11,0,False,False,False,0,3,2021-03-09T17:13:44.287,11,,0.0
2020,5,2866,10,32,7807,2,48,4,-1,3,4,-1,4,-1,0,False,False,False,1,1,2021-03-02T20:04:03.86,3,,4.0
2020,5,2866,20,32,7128,13,4,9,10,0,0,0,0,0,0,False,False,False,0,3,2020-10-12T10:08:34.417,0,,0.0
2020,5,2866,35,29,4866,2,26,10,1,1,0,1,0,1,0,False,False,False,0,3,2020-10-15T17:27:18.143,1,,0.0
2020,5,2866,40,29,4850,2,6,9,5,17,12,6,11,6,0,False,False,False,2,2,2020-10-13T22:09:26.383,17,,11.0
2020,5,2866,45,29,4875,2,4,7,16,17,1,17,0,17,0,False,False,False,0,3,2020-10-12T10:21:50.717,17,,0.0
2020,5,2866,50,29,3356,2,48,9,-6,-6,0,-6,0,-6,0,False,False,False,0,1,2020-10-12T10:24:06.47,-6,,0.0
2020,5,2866,55,29,3398,2,4,9,5,9,4,7,2,7,0,True,False,False,0,3,2020-10-12T10:26:35.623,9,,2.0
2020,5,2866,60,29,4850,2,50,10,-2,23,25,20,3,20,0,False,False,False,0,2,2021-03-04T15:41:03.177,23,,3.0
2020,5,2866,65,29,7378,2,48,9,-4,7,11,6,1,6,0,False,False,False,0,1,2021-02-15T21:13:45.477,7,,1.0
2020,5,2866,95,32,7807,2,45,5,-4,3,7,0,3,0,0,False,False,False,1,1,2020-10-15T17:37:18.653,3,,3.0
2020,5,2866,100,32,7128,2,26,5,5,12,7,12,0,12,0,False,False,False,0,3,2020-10-12T10:43:05.443,12,,0.0
2020,5,2866,110,32,7808,13,3,2,17,0,0,0,0,0,0,False,False,False,0,2,2021-02-15T21:15:05.397,0,,
2020,5,2866,120,32,3885,2,46,3,1,8,7,3,5,3,0,False,False,False,0,1,2020-10-12T10:55:13.06,8,,5.0
2020,5,2866,130,32,7807,2,48,10,-6,18,24,6,12,6,0,False,False,False,1,1,2020-10-15T17:38:20.583,18,,12.0
2020,5,2866,165,29,4866,13,4,9,13,0,0,0,0,0,0,False,False,False,0,3,2020-10-12T11:12:01.897,0,,
2020,5,2866,170,29,1958,2,44,3,-3,4,7,4,0,4,0,True,False,False,0,3,2020-10-12T11:14:29.97,4,,0.0
2020,5,2866,180,29,1958,2,11,6,37,56,19,56,0,56,6,True,False,False,0,4,2020-10-12T11:17:06.41,56,,0.0
2020,5,2866,200,32,3396,2,30,10,3,10,7,6,4,6,0,False,False,False,0,4,2020-10-12T11:28:17.993,10,,4.0
2020,5,2866,210,32,4467,3,13,5,2,0,0,0,0,0,0,False,False,False,0,4,2020-10-15T17:27:58.5,0,,0.0
2020,5,2866,215,32,3885,2,4,10,5,6,1,6,0,6,0,False,False,False,0,3,2020-10-12T11:33:42.507,6,,0.0
2020,5,2866,230,29,7378,2,44,3,-1,12,13,11,1,11,0,False,False,False,0,1,2020-10-12T11:39:38.757,12,,1.0
2020,5,2866,235,29,4875,13,4,9,13,0,0,0,0,0,0,False,False,False,0,3,2021-02-15T21:16:00.657,0,,0.0
2020,5,2866,240,29,1958,2,47,5,3,6,3,5,1,5,0,True,False,False,0,3,2020-10-12T11:43:30.18,6,,1.0
2020,5,2866,245,29,4866,2,5,3,4,8,4,8,0,8,0,False,False,False,0,3,2020-10-12T11:45:26.85,8,,0.0
2020,5,2866,250,29,4850,2,5,5,11,40,29,38,2,38,0,False,False,False,0,1,2020-10-15T19:37:56.25,40,,2.0
2020,5,2866,285,32,3885,2,5,5,5,5,0,5,0,5,0,False,False,False,0,3,2020-10-12T11:59:03.14,5,,0.0
2020,5,2866,300,29,3398,3,30,10,0,0,0,0,0,0,0,False,False,False,0,4,2021-02-15T21:16:53.137,0,,
2020,5,2866,325,29,4875,13,3,5,6,0,0,0,0,0,0,False,False,False,0,2,2020-10-15T17:13:01.08,0,,0.0
2020,5,2866,335,32,7128,2,4,9,4,9,5,8,1,8,0,False,False,False,0,3,2020-10-12T12:19:11.33,9,,1.0
2020,5,2866,355,32,3885,2,45,5,-3,6,9,3,3,3,0,False,False,False,2,1,2020-10-15T18:59:31.093,6,,3.0
2020,5,2866,360,32,7128,13,12,9,4,0,0,0,0,0,0,False,False,False,0,3,2021-03-08T18:48:08.96,0,,0.0
2020,5,2866,385,29,3398,2,5,5,3,3,0,3,0,3,0,False,False,False,0,4,2020-10-12T12:40:49.077,3,,0.0
2020,5,2866,390,29,4866,3,4,9,5,0,0,0,0,0,0,False,False,False,0,3,2020-10-15T19:49:57.263,0,,0.0
2020,5,2866,395,29,4866,13,7,6,20,0,0,0,0,0,0,False,False,False,0,2,2021-03-05T18:06:16.707,0,,0.0
2020,5,2866,400,32,3885,2,4,10,0,12,12,12,0,12,0,False,False,False,1,1,2020-10-12T12:48:45.213,12,,0.0
2020,5,2866,410,32,3885,2,46,9,-1,9,10,7,2,7,0,False,False,False,1,1,2020-10-12T12:50:50.623,9,,2.0
2020,5,2866,415,32,7128,2,4,9,5,5,0,5,0,5,0,False,False,False,0,3,2020-10-12T12:51:56.623,5,,0.0
2020,5,2866,425,32,8237,2,5,5,4,3,-1,3,0,3,0,False,False,False,0,3,2020-10-12T12:55:38.437,3,,0.0
2020,5,2866,475,32,1791,2,51,5,-5,-2,3,-3,1,-3,0,True,False,False,0,3,2020-10-12T13:04:53.987,-2,,1.0
2020,5,2866,480,32,7807,2,47,5,-1,-1,0,-1,0,-1,0,False,False,False,0,1,2020-10-12T13:06:33.843,-1,,0.0
2020,5,2866,500,29,1958,2,5,5,5,5,0,5,0,5,0,True,False,False,0,3,2020-10-12T13:15:26.34,5,,0.0
2020,5,2866,505,29,4850,2,2,10,5,10,5,7,3,7,0,True,False,False,3,3,2020-10-15T19:02:06.91,10,,3.0
2020,5,2866,515,29,4866,2,39,9,5,6,1,6,0,6,0,False,False,False,0,3,2020-10-12T13:22:10.4,6,,0.0
2020,5,2866,520,29,4866,2,2,10,8,49,41,44,5,44,0,True,False,False,0,3,2020-10-12T13:24:22.893,49,,5.0
2020,5,2866,525,29,3356,13,46,3,3,0,0,0,0,0,0,False,False,False,0,1,2020-10-15T19:55:46.807,0,,0.0
2020,5,2866,535,29,4866,13,4,4,10,0,0,0,0,0,0,False,False,False,0,3,2020-10-15T17:13:01.08,0,,0.0
2020,5,2866,560,32,1427,13,13,10,2,0,0,0,0,0,0,False,False,False,0,3,2020-10-12T13:35:53.387,0,,0.0
2020,5,2866,575,29,4866,2,50,9,-3,2,5,0,2,0,0,False,False,False,0,3,2021-03-04T15:42:02.06,2,,2.0
2020,5,2866,590,32,1427,2,39,4,4,4,0,4,0,4,0,False,False,False,0,3,2020-10-12T13:48:34.01,4,,0.0
2020,5,2866,610,29,7378,13,48,9,-5,0,0,0,0,0,0,False,False,False,0,1,2020-10-12T13:54:54.063,0,,0.0
2020,5,2866,630,29,1958,3,35,6,15,0,0,0,0,0,0,False,False,False,0,3,2020-10-15T17:13:01.08,0,,0.0
2020,5,2866,645,32,3885,13,44,9,-3,0,0,0,0,0,0,False,False,False,0,1,2020-10-12T14:09:51.63,0,,0.0
2020,5,2866,650,32,1427,13,4,10,3,0,0,0,0,0,0,False,False,False,0,3,2020-10-12T14:12:08.957,0,,0.0
2020,5,2866,680,32,7128,13,8,7,37,0,0,0,0,0,0,False,False,False,0,3,2020-10-12T14:21:11.853,0,,0.0
2020,5,2866,710,29,4875,2,22,7,21,29,8,21,8,21,0,False,False,False,0,3,2020-10-15T20:01:29.067,29,,8.0
2020,5,2866,720,29,7378,2,16,10,4,11,7,10,1,10,6,False,False,False,0,1,2020-10-12T14:35:59.46,11,,1.0
2020,5,2866,735,32,1427,13,8,7,20,0,0,0,0,0,0,False,False,False,0,3,2020-10-12T14:38:33.093,0,,0.0
2020,5,2866,740,32,7128,13,7,6,20,0,0,0,0,0,0,False,False,False,0,2,2020-10-12T14:40:43.85,0,,0.0
2020,5,2866,785,32,7807,2,48,9,-3,1,4,-3,4,-3,0,False,False,False,1,1,2020-10-12T14:55:26.177,1,,4.0
2020,5,2866,795,32,3885,13,46,3,-1,0,0,0,0,0,0,False,False,False,0,1,2020-10-12T14:58:31.31,0,,0.0
2020,5,2867,20,28,797,13,5,3,6,0,0,0,0,0,0,False,False,False,0,1,2020-10-16T16:19:10.377,0,,0.0
2020,5,2867,30,17,7087,2,19,6,42,47,5,47,0,47,0,False,False,False,0,2,2020-10-13T00:38:39.683,47,,0.0
2020,5,2867,40,17,2253,3,2,10,7,0,0,0,0,0,0,False,False,False,0,2,2020-10-12T10:45:02.19,0,,0.0
2020,5,2867,45,17,4752,2,6,4,14,15,1,15,0,15,0,False,False,False,0,3,2020-10-16T13:00:28.32,15,,0.0
2020,5,2867,60,17,4484,2,47,5,1,3,2,2,1,2,6,False,False,False,0,4,2020-10-16T15:42:49.5,3,,1.0
2020,5,2867,80,28,7224,3,4,4,4,0,0,0,0,0,0,False,False,False,0,3,2020-10-12T11:07:13.51,0,,0.0
2020,5,2867,85,28,7619,2,2,4,10,15,5,13,2,13,0,False,False,False,0,3,2020-10-12T11:12:11.337,15,,2.0
2020,5,2867,95,28,3264,2,4,10,5,5,0,5,0,5,0,False,False,False,0,1,2020-10-16T13:02:49.05,5,,0.0
2020,5,2867,100,28,4912,2,32,9,2,11,9,9,2,9,0,False,False,False,0,3,2020-10-12T11:20:07.423,11,,2.0
2020,5,2867,110,17,4305,13,3,6,19,0,0,0,0,0,0,False,False,False,0,2,2020-10-16T15:27:08.233,0,,0.0
2020,5,2867,115,17,2253,2,9,2,23,28,5,25,3,25,0,False,False,False,0,2,2020-10-16T15:27:44.57,28,,3.0
2020,5,2867,130,17,4305,2,5,5,6,6,0,6,0,6,0,False,False,False,0,3,2020-10-16T13:03:14.063,6,,0.0
2020,5,2867,135,17,7024,2,48,4,-1,6,7,3,3,3,0,False,False,False,0,1,2020-10-12T12:01:45.417,6,,3.0
2020,5,2867,155,28,7224,2,30,9,-2,15,17,14,1,14,0,False,False,False,0,3,2020-10-12T12:09:00.687,15,,1.0
2020,5,2867,175,28,4922,2,6,4,10,11,1,11,0,11,0,True,False,False,0,3,2021-02-15T20:59:32.093,11,,0.0
2020,5,2867,180,28,4912,13,4,9,10,0,0,0,0,0,0,False,False,False,0,3,2020-10-12T12:20:55.337,0,,0.0
2020,5,2867,210,17,7087,2,2,9,4,8,4,6,2,6,0,False,False,False,0,2,2020-10-16T16:26:06.857,8,,2.0
2020,5,2867,250,17,6274,2,17,9,10,12,2,11,1,11,0,True,False,False,0,4,2020-10-13T16:44:04.453,12,,1.0
2020,5,2867,255,17,7087,2,29,3,13,19,6,15,4,15,0,False,False,False,0,2,2021-02-15T21:00:36.233,19,,4.0
2020,5,2867,265,17,7087,13,9,2,21,0,0,0,0,0,0,False,False,False,0,2,2020-10-16T13:25:52.93,0,,
2020,5,2867,270,17,7024,2,47,5,0,2,2,1,1,1,0,False,False,False,0,1,2020-10-12T12:57:33.88,2,,1.0
2020,5,2867,285,17,2253,2,19,6,22,22,0,22,0,22,6,False,False,False,0,2,2020-10-12T13:05:16.263,22,,0.0
2020,5,2867,305,28,7224,13,35,9,13,0,0,0,0,0,0,False,False,False,0,3,2020-10-16T15:57:57.183,0,,0.0
2020,5,2867,315,28,7619,2,4,7,17,20,3,18,2,18,0,False,False,False,0,2,2020-10-16T15:59:34.657,20,,2.0
2020,5,2867,330,28,7224,13,35,7,18,0,0,0,0,0,0,False,False,False,0,3,2020-10-16T16:01:30.39,0,,0.0
2020,5,2867,345,17,6274,2,7,6,25,70,45,51,19,51,0,False,False,False,1,3,2020-10-12T13:30:15.633,70,,19.0
2020,5,2867,360,17,6274,13,17,9,8,0,0,0,0,0,0,False,False,False,0,3,2020-10-12T13:36:54.007,0,,0.0
2020,5,2867,375,28,4922,13,39,10,-3,0,0,0,0,0,0,True,False,False,0,3,2020-10-13T15:11:00.3,0,,0.0
2020,5,2867,380,28,4912,13,6,4,9,0,0,0,0,0,0,False,False,False,0,3,2020-10-16T13:04:36.22,0,,0.0
2020,5,2867,385,28,797,13,11,6,31,0,0,0,0,0,0,False,False,False,0,1,2020-10-12T14:06:29.997,0,,0.0
2020,5,2867,390,17,6274,2,4,10,3,4,1,3,1,3,0,False,False,False,0,3,2020-10-12T13:51:00.11,4,,1.0
2020,5,2867,395,17,6274,2,46,3,1,1,0,1,0,1,0,False,False,False,0,3,2020-10-12T13:52:44.393,1,,0.0
2020,5,2867,400,17,7087,13,9,6,25,0,0,0,0,0,0,False,False,False,0,2,2020-10-16T12:11:33.943,0,,0.0
2020,5,2867,415,28,797,2,48,9,-5,0,5,-4,4,-4,0,False,False,False,0,1,2020-10-16T16:03:43.51,0,,4.0
2020,5,2867,425,28,4922,13,6,4,11,0,0,0,0,0,0,True,False,False,0,3,2020-10-13T15:17:39.983,0,,0.0
2020,5,2867,430,28,7224,13,6,8,23,0,0,0,0,0,0,False,False,False,0,2,2021-03-05T18:08:51.97,0,,0.0
2020,5,2867,435,17,4752,2,2,4,7,8,1,7,1,7,0,False,False,False,0,3,2020-10-12T14:09:28.967,8,,1.0
2020,5,2867,470,17,6274,2,5,5,3,4,1,3,1,3,0,False,False,False,0,3,2020-10-16T14:57:09.857,4,,1.0
2020,5,2867,480,17,7024,2,46,3,2,7,5,7,0,7,0,False,False,False,0,1,2020-10-12T14:26:17.513,7,,0.0
2020,5,2867,485,17,4305,3,13,9,2,0,0,0,0,0,0,False,False,False,0,3,2020-10-12T14:28:47.68,0,,0.0
2020,5,2867,505,28,7224,13,6,4,12,0,0,0,0,0,0,False,False,False,0,3,2020-10-12T14:36:00.63,0,,0.0
2020,5,2867,510,28,7619,13,9,6,28,0,0,0,0,0,0,False,False,False,0,2,2020-10-16T16:09:27.79,0,,0.0
2020,5,2867,525,28,7619,13,19,6,35,0,0,0,0,0,0,False,False,False,0,2,2020-10-16T17:46:27.77,0,,0.0
2020,5,2867,530,28,4912,13,4,10,10,0,0,0,0,0,0,True,False,False,0,3,2020-10-16T13:27:03.73,0,,
2020,5,2867,540,28,4922,2,30,3,0,12,12,11,1,11,0,False,False,False,0,4,2021-02-15T21:04:43.92,12,,1.0
2020,5,2867,545,28,4912,2,30,10,1,19,18,17,2,17,6,False,False,False,0,3,2021-02-15T21:05:19.863,19,,2.0
2020,5,2867,560,17,7010,2,46,3,1,6,5,5,1,5,0,True,False,False,0,1,2020-10-13T16:44:24.787,6,,1.0
2020,5,2867,570,17,7024,2,48,9,0,15,15,13,2,13,0,True,False,False,0,1,2020-10-16T11:50:41.407,15,,2.0
2020,5,2867,580,17,4913,2,48,9,-3,31,34,27,4,27,0,False,False,False,0,1,2020-10-12T15:08:33.82,31,,4.0
2020,5,2867,590,17,7087,2,8,8,27,32,5,31,1,31,6,False,False,False,0,3,2020-10-16T12:11:33.943,32,,1.0
2020,5,2867,605,28,3264,2,17,10,9,15,6,14,1,14,0,False,False,False,0,1,2021-02-15T21:05:46.663,15,,1.0
2020,5,2867,610,28,6624,13,46,3,1,0,0,0,0,0,0,False,False,False,0,1,2021-02-15T20:55:47.197,0,,0.0
2020,5,2867,615,28,7619,13,2,4,12,0,0,0,0,0,0,False,False,False,0,2,2020-10-16T16:21:01.363,0,,
2020,5,2867,635,28,4922,2,6,10,5,12,7,7,5,7,0,False,False,False,0,3,2020-10-12T15:30:17.133,12,,5.0
2020,5,2867,645,28,262,3,12,3,10,0,0,0,0,0,0,True,False,False,0,3,2020-10-16T16:15:25.697,0,,0.0
2020,5,2867,660,28,797,2,12,9,4,5,1,4,1,4,0,False,False,False,0,1,2021-03-08T18:50:31.277,5,,1.0
2020,5,2867,700,17,6274,13,9,6,15,0,0,0,0,0,0,False,False,False,0,2,2020-10-16T15:39:38.31,0,,
2020,5,2867,730,17,7024,2,48,10,-2,4,6,1,3,1,0,False,False,False,0,1,2020-10-12T16:06:51.69,4,,3.0
2020,5,2867,750,28,3264,2,4,10,5,9,4,7,2,7,0,False,False,False,0,1,2020-10-16T13:08:15.947,9,,2.0
2020,5,2867,755,28,7224,13,12,5,13,0,0,0,0,0,0,False,False,False,0,2,2020-10-16T13:09:09.603,0,,0.0
2020,5,2867,765,28,7619,13,6,4,12,0,0,0,0,0,0,False,False,False,0,2,2020-10-12T16:17:42.183,0,,0.0
2020,5,2867,800,28,4922,2,4,10,4,9,5,7,2,7,0,False,False,False,0,3,2020-10-16T16:26:21.137,9,,2.0
2020,5,2867,805,28,7224,2,2,5,2,4,2,3,1,3,0,False,False,False,0,2,2020-10-16T16:17:40.15,4,,1.0
2020,5,2867,810,28,4922,3,39,4,5,0,0,0,0,0,0,False,False,False,0,3,2020-10-16T13:10:12.68,0,,0.0
2020,5,2867,815,28,7619,2,2,10,5,9,4,6,3,6,0,False,False,False,0,2,2020-10-12T16:31:47.42,9,,3.0
2020,5,2867,825,28,4922,2,13,9,5,6,1,5,1,5,0,False,False,False,0,3,2020-10-16T13:27:15.213,6,,
2020,5,2867,830,28,4922,13,4,9,6,0,0,0,0,0,0,True,False,False,0,3,2020-10-12T16:37:59.98,0,,0.0
2020,5,2868,15,8,3883,2,53,4,-4,8,12,5,3,5,0,False,False,False,0,4,2020-10-12T10:17:31.733,8,,3.0
2020,5,2868,20,8,232,2,35,8,31,32,1,31,1,31,0,False,False,False,0,3,2020-10-12T11:29:00.837,32,,1.0
2020,5,2868,35,8,3883,2,31,5,4,17,13,10,7,10,0,False,False,False,0,4,2020-10-12T10:30:03.173,17,,7.0
2020,5,2868,45,8,5053,3,16,9,3,0,0,0,0,0,0,False,False,False,0,1,2020-10-12T10:36:14.34,0,,0.0
2020,5,2868,50,8,1067,13,9,3,6,0,0,0,0,0,0,False,False,False,0,2,2021-02-25T15:43:39.863,0,,0.0
2020,5,2868,65,14,1114,2,4,10,7,7,0,7,0,7,0,False,False,False,0,2,2020-10-12T10:42:34.933,7,,0.0
2020,5,2868,70,14,7582,2,47,5,-3,13,16,6,7,6,0,False,False,False,0,1,2020-10-12T10:46:01.763,13,,7.0
2020,5,2868,90,14,4070,2,8,7,35,36,1,36,0,36,0,False,False,False,0,3,2020-10-15T18:28:38.287,36,,0.0
2020,5,2868,100,14,6543,13,24,6,15,0,0,0,0,0,0,False,False,False,0,3,2020-10-12T11:05:41.033,0,,0.0
2020,5,2868,105,14,1114,2,13,10,4,11,7,10,1,10,0,True,False,False,0,3,2020-10-15T18:29:14.88,11,,1.0
2020,5,2868,125,8,5053,2,47,10,-1,6,7,2,4,2,0,False,False,False,0,1,2020-10-12T11:16:29.6,6,,4.0
2020,5,2868,130,8,232,2,35,6,15,18,3,15,3,15,0,True,False,False,0,3,2021-02-16T00:00:18.723,18,,3.0
2020,5,2868,140,8,1067,13,6,10,10,0,0,0,0,0,0,False,False,False,0,2,2020-10-12T11:25:10.337,0,,0.0
2020,5,2868,145,8,3883,2,4,4,11,11,0,11,0,11,0,True,False,False,0,3,2021-02-16T00:00:39.597,11,,0.0
2020,5,2868,155,8,232,2,22,7,21,30,9,23,7,23,0,False,False,False,0,3,2020-10-15T18:29:51.103,30,,7.0
2020,5,2868,165,8,1067,2,2,10,6,7,1,7,0,7,0,False,False,False,0,3,2020-10-12T11:46:04.007,7,,0.0
2020,5,2868,175,8,1067,2,47,10,1,3,2,2,1,2,0,True,False,False,0,3,2020-10-12T18:07:39.22,3,,1.0
2020,5,2868,190,8,1067,13,12,10,2,0,0,0,0,0,0,False,False,False,0,2,2021-02-16T00:01:44.427,0,,0.0
2020,5,2868,195,8,5053,2,12,5,2,2,0,2,0,2,6,False,False,False,0,4,2021-02-15T21:56:38.35,2,,0.0
2020,5,2868,210,14,1114,13,3,6,17,0,0,0,0,0,0,False,False,False,0,2,2020-10-15T17:23:45.447,0,,
2020,5,2868,215,14,4449,2,50,10,-3,14,17,7,7,7,0,False,False,False,1,3,2020-10-15T17:23:45.447,14,,7.0
2020,5,2868,220,14,4449,2,44,3,-1,1,2,-1,2,-1,0,True,False,False,0,3,2020-10-12T18:00:20.607,1,,2.0
2020,5,2868,225,14,7495,2,8,7,27,34,7,34,0,34,0,False,False,False,0,3,2021-02-15T23:52:58.603,34,,0.0
2020,5,2868,230,14,7582,2,32,3,0,4,4,2,2,2,0,False,False,False,1,1,2020-10-12T18:17:21.383,4,,2.0
2020,5,2868,240,14,7582,13,46,9,-2,0,0,0,0,0,0,False,False,False,0,1,2020-10-15T18:23:23.513,0,,0.0
2020,5,2868,260,8,1067,2,4,4,6,9,3,5,4,5,0,False,False,False,1,2,2020-10-12T12:42:42.377,9,,4.0
2020,5,2868,270,8,1067,2,35,7,26,26,0,26,0,26,0,False,False,False,0,3,2021-03-05T13:20:18.153,26,,0.0
2020,5,2868,275,8,3883,13,5,2,17,0,0,0,0,0,0,False,False,False,0,4,2020-10-15T17:23:45.447,0,,0.0
2020,5,2868,280,8,3606,2,2,4,5,6,1,5,1,5,0,False,False,False,0,3,2020-10-12T18:10:14.867,6,,1.0
2020,5,2868,295,8,3606,2,17,8,15,15,0,15,0,15,6,False,False,False,0,3,2021-02-25T15:44:35.697,15,,0.0
2020,5,2868,320,14,1119,13,5,3,3,0,0,0,0,0,0,False,False,False,0,3,2020-10-13T20:31:07.53,0,,0.0
2020,5,2868,330,8,3883,2,31,4,2,3,1,3,0,3,0,False,False,False,0,4,2020-10-12T13:23:47.73,3,,0.0
2020,5,2868,335,8,3606,2,5,5,10,10,0,10,0,10,0,False,False,False,0,3,2020-10-12T13:27:10.69,10,,0.0
2020,5,2868,345,8,5053,2,48,10,-2,13,15,3,10,3,0,False,False,False,2,1,2020-10-12T13:35:44.583,13,,10.0
2020,5,2868,355,8,3883,2,7,2,16,18,2,18,0,18,0,False,False,False,0,4,2020-10-13T17:19:32.663,18,,0.0
2020,5,2868,360,8,7652,13,17,7,18,0,0,0,0,0,0,False,False,False,0,3,2020-10-12T13:45:52.697,0,,0.0
2020,5,2868,365,8,7009,2,48,9,-3,4,7,3,1,3,0,False,False,False,0,1,2020-10-12T13:48:18.643,4,,1.0
2020,5,2868,385,8,232,13,12,3,6,0,0,0,0,0,0,False,False,False,0,3,2021-02-25T15:45:19.117,0,,0.0
2020,5,2868,390,8,3883,13,4,9,10,0,0,0,0,0,0,False,False,False,0,3,2020-10-12T13:58:11.443,0,,0.0
2020,5,2868,395,8,232,2,5,5,7,8,1,8,0,8,0,False,False,False,0,3,2020-10-12T14:02:58.7,8,,0.0
2020,5,2868,430,14,1114,2,4,10,9,9,0,9,0,9,0,False,False,False,0,3,2020-10-12T14:11:27.957,9,,0.0
2020,5,2868,440,14,895,2,32,3,1,0,-1,0,0,0,0,False,False,False,0,3,2020-10-15T18:30:53.103,0,,
2020,5,2868,445,14,1114,13,29,3,11,0,0,0,0,0,0,False,False,False,0,2,2020-10-15T18:39:17.653,0,,0.0
2020,5,2868,455,14,1114,13,13,3,0,0,0,0,0,0,0,False,False,False,0,3,2021-03-05T18:11:14.787,0,,0.0
2020,5,2868,495,8,3883,13,17,8,17,0,0,0,0,0,0,False,False,False,0,4,2021-03-09T19:40:02.067,0,,0.0
2020,5,2868,540,14,6543,2,5,3,3,4,1,4,0,4,0,False,False,False,0,1,2020-10-12T18:12:24.453,4,,0.0
2020,5,2868,545,14,6543,13,12,5,4,0,0,0,0,0,0,True,False,False,0,3,2020-10-13T19:57:09.453,0,,0.0
2020,5,2868,570,8,4976,2,4,10,4,6,2,5,1,5,0,False,False,False,0,3,2021-02-15T23:06:56,6,,1.0
2020,5,2868,580,8,1067,2,2,10,12,13,1,13,0,13,0,False,False,False,0,2,2021-02-16T21:47:16.79,13,,0.0
2020,5,2868,595,8,232,3,32,9,1,0,0,0,0,0,0,True,False,False,0,4,2021-02-15T23:12:45.667,0,,0.0
2020,5,2868,600,8,1067,13,4,5,3,0,0,0,0,0,0,False,False,False,0,2,2020-10-12T15:51:55.243,0,,0.0
2020,5,2868,625,8,3883,13,7,2,15,0,0,0,0,0,0,False,False,False,0,4,2020-10-12T16:13:42.04,0,,0.0
2020,5,2868,630,8,232,3,12,5,3,0,0,0,0,0,0,False,False,False,0,2,2020-10-12T16:16:41.133,0,,0.0
2020,5,2868,645,14,1114,2,5,2,17,18,1,18,0,18,0,False,False,False,0,3,2020-10-12T16:24:56.123,18,,0.0
2020,5,2868,655,14,1119,13,5,3,10,0,0,0,0,0,0,False,False,False,0,3,2020-10-12T16:32:32.197,0,,0.0
2020,5,2868,660,14,5197,13,12,1,18,0,0,0,0,0,0,False,False,False,0,3,2021-03-08T19:33:46.34,0,,0.0
2020,5,2868,695,8,232,13,6,4,12,0,0,0,0,0,0,False,False,False,0,3,2021-03-05T18:12:38.363,0,,0.0
2020,5,2868,700,14,1114,2,4,5,13,13,0,13,0,13,0,False,False,False,0,2,2020-10-13T17:29:43.157,13,,0.0
2020,5,2868,705,14,895,2,39,10,6,6,0,6,0,6,0,False,False,False,0,3,2020-10-15T17:23:45.447,6,,0.0
2020,5,2868,710,14,1114,2,5,5,11,11,0,10,1,10,0,False,False,False,0,2,2020-10-12T18:03:05.757,11,,1.0
2020,5,2868,715,14,1114,13,8,8,30,0,0,0,0,0,0,False,False,False,0,2,2020-10-15T17:23:45.447,0,,0.0
2020,5,2868,720,14,895,2,32,3,1,6,5,2,4,2,0,False,False,False,0,4,2020-10-12T18:02:50.703,6,,4.0
2020,5,2868,725,14,4070,2,4,9,8,13,5,10,3,10,0,False,False,False,0,3,2020-10-12T18:02:35.75,13,,3.0
2020,5,2868,730,14,6543,2,48,10,-5,12,17,3,9,3,0,False,False,False,1,1,2020-10-15T18:43:21.78,12,,
2020,5,2868,735,14,895,2,4,10,7,10,3,8,2,8,0,False,False,False,0,3,2020-10-12T17:12:28.493,10,,2.0
2020,5,2868,740,14,895,2,26,10,6,10,4,6,4,6,0,False,False,False,1,3,2021-03-02T20:18:58.927,10,,4.0
2020,5,2868,745,14,895,13,8,10,11,0,0,0,0,0,0,False,False,False,0,3,2020-10-12T17:19:29.657,0,,0.0
2020,5,2868,750,14,1114,13,4,4,5,0,0,0,0,0,0,False,False,False,0,3,2020-10-15T18:37:31.443,0,,0.0
2020,5,2868,755,14,4070,2,32,9,2,4,2,2,2,2,0,False,False,False,0,3,2020-10-15T18:37:58.753,4,,2.0
2020,5,2868,790,8,3883,13,13,4,3,0,0,0,0,0,0,True,False,False,0,4,2021-02-15T23:51:56.593,0,,0.0
2020,5,2868,840,14,895,2,32,3,0,1,1,1,0,1,0,False,False,False,0,4,2020-10-12T18:01:03.913,1,,0.0
2020,5,2868,845,14,6543,2,48,10,-5,18,23,15,3,15,0,False,False,False,0,1,2020-10-12T18:13:49.257,18,,3.0
2020,5,2869,10,9,7816,3,5,6,15,0,0,0,0,0,0,False,False,False,0,3,2020-10-16T13:31:03.667,0,,0.0
2020,5,2869,15,9,6446,2,32,9,2,6,4,6,0,6,0,False,False,False,0,4,2020-10-15T21:51:41.96,6,,0.0
2020,5,2869,20,9,7816,2,17,7,16,18,2,18,0,18,0,False,False,False,0,3,2020-10-12T17:52:54.06,18,,0.0
2020,5,2869,30,9,7816,2,4,5,4,10,6,9,1,9,0,False,False,False,0,3,2020-10-15T21:15:45.88,10,,1.0
2020,5,2869,40,9,4202,2,28,9,1,14,13,13,1,13,0,False,False,False,0,1,2020-10-12T10:50:40.387,14,,1.0
2020,5,2869,45,9,6441,2,51,10,-4,3,7,1,2,1,0,False,False,False,0,3,2020-10-12T10:53:32.373,3,,2.0
2020,5,2869,55,9,7816,13,5,3,6,0,0,0,0,0,0,True,False,False,0,3,2020-10-15T22:32:20.417,0,,0.0
2020,5,2869,75,21,7090,2,39,9,6,12,6,8,4,8,0,False,False,False,1,3,2021-03-15T14:49:06.537,12,,4.0
2020,5,2869,80,21,713,2,48,9,-6,9,15,-6,15,-6,0,False,False,False,0,1,2020-10-12T11:18:39.843,9,,
2020,5,2869,85,21,5015,13,12,2,18,0,0,0,0,0,0,False,False,False,0,3,2021-03-08T19:35:52.333,0,,
2020,5,2869,100,21,7090,2,12,2,17,17,0,17,0,17,0,False,False,False,0,2,2021-03-08T19:36:21.873,17,,0.0
2020,5,2869,105,21,713,2,46,3,0,18,18,16,2,16,0,False,False,False,0,1,2020-10-12T17:53:30.117,18,,2.0
2020,5,2869,125,9,2568,2,13,10,4,13,9,11,2,11,0,False,False,False,0,4,2020-10-13T16:43:17.41,13,,2.0
2020,5,2869,134,9,4202,13,6,9,6,0,0,0,0,0,0,False,False,False,0,1,2021-03-05T18:14:53.17,0,,0.0
2020,5,2869,155,9,7183,3,28,9,-2,0,0,0,0,0,0,False,False,False,0,1,2021-03-08T16:15:47.463,0,,0.0
2020,5,2869,170,21,7226,2,5,9,5,7,2,5,2,5,0,False,False,False,0,4,2020-10-12T12:19:39.46,7,,2.0
2020,5,2869,180,21,713,13,28,9,-2,0,0,0,0,0,0,False,False,False,0,1,2020-10-12T12:27:20.42,0,,0.0
2020,5,2869,195,21,713,2,48,10,-6,9,15,9,0,9,0,False,False,False,0,1,2020-10-12T12:33:22.61,9,,0.0
2020,5,2869,215,21,576,2,4,10,3,3,0,3,0,3,0,False,False,False,0,3,2020-10-15T20:15:25.313,3,,0.0
2020,5,2869,220,21,2288,13,47,5,1,0,0,0,0,0,0,True,False,False,0,1,2020-10-13T19:57:51.34,0,,0.0
2020,5,2869,250,9,6441,2,4,9,1,4,3,3,1,3,0,True,False,False,0,3,2020-10-15T22:32:52.63,4,,1.0
2020,5,2869,270,9,6441,2,30,10,-2,10,12,2,8,2,0,False,False,False,0,4,2020-10-15T21:58:06.333,10,,8.0
2020,5,2869,280,9,6436,2,4,9,7,8,1,8,0,8,0,False,False,False,0,3,2020-10-12T13:10:20.323,8,,0.0
2020,5,2869,300,9,6441,2,30,5,0,5,5,3,2,3,0,False,False,False,0,3,2020-10-15T22:02:57.82,5,,2.0
2020,5,2869,335,21,576,2,5,3,14,11,-3,11,0,11,0,False,False,False,0,3,2020-10-13T19:44:28.65,11,,0.0
2020,5,2869,355,21,4422,13,5,9,6,0,0,0,0,0,0,False,False,False,0,3,2020-10-13T19:44:57.213,0,,0.0
2020,5,2869,360,21,576,2,13,10,7,21,14,19,2,19,0,False,False,False,0,3,2020-10-12T13:46:37.94,21,,2.0
2020,5,2869,370,21,7090,2,2,10,7,16,9,12,4,12,0,False,False,False,0,2,2020-10-15T21:26:49.137,16,,4.0
2020,5,2869,405,21,4422,2,9,2,15,27,12,27,0,27,6,False,False,False,0,2,2021-02-25T15:48:05.96,27,,
2020,5,2869,420,9,322,13,3,5,12,0,0,0,0,0,0,False,False,False,0,2,2020-10-15T22:07:25.41,0,,0.0
2020,5,2869,425,9,7816,2,8,7,20,26,6,24,2,24,0,True,False,False,1,3,2020-10-15T22:33:00.493,26,,2.0
2020,5,2869,430,9,7816,2,6,10,5,6,1,5,1,5,0,False,False,False,0,3,2020-10-15T22:08:07.72,6,,1.0
2020,5,2869,440,9,6446,13,32,5,2,0,0,0,0,0,0,True,False,False,0,3,2020-10-13T16:48:06.497,0,,0.0
2020,5,2869,445,9,7816,2,17,8,20,21,1,21,0,21,0,False,False,False,0,3,2020-10-12T17:54:40.07,21,,0.0
2020,5,2869,450,9,4233,2,11,5,10,11,1,11,0,11,6,False,False,False,0,6,2020-10-15T22:14:07.587,11,,0.0
2020,5,2869,465,21,576,13,4,9,10,0,0,0,0,0,0,False,False,False,0,3,2020-10-12T14:31:40.377,0,,0.0
2020,5,2869,485,21,7090,13,19,2,50,0,0,0,0,0,0,False,False,False,0,2,2020-10-13T19:45:22.427,0,,0.0
2020,5,2869,495,21,7090,2,12,10,1,12,11,7,5,7,0,False,False,False,2,3,2021-03-08T19:37:04.39,12,,5.0
2020,5,2869,510,21,576,3,2,9,5,0,0,0,0,0,0,False,False,False,0,3,2020-10-12T17:55:27.843,0,,
2020,5,2869,515,21,4422,2,32,3,5,16,11,14,2,14,0,False,False,False,0,4,2020-10-12T15:02:39.293,16,,2.0
2020,5,2869,520,21,4405,2,48,9,-3,-3,0,-3,0,-3,0,False,False,False,0,1,2020-10-12T15:04:56.24,-3,,0.0
2020,5,2869,530,21,7090,2,11,2,29,31,2,31,0,31,6,False,False,False,0,3,2020-10-12T15:10:48.597,31,,
2020,5,2869,570,9,7816,2,8,1,20,22,2,21,1,21,0,True,False,False,0,3,2020-10-15T20:35:51.983,22,,1.0
2020,5,2869,575,9,6446,13,32,5,6,0,0,0,0,0,0,False,False,False,0,4,2021-04-01T19:08:00.353,0,,0.0
2020,5,2869,600,9,7816,2,4,5,10,11,1,11,0,11,0,False,False,False,0,3,2020-10-12T15:36:21.147,11,,0.0
2020,5,2869,620,21,7090,3,35,5,10,0,0,0,0,0,0,False,False,False,0,3,2020-10-15T22:15:25.797,0,,0.0
2020,5,2869,630,21,576,2,5,3,7,7,0,7,0,7,0,False,False,False,0,3,2020-10-16T13:11:28.933,7,,0.0
2020,5,2869,650,9,322,2,5,3,6,8,2,7,1,7,0,False,False,False,0,3,2020-10-15T21:09:30.277,8,,1.0
2020,5,2869,655,9,322,3,4,5,2,0,0,0,0,0,0,False,False,False,0,2,2021-02-03T18:25:11.747,0,,0.0
2020,5,2869,670,21,7090,2,3,3,12,10,-2,10,0,10,0,False,False,False,0,2,2020-10-12T16:02:03.987,10,,0.0
2020,5,2869,680,21,7090,2,9,2,26,39,13,26,13,26,0,False,False,False,0,3,2020-10-12T16:08:45.723,39,,13.0
2020,5,2869,705,21,4405,2,48,9,-6,3,9,1,2,1,0,False,False,False,0,1,2020-10-12T16:18:34.79,3,,2.0
2020,5,2869,710,21,6444,13,12,5,3,0,0,0,0,0,0,False,False,False,0,2,2020-10-12T16:21:37.143,0,,0.0
2020,5,2869,740,21,7090,2,4,10,7,9,2,6,3,6,0,False,False,False,0,2,2020-10-12T17:44:32.72,9,,3.0
2020,5,2869,770,9,6436,2,4,5,6,8,2,6,2,6,0,False,False,False,1,2,2020-10-15T21:42:03.033,8,,2.0
2020,5,2869,795,9,7183,2,32,10,-4,9,13,4,5,4,0,False,False,False,1,1,2020-10-15T22:16:18.17,9,,5.0
2020,5,2869,810,9,7183,2,51,9,-7,-7,0,-7,0,-7,0,True,False,False,0,3,2020-10-15T21:11:10.68,-7,,0.0
2020,5,2869,815,9,7816,2,4,10,9,10,1,9,1,9,0,False,False,False,0,3,2020-10-12T17:00:11.743,10,,1.0
2020,5,2869,835,21,7090,13,2,10,7,0,0,0,0,0,0,False,False,False,0,2,2020-10-12T17:03:01.05,0,,0.0
2020,5,2869,840,21,7090,2,12,5,14,14,0,14,0,14,0,False,False,False,0,3,2021-03-08T19:38:22.107,14,,0.0
2020,5,2869,845,21,2288,2,12,9,-4,-1,3,-2,1,-2,0,False,False,False,0,1,2021-03-05T19:09:48.497,-1,,1.0
2020,5,2869,850,21,2288,2,46,3,0,2,2,1,1,1,0,False,False,False,0,1,2020-10-12T17:10:12.483,2,,1.0
2020,5,2869,855,21,2288,13,12,10,8,0,0,0,0,0,0,False,False,False,0,1,2020-10-16T13:29:04.423,0,,0.0
2020,5,2869,865,9,7816,13,2,4,6,0,0,0,0,0,0,False,False,False,0,3,2020-10-12T17:15:35.95,0,,0.0
2020,5,2869,870,9,322,2,13,9,3,15,12,4,11,4,0,True,False,False,2,2,2020-10-16T13:20:35.933,15,,11.0
2020,5,2869,880,9,6436,2,12,2,20,19,-1,19,0,19,0,False,False,False,0,2,2020-10-12T17:20:45.333,19,,0.0
2020,5,2869,885,9,6436,2,19,2,36,38,2,36,2,36,0,False,False,False,0,2,2020-10-15T22:16:55.767,38,,2.0
2020,5,2870,10,18,6907,13,2,9,6,0,0,0,0,0,0,False,False,False,0,2,2020-10-12T10:39:37.18,0,,0.0
2020,5,2870,15,18,6907,2,35,6,22,23,1,22,1,22,0,False,False,False,0,4,2020-10-12T10:41:48.887,23,,1.0
2020,5,2870,30,18,6706,2,32,3,5,11,6,9,2,9,0,False,False,False,0,4,2021-03-15T15:04:14.047,11,,2.0
2020,5,2870,35,18,4152,3,12,10,0,0,0,0,0,0,0,False,False,False,0,1,2021-03-08T19:44:10.807,0,,0.0
2020,5,2870,45,18,6907,2,13,9,4,5,1,4,1,4,0,False,False,False,0,4,2020-10-12T10:54:33.193,5,,1.0
2020,5,2870,50,18,7711,2,26,9,5,5,0,5,0,5,0,False,False,False,0,3,2020-10-12T11:01:01.73,5,,0.0
2020,5,2870,55,18,6897,2,3,5,13,13,0,13,0,13,0,False,False,False,0,2,2020-10-12T11:03:07.107,13,,0.0
2020,5,2870,80,27,5050,2,28,4,0,7,7,3,4,3,0,False,False,False,0,1,2020-10-12T11:14:25.5,7,,4.0
2020,5,2870,90,27,7408,2,2,4,12,13,1,13,0,13,0,False,False,False,0,3,2020-10-12T11:17:44.853,13,,0.0
2020,5,2870,105,27,5050,2,47,5,1,2,1,0,2,0,0,False,False,False,0,3,2020-10-12T11:22:29.71,2,,2.0
2020,5,2870,140,18,6900,2,48,9,-3,7,10,6,1,6,0,False,False,False,0,1,2020-10-12T11:36:16.143,7,,1.0
2020,5,2870,150,18,7711,13,6,7,18,0,0,0,0,0,0,False,False,False,0,2,2020-10-15T14:59:15.437,0,,0.0
2020,5,2870,160,18,4572,2,48,9,-4,7,11,2,5,2,0,False,False,False,0,1,2020-10-15T18:14:43.947,7,,5.0
2020,5,2870,170,18,1381,2,2,9,8,9,1,8,1,8,0,False,False,False,0,2,2020-10-12T11:57:21.093,9,,1.0
2020,5,2870,220,18,4572,2,44,9,-4,9,13,7,2,7,0,False,False,False,0,1,2020-10-12T12:40:00.84,9,,2.0
2020,5,2870,250,27,5050,2,4,9,2,3,1,2,1,2,0,False,False,False,0,1,2020-10-12T12:49:24.25,3,,1.0
2020,5,2870,255,27,7852,2,3,3,13,12,-1,12,0,12,0,False,False,False,0,2,2020-10-12T12:51:00.027,12,,0.0
2020,5,2870,265,18,7711,2,2,10,6,7,1,6,1,6,0,False,False,False,0,2,2020-10-12T12:53:33.597,7,,1.0
2020,5,2870,285,27,5050,2,48,9,-6,-6,0,-6,0,-6,0,False,False,False,0,1,2020-10-15T18:15:41.77,-6,,0.0
2020,5,2870,315,18,4572,2,45,10,-5,10,15,0,10,0,0,False,False,False,1,1,2020-10-12T13:10:37.58,10,,10.0
2020,5,2870,325,18,6706,13,39,4,4,0,0,0,0,0,0,False,False,False,0,3,2020-10-12T13:15:06.063,0,,0.0
2020,5,2870,330,18,1381,2,5,5,8,8,0,8,0,8,0,False,False,False,0,2,2020-10-12T13:19:26.137,8,,0.0
2020,5,2870,335,18,6900,2,48,10,-1,14,15,12,2,12,0,False,False,False,0,1,2020-10-12T13:25:15.42,14,,2.0
2020,5,2870,345,18,1381,2,2,10,7,9,2,8,1,8,0,False,False,False,0,2,2020-10-12T13:30:33.057,9,,1.0
2020,5,2870,350,18,4572,2,4,10,3,3,0,3,0,3,0,False,False,False,0,1,2020-10-15T18:15:52.183,3,,0.0
2020,5,2870,360,18,813,13,35,10,10,0,0,0,0,0,0,False,False,False,0,4,2020-10-12T13:36:58.35,0,,0.0
2020,5,2870,365,18,1381,13,19,2,28,0,0,0,0,0,0,False,False,False,0,2,2020-10-12T13:41:12.277,0,,0.0
2020,5,2870,390,27,650,2,5,5,5,9,4,8,1,8,0,False,False,False,0,3,2020-10-12T13:50:51.92,9,,1.0
2020,5,2870,425,18,4572,2,48,10,-6,-5,1,-5,0,-5,0,False,False,False,0,1,2020-10-12T14:10:03.167,-5,,0.0
2020,5,2870,430,18,1381,13,4,9,8,0,0,0,0,0,0,False,False,False,0,3,2020-10-15T16:45:02.107,0,,0.0
2020,5,2870,445,27,5050,2,12,5,5,13,8,5,8,5,0,False,False,False,1,1,2021-01-12T23:27:55.953,13,,8.0
2020,5,2870,450,27,505,2,5,2,15,20,5,20,0,20,0,False,False,False,0,3,2020-10-13T18:02:19.803,20,,0.0
2020,5,2870,460,27,6397,2,11,6,19,19,0,19,0,19,6,True,False,False,0,4,2020-10-15T18:16:02.687,19,,0.0
2020,5,2870,485,18,1381,13,4,2,16,0,0,0,0,0,0,False,False,False,0,2,2020-10-12T14:49:18.397,0,,0.0
2020,5,2870,495,27,7852,2,18,3,-2,2,4,0,2,0,0,False,False,False,0,2,2020-10-12T14:57:20.777,2,,2.0
2020,5,2870,500,27,7408,2,2,9,12,13,1,13,0,13,6,False,False,False,0,2,2020-10-12T15:04:16.703,13,,0.0
2020,5,2870,515,18,7711,13,35,5,11,0,0,0,0,0,0,False,False,False,0,3,2021-03-05T18:16:48.25,0,,0.0
2020,5,2870,540,18,6900,2,28,4,0,3,3,2,1,2,0,False,False,False,0,1,2020-10-15T18:16:39.12,3,,1.0
2020,5,2870,545,18,6907,2,35,6,21,25,4,23,2,23,0,False,False,False,0,4,2020-10-12T18:32:39.523,25,,2.0
2020,5,2870,550,18,1381,2,5,5,9,9,0,9,0,9,0,False,False,False,0,3,2021-03-15T15:20:36.507,9,,0.0
2020,5,2870,560,18,1381,13,26,10,3,0,0,0,0,0,0,False,False,False,0,3,2020-10-12T15:37:22.97,0,,0.0
2020,5,2870,565,18,1381,2,2,10,8,10,2,10,0,10,0,False,False,False,0,2,2021-02-15T20:49:23.923,10,,0.0
2020,5,2870,575,18,4152,13,9,2,17,0,0,0,0,0,0,True,False,False,0,3,2020-10-15T18:16:49.353,0,,0.0
2020,5,2870,580,18,1381,2,36,10,13,14,1,3,11,3,0,True,False,False,0,3,2021-03-15T15:20:45.937,14,,11.0
2020,5,2870,585,18,1381,2,5,5,3,3,0,3,0,3,6,False,False,False,0,3,2020-10-12T15:56:06.163,3,,0.0
2020,5,2870,605,27,5050,2,45,5,3,8,5,7,1,7,0,False,False,False,0,1,2020-10-12T16:10:25.303,8,,1.0
2020,5,2870,610,27,650,2,18,3,-1,1,2,0,1,0,0,False,False,False,0,2,2020-10-12T16:12:54.603,1,,1.0
2020,5,2870,615,27,650,2,51,3,-8,17,25,14,3,14,0,True,False,False,0,3,2020-10-15T17:01:03.233,17,,3.0
2020,5,2870,625,27,5069,3,19,6,40,0,0,0,0,0,0,False,False,False,0,3,2020-10-15T14:59:59.32,0,,0.0
2020,5,2870,630,27,7408,13,19,6,38,0,0,0,0,0,0,False,False,False,0,2,2021-03-15T15:20:56.33,0,,0.0
2020,5,2870,655,18,1381,2,5,5,8,12,4,10,2,10,0,True,False,False,0,3,2020-10-12T16:41:30.48,12,,2.0
2020,5,2870,675,18,7711,2,35,5,11,11,0,11,0,11,0,False,False,False,0,3,2021-03-15T15:21:05.03,11,,0.0
2020,5,2870,710,18,6907,2,6,9,8,11,3,9,2,9,0,False,False,False,0,4,2020-10-12T16:59:57.803,11,,2.0
2020,5,2870,725,18,1381,2,26,3,5,6,1,6,0,6,6,False,False,False,0,2,2020-10-15T18:16:58.77,6,,0.0
2020,5,2870,740,27,7408,13,29,6,29,0,0,0,0,0,0,False,False,False,0,2,2021-03-15T15:21:14.23,0,,0.0
2020,5,2870,745,27,505,13,4,8,15,0,0,0,0,0,0,True,False,False,0,3,2020-10-12T18:30:10.817,0,,
2020,5,2870,750,27,7408,2,5,3,6,7,1,6,1,6,0,False,False,False,0,3,2020-10-12T17:14:57.71,7,,1.0
2020,5,2870,760,27,5050,13,12,2,19,0,0,0,0,0,0,False,False,False,0,1,2021-03-05T18:17:35.867,0,,0.0
2020,5,2870,825,27,5069,13,3,3,11,0,0,0,0,0,0,False,False,False,0,2,2020-10-12T17:54:36.33,0,,0.0
2020,5,2870,830,27,5069,13,6,7,19,0,0,0,0,0,0,False,False,False,0,2,2020-10-15T18:17:11.257,0,,0.0
2020,5,2870,840,27,7408,2,21,6,34,39,5,38,1,38,0,False,False,False,0,2,2020-10-12T17:57:00.21,39,,1.0
2020,5,2870,845,27,7408,13,9,6,25,0,0,0,0,0,0,False,False,False,0,2,2020-10-12T18:01:24.953,0,,0.0
2020,5,2870,850,27,650,2,12,5,13,17,4,17,0,17,0,False,False,False,0,3,2020-10-12T18:01:13.857,17,,0.0
2020,5,2870,860,27,7408,2,2,10,7,15,8,12,3,12,0,False,False,False,0,2,2020-10-12T18:05:15.89,15,,3.0
2020,5,2870,865,27,650,3,5,3,5,0,0,0,0,0,0,False,False,False,0,2,2020-10-12T18:11:08.153,0,,0.0
2020,5,2870,870,27,7408,13,5,5,6,0,0,0,0,0,0,True,False,False,0,2,2020-10-13T18:07:26.433,0,,0.0
2020,5,2870,875,27,7408,13,9,5,6,0,0,0,0,0,0,True,False,False,0,2,2020-10-13T18:07:36.547,0,,0.0
2020,5,2870,885,27,7408,2,6,10,6,6,0,6,0,6,6,False,False,False,0,3,2021-03-15T15:21:24.55,6,,0.0
2020,5,2870,900,18,813,2,47,5,5,10,5,10,0,10,0,False,False,False,0,3,2021-03-15T15:21:33.713,10,,0.0
2020,5,2871,15,26,4282,3,30,5,3,0,0,0,0,0,0,False,False,False,0,4,2020-10-13T10:22:12.293,0,,0.0
2020,5,2871,45,20,5140,2,45,5,-6,-5,1,-5,0,-5,0,False,False,False,0,1,2020-10-13T10:33:36.07,-5,,0.0
2020,5,2871,50,20,5140,3,50,5,-2,0,0,0,0,0,0,True,False,False,0,2,2020-10-13T10:35:30.47,0,,0.0
2020,5,2871,75,26,309,2,5,3,11,12,1,11,1,11,0,False,False,False,0,2,2020-10-13T10:45:57.64,12,,1.0
2020,5,2871,95,26,7491,13,9,6,17,0,0,0,0,0,0,False,False,False,0,3,2021-02-15T20:04:25.23,0,,0.0
2020,5,2871,105,26,309,2,35,2,17,17,0,17,0,17,6,False,False,False,0,3,2020-10-13T10:55:39.73,17,,0.0
2020,5,2871,130,20,213,2,5,5,14,14,0,14,0,14,0,False,False,False,0,3,2020-10-13T11:02:22.34,14,,0.0
2020,5,2871,135,20,8131,13,4,10,9,0,0,0,0,0,0,False,False,False,0,2,2021-03-08T19:48:46.95,0,,0.0
2020,5,2871,140,20,4535,3,13,9,5,0,0,0,0,0,0,False,False,False,0,4,2020-10-15T21:10:30.697,0,,0.0
2020,5,2871,145,20,6388,13,4,3,13,0,0,0,0,0,0,False,False,False,0,2,2020-10-13T11:10:11.347,0,,0.0
2020,5,2871,155,26,7453,13,19,7,43,0,0,0,0,0,0,False,False,False,0,2,2020-10-13T11:14:01.75,0,,0.0
2020,5,2871,175,20,306,2,46,3,3,10,7,9,1,9,0,False,False,False,0,1,2020-10-13T11:21:07.677,10,,1.0
2020,5,2871,185,20,6388,2,5,3,4,4,0,4,0,4,0,True,False,False,0,2,2020-10-13T11:24:32.723,4,,0.0
2020,5,2871,215,26,4282,2,4,10,6,8,2,7,1,7,0,False,False,False,0,3,2020-10-13T11:40:26.583,8,,1.0
2020,5,2871,235,26,7695,2,44,9,-6,9,15,9,0,9,0,False,False,False,0,1,2020-10-13T11:47:23.687,9,,0.0
2020,5,2871,240,26,7453,2,23,7,44,49,5,5,44,5,0,False,False,False,0,3,2020-10-15T21:28:56.707,49,,44.0
2020,5,2871,245,26,4619,2,13,3,4,4,0,4,0,4,6,True,False,False,0,3,2020-10-13T11:53:28.61,4,,0.0
2020,5,2871,260,20,8131,13,12,3,13,0,0,0,0,0,0,False,False,False,0,3,2020-10-13T11:57:37.603,0,,0.0
2020,5,2871,265,20,5140,2,16,9,3,9,6,7,2,7,0,False,False,False,0,1,2020-10-13T11:59:29.35,9,,2.0
2020,5,2871,280,26,6301,2,45,10,-5,1,6,-1,2,-1,0,False,False,False,0,1,2020-10-13T12:05:12.533,1,,2.0
2020,5,2871,285,26,6301,2,48,10,-3,5,8,-2,7,-2,0,False,False,False,0,1,2020-10-13T12:07:14.86,5,,
2020,5,2871,295,26,6301,2,48,9,-3,6,9,-2,8,-2,0,False,False,False,1,1,2020-10-13T17:37:05.607,6,,8.0
2020,5,2871,310,20,213,13,4,9,10,0,0,0,0,0,0,False,False,False,0,3,2020-10-13T12:23:21.073,0,,0.0
2020,5,2871,315,20,2650,13,35,8,18,0,0,0,0,0,0,False,False,False,0,3,2020-10-13T12:25:57.187,0,,0.0
2020,5,2871,330,26,4282,2,7,5,3,3,0,3,0,3,6,False,False,False,0,4,2020-10-13T12:32:22.033,3,,0.0
2020,5,2871,350,20,2650,2,39,10,6,7,1,7,0,7,0,False,False,False,0,3,2020-10-13T12:38:12.28,7,,0.0
2020,5,2871,360,20,2650,2,5,3,4,4,0,4,0,4,0,False,False,False,0,3,2020-10-13T12:41:32.363,4,,0.0
2020,5,2871,365,20,5140,3,5,10,3,0,0,0,0,0,0,False,False,False,0,1,2020-10-13T12:43:34.683,0,,0.0
2020,5,2871,395,26,7453,13,12,7,35,0,0,0,0,0,0,False,False,False,0,3,2020-10-15T21:11:34.823,0,,0.0
2020,5,2871,405,20,2650,13,13,10,6,0,0,0,0,0,0,False,False,False,0,3,2020-10-13T12:55:18.983,0,,0.0
2020,5,2871,410,20,5140,2,16,10,6,14,8,12,2,12,0,False,False,False,0,1,2020-10-13T12:56:59.217,14,,2.0
2020,5,2871,415,20,8131,2,2,4,7,14,7,11,3,11,0,False,False,False,0,3,2020-10-13T12:58:26.967,14,,3.0
2020,5,2871,420,20,213,2,4,10,6,6,0,6,0,6,0,False,False,False,0,3,2020-10-13T13:00:29.42,6,,0.0
2020,5,2871,425,20,213,2,8,4,13,11,-2,13,-2,13,0,False,False,False,0,3,2020-10-13T13:02:17.573,11,,-2.0
2020,5,2871,430,20,213,2,2,10,5,5,0,5,0,5,0,False,False,False,0,3,2020-10-13T13:05:51.323,5,,0.0
2020,5,2871,440,20,4535,13,31,10,1,0,0,0,0,0,0,True,False,False,0,4,2020-10-14T17:42:52.857,0,,0.0
2020,5,2871,485,20,6388,2,46,3,1,4,3,3,1,3,0,True,False,False,0,4,2020-10-15T21:29:53.573,4,,1.0
2020,5,2871,500,20,5140,2,50,3,-4,9,13,9,0,9,0,True,False,False,1,2,2020-10-13T13:46:23.827,9,,0.0
2020,5,2871,520,26,4282,2,13,9,4,6,2,5,1,5,0,False,False,False,0,3,2020-10-13T13:52:30.723,6,,1.0
2020,5,2871,535,26,4619,13,5,6,17,0,0,0,0,0,0,False,False,False,0,2,2020-10-13T13:58:44.217,0,,0.0
2020,5,2871,545,20,213,2,6,1,17,19,2,18,1,18,0,False,False,False,0,2,2020-10-15T21:30:24.29,19,,1.0
2020,5,2871,555,20,213,2,4,10,7,12,5,11,1,11,0,False,False,False,0,3,2020-10-13T14:11:01.46,12,,1.0
2020,5,2871,560,20,2650,13,5,3,5,0,0,0,0,0,0,False,False,False,0,3,2020-10-13T14:13:37.777,0,,0.0
2020,5,2871,570,20,5140,2,46,3,4,6,2,6,0,6,0,False,False,False,0,3,2020-10-13T14:17:02.35,6,,0.0
2020,5,2871,605,26,4619,2,3,5,7,7,0,7,0,7,0,False,False,False,0,2,2020-10-13T14:32:53.517,7,,0.0
2020,5,2871,620,26,6301,3,18,5,-2,0,0,0,0,0,0,False,False,False,0,2,2020-10-13T14:42:43.3,0,,0.0
2020,5,2871,625,26,4619,13,21,7,33,0,0,0,0,0,0,False,False,False,0,2,2020-10-15T21:30:38.283,0,,0.0
2020,5,2871,640,20,5140,2,46,3,2,4,2,4,0,4,0,False,False,False,0,1,2020-10-13T14:50:49.793,4,,0.0
2020,5,2871,645,20,213,2,4,7,15,15,0,15,0,15,0,False,False,False,0,2,2020-10-13T17:37:21.507,15,,0.0
2020,5,2871,655,20,213,2,26,5,-1,9,10,6,3,6,0,False,False,False,0,2,2020-10-13T15:11:05.337,9,,3.0
2020,5,2871,670,20,213,2,5,6,15,15,0,15,0,15,0,False,False,False,0,2,2020-10-13T15:19:39.86,15,,0.0
2020,5,2871,690,20,958,2,35,6,31,41,10,41,0,41,6,False,False,False,0,3,2020-10-13T15:26:08.92,41,,0.0
2020,5,2871,705,26,4619,13,12,2,25,0,0,0,0,0,0,False,False,False,0,3,2021-03-08T19:49:46.407,0,,0.0
2020,5,2871,710,26,7697,2,5,5,8,8,0,8,0,8,0,False,False,False,0,2,2020-10-15T21:31:40.717,8,,0.0
2020,5,2871,715,26,4282,2,5,5,6,6,0,6,0,6,0,False,False,False,0,3,2020-10-13T15:34:55.297,6,,0.0
2020,5,2871,720,26,4282,13,35,2,19,0,0,0,0,0,0,False,False,False,0,4,2021-02-15T20:05:55.74,0,,0.0
2020,5,2871,745,26,4282,13,5,5,9,0,0,0,0,0,0,False,False,False,0,3,2020-10-13T15:44:09.857,0,,0.0
2020,5,2871,760,20,2650,13,13,9,6,0,0,0,0,0,0,False,False,False,0,3,2020-10-13T15:48:44.477,0,,0.0
2020,5,2871,765,20,8131,2,13,10,2,3,1,3,0,3,0,False,False,False,0,3,2020-10-13T15:50:37.197,3,,0.0
2020,5,2871,775,26,1900,2,53,3,-5,14,19,5,9,5,0,False,False,False,0,4,2020-10-13T15:53:55.563,14,,9.0
2020,5,2871,790,26,4619,2,19,2,37,64,27,64,0,64,6,True,False,False,0,2,2020-10-13T15:58:49.207,64,,0.0
2020,5,2871,805,20,213,2,13,10,1,2,1,2,0,2,0,False,False,False,0,3,2020-10-13T16:03:24.55,2,,0.0
2020,5,2871,810,20,5140,2,16,4,7,9,2,8,1,8,0,False,False,False,0,1,2020-10-13T17:34:43.537,9,,1.0
2020,5,2871,815,20,213,2,4,5,7,9,2,8,1,8,0,False,True,False,0,2,2020-10-13T16:07:16.68,9,,1.0
2020,5,2871,830,20,5140,2,11,2,22,28,6,28,0,28,0,False,False,False,0,1,2020-10-13T16:14:23.997,28,,0.0
2020,5,2871,835,20,958,13,17,8,15,0,0,0,0,0,0,False,False,False,0,4,2020-10-15T21:00:57.883,0,,0.0
2020,5,2871,840,20,8131,2,6,10,6,6,0,6,0,6,0,False,False,False,0,2,2021-02-25T15:53:39.263,6,,0.0
2020,5,2871,870,26,6301,2,16,9,2,7,5,5,2,5,0,False,False,False,0,1,2020-10-13T16:37:49.063,7,,2.0
2020,5,2871,875,26,6301,2,16,4,1,8,7,5,3,5,0,False,False,False,0,1,2020-10-13T16:39:00.653,8,,3.0
2020,5,2871,885,26,6301,2,46,3,-1,1,2,1,0,1,0,False,False,False,0,1,2020-10-13T16:42:00.673,1,,0.0
2020,5,2871,890,26,4619,2,9,6,29,29,0,29,0,29,0,False,False,False,0,2,2020-10-13T16:44:43.3,29,,0.0
2020,5,2871,925,20,8131,2,3,5,9,11,2,10,1,10,0,False,False,False,0,2,2020-10-15T21:32:12.04,11,,1.0
2020,5,2871,935,20,958,2,5,5,11,11,0,11,0,11,0,False,False,False,0,3,2020-10-15T21:32:31.593,11,,0.0
2020,5,2871,940,20,213,2,2,10,5,5,0,5,0,5,0,False,False,False,0,2,2020-10-13T16:58:25.403,5,,0.0
2020,5,2871,945,20,306,2,4,10,3,13,10,3,10,3,0,False,False,False,2,1,2020-10-15T21:32:51.36,13,,10.0
2020,5,2871,950,20,1162,2,32,5,0,1,1,1,0,1,0,True,False,False,0,4,2020-10-15T21:33:04.44,1,,0.0
2020,5,2871,965,20,213,13,12,5,9,0,0,0,0,0,0,False,False,False,0,3,2020-10-13T17:10:08.593,0,,0.0
2020,5,2871,980,26,7697,13,4,9,5,0,0,0,0,0,0,False,False,False,0,2,2020-10-13T17:13:12.64,0,,
2020,5,2871,990,26,4282,13,17,8,15,0,0,0,0,0,0,False,False,False,0,3,2020-10-13T17:17:14.75,0,,0.0
2020,5,2871,995,26,7697,3,6,4,12,0,0,0,0,0,0,False,False,False,0,3,2020-10-15T21:13:39.667,0,,0.0
2020,5,2871,1000,26,4619,2,2,9,5,5,0,6,-1,6,0,False,False,False,0,2,2021-05-03T19:58:32.79,5,,-1.0
2020,6,2872,10,4,594,13,5,5,5,0,0,0,0,0,0,False,False,False,0,3,2020-10-20T10:09:23.333,0,,
2020,6,2872,15,4,1412,13,35,9,10,0,0,0,0,0,0,False,False,False,0,3,2020-10-22T14:08:34.333,0,,
2020,6,2872,20,4,1412,3,5,3,14,0,0,0,0,0,0,False,False,False,0,3,2021-02-16T21:11:44.06,0,,
2020,6,2872,40,16,3938,2,4,3,3,8,5,7,1,7,0,False,False,False,0,2,2020-10-20T10:16:58.42,8,,
2020,6,2872,45,16,374,13,2,4,7,0,0,0,0,0,0,False,False,False,0,3,2020-10-22T18:37:38.547,0,,
2020,6,2872,65,16,374,13,12,10,7,0,0,0,0,0,0,False,False,False,0,3,2021-02-16T21:15:06.56,0,,
2020,6,2872,80,4,2629,13,12,5,3,0,0,0,0,0,0,False,False,False,0,1,2020-10-20T10:30:38.783,0,,
2020,6,2872,90,4,5119,2,34,4,-4,4,8,3,1,3,0,True,False,False,0,3,2021-03-04T14:31:30.107,4,,
2020,6,2872,100,4,1412,13,21,7,44,0,0,0,0,0,0,False,False,False,0,2,2021-02-16T21:16:20.553,0,,
2020,6,2872,105,4,594,2,4,9,11,11,0,11,0,11,0,False,False,False,0,3,2021-02-16T21:57:26.35,11,,
2020,6,2872,110,4,2853,13,35,6,33,0,0,0,0,0,0,False,False,False,0,3,2020-10-20T10:42:55.323,0,,
2020,6,2872,120,4,6983,13,12,5,1,0,0,0,0,0,0,False,False,False,0,1,2020-10-20T10:51:50.673,0,,
2020,6,2872,140,16,7681,2,46,3,-1,5,6,4,1,4,0,False,False,False,0,1,2020-10-20T10:57:03.763,5,,
2020,6,2872,145,16,4143,2,4,5,3,6,3,6,0,6,0,False,False,False,0,2,2020-10-20T10:58:39.453,6,,
2020,6,2872,150,16,4143,2,4,3,13,22,9,19,3,19,0,False,False,False,1,2,2020-10-20T11:00:28.597,22,,
2020,6,2872,155,16,374,2,4,9,6,11,5,9,2,9,6,True,False,False,0,3,2020-10-26T21:18:36.85,11,,
2020,6,2872,185,4,2853,2,4,3,6,6,0,6,0,6,0,False,False,False,0,2,2020-10-20T11:07:49.56,6,,
2020,6,2872,215,4,2853,3,8,1,41,0,0,0,0,0,0,False,False,False,0,3,2020-10-20T11:15:06.157,0,,
2020,6,2872,240,4,2853,13,9,2,27,0,0,0,0,0,0,False,False,False,0,2,2020-10-20T14:09:43.26,0,,
2020,6,2872,245,4,2853,2,12,5,4,4,0,4,0,4,6,False,False,False,0,2,2020-10-22T19:38:53.227,4,,
2020,6,2872,265,16,4143,2,4,5,5,5,0,5,0,5,0,False,False,False,0,3,2021-02-16T21:17:50.807,5,,
2020,6,2872,270,16,6499,2,48,10,-5,15,20,13,2,13,0,True,False,False,0,1,2020-10-26T21:18:53.94,15,,
2020,6,2872,305,16,3938,2,42,9,2,4,2,4,0,4,0,False,False,False,0,3,2021-02-16T21:18:29.03,4,,
2020,6,2872,315,16,374,2,7,3,12,12,0,12,0,12,6,False,False,False,0,3,2020-10-20T11:38:19.943,12,,
2020,6,2872,335,4,2853,2,50,3,-1,2,3,0,2,0,0,False,False,False,0,3,2020-10-20T11:41:06.3,2,,
2020,6,2872,355,4,2853,13,6,1,17,0,0,0,0,0,0,False,False,False,0,2,2020-10-20T14:10:55.59,0,,
2020,6,2872,375,4,1412,13,29,6,15,0,0,0,0,0,0,False,False,False,0,2,2020-10-20T11:54:14.887,0,,
2020,6,2872,400,16,7176,3,39,4,8,0,0,0,0,0,0,False,False,False,0,3,2020-10-20T11:57:24.97,0,,
2020,6,2872,405,16,4143,2,4,6,15,15,0,15,0,15,0,False,False,False,0,2,2020-10-20T14:20:56.087,15,,
2020,6,2872,415,16,374,2,32,5,7,16,9,15,1,15,0,False,True,True,0,3,2020-10-20T12:00:46.857,16,,
2020,6,2872,420,4,2853,2,9,5,8,15,7,15,0,15,0,False,False,False,0,2,2021-02-25T14:21:13.143,15,,
2020,6,2872,460,16,4788,3,4,9,4,0,0,0,0,0,0,False,False,False,0,4,2020-10-22T19:53:11.867,0,,
2020,6,2872,470,16,4143,13,12,5,14,0,0,0,0,0,0,False,False,False,0,2,2020-10-20T14:22:23.98,0,,
2020,6,2872,480,4,6983,2,48,10,-1,13,14,8,5,8,0,False,False,False,0,1,2020-10-20T12:19:23.447,13,,
2020,6,2872,490,4,594,2,5,9,4,4,0,4,0,4,0,False,False,False,0,3,2020-10-20T12:21:18.723,4,,
2020,6,2872,495,4,594,13,13,10,3,0,0,0,0,0,0,False,False,False,0,3,2021-01-29T15:55:53.447,0,,
2020,6,2872,505,16,3938,2,4,3,4,8,4,7,1,7,0,False,False,False,0,2,2020-10-20T12:24:29.107,8,,
2020,6,2872,520,16,6500,2,4,5,6,9,3,8,1,8,0,False,False,False,0,2,2020-10-22T19:38:40.173,9,,
2020,6,2872,550,16,374,2,4,10,4,6,2,6,0,6,0,False,False,False,0,4,2020-10-20T12:41:03.513,6,,
2020,6,2872,555,16,7681,2,48,10,-4,-3,1,-3,0,-3,0,False,False,False,0,1,2020-10-20T12:42:06.097,-3,,
2020,6,2872,595,4,2629,2,32,5,3,7,4,6,1,6,0,False,False,False,0,4,2020-10-20T12:48:02.513,7,,
2020,6,2872,625,16,4143,2,2,4,11,21,10,21,0,21,0,False,False,False,1,2,2020-10-22T19:39:59.94,21,,
2020,6,2872,635,16,7681,2,47,5,-2,-2,0,-2,0,-2,0,True,False,False,0,1,2021-02-16T21:19:15.867,-2,,
2020,6,2872,675,4,7646,2,47,5,4,7,3,5,2,5,0,False,False,False,0,3,2020-10-22T19:53:20.693,7,,
2020,6,2872,680,4,1412,13,4,3,9,0,0,0,0,0,0,False,False,False,0,2,2020-10-20T14:13:01.267,0,,
2020,6,2872,685,4,2853,2,6,9,4,5,1,5,0,5,0,False,False,False,0,2,2020-10-20T13:12:42.463,5,,
2020,6,2872,695,4,2853,2,4,9,13,14,1,13,1,13,0,False,False,False,0,2,2020-10-20T13:15:17.807,14,,
2020,6,2872,700,4,594,2,4,10,13,22,9,19,3,19,0,False,False,False,0,3,2020-10-20T13:16:45.23,22,,
2020,6,2872,705,4,594,2,2,4,5,8,3,7,1,7,6,False,False,False,0,3,2020-10-20T13:19:24.203,8,,
2020,6,2872,725,16,374,2,6,8,18,20,2,20,0,20,0,False,False,False,0,3,2020-10-20T13:22:36.19,20,,
2020,6,2872,735,16,7182,2,53,10,-5,2,7,1,1,1,0,False,False,False,0,4,2020-10-20T13:29:13.5,2,,
2020,6,2872,740,16,6500,2,12,2,25,37,12,35,2,35,0,False,False,False,0,3,2020-10-20T13:30:28.367,37,,
2020,6,2872,780,16,7681,2,48,10,-4,8,12,2,6,2,0,False,False,False,0,1,2020-10-26T21:18:15.77,8,,
2020,6,2872,815,4,594,13,35,6,19,0,0,0,0,0,0,False,False,False,0,3,2021-03-05T18:29:22.137,0,,
2020,6,2873,20,5,3477,13,4,7,15,0,0,0,0,0,0,False,False,False,0,3,2021-03-09T19:41:37.13,0,,
2020,6,2873,25,6,666,2,30,9,-2,1,3,0,1,0,0,False,False,False,0,4,2020-10-19T17:02:09.183,1,,
2020,6,2873,50,6,7728,2,17,10,9,9,0,9,0,9,6,False,False,False,0,4,2020-10-22T16:59:44.613,9,,
2020,6,2873,70,5,5220,2,2,9,4,22,18,12,10,12,0,False,False,False,1,2,2021-03-02T20:47:19.673,22,,
2020,6,2873,80,5,3750,13,5,5,6,0,0,0,0,0,0,False,False,False,0,4,2020-10-20T20:04:48.843,0,,
2020,6,2873,85,5,5220,2,6,10,11,12,1,11,1,11,0,False,False,False,0,3,2020-10-22T14:49:44.893,12,,
2020,6,2873,95,5,6562,13,35,6,28,0,0,0,0,0,0,False,False,False,0,3,2020-10-22T17:01:07.697,0,,
2020,6,2873,125,5,4719,3,30,3,1,0,0,0,0,0,0,False,False,False,0,1,2020-10-19T10:47:17.06,0,,
2020,6,2873,155,6,464,2,7,6,15,17,2,17,0,17,0,False,False,False,0,3,2020-10-19T11:01:12.457,17,,
2020,6,2873,170,6,7725,2,4,10,11,11,0,11,0,11,0,False,False,False,0,2,2020-10-19T16:52:25.243,11,,
2020,6,2873,175,6,6328,2,13,10,3,2,-1,3,-1,3,0,False,False,False,0,3,2020-10-19T11:07:28.603,2,,
2020,6,2873,190,5,3477,2,5,5,5,5,0,5,0,5,0,False,False,False,0,3,2020-10-19T11:10:44.21,5,,
2020,6,2873,215,6,7725,2,5,3,6,7,1,7,0,7,0,False,False,False,0,2,2021-02-17T15:26:31.553,7,,
2020,6,2873,220,6,6328,2,49,5,-3,4,7,3,1,3,0,True,False,False,0,2,2020-10-20T12:11:39.033,4,,
2020,6,2873,225,6,6328,2,51,3,-4,2,6,-2,4,-2,0,True,False,False,0,2,2020-10-19T11:26:15.817,2,,
2020,6,2873,230,6,666,2,5,10,6,8,2,6,2,6,0,False,False,False,0,3,2020-10-22T14:49:44.893,8,,
2020,6,2873,235,6,6786,2,46,3,1,12,11,2,10,2,0,False,False,False,1,1,2020-10-19T11:33:12.837,12,,
2020,6,2873,240,6,7728,2,32,5,5,11,6,8,3,8,0,True,False,False,0,4,2020-10-20T12:11:53.007,11,,
2020,6,2873,255,6,464,13,2,9,11,0,0,0,0,0,0,False,False,False,0,2,2020-10-19T11:43:30.983,0,,
2020,6,2873,270,5,5220,2,4,10,5,5,0,5,0,5,0,False,False,False,0,3,2020-10-22T17:10:36.017,5,,
2020,6,2873,285,5,5220,2,13,10,3,16,13,15,1,15,0,False,False,False,0,2,2020-10-22T17:11:55.447,16,,
2020,6,2873,305,5,6562,13,35,5,12,0,0,0,0,0,0,False,False,False,0,3,2020-10-22T17:12:38.51,0,,
2020,6,2873,350,5,5220,3,35,5,2,0,0,0,0,0,0,False,False,False,0,3,2020-10-19T12:11:17.49,0,,
2020,6,2873,370,6,6786,2,16,9,2,7,5,6,1,6,0,False,False,False,0,1,2020-10-19T12:15:35.203,7,,
2020,6,2873,375,6,666,2,4,10,6,10,4,10,0,10,0,False,False,False,0,3,2020-10-22T15:50:23.73,10,,
2020,6,2873,380,6,7725,3,4,3,12,0,0,0,0,0,0,False,False,False,0,2,2020-10-19T12:20:40.623,0,,
2020,6,2873,385,6,6786,2,16,10,3,13,10,9,4,9,0,False,False,False,0,1,2021-02-24T20:04:29.963,13,,
2020,6,2873,395,6,666,2,32,5,0,6,6,5,1,5,0,False,False,False,0,4,2021-02-17T15:27:20.643,6,,
2020,6,2873,400,6,7725,13,29,6,26,0,0,0,0,0,0,False,False,False,0,2,2020-10-22T15:51:48.87,0,,
2020,6,2873,405,6,666,13,5,3,5,0,0,0,0,0,0,False,False,False,0,3,2020-10-22T15:52:17.317,0,,
2020,6,2873,435,6,2071,3,5,5,11,0,0,0,0,0,0,False,False,False,0,4,2020-10-19T12:58:31.567,0,,
2020,6,2873,450,6,6331,13,21,2,20,0,0,0,0,0,0,False,False,False,0,3,2020-10-19T16:39:56.68,0,,
2020,6,2873,460,6,2071,13,53,9,-3,0,0,0,0,0,0,False,False,False,0,4,2020-10-19T16:52:59.907,0,,
2020,6,2873,465,6,666,13,5,10,3,0,0,0,0,0,0,False,False,False,0,3,2020-10-19T13:12:15.347,0,,
2020,6,2873,480,5,2554,2,47,5,-2,1,3,0,1,0,0,False,False,False,0,1,2020-10-19T16:31:46.557,1,,
2020,6,2873,485,5,3477,2,29,6,15,20,5,15,5,15,0,False,False,False,0,3,2020-10-19T13:19:52.62,20,,
2020,6,2873,495,6,2071,13,5,5,13,0,0,0,0,0,0,False,False,False,0,4,2021-03-05T18:32:50.49,0,,
2020,6,2873,500,5,3477,13,4,10,8,0,0,0,0,0,0,False,False,False,0,3,2021-03-05T18:33:20.317,0,,
2020,6,2873,510,5,3477,2,9,6,33,39,6,39,0,39,0,False,False,False,0,2,2020-10-22T15:52:57.713,39,,
2020,6,2873,525,5,3750,2,5,5,5,6,1,6,0,6,0,False,False,False,0,4,2020-10-22T17:19:23.473,6,,
2020,6,2873,530,5,6562,2,13,3,5,13,8,11,2,11,0,False,False,False,1,3,2020-10-22T14:49:44.893,13,,
2020,6,2873,545,6,464,2,18,5,-1,6,7,3,3,3,0,False,False,False,0,2,2020-10-19T13:49:18.817,6,,
2020,6,2873,550,6,811,2,2,5,6,8,2,6,2,6,0,False,False,False,0,2,2020-10-22T15:53:34.327,8,,
2020,6,2873,560,6,666,2,5,9,5,8,3,6,2,6,0,False,False,False,1,3,2020-10-22T14:49:44.893,8,,
2020,6,2873,565,6,7725,2,7,6,16,18,2,18,0,18,0,False,False,False,0,3,2020-10-19T16:53:29.393,18,,
2020,6,2873,600,5,5220,3,35,2,15,0,0,0,0,0,0,False,False,False,0,3,2020-10-22T17:20:05.527,0,,
2020,6,2873,605,5,2554,3,48,9,-4,0,0,0,0,0,0,False,False,False,0,1,2020-10-19T14:14:48.467,0,,
2020,6,2873,610,5,6425,2,38,5,4,9,5,9,0,9,0,True,False,False,0,3,2020-10-22T17:20:40.287,9,,
2020,6,2873,625,5,6265,2,51,9,-5,-2,3,-4,2,-4,0,True,False,False,0,1,2020-10-19T16:56:56.04,-2,,
2020,6,2873,660,5,5220,13,9,6,33,0,0,0,0,0,0,False,False,False,0,2,2020-10-19T16:42:22.103,0,,
2020,6,2873,680,6,464,2,4,9,6,6,0,6,0,6,0,False,False,False,0,3,2020-10-19T14:45:22.057,6,,
2020,6,2873,685,6,666,2,4,10,5,7,2,6,1,6,0,False,False,False,0,3,2020-10-19T14:48:16.223,7,,
2020,6,2873,695,6,666,13,47,10,1,0,0,0,0,0,0,False,False,False,0,3,2020-10-19T14:55:54.76,0,,
2020,6,2873,700,6,464,2,5,5,1,1,0,1,0,1,0,True,False,False,0,3,2020-10-22T17:23:17.86,1,,
2020,6,2873,705,6,464,2,6,8,17,23,6,22,1,22,0,False,False,False,0,2,2020-10-20T12:13:37.617,23,,
2020,6,2873,720,6,6786,13,46,3,4,0,0,0,0,0,0,False,False,False,0,1,2020-10-22T14:49:44.893,0,,
2020,6,2873,735,5,5220,2,19,6,34,38,4,35,3,35,0,False,False,False,0,2,2020-10-19T15:24:32.333,38,,
2020,6,2873,740,5,5220,13,13,10,3,0,0,0,0,0,0,False,False,False,0,3,2021-04-01T19:10:42.82,0,,
2020,6,2873,745,5,5220,13,6,9,2,0,0,0,0,0,0,True,False,False,0,2,2020-10-20T20:04:14.193,0,,
2020,6,2873,775,6,464,13,2,9,7,0,0,0,0,0,0,False,False,False,0,2,2020-10-22T15:57:23.763,0,,
2020,6,2873,780,6,6786,2,48,10,-5,7,12,7,0,7,0,False,False,False,0,1,2020-10-19T15:45:25.177,7,,
2020,6,2873,790,6,464,13,2,9,2,0,0,0,0,0,0,False,False,False,0,2,2020-10-19T15:53:26.53,0,,
2020,6,2873,800,5,2554,2,47,10,0,2,2,0,2,0,0,False,False,False,0,1,2020-10-19T15:56:12.723,2,,
2020,6,2873,805,5,3477,2,4,9,5,13,8,8,5,8,0,False,False,False,0,3,2020-10-22T16:10:56.273,13,,
2020,6,2873,815,5,6265,2,5,3,6,19,13,19,0,19,0,False,False,False,0,1,2020-10-19T16:03:50.43,19,,
2020,6,2873,825,5,6265,2,48,9,-4,-4,0,-4,0,-4,0,False,False,False,0,1,2020-10-19T16:06:56.617,-4,,
2020,6,2873,840,5,5220,3,7,6,20,0,0,0,0,0,0,False,False,False,0,3,2020-10-19T16:13:13.38,0,,
2020,6,2873,865,6,464,13,13,10,2,0,0,0,0,0,0,False,False,False,0,3,2020-10-19T16:20:08.903,0,,
2020,6,2873,875,5,5220,13,8,7,15,0,0,0,0,0,0,False,False,False,0,3,2021-03-09T19:42:45.273,0,,
2020,6,2874,10,14,7582,2,48,9,-6,22,28,10,12,10,0,False,False,False,1,1,2021-02-16T22:00:28.887,22,,
2020,6,2874,15,14,1119,2,53,4,-3,-2,1,-2,0,-2,0,False,True,True,0,4,2020-10-19T10:38:20.76,-2,,
2020,6,2874,35,7,3521,2,2,10,7,22,15,19,3,19,0,False,False,False,0,3,2020-10-19T16:06:29.673,22,,
2020,6,2874,45,7,7659,13,12,3,2,0,0,0,0,0,0,True,False,False,0,3,2020-10-19T11:07:13.587,0,,
2020,6,2874,70,14,7582,2,46,3,0,7,7,6,1,6,0,False,False,False,0,1,2020-10-19T10:58:38.91,7,,
2020,6,2874,85,7,7659,2,30,3,2,12,10,12,0,12,0,False,False,False,0,3,2020-10-19T11:03:33.683,12,,
2020,6,2874,95,7,910,2,12,10,12,12,0,12,0,12,0,False,False,False,0,2,2021-03-08T19:20:35.267,12,,
2020,6,2874,105,7,910,2,2,9,7,17,10,10,7,10,0,False,False,False,1,2,2021-02-16T21:59:06.913,17,,
2020,6,2874,110,7,3521,13,9,6,20,0,0,0,0,0,0,True,False,False,0,3,2020-10-19T11:11:42.957,0,,
2020,6,2874,120,7,3521,2,17,1,17,23,6,21,2,21,0,False,False,False,0,3,2020-10-19T16:06:46.577,23,,
2020,6,2874,135,7,4679,13,12,5,2,0,0,0,0,0,0,False,False,False,0,1,2020-10-19T11:21:45.65,0,,
2020,6,2874,160,14,4449,2,13,9,4,5,1,5,0,5,0,False,False,False,0,3,2020-10-19T11:28:40.433,5,,
2020,6,2874,165,14,1114,13,2,10,3,0,0,0,0,0,0,False,False,False,0,2,2020-10-19T11:30:55.033,0,,
2020,6,2874,185,7,3445,3,6,9,7,0,0,0,0,0,0,False,False,False,0,2,2020-10-19T11:36:09.657,0,,
2020,6,2874,190,7,7659,2,9,2,28,67,39,59,8,59,0,False,False,False,0,2,2020-10-22T17:09:59.81,67,,
2020,6,2874,220,14,1114,13,7,6,17,0,0,0,0,0,0,False,False,False,0,3,2020-10-22T14:55:38.683,0,,
2020,6,2874,225,14,1119,2,8,9,13,17,4,15,2,15,0,False,False,False,0,4,2020-10-22T14:55:38.683,17,,
2020,6,2874,235,14,895,2,5,5,12,15,3,14,1,14,0,False,False,False,0,4,2020-10-19T11:53:17.163,15,,
2020,6,2874,240,14,4070,2,7,2,41,55,14,48,7,48,0,False,False,False,0,3,2020-10-19T11:55:47.1,55,,
2020,6,2874,245,14,4449,13,17,10,1,0,0,0,0,0,0,False,False,False,0,3,2020-10-19T11:57:09.78,0,,
2020,6,2874,265,7,3445,13,13,5,8,0,0,0,0,0,0,False,False,False,0,2,2021-02-25T14:26:17.993,0,,
2020,6,2874,285,7,931,2,12,5,4,4,0,4,0,4,0,False,False,False,0,1,2021-03-08T19:21:29.21,4,,
2020,6,2874,300,7,3521,2,4,9,6,6,0,6,0,6,0,False,False,False,0,3,2020-10-19T16:07:07.213,6,,
2020,6,2874,315,14,1114,3,50,9,0,0,0,0,0,0,0,False,False,False,0,2,2020-10-19T12:17:57.123,0,,
2020,6,2874,320,14,1114,13,4,3,7,0,0,0,0,0,0,False,False,False,0,2,2020-10-22T14:55:38.683,0,,
2020,6,2874,325,14,4449,2,6,7,18,22,4,20,2,20,0,False,False,False,0,3,2020-10-19T16:43:03.317,22,,
2020,6,2874,330,14,8165,2,50,10,-4,13,17,2,11,2,0,False,False,False,0,3,2021-03-04T15:47:31.91,13,,
2020,6,2874,345,14,4070,3,13,9,6,0,0,0,0,0,0,False,False,False,0,3,2020-10-19T12:26:50.89,0,,
2020,6,2874,350,14,7582,2,11,3,2,21,19,16,5,16,0,False,False,False,0,1,2020-10-22T14:55:38.683,21,,
2020,6,2874,355,14,1114,2,33,10,5,5,0,5,0,5,6,False,False,False,0,2,2020-10-19T12:31:11.257,5,,
2020,6,2874,360,14,895,2,5,3,10,10,0,10,0,10,6,False,False,False,0,4,2020-10-19T12:32:56.057,10,,
2020,6,2874,380,7,3521,2,35,10,8,5,-3,5,0,5,0,False,True,False,0,3,2020-10-19T16:25:33.967,1,,
2020,6,2874,385,7,4341,13,4,4,11,0,0,0,0,0,0,False,False,False,0,3,2020-10-19T12:44:41.07,0,,
2020,6,2874,395,14,6543,2,46,3,0,7,7,5,2,5,0,False,False,False,0,1,2020-10-19T12:46:33.543,7,,
2020,6,2874,400,14,1114,2,13,4,2,20,18,20,0,20,0,False,False,False,1,2,2020-10-19T16:42:01.23,20,,
2020,6,2874,405,14,6543,2,32,9,-4,6,10,5,1,5,0,False,False,False,0,1,2020-10-19T12:51:02.997,6,,
2020,6,2874,415,14,4070,2,4,10,14,20,6,20,0,20,0,False,False,False,0,2,2020-10-19T12:53:10.197,20,,
2020,6,2874,420,14,6543,2,4,4,3,11,8,9,2,9,0,False,False,False,0,1,2020-10-19T12:54:23.55,11,,
2020,6,2874,425,14,6543,2,5,3,1,1,0,1,0,1,0,False,False,False,0,1,2020-10-19T12:55:52.92,1,,
2020,6,2874,430,14,4070,2,7,6,20,20,0,20,0,20,0,False,False,False,0,2,2020-10-19T12:57:18.55,20,,
2020,6,2874,435,14,4449,13,5,2,15,0,0,0,0,0,0,False,False,False,0,3,2020-10-19T12:59:29.143,0,,
2020,6,2874,450,14,4449,2,7,8,17,17,0,17,0,17,6,False,False,False,0,3,2020-10-19T13:04:05.03,17,,
2020,6,2874,480,7,7659,2,4,9,5,5,0,5,0,5,0,False,False,False,0,3,2020-10-19T13:31:38.763,5,,
2020,6,2874,490,7,910,13,2,9,10,0,0,0,0,0,0,False,False,False,0,3,2020-10-19T13:34:14.45,0,,
2020,6,2874,500,14,4070,2,6,9,4,5,1,5,0,5,0,False,False,False,0,2,2020-10-19T13:36:13.97,5,,
2020,6,2874,510,14,7582,2,4,9,-1,5,6,4,1,4,0,False,False,False,0,1,2020-10-19T13:41:28.527,5,,
2020,6,2874,520,14,4070,2,4,9,8,8,0,8,0,8,0,False,False,False,0,3,2020-10-19T13:43:00.91,8,,
2020,6,2874,525,14,6546,13,4,4,4,0,0,0,0,0,0,False,False,False,0,1,2020-10-19T13:44:40.863,0,,
2020,6,2874,535,14,4449,2,4,9,8,8,0,8,0,8,0,False,False,False,0,3,2020-10-19T13:47:36.95,8,,
2020,6,2874,540,14,4449,2,12,3,3,10,7,10,0,10,0,False,False,False,0,3,2021-03-08T19:25:46.133,10,,
2020,6,2874,560,7,3521,13,2,10,8,0,0,0,0,0,0,False,False,False,0,3,2020-10-19T13:56:02,0,,
2020,6,2874,565,7,910,2,8,1,16,19,3,19,0,19,0,False,False,False,0,2,2020-10-22T14:55:38.683,19,,
2020,6,2874,580,7,7659,2,8,4,13,13,0,13,0,13,0,False,False,False,0,3,2020-10-22T14:55:38.683,13,,
2020,6,2874,590,7,7659,13,4,10,13,0,0,0,0,0,0,False,False,False,0,3,2020-10-22T15:59:56.043,0,,
2020,6,2874,600,7,910,2,2,9,6,9,3,7,2,7,0,False,False,False,0,2,2020-10-19T14:13:35.49,9,,
2020,6,2874,610,7,910,13,19,2,37,0,0,0,0,0,0,False,False,False,0,2,2020-10-22T15:57:34.257,0,,
2020,6,2874,615,7,931,2,31,10,-5,7,12,6,1,6,0,False,False,False,0,1,2020-10-19T14:19:59.073,7,,
2020,6,2874,630,14,895,2,6,9,9,13,4,12,1,12,0,False,False,False,0,4,2020-10-22T14:55:38.683,13,,
2020,6,2874,650,14,8165,2,5,9,4,10,6,9,1,9,0,False,False,False,0,3,2020-10-19T14:34:57.663,10,,
2020,6,2874,670,14,1119,2,7,5,14,14,0,14,0,14,6,False,False,False,0,4,2020-10-19T14:41:42.813,14,,
2020,6,2874,690,7,4679,2,45,10,-6,7,13,7,0,7,0,False,False,False,0,1,2020-10-19T14:46:52.74,7,,
2020,6,2874,710,14,4070,13,6,9,2,0,0,0,0,0,0,False,False,False,0,2,2021-02-25T14:28:59.83,0,,
2020,6,2874,715,14,4449,13,35,7,31,0,0,0,0,0,0,False,False,False,0,3,2020-10-19T14:54:25.163,0,,
2020,6,2874,720,7,910,13,8,7,16,0,0,0,0,0,0,False,False,False,0,2,2020-10-19T14:59:30.483,0,,
2020,6,2874,725,7,4679,2,4,10,3,8,5,7,1,7,0,False,False,False,0,1,2020-10-22T17:17:29.773,8,,
2020,6,2874,730,7,3445,2,2,10,7,10,3,8,2,8,0,False,False,False,0,2,2020-10-19T15:05:37.57,10,,
2020,6,2874,735,7,7659,2,33,5,14,20,6,18,2,18,0,False,False,False,0,3,2020-10-19T15:08:26.857,20,,
2020,6,2874,745,7,4716,3,47,5,1,0,0,0,0,0,0,True,False,False,0,4,2020-10-19T15:10:56.467,0,,
2020,6,2874,750,7,910,2,5,5,11,11,0,11,0,11,0,False,False,False,0,3,2020-10-19T15:18:54.81,11,,
2020,6,2874,755,7,910,2,4,10,5,7,2,6,1,6,0,False,False,False,0,3,2020-10-19T15:21:15.02,7,,
2020,6,2874,775,14,4070,13,8,7,47,0,0,0,0,0,0,False,False,False,0,3,2020-10-19T16:43:19.51,0,,
2020,6,2874,780,14,6543,2,47,5,0,2,2,2,0,2,0,False,False,False,0,1,2020-10-19T15:27:28.193,2,,
2020,6,2874,785,14,1114,2,32,9,0,11,11,11,0,11,0,False,False,False,0,3,2020-10-19T15:29:04.273,11,,
2020,6,2874,795,14,6543,13,13,10,2,0,0,0,0,0,0,True,False,False,0,3,2020-10-19T15:31:45.537,0,,
2020,6,2874,800,14,895,2,5,5,4,20,16,20,0,20,0,True,False,False,0,2,2020-10-19T15:33:07.067,20,,
2020,6,2874,810,14,8165,2,47,5,4,6,2,6,0,6,0,False,False,False,0,3,2020-10-22T17:20:02.42,6,,
2020,6,2874,815,14,895,13,6,10,4,0,0,0,0,0,0,True,False,False,0,2,2020-10-19T15:53:23.13,0,,
2020,6,2874,830,7,910,2,2,9,7,11,4,9,2,9,0,False,False,False,0,2,2020-10-19T15:45:04.813,11,,
2020,6,2874,835,7,7659,2,6,10,5,8,3,8,0,8,0,False,False,False,0,2,2020-10-19T15:46:14.133,8,,
2020,6,2874,855,7,6975,13,5,9,5,0,0,0,0,0,0,False,False,False,0,4,2020-10-19T15:50:55.963,0,,
2020,6,2874,870,7,910,2,4,10,10,10,0,10,0,10,0,False,False,False,0,2,2020-10-19T15:55:07.347,10,,
2020,6,2874,875,7,931,2,4,4,2,2,0,2,0,2,0,False,False,False,0,1,2020-10-19T15:56:17.52,2,,
2020,6,2874,880,7,3521,2,32,9,-2,2,4,2,0,2,0,False,False,False,0,3,2020-10-19T16:08:14.473,2,,
2020,6,2874,885,7,3521,13,17,1,16,0,0,0,0,0,0,False,False,False,0,3,2020-10-19T16:02:41.663,0,,
2020,6,2875,20,15,1561,2,4,10,2,5,3,4,1,4,0,False,False,False,0,1,2020-10-22T19:52:33.557,5,,
2020,6,2875,35,11,914,13,6,7,17,0,0,0,0,0,0,True,False,False,0,2,2021-02-16T22:09:54.053,0,,
2020,6,2875,50,11,4492,3,13,10,5,0,0,0,0,0,0,False,False,False,0,2,2020-10-21T00:24:03.3,0,,
2020,6,2875,70,11,2714,2,5,10,1,3,2,3,0,3,0,False,False,False,0,3,2020-10-21T00:24:16.717,3,,
2020,6,2875,80,11,4492,13,8,4,9,0,0,0,0,0,0,False,False,False,0,3,2020-10-21T00:24:33.317,0,,
2020,6,2875,105,15,4997,2,24,2,31,35,4,35,0,35,0,False,False,False,0,3,2020-10-19T10:44:34.743,35,,
2020,6,2875,120,15,7591,2,44,3,-5,3,8,-2,5,-2,0,False,False,False,2,1,2020-10-22T18:55:33.603,3,,
2020,6,2875,125,15,4997,2,5,3,9,9,0,9,0,9,0,True,False,False,0,3,2020-10-22T18:47:36.597,9,,
2020,6,2875,140,15,4997,13,35,7,15,0,0,0,0,0,0,False,False,False,0,3,2020-10-22T20:41:30.013,0,,
2020,6,2875,150,15,1561,2,12,10,-6,2,8,2,0,2,0,False,False,False,0,1,2020-10-22T20:06:32.077,2,,
2020,6,2875,175,11,6810,2,6,10,12,16,4,14,2,14,0,False,False,False,0,4,2020-10-19T11:20:56.75,16,,
2020,6,2875,210,15,6501,13,19,6,39,0,0,0,0,0,0,False,False,False,0,2,2021-03-05T18:36:52.953,0,,
2020,6,2875,220,11,2714,13,17,10,6,0,0,0,0,0,0,False,False,False,0,4,2020-10-22T21:10:00.59,0,,
2020,6,2875,225,11,4492,13,8,8,33,0,0,0,0,0,0,False,False,False,0,3,2020-10-21T00:31:41.277,0,,
2020,6,2875,230,11,6810,3,24,6,20,0,0,0,0,0,0,False,False,False,0,4,2021-02-16T22:12:56.567,0,,
2020,6,2875,240,11,3820,13,17,1,38,0,0,0,0,0,0,False,False,False,0,3,2020-10-21T00:27:25.613,0,,
2020,6,2875,245,11,6341,2,48,10,-5,11,16,10,1,10,0,False,False,False,0,1,2020-10-19T12:19:06.783,11,,
2020,6,2875,260,15,7591,2,45,5,-3,3,6,2,1,2,0,True,False,False,0,3,2020-10-22T21:36:27.347,3,,
2020,6,2875,265,15,6501,2,46,9,2,2,0,2,0,2,0,False,False,False,0,3,2020-10-22T18:21:53.29,2,,
2020,6,2875,270,15,6501,2,4,3,6,10,4,8,2,8,0,False,False,False,0,2,2020-10-21T00:28:02.483,10,,
2020,6,2875,280,15,7593,13,7,3,14,0,0,0,0,0,0,False,False,False,0,4,2020-10-22T20:46:45.477,0,,
2020,6,2875,285,15,6501,13,11,5,14,0,0,0,0,0,0,False,False,False,0,3,2020-10-19T17:59:24.047,0,,
2020,6,2875,300,11,792,2,11,3,9,18,9,16,2,16,0,False,False,False,0,1,2020-10-22T20:47:12.953,18,,
2020,6,2875,310,11,914,2,17,7,19,20,1,20,0,20,0,False,False,False,0,3,2020-10-21T00:28:35.803,20,,
2020,6,2875,320,11,4492,2,8,7,32,36,4,33,3,33,0,False,False,False,0,2,2020-10-21T00:28:54.23,36,,
2020,6,2875,325,11,7732,2,45,10,0,1,1,1,0,1,0,False,False,False,0,1,2021-02-25T14:32:06.18,1,,
2020,6,2875,340,11,914,2,30,10,-2,2,4,2,0,2,0,True,False,False,0,4,2020-10-19T13:12:53.983,2,,
2020,6,2875,350,11,6341,3,47,5,0,0,0,0,0,0,0,False,False,False,0,1,2021-02-16T22:18:22.13,0,,
2020,6,2875,365,15,6501,13,4,9,11,0,0,0,0,0,0,False,False,False,0,3,2020-10-21T00:29:23.957,0,,
2020,6,2875,375,15,6501,2,13,10,2,3,1,3,0,3,0,False,False,False,2,3,2020-10-22T19:05:07.683,3,,
2020,6,2875,380,15,6501,2,4,3,6,7,1,6,1,6,0,False,False,False,0,2,2020-10-22T20:50:30.323,7,,
2020,6,2875,385,15,7591,2,6,10,4,4,0,4,0,4,0,False,False,False,0,2,2020-10-22T18:23:15.96,4,,
2020,6,2875,395,15,4997,13,13,10,6,0,0,0,0,0,0,False,False,False,0,3,2020-10-22T20:13:51.953,0,,
2020,6,2875,400,15,4997,2,35,2,15,16,1,15,1,15,0,False,False,False,0,3,2020-10-22T20:51:13.253,16,,
2020,6,2875,410,15,7591,3,13,10,4,0,0,0,0,0,0,False,False,False,0,3,2020-10-22T18:49:58.753,0,,
2020,6,2875,420,11,7732,2,28,9,2,3,1,3,0,3,0,False,False,False,0,1,2020-10-22T20:51:41.853,3,,
2020,6,2875,435,11,7732,13,19,5,10,0,0,0,0,0,0,False,False,False,0,2,2020-10-22T20:52:08.743,0,,
2020,6,2875,440,11,914,13,9,2,26,0,0,0,0,0,0,False,False,False,0,2,2020-10-19T13:53:40.257,0,,
2020,6,2875,475,11,914,13,35,9,-3,0,0,0,0,0,0,False,False,False,0,3,2021-03-05T18:37:24.303,0,,
2020,6,2875,485,15,6501,2,13,9,-1,0,1,0,0,0,0,False,False,False,0,3,2020-10-22T20:24:07.15,0,,
2020,6,2875,490,15,1561,2,47,10,-1,8,9,2,6,2,0,False,False,False,0,1,2020-10-22T20:24:23.83,8,,
2020,6,2875,495,15,6501,13,8,9,13,0,0,0,0,0,0,False,False,False,0,2,2020-10-19T18:00:31.27,0,,
2020,6,2875,500,11,914,2,5,3,5,6,1,6,0,6,0,True,False,False,0,3,2020-10-19T14:30:48.347,6,,
2020,6,2875,515,11,100,2,35,10,13,19,6,18,1,18,0,False,False,False,0,3,2020-10-19T14:37:34.713,19,,
2020,6,2875,520,11,4492,2,19,6,41,48,7,44,4,44,0,False,False,False,0,2,2020-10-19T14:40:16.323,48,,
2020,6,2875,525,11,4492,2,2,10,4,5,1,5,0,5,0,False,False,False,0,2,2020-10-19T14:42:57.563,5,,
2020,6,2875,530,11,6810,13,7,5,1,0,0,0,0,0,0,False,False,False,0,4,2020-10-22T20:24:54.13,0,,
2020,6,2875,535,11,6810,13,7,10,1,0,0,0,0,0,0,False,False,False,0,4,2020-10-22T20:25:58.82,0,,
2020,6,2875,540,11,6810,2,5,5,0,1,1,1,0,1,6,True,False,False,0,3,2020-10-22T18:41:42.087,1,,
2020,6,2875,560,15,6501,13,19,7,48,0,0,0,0,0,0,False,False,False,0,3,2020-10-22T20:26:31.83,0,,
2020,6,2875,565,15,8099,2,18,5,-2,3,5,2,1,2,0,True,False,False,0,2,2020-10-20T18:11:08.583,3,,
2020,6,2875,570,15,4997,2,12,2,36,51,15,37,14,37,0,False,False,False,1,3,2021-03-08T19:28:37.33,51,,
2020,6,2875,575,15,8099,2,44,9,-7,2,9,2,0,2,0,False,True,False,0,1,2020-10-19T15:14:44.393,2,,
2020,6,2875,585,15,4997,13,2,4,5,0,0,0,0,0,0,False,False,False,0,3,2020-10-22T20:53:10.037,0,,
2020,6,2875,595,15,2407,13,36,9,8,0,0,0,0,0,0,False,False,False,0,3,2020-10-19T18:01:48.34,0,,
2020,6,2875,620,11,3820,2,47,5,5,6,1,6,0,6,0,False,False,False,0,4,2020-10-21T00:30:40.15,6,,
2020,6,2875,635,11,4492,2,35,10,10,16,6,12,4,12,0,False,False,False,0,2,2020-10-21T00:30:52.893,16,,
2020,6,2875,640,11,4487,2,49,9,-2,11,13,5,6,5,0,True,False,False,1,3,2020-10-19T15:46:53.607,11,,
2020,6,2875,660,11,4492,13,4,5,6,0,0,0,0,0,0,False,False,False,0,2,2021-02-16T22:15:19.733,0,,
2020,6,2875,665,11,4487,2,34,4,-4,6,10,4,2,4,0,True,False,False,0,3,2020-10-21T00:26:46.037,6,,
2020,6,2875,685,15,7591,3,50,10,-4,0,0,0,0,0,0,True,False,False,0,2,2021-03-04T15:53:00.637,0,,
2020,6,2875,690,15,6813,2,12,10,-6,0,6,0,0,0,0,False,False,False,0,6,2020-10-19T18:02:29.963,0,,
2020,6,2875,695,15,4997,13,12,2,47,0,0,0,0,0,0,False,False,False,0,3,2020-10-19T18:12:52.73,0,,
2020,6,2875,720,11,100,2,51,3,-1,12,13,3,9,3,0,False,False,False,1,3,2020-10-19T16:22:03.767,12,,
2020,6,2875,740,11,4492,13,24,6,23,0,0,0,0,0,0,False,False,False,0,2,2020-10-22T18:28:11.357,0,,
2020,6,2875,755,15,6501,2,2,10,6,9,3,7,2,7,0,False,False,False,0,2,2020-10-19T16:31:30.373,9,,
2020,6,2875,760,15,8099,2,4,4,4,5,1,5,0,5,0,False,False,False,0,1,2020-10-22T18:29:27.713,5,,
2020,6,2875,765,15,4997,2,6,8,19,24,5,22,2,22,0,False,False,False,0,2,2020-10-19T16:37:27.44,24,,
2020,6,2875,770,15,4997,2,6,4,6,8,2,8,0,8,0,False,False,False,0,3,2020-10-22T21:15:50.61,8,,
2020,6,2875,775,15,7591,13,13,10,1,0,0,0,0,0,0,False,False,False,0,2,2020-10-22T20:29:21.007,0,,
2020,6,2875,780,15,2407,2,47,10,0,6,6,3,3,3,0,False,False,False,0,3,2020-10-19T16:45:27.173,6,,
2020,6,2875,785,15,6501,2,3,5,13,14,1,13,1,13,0,False,False,False,0,2,2020-10-22T20:29:39.507,14,,
2020,6,2875,790,15,6501,13,9,5,12,0,0,0,0,0,0,False,False,False,0,2,2020-10-20T18:10:49.627,0,,
2020,6,2875,795,15,8099,2,46,9,-2,14,16,14,0,14,6,False,False,False,0,1,2020-10-22T18:29:53.877,14,,
2020,6,2875,830,11,7732,2,11,3,2,3,1,3,0,3,0,False,False,False,0,1,2020-10-22T20:34:04.327,3,,
2020,6,2875,850,15,7591,13,13,4,2,0,0,0,0,0,0,False,False,False,0,3,2020-10-22T20:34:39.507,0,,
2020,6,2875,860,15,2757,13,4,10,7,0,0,0,0,0,0,False,False,False,0,3,2020-10-19T18:20:04.937,0,,
2020,6,2875,865,15,6501,13,7,6,26,0,0,0,0,0,0,False,False,False,0,2,2020-10-19T18:03:49.323,0,,
2020,6,2875,870,15,7593,3,4,10,13,0,0,0,0,0,0,False,False,False,0,3,2020-10-22T18:52:15.033,0,,
2020,6,2875,875,15,1561,13,12,3,11,0,0,0,0,0,0,False,False,False,0,1,2020-10-22T21:17:31.36,0,,
2020,6,2876,10,18,7711,13,35,8,22,0,0,0,0,0,0,False,False,False,0,3,2021-03-05T18:52:36.77,0,,
2020,6,2876,30,2,990,2,44,3,-4,3,7,3,0,3,0,False,False,False,0,1,2020-10-22T19:19:41.93,3,,
2020,6,2876,35,2,661,2,7,6,20,20,0,20,0,20,6,False,False,False,0,3,2020-10-19T10:24:07.083,20,,
2020,6,2876,50,18,7711,2,30,4,-4,-2,2,-2,0,-2,0,True,False,False,0,4,2020-10-22T19:18:07.787,-2,,
2020,6,2876,60,18,6706,2,26,5,1,4,3,2,2,2,0,True,False,False,0,2,2020-10-20T14:10:13.197,4,,
2020,6,2876,80,2,661,2,50,9,-1,23,24,21,2,21,0,False,False,False,0,2,2020-10-22T18:34:51.563,23,,
2020,6,2876,95,2,5214,2,47,5,4,8,4,7,1,7,0,False,False,False,0,4,2020-10-19T10:45:58.68,8,,
2020,6,2876,100,2,990,13,46,3,-4,0,0,0,0,0,0,False,False,False,0,1,2020-10-22T19:23:26.36,0,,
2020,6,2876,120,2,5223,2,5,3,5,5,0,5,0,5,0,True,False,False,0,3,2020-10-20T16:10:13.13,5,,
2020,6,2876,150,18,6900,2,4,4,1,4,3,4,0,4,0,False,False,False,0,1,2020-10-22T19:33:29.937,4,,
2020,6,2876,155,18,6706,3,12,10,4,0,0,0,0,0,0,False,False,False,0,3,2020-10-20T14:04:13.283,0,,
2020,6,2876,165,2,6247,2,5,2,17,17,0,17,0,17,0,False,False,False,0,3,2020-10-19T11:08:41.07,17,,
2020,6,2876,170,2,2835,2,46,3,3,3,0,3,0,3,0,False,False,False,0,1,2020-10-19T11:10:56.237,3,,
2020,6,2876,180,18,6907,2,7,2,20,36,16,36,0,36,0,True,False,False,0,3,2020-10-20T14:10:24.117,36,,
2020,6,2876,195,18,813,2,32,3,2,19,17,15,4,15,0,False,False,False,0,4,2020-10-22T18:36:37.997,19,,
2020,6,2876,200,18,7711,2,35,2,18,18,0,18,0,18,0,False,False,False,0,3,2020-10-19T11:25:13.047,18,,
2020,6,2876,215,18,6907,13,30,10,1,0,0,0,0,0,0,True,False,False,0,4,2020-10-22T18:27:59.383,0,,
2020,6,2876,240,2,990,2,4,10,-1,3,4,-1,4,-1,0,False,False,False,1,1,2020-10-22T17:29:59.743,3,,
2020,6,2876,245,2,5223,2,5,3,14,18,4,14,4,14,0,False,False,False,2,3,2020-10-19T11:45:17.623,18,,
2020,6,2876,285,18,7711,13,4,9,7,0,0,0,0,0,0,False,False,False,0,3,2021-03-05T18:53:05.403,0,,
2020,6,2876,295,2,5223,2,4,10,4,14,10,7,7,7,0,False,False,False,1,3,2020-10-22T18:42:02.58,14,,
2020,6,2876,305,2,5223,2,2,10,9,9,0,9,0,9,0,False,False,False,1,2,2021-02-16T22:49:19.077,9,,
2020,6,2876,315,2,661,2,13,4,3,4,1,4,0,4,0,False,False,False,0,2,2020-10-19T17:02:43.827,4,,
2020,6,2876,320,2,661,2,5,3,5,5,0,5,0,5,0,True,False,False,0,3,2020-10-22T20:58:44.683,5,,
2020,6,2876,330,2,5223,2,30,5,0,8,8,8,0,8,6,True,False,False,0,4,2020-10-19T12:12:18.37,8,,
2020,6,2876,345,18,1381,2,12,5,5,14,9,12,2,12,0,False,False,False,0,3,2020-10-20T14:04:27.51,14,,
2020,6,2876,350,18,813,2,47,5,5,9,4,9,0,9,0,False,False,False,0,4,2020-10-22T20:10:25.83,9,,
2020,6,2876,360,18,566,2,16,9,5,0,-5,0,0,0,0,False,False,False,0,1,2020-10-19T16:59:16.403,0,,
2020,6,2876,365,18,6706,13,8,4,6,0,0,0,0,0,0,False,False,False,0,3,2021-03-05T18:53:29.753,0,,
2020,6,2876,370,2,4670,2,46,3,3,3,0,3,0,3,0,False,False,False,0,1,2020-10-22T20:12:18.82,3,,
2020,6,2876,375,2,661,13,2,10,7,0,0,0,0,0,0,False,False,False,0,2,2021-02-16T22:48:37.69,0,,
2020,6,2876,380,2,6247,2,2,4,10,17,7,15,2,15,0,False,False,False,0,3,2020-10-22T20:13:00.753,17,,
2020,6,2876,385,2,6247,2,5,3,4,4,0,4,0,4,0,False,False,False,0,3,2020-10-22T20:13:35.52,4,,
2020,6,2876,390,2,4670,2,46,3,1,3,2,3,0,3,0,False,False,False,0,1,2020-10-22T20:14:51.873,3,,
2020,6,2876,400,2,6472,2,16,9,3,17,14,17,0,17,0,False,False,False,0,1,2020-10-19T12:47:30.073,17,,
2020,6,2876,405,2,661,13,5,3,4,0,0,0,0,0,0,False,False,False,0,2,2021-02-16T22:51:04.277,0,,
2020,6,2876,445,2,7303,13,6,9,12,0,0,0,0,0,0,False,False,False,0,2,2020-10-22T20:16:01.94,0,,
2020,6,2876,450,2,5223,2,5,3,7,7,0,7,0,7,0,False,False,False,0,3,2020-10-22T18:30:21.16,7,,
2020,6,2876,455,2,6247,2,9,2,27,27,0,27,0,27,0,False,False,False,0,3,2020-10-22T20:17:37.39,27,,
2020,6,2876,460,2,5223,13,3,3,14,0,0,0,0,0,0,False,False,False,0,2,2020-10-20T16:07:44.03,0,,
2020,6,2876,465,2,661,2,4,5,5,7,2,7,0,7,0,True,False,False,0,2,2021-03-04T14:39:59.963,7,,
2020,6,2876,470,2,5214,2,13,4,5,6,1,6,0,6,0,False,False,False,0,3,2020-10-22T17:29:59.743,6,,
2020,6,2876,475,2,6342,2,50,3,0,0,0,0,0,0,0,False,False,False,0,2,2020-10-22T20:20:17.287,0,,
2020,6,2876,490,2,6240,13,5,3,11,0,0,0,0,0,0,True,False,False,0,2,2020-10-20T16:12:17.45,0,,
2020,6,2876,505,18,7711,2,9,2,22,35,13,33,2,33,0,False,False,False,0,3,2020-10-22T17:29:59.743,35,,
2020,6,2876,510,18,813,2,26,10,5,9,4,8,1,8,0,False,False,False,0,4,2020-10-19T16:52:40.09,9,,
2020,6,2876,520,18,6900,2,4,4,3,4,1,4,0,4,0,False,False,False,0,1,2020-10-22T17:29:59.743,4,,
2020,6,2876,525,18,7711,2,7,2,19,19,0,19,0,19,0,False,False,False,0,3,2020-10-22T17:29:59.743,19,,
2020,6,2876,530,18,7711,2,5,5,8,8,0,8,0,8,0,False,False,False,0,3,2021-02-16T22:49:57.64,8,,
2020,6,2876,535,18,1381,13,22,6,22,0,0,0,0,0,0,False,False,False,0,3,2020-10-19T13:44:13.5,0,,
2020,6,2876,540,18,6358,2,48,9,-4,6,10,4,2,4,0,False,False,False,0,1,2020-10-22T20:59:04.243,6,,
2020,6,2876,545,18,6706,13,19,1,16,0,0,0,0,0,0,False,False,False,0,3,2020-10-22T20:23:38.927,0,,
2020,6,2876,550,18,6907,2,6,4,4,5,1,4,1,4,0,False,False,False,0,4,2020-10-19T17:03:07.95,5,,
2020,6,2876,555,18,7711,2,6,9,7,11,4,8,3,8,6,False,False,False,0,2,2020-10-22T17:29:59.743,11,,
2020,6,2876,585,2,661,2,5,5,5,7,2,7,0,7,0,False,False,False,0,3,2020-10-22T18:32:25.1,7,,
2020,6,2876,605,2,661,2,12,3,11,40,29,27,13,27,6,False,False,False,1,3,2021-03-02T21:11:10.5,40,,
2020,6,2876,625,18,6900,13,19,2,24,0,0,0,0,0,0,False,False,False,0,2,2020-10-19T14:13:04.393,0,,
2020,6,2876,630,18,7711,2,13,9,4,11,7,9,2,9,0,False,False,False,0,2,2020-10-19T14:14:40.793,11,,
2020,6,2876,655,2,990,2,47,10,2,14,12,7,7,7,0,False,False,False,1,1,2020-10-22T21:19:50.637,14,,
2020,6,2876,685,18,1381,13,5,3,10,0,0,0,0,0,0,False,False,False,0,3,2020-10-22T18:29:45.12,0,,
2020,6,2876,695,18,6706,13,39,4,5,0,0,0,0,0,0,False,False,False,0,3,2020-10-22T17:29:59.743,0,,
2020,6,2876,705,2,661,2,29,6,25,31,6,29,2,29,0,False,False,False,0,3,2020-10-22T17:29:59.743,31,,
2020,6,2876,715,2,5214,2,46,3,7,8,1,8,0,8,0,False,False,False,0,4,2020-10-19T15:09:28.26,8,,
2020,6,2876,725,2,7303,13,9,3,7,0,0,0,0,0,0,False,False,False,0,3,2021-02-25T14:37:21.42,0,,
2020,6,2876,730,2,6240,2,5,5,5,5,0,5,0,5,0,True,False,False,0,2,2020-10-22T20:30:34.28,5,,
2020,6,2876,750,18,7711,2,29,6,16,17,1,17,0,17,0,False,False,False,0,3,2020-10-19T15:18:48.883,17,,
2020,6,2876,755,18,6897,2,4,9,7,7,0,7,0,7,0,False,False,False,0,3,2020-10-19T17:12:16.747,7,,
2020,6,2876,760,18,566,2,44,3,-3,1,4,-1,2,-1,0,False,False,False,0,1,2020-10-22T20:31:01.683,1,,
2020,6,2876,765,18,6907,2,46,3,2,2,0,2,0,2,0,False,False,False,0,4,2020-10-22T17:29:59.743,2,,
2020,6,2876,770,18,1381,2,19,2,35,35,0,35,0,35,0,False,False,False,0,2,2020-10-20T14:08:31.3,35,,
2020,6,2876,775,18,6706,2,2,10,7,9,2,9,0,9,0,True,False,False,0,3,2020-10-19T15:29:37.707,9,,
2020,6,2876,780,18,813,13,39,10,6,0,0,0,0,0,0,False,False,False,0,4,2020-10-22T18:28:08.9,0,,
2020,6,2876,790,18,1381,2,13,4,2,2,0,2,0,2,6,False,False,False,0,3,2020-10-19T16:33:08.917,2,,
2020,6,2876,830,2,5214,2,13,3,4,35,31,35,0,35,6,False,False,False,0,4,2020-10-19T15:48:03.597,35,,
2020,6,2876,845,18,813,2,8,7,19,19,0,19,0,19,0,False,False,False,0,3,2021-02-25T14:39:02.213,19,,
2020,6,2876,855,18,6907,2,4,3,3,12,9,10,2,10,0,False,False,False,0,3,2020-10-22T20:33:51.077,12,,
2020,6,2876,860,18,7711,2,21,6,21,49,28,27,22,27,6,False,False,False,1,2,2021-03-02T21:14:13.083,49,,
2020,6,2877,10,32,7807,2,46,9,1,9,8,7,2,7,0,False,False,False,0,1,2020-10-19T08:50:11.733,9,,
2020,6,2877,20,32,3708,2,4,10,2,4,2,4,0,4,0,False,False,False,0,1,2020-10-19T08:56:34.227,4,,
2020,6,2877,40,32,7128,13,3,6,16,0,0,0,0,0,0,False,False,False,0,2,2020-10-19T09:04:40.13,0,,
2020,6,2877,55,32,7808,13,24,5,7,0,0,0,0,0,0,False,False,False,0,3,2020-10-22T15:02:56.977,0,,
2020,6,2877,65,32,3885,2,28,5,-4,3,7,2,1,2,0,False,False,False,0,1,2020-10-19T09:15:13.703,3,,
2020,6,2877,75,21,4422,2,7,2,19,21,2,21,0,21,0,False,False,False,0,4,2020-10-19T09:20:24.85,21,,
2020,6,2877,90,21,5015,2,46,3,3,8,5,7,1,7,0,True,False,False,0,3,2020-10-22T15:03:46.207,8,,
2020,6,2877,95,21,2288,2,44,3,-2,10,12,5,5,5,0,True,False,False,0,1,2020-10-19T09:28:58.737,10,,
2020,6,2877,130,32,7128,13,6,7,18,0,0,0,0,0,0,False,False,False,0,2,2021-03-05T18:55:27.96,0,,
2020,6,2877,140,21,5015,13,12,5,8,0,0,0,0,0,0,False,False,False,0,2,2021-03-08T19:31:51.39,0,,
2020,6,2877,145,21,7090,2,9,6,23,23,0,23,0,23,6,False,False,False,0,3,2020-10-19T09:55:00.213,23,,
2020,6,2877,160,32,1427,2,5,7,16,29,13,24,5,24,0,True,False,False,1,3,2020-10-22T14:05:09.407,29,,
2020,6,2877,165,32,7807,2,47,10,-1,10,11,7,3,7,0,False,False,False,0,1,2020-10-19T10:01:12.903,10,,
2020,6,2877,185,32,7128,2,26,10,4,8,4,6,2,6,0,True,False,False,0,3,2021-02-16T23:23:06.437,8,,
2020,6,2877,195,32,7128,2,4,3,7,11,4,8,3,8,0,False,False,False,0,2,2020-10-19T10:14:54.3,11,,
2020,6,2877,210,32,7128,2,50,9,-1,20,21,5,15,5,0,False,False,False,1,2,2021-02-16T23:23:58.763,20,,
2020,6,2877,235,21,7226,2,46,3,1,5,4,4,1,4,0,False,False,False,0,4,2020-10-19T10:28:21.567,5,,
2020,6,2877,240,21,4422,2,13,10,4,9,5,7,2,7,0,False,False,False,0,3,2020-10-19T14:44:26.413,9,,
2020,6,2877,245,21,713,2,48,4,-4,-4,0,-4,0,-4,0,False,False,False,0,1,2020-10-19T10:34:07.507,-4,,
2020,6,2877,285,32,1427,2,4,4,8,8,0,8,0,8,0,False,False,False,0,3,2020-10-19T10:47:36.247,8,,
2020,6,2877,290,32,8237,2,4,9,8,12,4,8,4,8,0,False,False,False,1,3,2020-10-19T10:49:46.8,12,,
2020,6,2877,295,32,8237,2,54,10,-3,2,5,2,0,2,0,True,False,False,0,3,2020-10-19T10:52:06.597,2,,
2020,6,2877,310,32,3885,2,38,9,0,0,0,0,0,0,0,True,False,False,0,3,2020-10-19T10:58:25.117,0,,
2020,6,2877,320,32,1791,2,12,2,15,15,0,15,0,15,0,False,False,False,0,2,2021-02-16T23:21:26.747,15,,
2020,6,2877,325,32,7128,13,29,6,23,0,0,0,0,0,0,False,False,False,0,2,2020-10-22T14:05:09.407,0,,
2020,6,2877,330,32,3885,2,31,10,3,8,5,8,0,8,0,False,False,False,0,3,2021-02-16T23:22:15.437,8,,
2020,6,2877,345,32,7128,2,50,9,-2,7,9,6,1,6,0,False,False,False,0,2,2020-10-19T11:10:53.467,7,,
2020,6,2877,360,32,1427,2,9,3,5,5,0,5,0,5,6,False,False,False,0,2,2020-10-19T11:15:39.23,5,,
2020,6,2877,390,21,8259,2,30,5,1,1,0,1,0,1,0,True,False,False,0,4,2020-10-19T11:28:24.373,1,,
2020,6,2877,405,21,5015,13,8,10,14,0,0,0,0,0,0,False,False,False,0,3,2020-10-19T14:49:03.4,0,,
2020,6,2877,440,32,7128,13,6,1,19,0,0,0,0,0,0,False,False,False,0,3,2020-10-19T11:49:04.353,0,,
2020,6,2877,455,21,7226,2,50,10,-1,9,10,6,3,6,0,False,False,False,0,3,2020-10-22T15:03:11.557,9,,
2020,6,2877,495,21,7090,2,6,8,18,18,0,18,0,18,0,False,False,False,0,3,2020-10-19T12:10:02.82,18,,
2020,6,2877,510,21,7226,2,46,3,1,1,0,1,0,1,0,True,False,False,0,4,2020-10-19T12:15:46.303,1,,
2020,6,2877,525,21,8259,13,6,9,5,0,0,0,0,0,0,False,False,False,0,2,2020-10-19T12:20:54.677,0,,
2020,6,2877,530,21,7090,13,7,3,7,0,0,0,0,0,0,False,False,False,0,2,2020-10-19T12:23:05.337,0,,
2020,6,2877,550,32,1427,13,54,9,-4,0,0,0,0,0,0,False,False,False,0,3,2020-10-19T12:39:52.297,0,,
2020,6,2877,560,32,7807,2,45,5,-4,2,6,1,1,1,0,False,False,False,0,1,2020-10-19T12:43:33.793,2,,
2020,6,2877,575,32,1791,2,5,5,7,11,4,10,1,10,0,False,False,False,0,3,2020-10-22T15:03:25.41,11,,
2020,6,2877,585,32,7807,13,48,10,-1,0,0,0,0,0,0,False,False,False,0,1,2020-10-19T12:54:43.417,0,,
2020,6,2877,590,32,1791,2,13,10,4,6,2,5,1,5,0,False,False,False,0,3,2020-10-22T15:05:42.793,6,,
2020,6,2877,600,32,7807,2,4,4,3,4,1,3,1,3,0,False,False,False,0,1,2020-10-19T13:00:33.953,4,,
2020,6,2877,605,32,8237,13,12,3,10,0,0,0,0,0,0,False,False,False,0,3,2020-10-19T13:02:40.617,0,,
2020,6,2877,620,21,713,3,47,5,1,0,0,0,0,0,0,False,False,False,0,1,2020-10-19T13:06:18.58,0,,
2020,6,2877,625,21,4422,13,2,4,7,0,0,0,0,0,0,False,False,False,0,3,2020-10-19T13:08:29.963,0,,
2020,6,2877,630,21,576,2,4,4,11,11,0,11,0,11,0,False,False,False,0,3,2020-10-20T20:16:19.807,11,,
2020,6,2877,640,21,7090,13,8,9,13,0,0,0,0,0,0,False,False,False,0,3,2020-10-22T15:04:00.94,0,,
2020,6,2877,645,21,4422,13,12,2,25,0,0,0,0,0,0,False,False,False,0,3,2020-10-19T13:16:18.703,0,,
2020,6,2877,655,32,7128,2,50,10,-2,5,7,3,2,3,0,False,False,False,0,2,2020-10-19T13:27:09.58,5,,
2020,6,2877,665,32,1791,2,12,9,7,10,3,8,2,8,0,False,False,False,0,3,2020-10-19T13:30:54.28,10,,
2020,6,2877,670,32,3885,2,44,9,-3,11,14,9,2,9,0,False,False,False,1,1,2020-10-22T15:04:42.187,11,,
2020,6,2877,700,32,8237,2,26,10,3,5,2,4,1,4,0,False,False,False,0,3,2020-10-19T13:49:42.077,5,,
2020,6,2877,705,32,1427,13,5,5,11,0,0,0,0,0,0,False,False,False,0,3,2020-10-19T13:51:45.807,0,,
2020,6,2877,710,32,7128,2,6,1,18,18,0,18,0,18,0,False,False,False,0,2,2020-10-19T13:53:55.613,18,,
2020,6,2877,720,32,7128,2,13,10,2,5,3,5,0,5,0,False,False,False,0,2,2020-10-19T14:49:28.713,5,,
2020,6,2877,730,32,1791,2,13,9,3,3,0,3,0,3,0,True,False,False,0,3,2020-10-20T15:54:33.603,3,,
2020,6,2877,735,32,3885,2,16,9,4,13,9,9,4,9,0,False,False,False,0,1,2020-10-19T14:00:21.577,13,,
2020,6,2877,740,32,8237,2,13,9,3,6,3,3,3,3,0,False,False,False,1,3,2020-10-19T14:02:46.323,6,,
2020,6,2877,750,32,3885,2,13,4,2,8,6,8,0,8,0,True,False,False,0,3,2020-10-20T15:59:18.887,8,,
2020,6,2877,755,32,7128,13,50,9,-2,0,0,0,0,0,0,False,False,False,0,2,2020-10-19T14:07:23.227,0,,
2020,6,2877,760,32,6430,2,24,6,22,22,0,22,0,22,6,False,False,False,0,3,2020-10-19T14:09:02.057,22,,
2020,6,2878,15,24,6937,2,48,10,-2,-6,-4,-6,0,-6,0,False,False,False,0,1,2021-01-12T23:28:50.323,-6,,
2020,6,2878,20,24,7799,3,21,2,44,0,0,0,0,0,0,False,False,False,0,2,2020-10-22T16:36:56.467,0,,
2020,6,2878,40,3,6935,2,5,3,11,11,0,11,0,11,0,False,False,False,0,2,2020-10-19T10:49:31.45,11,,
2020,6,2878,55,3,7672,2,49,9,4,17,13,9,8,9,0,False,False,False,0,3,2020-10-22T17:12:39.21,17,,
2020,6,2878,70,3,2976,2,12,5,4,7,3,7,0,7,6,False,False,False,0,4,2020-10-21T00:00:58.923,7,,
2020,6,2878,100,24,894,2,5,5,8,9,1,9,0,9,0,True,False,False,0,3,2020-10-19T11:27:04.723,9,,
2020,6,2878,115,3,7671,13,48,4,-5,0,0,0,0,0,0,False,False,False,0,1,2021-02-16T23:14:34.417,0,,
2020,6,2878,120,3,6936,13,6,8,17,0,0,0,0,0,0,False,False,False,0,3,2020-10-22T15:30:05.377,0,,
2020,6,2878,135,24,894,13,35,10,11,0,0,0,0,0,0,False,False,False,0,4,2020-10-19T11:50:15.9,0,,
2020,6,2878,140,24,7799,13,9,6,28,0,0,0,0,0,0,False,False,False,0,2,2020-10-22T16:39:19.34,0,,
2020,6,2878,155,3,7672,13,6,9,8,0,0,0,0,0,0,False,False,False,0,2,2021-02-16T23:16:50.737,0,,
2020,6,2878,165,3,2688,3,13,10,4,0,0,0,0,0,0,False,False,False,0,3,2020-10-19T12:22:05.913,0,,
2020,6,2878,185,3,2976,2,35,9,9,9,0,9,0,9,0,False,False,False,0,4,2020-10-22T16:39:41.643,9,,
2020,6,2878,240,3,2688,2,6,10,13,32,19,25,7,25,0,False,True,False,1,3,2020-10-22T15:30:05.377,32,,
2020,6,2878,255,3,7671,3,16,10,3,0,0,0,0,0,0,True,False,False,0,1,2020-10-22T16:42:59.197,0,,
2020,6,2878,275,24,894,13,2,10,7,0,0,0,0,0,0,False,False,False,0,3,2020-10-19T13:33:26.157,0,,
2020,6,2878,290,3,6454,13,4,3,11,0,0,0,0,0,0,False,False,False,0,4,2020-10-22T17:03:35.947,0,,
2020,6,2878,315,3,2688,2,6,10,8,9,1,8,1,8,0,False,False,False,0,3,2020-10-22T16:44:12.66,9,,
2020,6,2878,320,3,2976,2,53,9,-6,6,12,1,5,1,0,False,False,False,0,4,2021-02-16T23:17:23.747,6,,
2020,6,2878,330,3,6454,13,5,10,4,0,0,0,0,0,0,False,False,False,0,3,2020-10-22T16:44:34.973,0,,
2020,6,2878,335,3,7672,2,52,10,4,9,5,4,5,4,0,False,False,False,1,3,2020-10-22T17:43:14.833,9,,
2020,6,2878,350,24,894,2,5,5,8,8,0,8,0,8,0,False,False,False,0,3,2020-10-20T18:18:26.853,8,,
2020,6,2878,360,24,7797,2,51,3,-6,3,9,-3,6,-3,0,False,False,False,2,6,2021-02-16T23:18:02.797,3,,
2020,6,2878,370,24,6808,2,4,10,11,19,8,12,7,12,0,False,False,False,1,3,2020-10-19T15:11:31.573,19,,
2020,6,2878,380,24,4382,2,35,5,13,13,0,13,0,13,0,False,False,False,0,3,2020-10-19T15:17:21.353,13,,
2020,6,2878,385,24,6808,2,50,5,-1,8,9,5,3,5,0,True,False,False,0,2,2020-10-20T18:21:47.87,8,,
2020,6,2878,390,24,6937,3,11,2,21,0,0,0,0,0,0,False,False,False,0,1,2020-10-22T16:45:35.32,0,,
2020,6,2878,440,24,6808,13,6,10,10,0,0,0,0,0,0,False,False,False,0,2,2021-02-16T23:19:01.357,0,,
2020,6,2878,450,24,6808,13,19,2,47,0,0,0,0,0,0,False,False,False,0,2,2021-03-05T18:58:02.053,0,,
2020,6,2878,470,3,6936,13,5,5,5,0,0,0,0,0,0,False,False,False,0,3,2020-10-19T16:01:17.453,0,,
2020,6,2878,490,3,6454,2,47,5,1,11,10,10,1,10,0,False,False,False,0,4,2020-10-22T17:08:33.497,11,,
2020,6,2878,500,3,7672,2,34,4,-3,5,8,5,0,5,0,True,False,False,0,3,2020-10-22T17:09:10.823,5,,
2020,6,2878,505,3,6936,2,4,1,15,18,3,18,0,18,0,False,False,False,0,3,2020-10-22T16:46:28.887,18,,
2020,6,2878,515,3,7671,2,47,10,-3,2,5,2,0,2,0,False,False,False,0,1,2020-10-19T16:23:56.21,2,,
2020,6,2878,555,3,7671,2,51,3,-6,-1,5,-2,1,-2,0,False,False,False,0,1,2020-10-22T15:30:05.377,-1,,
2020,6,2878,560,3,6936,2,5,2,19,20,1,18,2,18,0,False,False,False,0,2,2020-10-22T15:30:05.377,20,,
2020,6,2878,595,24,6389,13,54,9,-5,0,0,0,0,0,0,True,False,False,0,2,2020-10-20T18:19:14.62,0,,
2020,6,2878,600,24,4382,2,32,10,-5,6,11,4,2,4,0,False,True,False,0,3,2021-02-16T23:21:14.247,6,,
2020,6,2878,620,3,6935,13,9,3,12,0,0,0,0,0,0,False,False,False,0,2,2021-03-17T19:03:49.43,0,,
2020,6,2878,630,24,6389,2,5,5,4,4,0,4,0,4,0,False,False,False,0,1,2020-10-19T17:04:27.003,4,,
2020,6,2878,635,24,894,3,5,5,7,0,0,0,0,0,0,False,False,False,0,3,2020-10-19T17:11:25.94,0,,
2020,6,2878,640,24,7799,2,19,6,32,50,18,36,14,36,0,True,False,False,0,3,2020-10-22T16:47:27.95,50,,
2020,6,2878,650,24,565,2,6,10,5,6,1,6,0,6,0,False,False,False,0,3,2020-10-22T15:30:05.377,6,,
2020,6,2878,660,24,7799,13,35,2,16,0,0,0,0,0,0,True,False,False,0,3,2020-10-22T16:48:34.76,0,,
2020,6,2878,665,24,6808,13,35,2,16,0,0,0,0,0,0,False,False,False,0,3,2020-10-22T16:48:51.087,0,,
2020,6,2878,670,24,894,2,5,5,10,11,1,11,0,11,0,False,False,False,0,3,2020-10-19T17:18:27.15,11,,
2020,6,2878,675,24,894,13,16,10,3,0,0,0,0,0,0,False,False,False,0,3,2021-02-16T23:21:58.947,0,,
2020,6,2878,680,24,6389,13,12,5,5,0,0,0,0,0,0,False,False,False,0,1,2020-10-22T16:49:06.343,0,,
2020,6,2878,685,24,4385,13,12,5,5,0,0,0,0,0,0,False,False,False,0,1,2021-02-16T23:23:11.093,0,,
2020,6,2878,695,24,4946,2,12,5,3,3,0,3,0,3,6,False,False,False,0,4,2021-03-08T19:36:27.423,3,,
2020,6,2878,710,3,6454,2,4,10,5,10,5,9,1,9,0,False,False,False,0,4,2020-10-19T17:37:10.957,10,,
2020,6,2878,725,3,2976,2,7,10,10,17,7,12,5,12,0,True,False,False,0,4,2020-10-21T00:18:02.503,17,,
2020,6,2878,735,3,6936,2,2,4,10,10,0,10,0,10,0,False,False,False,0,3,2020-10-22T17:10:32.913,10,,
2020,6,2878,755,24,894,2,5,5,3,5,2,3,2,3,0,True,False,False,0,3,2020-10-22T17:46:25.243,5,,
2020,6,2878,760,24,894,13,2,10,7,0,0,0,0,0,0,False,False,False,0,3,2020-10-19T17:50:54.713,0,,
2020,6,2878,765,24,894,13,5,3,10,0,0,0,0,0,0,False,False,False,0,3,2020-10-19T17:54:01.053,0,,
2020,6,2878,770,24,6808,3,6,5,12,0,0,0,0,0,0,False,False,False,0,3,2021-02-16T23:24:21.86,0,,
2020,6,2878,780,3,5017,3,12,5,1,0,0,0,0,0,0,True,False,False,0,1,2021-03-08T19:38:05.807,0,,
2020,6,2878,785,3,6936,2,12,10,12,12,0,12,0,12,0,False,False,False,0,2,2020-10-19T18:01:33.587,12,,
2020,6,2878,790,3,6936,2,2,10,9,9,0,9,0,9,0,False,False,False,0,2,2020-10-19T18:03:48.033,9,,
2020,6,2878,810,24,565,2,5,5,5,9,4,6,3,6,0,False,False,False,0,4,2021-02-16T23:24:45.903,9,,
2020,6,2878,815,24,6808,2,3,3,10,10,0,10,0,10,0,False,False,False,0,2,2021-02-16T23:25:22.493,10,,
2020,6,2878,830,24,4385,2,48,9,-5,-1,4,-2,1,-2,0,False,False,False,0,1,2020-10-19T18:13:24.017,-1,,
2020,6,2878,835,24,6808,2,12,5,9,10,1,10,0,10,0,False,False,False,0,2,2020-10-19T18:15:46.67,10,,
2020,6,2878,840,24,6808,2,3,10,10,10,0,10,0,10,0,False,False,False,0,2,2020-10-19T18:17:04.59,10,,
2020,6,2878,845,24,6808,13,8,1,19,0,0,0,0,0,0,False,False,False,0,2,2020-10-19T18:19:11.71,0,,
2020,6,2878,850,24,7003,13,2,4,10,0,0,0,0,0,0,False,False,False,0,2,2020-10-19T18:22:41.51,0,,
2020,6,2878,855,24,6389,2,12,9,-1,1,2,-1,2,-1,0,False,False,False,0,1,2020-10-19T18:26:04.567,1,,
2020,6,2878,860,24,6808,2,8,1,18,18,0,18,0,18,6,False,False,False,0,2,2020-10-22T16:50:45.737,18,,
2020,6,2878,910,24,6808,13,12,2,45,0,0,0,0,0,0,False,False,False,0,2,2021-03-08T19:38:58.883,0,,
2020,6,2878,915,24,4382,3,26,3,4,0,0,0,0,0,0,False,False,False,0,3,2020-10-19T18:40:29.787,0,,
2020,6,2878,920,24,565,2,35,8,15,16,1,16,0,16,0,False,False,False,0,3,2021-02-16T23:26:00.853,16,,
2020,6,2879,15,25,609,13,2,9,6,0,0,0,0,0,0,False,False,False,0,2,2021-02-16T22:55:34.947,0,,
2020,6,2879,20,25,6486,2,19,6,24,27,3,24,3,24,0,False,False,False,0,2,2020-10-19T16:21:48.813,27,,
2020,6,2879,25,25,6486,3,7,2,16,0,0,0,0,0,0,False,False,False,0,3,2020-10-20T18:57:47.663,0,,
2020,6,2879,45,25,7081,2,48,4,-7,4,11,-2,6,-2,0,False,False,False,1,1,2021-02-16T22:56:16.827,4,,
2020,6,2879,50,25,6486,13,9,2,17,0,0,0,0,0,0,False,False,False,0,2,2020-10-22T15:53:24.177,0,,
2020,6,2879,55,25,609,13,17,8,17,0,0,0,0,0,0,False,False,False,0,3,2020-10-19T16:25:09.043,0,,
2020,6,2879,80,8,7652,13,2,9,5,0,0,0,0,0,0,False,False,False,0,3,2021-03-05T19:13:38.983,0,,
2020,6,2879,100,8,3883,13,6,4,5,0,0,0,0,0,0,False,False,False,0,3,2020-10-19T11:47:46.88,0,,
2020,6,2879,115,25,6486,13,2,9,6,0,0,0,0,0,0,False,False,False,0,2,2020-10-22T17:00:40.167,0,,
2020,6,2879,135,8,7652,2,32,9,1,11,10,10,1,10,0,False,False,False,0,4,2020-10-19T11:59:15.853,11,,
2020,6,2879,155,8,1067,13,5,2,16,0,0,0,0,0,0,False,False,False,0,2,2020-10-22T15:53:24.177,0,,
2020,6,2879,175,25,6486,13,4,3,6,0,0,0,0,0,0,False,False,False,0,2,2020-10-22T17:02:42.913,0,,
2020,6,2879,190,8,5053,2,5,5,3,12,9,5,7,5,0,False,False,False,1,1,2020-10-19T12:18:30.063,12,,
2020,6,2879,205,8,4976,13,32,5,-2,0,0,0,0,0,0,False,False,False,0,4,2020-10-22T16:59:56.247,0,,
2020,6,2879,210,8,232,13,12,5,8,0,0,0,0,0,0,False,False,False,0,2,2020-10-19T12:24:28.06,0,,
2020,6,2879,230,25,4583,2,46,9,-1,1,2,1,0,1,0,False,False,False,0,3,2020-10-19T12:30:09.72,1,,
2020,6,2879,235,25,4583,2,4,9,4,5,1,5,0,5,0,False,False,False,0,3,2020-10-19T12:32:53.923,5,,
2020,6,2879,240,25,609,2,13,10,3,7,4,5,2,5,0,False,False,False,0,4,2020-10-19T12:34:51.597,7,,
2020,6,2879,245,25,6486,2,4,5,7,7,0,7,0,7,0,False,False,False,0,2,2020-10-19T12:38:31.413,7,,
2020,6,2879,250,25,7666,2,19,6,32,36,4,32,4,32,0,True,False,False,0,3,2020-10-22T17:03:01.377,36,,
2020,6,2879,270,8,1067,2,3,5,12,12,0,12,0,12,0,False,False,False,0,2,2020-10-19T12:45:35.007,12,,
2020,6,2879,280,8,232,2,12,5,5,5,0,5,0,5,0,False,False,False,0,3,2020-10-22T17:03:20.763,5,,
2020,6,2879,285,8,3883,2,53,3,-3,8,11,5,3,5,0,True,False,False,0,4,2020-10-20T16:14:47.987,8,,
2020,6,2879,290,8,3606,13,12,2,16,0,0,0,0,0,0,False,False,False,0,3,2021-03-05T19:14:07.043,0,,
2020,6,2879,295,25,7666,13,19,2,40,0,0,0,0,0,0,False,False,False,0,2,2020-10-19T12:56:53.97,0,,
2020,6,2879,305,25,7666,2,5,3,8,8,0,8,0,8,0,False,False,False,0,3,2020-10-19T13:01:08.023,8,,
2020,6,2879,315,25,6486,2,24,2,28,28,0,28,0,28,6,False,False,False,0,3,2020-10-22T17:12:41.487,28,,
2020,6,2879,345,8,3883,2,24,6,20,36,16,34,2,34,0,False,False,False,0,4,2020-10-19T16:18:53.017,36,,
2020,6,2879,355,8,1067,13,21,2,28,0,0,0,0,0,0,False,False,False,0,2,2020-10-19T16:19:05.253,0,,
2020,6,2879,360,8,7009,3,44,3,-4,0,0,0,0,0,0,False,False,False,0,1,2020-10-19T13:21:28.18,0,,
2020,6,2879,375,8,5053,2,48,9,-2,5,7,4,1,4,0,False,False,False,0,1,2020-10-19T13:25:21.38,5,,
2020,6,2879,385,8,3606,2,9,5,13,13,0,13,0,13,6,False,False,False,0,2,2021-02-25T14:45:32.15,13,,
2020,6,2879,400,25,4583,13,5,3,9,0,0,0,0,0,0,False,False,False,0,4,2020-10-22T17:03:38.24,0,,
2020,6,2879,415,25,6486,2,49,3,0,6,6,6,0,6,0,False,False,False,0,2,2021-03-04T14:42:51.66,6,,
2020,6,2879,425,8,1067,2,4,3,8,8,0,8,0,8,0,False,False,False,0,2,2021-02-16T23:00:25.967,8,,
2020,6,2879,430,8,232,2,5,3,8,13,5,10,3,10,0,False,False,False,0,3,2020-10-22T17:03:54.963,13,,
2020,6,2879,435,8,3883,2,38,10,6,6,0,6,0,6,0,False,False,False,0,3,2021-02-16T23:04:42.86,6,,
2020,6,2879,505,25,6259,3,49,9,-3,0,0,0,0,0,0,False,False,False,0,2,2020-10-22T17:04:09.57,0,,
2020,6,2879,515,25,4587,2,48,4,-3,5,8,3,2,3,0,False,False,False,0,1,2020-10-19T16:05:40.86,1,,
2020,6,2879,525,25,609,2,32,10,1,2,1,1,1,1,0,False,False,False,0,4,2020-10-22T15:53:24.177,2,,
2020,6,2879,530,25,609,2,5,3,12,18,6,12,6,12,0,False,False,False,0,3,2020-10-19T16:17:15.58,18,,
2020,6,2879,535,25,7666,2,13,10,4,7,3,7,0,7,0,False,False,False,0,2,2020-10-22T15:53:24.177,7,,
2020,6,2879,555,8,232,2,5,5,3,3,0,3,0,3,0,False,False,False,0,2,2020-10-22T17:04:28.44,3,,
2020,6,2879,615,8,3883,2,53,9,-6,-6,0,-6,0,-6,0,False,False,False,0,4,2020-10-19T14:55:29.52,-6,,
2020,6,2879,620,8,232,2,17,9,12,24,12,23,1,23,0,False,False,False,1,3,2021-02-16T23:06:30.057,24,,
2020,6,2879,630,8,1067,2,4,10,13,13,0,13,0,13,0,False,False,False,0,2,2020-10-19T15:00:52.617,13,,
2020,6,2879,640,8,3883,2,53,9,-3,8,11,6,2,6,0,True,False,False,0,4,2020-10-20T16:15:20.507,8,,
2020,6,2879,645,8,232,13,47,5,3,0,0,0,0,0,0,True,False,False,0,4,2020-10-22T17:05:08.4,0,,
2020,6,2879,650,8,5053,13,46,3,2,0,0,0,0,0,0,False,False,False,0,1,2020-10-19T15:08:32.74,0,,
2020,6,2879,695,25,7666,2,5,3,6,23,17,10,13,10,0,False,False,False,1,2,2021-03-04T14:43:13.54,23,,
2020,6,2879,730,8,4976,13,39,4,4,0,0,0,0,0,0,False,False,False,0,3,2020-10-22T15:53:24.177,0,,
2020,6,2879,760,25,7665,2,48,4,-3,6,9,4,2,4,0,False,False,False,0,1,2020-10-19T15:50:58.673,6,,
2020,6,2879,775,8,4976,2,4,9,5,7,2,5,2,5,0,False,False,False,0,4,2020-10-19T15:54:25.833,7,,
2020,6,2879,785,8,7651,13,5,5,4,0,0,0,0,0,0,False,False,False,0,3,2020-10-19T15:56:32.237,0,,
2020,6,2880,15,31,5096,13,2,10,11,0,0,0,0,0,0,True,False,False,0,3,2020-10-22T15:31:30.937,0,,
2020,6,2880,20,31,4037,2,5,3,5,6,1,6,0,6,0,False,False,False,0,3,2020-10-19T10:19:57.083,6,,
2020,6,2880,25,31,6793,13,24,6,46,0,0,0,0,0,0,False,False,False,0,3,2020-10-22T15:48:21.633,0,,
2020,6,2880,45,13,3951,2,52,4,3,22,19,15,7,15,0,False,False,False,1,3,2020-10-22T15:52:24.9,22,,
2020,6,2880,50,13,3951,13,6,4,11,0,0,0,0,0,0,False,False,False,0,2,2020-10-19T10:33:36.917,0,,
2020,6,2880,60,13,2455,13,16,10,2,0,0,0,0,0,0,False,False,False,0,1,2020-10-19T10:37:03.13,0,,
2020,6,2880,75,31,3504,13,44,9,-4,0,0,0,0,0,0,False,False,False,0,1,2020-10-19T10:43:00.11,0,,
2020,6,2880,85,31,6724,13,5,5,8,0,0,0,0,0,0,True,False,False,0,3,2020-10-19T17:13:54.873,0,,
2020,6,2880,95,31,6793,2,4,4,13,18,5,15,3,15,0,False,False,False,0,3,2020-10-19T10:54:34.01,18,,
2020,6,2880,100,31,6390,2,35,9,12,13,1,12,1,12,0,True,False,False,0,4,2021-02-17T16:30:47.103,13,,
2020,6,2880,105,31,6724,2,4,10,5,10,5,9,1,9,0,False,False,False,0,3,2020-10-19T10:56:24.417,10,,
2020,6,2880,115,31,6724,2,6,10,7,7,0,7,0,7,6,False,False,False,0,4,2020-10-22T16:26:36.36,7,,
2020,6,2880,140,13,1430,13,35,9,12,0,0,0,0,0,0,True,False,False,0,3,2020-10-19T11:08:35.977,0,,
2020,6,2880,160,31,6724,2,4,9,7,9,2,8,1,8,0,True,False,False,0,3,2020-10-19T11:15:32.85,9,,
2020,6,2880,170,31,2865,3,53,9,-3,0,0,0,0,0,0,False,False,False,0,4,2020-10-19T11:18:48.227,0,,
2020,6,2880,180,31,2675,2,4,9,10,10,0,10,0,10,0,True,False,False,0,3,2020-10-22T16:28:06.087,10,,
2020,6,2880,190,31,2675,2,3,5,8,8,0,8,0,8,0,False,False,False,0,2,2020-10-22T16:51:28.483,8,,
2020,6,2880,195,31,6793,2,12,10,0,6,6,5,1,5,6,False,False,False,0,3,2021-03-08T19:47:43.167,6,,
2020,6,2880,210,13,496,2,4,9,4,7,3,6,1,6,0,False,False,False,0,3,2020-10-19T11:39:45.097,7,,
2020,6,2880,225,13,1430,2,2,1,15,18,3,18,0,18,0,False,False,False,0,3,2020-10-19T11:43:48.877,18,,
2020,6,2880,250,13,3951,2,5,3,12,17,5,14,3,14,0,False,False,False,0,2,2020-10-19T11:52:55.41,17,,
2020,6,2880,260,13,3951,13,7,3,7,0,0,0,0,0,0,False,False,False,0,2,2020-10-19T12:04:28.703,0,,
2020,6,2880,265,13,4662,2,30,9,2,6,4,6,0,6,0,True,False,False,0,1,2020-10-19T12:03:58.697,6,,
2020,6,2880,280,13,1430,2,47,5,1,1,0,1,0,1,6,False,False,False,0,4,2020-10-19T12:07:48.817,1,,
2020,6,2880,295,31,2865,2,30,10,0,2,2,1,1,1,0,False,False,False,0,4,2020-10-19T12:12:20.2,2,,
2020,6,2880,305,31,5096,2,52,4,2,13,11,7,6,7,0,False,False,False,2,3,2020-10-19T12:16:11.407,13,,
2020,6,2880,315,31,3504,13,45,5,-2,0,0,0,0,0,0,False,False,False,0,1,2020-10-19T12:19:04.543,0,,
2020,6,2880,320,31,6724,2,26,4,5,5,0,5,0,5,0,True,False,False,0,3,2020-10-22T16:52:05.573,5,,
2020,6,2880,340,31,4037,2,5,6,20,20,0,20,0,20,0,False,False,False,0,3,2020-10-19T12:34:51.08,20,,
2020,6,2880,350,31,2675,2,11,6,18,22,4,22,0,22,6,True,False,False,0,3,2020-10-22T16:56:35.747,22,,
2020,6,2880,370,13,1430,2,39,4,4,16,12,5,11,5,0,False,False,False,1,3,2020-10-19T12:44:54.71,16,,
2020,6,2880,390,13,3951,2,5,5,7,8,1,8,0,8,0,False,False,False,0,2,2020-10-22T16:12:35.853,8,,
2020,6,2880,395,13,3951,13,12,2,40,0,0,0,0,0,0,False,False,False,0,2,2020-10-19T12:57:22.02,0,,
2020,6,2880,405,13,3951,2,5,5,13,17,4,14,3,14,0,False,False,False,0,3,2020-10-19T13:01:24.03,17,,
2020,6,2880,415,13,876,2,13,9,4,6,2,5,1,5,0,False,False,False,0,3,2020-10-19T13:05:31.143,6,,
2020,6,2880,420,13,2455,2,31,9,2,12,10,10,2,10,0,False,False,False,0,1,2020-10-20T14:07:49.47,12,,
2020,6,2880,430,13,496,2,4,9,5,6,1,6,0,6,0,False,False,False,0,3,2020-10-19T13:18:13.243,6,,
2020,6,2880,465,13,404,3,16,9,7,0,0,0,0,0,0,False,False,False,0,1,2021-02-03T18:28:35.093,0,,
2020,6,2880,485,31,3504,13,45,5,-1,0,0,0,0,0,0,False,False,False,0,1,2020-10-19T13:36:18.31,0,,
2020,6,2880,490,31,6793,13,21,6,15,0,0,0,0,0,0,False,False,False,0,2,2020-10-19T13:38:26.61,0,,
2020,6,2880,500,31,6724,13,4,9,3,0,0,0,0,0,0,True,False,False,0,4,2020-10-19T13:43:02.733,0,,
2020,6,2880,505,31,6724,2,17,8,19,45,26,36,9,36,0,False,False,False,0,4,2020-10-19T13:56:14.54,45,,
2020,6,2880,520,31,6793,2,4,9,10,12,2,10,2,10,0,False,False,False,0,2,2021-02-16T16:43:47.223,12,,
2020,6,2880,530,13,1430,2,39,4,4,11,7,9,2,9,0,False,False,False,0,3,2020-10-19T14:06:24.343,11,,
2020,6,2880,540,13,1430,2,11,5,11,35,24,29,6,29,0,False,False,False,0,4,2020-10-20T14:09:47.757,35,,
2020,6,2880,545,13,2136,13,7,6,29,0,0,0,0,0,0,False,False,False,0,3,2021-02-17T16:34:27.723,0,,
2020,6,2880,550,13,876,2,34,4,-3,0,3,-1,1,-1,0,True,False,False,0,3,2020-10-19T14:15:01.457,0,,
2020,6,2880,570,31,6793,13,50,9,0,0,0,0,0,0,0,False,False,False,0,3,2020-10-22T15:21:02.57,0,,
2020,6,2880,575,31,6888,3,46,9,0,0,0,0,0,0,0,False,False,False,0,1,2020-10-19T14:22:17.223,0,,
2020,6,2880,590,13,404,2,51,9,-5,2,7,1,1,1,0,True,False,False,0,1,2020-10-19T14:32:57.35,2,,
2020,6,2880,595,13,496,2,12,5,4,4,0,4,0,4,6,False,False,False,0,3,2020-10-22T16:36:45.537,4,,
2020,6,2880,625,31,6724,2,4,4,7,7,0,7,0,7,0,False,False,False,0,3,2020-10-19T14:48:41.657,7,,
2020,6,2880,640,31,6793,2,6,4,11,15,4,14,1,14,0,False,False,False,1,2,2020-10-19T14:53:41.737,15,,
2020,6,2880,650,31,3504,2,48,3,-4,-1,3,-3,2,-3,0,False,False,False,0,1,2021-02-17T16:30:04.147,-1,,
2020,6,2880,655,31,2865,2,4,10,4,8,4,6,2,6,0,True,False,False,0,4,2020-10-19T15:01:44.513,8,,
2020,6,2880,675,13,876,2,5,2,19,19,0,19,0,19,0,False,False,False,0,3,2020-10-19T15:12:12.147,19,,
2020,6,2880,680,13,876,2,13,10,3,5,2,5,0,5,0,False,False,False,0,3,2020-10-20T14:08:02.98,5,,
2020,6,2880,690,13,876,2,13,10,5,6,1,5,1,5,0,False,False,False,0,3,2020-10-19T15:21:31.21,6,,
2020,6,2880,700,13,1430,2,39,4,4,4,0,4,0,4,0,False,False,False,0,3,2020-10-19T15:24:53.673,4,,
2020,6,2880,730,13,4662,2,17,8,15,22,7,18,4,18,0,False,False,False,0,3,2020-10-22T16:14:48.473,22,,
2020,6,2880,735,13,3951,2,19,6,52,53,1,53,0,53,6,False,False,False,0,2,2020-10-19T15:41:21.48,53,,
2020,6,2880,750,31,4037,13,8,8,44,0,0,0,0,0,0,False,False,False,0,2,2021-03-05T19:17:22.333,0,,
2020,6,2880,755,13,876,2,5,6,15,15,0,15,0,15,0,False,False,False,0,2,2020-10-19T15:48:05.87,15,,
2020,6,2880,765,13,3951,13,5,3,8,0,0,0,0,0,0,False,False,False,0,3,2020-10-19T15:51:27.507,0,,
2020,6,2880,770,13,876,2,3,3,7,7,0,7,0,7,0,False,False,False,0,2,2020-10-19T15:53:32.093,7,,
2020,6,2880,780,13,3951,2,13,9,2,6,4,6,0,6,0,False,False,False,0,2,2020-10-19T15:56:56.82,6,,
2020,6,2880,785,13,496,13,47,10,1,0,0,0,0,0,0,False,False,False,0,3,2020-10-19T15:58:57.387,0,,
2020,6,2880,795,13,876,2,5,5,6,9,3,8,1,8,0,False,False,False,0,3,2020-10-19T16:02:44.193,9,,
2020,6,2880,805,13,3951,13,29,6,15,0,0,0,0,0,0,False,False,False,0,3,2020-10-22T16:37:12.747,0,,
2020,6,2880,845,13,876,2,13,4,1,1,0,1,0,1,6,False,False,False,0,3,2020-10-19T16:22:12.067,1,,
2020,6,2880,860,31,4545,13,28,10,-2,0,0,0,0,0,0,False,False,False,0,1,2020-10-19T16:29:52.083,0,,
2020,6,2880,865,31,2675,2,2,9,6,11,5,8,3,8,0,False,False,False,0,3,2020-10-19T16:32:44.34,11,,
2020,6,2880,870,31,2675,2,5,3,4,5,1,5,0,5,0,False,False,False,0,3,2020-10-19T16:34:11.26,5,,
2020,6,2880,875,31,4037,2,4,5,6,6,0,6,0,6,0,False,False,False,0,2,2020-10-19T16:35:35.733,6,,
2020,6,2880,880,31,6724,2,4,9,6,23,17,16,7,16,0,False,False,False,1,3,2020-10-22T16:16:06.033,23,,
2020,6,2880,885,31,6724,2,5,5,7,7,0,7,0,7,0,False,False,False,0,3,2020-10-19T16:38:25.44,7,,
2020,6,2880,895,31,2675,2,2,4,5,8,3,5,3,5,0,False,False,False,0,3,2020-10-19T16:40:46.943,8,,
2020,6,2880,905,31,4545,2,13,9,3,9,6,8,1,8,0,False,False,False,0,1,2020-10-22T16:16:31.983,9,,
2020,6,2880,910,31,6793,2,29,3,7,7,0,7,0,7,6,False,False,False,0,2,2020-10-19T16:45:51.29,7,,
2020,6,2880,945,31,3504,2,45,5,-1,53,54,19,34,19,0,False,False,False,1,1,2020-10-19T16:58:35.2,53,,
2020,6,2880,960,31,4545,2,46,3,0,2,2,1,1,1,0,False,False,False,1,1,2020-10-19T17:08:08.627,2,,
2020,11,2881,10,17,4305,13,21,6,40,0,0,0,0,0,0,False,False,False,0,2,2020-11-24T21:07:43.717,0,,0.0
2020,11,2881,20,17,4305,13,21,6,31,0,0,0,0,0,0,False,False,False,0,2,2020-11-23T11:15:04.003,0,,0.0
2020,11,2881,35,10,7700,13,19,2,33,0,0,0,0,0,0,False,False,False,0,2,2020-11-23T11:20:54.33,0,,0.0
2020,11,2881,45,10,4930,13,6,4,12,0,0,0,0,0,0,False,False,False,0,3,2021-03-05T15:08:20.173,0,,0.0
2020,11,2881,55,17,4305,13,3,5,13,0,0,0,0,0,0,False,False,False,0,2,2020-11-23T11:29:47.08,0,,
2020,11,2881,75,17,2253,2,29,5,3,3,0,3,0,3,6,False,False,False,0,2,2021-02-19T16:12:45.173,3,,0.0
2020,11,2881,95,10,4930,13,35,1,29,0,0,0,0,0,0,True,False,False,0,3,2021-03-08T20:06:48.327,0,,0.0
2020,11,2881,100,10,7700,13,6,9,11,0,0,0,0,0,0,False,False,False,0,3,2020-11-23T11:52:52.093,0,,0.0
2020,11,2881,115,17,2253,13,35,3,14,0,0,0,0,0,0,False,False,False,0,3,2020-11-28T01:20:49.783,0,,0.0
2020,11,2881,130,10,4930,13,35,5,14,0,0,0,0,0,0,False,False,False,0,3,2020-11-23T12:03:30.19,0,,0.0
2020,11,2881,135,10,7700,13,19,6,23,0,0,0,0,0,0,False,False,False,0,2,2020-11-23T12:05:30.23,0,,0.0
2020,11,2881,140,10,7701,2,4,4,14,15,1,14,1,14,0,False,False,False,0,3,2020-11-24T21:08:29.54,15,,1.0
2020,11,2881,145,10,6840,2,32,3,0,2,2,2,0,2,0,False,False,False,0,4,2020-11-23T12:10:21.187,2,,0.0
2020,11,2881,170,10,7700,2,49,5,-1,9,10,6,3,6,0,False,False,False,0,2,2021-02-19T16:13:47.677,9,,3.0
2020,11,2881,185,10,3848,2,32,5,1,15,14,11,4,11,0,False,False,False,0,4,2020-11-23T12:24:54.5,15,,4.0
2020,11,2881,205,17,4305,13,4,5,9,0,0,0,0,0,0,False,False,False,0,2,2020-11-23T16:49:17.297,0,,0.0
2020,11,2881,215,17,7618,2,51,10,-3,13,16,11,2,11,0,True,False,False,0,1,2020-11-28T00:08:23.607,13,,2.0
2020,11,2881,240,10,7701,2,13,10,4,4,0,4,0,4,0,False,False,False,0,3,2020-11-23T12:44:46.42,4,,0.0
2020,11,2881,260,17,7051,13,32,9,-4,0,0,0,0,0,0,False,False,False,0,1,2020-11-23T12:51:24.96,0,,0.0
2020,11,2881,270,10,4930,2,35,10,14,41,27,40,1,40,0,False,False,False,0,3,2020-11-28T00:11:38.563,41,,1.0
2020,11,2881,275,10,6840,2,35,5,8,9,1,9,0,9,0,False,False,False,0,4,2021-02-25T16:06:01.953,9,,0.0
2020,11,2881,285,10,6840,13,26,10,0,0,0,0,0,0,0,False,False,False,0,4,2020-11-23T13:04:32.777,0,,0.0
2020,11,2881,300,17,6274,2,4,10,3,8,5,7,1,7,0,False,False,False,0,3,2020-11-23T13:08:09.123,8,,1.0
2020,11,2881,310,17,6274,2,4,10,3,4,1,3,1,3,0,False,False,False,0,3,2020-11-23T13:10:35.173,4,,1.0
2020,11,2881,320,17,2253,2,3,5,9,9,0,9,0,9,0,False,False,False,0,2,2020-11-23T13:14:00.353,9,,0.0
2020,11,2881,330,17,7634,2,47,5,2,3,1,3,0,3,0,False,False,False,0,3,2020-11-27T23:38:22.633,3,,0.0
2020,11,2881,340,17,2253,2,2,9,6,6,0,6,0,6,0,False,False,False,0,2,2020-11-23T13:21:45.61,6,,0.0
2020,11,2881,345,17,4305,2,12,3,4,10,6,9,1,9,0,False,False,False,0,2,2020-11-23T13:25:48.207,10,,1.0
2020,11,2881,350,17,6276,13,30,3,6,0,0,0,0,0,0,True,False,False,0,4,2021-03-08T14:46:19.35,0,,0.0
2020,11,2881,390,10,7701,13,12,5,12,0,0,0,0,0,0,False,False,False,0,3,2021-02-25T16:07:23.923,0,,0.0
2020,11,2881,395,10,7700,13,2,9,9,0,0,0,0,0,0,False,False,False,0,2,2020-11-23T13:46:33.937,0,,0.0
2020,11,2881,400,10,7700,2,7,6,21,22,1,22,0,22,0,False,False,False,0,3,2020-11-23T13:48:26.737,22,,0.0
2020,11,2881,405,10,7701,13,9,2,31,0,0,0,0,0,0,False,False,False,0,3,2020-11-23T13:50:26.03,0,,0.0
2020,11,2881,415,10,4930,2,18,3,-2,1,3,-1,2,-1,0,False,False,False,0,2,2020-11-27T23:39:52.653,1,,2.0
2020,11,2881,460,10,6840,2,35,10,12,15,3,12,3,12,0,False,False,False,0,4,2020-11-23T14:10:25.62,15,,3.0
2020,11,2881,470,10,3848,2,32,5,1,9,8,6,3,6,0,False,False,False,0,4,2020-11-23T14:10:17.307,9,,3.0
2020,11,2881,480,10,6286,13,47,5,1,0,0,0,0,0,0,False,False,False,0,4,2020-11-23T14:16:31.397,0,,0.0
2020,11,2881,485,10,7700,2,2,9,5,6,1,6,0,6,0,False,False,False,0,2,2020-11-23T14:18:34.443,6,,0.0
2020,11,2881,505,17,7051,2,4,10,7,8,1,8,0,8,0,False,False,False,0,3,2020-11-23T14:27:44.063,8,,0.0
2020,11,2881,515,10,4930,2,4,9,10,9,-1,9,0,9,0,False,False,False,0,2,2020-11-23T14:31:06.167,9,,0.0
2020,11,2881,525,10,7701,2,5,3,4,16,12,13,3,13,0,False,False,False,0,2,2020-11-23T14:34:16.22,16,,3.0
2020,11,2881,540,10,7700,13,4,2,38,0,0,0,0,0,0,False,False,False,0,2,2020-11-23T14:39:31.84,0,,0.0
2020,11,2881,550,10,7701,13,32,5,4,0,0,0,0,0,0,False,False,False,0,3,2020-11-23T14:42:54.233,0,,
2020,11,2881,555,10,4930,2,26,5,2,7,5,3,4,3,0,False,False,False,0,2,2020-11-23T14:46:07.537,7,,4.0
2020,11,2881,575,17,7618,3,12,3,1,0,0,0,0,0,0,False,False,False,0,1,2021-03-08T20:10:16.39,0,,0.0
2020,11,2881,580,17,4305,13,8,7,30,0,0,0,0,0,0,False,False,False,0,2,2020-11-23T14:52:43.883,0,,0.0
2020,11,2881,585,17,6442,2,2,10,10,13,3,10,3,10,0,False,False,False,0,2,2020-11-23T14:54:58.62,13,,3.0
2020,11,2881,600,17,2253,13,29,2,18,0,0,0,0,0,0,False,False,False,0,2,2020-11-23T15:01:23.133,0,,
2020,11,2881,620,17,7618,2,2,10,5,6,1,6,0,6,0,False,False,False,0,3,2020-11-27T21:57:53.363,6,,0.0
2020,11,2881,640,10,7701,2,45,5,-5,0,5,-2,2,-2,0,False,False,False,0,3,2021-03-04T19:26:36.647,0,,2.0
2020,11,2881,660,17,2253,2,4,3,7,7,0,7,0,7,0,False,False,False,0,2,2021-02-19T16:16:58.69,7,,0.0
2020,11,2881,665,17,7618,2,46,3,0,0,0,0,0,0,0,False,False,False,0,1,2021-02-19T16:18:32.827,0,,0.0
2020,11,2881,670,17,6274,2,7,2,20,25,5,22,3,22,0,False,False,False,0,3,2021-02-25T16:08:17.167,25,,3.0
2020,11,2881,675,17,7618,2,46,9,1,11,10,4,7,4,0,False,False,False,0,1,2020-11-23T15:36:46.543,11,,7.0
2020,11,2881,680,17,2253,13,6,9,6,0,0,0,0,0,0,False,False,False,0,2,2020-11-23T15:38:33.847,0,,0.0
2020,11,2881,685,17,4383,13,13,9,5,0,0,0,0,0,0,False,False,False,0,2,2020-11-27T21:57:53.363,0,,0.0
2020,11,2881,705,10,6840,2,32,5,3,29,26,22,7,22,0,False,False,False,1,4,2020-11-23T15:46:29.087,29,,7.0
2020,11,2881,740,17,7634,3,2,3,6,0,0,0,0,0,0,False,False,False,0,2,2020-11-23T16:03:14.347,0,,0.0
2020,11,2881,745,17,2253,2,5,3,5,15,10,5,10,5,0,False,False,False,1,3,2020-11-23T16:05:12.307,15,,10.0
2020,11,2881,755,17,7618,2,47,5,-1,1,2,0,1,0,0,False,False,False,0,1,2020-11-23T16:09:37.347,1,,1.0
2020,11,2881,760,17,7634,2,5,3,7,8,1,7,1,7,0,False,False,False,0,3,2020-11-23T16:11:55.667,8,,1.0
2020,11,2881,765,17,6274,2,13,4,5,6,1,6,0,6,0,False,False,False,0,3,2020-11-28T00:18:30.113,6,,0.0
2020,11,2881,770,17,7634,13,13,9,6,0,0,0,0,0,0,False,False,False,0,3,2021-02-19T16:26:01.42,0,,0.0
2020,11,2881,775,17,4383,13,12,4,10,0,0,0,0,0,0,False,False,False,0,2,2020-11-23T16:17:56.89,0,,
2020,11,2881,780,17,4383,2,6,10,5,9,4,9,0,9,0,False,False,False,0,3,2020-11-23T16:21:08.57,9,,0.0
2020,11,2881,785,17,2253,2,19,6,17,21,4,20,1,20,0,False,False,False,0,2,2020-11-23T16:23:13.37,21,,1.0
2020,11,2881,790,17,7634,2,4,10,4,12,8,10,2,10,0,False,False,False,0,3,2020-11-23T16:25:16.107,12,,2.0
2020,11,2881,795,17,6274,13,7,6,17,0,0,0,0,0,0,False,False,False,0,3,2021-02-19T16:27:01.71,0,,0.0
2020,11,2881,805,17,4305,2,13,10,2,2,0,2,0,2,0,False,False,False,0,2,2020-11-23T16:30:29.85,2,,0.0
2020,11,2881,810,17,2253,13,8,8,15,0,0,0,0,0,0,False,False,False,0,3,2020-11-23T16:32:32.237,0,,0.0
2020,11,2881,850,10,4930,2,19,2,39,61,22,49,12,49,0,False,False,False,0,2,2020-11-23T16:42:35.96,61,,12.0
2020,11,2882,10,26,6277,2,47,5,1,2,1,1,1,1,0,False,False,False,0,1,2020-11-24T22:42:12.253,2,,1.0
2020,11,2882,15,26,309,2,2,10,5,17,12,13,4,13,0,False,False,False,0,3,2020-11-29T18:14:24.123,17,,4.0
2020,11,2882,25,26,7695,2,48,4,-6,-6,0,-6,0,-6,0,False,False,False,0,1,2020-11-29T18:14:42.64,-6,,0.0
2020,11,2882,30,26,4282,2,4,4,13,18,5,15,3,15,0,False,False,False,0,3,2021-02-19T20:34:22.717,18,,3.0
2020,11,2882,35,26,309,2,51,10,-3,1,4,-1,2,-1,0,False,False,False,0,3,2021-03-04T19:30:57.733,1,,2.0
2020,11,2882,45,26,4619,13,19,2,49,0,0,0,0,0,0,False,False,False,0,2,2020-11-29T16:23:04.113,0,,0.0
2020,11,2882,85,26,309,2,49,10,-2,4,6,4,0,4,0,False,False,False,0,3,2021-02-19T20:35:36.877,4,,0.0
2020,11,2882,95,26,309,13,4,5,7,0,0,0,0,0,0,False,False,False,0,2,2020-11-23T11:44:40.287,0,,
2020,11,2882,105,26,4282,2,39,4,5,6,1,5,1,5,0,False,False,False,0,4,2020-11-29T14:53:55.887,6,,1.0
2020,11,2882,110,26,4619,2,4,5,13,13,0,13,0,13,0,False,False,False,0,2,2021-02-19T20:36:43.617,13,,0.0
2020,11,2882,115,26,309,2,35,10,13,18,5,14,4,14,0,False,False,False,0,3,2021-02-19T20:38:25.74,18,,4.0
2020,11,2882,120,26,3653,2,47,5,5,8,3,8,0,8,0,False,False,False,0,1,2021-02-19T20:39:26.723,8,,0.0
2020,11,2882,135,26,6277,2,28,4,1,3,2,3,0,3,0,False,False,False,0,1,2020-11-29T14:53:55.887,3,,0.0
2020,11,2882,140,26,309,2,4,10,7,14,7,8,6,8,0,False,True,True,1,3,2020-11-29T16:12:16.02,14,,6.0
2020,11,2882,145,22,3170,13,47,5,2,0,0,0,0,0,0,False,False,False,0,3,2021-03-05T15:12:22.35,0,,0.0
2020,11,2882,170,22,6812,2,48,4,-3,0,3,-1,1,-1,0,False,False,False,0,1,2020-11-29T15:14:11.107,0,,1.0
2020,11,2882,180,26,6277,2,44,9,-3,3,6,3,0,3,0,False,False,False,0,1,2020-11-29T16:29:27.9,3,,0.0
2020,11,2882,185,26,309,2,50,3,-2,9,11,7,2,7,0,True,False,False,0,2,2020-11-29T16:30:21.887,9,,2.0
2020,11,2882,205,26,4619,2,6,4,12,39,27,14,25,14,6,False,False,False,1,3,2021-03-02T21:42:39.683,39,,25.0
2020,11,2882,220,22,6262,3,4,10,6,0,0,0,0,0,0,True,False,False,0,4,2020-11-24T23:41:26.65,0,,0.0
2020,11,2882,235,22,7610,13,13,9,7,0,0,0,0,0,0,False,False,False,0,3,2021-03-08T15:27:27.413,0,,0.0
2020,11,2882,245,26,7514,2,19,1,50,54,4,51,3,51,0,False,False,False,0,3,2020-11-23T12:23:15.407,54,,3.0
2020,11,2882,255,26,309,2,4,10,3,9,6,4,5,4,0,False,False,False,1,3,2020-11-23T12:25:51.43,9,,5.0
2020,11,2882,265,26,4282,13,32,5,4,0,0,0,0,0,0,False,False,False,0,4,2020-11-29T16:41:36.28,0,,0.0
2020,11,2882,275,26,4282,2,4,10,2,2,0,2,0,2,6,False,False,False,0,3,2020-11-29T18:06:34.563,2,,0.0
2020,11,2882,300,22,6262,2,35,2,26,26,0,26,0,26,0,True,False,False,0,4,2020-11-29T14:53:55.903,26,,0.0
2020,11,2882,315,22,6812,13,2,9,4,0,0,0,0,0,0,False,False,False,0,2,2020-11-23T12:40:08.063,0,,0.0
2020,11,2882,325,26,4282,2,53,9,-5,11,16,9,2,9,0,False,False,False,0,4,2020-11-29T17:13:38.943,11,,
2020,11,2882,330,26,309,2,7,6,16,21,5,21,0,21,0,False,False,False,0,3,2020-11-29T17:14:05.7,21,,0.0
2020,11,2882,335,26,4619,13,9,2,33,0,0,0,0,0,0,False,False,False,0,3,2020-11-24T22:48:41.737,0,,0.0
2020,11,2882,340,26,309,13,4,10,4,0,0,0,0,0,0,False,False,False,0,3,2020-11-29T17:14:41.493,0,,0.0
2020,11,2882,345,26,309,2,26,9,2,10,8,10,0,10,0,False,False,False,0,3,2020-11-29T18:15:31.733,10,,0.0
2020,11,2882,355,26,6277,2,28,10,0,5,5,5,0,5,0,False,False,False,0,1,2020-11-29T14:53:55.903,5,,0.0
2020,11,2882,360,26,6277,3,28,10,-5,0,0,0,0,0,0,False,False,False,0,1,2020-11-29T17:16:51.04,0,,0.0
2020,11,2882,385,22,6812,2,47,5,3,4,1,4,0,4,0,False,False,False,0,1,2021-02-19T20:43:27.65,4,,0.0
2020,11,2882,395,22,7609,13,11,5,1,0,0,0,0,0,0,False,False,False,0,1,2021-03-17T19:41:53.33,0,,0.0
2020,11,2882,425,26,309,2,5,5,4,5,1,5,0,5,0,False,False,False,0,3,2020-11-29T18:16:07.103,5,,0.0
2020,11,2882,430,26,4282,2,17,8,17,22,5,18,4,18,0,False,False,False,0,3,2021-02-19T20:44:46.45,22,,4.0
2020,11,2882,440,26,4282,13,4,1,15,0,0,0,0,0,0,False,False,False,0,3,2021-03-08T14:48:49.547,0,,0.0
2020,11,2882,450,26,309,3,4,5,8,0,0,0,0,0,0,False,False,False,0,3,2020-11-29T18:16:22.767,0,,
2020,11,2882,455,26,309,13,19,6,36,0,0,0,0,0,0,False,False,False,0,3,2020-11-29T18:16:41.75,0,,
2020,11,2882,465,26,6277,13,12,3,1,0,0,0,0,0,0,False,False,False,0,1,2021-03-01T15:05:08.233,0,,0.0
2020,11,2882,500,22,7118,2,4,9,5,5,0,5,0,5,0,False,False,False,0,3,2020-11-29T17:22:54.243,5,,0.0
2020,11,2882,505,22,3170,13,39,4,4,0,0,0,0,0,0,False,False,False,0,3,2020-11-29T17:24:13.28,0,,0.0
2020,11,2882,520,22,3170,2,12,2,16,16,0,16,0,16,0,False,False,False,0,2,2020-11-29T18:17:15.217,16,,0.0
2020,11,2882,525,22,256,2,19,8,49,49,0,48,1,48,6,False,False,False,0,3,2020-11-29T18:17:36.433,49,,1.0
2020,11,2882,540,26,309,2,4,9,5,9,4,6,3,6,0,False,False,False,0,3,2020-11-29T18:18:05.383,9,,3.0
2020,11,2882,550,26,7453,2,4,9,5,4,-1,4,0,4,0,False,False,False,0,3,2020-11-29T18:18:48.92,4,,0.0
2020,11,2882,565,26,309,2,4,10,5,10,5,6,4,6,0,False,False,False,1,3,2020-11-29T17:25:16.007,10,,4.0
2020,11,2882,570,26,7695,2,47,5,1,10,9,10,0,10,0,False,False,False,0,1,2020-11-29T17:25:53.043,10,,0.0
2020,11,2882,580,26,6277,2,48,3,-4,9,13,-1,10,-1,0,False,False,False,2,1,2020-11-23T13:41:12.37,9,,10.0
2020,11,2882,590,26,4282,13,12,5,13,0,0,0,0,0,0,False,False,False,0,3,2020-11-23T13:43:45.527,0,,0.0
2020,11,2882,595,26,309,2,12,3,13,13,0,13,0,13,6,False,False,False,0,3,2021-03-08T20:15:29.737,13,,0.0
2020,11,2882,620,22,7610,13,7,2,35,0,0,0,0,0,0,False,False,False,0,2,2020-11-29T17:46:52.507,0,,
2020,11,2882,625,22,1113,2,4,10,5,7,2,5,2,5,0,False,False,False,1,1,2020-11-29T16:20:12.007,7,,
2020,11,2882,630,22,256,13,19,2,45,0,0,0,0,0,0,False,False,False,0,2,2020-11-23T13:54:43.953,0,,0.0
2020,11,2882,635,22,6812,2,5,5,5,12,7,6,6,6,0,False,False,False,0,1,2020-11-23T13:56:16.29,12,,6.0
2020,11,2882,640,22,7610,2,9,2,23,27,4,24,3,24,0,False,False,False,0,2,2020-11-29T14:53:55.903,27,,3.0
2020,11,2882,645,22,6812,13,47,5,3,0,0,0,0,0,0,False,False,False,0,1,2020-11-29T14:53:55.903,0,,0.0
2020,11,2882,650,22,1113,2,28,4,3,7,4,7,0,7,0,False,False,False,0,1,2020-11-23T14:01:25.99,7,,0.0
2020,11,2882,655,22,7610,13,9,6,30,0,0,0,0,0,0,False,False,False,0,2,2021-02-19T20:46:47.697,0,,
2020,11,2882,670,22,256,13,13,9,2,0,0,0,0,0,0,False,False,False,0,3,2020-11-29T18:29:10.693,0,,
2020,11,2882,690,26,309,3,50,3,-3,0,0,0,0,0,0,True,False,False,0,2,2020-11-29T17:49:04.667,0,,0.0
2020,11,2882,705,26,4619,2,4,10,9,9,0,9,0,9,0,False,False,False,0,3,2020-11-29T18:29:35.477,9,,0.0
2020,11,2882,710,26,4619,3,5,5,12,0,0,0,0,0,0,False,False,False,0,2,2020-11-23T14:17:46.153,0,,0.0
2020,11,2882,715,26,4619,2,4,5,9,11,2,9,2,9,0,False,False,False,0,2,2021-02-19T20:47:13.727,11,,2.0
2020,11,2882,720,26,6277,2,45,5,-5,3,8,3,0,3,0,False,False,False,0,1,2020-11-29T15:14:45.34,3,,0.0
2020,11,2882,725,26,309,2,4,10,3,5,2,3,2,3,0,False,False,False,0,2,2021-02-19T20:47:40.673,5,,2.0
2020,11,2882,750,26,6277,2,46,3,1,2,1,1,1,1,0,False,False,False,0,1,2020-11-29T14:53:55.903,2,,1.0
2020,11,2882,755,26,7453,13,13,9,7,0,0,0,0,0,0,False,False,False,0,3,2021-02-19T20:49:06.72,0,,
2020,11,2882,770,26,3653,2,47,5,3,4,1,4,0,4,0,False,False,False,0,1,2020-11-29T17:54:09.823,4,,0.0
2020,11,2882,795,22,256,2,5,5,5,5,0,5,0,5,0,False,False,False,0,3,2020-11-29T17:54:46.683,5,,0.0
2020,11,2882,800,22,7610,13,12,8,35,0,0,0,0,0,0,False,False,False,0,2,2020-11-29T17:55:19.933,0,,0.0
2020,11,2882,805,22,7610,2,9,2,25,25,0,25,0,25,0,False,False,False,0,2,2020-11-23T14:41:59.497,25,,0.0
2020,11,2882,815,22,1113,2,48,4,-5,3,8,3,0,3,0,False,False,False,0,1,2020-11-29T17:55:47.083,3,,0.0
2020,11,2882,820,22,7610,2,29,6,19,19,0,19,0,19,0,False,False,False,0,2,2020-11-23T14:46:03.43,19,,0.0
2020,11,2882,830,22,6262,2,17,9,6,6,0,6,0,6,6,False,False,False,0,4,2020-11-23T14:49:43.36,6,,0.0
2020,11,2882,845,26,309,2,30,5,-6,1,7,-5,6,-5,0,True,False,False,1,4,2020-11-23T14:53:08.003,1,,6.0
2020,11,2882,850,26,309,13,3,5,7,0,0,0,0,0,0,False,False,False,0,2,2020-11-29T14:53:55.903,0,,0.0
2020,11,2882,855,26,309,2,50,5,-1,-1,0,-1,0,-1,0,False,False,False,0,2,2020-11-29T14:53:55.903,-1,,0.0
2020,11,2882,875,22,7610,13,8,9,14,0,0,0,0,0,0,False,False,False,0,2,2021-02-19T20:51:31.193,0,,0.0
2020,11,2882,885,22,6812,2,44,3,-7,1,8,1,0,1,0,False,False,False,0,1,2021-02-19T20:52:51.963,1,,0.0
2020,11,2882,900,22,7610,13,19,6,32,0,0,0,0,0,0,False,False,False,0,2,2020-11-23T15:05:49.09,0,,0.0
2020,11,2882,910,22,7610,13,9,2,32,0,0,0,0,0,0,False,False,False,0,2,2020-11-29T14:53:55.903,0,,0.0
2020,6,2883,15,12,4561,13,51,10,-3,0,0,0,0,0,0,False,False,False,0,3,2021-02-16T22:13:29.887,0,,
2020,6,2883,20,12,4537,2,12,10,3,20,17,15,5,15,0,False,False,False,1,1,2021-03-08T19:50:05.977,20,,
2020,6,2883,25,12,556,2,3,5,7,8,1,8,0,8,0,False,False,False,0,2,2020-10-19T10:18:08.2,8,,
2020,6,2883,30,12,556,2,13,4,3,12,9,7,5,7,0,False,False,False,0,3,2020-10-22T21:37:23.857,12,,
2020,6,2883,35,12,6357,2,13,9,2,12,10,12,0,12,0,False,False,False,0,3,2020-10-22T15:21:52.637,12,,
2020,6,2883,40,12,6356,13,5,3,5,0,0,0,0,0,0,False,False,False,0,2,2020-10-19T10:32:42.433,0,,
2020,6,2883,55,12,7460,13,7,6,21,0,0,0,0,0,0,False,False,False,0,3,2020-10-19T10:38:49.353,0,,
2020,6,2883,75,30,6414,2,48,10,-2,6,8,-1,7,-1,0,False,False,False,2,1,2020-10-22T15:44:47.35,6,,
2020,6,2883,100,12,4511,2,12,5,11,11,0,11,0,11,0,False,False,False,0,2,2021-03-08T19:50:53.603,11,,
2020,6,2883,115,12,6357,2,12,8,15,15,0,15,0,15,0,False,False,False,0,3,2020-10-19T17:05:49.12,15,,
2020,6,2883,120,12,556,2,2,10,5,13,8,10,3,10,0,False,False,False,0,3,2020-10-22T15:52:58.04,13,,
2020,6,2883,135,12,6869,2,4,5,6,16,10,14,2,14,0,False,False,False,1,2,2020-10-19T11:18:38.94,16,,
2020,6,2883,160,30,4516,2,4,9,4,9,5,4,5,4,0,False,False,False,1,2,2021-02-16T22:14:01.957,9,,
2020,6,2883,180,30,793,2,5,3,5,10,5,10,0,10,0,False,False,False,0,3,2021-02-16T22:17:45.777,10,,
2020,6,2883,190,30,63,13,20,2,17,0,0,0,0,0,0,False,False,False,0,2,2020-10-19T11:43:33.247,0,,
2020,6,2883,195,30,4516,13,5,3,4,0,0,0,0,0,0,False,False,False,0,3,2021-02-16T22:18:20.717,0,,
2020,6,2883,205,12,4537,13,12,5,-2,0,0,0,0,0,0,True,False,False,0,3,2021-02-16T22:20:51.607,0,,
2020,6,2883,215,12,556,13,5,3,10,0,0,0,0,0,0,True,False,False,0,2,2020-10-20T17:58:36.323,0,,
2020,6,2883,225,12,4537,2,51,5,-3,7,10,2,5,2,0,True,False,False,0,1,2020-10-20T17:58:55.387,7,,
2020,6,2883,235,12,556,13,2,4,7,0,0,0,0,0,0,False,False,False,0,2,2021-03-05T19:20:18.917,0,,
2020,6,2883,255,12,4537,13,11,6,23,0,0,0,0,0,0,True,False,False,0,4,2021-02-16T22:21:55.903,0,,
2020,6,2883,260,12,467,13,17,8,21,0,0,0,0,0,0,False,False,False,0,4,2020-10-22T16:21:35.397,0,,
2020,6,2883,280,30,63,2,5,10,7,13,6,10,3,10,0,False,False,False,0,4,2020-10-19T12:29:05.07,13,,
2020,6,2883,290,30,6414,2,46,9,0,2,2,1,1,1,0,False,False,False,0,1,2020-10-19T12:32:49.047,2,,
2020,6,2883,295,30,4516,2,13,9,4,6,2,5,1,5,0,False,False,False,0,3,2020-10-19T12:36:48.293,6,,
2020,6,2883,300,30,63,2,53,9,-5,4,9,4,0,4,0,False,False,False,0,4,2020-10-19T12:39:14.73,4,,
2020,6,2883,310,30,119,2,46,3,0,6,6,3,3,3,0,False,False,False,0,3,2020-10-19T12:43:05.217,6,,
2020,6,2883,320,30,4516,2,50,5,-3,0,3,-1,1,-1,0,True,False,False,1,3,2020-10-22T15:45:15.84,0,,
2020,6,2883,325,30,7893,2,12,3,7,7,0,7,0,7,6,False,False,False,0,2,2020-10-19T12:50:39.97,7,,
2020,6,2883,345,12,6357,13,8,1,53,0,0,0,0,0,0,True,False,False,0,2,2020-10-20T17:59:17.857,0,,
2020,6,2883,360,30,4516,2,50,10,-3,8,11,6,2,6,0,True,False,False,0,2,2020-10-22T15:19:21.957,8,,
2020,6,2883,385,30,4516,2,5,8,16,25,9,22,3,22,0,True,False,False,0,3,2020-10-19T17:06:12.087,25,,
2020,6,2883,395,30,2290,2,51,3,3,3,0,3,0,3,0,True,False,False,0,4,2021-02-16T22:22:33.29,3,,
2020,6,2883,405,30,63,2,29,3,12,12,0,12,0,12,6,False,False,False,0,3,2020-10-19T13:25:09.17,12,,
2020,6,2883,420,12,556,13,4,3,5,0,0,0,0,0,0,False,False,False,0,3,2020-10-19T13:29:25.63,0,,
2020,6,2883,425,12,4511,2,39,9,4,9,5,9,0,9,0,False,False,False,0,3,2020-10-19T13:31:02.743,9,,
2020,6,2883,430,12,4511,2,51,3,-2,5,7,5,0,5,0,False,False,False,0,4,2020-10-19T13:33:27.793,5,,
2020,6,2883,440,12,6357,13,19,6,51,0,0,0,0,0,0,False,False,False,0,2,2020-10-19T13:39:00.367,0,,
2020,6,2883,465,30,63,2,35,8,20,31,11,21,10,21,0,False,False,False,0,4,2020-10-22T15:45:27.15,31,,
2020,6,2883,480,30,7268,2,4,3,6,6,0,6,0,6,0,False,False,False,0,2,2020-10-19T14:07:33.98,6,,
2020,6,2883,505,12,4511,13,6,9,11,0,0,0,0,0,0,False,False,False,0,3,2020-10-19T14:19:32.473,0,,
2020,6,2883,515,30,7268,13,35,6,28,0,0,0,0,0,0,True,False,False,0,2,2020-10-20T17:19:05.923,0,,
2020,6,2883,520,30,793,13,5,3,7,0,0,0,0,0,0,False,False,False,0,2,2020-10-19T14:24:48.863,0,,
2020,6,2883,525,30,4516,13,4,3,9,0,0,0,0,0,0,True,False,False,0,2,2020-10-20T17:21:34.197,0,,
2020,6,2883,545,12,6357,2,5,3,2,5,3,5,0,5,0,False,False,False,0,3,2020-10-22T14:49:27.247,5,,
2020,6,2883,550,12,556,2,4,1,18,18,0,18,0,18,0,False,False,False,0,3,2021-02-16T22:28:02.86,18,,
2020,6,2883,560,12,467,3,28,10,0,0,0,0,0,0,0,False,False,False,0,4,2020-10-19T14:53:24.573,0,,
2020,6,2883,565,12,556,2,5,5,3,4,1,3,1,3,0,False,False,False,0,3,2020-10-22T14:49:27.247,4,,
2020,6,2883,570,12,6356,3,51,3,1,0,0,0,0,0,0,False,False,False,0,3,2021-02-16T22:29:36.267,0,,
2020,6,2883,580,12,556,13,29,2,16,0,0,0,0,0,0,False,False,False,0,2,2021-02-25T14:48:35.247,0,,
2020,6,2883,595,30,63,2,35,2,18,18,0,18,0,18,0,False,False,False,0,4,2020-10-19T15:14:42.68,18,,
2020,6,2883,615,30,7268,13,19,6,42,0,0,0,0,0,0,False,False,False,0,2,2020-10-19T16:51:41.95,0,,
2020,6,2883,625,30,63,13,46,3,1,0,0,0,0,0,0,False,False,False,0,3,2020-10-19T15:28:45.087,0,,
2020,6,2883,650,12,4537,2,48,10,-4,-1,3,-1,0,-1,0,False,False,False,1,1,2020-10-22T15:46:02.207,-1,,
2020,6,2883,695,30,7891,3,28,4,4,0,0,0,0,0,0,False,False,False,0,1,2020-10-19T15:48:40.343,0,,
2020,6,2883,700,30,63,3,4,4,10,0,0,0,0,0,0,False,False,False,0,4,2020-10-19T15:50:55.37,0,,
2020,6,2883,715,12,556,2,51,10,0,6,6,4,2,4,0,False,False,False,0,3,2020-10-19T15:55:08.86,6,,
2020,6,2883,755,30,5056,13,19,6,39,0,0,0,0,0,0,False,False,False,0,2,2020-10-19T16:06:57.373,0,,
2020,6,2883,790,30,5056,13,2,9,1,0,0,0,0,0,0,False,False,False,0,2,2020-10-19T16:52:53.35,0,,
2020,6,2884,15,28,7224,2,34,4,-5,35,40,4,31,4,0,True,False,False,2,3,2020-10-19T13:09:11.837,35,,
2020,6,2884,25,28,7619,2,51,3,-5,10,15,7,3,7,0,True,False,False,0,1,2021-02-16T22:42:37.67,10,,
2020,6,2884,30,28,4922,2,53,4,-6,18,24,16,2,16,0,False,False,False,0,4,2020-10-19T17:50:57.727,18,,
2020,6,2884,35,28,7224,2,34,4,-4,6,10,6,0,6,6,True,False,False,0,3,2020-10-19T13:15:54.093,6,,
2020,6,2884,50,29,4866,13,2,9,5,0,0,0,0,0,0,False,False,False,0,3,2020-10-19T13:19:10.037,0,,
2020,6,2884,55,29,3398,2,2,4,4,17,13,15,2,15,0,False,False,False,0,3,2020-10-22T19:31:11.083,17,,
2020,6,2884,60,29,4866,13,38,6,18,0,0,0,0,0,0,False,False,False,0,4,2020-10-19T13:24:13.777,0,,
2020,6,2884,70,29,4866,13,35,8,34,0,0,0,0,0,0,True,False,False,0,3,2020-10-19T13:28:13.407,0,,
2020,6,2884,100,28,4922,3,4,9,4,0,0,0,0,0,0,False,False,False,0,4,2020-10-20T16:14:56.167,0,,
2020,6,2884,105,28,797,2,5,10,1,2,1,2,0,2,0,False,False,False,0,1,2020-10-19T13:41:40.763,2,,
2020,6,2884,115,29,1958,13,5,2,22,0,0,0,0,0,0,False,False,False,0,3,2020-10-22T17:22:24.64,0,,
2020,6,2884,125,29,4850,13,4,3,12,0,0,0,0,0,0,False,False,False,0,2,2020-10-19T13:52:07.117,0,,
2020,6,2884,150,28,3264,2,48,5,-6,7,13,-4,11,-4,0,False,False,False,1,1,2020-10-19T14:01:27.603,7,,
2020,6,2884,155,28,4922,2,5,3,4,4,0,4,0,4,0,True,False,False,0,3,2020-10-19T14:03:34.09,4,,
2020,6,2884,160,28,262,2,5,10,4,8,4,6,2,6,0,False,False,False,0,1,2020-10-22T19:58:47.947,8,,
2020,6,2884,175,28,7224,2,51,3,-5,5,10,2,3,2,0,True,False,False,0,1,2020-10-19T14:12:27.647,5,,
2020,6,2884,195,28,4922,2,2,10,10,44,34,11,33,11,6,False,False,False,1,3,2020-10-22T17:30:19.72,44,,
2020,6,2884,215,29,3398,3,53,10,-1,0,0,0,0,0,0,False,False,False,0,4,2020-10-19T14:21:56.767,0,,
2020,6,2884,260,29,1958,2,13,9,2,3,1,3,0,3,0,False,False,False,0,3,2020-10-19T14:45:14.17,3,,
2020,6,2884,265,29,1958,2,8,9,10,10,0,10,0,10,6,False,False,False,0,3,2020-10-19T14:46:33.063,10,,
2020,6,2884,300,28,4912,2,8,10,14,19,5,17,2,17,0,False,False,False,0,3,2020-10-19T14:54:14.357,19,,
2020,6,2884,305,28,4912,2,35,7,18,25,7,21,4,21,0,False,False,False,0,3,2020-10-19T14:55:57.63,25,,
2020,6,2884,320,28,4932,2,26,3,5,8,3,6,2,6,0,False,False,False,0,2,2020-10-22T20:03:29.41,8,,
2020,6,2884,360,28,4932,13,47,5,2,0,0,0,0,0,0,False,False,False,0,3,2020-10-19T15:07:16.927,0,,
2020,6,2884,365,28,7619,2,4,10,2,2,0,2,0,2,6,False,False,False,0,3,2020-10-19T15:09:01.943,2,,
2020,6,2884,380,29,3398,2,2,10,5,8,3,7,1,7,0,True,False,False,0,4,2020-10-19T15:11:10.67,8,,
2020,6,2884,385,29,1958,13,5,5,5,0,0,0,0,0,0,False,False,False,0,3,2020-10-19T15:12:32.873,0,,
2020,6,2884,395,29,4866,2,50,10,-3,-5,-2,0,-5,0,0,False,False,False,0,3,2021-03-04T16:08:27.79,0,,
2020,6,2884,405,28,7224,2,34,10,-4,11,15,9,2,9,0,True,False,False,0,3,2020-10-19T15:20:06.21,11,,
2020,6,2884,410,28,3264,2,5,4,2,4,2,3,1,3,0,False,False,False,0,1,2020-10-19T15:22:15.513,4,,
2020,6,2884,415,28,4922,2,39,4,5,7,2,6,1,6,0,False,False,False,0,3,2020-10-19T15:24:00.56,7,,
2020,6,2884,425,28,4912,13,26,9,6,0,0,0,0,0,0,False,False,False,0,3,2020-10-22T19:31:11.1,0,,
2020,6,2884,430,28,7619,13,19,6,44,0,0,0,0,0,0,False,False,False,0,3,2020-10-19T15:28:52.103,0,,
2020,6,2884,435,28,4922,3,12,5,12,0,0,0,0,0,0,False,False,False,0,3,2020-10-19T15:30:38.773,0,,
2020,6,2884,455,29,3398,2,7,2,26,31,5,31,0,31,0,False,False,False,0,4,2020-10-22T17:22:47.83,31,,
2020,6,2884,465,29,1958,2,5,5,12,12,0,12,0,12,0,False,False,False,0,3,2020-10-19T15:37:45.63,12,,
2020,6,2884,475,29,3356,2,11,3,5,6,1,6,0,6,0,False,False,False,0,1,2020-10-22T20:25:26.95,6,,
2020,6,2884,485,29,4875,13,3,3,12,0,0,0,0,0,0,False,False,False,0,2,2021-02-16T22:47:03.473,0,,
2020,6,2884,505,28,7224,2,51,9,-7,-2,5,-2,0,-2,0,True,False,False,0,2,2021-02-16T22:47:43.68,-2,,
2020,6,2884,510,28,797,3,16,9,4,0,0,0,0,0,0,False,False,False,0,1,2020-10-19T15:47:47.483,0,,
2020,6,2884,530,29,4850,13,19,6,39,0,0,0,0,0,0,False,False,False,0,2,2020-10-22T15:28:10.02,0,,
2020,6,2884,540,29,4866,13,17,7,37,0,0,0,0,0,0,True,False,False,0,3,2020-10-22T19:31:11.1,0,,
2020,6,2884,560,28,797,2,46,3,3,8,5,7,1,7,0,False,False,False,0,1,2020-10-19T15:59:44.083,8,,
2020,6,2884,585,29,4875,13,4,7,17,0,0,0,0,0,0,False,False,False,0,3,2020-10-22T15:28:27.477,0,,
2020,6,2884,615,29,4866,13,5,5,2,0,0,0,0,0,0,False,False,False,0,3,2020-10-19T16:16:08.313,0,,
2020,6,2884,620,29,4875,13,5,3,2,0,0,0,0,0,0,False,False,False,0,3,2020-10-22T19:31:11.1,0,,
2020,6,2884,625,28,4922,2,6,9,11,18,7,16,2,16,0,False,False,False,0,4,2020-10-19T16:19:01.363,18,,
2020,6,2884,640,28,4912,3,6,9,4,0,0,0,0,0,0,True,False,False,0,2,2020-10-22T19:31:11.1,0,,
2020,6,2884,660,29,4850,2,38,3,11,17,6,16,1,16,0,False,False,False,0,4,2020-10-22T20:26:10.247,17,,
2020,6,2884,665,29,1958,13,11,6,16,0,0,0,0,0,0,True,False,False,0,4,2020-10-22T19:31:11.1,0,,
2020,6,2884,670,29,3356,13,45,5,-5,0,0,0,0,0,0,False,False,False,0,1,2020-10-19T16:44:24.273,0,,
2020,6,2884,680,29,3356,2,32,3,0,7,7,5,2,5,0,False,False,False,0,3,2020-10-22T15:28:49.253,7,,
2020,6,2884,705,28,4922,2,4,10,6,7,1,7,0,7,0,False,False,False,0,4,2020-10-19T16:53:48.943,7,,
2020,6,2884,715,28,7751,13,28,5,-5,0,0,0,0,0,0,False,False,False,0,1,2020-10-22T20:13:36.02,0,,
2020,6,2884,720,28,4922,3,8,9,11,0,0,0,0,0,0,False,False,False,0,3,2021-02-16T22:48:53.063,0,,
2020,6,2884,730,29,1958,2,4,9,4,4,0,4,0,4,0,False,False,False,0,2,2020-10-22T20:28:29.363,4,,
2020,6,2884,735,29,1958,13,4,10,12,0,0,0,0,0,0,False,False,False,0,3,2020-10-22T20:15:19.213,0,,
2020,6,2884,740,29,4875,13,19,6,27,0,0,0,0,0,0,False,False,False,0,2,2021-02-16T22:50:44.207,0,,
2020,6,2884,755,28,262,13,43,6,29,0,0,0,0,0,0,True,False,False,0,4,2020-10-22T19:31:11.1,0,,
2020,6,2884,760,28,4922,2,4,10,4,11,7,6,5,6,0,False,False,False,1,3,2020-10-22T19:53:09.14,11,,
2020,6,2884,795,29,4850,2,39,9,4,4,0,4,0,4,0,False,False,False,0,3,2020-10-22T17:24:07.84,4,,
2020,6,2884,800,29,1958,13,7,2,20,0,0,0,0,0,0,False,False,False,0,3,2020-10-22T19:31:11.1,0,,
2020,6,2884,805,29,4866,2,5,5,6,7,1,7,0,7,0,False,False,False,0,3,2020-10-19T17:28:28.817,7,,
2020,6,2884,810,29,4850,2,32,5,2,6,4,6,0,6,0,False,False,False,0,4,2020-10-19T17:29:52.88,6,,
2020,6,2884,815,29,1958,13,24,2,51,0,0,0,0,0,0,False,False,False,0,3,2020-10-22T20:26:53.54,0,,
2020,6,2884,820,29,7828,2,4,5,4,8,4,7,1,7,0,False,False,False,0,2,2020-10-22T17:24:17.727,8,,
2020,6,2884,825,29,4875,2,39,4,5,5,0,5,0,5,0,False,False,False,0,3,2020-10-19T17:34:54.503,5,,
2020,6,2884,830,29,3356,2,4,9,2,5,3,4,1,4,0,False,False,False,0,1,2020-10-19T17:36:26.713,5,,
2020,6,2884,835,29,4866,2,5,3,4,4,0,4,0,4,0,False,False,False,0,3,2020-10-19T17:37:59.41,4,,
2020,6,2884,840,29,4875,2,19,7,40,40,0,40,0,40,6,False,False,False,0,3,2020-10-22T20:18:56.453,40,,
2020,6,2884,880,28,7224,2,34,4,-5,11,16,5,6,5,0,True,False,False,2,3,2021-02-16T22:51:12.18,11,,
2020,6,2885,10,1,245,13,4,9,3,0,0,0,0,0,0,False,False,False,0,2,2020-10-20T10:12:41.353,0,,
2020,6,2885,20,1,7315,13,19,1,47,0,0,0,0,0,0,False,False,False,0,3,2020-10-20T10:16:31.47,0,,
2020,6,2885,40,9,4202,2,44,3,-2,0,2,0,0,0,0,True,False,False,0,1,2020-10-22T21:23:43.903,0,,
2020,6,2885,45,9,4202,2,4,9,0,4,4,4,0,4,0,False,False,False,0,1,2020-10-22T18:15:11.83,4,,
2020,6,2885,65,1,5032,2,5,5,1,1,0,1,0,1,0,True,False,False,0,3,2020-10-22T19:05:07.807,1,,
2020,6,2885,75,1,525,2,5,5,5,5,0,5,0,5,0,False,False,False,0,3,2020-10-20T10:38:34.07,5,,
2020,6,2885,80,1,525,2,4,9,4,6,2,4,2,4,0,False,False,False,0,3,2020-10-22T20:10:24.037,6,,
2020,6,2885,90,1,245,13,2,3,-2,0,0,0,0,0,0,False,False,False,0,2,2021-03-04T14:48:06.097,0,,
2020,6,2885,100,1,7315,13,19,2,40,0,0,0,0,0,0,False,False,False,0,3,2020-10-22T19:20:40.827,0,,
2020,6,2885,110,9,4202,13,11,7,15,0,0,0,0,0,0,False,False,False,0,1,2020-10-20T10:58:03.377,0,,
2020,6,2885,125,9,4202,3,12,10,-2,0,0,0,0,0,0,False,False,False,0,1,2021-02-16T21:31:52.717,0,,
2020,6,2885,140,1,245,13,2,3,5,0,0,0,0,0,0,False,False,False,0,2,2021-04-01T19:12:23.443,0,,
2020,6,2885,150,1,245,2,52,4,2,13,11,12,1,12,0,False,False,False,0,2,2020-10-21T17:41:44.207,13,,
2020,6,2885,170,9,7816,3,4,4,6,0,0,0,0,0,0,False,False,False,0,3,2020-10-20T11:20:00.927,0,,
2020,6,2885,175,9,6446,2,53,10,-3,13,16,13,0,13,0,False,False,False,0,4,2020-10-20T11:23:01.423,13,,
2020,6,2885,180,9,6436,2,5,3,6,6,0,6,0,6,0,False,False,False,0,2,2020-10-22T21:01:48.723,6,,
2020,6,2885,195,9,4202,2,12,4,-3,0,3,0,0,0,0,False,True,True,0,1,2020-10-20T12:04:31.933,0,,
2020,6,2885,200,1,245,13,35,2,20,0,0,0,0,0,0,False,False,False,0,2,2020-10-22T19:21:35.82,0,,
2020,6,2885,205,1,4307,13,47,5,-1,0,0,0,0,0,0,False,False,False,0,1,2020-10-20T11:34:54.497,0,,
2020,6,2885,220,1,245,2,4,3,13,13,0,13,0,13,0,False,False,False,0,3,2020-10-22T20:12:07.24,13,,
2020,6,2885,225,1,6406,2,50,3,-4,6,10,3,3,3,0,True,False,False,1,2,2021-03-04T16:11:21.607,6,,
2020,6,2885,240,1,4307,3,47,5,1,0,0,0,0,0,0,False,False,False,0,1,2020-10-20T11:47:35.957,0,,
2020,6,2885,255,1,6405,2,34,4,-3,6,9,6,0,6,6,True,False,False,0,3,2020-10-20T11:53:21.33,6,,
2020,6,2885,270,9,4446,2,30,5,0,1,1,0,1,0,0,True,False,False,0,3,2020-10-20T11:56:31.737,1,,
2020,6,2885,285,1,6406,13,12,2,17,0,0,0,0,0,0,False,False,False,0,1,2021-02-16T21:41:50.447,0,,
2020,6,2885,290,1,525,2,5,3,10,11,1,11,0,11,0,False,False,False,0,3,2020-10-20T12:13:34.617,11,,
2020,6,2885,315,9,6446,2,5,10,4,4,0,4,0,4,0,False,False,False,0,4,2020-10-20T12:22:26.067,4,,
2020,6,2885,330,9,6436,2,2,4,12,17,5,12,5,12,0,False,False,False,0,2,2020-10-22T20:05:14.627,17,,
2020,6,2885,340,9,6446,2,4,9,4,6,2,5,1,5,0,False,False,False,0,4,2020-10-22T21:27:27.383,6,,
2020,6,2885,355,9,4202,13,44,3,-4,0,0,0,0,0,0,False,False,False,0,1,2020-10-22T18:15:11.83,0,,
2020,6,2885,360,9,322,2,50,10,-3,0,3,-1,1,-1,0,False,False,False,0,3,2020-10-20T12:39:45.693,0,,
2020,6,2885,365,9,6436,13,5,6,17,0,0,0,0,0,0,False,False,False,0,2,2020-10-22T20:54:26.107,0,,
2020,6,2885,375,1,6405,2,21,8,42,80,38,80,0,80,6,True,False,False,0,3,2020-10-22T21:23:57.773,80,,
2020,6,2885,390,9,4202,2,45,5,-3,3,6,3,0,3,0,False,False,False,0,1,2020-10-22T18:15:11.83,3,,
2020,6,2885,395,9,322,2,2,5,4,8,4,6,2,6,0,False,False,False,0,2,2020-10-20T12:49:50.96,8,,
2020,6,2885,425,9,6446,2,5,5,11,12,1,12,0,12,0,True,False,False,0,3,2020-10-22T21:24:10.447,12,,
2020,6,2885,440,9,6441,2,50,9,-2,5,7,5,0,5,0,False,False,False,0,3,2020-10-22T20:05:26.1,5,,
2020,6,2885,445,9,6441,2,47,5,4,5,1,5,0,5,0,False,False,False,0,3,2020-10-22T18:45:50.933,5,,
2020,6,2885,460,9,4202,2,48,10,-6,-2,4,-2,0,-2,0,False,False,False,0,1,2020-10-20T13:09:41.243,-2,,
2020,6,2885,465,9,6436,3,4,2,16,0,0,0,0,0,0,False,False,False,0,3,2020-10-22T18:15:11.83,0,,
2020,6,2885,500,9,322,2,2,10,7,26,19,23,3,23,0,False,False,False,0,3,2020-10-20T13:19:36.737,26,,
2020,6,2885,505,9,7816,2,51,10,-3,-2,1,-2,0,-2,0,False,False,False,0,3,2020-10-22T20:56:43.23,-2,,
2020,6,2885,510,9,7816,2,6,9,6,6,0,6,0,6,0,True,False,False,0,3,2020-10-22T21:24:24.237,6,,
2020,6,2885,515,9,7816,13,5,2,21,0,0,0,0,0,0,False,False,False,0,3,2021-03-05T19:22:24.82,0,,
2020,6,2885,560,1,5152,13,35,5,7,0,0,0,0,0,0,False,False,False,0,4,2021-02-25T14:52:09.08,0,,
2020,6,2885,580,9,322,13,4,3,6,0,0,0,0,0,0,False,False,False,0,2,2021-03-17T19:06:05.593,0,,
2020,6,2885,585,9,322,2,2,10,8,13,5,8,5,8,0,True,False,False,1,2,2021-02-16T21:38:25.203,13,,
2020,6,2885,590,9,322,2,4,5,7,8,1,8,0,8,0,False,False,False,0,2,2020-10-20T14:03:44.4,8,,
2020,6,2885,600,9,7183,3,46,9,1,0,0,0,0,0,0,False,False,False,0,1,2020-10-20T14:03:34.503,0,,
2020,6,2885,605,9,4202,2,4,10,6,11,5,11,0,11,0,True,False,False,0,3,2020-10-22T21:24:45.99,11,,
2020,6,2885,610,9,6441,13,17,7,28,0,0,0,0,0,0,False,False,False,0,3,2020-10-20T14:08:57.26,0,,
2020,6,2885,615,9,6436,13,19,2,32,0,0,0,0,0,0,False,False,False,0,2,2020-10-20T14:11:36.067,0,,
2020,6,2885,620,9,7816,13,7,6,24,0,0,0,0,0,0,False,False,False,0,3,2020-10-20T14:15:36.673,0,,
2020,6,2885,645,1,245,13,5,3,5,0,0,0,0,0,0,False,False,False,0,2,2020-10-22T21:03:32.14,0,,
2020,6,2885,670,9,6446,13,12,6,16,0,0,0,0,0,0,False,False,False,0,3,2021-02-16T21:36:36.47,0,,
2020,6,2885,685,9,7816,2,26,10,1,7,6,5,2,5,0,False,False,False,0,3,2020-10-20T14:35:23.883,7,,
2020,6,2885,690,9,7816,2,4,3,9,27,18,9,18,9,0,False,False,False,1,3,2021-03-02T21:36:26.107,27,,
2020,6,2885,710,9,7816,2,13,9,5,6,1,6,0,6,0,False,False,False,0,3,2020-10-20T14:47:37.123,6,,
2020,6,2885,715,9,4446,2,4,10,14,14,0,15,-1,15,0,False,False,False,0,3,2020-10-20T14:49:50.897,14,,
2020,6,2885,720,9,7816,3,6,9,5,0,0,0,0,0,0,False,False,False,0,3,2020-10-20T14:51:28.993,0,,
2020,6,2885,725,9,7816,2,51,9,-1,11,12,7,4,7,0,False,False,False,1,3,2021-03-04T14:50:04.75,11,,
2020,6,2885,730,9,322,13,2,10,7,0,0,0,0,0,0,False,False,False,0,3,2020-10-22T17:42:57.357,0,,
2020,6,2885,755,1,245,2,13,10,3,60,57,59,1,59,0,False,False,False,1,3,2020-10-20T15:13:29.917,60,,
2020,6,2885,765,1,245,13,29,3,8,0,0,0,0,0,0,False,False,False,0,2,2020-10-22T19:09:00.31,0,,
2020,6,2885,770,1,525,13,7,5,8,0,0,0,0,0,0,True,False,False,0,3,2020-10-22T21:24:58.933,0,,
2020,6,2885,785,9,7183,2,45,5,-5,5,10,2,3,2,0,False,False,False,0,1,2020-10-22T18:15:11.83,5,,
2020,6,2885,790,9,7183,2,5,5,4,4,0,4,0,4,0,False,False,False,0,3,2020-10-22T21:04:07.667,4,,
2020,6,2885,805,9,4202,2,13,10,3,9,6,7,2,7,0,False,False,False,0,2,2020-10-22T21:04:35.553,9,,
2020,6,2885,810,9,7816,2,4,9,10,9,-1,9,0,9,0,False,False,False,0,3,2020-10-20T15:29:46.54,9,,
2020,6,2885,815,9,2568,13,17,8,17,0,0,0,0,0,0,False,False,False,0,3,2021-02-16T21:37:29.05,0,,
2020,6,2885,820,9,4202,2,5,3,5,6,1,6,0,6,0,False,False,False,0,1,2020-10-20T15:36:30.1,6,,
2020,6,2885,825,9,6446,13,2,4,11,0,0,0,0,0,0,False,False,False,0,3,2020-10-22T18:17:04.193,0,,
2020,6,2885,835,9,322,2,4,5,14,14,0,14,0,14,0,False,False,False,0,3,2020-10-22T18:15:11.83,14,,
2020,6,2885,840,9,322,2,6,10,5,9,4,5,4,5,0,False,False,False,0,2,2020-10-20T16:39:33.647,9,,
2020,6,2885,855,9,7183,3,13,4,1,0,0,0,0,0,0,False,False,False,0,1,2020-10-22T21:21:48.287,0,,
2020,6,2885,860,9,6436,13,29,3,13,0,0,0,0,0,0,False,False,False,0,2,2020-10-20T15:51:17.427,0,,
2020,6,2885,870,9,6436,13,29,3,4,0,0,0,0,0,0,False,False,False,0,2,2020-10-20T15:54:24.377,0,,
2020,6,2885,875,9,322,13,47,5,1,0,0,0,0,0,0,False,False,False,0,3,2020-10-22T18:15:11.83,0,,
2020,6,2885,880,9,6436,13,9,3,1,0,0,0,0,0,0,False,False,False,0,3,2020-10-22T18:15:11.83,0,,
2020,6,2885,890,9,322,2,26,3,1,1,0,1,0,1,6,False,False,False,0,2,2021-02-16T21:51:56.32,1,,
2020,7,2886,15,24,967,2,4,3,7,10,3,10,0,10,0,False,False,False,0,2,2020-10-23T11:05:48.307,10,,0.0
2020,7,2886,35,24,4382,2,39,4,5,8,3,7,1,7,0,False,False,False,0,3,2020-10-30T16:52:29.107,8,,1.0
2020,7,2886,55,24,967,2,5,3,9,9,0,9,0,9,0,False,False,False,0,3,2020-10-23T11:31:54.857,9,,0.0
2020,7,2886,65,24,565,2,2,9,11,18,7,15,3,15,0,False,False,False,0,4,2020-10-23T11:35:00.8,18,,3.0
2020,7,2886,90,21,7090,13,21,6,40,0,0,0,0,0,0,False,False,False,0,2,2020-10-23T18:32:47.827,0,,
2020,7,2886,100,21,713,3,46,3,0,0,0,0,0,0,0,False,False,False,0,1,2020-10-23T11:57:02.503,0,,0.0
2020,7,2886,105,21,4422,2,13,9,2,2,0,2,0,2,0,False,False,False,0,3,2020-10-30T13:57:27.207,2,,
2020,7,2886,120,24,6808,13,9,6,22,0,0,0,0,0,0,False,False,False,0,2,2020-10-23T12:05:30.773,0,,0.0
2020,7,2886,140,21,576,2,9,2,26,39,13,26,13,26,6,False,False,False,1,3,2020-10-30T12:48:24.517,39,,13.0
2020,7,2886,160,24,6389,2,48,9,-6,15,21,11,4,11,0,False,False,False,0,1,2020-10-23T12:29:40.347,15,,4.0
2020,7,2886,165,24,565,13,39,4,5,0,0,0,0,0,0,False,False,False,0,4,2020-10-23T12:31:36.043,0,,0.0
2020,7,2886,170,24,6389,2,4,9,3,13,10,8,5,8,0,False,False,False,1,1,2020-10-23T18:33:08.867,13,,5.0
2020,7,2886,180,24,4385,2,47,5,2,12,10,3,9,3,0,False,False,False,1,1,2020-10-23T12:40:09.183,12,,9.0
2020,7,2886,185,24,7003,2,5,5,3,8,5,6,2,6,0,False,False,False,0,3,2020-10-23T12:42:01.747,8,,2.0
2020,7,2886,200,24,565,2,4,10,14,16,2,16,0,16,0,False,False,False,0,3,2020-10-30T13:57:40.197,16,,0.0
2020,7,2886,210,24,4382,2,5,9,10,14,4,12,2,12,0,False,False,False,0,3,2020-10-23T13:13:18.863,14,,2.0
2020,7,2886,220,24,6389,13,16,9,2,0,0,0,0,0,0,False,False,False,0,1,2020-10-30T12:55:52.11,0,,0.0
2020,7,2886,225,24,967,13,2,10,3,0,0,0,0,0,0,False,False,False,0,2,2020-10-30T16:45:42.223,0,,0.0
2020,7,2886,240,21,4422,2,51,5,-4,5,9,-1,6,-1,0,True,False,False,1,1,2021-02-17T13:43:13.14,5,,6.0
2020,7,2886,250,21,3680,2,26,5,2,7,5,7,0,7,0,True,False,False,0,3,2021-02-17T13:43:49.403,7,,0.0
2020,7,2886,255,21,4405,2,48,10,-5,-4,1,-5,1,-5,0,False,False,False,0,1,2020-10-23T13:34:16.16,-4,,1.0
2020,7,2886,260,21,4422,2,7,2,16,17,1,17,0,17,0,False,False,False,0,3,2020-10-24T17:30:51.847,17,,0.0
2020,7,2886,270,21,4422,13,31,9,2,0,0,0,0,0,0,True,False,False,0,4,2020-10-30T16:46:42.787,0,,0.0
2020,7,2886,275,21,4422,3,2,10,1,0,0,0,0,0,0,False,False,False,0,3,2021-04-01T19:48:34.52,0,,0.0
2020,7,2886,280,24,6808,3,12,9,7,0,0,0,0,0,0,False,False,False,0,3,2020-10-30T16:47:01.917,0,,0.0
2020,7,2886,310,24,4382,2,39,4,6,6,0,6,0,6,0,False,False,False,0,4,2020-10-30T13:57:55.847,6,,0.0
2020,7,2886,320,24,6808,2,4,9,10,10,0,10,0,10,0,False,False,False,0,3,2020-10-23T13:56:34.723,10,,0.0
2020,7,2886,330,24,7799,13,12,6,20,0,0,0,0,0,0,False,False,False,0,2,2020-10-23T13:59:13.02,0,,0.0
2020,7,2886,335,21,3680,2,6,8,15,29,14,15,14,15,0,True,False,False,1,2,2020-10-23T14:02:17.253,29,,14.0
2020,7,2886,350,21,4422,2,49,10,2,9,7,7,2,7,0,False,False,False,0,3,2020-10-30T12:31:39.56,9,,2.0
2020,7,2886,370,24,565,13,39,4,3,0,0,0,0,0,0,False,False,False,0,4,2020-10-23T14:11:20.967,0,,0.0
2020,7,2886,375,24,6808,2,50,5,-3,1,4,-3,4,-3,0,False,False,False,1,2,2020-10-30T12:48:50.79,1,,4.0
2020,7,2886,390,21,3680,13,4,5,10,0,0,0,0,0,0,False,False,False,0,2,2020-10-23T14:16:49.497,0,,0.0
2020,7,2886,400,24,967,2,9,3,14,15,1,15,0,15,0,False,False,False,0,2,2021-02-25T14:39:24.943,15,,0.0
2020,7,2886,405,24,6808,2,5,2,16,16,0,16,0,16,0,False,False,False,0,3,2020-10-23T14:25:44.06,16,,0.0
2020,7,2886,410,24,967,13,9,3,11,0,0,0,0,0,0,False,False,False,0,3,2020-10-23T14:28:47.653,0,,0.0
2020,7,2886,415,24,6808,13,5,3,11,0,0,0,0,0,0,False,False,False,0,3,2020-10-30T13:59:13.503,0,,0.0
2020,7,2886,430,24,6808,3,5,5,11,0,0,0,0,0,0,False,False,False,0,2,2020-10-23T14:35:44.853,0,,0.0
2020,7,2886,465,21,7090,2,5,3,11,12,1,12,0,12,0,False,False,False,0,2,2020-10-23T15:04:09.273,12,,0.0
2020,7,2886,480,24,565,2,39,4,5,7,2,6,1,6,0,False,False,False,0,4,2020-10-23T15:09:02.383,7,,1.0
2020,7,2886,500,21,7090,13,2,9,8,0,0,0,0,0,0,False,False,False,0,2,2020-10-24T17:31:08.733,0,,0.0
2020,7,2886,520,24,7734,13,46,3,0,0,0,0,0,0,0,False,False,False,0,1,2020-10-23T15:35:18.723,0,,0.0
2020,7,2886,525,24,6808,13,12,10,10,0,0,0,0,0,0,False,False,False,0,3,2020-10-24T16:49:44.847,0,,0.0
2020,7,2886,540,21,4422,2,34,4,-3,0,3,-1,1,-1,0,True,False,False,0,3,2020-10-30T12:33:56.72,0,,1.0
2020,7,2886,545,21,3680,2,4,5,3,5,2,5,0,5,0,False,False,False,0,2,2020-10-30T12:58:11.993,5,,0.0
2020,7,2886,550,21,4422,13,26,5,3,0,0,0,0,0,0,False,False,False,0,3,2020-10-23T15:49:08.883,0,,
2020,7,2886,575,24,6389,13,47,10,0,0,0,0,0,0,0,False,False,False,0,1,2020-10-30T13:59:25.847,0,,0.0
2020,7,2886,580,24,4382,13,3,5,9,0,0,0,0,0,0,False,False,False,0,3,2020-10-30T16:47:17.663,0,,0.0
2020,7,2886,595,21,4405,2,51,9,-4,0,4,-2,2,-2,0,False,False,False,0,1,2020-10-30T12:29:40.987,0,,2.0
2020,7,2886,600,21,4422,2,47,10,4,7,3,7,0,7,0,False,False,False,0,3,2020-10-30T16:47:26.07,7,,0.0
2020,7,2886,610,24,565,2,47,10,-2,3,5,0,3,0,0,False,False,False,0,4,2020-10-23T16:09:25.817,3,,3.0
2020,7,2886,615,24,6808,2,4,10,6,6,0,6,0,6,0,False,False,False,0,3,2020-10-30T13:59:40.327,6,,0.0
2020,7,2886,620,24,4382,2,5,5,11,11,0,11,0,11,0,True,False,False,0,3,2020-10-30T13:02:39.233,11,,0.0
2020,7,2886,625,24,6808,2,24,2,22,40,18,37,3,37,0,False,False,False,0,3,2021-02-17T13:45:00.94,40,,3.0
2020,7,2886,650,24,7310,13,9,5,3,0,0,0,0,0,0,False,False,False,0,2,2020-10-23T16:26:40.483,0,,0.0
2020,7,2886,660,21,7090,2,6,9,11,11,0,11,0,11,0,False,False,False,0,2,2020-10-23T16:31:01.317,11,,0.0
2020,7,2886,665,21,3680,2,47,5,5,7,2,7,0,7,0,True,False,False,0,3,2020-10-23T16:32:59.923,7,,0.0
2020,7,2886,675,21,4405,2,12,9,-6,7,13,5,2,5,0,False,False,False,1,1,2021-03-02T21:47:33.22,7,,2.0
2020,7,2886,685,21,576,13,9,2,23,0,0,0,0,0,0,False,False,False,0,3,2020-10-30T13:59:54.96,0,,
2020,7,2886,690,21,3680,13,5,2,17,0,0,0,0,0,0,False,False,False,0,3,2020-10-30T14:00:16.457,0,,0.0
2020,7,2886,695,21,4405,2,4,4,3,12,9,10,2,10,0,False,False,False,0,1,2020-10-23T16:46:41.93,12,,2.0
2020,7,2886,710,21,4405,2,46,3,2,5,3,3,2,3,0,False,False,False,0,3,2020-10-23T17:02:28.28,5,,2.0
2020,7,2886,715,21,3680,2,26,10,2,9,7,7,2,7,0,False,False,False,0,2,2020-10-23T18:30:38.85,9,,2.0
2020,7,2886,725,21,576,13,2,4,2,0,0,0,0,0,0,False,False,False,0,3,2021-02-17T13:47:06.307,0,,0.0
2020,7,2886,730,21,3680,2,2,4,2,2,0,2,0,2,6,False,False,False,0,3,2020-10-24T17:31:55.357,2,,0.0
2020,7,2886,745,24,6808,13,23,8,20,0,0,0,0,0,0,False,False,False,0,3,2020-10-30T16:48:20.537,0,,0.0
2020,7,2886,755,24,7799,2,19,2,45,59,14,47,12,47,0,False,False,False,1,2,2021-03-02T21:53:12.683,59,,12.0
2020,7,2886,760,24,7799,13,9,5,14,0,0,0,0,0,0,False,False,False,0,2,2020-10-23T17:30:56.623,0,,
2020,7,2886,775,24,4382,2,47,5,3,3,0,3,0,3,6,True,False,False,0,3,2020-10-23T17:34:55.363,3,,0.0
2020,7,2886,815,21,4422,3,9,6,24,0,0,0,0,0,0,False,False,False,0,3,2020-10-24T17:32:10.463,0,,0.0
2020,7,2886,825,24,565,2,4,10,10,11,1,10,1,10,0,False,False,False,0,4,2020-10-30T14:01:49.207,11,,1.0
2020,7,2886,835,24,565,2,12,2,20,30,10,28,2,28,0,False,False,False,0,3,2021-03-08T20:05:12.087,30,,2.0
2020,7,2886,840,24,6808,13,4,5,9,0,0,0,0,0,0,False,False,False,0,2,2020-10-30T17:00:04.327,0,,
2020,7,2886,870,24,7799,13,12,9,5,0,0,0,0,0,0,False,False,False,0,3,2021-03-08T20:05:53.1,0,,
2020,7,2886,880,24,6389,2,11,2,18,18,0,18,0,18,6,False,False,False,0,1,2020-10-23T18:03:16.757,18,,0.0
2020,7,2886,895,21,4422,2,32,5,2,7,5,7,0,7,0,False,False,False,0,3,2020-10-30T14:02:11.537,7,,
2020,7,2886,900,21,4422,2,47,5,4,8,4,8,0,8,0,False,False,False,0,3,2020-10-23T18:08:07.513,8,,0.0
2020,7,2887,20,2,5214,2,5,5,7,12,5,11,1,11,0,True,False,False,0,4,2020-10-26T10:56:50.34,12,,1.0
2020,7,2887,35,2,6247,13,26,10,1,0,0,0,0,0,0,True,False,False,0,3,2021-02-17T16:38:27.8,0,,0.0
2020,7,2887,55,11,6820,2,5,3,3,3,0,3,0,3,0,False,False,False,0,4,2020-10-26T11:18:14.953,3,,0.0
2020,7,2887,70,2,6247,2,44,3,-5,-2,3,-2,0,-2,0,False,False,False,0,3,2020-10-29T16:33:12.167,-2,,0.0
2020,7,2887,75,2,4670,2,5,3,2,7,5,5,2,5,0,False,False,False,0,1,2021-02-25T14:42:02.967,7,,2.0
2020,7,2887,85,11,6810,2,17,9,11,16,5,15,1,15,0,False,False,False,0,4,2020-10-29T14:51:57.717,16,,1.0
2020,7,2887,90,11,3820,13,19,6,38,0,0,0,0,0,0,False,False,False,0,2,2020-10-26T11:30:55.203,0,,0.0
2020,7,2887,100,11,914,2,8,7,19,23,4,21,2,21,0,False,False,False,0,2,2020-10-28T03:24:17.68,23,,2.0
2020,7,2887,120,11,914,13,6,4,4,0,0,0,0,0,0,False,False,False,0,3,2020-10-26T11:45:04.913,0,,0.0
2020,7,2887,150,2,661,13,5,5,5,0,0,0,0,0,0,False,False,False,0,3,2020-10-26T11:59:35.933,0,,0.0
2020,7,2887,155,2,6342,13,2,9,6,0,0,0,0,0,0,True,False,False,0,2,2020-10-29T17:02:58.483,0,,0.0
2020,7,2887,165,11,792,2,47,5,0,1,1,0,1,0,0,False,False,False,0,1,2020-10-28T03:25:09.143,1,,1.0
2020,7,2887,175,11,100,3,4,4,9,0,0,0,0,0,0,False,False,False,0,3,2020-10-26T12:08:48.47,0,,0.0
2020,7,2887,185,2,5214,2,46,3,7,16,9,16,0,16,0,False,False,False,1,4,2020-10-26T12:13:20.727,16,,0.0
2020,7,2887,190,2,661,2,4,9,3,8,5,6,2,6,0,False,False,False,0,3,2020-10-26T12:13:12.087,8,,2.0
2020,7,2887,195,2,5214,2,12,10,8,7,-1,7,0,7,0,False,False,False,0,4,2021-02-24T19:40:04.92,7,,0.0
2020,7,2887,200,2,5223,13,9,6,24,0,0,0,0,0,0,False,False,False,0,2,2020-10-26T12:20:02.72,0,,0.0
2020,7,2887,205,2,4670,2,51,5,-1,9,10,9,0,9,0,False,False,False,0,1,2020-10-26T12:21:58.52,9,,0.0
2020,7,2887,220,2,5214,2,47,5,4,8,4,8,0,8,0,True,False,False,0,4,2021-02-17T16:37:13.76,8,,0.0
2020,7,2887,225,2,5223,2,5,2,19,19,0,19,0,19,0,False,False,False,0,3,2020-10-26T12:31:52.713,19,,0.0
2020,7,2887,230,2,5214,13,8,7,22,0,0,0,0,0,0,False,False,False,0,4,2020-10-29T16:37:08.207,0,,
2020,7,2887,240,2,6342,13,11,6,17,0,0,0,0,0,6,False,False,False,0,3,2020-10-26T12:38:20.963,0,,
2020,7,2887,245,2,990,2,4,4,3,11,8,7,4,7,0,False,False,False,0,1,2020-10-26T12:40:42.02,11,,4.0
2020,7,2887,250,2,5223,13,9,2,16,0,0,0,0,0,0,False,False,False,0,2,2020-10-26T12:42:01.233,0,,
2020,7,2887,255,2,2223,3,12,9,1,0,0,0,0,0,0,False,False,False,0,4,2021-02-17T16:40:39.44,0,,0.0
2020,7,2887,280,11,4492,2,2,9,10,13,3,11,2,11,0,False,False,False,0,2,2020-10-26T12:50:04.757,13,,2.0
2020,7,2887,295,11,100,2,11,2,18,36,18,36,0,36,0,False,False,False,0,3,2020-10-28T03:25:24.133,36,,0.0
2020,7,2887,305,11,7732,2,46,3,1,1,0,1,0,1,0,False,False,False,0,1,2020-10-26T12:59:32.27,1,,0.0
2020,7,2887,310,11,6810,2,46,3,3,9,6,6,3,6,0,False,False,False,0,4,2020-10-26T13:01:13.71,9,,3.0
2020,7,2887,320,2,5214,13,47,5,6,0,0,0,0,0,0,False,False,False,0,4,2020-10-26T13:07:33.023,0,,0.0
2020,7,2887,330,2,5223,2,29,6,27,27,0,27,0,27,0,False,False,False,0,3,2020-10-26T13:11:28.153,27,,0.0
2020,7,2887,340,2,4670,2,12,4,1,11,10,9,2,9,0,False,False,False,0,1,2021-03-02T21:58:15.757,11,,2.0
2020,7,2887,350,2,5214,2,4,9,10,17,7,14,3,14,0,True,False,False,0,3,2020-10-29T14:56:57.96,17,,3.0
2020,7,2887,365,2,6342,2,47,5,4,4,0,4,0,4,0,False,False,False,0,3,2021-02-24T19:34:32.803,4,,0.0
2020,7,2887,370,2,661,2,4,10,7,13,6,10,3,10,0,True,False,False,0,3,2020-10-27T15:57:26.097,13,,3.0
2020,7,2887,375,2,661,2,6,4,10,13,3,11,2,11,0,False,False,False,0,3,2020-10-29T16:40:06.533,13,,2.0
2020,7,2887,395,2,5223,13,35,3,4,0,0,0,0,0,0,True,False,False,0,3,2021-02-25T14:44:53.447,0,,0.0
2020,7,2887,400,2,5223,2,2,9,4,4,0,4,0,4,6,False,False,False,0,2,2020-10-26T13:34:13.58,4,,0.0
2020,7,2887,415,11,6810,2,5,5,7,10,3,10,0,10,0,False,False,False,0,3,2020-10-26T13:36:28.99,10,,0.0
2020,7,2887,425,11,4492,2,8,7,17,18,1,17,1,17,0,False,False,False,0,2,2020-10-26T13:39:16.767,18,,1.0
2020,7,2887,440,11,914,2,8,1,20,20,0,20,0,20,0,False,False,False,0,2,2020-10-26T16:49:56.343,20,,0.0
2020,7,2887,470,11,914,2,8,10,14,16,2,16,0,16,0,False,False,False,0,3,2020-10-29T17:03:46.997,16,,0.0
2020,7,2887,480,11,7732,2,48,4,-5,8,13,6,2,6,0,False,False,False,0,1,2020-10-26T13:54:58.567,8,,2.0
2020,7,2887,485,11,4492,2,12,6,29,29,0,29,0,29,0,False,False,False,0,2,2020-10-26T13:58:19.03,29,,0.0
2020,7,2887,495,11,7732,2,16,9,5,14,9,11,3,11,0,False,False,False,0,1,2020-10-26T14:07:08.23,14,,3.0
2020,7,2887,530,2,6247,2,13,9,5,9,4,8,1,8,0,True,False,False,0,3,2020-10-26T14:15:00.383,9,,1.0
2020,7,2887,540,2,990,3,44,3,0,0,0,0,0,0,0,False,False,False,0,1,2021-02-17T16:46:35.083,0,,0.0
2020,7,2887,545,2,661,2,13,9,4,5,1,4,1,4,0,True,False,False,0,3,2020-10-26T14:20:20.36,5,,1.0
2020,7,2887,560,11,4487,13,30,10,-1,0,0,0,0,0,0,False,False,False,0,3,2020-10-28T03:26:32.923,0,,0.0
2020,7,2887,565,11,100,2,51,10,-3,4,7,3,1,3,0,False,False,False,0,3,2020-10-26T14:26:42.89,4,,1.0
2020,7,2887,575,11,6810,13,4,10,8,0,0,0,0,0,0,False,False,False,0,4,2020-10-26T14:30:12.897,0,,0.0
2020,7,2887,595,2,661,2,8,10,12,17,5,15,2,15,0,False,False,False,0,3,2020-10-26T14:36:33.787,17,,2.0
2020,7,2887,605,2,5214,2,46,3,5,8,3,5,3,5,0,False,False,False,0,4,2020-10-26T14:39:31.193,8,,3.0
2020,7,2887,615,2,661,2,2,4,6,8,2,7,1,7,0,False,False,False,0,3,2020-10-27T15:58:28.39,8,,1.0
2020,7,2887,620,2,661,2,47,5,2,5,3,4,1,4,0,True,False,False,0,4,2020-10-29T17:05:32.347,5,,1.0
2020,7,2887,635,2,661,2,23,7,21,28,7,26,2,26,0,False,False,False,0,2,2020-10-26T14:56:07.98,28,,2.0
2020,7,2887,655,2,5223,2,12,5,7,7,0,7,0,7,0,False,False,False,0,2,2020-10-27T15:55:35.073,7,,0.0
2020,7,2887,660,2,6472,13,46,3,0,0,0,0,0,0,0,False,False,False,0,1,2020-10-26T15:05:47.907,0,,0.0
2020,7,2887,670,11,4492,2,9,5,13,18,5,13,5,13,0,False,False,False,0,2,2020-10-28T03:26:47.293,18,,5.0
2020,7,2887,675,11,914,2,6,7,15,15,0,15,0,15,0,False,False,False,0,3,2021-02-17T16:48:09.113,15,,0.0
2020,7,2887,680,11,914,2,50,3,-1,6,7,4,2,4,0,False,False,False,1,2,2021-02-24T19:37:40.427,6,,2.0
2020,7,2887,700,11,7732,13,47,10,-1,0,0,0,0,0,0,False,False,False,0,1,2020-10-26T15:23:33.123,0,,0.0
2020,7,2887,705,11,4492,2,2,9,7,7,0,7,0,7,0,False,False,False,0,2,2020-10-26T15:25:12.443,7,,0.0
2020,7,2887,715,2,5223,2,4,9,12,12,0,12,0,12,0,False,False,False,0,3,2020-10-26T15:35:29.383,12,,0.0
2020,7,2887,740,11,7732,2,16,10,2,-2,-4,2,-4,2,0,False,False,False,1,1,2020-10-29T16:28:40.387,-2,,-4.0
2020,7,2887,760,2,6247,2,4,10,4,6,2,5,1,5,0,False,False,False,0,2,2020-10-26T15:50:49.63,6,,1.0
2020,7,2887,765,2,6247,2,5,3,8,9,1,8,1,8,0,False,False,False,0,3,2020-10-26T15:52:31.15,9,,1.0
2020,7,2887,770,2,990,2,4,4,4,8,4,6,2,6,0,False,False,False,0,1,2020-10-26T15:53:59.453,8,,2.0
2020,7,2887,780,2,6247,2,12,9,14,16,2,16,0,16,0,False,False,False,0,3,2020-10-26T15:56:39.4,16,,0.0
2020,7,2887,785,2,6247,2,5,6,16,16,0,16,0,16,0,False,False,False,0,3,2020-10-26T15:58:34.453,16,,0.0
2020,7,2887,840,11,4492,13,3,6,15,0,0,0,0,0,0,False,False,False,0,2,2020-10-26T16:11:38.133,0,,0.0
2020,7,2887,845,11,6810,2,12,5,10,13,3,13,0,13,0,False,False,False,0,2,2021-03-08T20:08:59.543,13,,0.0
2020,7,2887,855,11,100,2,6,1,18,22,4,22,0,22,0,False,False,False,0,3,2020-10-29T17:05:47.227,22,,0.0
2020,7,2887,865,11,4492,2,8,7,29,29,0,29,0,29,0,False,False,False,0,3,2020-10-28T03:26:59.34,29,,0.0
2020,7,2887,875,11,6810,2,6,9,11,11,0,11,0,11,6,False,False,False,0,3,2020-10-28T03:27:12.683,11,,0.0
2020,8,2888,15,3,7672,3,49,3,-1,0,0,0,0,0,0,False,False,False,0,2,2021-03-04T15:30:33.773,0,,
2020,8,2888,20,3,7673,13,4,10,4,0,0,0,0,0,0,False,False,False,0,3,2021-03-05T14:14:11.323,0,,
2020,8,2888,30,3,6935,2,2,4,13,14,1,14,0,14,0,False,False,False,0,3,2020-11-06T20:01:31.403,14,,
2020,8,2888,55,3,5017,3,47,10,-1,0,0,0,0,0,0,False,False,False,0,1,2020-11-02T11:46:27.62,0,,
2020,8,2888,60,3,2688,2,12,9,6,34,28,28,6,28,0,False,False,False,0,3,2020-11-04T00:24:19.473,34,,
2020,8,2888,75,3,6935,2,7,3,6,6,0,6,0,6,6,False,False,False,0,3,2020-11-02T18:18:52.383,6,,
2020,8,2888,95,25,609,3,5,3,5,0,0,0,0,0,0,True,False,False,0,3,2020-11-02T12:05:42.573,0,,
2020,8,2888,100,25,6486,13,19,2,25,0,0,0,0,0,0,False,False,False,0,2,2020-11-02T12:08:50.52,0,,
2020,8,2888,105,25,7666,2,2,10,7,10,3,7,3,7,0,False,True,True,0,2,2020-11-03T20:44:57.107,10,,
2020,8,2888,145,25,7666,13,21,2,31,0,0,0,0,0,0,False,False,False,0,2,2020-11-02T12:27:14.187,0,,
2020,8,2888,150,25,4587,2,46,3,-1,0,1,-1,1,-1,0,False,False,False,0,1,2020-11-02T12:29:00.18,0,,
2020,8,2888,180,3,2976,13,13,10,7,0,0,0,0,0,0,False,False,False,0,4,2020-11-06T20:01:41.947,0,,
2020,8,2888,185,3,6454,2,12,10,3,3,0,3,0,3,0,False,False,False,0,4,2020-11-04T00:24:41.993,3,,
2020,8,2888,205,25,609,2,5,5,5,7,2,5,2,5,0,False,False,False,0,3,2020-11-02T13:13:15.46,7,,
2020,8,2888,210,25,7666,2,2,10,7,7,0,7,0,7,0,False,False,False,1,2,2020-11-02T13:14:12.427,7,,
2020,8,2888,215,25,6490,3,13,10,2,0,0,0,0,0,0,False,False,False,0,3,2020-11-02T13:12:46.427,0,,
2020,8,2888,220,25,6486,13,5,3,4,0,0,0,0,0,0,True,False,False,0,3,2020-11-02T13:15:32.343,0,,
2020,8,2888,260,3,6454,2,5,3,5,11,6,10,1,10,0,False,False,False,0,4,2020-11-02T13:27:15.277,11,,
2020,8,2888,285,25,7060,13,24,2,29,0,0,0,0,0,0,False,False,False,0,3,2020-11-02T13:35:39.353,0,,
2020,8,2888,310,25,7666,13,13,10,0,0,0,0,0,0,0,False,False,False,0,3,2020-11-02T13:47:29.503,0,,
2020,8,2888,355,3,6935,13,6,10,8,0,0,0,0,0,0,False,False,False,0,2,2020-11-06T18:21:58.563,0,,
2020,8,2888,375,3,2688,2,46,3,0,7,7,7,0,7,0,True,False,False,0,3,2020-11-06T16:41:08.167,7,,
2020,8,2888,385,3,2688,2,4,9,6,6,0,6,0,6,0,False,False,False,0,3,2020-11-06T16:43:01.393,6,,
2020,8,2888,400,3,6454,13,6,9,11,0,0,0,0,0,0,False,False,False,0,3,2020-11-06T18:23:55.617,0,,
2020,8,2888,405,3,2688,2,5,3,4,10,6,10,0,10,0,False,False,False,0,3,2020-11-02T14:16:10.2,10,,
2020,8,2888,440,25,4583,2,8,9,14,24,10,24,0,24,0,False,False,False,0,3,2020-11-06T18:25:49.48,24,,
2020,8,2888,445,25,7666,13,50,9,-2,0,0,0,0,0,0,False,False,False,0,2,2020-11-06T16:48:31.663,0,,
2020,8,2888,450,25,6490,13,4,10,5,0,0,0,0,0,0,False,False,False,0,3,2020-11-02T15:00:46.84,0,,
2020,8,2888,455,25,7060,13,19,6,31,0,0,0,0,0,0,False,False,False,0,2,2020-11-02T15:02:47.683,0,,
2020,8,2888,465,3,6454,13,5,3,6,0,0,0,0,0,0,False,False,False,0,4,2021-03-05T14:14:49.673,0,,
2020,8,2888,475,25,609,2,13,10,3,18,15,18,0,18,6,False,False,False,0,3,2020-11-02T15:10:05.663,18,,
2020,8,2888,505,3,7671,13,26,10,4,0,0,0,0,0,0,True,False,False,0,3,2020-11-02T15:18:56.767,0,,
2020,8,2888,520,25,609,2,7,5,14,14,0,14,0,14,0,False,False,False,0,3,2020-11-02T15:22:58.73,14,,
2020,8,2888,525,25,6259,13,9,6,22,0,0,0,0,0,0,False,False,False,0,3,2020-11-02T15:24:47.737,0,,
2020,8,2888,530,25,7666,2,5,3,5,9,4,9,0,9,0,False,False,False,0,3,2020-11-02T15:27:26.24,9,,
2020,8,2888,535,25,7666,2,4,3,8,8,0,8,0,8,0,False,False,False,0,2,2020-11-02T15:29:09.097,8,,
2020,8,2888,545,25,4587,2,48,9,-4,13,17,4,9,4,0,False,False,False,1,1,2021-03-03T15:14:45.127,13,,
2020,8,2888,550,25,4583,2,39,4,5,7,2,6,1,6,0,False,False,False,0,3,2020-11-02T15:34:25.153,7,,
2020,8,2888,560,25,4583,2,17,9,8,14,6,9,5,9,0,False,False,False,1,3,2021-03-03T15:15:56.307,14,,
2020,8,2888,595,3,6454,2,12,10,10,18,8,18,0,18,0,False,True,False,0,3,2020-11-06T18:26:59.747,18,,
2020,8,2888,605,3,6659,3,44,3,-4,0,0,0,0,0,0,False,False,False,0,1,2020-11-02T15:50:46.44,0,,
2020,8,2888,625,25,4583,13,6,4,9,0,0,0,0,0,0,False,False,False,0,2,2020-11-06T20:02:14.037,0,,
2020,8,2888,630,25,4587,2,18,3,-2,0,2,0,0,0,0,False,False,False,0,2,2020-11-02T16:00:01.41,0,,
2020,8,2888,655,3,7672,2,8,1,37,39,2,39,0,39,0,False,False,False,0,3,2020-11-06T18:29:48.867,39,,
2020,8,2888,670,3,2688,2,4,4,8,24,16,17,7,17,0,False,False,False,0,3,2020-11-02T16:27:58.593,24,,
2020,8,2888,680,3,6936,13,13,3,3,0,0,0,0,0,0,False,False,False,0,3,2020-11-02T16:31:58.053,0,,
2020,8,2888,685,3,6936,2,4,10,3,3,0,3,0,3,6,False,False,False,0,3,2020-11-02T18:20:21.357,3,,
2020,8,2888,700,25,7666,13,9,2,27,0,0,0,0,0,0,False,False,False,0,2,2020-11-02T16:39:32.357,0,,
2020,8,2888,705,25,609,2,13,4,4,9,5,4,5,4,0,False,False,False,0,3,2020-11-02T16:41:50.57,9,,
2020,8,2888,710,25,6259,2,13,9,0,6,6,6,0,6,0,False,False,False,0,3,2020-11-02T16:43:32.907,6,,
2020,8,2888,715,25,4583,2,39,9,3,4,1,4,0,4,0,False,False,False,0,3,2020-11-02T16:46:16.907,4,,
2020,8,2888,720,25,4583,2,5,3,5,5,0,5,0,5,0,False,False,False,0,3,2020-11-02T16:47:52.763,5,,
2020,8,2888,725,25,4583,2,51,10,-2,2,4,-1,3,-1,0,False,False,False,0,3,2020-11-02T16:50:48.573,2,,
2020,8,2888,730,25,7666,13,7,2,26,0,0,0,0,0,0,False,False,False,0,3,2021-02-17T15:37:14.733,0,,
2020,8,2888,735,25,4583,2,2,10,2,11,9,4,7,4,0,False,False,False,1,2,2020-11-06T16:55:55.377,11,,
2020,8,2888,740,25,7666,2,7,5,8,8,0,8,0,8,6,False,False,False,0,3,2020-11-02T16:57:47.813,8,,
2020,8,2888,820,25,7060,2,13,10,1,6,5,6,0,6,0,False,False,False,0,2,2020-11-02T17:24:35.917,6,,
2020,8,2888,850,3,7671,2,4,9,4,8,4,5,3,5,0,False,False,False,2,1,2020-11-06T18:16:26.05,8,,
2020,8,2888,855,3,6454,13,4,4,5,0,0,0,0,0,0,False,False,False,0,3,2020-11-02T17:38:36.27,0,,
2020,8,2888,860,3,2688,2,8,1,22,32,10,23,9,23,0,False,False,False,1,3,2020-11-02T17:41:26.183,32,,
2020,8,2888,875,3,7672,13,5,5,5,0,0,0,0,0,0,False,False,False,0,2,2020-11-02T18:12:51.063,0,,
2020,8,2888,880,3,2688,13,17,7,23,0,0,0,0,0,0,False,False,False,0,3,2020-11-02T18:29:58.25,0,,
2020,7,2889,10,7,6975,2,53,9,-2,6,8,4,2,4,0,False,False,False,1,4,2020-10-26T16:52:46.483,6,,2.0
2020,7,2889,20,7,910,2,29,3,13,17,4,16,1,16,0,False,False,False,0,3,2020-10-26T09:58:48.233,17,,1.0
2020,7,2889,30,7,910,13,8,1,45,0,0,0,0,0,0,False,False,False,0,2,2021-03-08T20:12:09.463,0,,0.0
2020,7,2889,35,7,3521,2,49,10,-3,-2,1,-2,0,-2,0,False,False,False,0,2,2021-03-04T14:54:08.7,-2,,0.0
2020,7,2889,45,7,3445,2,35,2,29,29,0,29,0,29,0,False,False,False,0,3,2020-10-26T10:07:30.067,29,,0.0
2020,7,2889,60,7,3521,2,46,9,2,14,12,11,3,11,0,False,False,False,0,3,2020-10-26T16:56:14.35,14,,3.0
2020,7,2889,65,7,3521,13,2,10,2,0,0,0,0,0,0,False,False,False,0,3,2021-03-05T19:36:47.607,0,,0.0
2020,7,2889,75,8,1067,13,19,2,35,0,0,0,0,0,0,False,False,False,0,2,2021-03-05T19:38:00.8,0,,0.0
2020,7,2889,80,7,3521,2,42,4,5,13,8,8,5,8,0,False,False,False,0,3,2020-10-26T16:56:28.43,13,,5.0
2020,7,2889,85,7,3521,13,36,10,11,0,0,0,0,0,0,False,False,False,0,3,2020-10-26T10:29:35.673,0,,
2020,7,2889,120,8,5053,3,48,9,-5,0,0,0,0,0,0,False,False,False,0,1,2021-02-24T16:00:53.89,0,,0.0
2020,7,2889,125,8,7652,13,5,3,14,0,0,0,0,0,0,True,False,False,0,3,2021-02-24T19:05:11.99,0,,0.0
2020,7,2889,140,7,910,13,4,9,13,0,0,0,0,0,0,False,False,False,0,2,2020-10-26T11:01:14.773,0,,0.0
2020,7,2889,145,7,6975,2,51,9,0,10,10,7,3,7,0,False,False,False,0,3,2020-10-26T16:53:00.107,10,,3.0
2020,7,2889,155,7,3521,2,4,10,8,7,-1,7,0,7,0,False,False,False,0,3,2020-10-26T16:56:39.073,7,,0.0
2020,7,2889,160,7,3445,3,5,5,9,0,0,0,0,0,0,False,False,False,0,3,2020-10-26T11:13:15.827,0,,0.0
2020,7,2889,180,8,4976,13,9,6,23,0,0,0,0,0,0,False,False,False,0,3,2021-02-24T16:33:34.547,0,,0.0
2020,7,2889,185,8,232,13,17,9,14,0,0,0,0,0,0,False,False,False,0,3,2021-03-08T17:42:46.25,0,,0.0
2020,7,2889,210,7,910,2,29,6,21,22,1,21,1,21,0,False,False,False,0,2,2020-10-26T11:34:32.71,22,,1.0
2020,7,2889,220,7,931,2,48,9,-5,25,30,22,3,22,0,False,False,False,0,1,2020-10-26T16:50:53.657,25,,3.0
2020,7,2889,225,7,910,2,4,3,4,4,0,4,0,4,0,False,False,False,0,2,2020-10-26T11:40:23.82,4,,0.0
2020,7,2889,235,7,3521,2,51,10,-2,4,6,3,1,3,0,False,False,False,0,3,2020-10-26T16:56:53.487,4,,1.0
2020,7,2889,240,7,4455,2,45,5,-4,3,7,2,1,2,0,False,False,False,0,1,2020-10-26T11:51:24.783,3,,1.0
2020,7,2889,245,7,3521,13,35,10,11,0,0,0,0,0,0,False,False,False,0,3,2020-10-26T11:51:51.51,0,,0.0
2020,7,2889,265,8,232,2,5,10,6,28,22,16,12,16,0,False,False,False,2,3,2020-10-30T15:03:09.697,28,,12.0
2020,7,2889,270,8,232,2,34,4,-4,-6,-2,-6,0,-6,0,True,False,False,0,3,2021-02-15T17:12:33.493,-3,,0.0
2020,7,2889,305,8,3606,2,2,9,8,10,2,10,0,10,0,False,False,False,0,2,2020-10-26T12:12:37.5,10,,0.0
2020,7,2889,320,8,232,2,50,9,-2,11,13,7,4,7,0,True,False,False,0,2,2021-02-24T17:02:44.323,11,,4.0
2020,7,2889,325,8,7652,2,5,9,2,3,1,3,0,3,6,False,False,False,0,4,2020-10-30T14:16:28.663,3,,0.0
2020,7,2889,345,7,7659,2,2,10,4,7,3,5,2,5,0,False,False,False,0,2,2020-10-30T14:06:50.16,7,,2.0
2020,7,2889,350,7,7659,2,29,2,23,27,4,24,3,24,0,False,False,False,0,2,2020-10-26T12:30:55.333,27,,3.0
2020,7,2889,360,7,931,2,47,5,2,5,3,5,0,5,0,False,False,False,0,1,2020-10-26T16:46:59.367,5,,0.0
2020,7,2889,365,7,931,2,48,10,-4,23,27,23,0,23,0,False,False,False,0,1,2021-02-17T17:12:43.957,10,,0.0
2020,7,2889,370,7,910,2,2,9,8,13,5,11,2,11,0,False,False,False,0,3,2020-10-26T12:39:45.927,13,,2.0
2020,7,2889,375,7,3521,2,4,10,7,9,2,7,2,7,0,False,False,False,1,3,2020-10-30T15:34:53.457,9,,2.0
2020,7,2889,405,7,3521,2,4,4,11,11,0,11,0,11,6,False,False,False,0,3,2020-10-26T16:57:20.187,11,,0.0
2020,7,2889,435,8,7652,2,5,6,15,35,20,24,11,24,0,True,False,False,1,3,2021-03-03T14:09:33.82,35,,11.0
2020,7,2889,445,8,232,2,4,10,8,8,0,8,0,8,0,False,False,False,0,2,2020-10-26T13:01:38.02,8,,0.0
2020,7,2889,450,8,4976,2,39,4,3,4,1,3,1,3,0,False,False,False,0,4,2020-10-26T13:05:13.02,4,,1.0
2020,7,2889,460,8,7652,2,6,10,5,12,7,6,6,6,0,False,False,False,1,3,2021-02-24T17:36:49.803,12,,6.0
2020,7,2889,475,8,7652,2,6,10,6,6,0,6,0,6,6,True,False,False,0,3,2021-02-24T17:38:44.777,6,,0.0
2020,7,2889,495,7,3521,2,35,2,16,16,0,16,0,16,0,False,False,False,0,3,2020-10-26T16:57:33.07,16,,0.0
2020,7,2889,500,7,6975,2,47,5,3,6,3,4,2,4,0,False,False,False,0,4,2020-10-26T16:53:18.967,6,,2.0
2020,7,2889,515,7,910,2,2,9,7,10,3,8,2,8,0,False,False,False,0,3,2020-10-26T13:34:25.217,10,,2.0
2020,7,2889,525,7,931,2,48,5,-7,16,23,11,5,11,0,False,False,False,0,1,2020-10-30T16:02:49.113,16,,5.0
2020,7,2889,545,7,3521,2,39,4,4,5,1,4,1,4,0,False,False,False,0,3,2020-10-26T16:57:52.783,5,,1.0
2020,7,2889,550,7,910,13,9,5,4,0,0,0,0,0,0,False,False,False,0,2,2020-10-26T13:54:55.563,0,,0.0
2020,7,2889,570,8,232,2,26,5,4,4,0,4,0,4,0,False,False,False,0,2,2021-02-24T18:05:58.913,4,,0.0
2020,7,2889,575,8,7651,13,9,2,15,0,0,0,0,0,0,False,False,False,0,2,2020-10-30T14:38:29.143,0,,
2020,7,2889,585,8,5053,2,44,9,-5,6,11,3,3,3,0,False,False,False,1,1,2020-10-30T16:13:50.253,6,,3.0
2020,7,2889,595,8,3606,2,29,6,15,21,6,21,0,21,0,False,False,False,0,3,2020-10-26T14:22:52.077,21,,0.0
2020,7,2889,600,8,3606,2,43,6,18,21,3,21,0,21,0,False,False,False,0,3,2020-10-30T16:04:35.273,21,,0.0
2020,7,2889,610,8,4976,2,17,1,16,16,0,16,0,16,6,False,False,False,0,4,2021-02-17T16:58:30.533,16,,0.0
2020,7,2889,625,7,910,2,4,5,5,6,1,5,1,5,0,False,False,False,0,2,2020-10-26T14:31:32.28,6,,1.0
2020,7,2889,630,7,7659,2,5,5,9,9,0,9,0,9,0,False,False,False,0,3,2020-10-26T14:33:44.687,9,,0.0
2020,7,2889,640,7,6975,2,4,10,5,14,9,9,5,9,0,False,False,False,0,3,2020-10-26T16:53:38.997,14,,5.0
2020,7,2889,645,7,910,13,9,3,13,0,0,0,0,0,0,False,False,False,0,2,2021-03-17T19:08:09.74,0,,0.0
2020,7,2889,655,7,910,13,6,7,18,0,0,0,0,0,0,False,False,False,0,3,2020-10-26T14:54:07.277,0,,0.0
2020,7,2889,660,7,6975,2,46,3,2,16,14,14,2,14,0,False,False,False,0,4,2021-02-17T17:00:03.553,16,,2.0
2020,7,2889,675,7,910,2,4,3,5,10,5,5,5,5,0,False,False,False,1,2,2020-10-26T15:03:12.91,10,,5.0
2020,7,2889,680,7,6975,13,7,6,15,0,0,0,0,0,0,False,False,False,0,4,2020-10-30T14:55:32.41,0,,0.0
2020,7,2889,685,7,7659,2,6,4,5,16,11,7,9,7,6,False,False,False,3,2,2020-10-30T15:40:49.087,16,,9.0
2020,7,2889,700,8,3606,2,35,6,19,20,1,20,0,20,0,False,False,False,0,3,2020-10-26T15:15:12.157,20,,0.0
2020,7,2889,715,8,7651,2,22,6,18,19,1,19,0,19,0,False,False,False,0,3,2021-02-24T19:11:23.573,19,,0.0
2020,7,2889,725,8,5053,2,44,9,-5,12,17,5,7,5,0,False,False,False,0,1,2020-10-26T16:44:23.033,12,,7.0
2020,7,2889,735,8,5053,2,46,3,1,8,7,8,0,8,6,False,False,False,0,1,2020-10-26T17:18:34.66,8,,0.0
2020,7,2889,750,7,7659,2,2,10,9,12,3,12,0,12,0,False,False,False,0,2,2020-10-26T15:34:07.193,12,,0.0
2020,7,2889,755,7,3521,2,2,9,5,15,10,8,7,8,0,False,False,False,1,3,2020-10-26T15:42:33.93,15,,7.0
2020,7,2889,760,7,3445,2,12,9,12,25,13,21,4,21,0,False,False,False,0,2,2021-03-08T20:13:04.223,25,,4.0
2020,7,2889,770,7,910,13,9,2,23,0,0,0,0,0,0,False,False,False,0,3,2020-10-26T15:50:48.113,0,,0.0
2020,7,2889,775,7,3521,2,4,10,8,9,1,8,1,8,0,False,False,False,0,3,2020-10-26T15:53:58.063,9,,1.0
2020,7,2889,825,7,931,2,47,10,1,3,2,1,2,1,6,True,False,False,0,3,2020-10-26T17:15:41.123,3,,2.0
2020,7,2889,840,8,7651,2,6,4,8,13,5,13,0,13,0,False,False,False,0,2,2020-10-26T16:14:34.207,13,,0.0
2020,7,2889,845,8,3606,2,4,5,8,8,0,8,0,8,0,False,False,False,0,2,2020-10-26T16:16:47.877,8,,0.0
2020,7,2889,850,8,3606,2,19,2,28,30,2,28,2,28,0,False,False,False,0,3,2020-10-26T16:19:37.603,30,,2.0
2020,7,2889,865,8,7651,2,19,2,24,24,0,24,0,24,6,False,False,False,0,2,2020-10-26T16:26:06.843,24,,0.0
2020,7,2889,880,7,7659,13,19,8,56,0,0,0,0,0,0,False,False,False,0,2,2020-10-30T16:07:42.92,0,,0.0
2020,7,2890,30,12,4561,2,13,10,3,17,14,12,5,12,0,False,False,False,0,3,2020-10-27T18:31:00.47,17,,5.0
2020,7,2890,35,12,6357,13,5,3,6,0,0,0,0,0,0,False,False,False,0,2,2020-10-29T15:23:35.46,0,,0.0
2020,7,2890,40,12,467,2,4,3,4,9,5,7,2,7,0,False,False,False,1,2,2020-10-27T18:31:22.063,9,,2.0
2020,7,2890,45,12,556,2,13,10,2,8,6,6,2,6,0,False,False,False,0,3,2020-10-26T10:28:00.993,8,,2.0
2020,7,2890,55,12,556,2,34,4,-4,0,4,0,0,0,0,True,False,False,0,3,2020-10-29T19:35:23.263,0,,0.0
2020,7,2890,60,12,556,2,26,5,2,3,1,3,0,3,6,False,False,False,0,2,2020-10-26T10:32:17.313,3,,0.0
2020,7,2890,75,13,3951,2,4,9,4,5,1,5,0,5,0,False,False,False,0,3,2020-10-29T17:15:55.19,5,,0.0
2020,7,2890,95,12,467,13,11,6,18,0,0,0,0,0,0,False,False,False,0,4,2020-10-26T10:40:13.493,0,,0.0
2020,7,2890,110,12,6869,13,4,5,11,0,0,0,0,0,0,False,False,False,0,2,2020-10-26T10:44:40.68,0,,0.0
2020,7,2890,125,13,496,2,4,9,5,6,1,6,0,6,0,False,False,False,0,3,2020-10-29T19:43:04.24,6,,0.0
2020,7,2890,130,13,2136,2,6,9,13,16,3,16,0,16,0,False,False,False,0,3,2020-10-26T17:31:45.367,16,,0.0
2020,7,2890,135,13,3951,3,6,9,12,0,0,0,0,0,0,False,False,False,0,3,2021-02-17T17:45:02.447,0,,0.0
2020,7,2890,145,13,2136,13,24,3,13,0,0,0,0,0,0,False,False,False,0,3,2021-03-09T16:17:37.447,0,,0.0
2020,7,2890,160,12,556,2,13,4,3,8,5,6,2,6,0,False,False,False,0,3,2020-10-29T20:09:58.59,8,,2.0
2020,7,2890,170,12,4511,2,32,10,0,1,1,0,1,0,0,False,False,False,0,4,2020-10-29T19:05:12.89,1,,1.0
2020,7,2890,175,12,556,2,9,6,22,28,6,28,0,28,0,False,False,False,0,2,2020-10-26T11:09:15.533,28,,0.0
2020,7,2890,190,12,556,2,35,6,18,36,18,31,5,31,0,False,False,False,0,3,2020-10-26T11:19:39.003,36,,5.0
2020,7,2890,200,12,6876,2,30,10,-1,3,4,3,0,3,6,False,False,False,0,4,2020-10-26T11:22:31.963,3,,0.0
2020,7,2890,220,13,876,2,13,9,4,5,1,5,0,5,0,False,False,False,0,3,2020-10-26T11:30:58.213,5,,0.0
2020,7,2890,240,13,876,2,52,4,4,8,4,7,1,7,0,False,False,False,0,3,2020-10-26T11:35:50.713,8,,1.0
2020,7,2890,250,12,4511,2,11,6,26,31,5,31,0,31,0,False,False,False,0,3,2020-10-26T17:16:23.997,31,,0.0
2020,7,2890,265,12,6357,13,12,3,10,0,0,0,0,0,0,False,False,False,0,3,2021-02-25T14:47:50.063,0,,0.0
2020,7,2890,285,13,496,2,42,4,3,12,9,12,0,12,0,False,False,False,0,3,2020-10-26T12:00:58.54,12,,0.0
2020,7,2890,290,13,496,2,2,9,6,8,2,8,0,8,0,False,False,False,0,3,2020-10-26T12:01:11.813,8,,0.0
2020,7,2890,295,13,3951,2,17,7,20,24,4,23,1,23,0,False,False,False,0,3,2020-10-26T12:02:55.837,24,,1.0
2020,7,2890,305,13,496,2,7,6,24,28,4,28,0,28,0,True,False,False,0,3,2020-10-26T12:06:25.61,28,,0.0
2020,7,2890,310,13,876,2,51,3,-5,16,21,3,13,3,0,True,False,False,1,3,2020-10-29T20:10:17.78,16,,
2020,7,2890,315,13,3951,13,6,9,5,0,0,0,0,0,0,False,False,False,0,3,2020-10-26T12:10:24.83,0,,0.0
2020,7,2890,325,13,496,2,12,5,14,14,0,14,0,14,0,False,False,False,0,3,2020-10-29T19:12:46.793,14,,0.0
2020,7,2890,335,12,556,2,6,9,13,15,2,15,0,15,0,False,False,False,0,3,2020-10-26T12:23:47.49,15,,0.0
2020,7,2890,340,12,556,13,29,3,10,0,0,0,0,0,0,False,False,False,0,2,2021-02-25T14:49:06.01,0,,0.0
2020,7,2890,355,12,556,2,50,9,-2,16,18,12,4,12,0,False,False,False,0,3,2021-02-23T22:36:29.48,16,,4.0
2020,7,2890,360,12,4561,2,4,9,1,6,5,3,3,3,0,False,False,False,0,1,2020-10-26T12:29:07.003,6,,3.0
2020,7,2890,370,12,4561,2,48,9,-2,15,17,9,6,9,0,False,False,False,1,1,2020-10-29T20:10:39.333,15,,6.0
2020,7,2890,390,12,7460,2,32,9,1,1,0,1,0,1,6,False,False,False,0,4,2020-10-26T12:37:22.15,1,,0.0
2020,7,2890,435,13,496,2,6,9,7,9,2,8,1,8,0,False,False,False,0,3,2020-10-26T13:56:37.147,9,,1.0
2020,7,2890,440,13,876,2,5,5,6,11,5,10,1,10,0,False,False,False,0,3,2021-02-17T18:02:01.807,11,,1.0
2020,7,2890,445,13,2136,13,2,9,7,0,0,0,0,0,0,False,False,False,0,3,2020-10-29T17:55:38.107,0,,
2020,7,2890,455,13,876,2,4,3,5,8,3,7,1,7,0,False,False,False,0,3,2020-10-26T14:02:58.81,8,,1.0
2020,7,2890,465,13,876,2,13,10,7,8,1,8,0,8,0,False,False,False,0,3,2020-10-26T14:05:20.627,8,,0.0
2020,7,2890,470,13,2455,2,44,9,-5,16,21,15,1,15,0,False,False,False,0,1,2020-10-26T14:07:02.743,16,,1.0
2020,7,2890,480,13,2455,2,12,3,3,3,0,3,0,3,6,False,False,False,0,1,2020-10-26T17:33:41.173,3,,0.0
2020,7,2890,495,12,556,2,18,10,0,6,6,4,2,4,0,False,False,False,0,3,2021-02-17T18:03:23.297,6,,2.0
2020,7,2890,500,12,4561,2,34,4,-4,-1,3,-4,3,-4,0,True,False,False,1,3,2021-03-04T14:56:14.277,-1,,3.0
2020,7,2890,505,12,556,2,13,5,2,9,7,9,0,9,0,True,False,False,0,2,2020-10-27T18:41:45.917,9,,0.0
2020,7,2890,510,12,7460,2,30,9,-4,5,9,5,0,5,0,False,False,False,0,3,2020-10-26T14:18:30.937,5,,0.0
2020,7,2890,525,12,556,13,6,9,11,0,0,0,0,0,0,False,False,False,0,3,2020-10-29T17:25:33.917,0,,0.0
2020,7,2890,530,12,556,2,19,2,23,45,22,45,0,45,6,False,False,False,1,3,2020-10-26T14:24:35.377,45,,0.0
2020,7,2890,545,13,876,3,2,10,8,0,0,0,0,0,0,False,False,False,0,3,2020-10-26T14:26:53.013,0,,0.0
2020,7,2890,550,13,404,2,5,5,5,6,1,6,0,6,0,True,False,False,0,1,2020-10-26T17:19:55.747,6,,0.0
2020,7,2890,555,13,496,13,4,9,5,0,0,0,0,0,0,True,False,False,0,3,2020-10-27T15:53:36.363,0,,0.0
2020,7,2890,570,12,467,13,12,5,8,0,0,0,0,0,0,False,False,False,0,2,2020-10-27T18:32:09.777,0,,0.0
2020,7,2890,575,12,556,13,9,6,17,0,0,0,0,0,0,False,False,False,0,2,2020-10-29T19:18:26.417,0,,0.0
2020,7,2890,590,13,404,2,47,5,1,9,8,6,3,6,0,False,False,False,0,1,2020-10-26T17:20:11.62,9,,3.0
2020,7,2890,595,13,404,2,30,10,0,30,30,27,3,27,0,False,False,False,1,1,2021-02-17T18:04:58.043,30,,3.0
2020,7,2890,600,13,404,2,50,9,-4,1,5,0,1,0,0,False,False,False,1,3,2020-10-29T20:11:38.78,1,,1.0
2020,7,2890,635,12,556,2,49,9,0,6,6,1,5,1,0,False,False,False,0,3,2021-02-17T18:05:56.567,6,,5.0
2020,7,2890,650,13,496,2,45,10,-6,5,11,1,4,1,0,True,False,False,1,2,2021-02-17T18:07:18.097,5,,4.0
2020,7,2890,665,13,496,13,2,10,8,0,0,0,0,0,0,True,False,False,0,3,2020-10-27T15:53:24.277,0,,0.0
2020,7,2890,670,13,2136,3,5,5,6,0,0,0,0,0,0,False,False,False,0,3,2020-10-26T16:02:13.983,0,,0.0
2020,7,2890,675,13,404,2,32,3,-1,-3,-2,-2,-1,-2,0,False,False,False,0,1,2020-10-29T19:36:08.453,-3,,-1.0
2020,7,2890,695,12,4561,3,50,3,-4,0,0,0,0,0,0,False,False,False,0,2,2021-02-23T23:13:24.007,0,,0.0
2020,7,2890,700,12,6357,3,3,3,13,0,0,0,0,0,0,False,False,False,0,2,2021-02-17T18:08:54.097,0,,0.0
2020,7,2890,720,13,876,2,12,6,17,16,-1,16,0,16,0,False,False,False,0,3,2021-03-08T20:20:35.72,16,,
2020,7,2890,765,12,556,2,29,5,14,16,2,16,0,16,0,False,False,False,0,2,2021-02-25T14:49:54.563,16,,0.0
2020,7,2890,795,13,2455,2,4,10,4,15,11,12,3,12,0,False,False,False,0,1,2020-10-26T16:52:36.23,15,,3.0
2020,7,2890,800,13,496,2,6,10,13,13,0,13,0,13,0,False,False,False,0,3,2020-10-26T16:54:15.597,13,,0.0
2020,7,2890,805,13,2136,2,35,8,18,18,0,18,0,18,0,False,False,False,0,2,2020-10-26T16:55:34.877,18,,0.0
2020,7,2890,815,13,876,2,39,4,5,8,3,8,0,8,0,False,False,False,0,3,2020-10-26T16:57:36.247,8,,0.0
2020,7,2890,825,13,876,2,3,3,13,12,-1,12,0,12,0,False,False,False,0,2,2020-10-26T17:06:16.953,12,,0.0
2020,7,2890,830,13,876,13,12,10,6,0,0,0,0,0,0,False,False,False,0,2,2020-10-29T19:34:00.063,0,,0.0
2020,7,2890,835,13,3951,13,6,4,6,0,0,0,0,0,0,False,False,False,0,2,2020-10-26T17:32:15.797,0,,0.0
2020,7,2890,840,13,3951,2,4,9,5,6,1,5,1,5,6,True,False,False,0,2,2020-10-26T17:10:34.41,6,,1.0
2020,7,2890,855,13,2455,2,4,4,4,8,4,6,2,6,0,False,True,True,1,1,2020-10-29T20:12:29.893,8,,2.0
2020,10,2891,20,26,7453,2,50,9,-2,6,8,4,2,4,0,False,False,False,0,2,2020-11-16T13:17:54.597,6,,2
2020,10,2891,45,26,309,2,49,10,-2,11,13,11,0,11,0,False,False,False,0,3,2020-11-16T13:32:49.777,11,,0
2020,10,2891,65,26,4282,2,35,7,17,17,0,17,0,17,0,False,False,False,0,4,2020-11-16T13:47:31.313,17,,0
2020,10,2891,80,26,309,13,5,9,5,0,0,0,0,0,0,True,False,False,0,3,2020-11-19T15:58:05.6,0,,0
2020,10,2891,95,17,6274,2,7,6,20,23,3,23,0,23,0,False,False,False,0,4,2020-11-16T14:04:22.8,23,,0
2020,10,2891,105,17,4305,2,5,3,13,13,0,13,0,13,0,False,False,False,0,3,2020-11-16T14:08:17.817,13,,0
2020,10,2891,120,17,6274,13,8,7,17,0,0,0,0,0,0,False,False,False,0,4,2020-11-16T14:19:08.737,0,,0
2020,10,2891,125,17,4305,2,6,10,9,15,6,9,6,9,0,False,False,False,3,2,2020-11-16T14:23:09.56,15,,6
2020,10,2891,155,17,2253,13,29,5,3,0,0,0,0,0,0,False,False,False,0,2,2020-11-19T15:53:53.81,0,,0
2020,10,2891,160,17,4305,2,4,10,3,3,0,3,0,3,6,False,False,False,0,3,2020-11-16T14:48:16.643,3,,0
2020,10,2891,180,26,309,13,35,6,15,0,0,0,0,0,0,False,False,False,0,4,2020-11-16T14:56:29.73,0,,0
2020,10,2891,185,26,7453,2,13,10,1,9,8,6,3,6,0,False,False,False,0,3,2020-11-16T15:00:43.703,9,,3
2020,10,2891,200,17,6274,3,38,5,14,0,0,0,0,0,0,False,False,False,0,4,2020-11-16T15:08:43.507,0,,0
2020,10,2891,210,17,2253,2,29,2,20,23,3,23,0,23,0,False,False,False,0,2,2020-11-16T15:31:13.487,23,,0
2020,10,2891,215,17,2253,2,39,10,7,8,1,8,0,8,0,False,False,False,0,3,2020-11-16T15:30:59.7,8,,0
2020,10,2891,220,17,2253,13,29,5,11,0,0,0,0,0,0,False,False,False,0,2,2020-11-16T15:34:49.337,0,,0
2020,10,2891,225,17,6276,2,55,4,-2,7,9,5,2,5,0,False,False,False,0,4,2021-02-18T17:59:22.173,7,,2
2020,10,2891,265,26,7453,2,51,5,-3,5,8,5,0,5,0,True,False,False,0,3,2020-11-16T16:08:27.523,5,,0
2020,10,2891,345,26,6277,2,46,3,0,5,5,4,1,4,0,False,False,False,0,1,2020-11-16T16:41:07.913,5,,1
2020,10,2891,350,26,6277,2,28,9,0,6,6,1,5,1,0,False,False,False,0,1,2020-11-16T16:43:51.64,6,,5
2020,10,2891,355,26,6277,13,16,10,0,0,0,0,0,0,0,False,False,False,0,1,2020-11-16T16:46:12.217,0,,0
2020,10,2891,360,26,4282,13,7,6,18,0,0,0,0,0,0,False,False,False,0,3,2020-11-16T16:49:17.803,0,,0
2020,10,2891,365,26,4282,13,2,9,10,0,0,0,0,0,0,False,False,False,0,3,2021-01-12T23:30:25.463,0,,0
2020,10,2891,380,17,7634,2,5,3,5,13,8,5,8,5,0,False,False,False,2,3,2020-11-16T16:58:19.663,13,,8
2020,10,2891,385,17,2253,13,7,9,14,0,0,0,0,0,0,False,False,False,0,3,2020-11-16T17:00:49.837,0,,0
2020,10,2891,400,17,4305,13,12,2,30,0,0,0,0,0,0,False,False,False,0,2,2020-11-19T15:54:19.283,0,,0
2020,10,2891,435,17,2253,3,2,10,10,0,0,0,0,0,0,False,False,False,0,3,2020-11-16T17:24:24.243,0,,0
2020,10,2891,450,17,6274,13,5,5,13,0,0,0,0,0,0,False,False,False,0,3,2020-11-16T17:29:35.793,0,,0
2020,10,2891,460,26,309,2,50,3,-2,15,17,15,0,15,0,False,False,False,0,2,2020-11-16T17:32:55.76,15,,0
2020,10,2891,465,26,8177,2,28,10,1,9,8,8,1,8,0,True,False,False,0,1,2020-11-16T17:35:08.367,9,,1
2020,10,2891,485,26,4619,2,4,3,6,10,4,6,4,6,0,False,False,False,0,2,2020-11-16T17:44:53.5,10,,4
2020,10,2891,510,26,4282,2,12,5,2,2,0,2,0,2,6,False,False,False,0,4,2020-11-16T20:25:44.62,2,,0
2020,10,2891,530,17,6274,2,2,4,13,17,4,15,2,15,0,False,False,False,0,4,2021-02-25T15:48:18.883,17,,2
2020,10,2891,535,17,7634,2,4,10,7,8,1,8,0,8,0,False,False,False,0,3,2020-11-16T18:05:15.037,8,,0
2020,10,2891,550,17,4484,2,8,7,17,19,2,19,0,19,0,False,False,False,0,4,2020-11-16T18:13:47.54,19,,0
2020,10,2891,565,17,2253,13,7,6,17,0,0,0,0,0,0,False,False,False,0,2,2020-11-19T16:15:27.723,0,,0
2020,10,2891,580,26,6277,2,48,3,-8,9,17,9,0,9,0,False,False,False,0,1,2020-11-16T18:33:15.92,9,,0
2020,10,2891,590,26,6277,2,32,5,-4,16,20,14,2,14,0,False,False,False,1,1,2020-11-16T18:37:30.783,16,,2
2020,10,2891,610,26,4619,13,5,2,15,0,0,0,0,0,0,False,False,False,0,2,2020-11-16T18:44:13.133,0,,0
2020,10,2891,615,17,4305,2,5,3,12,12,0,12,0,12,0,False,False,False,0,3,2020-11-16T18:46:41.85,12,,0
2020,10,2891,630,17,7618,2,48,10,-1,5,6,4,1,4,0,False,False,False,0,1,2020-11-16T18:56:06.21,5,,1
2020,10,2891,640,17,6276,2,30,10,0,2,2,2,0,2,6,True,False,False,0,4,2020-11-16T18:59:59.463,2,,0
2020,10,2891,660,26,4619,13,8,1,38,0,0,0,0,0,0,False,False,False,0,2,2020-11-16T19:08:03.67,0,,0
2020,10,2891,665,26,7453,13,5,5,9,0,0,0,0,0,0,False,False,False,0,3,2020-11-19T14:10:43.39,0,,0
2020,10,2891,685,17,4383,2,46,9,-1,1,2,1,0,1,0,False,False,False,0,4,2020-11-16T19:19:39.31,1,,0
2020,10,2891,695,26,6277,2,48,10,-6,-2,4,-2,0,-2,0,False,False,False,0,1,2020-11-16T19:22:50.483,-2,,0
2020,10,2891,700,26,4282,2,13,9,4,7,3,5,2,5,0,False,False,False,0,3,2020-11-16T19:25:39.357,7,,2
2020,10,2891,705,26,4282,2,13,10,3,4,1,4,0,4,0,False,False,False,0,3,2020-11-16T19:27:59.66,4,,0
2020,10,2891,710,26,309,13,4,10,5,0,0,0,0,0,0,False,False,False,0,2,2020-11-16T19:30:23.437,0,,0
2020,10,2891,775,26,7453,2,13,4,1,4,3,4,0,4,0,False,False,False,0,2,2020-11-16T19:46:16.987,4,,0
2020,10,2891,780,26,4619,2,29,2,25,28,3,25,3,25,0,False,False,False,0,2,2020-11-16T19:48:21.48,28,,3
2020,10,2891,785,26,7453,13,9,6,26,0,0,0,0,0,0,False,False,False,0,2,2020-11-16T19:51:08.923,0,,0
2020,10,2891,790,26,7491,2,13,9,3,13,10,7,6,7,0,False,False,False,1,3,2020-11-19T15:54:36.973,13,,6
2020,10,2891,795,26,309,13,29,5,13,0,0,0,0,0,0,False,False,False,0,2,2020-11-16T19:55:35.53,0,,0
2020,10,2891,800,26,4619,13,9,3,13,0,0,0,0,0,0,False,False,False,0,2,2020-11-16T19:57:56.01,0,,0
2020,10,2891,810,26,309,2,35,9,11,13,2,13,0,13,6,True,False,False,0,3,2020-11-16T20:00:02.787,13,,0
2020,7,2892,15,20,4828,2,5,5,4,6,2,6,0,6,0,False,False,False,0,3,2020-10-30T20:59:39.08,6,,0.0
2020,7,2892,20,20,8131,2,4,10,5,9,4,7,2,7,0,False,False,False,0,2,2020-10-26T10:26:14.583,9,,2.0
2020,7,2892,35,20,306,2,6,10,3,9,6,8,1,8,0,False,False,False,0,1,2021-02-17T20:29:36.55,9,,1.0
2020,7,2892,45,20,5140,2,45,5,-4,2,6,-1,3,-1,0,True,False,False,0,2,2020-10-26T11:30:32.45,2,,3.0
2020,7,2892,50,20,5140,2,48,10,-4,7,11,6,1,6,0,False,False,False,0,1,2021-02-17T20:32:35.85,7,,1.0
2020,7,2892,75,20,958,2,29,5,4,4,0,4,0,4,6,False,False,False,0,3,2020-10-26T11:48:11.397,4,,0.0
2020,7,2892,95,5,3477,2,2,4,4,10,6,8,2,8,0,False,False,False,0,3,2020-10-26T16:24:23.37,10,,2.0
2020,7,2892,100,5,4803,3,30,10,-1,0,0,0,0,0,0,True,False,False,0,4,2020-10-27T20:59:41.42,0,,
2020,7,2892,110,5,4803,2,50,10,-4,2,6,0,2,0,0,True,False,False,0,3,2021-03-04T16:16:50.41,2,,2.0
2020,7,2892,115,5,4803,2,12,7,20,22,2,22,0,22,0,False,False,False,0,3,2020-10-27T20:59:58.573,22,,0.0
2020,7,2892,120,5,5220,13,29,2,24,0,0,0,0,0,0,False,False,False,0,2,2020-10-26T12:15:12.407,0,,0.0
2020,7,2892,145,20,8131,2,4,9,13,15,2,14,1,14,0,False,False,False,0,3,2020-10-26T12:25:08.327,15,,1.0
2020,7,2892,150,20,8131,2,4,9,4,8,4,5,3,5,0,False,False,False,1,2,2020-10-30T20:52:50.673,8,,3.0
2020,7,2892,170,20,8131,2,4,9,14,14,0,14,0,14,0,False,False,False,0,2,2020-10-26T13:00:32.833,14,,0.0
2020,7,2892,175,20,8131,13,4,5,0,0,0,0,0,0,0,False,False,False,0,3,2020-10-26T13:02:13.313,0,,0.0
2020,7,2892,180,20,8131,2,4,10,8,10,2,9,1,9,0,False,False,False,0,3,2020-10-26T13:04:29.45,10,,1.0
2020,7,2892,210,5,5220,2,13,3,5,6,1,6,0,6,0,False,False,False,0,3,2020-10-30T21:16:20.173,6,,
2020,7,2892,220,5,5220,2,8,1,41,74,33,74,0,74,6,False,False,False,0,3,2020-10-26T16:25:32.033,74,,0.0
2020,7,2892,235,20,7353,3,13,10,3,0,0,0,0,0,0,False,False,False,0,2,2020-10-26T13:23:29.657,0,,0.0
2020,7,2892,240,20,6388,2,39,4,4,5,1,4,1,4,0,False,False,False,0,3,2020-10-26T13:26:00.85,5,,1.0
2020,7,2892,245,20,5140,2,28,5,-1,2,3,-2,4,-2,0,False,False,False,1,1,2020-10-30T20:53:41.5,2,,
2020,7,2892,265,20,7353,2,5,2,17,17,0,17,0,17,0,False,False,False,0,2,2020-10-26T13:40:51.937,17,,0.0
2020,7,2892,280,5,3477,2,5,3,5,5,0,5,0,5,0,False,False,False,0,3,2020-10-30T21:21:14.727,5,,0.0
2020,7,2892,290,5,4803,2,13,3,2,11,9,10,1,10,0,False,False,False,0,3,2020-10-30T21:22:43.67,11,,1.0
2020,7,2892,300,5,3477,2,42,4,3,19,16,15,4,15,0,False,False,False,0,3,2020-10-26T16:26:22.193,19,,4.0
2020,7,2892,305,5,2554,2,28,3,1,8,7,6,2,6,0,False,False,False,2,1,2020-10-30T20:54:12.483,8,,2.0
2020,7,2892,310,5,6372,2,18,5,-1,4,5,2,2,2,0,False,False,False,0,2,2020-10-26T16:26:54.753,4,,2.0
2020,7,2892,320,5,2554,2,48,9,-4,8,12,5,3,5,0,False,False,False,1,1,2021-02-17T20:39:34.747,8,,3.0
2020,7,2892,330,5,5220,2,34,4,-3,7,10,3,4,3,6,True,False,False,1,3,2020-10-26T16:27:18.993,7,,4.0
2020,7,2892,345,20,5140,2,28,9,1,3,2,2,1,2,0,False,False,False,0,1,2020-10-26T14:06:07.047,3,,1.0
2020,7,2892,350,20,7353,2,5,2,18,18,0,18,0,18,0,False,False,False,0,2,2020-10-26T14:08:11.497,18,,0.0
2020,7,2892,355,20,7353,2,4,5,7,7,0,7,0,7,0,False,False,False,0,2,2020-10-27T18:20:25.777,7,,0.0
2020,7,2892,365,20,958,2,17,10,14,22,8,18,4,18,0,False,False,False,1,3,2020-10-30T20:54:35.723,22,,4.0
2020,7,2892,375,20,5140,2,48,10,-7,17,24,14,3,14,0,False,False,False,0,1,2020-10-26T14:18:42.207,17,,3.0
2020,7,2892,390,20,7353,2,26,10,4,4,0,4,0,4,6,False,False,False,0,3,2020-10-26T14:21:37.497,4,,0.0
2020,7,2892,415,5,3477,2,2,4,5,8,3,5,3,5,0,False,False,False,0,3,2020-10-26T16:27:41.92,8,,3.0
2020,7,2892,420,5,3477,13,29,2,19,0,0,0,0,0,0,False,False,False,0,3,2020-10-26T14:38:17.023,0,,0.0
2020,7,2892,430,5,4803,2,46,3,2,3,1,3,0,3,0,True,False,False,0,4,2020-10-30T21:35:15.9,3,,0.0
2020,7,2892,440,5,3477,13,19,7,47,0,0,0,0,0,0,False,False,False,0,3,2020-10-30T19:53:05.097,0,,0.0
2020,7,2892,445,5,5220,2,26,5,3,4,1,4,0,4,0,False,False,False,0,3,2020-10-26T16:28:18.043,4,,0.0
2020,7,2892,455,20,958,2,4,4,5,6,1,5,1,5,0,False,False,False,0,3,2020-10-26T14:58:56.367,6,,1.0
2020,7,2892,460,20,7888,13,35,10,10,0,0,0,0,0,0,False,False,False,0,4,2020-10-30T21:24:29.293,0,,0.0
2020,7,2892,465,20,5140,2,48,9,-6,16,22,10,6,10,0,False,False,False,1,1,2020-10-26T15:02:50.333,16,,6.0
2020,7,2892,475,20,958,13,39,4,4,0,0,0,0,0,0,False,False,False,0,3,2020-10-26T15:07:30.677,0,,0.0
2020,7,2892,480,20,6388,2,13,4,5,6,1,5,1,5,0,False,False,False,0,4,2020-10-30T21:36:00.48,6,,1.0
2020,7,2892,485,20,5140,2,13,10,0,14,14,-1,15,-1,0,False,False,False,1,3,2020-10-30T19:53:05.097,14,,15.0
2020,7,2892,500,20,6388,2,35,9,13,23,10,14,9,14,0,False,False,False,1,4,2021-03-03T14:19:41.737,23,,9.0
2020,7,2892,515,20,8131,2,11,3,11,11,0,11,0,11,0,False,False,False,0,3,2021-02-17T20:42:37.387,11,,
2020,7,2892,520,20,5140,2,48,9,-3,-2,1,-2,0,-2,0,False,False,False,2,1,2020-10-26T15:27:52.427,-2,,0.0
2020,7,2892,535,5,3477,2,35,2,16,26,10,21,5,21,0,False,False,False,0,3,2020-10-26T15:31:17.957,26,,5.0
2020,7,2892,545,5,2554,2,46,3,-1,2,3,1,1,1,0,False,False,False,0,1,2020-10-27T21:00:33.877,2,,1.0
2020,7,2892,560,5,4803,2,30,3,-1,5,6,3,2,3,0,False,False,False,1,4,2020-10-30T21:36:55.493,5,,2.0
2020,7,2892,565,5,6425,2,4,3,5,11,6,6,5,6,0,False,False,False,0,3,2020-10-26T16:29:14.08,11,,5.0
2020,7,2892,585,20,8131,2,4,10,4,5,1,5,0,5,0,False,False,False,0,2,2020-10-26T15:44:32.187,5,,0.0
2020,7,2892,600,20,8131,2,13,9,4,7,3,5,2,5,0,False,False,False,0,3,2020-10-26T15:48:44.53,7,,2.0
2020,7,2892,610,20,8131,13,4,9,14,0,0,0,0,0,0,False,False,False,0,3,2020-10-26T15:51:19.523,0,,0.0
2020,7,2892,620,20,6388,2,6,8,17,20,3,17,3,17,0,False,False,False,1,2,2020-10-26T15:53:29.033,20,,3.0
2020,7,2892,630,20,1162,2,30,5,-1,0,1,-1,1,-1,0,False,False,False,0,4,2020-10-26T15:56:46.257,0,,1.0
2020,7,2892,635,20,5140,2,13,5,3,8,5,8,0,8,0,False,False,False,0,3,2020-10-30T21:29:52.093,8,,0.0
2020,7,2892,655,20,8131,2,13,4,4,7,3,5,2,5,0,False,False,False,0,2,2020-10-26T16:02:41.027,7,,2.0
2020,7,2892,670,5,2554,2,5,5,2,7,5,5,2,5,0,False,False,False,0,1,2020-10-26T16:05:29.077,7,,2.0
2020,7,2892,675,5,3477,2,2,9,3,6,3,5,1,5,0,False,False,False,0,3,2020-10-26T16:07:28.29,6,,1.0
2020,7,2892,680,5,5220,2,2,4,4,8,4,7,1,7,0,False,False,False,0,3,2020-10-26T16:08:56.41,8,,1.0
2020,7,2892,695,5,4803,2,18,3,-2,5,7,1,4,1,0,False,False,False,0,2,2020-10-27T21:00:54.253,5,,4.0
2020,7,2892,710,5,2554,2,48,3,-6,-1,5,-6,5,-6,0,False,False,False,1,1,2020-10-26T16:16:18.417,-1,,5.0
2020,7,2893,20,22,256,2,35,9,11,19,8,17,2,17,0,False,False,False,0,2,2020-10-26T18:04:31.603,19,,2.0
2020,7,2893,25,22,7609,2,6,4,2,7,5,7,0,7,0,False,False,False,0,1,2020-10-30T18:32:59.237,7,,0.0
2020,7,2893,35,22,7610,2,30,3,3,5,2,4,1,4,0,True,False,False,0,4,2020-10-27T22:41:20.293,5,,1.0
2020,7,2893,50,22,256,2,5,10,6,8,2,7,1,7,0,False,False,False,0,3,2020-10-26T10:57:54.193,8,,1.0
2020,7,2893,60,22,7610,13,12,3,6,0,0,0,0,0,0,False,False,False,0,3,2020-10-30T15:53:08.527,0,,0.0
2020,7,2893,75,4,6983,2,51,10,-5,6,11,5,1,5,0,False,False,False,0,1,2020-10-26T11:10:51.677,6,,1.0
2020,7,2893,80,4,2629,2,4,10,7,12,5,9,3,9,0,False,False,False,0,4,2020-10-26T11:48:12.367,12,,3.0
2020,7,2893,85,4,594,2,13,9,5,23,18,20,3,20,0,False,False,False,0,3,2020-10-26T11:50:03.877,23,,3.0
2020,7,2893,90,4,6983,13,46,3,-1,0,0,0,0,0,0,False,False,False,0,1,2020-10-26T11:51:58.477,0,,0.0
2020,7,2893,100,4,7646,13,12,2,27,0,0,0,0,0,0,False,False,False,0,3,2021-02-17T20:15:36.777,0,,0.0
2020,7,2893,125,22,7609,2,47,5,3,9,6,9,0,9,0,False,False,False,0,1,2020-10-26T12:17:40.17,9,,0.0
2020,7,2893,160,22,6270,2,50,10,-3,0,3,-3,3,-3,0,False,False,False,1,3,2021-03-04T14:58:07.947,0,,3.0
2020,7,2893,165,22,6270,2,7,6,21,22,1,22,0,22,0,True,False,False,0,2,2020-10-27T22:41:30.583,22,,0.0
2020,7,2893,185,22,7610,2,5,5,3,10,7,8,2,8,0,False,False,False,0,3,2020-10-30T20:54:24.713,10,,2.0
2020,7,2893,195,4,2853,13,5,2,17,0,0,0,0,0,0,False,False,False,0,2,2021-02-17T20:17:06.323,0,,0.0
2020,7,2893,205,4,594,2,5,5,5,13,8,13,0,13,0,False,False,False,1,3,2020-10-30T16:07:03.95,13,,0.0
2020,7,2893,210,4,7646,13,4,10,9,0,0,0,0,0,0,False,False,False,0,2,2020-10-26T13:39:53.797,0,,0.0
2020,7,2893,220,4,7937,2,17,9,6,15,9,13,2,13,0,True,False,False,0,1,2020-10-27T18:33:09.117,15,,2.0
2020,7,2893,230,4,594,2,5,10,3,3,0,3,0,3,0,False,False,False,0,3,2020-10-27T18:33:09.117,3,,0.0
2020,7,2893,250,22,256,13,9,3,14,0,0,0,0,0,0,False,False,False,0,2,2020-10-30T20:55:06.58,0,,
2020,7,2893,255,22,7610,2,35,10,14,16,2,14,2,14,0,False,False,False,0,3,2020-10-26T13:59:23.873,16,,2.0
2020,7,2893,265,22,7610,2,5,3,9,11,2,9,2,9,0,False,False,False,0,3,2020-10-30T15:39:44.607,11,,2.0
2020,7,2893,275,22,256,13,35,10,13,0,0,0,0,0,0,False,False,False,0,3,2020-10-26T14:09:46.93,0,,
2020,7,2893,280,22,7610,13,29,5,5,0,0,0,0,0,0,False,False,False,0,2,2021-01-15T21:38:09.377,0,,0.0
2020,7,2893,315,4,2853,2,3,5,9,9,0,9,0,9,0,False,False,False,0,2,2020-10-27T18:33:09.117,9,,0.0
2020,7,2893,320,4,7645,2,4,4,3,5,2,3,2,3,0,False,False,False,0,1,2021-02-17T20:18:45.267,5,,2.0
2020,7,2893,335,4,2853,13,12,2,19,0,0,0,0,0,0,False,False,False,0,2,2021-02-17T20:19:54.753,0,,0.0
2020,7,2893,340,4,2853,13,6,7,18,0,0,0,0,0,0,False,False,False,0,2,2020-10-30T16:14:04.19,0,,0.0
2020,7,2893,370,22,6270,2,39,4,4,9,5,6,3,6,0,False,False,False,1,3,2020-10-30T14:33:11.923,9,,3.0
2020,7,2893,380,22,7609,13,4,4,1,0,0,0,0,0,0,False,False,False,0,1,2020-10-26T14:51:22.3,0,,0.0
2020,7,2893,385,22,7118,13,7,6,18,0,0,0,0,0,0,False,False,False,0,3,2021-03-05T19:41:45.113,0,,0.0
2020,7,2893,390,4,6983,2,28,10,3,12,9,10,2,10,0,False,False,False,0,1,2020-10-27T18:33:09.117,12,,2.0
2020,7,2893,395,4,2853,2,5,5,8,8,0,8,0,8,0,False,False,False,0,2,2020-10-26T17:45:49.787,8,,0.0
2020,7,2893,400,4,2853,2,4,3,7,9,2,9,0,9,0,False,False,False,0,2,2020-10-26T17:46:42.787,9,,0.0
2020,7,2893,410,4,2853,13,6,9,10,0,0,0,0,0,0,False,False,False,0,3,2020-10-26T15:03:01.903,0,,0.0
2020,7,2893,415,4,594,2,2,9,5,14,9,14,0,14,0,False,False,False,0,3,2020-10-26T15:04:26.037,14,,0.0
2020,7,2893,440,4,5119,2,34,4,-4,8,12,8,0,8,0,True,False,False,0,2,2021-03-04T14:59:03.783,8,,0.0
2020,7,2893,450,4,6983,13,45,5,-4,0,0,0,0,0,0,True,False,False,0,1,2020-10-30T16:18:40.58,0,,0.0
2020,7,2893,455,4,2853,2,4,5,7,5,-2,5,0,5,0,False,False,False,0,2,2020-10-26T15:19:03.613,5,,0.0
2020,7,2893,460,4,2853,2,6,10,6,12,6,11,1,11,0,False,False,False,0,2,2020-10-30T21:00:23.317,12,,1.0
2020,7,2893,475,4,594,2,4,4,8,8,0,8,0,8,0,False,False,False,0,3,2021-02-17T20:21:15.44,8,,0.0
2020,7,2893,480,4,2853,13,12,5,13,0,0,0,0,0,0,False,False,False,0,2,2021-02-17T20:22:13.14,0,,0.0
2020,7,2893,505,22,6270,13,39,4,3,0,0,0,0,0,0,False,False,False,0,3,2021-03-17T19:09:52.583,0,,0.0
2020,7,2893,510,22,6270,13,5,2,15,0,0,0,0,0,0,False,False,False,0,3,2020-10-26T15:37:27.517,0,,0.0
2020,7,2893,525,4,7645,2,45,5,-4,3,7,0,3,0,0,False,False,False,0,1,2020-10-26T15:52:04.343,3,,3.0
2020,7,2893,535,4,7645,2,12,5,4,17,13,7,10,7,0,False,False,False,1,1,2021-03-03T14:22:50.99,17,,10.0
2020,7,2893,540,4,594,2,51,3,-2,6,8,4,2,4,0,False,False,False,0,3,2021-02-17T20:23:20.01,6,,2.0
2020,7,2893,545,4,594,2,5,3,5,6,1,6,0,6,0,False,False,False,0,3,2020-10-27T18:33:09.117,6,,0.0
2020,7,2893,555,4,5119,2,4,10,4,6,2,4,2,4,0,False,False,False,0,3,2020-10-26T16:13:33.157,6,,2.0
2020,7,2893,565,4,7646,2,4,9,6,11,5,11,0,11,0,False,False,False,0,3,2020-10-26T17:53:32.56,11,,0.0
2020,7,2893,575,4,7646,2,19,6,22,22,0,22,0,22,6,False,False,False,0,2,2021-02-17T20:24:03.593,22,,
2020,7,2893,580,4,594,13,11,6,27,0,0,0,0,0,0,False,False,False,0,3,2020-10-30T21:05:45.853,0,,0.0
2020,7,2893,585,4,2629,2,5,5,8,8,0,8,0,8,0,False,False,False,0,3,2020-10-27T18:27:13.12,8,,0.0
2020,7,2893,605,22,6270,2,5,3,4,4,0,4,0,4,0,False,False,False,0,3,2020-10-26T16:32:43.053,4,,0.0
2020,7,2893,625,4,594,2,4,9,6,9,3,6,3,6,0,False,False,False,0,3,2020-10-26T16:37:52.903,9,,3.0
2020,7,2893,635,4,2629,2,24,6,22,38,16,38,0,38,0,False,False,False,0,3,2020-10-26T16:41:00.107,38,,0.0
2020,7,2893,645,4,6983,13,48,9,-3,0,0,0,0,0,0,False,False,False,0,1,2020-10-30T16:35:43.9,0,,0.0
2020,7,2893,660,22,7121,13,13,5,0,0,0,0,0,0,0,True,False,False,0,4,2020-10-30T14:36:06.333,0,,0.0
2020,7,2893,670,22,6262,2,13,10,4,14,10,10,4,10,0,False,False,False,0,3,2020-10-30T16:37:24.96,14,,
2020,7,2893,685,4,2853,2,51,10,-1,5,6,5,0,5,0,True,False,False,1,3,2020-10-30T15:16:10.803,5,,0.0
2020,7,2893,690,4,2629,2,47,5,1,6,5,5,1,5,0,False,False,False,0,4,2020-10-26T16:58:26.407,6,,1.0
2020,7,2893,695,4,594,2,51,3,-2,8,10,8,0,8,0,False,False,False,0,3,2021-02-17T20:25:14.127,8,,0.0
2020,7,2893,740,22,7610,13,6,10,13,0,0,0,0,0,0,False,False,False,0,2,2020-10-30T18:33:47.967,0,,0.0
2020,7,2893,755,4,594,2,17,10,14,18,4,15,3,15,0,False,False,False,0,3,2020-10-30T16:50:12.987,18,,3.0
2020,7,2893,760,4,594,2,51,3,-1,4,5,4,0,4,0,False,False,False,0,3,2021-02-17T20:25:47.087,4,,0.0
2020,7,2893,825,22,256,13,9,2,25,0,0,0,0,0,0,False,False,False,0,2,2021-02-17T20:27:33.903,0,,
2020,7,2893,845,22,6270,13,13,10,-5,0,0,0,0,0,0,False,False,False,0,3,2021-03-05T19:42:55.71,0,,0.0
2020,7,2894,35,32,3885,2,47,5,1,7,6,5,2,5,0,False,False,False,0,3,2020-10-26T14:30:16.913,7,,2.0
2020,7,2894,60,32,7128,2,46,3,1,1,0,1,0,1,0,False,False,False,0,3,2020-10-26T14:39:20.99,1,,0.0
2020,7,2894,85,9,7816,3,30,3,-2,0,0,0,0,0,0,False,False,False,0,3,2020-10-26T14:44:51.333,0,,0.0
2020,7,2894,115,32,3885,2,5,3,5,9,4,9,0,9,0,True,False,False,0,2,2020-10-26T14:51:20.553,9,,0.0
2020,7,2894,120,32,7128,2,50,10,-2,5,7,1,4,1,0,False,False,False,0,2,2020-10-26T14:52:37.447,5,,4.0
2020,7,2894,125,32,1427,2,24,2,21,26,5,25,1,25,0,True,False,False,0,4,2020-10-26T14:53:46.033,26,,1.0
2020,7,2894,175,32,1427,13,7,6,19,0,0,0,0,0,0,False,False,False,0,4,2020-10-26T15:02:09.193,0,,
2020,7,2894,185,32,3396,13,47,5,2,0,0,0,0,0,0,True,False,False,0,4,2020-10-26T15:08:09.453,0,,0.0
2020,7,2894,200,9,322,2,4,5,5,5,0,5,0,5,0,False,False,False,0,2,2020-10-26T15:07:58.077,5,,0.0
2020,7,2894,215,9,322,2,13,4,3,4,1,4,0,4,0,True,False,False,0,3,2020-10-29T21:46:35.023,4,,0.0
2020,7,2894,225,9,6446,2,32,5,1,14,13,11,3,11,0,False,False,False,0,4,2020-10-29T21:46:43.507,14,,3.0
2020,7,2894,235,9,7816,3,2,9,7,0,0,0,0,0,0,False,False,False,0,3,2020-10-26T15:19:57.223,0,,0.0
2020,7,2894,250,9,6446,13,12,1,25,0,0,0,0,0,0,False,False,False,0,4,2021-02-17T12:56:51.603,0,,0.0
2020,7,2894,260,32,7128,2,19,6,38,52,14,52,0,52,6,False,False,False,0,2,2020-10-29T22:11:26.493,52,,0.0
2020,7,2894,280,9,322,2,5,5,5,10,5,7,3,7,0,False,False,False,0,3,2020-10-26T15:37:18.447,10,,3.0
2020,7,2894,315,32,3885,13,5,9,-5,0,0,0,0,0,0,False,False,False,0,1,2020-10-29T21:53:26.587,0,,
2020,7,2894,320,32,7807,3,50,9,-1,0,0,0,0,0,0,True,False,False,0,2,2020-10-26T15:45:17.383,0,,0.0
2020,7,2894,330,32,7128,2,42,4,4,6,2,5,1,5,0,False,False,False,0,3,2020-10-29T21:55:41.03,6,,1.0
2020,7,2894,340,32,1427,2,46,3,0,7,7,7,0,7,0,True,False,False,0,4,2020-10-27T14:58:33.04,7,,0.0
2020,7,2894,360,32,1427,2,38,3,3,15,12,3,12,3,6,False,False,False,1,4,2021-03-03T14:27:23.55,15,,12.0
2020,7,2894,380,9,322,2,5,3,4,4,0,4,0,4,0,False,False,False,0,3,2020-10-26T15:58:08.233,4,,0.0
2020,7,2894,400,9,322,2,6,8,18,18,0,18,0,18,0,False,False,False,0,3,2020-10-29T21:55:41.03,18,,0.0
2020,7,2894,405,9,6446,13,2,10,5,0,0,0,0,0,0,False,False,False,0,3,2020-10-29T21:47:14.177,0,,0.0
2020,7,2894,430,9,4202,2,45,5,-4,6,10,6,0,6,0,False,False,False,0,1,2020-10-26T16:05:56.737,6,,0.0
2020,7,2894,435,9,7183,2,47,5,0,6,6,2,4,2,0,False,False,False,1,1,2020-10-30T12:30:25.967,6,,4.0
2020,7,2894,450,9,7816,13,17,4,12,0,0,0,0,0,0,False,False,False,0,3,2020-10-26T16:09:27.407,0,,0.0
2020,7,2894,455,9,4202,3,16,10,4,0,0,0,0,0,0,False,False,False,0,1,2021-03-05T19:53:55.547,0,,0.0
2020,7,2894,480,9,6446,2,4,10,6,8,2,7,1,7,0,False,False,False,0,3,2020-10-26T16:30:57.337,8,,1.0
2020,7,2894,485,9,7816,3,6,10,4,0,0,0,0,0,0,False,False,False,0,3,2020-10-29T21:55:41.03,0,,0.0
2020,7,2894,495,9,7816,13,12,2,23,0,0,0,0,0,0,False,False,False,0,3,2020-10-26T16:35:32.19,0,,0.0
2020,7,2894,510,32,7128,13,35,2,21,0,0,0,0,0,0,False,False,False,0,3,2020-10-26T16:41:18.98,0,,0.0
2020,7,2894,515,32,7128,2,5,3,13,13,0,13,0,13,0,False,False,False,0,3,2020-10-29T21:47:50.687,13,,0.0
2020,7,2894,545,32,7128,2,50,9,-2,5,7,3,2,3,0,False,False,False,0,2,2020-10-26T16:56:18.613,5,,2.0
2020,7,2894,560,9,6436,13,2,10,6,0,0,0,0,0,0,False,False,False,0,2,2021-02-17T12:58:26.657,0,,0.0
2020,7,2894,575,9,322,2,19,2,20,32,12,27,5,27,0,False,False,False,0,2,2020-10-29T21:48:00.937,32,,5.0
2020,7,2894,605,32,6430,2,8,6,18,22,4,20,2,20,0,False,False,False,0,3,2020-10-26T17:19:06.89,22,,2.0
2020,7,2894,610,32,7128,13,2,9,4,0,0,0,0,0,0,False,False,False,0,2,2020-10-26T17:20:25.08,0,,0.0
2020,7,2894,620,32,1427,2,5,5,10,12,2,10,2,10,0,False,False,False,0,3,2020-10-26T17:22:44.767,12,,2.0
2020,7,2894,625,32,7128,2,13,10,4,8,4,5,3,5,0,True,False,False,0,3,2020-10-27T15:00:33.647,8,,3.0
2020,7,2894,640,32,7128,13,12,3,13,0,0,0,0,0,0,False,False,False,0,2,2020-10-26T17:26:54.087,0,,0.0
2020,7,2894,650,32,7128,13,12,5,12,0,0,0,0,0,0,False,False,False,0,3,2020-10-26T17:30:16.523,0,,0.0
2020,7,2894,670,9,322,2,4,9,4,7,3,4,3,4,0,False,False,False,1,3,2020-10-26T17:42:04.557,7,,3.0
2020,7,2894,680,9,6436,13,4,3,11,0,0,0,0,0,0,False,False,False,0,2,2020-10-29T21:48:09.857,0,,0.0
2020,7,2894,710,32,4467,2,38,9,3,6,3,4,2,4,0,False,False,False,0,4,2020-10-30T12:35:32.043,6,,2.0
2020,7,2895,10,27,650,2,9,6,34,34,0,34,0,34,0,False,False,False,0,2,2021-02-24T17:55:03.893,34,,0.0
2020,7,2895,15,27,4835,2,35,10,8,17,9,8,9,8,0,False,False,False,0,4,2020-10-26T09:57:28.027,17,,9.0
2020,7,2895,20,27,650,2,5,5,4,4,0,4,0,4,0,False,False,False,0,3,2020-10-26T10:01:20.22,4,,0.0
2020,7,2895,25,27,5050,2,28,4,0,7,7,3,4,3,0,False,False,False,0,1,2020-10-26T10:04:26.71,7,,4.0
2020,7,2895,35,27,650,2,5,3,3,3,0,3,0,3,6,True,False,False,0,3,2020-10-30T15:38:42.063,3,,0.0
2020,7,2895,50,1,5032,3,11,5,13,0,0,0,0,0,0,False,False,False,0,4,2020-10-26T10:19:26.56,0,,0.0
2020,7,2895,60,1,6405,2,18,5,-1,0,1,0,0,0,0,False,False,False,0,2,2020-10-26T10:23:22.4,0,,0.0
2020,7,2895,65,1,245,2,50,9,-2,-2,0,-2,0,-2,0,False,False,False,0,2,2020-10-26T18:48:50.853,-2,,0.0
2020,7,2895,85,27,650,13,19,2,25,0,0,0,0,0,0,False,False,False,0,2,2021-02-17T14:07:32.16,0,,0.0
2020,7,2895,90,27,7408,2,13,4,4,17,13,8,9,8,0,False,False,False,1,2,2020-10-26T18:42:05.88,17,,9.0
2020,7,2895,100,27,5069,2,30,10,0,18,18,16,2,16,0,True,False,False,1,4,2020-10-30T16:44:40.407,18,,2.0
2020,7,2895,105,27,505,13,11,2,23,0,0,0,0,0,0,False,False,False,0,3,2021-02-17T14:09:14.307,0,,0.0
2020,7,2895,110,27,153,13,12,5,10,0,0,0,0,0,0,False,False,False,0,1,2020-10-30T15:29:07.967,0,,0.0
2020,7,2895,135,1,5152,13,35,2,33,0,0,0,0,0,0,False,False,False,0,4,2020-10-26T19:08:37.97,0,,0.0
2020,7,2895,150,1,245,13,2,9,7,0,0,0,0,0,0,False,False,False,0,2,2021-03-02T13:27:37.1,0,,
2020,7,2895,160,1,5152,2,26,9,5,16,11,12,4,12,0,False,False,False,0,4,2020-10-26T11:21:24.34,16,,4.0
2020,7,2895,175,1,245,2,9,6,33,35,2,34,1,34,6,False,False,False,0,2,2020-10-26T18:49:19.717,35,,1.0
2020,7,2895,190,27,5050,2,46,3,0,2,2,0,2,0,0,False,False,False,0,1,2020-10-30T16:19:37.38,2,,
2020,7,2895,205,27,650,2,3,2,16,16,0,16,0,16,0,False,False,False,0,2,2020-10-26T11:49:25.643,16,,0.0
2020,7,2895,210,27,4835,2,30,5,-1,-1,0,-1,0,-1,0,False,False,False,0,4,2020-10-30T16:22:03.83,-1,,0.0
2020,7,2895,220,27,505,2,17,10,12,13,1,13,0,13,0,False,False,False,0,3,2020-10-26T11:55:50.543,13,,0.0
2020,7,2895,235,27,7850,13,5,5,6,0,0,0,0,0,0,False,False,False,0,3,2021-02-23T15:25:07.977,0,,0.0
2020,7,2895,255,1,245,2,4,9,6,19,13,17,2,17,0,False,False,False,0,2,2020-10-26T18:50:03.507,19,,2.0
2020,7,2895,265,1,245,2,18,3,0,1,1,1,0,1,0,False,True,True,1,2,2021-03-04T15:01:09.69,1,,0.0
2020,7,2895,270,27,650,2,39,4,9,9,0,9,0,9,0,False,False,False,0,3,2020-10-26T18:46:34.45,9,,0.0
2020,7,2895,280,27,650,13,12,3,13,0,0,0,0,0,0,False,False,False,0,3,2020-10-30T16:56:16.273,0,,0.0
2020,7,2895,285,27,5069,2,2,10,13,18,5,15,3,15,0,False,False,False,0,2,2020-10-26T12:39:12.077,18,,3.0
2020,7,2895,290,27,5050,13,47,5,1,0,0,0,0,0,0,False,False,False,0,1,2021-03-05T20:04:19.413,0,,0.0
2020,7,2895,320,27,650,2,5,5,4,4,0,4,0,4,0,False,False,False,0,3,2020-10-26T12:58:01.903,4,,0.0
2020,7,2895,330,27,6397,2,38,3,6,28,22,25,3,25,0,False,False,False,1,4,2021-02-17T14:20:43.243,28,,3.0
2020,7,2895,335,27,650,3,44,3,2,0,0,0,0,0,0,True,False,False,0,3,2020-10-26T13:09:55.047,0,,0.0
2020,7,2895,355,1,245,2,12,10,10,12,2,12,0,12,0,False,False,False,0,3,2020-10-26T18:52:05.63,12,,0.0
2020,7,2895,365,1,245,2,26,3,2,2,0,2,0,2,0,False,False,False,0,2,2020-10-26T18:52:24.603,2,,0.0
2020,7,2895,370,1,245,2,29,3,12,13,1,13,0,13,0,False,False,False,0,2,2021-02-25T14:52:46.56,13,,0.0
2020,7,2895,380,1,5152,2,6,8,19,41,22,38,3,38,0,False,False,False,0,4,2020-10-26T13:29:44.96,41,,3.0
2020,7,2895,385,1,6405,2,9,5,7,7,0,7,0,7,6,False,False,False,0,2,2020-10-26T13:31:53.653,7,,0.0
2020,7,2895,410,27,650,2,13,4,3,16,13,9,7,9,0,False,False,False,1,2,2020-10-26T13:38:46.547,16,,7.0
2020,7,2895,420,27,650,2,19,2,47,47,0,47,0,47,6,True,False,False,0,3,2020-10-26T13:44:51.817,47,,0.0
2020,7,2895,435,1,525,2,39,10,5,9,4,8,1,8,0,False,False,False,0,3,2020-10-26T13:53:32.043,9,,1.0
2020,7,2895,445,1,525,2,4,4,5,12,7,10,2,10,0,False,False,False,0,3,2020-10-26T13:55:28.243,12,,2.0
2020,7,2895,455,1,6406,2,4,9,13,15,2,12,3,12,0,False,False,False,1,3,2020-10-27T21:29:38.85,15,,3.0
2020,7,2895,460,1,6406,2,46,3,-2,6,8,6,0,6,0,False,False,False,0,1,2020-10-26T14:00:23.653,6,,0.0
2020,7,2895,495,1,525,2,39,10,4,5,1,5,0,5,0,False,False,False,0,3,2020-10-26T14:09:47.953,5,,0.0
2020,7,2895,500,1,6406,2,2,9,3,21,18,3,18,3,0,False,False,False,2,2,2020-10-26T14:12:58.29,21,,18.0
2020,7,2895,510,1,245,2,49,5,-4,-4,0,-4,0,-4,0,False,False,False,0,2,2021-03-09T15:24:09.283,-4,,0.0
2020,7,2895,530,27,4835,2,13,10,3,6,3,6,0,6,0,False,False,False,0,3,2020-10-30T16:57:01.093,6,,0.0
2020,7,2895,535,27,6397,2,13,10,2,10,8,9,1,9,0,False,False,False,0,4,2020-10-30T16:46:36.42,10,,1.0
2020,7,2895,545,27,650,13,3,3,12,0,0,0,0,0,0,False,False,False,0,2,2021-02-23T21:34:22.493,0,,0.0
2020,7,2895,560,1,245,13,19,6,43,0,0,0,0,0,0,False,False,False,0,2,2020-10-26T14:43:21.533,0,,0.0
2020,7,2895,570,1,5152,13,13,9,4,0,0,0,0,0,0,False,False,False,0,3,2020-10-26T14:48:14.273,0,,
2020,7,2895,575,1,4307,2,46,3,3,7,4,7,0,7,0,False,False,False,0,1,2021-02-23T21:46:43.437,7,,0.0
2020,7,2895,585,1,4307,3,48,9,-4,0,0,0,0,0,0,False,False,False,0,1,2020-10-30T16:47:28.03,0,,0.0
2020,7,2895,590,1,245,2,5,6,18,18,0,18,0,18,0,False,False,False,0,2,2020-10-26T18:53:40.77,18,,0.0
2020,7,2895,600,1,7315,2,4,10,6,7,1,6,1,6,0,False,False,False,0,3,2020-10-26T15:05:40.327,7,,1.0
2020,7,2895,605,1,525,2,17,9,6,8,2,8,0,8,0,False,False,False,0,3,2020-10-26T15:08:06.987,8,,0.0
2020,7,2895,610,1,6406,2,4,9,0,18,18,9,9,9,0,False,False,False,1,1,2020-10-26T15:12:04.323,18,,9.0
2020,7,2895,620,1,6406,2,34,4,-4,13,17,3,10,3,0,True,False,False,1,2,2020-10-26T15:16:09.45,13,,10.0
2020,7,2895,645,27,505,2,30,10,1,5,4,3,2,3,0,False,False,False,0,4,2020-10-30T16:47:55.763,5,,2.0
2020,7,2895,655,27,650,2,13,4,4,10,6,6,4,6,0,False,False,False,1,3,2020-10-26T15:32:49.393,10,,4.0
2020,7,2895,680,27,650,2,6,2,15,16,1,16,0,16,0,False,False,False,0,3,2021-02-24T16:22:45.98,16,,0.0
2020,7,2895,695,27,7408,13,9,2,30,0,0,0,0,0,0,False,False,False,0,2,2021-02-24T16:29:34.23,0,,0.0
2020,7,2895,700,1,7315,13,4,1,25,0,0,0,0,0,0,True,False,False,0,3,2021-02-24T16:31:58.98,0,,0.0
2020,7,2895,705,27,7408,13,9,6,26,0,0,0,0,0,0,False,False,False,0,2,2020-10-26T16:04:32.423,0,,0.0
2020,7,2895,715,27,7850,2,13,4,1,8,7,7,1,7,0,True,False,False,0,3,2020-10-26T16:08:41.8,8,,1.0
2020,7,2895,730,27,650,2,13,10,3,5,2,4,1,4,0,False,False,False,0,3,2021-02-24T20:25:44.043,5,,1.0
2020,7,2895,740,27,153,2,5,10,-1,4,5,3,1,3,0,False,False,False,0,1,2020-10-26T16:23:48.547,4,,1.0
2020,7,2895,750,27,6397,13,7,3,11,0,0,0,0,0,0,False,False,False,0,4,2020-10-26T16:31:41.387,0,,0.0
2020,7,2895,755,27,650,2,30,5,1,8,7,8,0,8,0,False,False,False,0,3,2020-10-30T16:48:55.507,8,,0.0
2020,7,2895,760,27,6397,3,35,5,3,0,0,0,0,0,0,False,False,False,0,4,2020-10-26T16:36:59.223,0,,0.0
2020,7,2895,765,27,650,2,35,3,3,3,0,3,0,3,6,False,False,False,0,3,2021-02-24T16:49:55.7,3,,0.0
2020,7,2895,810,1,6406,2,45,5,-5,3,8,3,0,3,0,False,False,False,0,1,2020-10-26T17:00:41.737,3,,0.0
2020,7,2895,815,1,6405,2,5,5,6,6,0,6,0,6,0,False,False,False,0,2,2020-10-26T17:02:53.173,6,,0.0
2020,7,2895,830,1,525,2,12,3,3,3,0,3,0,3,0,False,False,False,0,3,2020-10-26T17:07:17.063,3,,0.0
2020,7,2895,835,1,7315,3,12,9,11,0,0,0,0,0,0,False,False,False,0,3,2020-10-26T17:09:27.143,0,,0.0
2020,7,2895,840,1,6405,13,3,5,12,0,0,0,0,0,0,False,False,False,0,2,2020-10-26T17:11:21.543,0,,0.0
2020,7,2895,850,1,6406,2,4,4,2,11,9,9,2,9,0,False,False,False,0,1,2020-10-26T17:17:06.053,11,,2.0
2020,7,2895,855,1,6405,2,4,10,6,8,2,6,2,6,6,False,False,False,0,2,2020-10-26T17:18:49.477,8,,2.0
2020,7,2895,920,1,525,2,2,4,9,11,2,10,1,10,0,False,False,False,0,3,2020-10-26T17:34:57.817,11,,1.0
2020,7,2895,940,1,6405,2,13,3,6,16,10,16,0,16,0,False,False,False,0,2,2020-10-30T16:50:23.023,16,,0.0
2020,7,2895,970,27,153,2,46,3,0,8,8,5,3,5,0,False,False,False,0,1,2020-10-30T16:12:20.197,8,,3.0
2020,7,2895,980,27,5069,2,6,1,18,18,0,18,0,18,0,False,False,False,0,2,2020-10-26T17:54:44.4,18,,0.0
2020,7,2895,990,27,7850,2,4,10,2,10,8,6,4,6,0,False,False,False,0,1,2020-10-26T17:59:11.97,10,,4.0
2020,7,2895,1010,1,525,2,5,3,4,7,3,6,1,6,0,False,False,False,0,3,2020-10-26T18:03:52.46,7,,1.0
2020,7,2895,1045,27,650,2,3,5,11,11,0,11,0,11,0,False,False,False,0,2,2020-10-26T18:12:47.237,11,,0.0
2020,7,2895,1050,27,153,2,45,5,-4,-4,0,-4,0,-4,0,False,False,False,0,1,2020-10-30T16:51:04.59,-4,,0.0
2020,7,2895,1060,27,650,2,12,10,7,14,7,14,0,14,0,False,False,False,2,2,2020-10-30T15:51:46.433,14,,0.0
2020,7,2895,1075,27,7852,13,2,10,4,0,0,0,0,0,0,False,False,False,0,2,2021-01-12T23:31:51.103,0,,0.0
2020,7,2895,1080,27,7408,2,49,3,-2,48,50,19,29,19,6,False,False,False,1,2,2020-10-26T18:43:28.963,6,,29.0
2020,7,2895,1085,27,650,13,35,4,13,0,0,0,0,0,0,False,False,False,0,3,2021-03-05T20:05:54.903,0,,0.0
2020,7,2895,1090,1,245,2,5,3,5,9,4,9,0,9,0,False,False,False,0,2,2020-10-26T18:54:29.287,9,,0.0
2020,7,2895,1105,1,525,2,51,10,-3,7,10,7,0,7,0,False,False,False,0,3,2020-10-26T18:33:18.023,7,,0.0
2020,7,2895,1115,1,6405,3,9,2,30,0,0,0,0,0,0,False,False,False,0,2,2020-10-26T19:07:24.04,0,,0.0
2020,7,2896,20,10,6840,2,4,5,-2,3,5,3,0,3,0,False,False,False,0,2,2020-10-27T01:28:10.597,3,,0
2020,7,2896,45,16,3938,2,4,5,5,11,6,11,0,11,0,False,False,False,0,2,2020-10-26T15:04:20.823,11,,0
2020,7,2896,50,16,374,2,53,10,-1,8,9,6,2,6,0,False,False,False,0,4,2020-10-26T10:25:19.233,8,,2
2020,7,2896,65,16,7176,2,7,6,18,19,1,19,0,19,0,False,False,False,0,3,2020-10-30T19:12:54.27,19,,0
2020,7,2896,85,10,6840,13,13,5,4,0,0,0,0,0,0,False,False,False,0,4,2020-10-27T01:29:42.533,0,,0
2020,7,2896,95,10,6840,13,7,6,20,0,0,0,0,0,0,False,False,False,0,3,2020-10-26T15:13:27.843,0,,0
2020,7,2896,105,16,7182,2,32,3,3,14,11,14,0,14,0,False,True,True,0,4,2020-10-30T17:42:36.467,14,,0
2020,7,2896,110,10,4930,2,35,2,27,27,0,27,0,27,0,False,False,False,0,3,2020-10-30T17:43:31.617,27,,0
2020,7,2896,120,10,4930,2,4,10,5,5,0,5,0,5,0,True,False,False,0,3,2020-10-26T15:10:52.51,5,,0
2020,7,2896,155,16,7176,2,35,2,25,38,13,31,7,31,0,False,False,False,0,3,2020-10-27T01:12:06.373,38,,7
2020,7,2896,160,16,4143,2,4,9,4,4,0,4,0,4,0,False,False,False,0,2,2020-10-30T19:13:12.127,4,,0
2020,7,2896,190,10,3848,13,35,10,14,0,0,0,0,0,0,False,False,False,0,4,2020-10-27T17:47:18.283,0,,0
2020,7,2896,200,10,282,2,45,5,-2,2,4,2,0,2,0,False,False,False,0,1,2020-10-26T11:18:51.52,2,,0
2020,7,2896,205,10,282,2,28,10,0,10,10,6,4,6,0,False,True,True,0,1,2020-10-27T01:31:30.193,10,,4
2020,7,2896,210,16,3938,13,7,6,44,0,0,0,0,0,0,False,False,False,0,2,2020-10-30T19:13:48.633,0,,0
2020,7,2896,220,16,7681,13,11,9,3,0,0,0,0,0,0,True,False,False,0,1,2020-10-30T18:37:45.573,0,,0
2020,7,2896,245,10,7700,2,47,5,4,7,3,4,3,4,0,False,False,False,1,3,2020-10-26T11:36:49.407,7,,3
2020,7,2896,250,10,7700,13,8,1,46,0,0,0,0,0,0,True,False,False,0,2,2020-10-30T17:50:56.25,0,,0
2020,7,2896,275,10,6840,13,5,5,4,0,0,0,0,0,0,False,False,False,0,3,2021-02-17T17:28:13.063,0,,0
2020,7,2896,300,10,3848,2,32,5,1,19,18,18,1,18,0,False,False,False,0,4,2020-10-26T15:09:54.607,19,,1
2020,7,2896,310,10,7703,2,47,5,1,5,4,2,3,2,0,False,False,False,0,4,2020-10-26T11:58:18.23,5,,3
2020,7,2896,315,10,6840,13,7,6,15,0,0,0,0,0,0,True,False,False,0,3,2021-02-17T17:29:16.083,0,,0
2020,7,2896,350,10,4930,13,5,5,13,0,0,0,0,0,0,False,False,False,0,3,2020-10-26T15:14:33.227,0,,0
2020,7,2896,365,16,3938,2,51,3,-3,5,8,5,0,5,0,False,False,False,0,3,2020-10-30T17:20:49.703,5,,0
2020,7,2896,375,16,3938,13,35,9,8,0,0,0,0,0,0,False,False,False,0,3,2020-10-30T19:28:46.263,0,,0
2020,7,2896,405,10,7703,2,5,5,7,17,10,15,2,15,0,False,False,False,0,4,2020-10-26T12:23:46.983,17,,2
2020,7,2896,420,10,6285,2,6,9,6,13,7,10,3,10,0,False,False,False,0,2,2020-10-30T18:37:45.573,13,,3
2020,7,2896,445,10,7701,2,4,5,8,21,13,20,1,20,0,False,False,False,0,2,2020-10-27T01:34:30.667,21,,1
2020,7,2896,465,16,3938,3,17,8,19,0,0,0,0,0,0,False,False,False,0,3,2020-10-30T18:37:45.573,0,,0
2020,7,2896,470,16,3938,2,4,1,15,15,0,15,0,15,0,False,False,False,1,3,2020-10-30T17:39:48.2,15,,0
2020,7,2896,485,10,4930,2,32,5,5,12,7,9,3,9,0,False,False,False,2,4,2021-03-03T14:36:38.977,12,,3
2020,7,2896,500,16,7681,13,12,10,1,0,0,0,0,0,0,False,False,False,0,2,2020-10-30T19:14:14.233,0,,0
2020,7,2896,510,16,7681,3,12,5,10,0,0,0,0,0,0,True,False,False,0,1,2020-10-26T13:01:04.863,0,,0
2020,7,2896,535,10,282,13,45,5,1,0,0,0,0,0,0,True,False,False,0,1,2020-10-26T15:15:04.86,0,,0
2020,7,2896,545,10,7700,2,5,3,5,13,8,9,4,9,0,False,False,False,0,3,2020-10-26T13:10:45.057,13,,4
2020,7,2896,555,10,7703,2,13,10,4,4,0,4,0,4,0,False,False,False,0,4,2020-10-26T13:13:33.39,4,,0
2020,7,2896,560,10,3848,2,5,5,6,6,0,6,0,6,0,False,False,False,0,4,2020-10-26T15:10:10.98,6,,0
2020,7,2896,565,10,282,13,5,9,1,0,0,0,0,0,0,False,False,False,0,1,2020-10-27T01:35:25.117,0,,0
2020,7,2896,570,10,7701,2,46,3,0,3,3,3,0,3,0,True,True,False,0,4,2020-10-27T01:19:17.42,3,,0
2020,7,2896,580,16,374,2,54,10,0,17,17,15,2,15,0,False,False,False,0,4,2020-10-30T17:21:12.527,17,,2
2020,7,2896,590,16,3938,2,51,9,-4,7,11,7,0,7,0,False,False,False,0,3,2021-03-04T15:02:38.16,7,,0
2020,7,2896,595,16,374,2,51,10,-1,6,7,3,3,3,0,False,False,False,0,4,2020-10-30T17:21:40.34,6,,3
2020,7,2896,605,16,3938,13,5,3,8,0,0,0,0,0,0,False,False,False,0,3,2020-10-30T19:47:25.77,0,,0
2020,7,2896,630,10,7703,2,47,5,1,6,5,5,1,5,0,False,False,False,0,4,2020-10-30T18:06:04.423,6,,1
2020,7,2896,645,10,7701,3,2,9,14,0,0,0,0,0,0,False,False,False,0,3,2021-03-05T20:07:55.517,0,,0
2020,7,2896,655,16,7681,2,51,3,2,17,15,16,1,16,0,False,False,False,0,1,2020-10-30T18:37:45.573,17,,1
2020,7,2896,660,16,3938,2,2,4,7,7,0,7,0,7,0,False,False,False,0,3,2020-10-26T13:50:54.547,7,,0
2020,7,2896,665,16,7182,2,31,10,8,22,14,21,1,21,0,False,False,False,0,4,2021-02-17T17:37:10.443,22,,1
2020,7,2896,675,16,3938,2,47,10,0,10,10,5,5,5,6,False,False,False,1,4,2021-02-17T17:39:47.137,10,,5
2020,7,2896,695,10,6285,2,4,5,-2,13,15,12,1,12,0,False,False,False,0,2,2020-10-27T01:28:25.627,13,,1
2020,7,2896,710,10,6840,2,4,10,6,11,5,11,0,11,0,False,False,False,0,4,2020-10-26T14:24:50.86,11,,0
2020,7,2896,715,10,6840,2,17,1,16,24,8,19,5,19,0,False,False,False,0,4,2020-10-30T18:37:45.573,24,,5
2020,7,2896,720,10,6282,2,45,5,-6,5,11,2,3,2,0,False,False,False,1,1,2020-10-30T17:40:37.46,5,,3
2020,7,2896,725,10,7703,2,47,5,1,11,10,10,1,10,0,False,False,False,1,4,2020-10-30T19:15:10.853,11,,1
2020,7,2896,750,16,5039,2,47,5,2,11,9,11,0,11,0,True,False,False,0,4,2020-10-27T21:21:38.853,11,,0
2020,7,2896,765,16,3516,2,47,5,1,2,1,2,0,2,0,False,False,False,0,1,2020-10-26T15:02:33.147,2,,0
2020,7,2896,795,10,7703,2,47,5,2,9,7,7,2,7,0,False,False,False,0,4,2020-10-26T14:49:34.61,9,,2
2020,7,2896,800,10,7703,2,5,5,4,8,4,7,1,7,0,False,False,False,0,4,2020-10-26T14:50:39.71,8,,1
2020,7,2896,815,10,7700,13,5,3,3,0,0,0,0,0,0,False,False,False,0,3,2021-03-17T19:11:33.217,0,,0
2020,7,2896,820,10,6285,13,2,4,10,0,0,0,0,0,0,False,False,False,0,3,2020-10-26T15:16:05.86,0,,0
2020,7,2896,825,10,6282,13,5,5,4,0,0,0,0,0,0,False,False,False,0,1,2020-10-26T15:16:19.82,0,,0
2020,7,2896,830,10,7702,13,9,6,29,0,0,0,0,0,0,False,False,False,0,2,2020-10-27T01:36:40.79,0,,0
2020,7,2897,25,28,4922,2,6,10,6,7,1,7,0,7,0,False,False,False,0,4,2020-10-26T10:15:37.377,7,,0.0
2020,7,2897,30,28,7224,2,51,3,-4,23,27,6,17,6,0,True,False,False,0,3,2020-10-29T13:23:11.077,23,,17.0
2020,7,2897,35,28,4922,2,2,10,6,15,9,11,4,11,0,False,False,False,0,3,2020-10-27T15:51:20.18,15,,4.0
2020,7,2897,45,28,7224,2,45,5,-6,14,20,10,4,10,0,True,False,False,0,2,2021-02-17T19:33:49.13,14,,4.0
2020,7,2897,70,19,7173,2,4,3,6,6,0,6,0,6,0,False,False,False,0,2,2020-10-26T10:41:57.797,6,,0.0
2020,7,2897,85,19,1328,2,5,3,2,3,1,3,0,3,0,False,False,False,0,1,2020-10-29T12:58:49.06,3,,0.0
2020,7,2897,100,28,6624,2,47,5,1,1,0,1,0,1,0,False,False,False,0,1,2020-10-26T10:54:56.233,1,,0.0
2020,7,2897,105,28,4922,2,5,5,13,14,1,12,2,12,0,False,False,False,0,3,2020-10-26T10:57:17.593,14,,2.0
2020,7,2897,115,28,7619,2,6,4,14,19,5,14,5,14,0,False,False,False,1,3,2020-10-26T11:00:39.033,19,,5.0
2020,7,2897,135,28,4922,13,8,1,21,0,0,0,0,0,0,True,False,False,0,3,2021-03-09T19:48:34.43,0,,0.0
2020,7,2897,140,19,3233,13,6,6,22,0,0,0,0,0,0,False,False,False,0,3,2020-10-26T11:14:01.973,0,,
2020,7,2897,165,19,7173,13,13,10,2,0,0,0,0,0,0,False,False,False,0,3,2021-02-17T19:36:37.39,0,,0.0
2020,7,2897,215,28,7619,2,34,4,-5,20,25,18,2,18,0,True,False,False,0,3,2021-03-04T15:03:49.467,20,,2.0
2020,7,2897,220,28,262,3,31,4,5,0,0,0,0,0,0,False,False,False,0,1,2020-10-26T11:40:59.137,0,,0.0
2020,7,2897,230,28,6624,2,51,3,-6,7,13,5,2,5,0,True,False,False,0,1,2020-10-29T13:13:07.163,7,,2.0
2020,7,2897,235,28,4912,13,26,10,4,0,0,0,0,0,0,True,False,False,0,2,2020-10-29T13:41:31.77,0,,0.0
2020,7,2897,250,19,7175,13,12,9,14,0,0,0,0,0,0,False,False,False,0,3,2021-03-09T19:49:49.777,0,,0.0
2020,7,2897,255,28,4922,2,26,9,-1,8,9,5,3,5,0,False,False,False,0,4,2020-10-29T13:39:52.623,8,,3.0
2020,7,2897,295,19,7456,2,48,9,-1,1,2,1,0,1,0,False,True,False,0,1,2020-10-26T12:09:19.217,1,,0.0
2020,7,2897,300,19,3233,13,4,3,8,0,0,0,0,0,0,False,False,False,0,2,2020-10-26T12:11:00.89,0,,0.0
2020,7,2897,310,28,7619,2,4,9,11,15,4,13,2,13,0,False,False,False,0,3,2020-10-26T12:13:57.45,15,,2.0
2020,7,2897,320,28,7751,2,51,10,-6,16,22,8,8,8,0,True,False,False,1,1,2020-10-26T12:18:10.293,16,,8.0
2020,7,2897,340,28,7224,2,51,3,-4,9,13,6,3,6,0,True,False,False,0,3,2020-10-26T15:00:17.717,9,,3.0
2020,7,2897,345,28,7224,2,28,10,1,13,12,9,4,9,0,False,False,False,0,3,2020-10-26T12:25:08.847,13,,4.0
2020,7,2897,365,19,7175,2,6,1,20,23,3,20,3,20,0,False,False,False,0,2,2020-10-29T13:13:07.163,23,,
2020,7,2897,370,19,7175,2,6,8,20,20,0,20,0,20,0,False,False,False,0,2,2020-10-29T13:01:39.167,20,,0.0
2020,7,2897,380,19,7175,13,8,8,58,0,0,0,0,0,0,False,False,False,0,3,2021-03-05T20:11:45.293,0,,0.0
2020,7,2897,385,28,4922,13,12,5,-5,0,0,0,0,0,0,True,False,False,0,1,2021-03-08T20:46:33.933,0,,0.0
2020,7,2897,395,28,7619,13,19,6,43,0,0,0,0,0,0,False,False,False,0,2,2021-03-05T20:12:12.533,0,,0.0
2020,7,2897,415,19,7175,2,5,6,21,21,0,21,0,21,0,False,False,False,0,3,2021-02-17T19:57:00.917,21,,0.0
2020,7,2897,420,19,7172,2,48,9,-4,12,16,10,2,10,0,False,False,False,0,1,2021-02-17T19:57:31.537,12,,2.0
2020,7,2897,455,28,7619,2,6,4,12,23,11,16,7,16,0,False,False,False,1,3,2021-03-03T14:43:46.407,23,,7.0
2020,7,2897,470,28,7224,2,26,9,-1,6,7,4,2,4,0,False,False,False,0,3,2020-10-26T13:26:21.99,6,,2.0
2020,7,2897,475,28,7619,2,9,2,26,35,9,35,0,35,0,False,False,False,0,3,2020-10-26T13:28:12.96,35,,0.0
2020,7,2897,495,19,3233,2,5,6,17,16,-1,16,0,16,0,False,False,False,0,3,2020-10-26T13:35:05.93,16,,0.0
2020,7,2897,505,19,7175,2,5,3,11,11,0,11,0,11,0,False,False,False,0,3,2020-10-29T13:13:07.163,11,,0.0
2020,7,2897,510,19,7622,2,31,10,7,8,1,8,0,8,0,False,False,False,0,4,2020-10-29T13:03:59.447,8,,0.0
2020,7,2897,525,19,54,13,4,4,11,0,0,0,0,0,0,False,False,False,0,3,2021-03-05T20:12:54.167,0,,0.0
2020,7,2897,535,28,262,2,17,10,12,18,6,18,0,18,0,True,False,False,0,3,2020-10-26T13:57:30.223,18,,0.0
2020,7,2897,570,28,7619,2,5,5,4,3,-1,3,0,3,0,False,False,False,0,3,2020-10-29T12:53:56.28,3,,0.0
2020,7,2897,605,19,7175,2,4,10,4,8,4,6,2,6,0,False,False,False,0,3,2020-10-26T14:15:33.723,8,,2.0
2020,7,2897,615,19,1510,13,5,9,4,0,0,0,0,0,0,False,False,False,0,1,2021-02-17T20:09:24.2,0,,
2020,7,2897,620,19,1510,2,38,4,2,3,1,3,0,3,0,False,False,False,0,1,2020-10-29T13:05:20.6,3,,0.0
2020,7,2897,630,19,54,13,5,5,4,0,0,0,0,0,0,False,False,False,0,3,2021-03-05T20:13:32.697,0,,0.0
2020,7,2897,645,28,4922,2,5,3,11,11,0,11,0,11,0,False,False,False,0,3,2021-02-17T20:12:58.88,11,,0.0
2020,7,2897,695,19,54,2,6,10,8,13,5,11,2,11,0,True,False,False,0,2,2020-10-29T13:13:07.163,13,,2.0
2020,7,2897,700,19,1510,13,32,5,3,0,0,0,0,0,0,False,False,False,0,1,2020-10-29T13:06:22.3,0,,0.0
2020,7,2897,705,19,1510,2,48,9,-5,17,22,15,2,15,0,False,False,False,0,1,2020-10-26T14:44:26.22,17,,2.0
2020,7,2897,715,19,6273,2,32,5,1,8,7,4,4,4,0,False,False,False,1,3,2020-10-26T14:49:19.117,8,,4.0
2020,7,2897,730,19,1510,2,48,10,-1,15,16,12,3,12,0,False,False,False,0,1,2020-10-26T14:48:53.413,15,,3.0
2020,7,2898,10,30,63,13,35,6,15,0,0,0,0,0,0,False,False,False,0,4,2020-10-29T16:09:10.477,0,,0.0
2020,7,2898,20,30,63,2,38,10,4,3,-1,3,0,3,0,False,False,False,0,4,2020-10-26T11:12:27.88,3,,0.0
2020,7,2898,35,23,2256,2,8,1,15,28,13,27,1,27,0,False,False,False,0,3,2020-10-26T11:16:04.91,28,,1.0
2020,7,2898,45,23,2994,2,35,10,11,14,3,14,0,14,0,False,False,False,0,4,2020-10-26T11:18:36.223,14,,0.0
2020,7,2898,55,23,2256,2,17,1,20,20,0,20,0,20,6,False,False,False,0,3,2020-10-26T11:20:57.61,20,,0.0
2020,7,2898,75,30,4516,2,50,9,-1,6,7,3,3,3,0,False,False,False,0,2,2020-10-26T11:23:52.687,6,,3.0
2020,7,2898,80,30,63,2,35,9,14,28,14,18,10,18,0,False,True,False,0,4,2020-10-26T11:26:10.7,22,,10.0
2020,7,2898,100,30,6570,2,5,5,10,12,2,12,0,12,0,False,False,False,0,4,2020-10-29T16:09:24.03,12,,0.0
2020,7,2898,110,30,4937,2,16,10,4,8,4,7,1,7,0,False,False,False,0,1,2020-10-29T16:19:45.543,8,,1.0
2020,7,2898,135,23,7241,2,4,9,3,5,2,3,2,3,0,False,False,False,0,1,2020-10-29T16:09:32.027,5,,2.0
2020,7,2898,140,23,2994,13,47,5,0,0,0,0,0,0,0,False,False,False,0,4,2020-10-29T16:09:39.957,0,,0.0
2020,7,2898,150,23,7241,2,45,10,-7,7,14,-2,9,-2,0,False,False,False,1,1,2020-10-29T16:09:48.997,7,,9.0
2020,7,2898,160,23,7688,2,26,9,3,29,26,28,1,28,0,True,False,False,1,2,2020-10-27T15:23:44.82,29,,1.0
2020,7,2898,175,23,2256,2,2,9,8,9,1,8,1,8,0,False,False,False,0,2,2020-10-26T11:50:39.663,9,,1.0
2020,7,2898,185,23,2994,13,4,10,4,0,0,0,0,0,0,False,False,False,0,4,2021-04-02T13:28:47.503,0,,0.0
2020,7,2898,205,30,7268,2,4,3,-1,8,9,8,0,8,0,False,False,False,0,2,2020-10-26T11:57:21.747,8,,0.0
2020,7,2898,210,30,6414,3,48,9,-4,0,0,0,0,0,0,False,False,False,0,1,2020-10-26T11:58:52.273,0,,0.0
2020,7,2898,215,30,4937,2,44,3,-4,6,10,6,0,6,0,False,False,False,0,1,2020-10-26T12:00:29.363,6,,0.0
2020,7,2898,220,30,4937,13,11,3,10,0,0,0,0,0,0,True,False,False,0,1,2020-10-26T12:01:52.677,0,,0.0
2020,7,2898,230,23,2256,2,5,5,5,6,1,6,0,6,0,False,False,False,0,3,2020-10-27T15:24:11.86,6,,0.0
2020,7,2898,240,23,2994,2,26,10,4,11,7,10,1,10,0,True,False,False,0,4,2020-10-27T15:26:55.11,11,,1.0
2020,7,2898,245,23,7241,13,28,9,1,0,0,0,0,0,0,False,False,False,0,1,2020-10-26T12:08:46.057,0,,0.0
2020,7,2898,265,23,2256,13,6,8,17,0,0,0,0,0,0,False,False,False,0,2,2020-10-26T12:44:15.427,0,,0.0
2020,7,2898,275,30,4937,2,16,10,2,11,9,8,3,8,0,False,False,False,0,1,2020-10-26T12:15:45.557,11,,3.0
2020,7,2898,285,30,4516,2,35,9,14,16,2,16,0,16,0,False,False,False,0,2,2020-10-27T00:04:50.69,16,,0.0
2020,7,2898,300,30,63,2,35,8,23,26,3,25,1,25,0,False,False,False,0,4,2020-10-26T12:28:15.98,26,,1.0
2020,7,2898,310,30,63,2,29,3,5,5,0,5,0,5,6,False,False,False,0,2,2020-10-26T12:26:59.977,5,,0.0
2020,7,2898,330,23,7688,13,35,2,27,0,0,0,0,0,0,False,False,False,0,3,2020-10-26T12:32:26.65,0,,
2020,7,2898,335,23,7240,2,47,5,1,21,20,6,15,6,0,False,False,False,2,1,2020-10-26T12:34:15.093,21,,15.0
2020,7,2898,340,23,2994,13,4,8,16,0,0,0,0,0,0,False,False,False,0,4,2020-10-27T00:05:31.437,0,,0.0
2020,7,2898,350,23,3957,2,4,4,2,6,4,6,0,6,0,False,False,False,0,1,2020-10-26T12:40:58.257,6,,0.0
2020,7,2898,380,30,4516,2,2,4,5,5,0,5,0,5,0,True,False,False,0,3,2020-10-26T12:48:43.177,5,,0.0
2020,7,2898,385,30,4937,2,31,9,-5,2,7,1,1,1,0,False,False,False,0,1,2020-10-29T16:10:16.1,2,,1.0
2020,7,2898,395,30,4516,2,4,10,10,16,6,16,0,16,0,True,False,False,0,3,2020-10-26T12:54:37.153,16,,0.0
2020,7,2898,400,30,7268,13,8,7,29,0,0,0,0,0,0,False,False,False,0,2,2021-02-17T19:27:19.493,0,,0.0
2020,7,2898,405,30,7268,2,3,5,7,11,4,6,5,6,0,False,False,False,1,2,2021-03-03T14:48:34.88,11,,5.0
2020,7,2898,410,30,4937,2,28,10,0,7,7,5,2,5,0,False,False,False,0,1,2020-10-26T12:59:54.687,7,,2.0
2020,7,2898,420,30,7268,13,2,10,5,0,0,0,0,0,0,False,False,False,0,2,2020-10-26T13:02:22.603,0,,0.0
2020,7,2898,425,30,4516,2,2,4,4,8,4,6,2,6,0,False,False,False,0,3,2020-10-26T13:03:51.787,8,,2.0
2020,7,2898,435,30,7268,2,19,6,33,33,0,33,0,33,6,False,False,False,0,2,2020-10-26T13:05:53.807,33,,0.0
2020,7,2898,450,23,7250,2,49,9,-4,9,13,7,2,7,0,False,False,False,0,2,2020-10-29T15:31:21.573,9,,2.0
2020,7,2898,470,23,7250,3,4,10,6,0,0,0,0,0,0,False,False,False,0,3,2020-10-27T15:24:45.993,0,,0.0
2020,7,2898,475,23,7250,2,2,10,6,15,9,15,0,15,0,False,False,False,1,3,2020-10-26T13:16:35.673,15,,0.0
2020,7,2898,480,23,7688,2,5,3,4,6,2,6,0,6,0,False,False,False,0,3,2020-10-26T13:20:03.067,6,,0.0
2020,7,2898,485,23,7688,13,7,6,42,0,0,0,0,0,0,False,False,False,0,2,2020-10-27T15:28:41.743,0,,0.0
2020,7,2898,490,23,6630,13,8,7,40,0,0,0,0,0,0,False,False,False,0,3,2020-10-26T13:24:02.63,0,,0.0
2020,7,2898,505,30,4516,2,5,5,4,6,2,4,2,4,0,True,False,False,0,3,2020-10-26T13:27:55.553,6,,2.0
2020,7,2898,515,30,793,3,6,10,5,0,0,0,0,0,0,False,False,False,0,3,2020-10-26T13:31:57.63,0,,
2020,7,2898,520,30,7268,2,35,2,26,35,9,35,0,35,0,False,False,False,0,2,2020-10-26T13:33:33.52,35,,0.0
2020,7,2898,525,30,7893,2,49,9,-1,3,4,2,1,2,0,False,False,False,0,2,2020-10-26T13:34:53.92,3,,1.0
2020,7,2898,530,30,2290,2,5,3,8,8,0,8,0,8,0,False,False,False,0,4,2020-10-26T13:36:49.82,8,,0.0
2020,7,2898,540,30,63,13,7,2,19,0,0,0,0,0,0,False,False,False,0,4,2020-10-26T13:39:40.92,0,,0.0
2020,7,2898,545,30,7268,2,46,3,2,10,8,7,3,7,0,False,False,False,0,3,2020-10-26T13:41:34.65,10,,3.0
2020,7,2898,560,23,7250,2,2,10,5,11,6,9,2,9,0,True,False,False,0,3,2020-10-27T15:27:25.503,11,,2.0
2020,7,2898,570,23,7241,2,28,9,2,2,0,2,0,2,0,False,False,False,0,1,2020-10-27T15:25:16.047,2,,0.0
2020,7,2898,575,23,2256,13,8,1,22,0,0,0,0,0,0,False,False,False,0,3,2020-10-26T13:56:18.593,0,,
2020,7,2898,585,23,2256,2,19,6,40,44,4,40,4,40,0,False,False,False,0,2,2021-03-15T15:40:05.11,44,,4.0
2020,7,2898,595,23,2994,2,2,9,1,1,0,1,0,1,6,False,False,False,0,2,2020-10-26T14:00:46.97,1,,0.0
2020,7,2898,610,30,6414,2,45,10,1,2,1,2,0,2,0,False,False,False,0,1,2020-10-26T14:05:38.9,2,,0.0
2020,7,2898,620,30,4516,2,50,3,-2,4,6,2,2,2,0,False,False,False,0,2,2021-03-04T16:18:36.403,4,,2.0
2020,7,2898,625,30,7268,13,7,2,43,0,0,0,0,0,0,False,False,False,0,3,2020-10-26T14:10:07.54,0,,0.0
2020,7,2898,640,23,2994,2,51,10,0,11,11,9,2,9,0,False,False,False,0,4,2021-02-17T19:29:11.89,11,,2.0
2020,7,2898,645,23,3957,2,4,5,2,3,1,2,1,2,0,True,False,False,1,2,2021-03-03T14:51:01,3,,1.0
2020,7,2898,650,23,2256,3,26,3,2,0,0,0,0,0,0,False,False,False,0,2,2020-10-29T16:19:45.543,0,,0.0
2020,7,2898,660,23,2994,2,2,10,6,10,4,8,2,8,0,False,False,False,0,3,2020-10-26T14:20:41.66,10,,2.0
2020,7,2898,675,23,596,2,28,4,2,6,4,6,0,6,0,False,False,False,0,4,2020-10-26T14:36:04.37,6,,0.0
2020,7,2898,680,23,2256,3,35,5,14,0,0,0,0,0,0,False,False,False,0,3,2020-10-26T14:37:17.42,0,,0.0
2020,7,2898,685,23,2994,2,5,5,3,3,0,3,0,3,0,False,False,False,0,4,2020-10-26T14:38:44.6,3,,0.0
2020,7,2898,710,30,4937,2,28,10,4,13,9,12,1,12,0,True,False,False,0,1,2020-10-26T14:43:20.513,13,,1.0
2020,7,2898,725,30,793,13,24,2,24,0,0,0,0,0,0,False,False,False,0,3,2020-10-29T16:10:38.277,0,,
2020,7,2898,735,30,793,2,2,4,11,15,4,13,2,13,0,False,False,False,0,3,2020-10-29T14:54:51.92,15,,2.0
2020,7,2898,740,30,63,2,13,5,5,6,1,6,0,6,0,False,False,False,0,4,2020-10-29T14:55:34.86,6,,0.0
2020,7,2898,745,30,63,13,29,2,16,0,0,0,0,0,0,False,False,False,0,4,2020-10-26T14:59:49.54,0,,0.0
2020,7,2898,750,30,7268,2,46,3,2,12,10,12,0,12,0,False,False,False,0,2,2020-10-27T00:07:19.99,12,,0.0
2020,7,2898,755,30,4516,2,32,5,4,4,0,4,0,4,6,False,False,False,0,4,2020-10-26T15:03:18.647,4,,0.0
2020,7,2898,770,23,2256,13,6,8,15,0,0,0,0,0,0,False,False,False,0,3,2021-03-09T19:52:12.44,0,,0.0
2020,7,2898,775,30,4516,2,8,7,18,23,5,20,3,20,0,True,False,False,0,3,2020-10-26T15:09:00.977,23,,3.0
2020,7,2898,795,23,7250,2,49,9,-3,7,10,5,2,5,0,False,False,False,0,2,2021-02-17T19:29:52.05,7,,2.0
2020,7,2898,805,23,7250,13,11,6,18,0,0,0,0,0,0,False,False,False,0,3,2020-10-26T15:15:46.973,0,,0.0
2020,7,2898,835,30,793,2,7,6,18,22,4,22,0,22,0,False,False,False,0,3,2020-10-26T15:28:09.697,22,,0.0
2020,7,2898,855,30,7893,2,6,4,1,1,0,1,0,1,6,False,False,False,0,2,2020-10-26T15:33:57.297,1,,0.0
2020,7,2899,20,6,6328,2,5,3,7,8,1,8,0,8,0,True,False,False,0,3,2020-10-27T11:04:34.513,8,,0.0
2020,7,2899,25,6,464,2,5,5,5,8,3,8,0,8,0,False,False,False,0,2,2020-10-27T11:05:47.737,8,,0.0
2020,7,2899,35,6,811,13,2,10,10,0,0,0,0,0,0,False,False,False,0,3,2020-10-27T11:10:31.267,0,,0.0
2020,7,2899,40,6,811,2,13,10,4,7,3,6,1,6,0,True,False,False,0,2,2020-10-27T11:12:04.98,7,,1.0
2020,7,2899,60,29,1958,2,30,9,3,13,10,13,0,13,0,False,False,False,0,3,2020-10-27T11:16:33.707,13,,0.0
2020,7,2899,65,29,4866,2,47,5,1,11,10,10,1,10,0,False,False,False,0,3,2020-10-27T11:25:23.767,11,,1.0
2020,7,2899,70,29,1958,13,5,5,3,0,0,0,0,0,0,False,False,False,0,3,2020-10-27T11:27:35.39,0,,0.0
2020,7,2899,75,29,4850,13,26,10,7,0,0,0,0,0,0,False,False,False,0,4,2020-10-29T21:30:44.647,0,,
2020,7,2899,85,29,3356,13,44,3,4,0,0,0,0,0,0,False,False,False,0,1,2020-10-27T11:32:56.34,0,,0.0
2020,7,2899,95,29,4850,2,50,10,-5,-3,2,-3,0,-3,0,False,False,False,0,2,2020-10-29T17:32:00.487,-3,,0.0
2020,7,2899,110,6,2071,3,4,9,6,0,0,0,0,0,0,False,False,False,0,4,2020-10-27T11:44:00.763,0,,0.0
2020,7,2899,115,6,811,2,44,3,-2,2,4,-1,3,-1,0,False,False,False,0,1,2020-10-27T11:45:16.373,2,,3.0
2020,7,2899,125,29,4875,13,19,7,48,0,0,0,0,0,0,False,False,False,0,3,2020-10-27T11:48:15.267,0,,0.0
2020,7,2899,130,29,4850,2,12,2,17,16,-1,16,0,16,0,False,False,False,0,3,2020-10-27T11:49:48.547,16,,0.0
2020,7,2899,135,29,7828,2,3,3,14,14,0,14,0,14,0,False,False,False,0,2,2020-10-27T11:53:58.46,14,,0.0
2020,7,2899,140,29,4906,2,47,10,1,7,6,5,2,5,0,False,False,False,0,4,2020-10-27T11:53:27.02,7,,2.0
2020,7,2899,150,29,4906,2,30,3,0,7,7,3,4,3,0,False,False,False,0,4,2020-10-29T14:15:43.347,7,,4.0
2020,7,2899,155,29,4875,2,46,3,4,4,0,4,0,4,6,False,False,False,0,1,2020-10-27T11:57:46.067,4,,0.0
2020,7,2899,170,6,7728,2,33,6,23,38,15,24,14,24,0,False,False,False,1,4,2020-10-27T12:00:44.8,38,,14.0
2020,7,2899,175,6,7728,2,12,3,7,7,0,7,0,7,0,False,False,False,0,4,2020-10-29T21:30:56.36,7,,0.0
2020,7,2899,190,6,811,2,34,4,-4,2,6,-3,5,-3,0,True,False,False,0,2,2020-10-27T12:05:24.737,2,,5.0
2020,7,2899,205,6,7725,2,13,10,2,3,1,3,0,3,0,False,False,False,0,3,2020-10-27T12:07:54.04,3,,0.0
2020,7,2899,230,29,4875,2,4,8,18,18,0,18,0,18,0,False,False,False,0,2,2021-03-15T16:11:35.373,18,,0.0
2020,7,2899,245,29,4875,2,4,5,3,9,6,7,2,7,0,False,False,False,0,2,2020-10-29T21:31:18.207,9,,2.0
2020,7,2899,255,29,1958,2,5,5,3,3,0,3,0,3,0,False,False,False,0,3,2020-10-27T12:19:43.257,3,,0.0
2020,7,2899,260,29,1958,13,7,6,29,0,0,0,0,0,0,False,False,False,0,2,2021-02-24T21:58:10.18,0,,0.0
2020,7,2899,275,6,7725,13,23,7,47,0,0,0,0,0,0,False,False,False,0,3,2020-10-27T12:24:42.447,0,,0.0
2020,7,2899,280,6,6331,2,26,5,7,8,1,8,0,8,0,False,False,False,0,3,2020-10-27T12:26:54.823,8,,0.0
2020,7,2899,300,29,4906,2,26,4,2,34,32,6,28,6,0,False,False,False,1,4,2020-10-27T12:30:55.08,34,,28.0
2020,7,2899,315,29,7378,2,6,4,2,2,0,2,0,2,0,False,False,False,0,1,2020-10-27T12:34:50.927,2,,0.0
2020,7,2899,330,6,464,2,4,10,14,14,0,14,0,14,0,False,False,False,0,2,2020-10-29T21:31:27.973,14,,0.0
2020,7,2899,335,6,666,2,4,9,5,6,1,6,0,6,0,False,False,False,0,4,2020-10-27T12:38:31.813,6,,0.0
2020,7,2899,345,6,7725,2,30,10,0,18,18,14,4,14,0,True,False,False,1,4,2020-10-28T06:26:27.14,18,,4.0
2020,7,2899,380,29,4866,2,4,9,5,6,1,5,1,5,0,False,False,False,0,3,2020-10-27T12:44:46.83,6,,1.0
2020,7,2899,385,29,4875,13,19,6,25,0,0,0,0,0,0,False,False,False,0,3,2020-10-29T17:42:00.103,0,,0.0
2020,7,2899,400,29,4875,13,6,9,11,0,0,0,0,0,0,False,False,False,0,2,2020-10-29T18:27:33.633,0,,0.0
2020,7,2899,430,29,4866,13,5,6,19,0,0,0,0,0,0,False,False,False,0,3,2020-10-27T13:03:45.463,0,,
2020,7,2899,435,29,4866,2,34,4,-4,-5,-1,-5,0,-5,0,True,False,False,0,3,2020-10-27T13:05:03.943,-5,,0.0
2020,7,2899,440,29,4866,2,13,4,4,13,9,11,2,11,0,False,False,False,0,3,2020-10-27T13:07:08.937,13,,2.0
2020,7,2899,475,6,7725,13,21,6,23,0,0,0,0,0,0,False,False,False,0,2,2020-10-27T13:15:10.853,0,,0.0
2020,7,2899,490,29,4875,13,35,6,20,0,0,0,0,0,0,False,False,False,0,2,2020-10-29T16:50:37.593,0,,0.0
2020,7,2899,495,29,4875,2,6,10,7,21,14,18,3,18,0,False,False,False,0,2,2020-10-27T13:32:06.49,21,,3.0
2020,7,2899,500,29,1958,2,5,5,5,6,1,6,0,6,0,False,False,False,0,3,2020-10-27T13:33:39.837,6,,0.0
2020,7,2899,505,29,4866,2,2,4,5,10,5,8,2,8,0,False,False,False,0,3,2020-10-27T13:34:50.357,10,,2.0
2020,7,2899,530,6,2071,2,4,9,5,9,4,6,3,6,0,False,False,False,0,3,2020-10-27T13:41:51.81,9,,3.0
2020,7,2899,540,6,666,2,2,4,6,14,8,6,8,6,0,False,False,False,1,3,2020-10-29T21:31:49.73,14,,8.0
2020,7,2899,550,6,464,13,9,2,29,0,0,0,0,0,0,False,False,False,0,2,2020-10-29T21:31:59.887,0,,
2020,7,2899,555,6,2071,2,47,5,-2,6,8,3,3,3,0,False,False,False,1,4,2020-10-28T06:28:14.117,6,,3.0
2020,7,2899,560,6,7725,13,7,3,9,0,0,0,0,0,0,False,False,False,0,3,2020-10-29T18:28:09.56,0,,0.0
2020,7,2899,565,29,4850,2,26,10,2,3,1,2,1,2,0,False,False,False,0,4,2020-10-27T13:50:35.753,3,,1.0
2020,7,2899,570,29,7378,2,44,3,-3,11,14,9,2,9,0,False,False,False,1,1,2021-03-03T14:57:20.857,11,,2.0
2020,7,2899,575,29,4850,13,32,10,2,0,0,0,0,0,0,False,False,False,0,4,2020-10-27T13:53:38.383,0,,0.0
2020,7,2899,585,29,4866,2,2,4,7,8,1,7,1,7,0,False,False,False,0,3,2020-10-27T13:55:44.27,8,,1.0
2020,7,2899,605,29,4850,2,4,9,4,12,8,4,8,4,6,False,False,False,1,3,2020-10-27T13:59:54.903,12,,8.0
2020,7,2899,625,6,6786,2,48,10,-7,0,7,-2,2,-2,0,False,False,False,0,1,2020-10-27T14:03:34.687,0,,2.0
2020,7,2899,630,6,6328,2,13,9,3,7,4,4,3,4,0,False,False,False,0,3,2020-10-27T14:05:37.733,7,,3.0
2020,7,2899,670,6,464,2,19,6,40,42,2,40,2,40,0,False,False,False,0,2,2021-02-17T19:24:18.033,42,,2.0
2020,7,2899,675,6,6786,2,46,3,0,3,3,3,0,3,0,False,False,False,0,1,2020-10-27T14:15:50.55,3,,0.0
2020,7,2899,690,6,666,2,47,10,-2,4,6,2,2,2,0,False,False,False,0,4,2020-10-27T14:19:48.13,4,,2.0
2020,7,2899,700,6,6328,13,3,5,4,0,0,0,0,0,0,False,False,False,0,2,2020-10-29T18:00:48.833,0,,0.0
2020,7,2899,755,6,6328,13,8,7,40,0,0,0,0,0,0,False,False,False,0,3,2020-10-28T06:27:11.087,0,,0.0
2020,7,2899,760,6,6786,2,46,3,0,7,7,5,2,5,0,False,False,False,0,1,2020-10-27T14:42:10.17,7,,2.0
2020,7,2899,765,6,464,2,2,4,6,6,0,6,0,6,0,False,False,False,0,3,2020-10-27T14:43:20.687,6,,0.0
2020,7,2899,770,6,6786,2,47,10,-2,5,7,5,0,5,0,False,False,False,0,1,2020-10-27T14:44:45.053,5,,0.0
2020,7,2899,775,6,666,13,7,2,17,0,0,0,0,0,0,False,False,False,0,3,2020-10-27T14:45:56.84,0,,0.0
2020,7,2899,815,6,666,2,32,10,3,7,4,5,2,5,0,False,False,False,0,4,2020-10-29T21:32:09.81,7,,2.0
2020,7,2899,820,6,7725,2,8,7,19,19,0,19,0,19,0,False,False,False,0,3,2020-10-27T14:52:33.39,19,,0.0
2020,7,2899,830,6,6786,2,13,9,2,6,4,2,4,2,0,False,False,False,2,2,2020-10-27T14:54:29.837,6,,4.0
2020,7,2899,840,6,6328,2,5,5,5,5,0,5,0,5,0,False,False,False,0,3,2020-10-27T14:55:27.957,5,,0.0
2020,7,2899,845,6,7725,13,19,8,50,0,0,0,0,0,0,False,False,False,0,3,2020-10-29T18:29:11.217,0,,0.0
2020,7,2899,850,6,666,2,32,9,-4,0,4,0,0,0,0,False,False,False,0,3,2020-10-27T14:58:49.893,0,,0.0
2020,7,2899,870,6,6331,13,19,6,41,0,0,0,0,0,0,False,False,False,0,2,2020-10-27T15:01:04.443,0,,0.0
2020,8,2900,10,2,661,2,6,1,19,24,5,21,3,21,0,False,False,False,1,2,2020-10-30T11:50:56.073,24,,
2020,8,2900,15,2,661,2,5,6,24,28,4,28,0,28,0,False,False,False,0,2,2020-11-06T14:57:35.523,28,,
2020,8,2900,20,2,5214,2,30,3,1,11,10,11,0,11,0,True,False,False,0,4,2020-10-30T11:56:30.32,11,,
2020,8,2900,30,2,5223,2,2,10,4,7,3,6,1,6,0,False,False,False,0,2,2020-11-06T13:37:48.363,7,,
2020,8,2900,55,5,5220,3,2,9,7,0,0,0,0,0,0,False,False,False,0,2,2020-10-30T12:03:52.777,0,,
2020,8,2900,60,5,3477,2,2,9,5,5,0,5,0,5,0,False,False,False,0,3,2020-10-30T12:06:02.213,5,,
2020,8,2900,65,5,3477,13,9,3,10,0,0,0,0,0,0,False,False,False,0,3,2020-10-30T12:07:47.88,0,,
2020,8,2900,80,5,2554,2,44,9,-4,11,15,9,2,9,0,False,False,False,1,1,2020-10-30T12:13:32.713,11,,
2020,8,2900,110,2,661,2,6,10,12,13,1,12,1,12,0,False,False,False,0,2,2020-10-30T12:22:11.417,13,,
2020,8,2900,120,2,661,2,6,7,18,20,2,18,2,18,0,False,False,False,0,3,2020-10-30T12:24:16.323,20,,
2020,8,2900,130,2,5214,13,6,9,3,0,0,0,0,0,0,False,False,False,0,3,2020-10-30T12:26:22.547,0,,
2020,8,2900,150,2,5223,2,4,7,16,16,0,16,0,16,0,False,False,False,0,2,2020-10-30T12:29:55.003,16,,
2020,8,2900,160,2,661,13,8,9,13,0,0,0,0,0,0,True,False,False,0,2,2020-11-06T13:53:46.99,0,,
2020,8,2900,165,2,661,13,12,5,13,0,0,0,0,0,0,False,False,False,0,3,2020-10-30T12:37:57.333,0,,
2020,8,2900,185,5,3477,2,5,3,10,27,17,10,17,10,0,True,False,False,2,3,2020-11-06T13:54:59.473,27,,
2020,8,2900,215,2,5223,13,3,6,23,0,0,0,0,0,0,False,False,False,0,2,2021-03-05T14:16:23.407,0,,
2020,8,2900,230,5,4803,2,47,5,-1,3,4,2,1,2,0,True,False,False,0,1,2021-02-17T16:01:11.61,3,,
2020,8,2900,235,5,4803,2,35,6,27,29,2,29,0,29,6,True,False,False,0,3,2020-10-30T13:14:41.643,29,,
2020,8,2900,260,2,5214,2,17,7,15,18,3,18,0,18,0,False,False,False,0,3,2020-10-30T13:25:15.677,18,,
2020,8,2900,265,2,4670,3,44,3,-4,0,0,0,0,0,0,False,False,False,0,1,2020-10-30T13:26:32.823,0,,
2020,8,2900,270,2,5214,2,4,4,6,8,2,8,0,8,0,False,False,False,0,3,2020-10-30T13:30:20.75,8,,
2020,8,2900,285,2,5223,2,2,9,9,19,10,12,7,12,0,True,False,False,1,2,2020-10-31T16:39:18.203,19,,
2020,8,2900,310,5,6425,2,4,9,5,21,16,18,3,18,0,False,False,False,0,4,2020-10-30T13:40:50.717,21,,
2020,8,2900,330,5,3477,2,4,5,4,4,0,4,0,4,0,False,False,False,0,2,2020-10-30T17:23:17.973,4,,
2020,8,2900,350,2,6247,2,50,10,-2,19,21,16,3,16,0,True,False,False,0,3,2020-10-30T16:40:54.697,19,,
2020,8,2900,355,2,6240,2,4,3,6,7,1,6,1,6,0,False,False,False,0,2,2020-10-30T14:03:49.05,7,,
2020,8,2900,375,2,6240,2,2,9,5,7,2,5,2,5,0,False,False,False,0,2,2020-11-06T14:59:42.89,7,,
2020,8,2900,385,2,661,13,35,2,16,0,0,0,0,0,0,False,False,False,0,3,2020-10-30T14:17:53.063,0,,
2020,8,2900,425,5,6425,2,47,5,2,2,0,2,0,2,0,False,False,False,0,4,2020-10-30T14:33:53.613,2,,
2020,8,2900,440,5,2554,13,48,9,-5,0,0,0,0,0,0,False,False,False,0,1,2020-10-30T14:38:51.957,0,,
2020,8,2900,445,5,3477,2,13,10,1,4,3,3,1,3,0,False,False,False,0,3,2020-10-30T17:22:57.397,4,,
2020,8,2900,460,2,661,2,6,1,16,23,7,23,0,23,0,False,False,False,0,2,2020-11-06T14:30:51.267,23,,
2020,8,2900,465,2,2835,13,47,5,1,0,0,0,0,0,0,False,False,False,0,1,2020-10-30T14:54:12.347,0,,
2020,8,2900,485,2,5214,13,12,10,5,0,0,0,0,0,0,False,False,False,0,3,2020-10-30T15:02:33.483,0,,
2020,8,2900,490,2,5214,3,31,10,1,0,0,0,0,0,0,False,False,False,0,4,2021-02-17T16:03:56.033,0,,
2020,8,2900,500,2,6247,2,2,4,6,6,0,6,0,6,0,False,False,False,0,2,2020-11-06T14:32:45.13,6,,
2020,8,2900,515,5,3477,13,2,9,5,0,0,0,0,0,0,False,False,False,0,3,2020-10-30T15:11:22.297,0,,
2020,8,2900,520,5,3750,2,13,9,3,6,3,4,2,4,0,False,False,False,0,3,2020-10-30T15:12:31.137,6,,
2020,8,2900,525,5,4803,13,19,2,31,0,0,0,0,0,0,False,False,False,0,2,2020-10-31T18:34:48.937,0,,
2020,8,2900,545,5,5220,13,13,4,3,0,0,0,0,0,0,False,False,False,0,3,2020-10-30T15:27:00.633,0,,
2020,8,2900,555,5,3477,13,19,2,24,0,0,0,0,0,0,False,False,False,0,2,2020-10-30T15:44:23.31,0,,
2020,8,2900,560,5,4803,2,34,4,-4,-7,-3,-7,0,-7,0,True,False,False,0,3,2020-10-30T15:44:12.017,0,,
2020,8,2900,565,5,3477,3,6,10,14,0,0,0,0,0,0,False,False,False,0,3,2020-11-06T14:14:29.08,0,,
2020,8,2900,585,2,4670,2,47,5,0,0,0,0,0,0,0,False,False,False,0,1,2020-10-30T15:49:21.677,0,,
2020,8,2900,615,2,5214,2,30,5,1,12,11,12,0,12,0,False,False,False,0,4,2021-02-17T16:04:55.207,12,,
2020,8,2900,625,2,661,2,4,5,6,9,3,7,2,7,0,False,False,False,0,2,2020-10-30T16:00:59.003,9,,
2020,8,2900,665,5,4419,13,46,3,-1,0,0,0,0,0,0,False,False,False,0,4,2021-02-17T16:05:21.113,0,,
2020,8,2900,670,5,3477,2,5,3,5,5,0,5,0,5,0,True,False,False,0,3,2020-10-31T18:35:07.063,5,,
2020,8,2900,675,5,4803,2,44,3,-1,-1,0,-1,0,-1,0,True,False,False,0,1,2020-11-06T14:34:30.297,-1,,
2020,8,2900,690,2,4670,2,46,3,3,9,6,7,2,7,0,False,False,False,1,1,2020-11-06T13:40:14.003,9,,
2020,8,2900,710,2,5214,2,47,5,5,5,0,5,0,5,0,True,False,False,0,4,2020-10-30T16:28:37.69,5,,
2020,8,2900,720,2,661,2,35,3,14,20,6,20,0,20,0,False,False,False,0,3,2020-10-30T16:31:58.7,20,,
2020,8,2900,730,2,6247,3,50,10,-1,0,0,0,0,0,0,False,False,False,0,3,2020-11-06T14:57:20.227,0,,
2020,8,2900,745,5,5220,2,6,9,4,13,9,12,1,12,0,False,False,False,2,2,2020-10-30T16:47:55.587,13,,
2020,8,2900,750,5,3477,2,5,5,2,4,2,4,0,4,0,False,False,False,0,3,2020-10-30T17:21:53.9,4,,
2020,8,2900,760,5,6425,2,32,5,1,5,4,5,0,5,0,False,False,False,0,4,2020-10-30T16:52:28.317,5,,
2020,8,2900,785,5,5220,2,24,2,40,42,2,42,0,42,0,False,False,False,0,2,2020-10-30T16:59:52.127,42,,
2020,8,2900,790,5,5220,13,5,3,12,0,0,0,0,0,0,False,False,False,0,2,2020-11-06T14:35:13.353,0,,
2020,8,2900,805,5,5220,13,35,6,21,0,0,0,0,0,0,False,False,False,0,3,2021-03-05T14:16:45.013,0,,
2020,8,2901,10,19,7175,2,5,5,8,7,-1,7,0,7,0,False,False,False,0,2,2020-11-05T19:27:56.95,7,,
2020,8,2901,40,19,1328,13,46,3,2,0,0,0,0,0,0,True,False,False,0,3,2020-11-02T11:22:33.48,0,,
2020,8,2901,80,4,6983,2,5,5,3,6,3,6,0,6,0,True,False,False,0,3,2021-02-17T15:45:10.927,6,,
2020,8,2901,85,4,594,2,26,9,3,12,9,9,3,9,0,False,False,False,0,3,2020-11-05T19:29:32.94,12,,
2020,8,2901,95,4,2853,13,30,9,-3,0,0,0,0,0,0,True,False,False,0,4,2020-11-02T11:58:03.09,0,,
2020,8,2901,120,19,7175,2,2,7,15,16,1,16,0,16,0,True,False,False,0,3,2020-11-03T18:30:46.77,16,,
2020,8,2901,125,19,7175,2,5,2,18,17,-1,17,0,17,0,False,False,False,0,3,2021-03-09T16:33:17.587,17,,
2020,8,2901,140,19,1328,2,31,10,3,10,7,10,0,10,0,True,False,False,0,4,2020-11-03T18:31:08.327,10,,
2020,8,2901,150,19,6273,3,47,5,0,0,0,0,0,0,0,True,False,False,0,4,2020-11-05T19:11:04.343,0,,
2020,8,2901,165,4,2853,2,5,8,19,20,1,19,1,19,0,False,False,False,0,3,2021-03-09T16:34:28.21,20,,
2020,8,2901,175,4,7646,13,19,6,45,0,0,0,0,0,0,False,False,False,0,2,2021-02-17T15:46:09.81,0,,
2020,8,2901,185,4,7645,13,12,3,4,0,0,0,0,0,0,False,False,False,0,1,2021-03-08T21:13:29.51,0,,
2020,8,2901,200,19,7175,2,5,5,4,8,4,8,0,8,0,False,False,False,0,2,2021-02-17T15:47:44.663,8,,
2020,8,2901,215,19,1328,2,31,9,1,28,27,2,26,2,0,False,False,False,1,1,2020-11-05T17:58:18.7,28,,
2020,8,2901,220,19,3233,13,6,4,12,0,0,0,0,0,0,False,False,False,0,2,2020-11-05T19:13:28.887,0,,
2020,8,2901,280,4,1412,13,4,5,7,0,0,0,0,0,0,False,False,False,0,2,2020-11-02T13:25:39.69,0,,
2020,8,2901,310,4,594,2,4,3,5,12,7,10,2,10,0,False,False,False,0,3,2020-11-02T13:41:06.33,12,,
2020,8,2901,315,4,2853,2,4,3,8,8,0,8,0,8,0,False,False,False,0,2,2020-11-03T17:13:31.51,8,,
2020,8,2901,330,4,2853,2,3,5,12,12,0,12,0,12,0,False,False,False,0,2,2021-03-09T16:38:34.423,12,,
2020,8,2901,350,4,2853,2,6,9,4,5,1,4,1,4,0,False,False,False,0,2,2020-11-02T13:59:57.477,5,,
2020,8,2901,355,4,2853,13,4,2,15,0,0,0,0,0,0,False,False,False,0,2,2021-03-09T19:55:05.127,0,,
2020,8,2901,365,19,7175,13,35,9,10,0,0,0,0,0,0,False,False,False,0,3,2020-11-05T19:14:09.237,0,,
2020,8,2901,370,19,7175,2,6,4,9,10,1,10,0,10,0,False,False,False,0,3,2020-11-05T19:37:02.043,10,,
2020,8,2901,375,19,7175,3,13,9,6,0,0,0,0,0,0,False,False,False,0,3,2021-02-25T15:11:03.797,0,,
2020,8,2901,380,19,6273,2,33,5,3,15,12,14,1,14,0,False,False,False,0,4,2020-11-02T14:19:59.317,15,,
2020,8,2901,385,19,6273,2,5,5,9,9,0,9,0,9,0,False,False,False,0,4,2020-11-02T14:22:30.42,9,,
2020,8,2901,400,19,1328,13,4,5,3,0,0,0,0,0,0,False,False,False,0,1,2020-11-03T17:13:31.51,0,,
2020,8,2901,450,4,2853,2,4,3,8,41,33,32,9,32,0,False,False,False,1,3,2021-03-04T14:54:14.133,41,,
2020,8,2901,470,19,7175,2,4,5,5,9,4,6,3,6,0,False,False,False,0,2,2020-11-02T17:41:24.757,9,,
2020,8,2901,500,19,7175,13,2,10,13,0,0,0,0,0,0,False,False,False,0,3,2020-11-05T19:41:32.85,0,,
2020,8,2901,505,19,8005,2,50,9,-4,13,17,7,6,7,0,True,False,False,0,2,2020-11-05T17:52:18.777,13,,
2020,8,2901,520,4,2853,13,35,2,27,0,0,0,0,0,0,False,False,False,0,3,2021-02-17T15:50:47.747,0,,
2020,8,2901,535,19,7175,2,2,4,9,14,5,12,2,12,0,False,False,False,0,3,2020-11-05T19:42:33.383,14,,
2020,8,2901,540,19,1510,2,48,9,-4,5,9,2,3,2,0,True,False,False,0,1,2020-11-03T18:31:37.983,5,,
2020,8,2901,640,19,3233,2,35,8,15,22,7,22,0,22,0,True,False,False,0,3,2021-03-09T16:45:40.983,22,,
2020,8,2901,645,19,3233,2,2,9,8,9,1,9,0,9,0,False,False,False,0,2,2020-11-02T16:12:49.47,9,,
2020,8,2901,695,4,2629,2,39,9,9,11,2,11,0,11,0,False,False,False,0,3,2020-11-03T17:13:31.51,11,,
2020,8,2901,710,4,1412,2,50,5,-2,21,23,15,6,15,0,False,False,False,0,2,2021-02-17T15:52:49.747,21,,
2020,8,2901,720,4,2853,2,5,5,2,6,4,2,4,2,0,False,False,False,0,3,2020-11-02T16:47:53.533,6,,
2020,8,2901,725,4,7646,3,12,5,10,0,0,0,0,0,0,False,False,False,0,3,2020-11-03T17:07:14.87,0,,
2020,8,2901,745,19,7175,13,13,9,4,0,0,0,0,0,0,False,False,False,0,3,2020-11-04T14:47:35.033,0,,
2020,8,2901,750,19,7175,2,2,9,6,8,2,8,0,8,0,False,False,False,0,3,2020-11-02T17:01:14.87,8,,
2020,8,2901,760,19,3233,2,4,5,7,8,1,8,0,8,0,False,False,False,0,2,2020-11-05T19:25:22.003,8,,
2020,8,2901,770,19,1328,2,28,3,0,7,7,6,1,6,0,False,False,False,0,1,2020-11-02T17:06:41.77,7,,
2020,8,2902,15,7,7659,2,39,4,5,9,4,7,2,7,0,False,False,False,0,3,2020-11-03T17:45:21.71,9,,
2020,8,2902,25,7,931,2,47,5,0,0,0,0,0,0,0,False,False,False,0,1,2020-11-05T17:48:57.29,0,,
2020,8,2902,40,7,7659,3,39,4,5,0,0,0,0,0,0,False,False,False,0,3,2020-11-02T11:19:27.91,0,,
2020,8,2902,45,7,931,2,44,9,-3,10,13,8,2,8,0,False,False,False,0,1,2020-11-02T11:21:02.263,10,,
2020,8,2902,50,7,7659,2,12,2,24,24,0,24,0,24,0,False,False,False,0,3,2020-11-02T11:25:13.453,24,,
2020,8,2902,55,7,6975,13,12,5,5,0,0,0,0,0,0,False,False,False,0,4,2020-11-05T17:21:53.26,0,,
2020,8,2902,60,7,4455,2,12,3,-3,2,5,0,2,0,0,True,False,False,0,2,2020-11-02T11:30:45.977,2,,
2020,8,2902,65,7,3521,13,5,3,6,0,0,0,0,0,0,True,False,False,0,3,2020-11-05T17:49:06.72,0,,
2020,8,2902,80,31,5096,2,7,10,10,10,0,10,0,10,0,True,False,False,0,4,2020-11-02T11:35:58.797,10,,
2020,8,2902,90,31,6888,2,47,10,4,5,1,4,1,4,0,False,False,False,0,1,2020-11-02T11:38:51.55,5,,
2020,8,2902,110,31,5080,2,24,6,20,27,7,24,3,24,0,False,False,False,0,3,2020-11-02T11:47:47.82,27,,
2020,8,2902,115,31,6793,13,12,10,8,0,0,0,0,0,0,False,False,False,0,3,2020-11-02T11:49:30.013,0,,
2020,8,2902,120,7,6383,2,5,5,6,6,0,6,0,6,0,False,False,False,0,3,2020-11-02T11:51:01.633,6,,
2020,8,2902,125,7,4716,13,6,4,10,0,0,0,0,0,0,False,False,False,0,3,2020-11-05T16:08:49.713,0,,
2020,8,2902,135,7,910,2,5,3,6,6,0,6,0,6,0,False,False,False,0,2,2020-11-02T11:57:53.71,6,,
2020,8,2902,140,7,7659,13,12,5,11,0,0,0,0,0,0,False,False,False,0,3,2020-11-02T12:00:41.133,0,,
2020,8,2902,165,31,5080,2,35,8,15,24,9,21,3,21,0,False,False,False,0,3,2020-11-02T12:10:33.997,24,,
2020,8,2902,175,31,5080,13,5,3,13,0,0,0,0,0,0,False,False,False,0,3,2020-11-03T17:43:36.43,0,,
2020,8,2902,180,31,2675,13,5,3,12,0,0,0,0,0,0,False,False,False,0,3,2020-11-05T17:49:16.427,0,,
2020,8,2902,190,7,3521,2,5,5,5,7,2,6,1,6,0,False,False,False,0,2,2020-11-02T12:17:37.727,7,,
2020,8,2902,210,7,910,13,2,10,4,0,0,0,0,0,0,False,False,False,0,2,2020-11-02T12:23:42.37,0,,
2020,8,2902,215,7,6383,2,47,5,2,8,6,6,2,6,0,False,False,False,0,3,2020-11-02T12:24:47.98,8,,
2020,8,2902,230,7,3521,2,4,4,13,13,0,12,1,12,0,False,False,False,0,3,2020-11-02T12:31:37.163,13,,
2020,8,2902,235,7,4716,2,30,5,1,2,1,1,1,1,0,False,False,False,0,4,2020-11-02T12:33:36.217,2,,
2020,8,2902,240,7,7659,13,9,2,23,0,0,0,0,0,0,False,False,False,0,2,2020-11-02T12:35:22.757,0,,
2020,8,2902,305,31,2901,13,9,10,3,0,0,0,0,0,0,False,False,False,0,3,2021-02-25T15:15:44.317,0,,
2020,8,2902,330,7,7659,2,6,10,11,13,2,11,2,11,0,False,False,False,0,3,2020-11-02T13:01:59.407,13,,
2020,8,2902,335,7,910,2,4,5,3,3,0,3,0,3,0,False,False,False,0,2,2020-11-02T13:03:47.607,3,,
2020,8,2902,345,7,7659,2,50,10,-2,3,5,2,1,2,0,False,False,False,0,2,2020-11-05T17:49:40.713,3,,
2020,8,2902,350,7,910,13,9,2,22,0,0,0,0,0,0,False,False,False,0,2,2020-11-02T13:08:09.11,0,,
2020,8,2902,365,7,7659,2,12,7,22,22,0,22,0,22,0,False,False,False,0,3,2020-11-02T13:12:14.233,22,,
2020,8,2902,405,31,6724,13,39,4,8,0,0,0,0,0,0,False,False,False,0,3,2020-11-02T13:19:35.11,0,,
2020,8,2902,420,31,2675,13,8,1,28,0,0,0,0,0,0,False,False,False,0,3,2020-11-02T13:27:37.223,0,,
2020,8,2902,425,31,5080,2,5,3,9,9,0,9,0,9,0,False,False,False,0,3,2020-11-02T13:30:07.15,9,,
2020,8,2902,440,31,4037,2,17,10,6,11,5,10,1,10,0,False,False,False,0,3,2020-11-02T13:33:23.757,11,,
2020,8,2902,455,31,5080,2,5,2,21,23,2,21,2,21,0,False,False,False,0,3,2020-11-02T13:36:37.11,23,,
2020,8,2902,465,31,5096,2,32,9,4,19,15,17,2,17,0,False,False,False,0,4,2020-11-02T13:39:02.82,19,,
2020,8,2902,480,31,6793,2,50,9,0,0,0,0,0,0,0,False,False,False,0,3,2021-02-17T16:14:26.433,0,,
2020,8,2902,485,31,6793,13,4,9,11,0,0,0,0,0,0,False,False,False,0,3,2020-11-02T13:45:28.86,0,,
2020,8,2902,500,7,7659,2,5,10,6,7,1,6,1,6,0,False,False,False,0,3,2020-11-02T13:50:15.037,7,,
2020,8,2902,505,7,6383,2,2,10,8,12,4,8,4,8,0,False,False,False,0,2,2020-11-02T13:52:01.163,12,,
2020,8,2902,510,7,931,13,28,5,-7,0,0,0,0,0,0,True,False,False,0,1,2020-11-02T13:53:42.863,0,,
2020,8,2902,515,7,7659,13,6,4,7,0,0,0,0,0,0,False,False,False,0,3,2020-11-02T13:55:50,0,,
2020,8,2902,535,31,3504,13,48,3,-3,0,0,0,0,0,0,False,False,False,0,1,2020-11-02T14:05:06.383,0,,
2020,8,2902,540,31,6793,2,51,10,-2,6,8,4,2,4,0,False,False,False,0,3,2020-11-02T14:15:09.01,6,,
2020,8,2902,560,31,6793,3,2,4,5,0,0,0,0,0,0,False,False,False,0,2,2020-11-02T14:19:52.01,0,,
2020,8,2902,580,7,6383,2,5,5,7,8,1,7,1,7,0,False,False,False,0,2,2020-11-02T14:24:27.513,8,,
2020,8,2902,590,7,6383,2,18,5,-1,12,13,5,7,5,0,False,False,False,1,2,2020-11-02T14:28:58.767,12,,
2020,8,2902,600,7,910,2,6,10,13,13,0,13,0,13,0,False,False,False,0,3,2020-11-02T14:33:33.31,13,,
2020,8,2902,615,7,3521,2,2,10,7,9,2,8,1,8,0,True,False,False,0,3,2020-11-02T14:38:10.317,9,,
2020,8,2902,630,7,3521,2,6,4,8,13,5,13,0,13,0,False,False,False,0,3,2020-11-02T14:48:39.23,13,,
2020,8,2902,640,7,3521,2,5,5,7,7,0,7,0,7,6,False,False,False,0,3,2020-11-02T14:51:30.17,7,,
2020,8,2902,665,31,5080,13,26,10,3,0,0,0,0,0,0,False,False,False,0,3,2021-02-17T16:15:58.523,0,,
2020,8,2902,670,31,6793,2,2,9,7,9,2,9,0,9,0,False,False,False,0,2,2020-11-02T14:58:42.617,9,,
2020,8,2902,680,31,5080,2,4,5,7,11,4,11,0,11,0,False,False,False,0,2,2020-11-02T15:00:26.797,11,,
2020,8,2902,695,31,6793,2,26,9,2,9,7,3,6,3,6,False,False,False,2,2,2020-11-02T15:05:13.203,9,,
2020,8,2902,710,7,6383,2,4,5,4,4,0,4,0,4,0,False,False,False,0,2,2020-11-02T15:07:50.267,4,,
2020,8,2902,725,7,910,13,2,9,6,0,0,0,0,0,0,False,False,False,0,2,2020-11-02T15:14:39.373,0,,
2020,8,2902,730,7,3521,2,2,4,11,18,7,16,2,16,0,False,False,False,0,3,2021-03-08T17:55:20.013,18,,
2020,8,2902,740,7,931,2,47,5,3,6,3,5,1,5,6,False,False,False,0,3,2020-11-02T15:20:16.91,6,,
2020,8,2902,755,31,6724,2,4,10,9,10,1,9,1,9,0,False,False,False,0,3,2020-11-02T15:37:59.887,10,,
2020,8,2902,760,31,6724,2,17,7,15,26,11,24,2,24,0,False,False,False,0,3,2020-11-02T15:38:59.253,26,,
2020,8,2902,765,31,5080,2,4,5,12,12,0,12,0,12,0,False,False,False,0,2,2020-11-02T15:39:53.573,12,,
2020,8,2902,770,31,5080,2,4,5,10,10,0,10,0,10,0,False,False,False,0,2,2021-03-15T15:11:03.78,10,,
2020,8,2902,775,31,4545,3,4,9,2,0,0,0,0,0,0,False,False,False,0,1,2020-11-02T15:43:16.397,0,,
2020,8,2902,780,31,6724,13,17,1,17,0,0,0,0,0,0,False,False,False,0,3,2020-11-05T17:25:40.35,0,,
2020,8,2902,785,31,5080,2,5,5,12,12,0,12,0,12,6,False,False,False,0,3,2020-11-02T15:48:02.88,12,,
2020,8,2902,835,7,910,13,2,10,4,0,0,0,0,0,0,False,False,False,0,2,2020-11-02T15:58:38.31,0,,
2020,8,2902,855,7,6383,2,9,9,14,15,1,14,1,14,0,False,False,False,0,3,2020-11-02T16:03:37.63,15,,
2020,8,2903,10,23,7250,2,47,5,0,2,2,2,0,2,0,False,False,False,0,3,2020-11-02T11:06:20.157,2,,
2020,8,2903,25,23,2994,2,4,9,6,7,1,6,1,6,0,False,False,False,0,4,2021-02-17T20:33:17.96,7,,
2020,8,2903,35,23,596,2,6,10,13,13,0,13,0,13,0,False,False,False,0,4,2020-11-02T11:21:58.347,13,,
2020,8,2903,45,23,2994,3,13,3,4,0,0,0,0,0,0,False,False,False,0,4,2020-11-02T11:26:40.363,0,,
2020,8,2903,50,23,2256,13,13,9,6,0,0,0,0,0,0,False,False,False,0,3,2021-02-17T22:36:25.123,0,,
2020,8,2903,60,8,4976,13,35,9,10,0,0,0,0,0,0,False,False,False,0,4,2020-11-02T11:34:40.76,0,,
2020,8,2903,90,8,7652,2,53,3,-4,6,10,0,6,0,0,False,True,True,0,4,2020-11-02T11:49:32.313,6,,
2020,8,2903,95,23,7688,2,5,3,3,4,1,4,0,4,0,False,False,False,0,3,2020-11-05T16:08:41.633,4,,
2020,8,2903,100,23,7688,13,7,2,49,0,0,0,0,0,0,False,False,False,0,3,2020-11-02T11:56:00.103,0,,
2020,8,2903,115,8,232,2,4,9,4,5,1,5,0,5,0,False,False,False,0,2,2020-11-02T12:05:05.087,5,,
2020,8,2903,125,8,4976,2,32,10,-3,19,22,2,17,2,0,False,False,False,0,4,2020-11-02T12:14:15.963,19,,
2020,8,2903,150,8,7009,2,5,5,5,5,0,5,0,5,0,False,False,False,0,1,2020-11-02T12:28:15.023,5,,
2020,8,2903,160,8,232,2,30,9,-2,3,5,0,3,0,0,False,False,False,1,3,2020-11-02T12:32:59.503,3,,
2020,8,2903,190,8,232,3,12,9,9,0,0,0,0,0,0,False,False,False,0,3,2020-11-02T12:43:47.71,0,,
2020,8,2903,195,8,3606,13,8,1,16,0,0,0,0,0,0,False,False,False,0,2,2020-11-05T16:20:13.197,0,,
2020,8,2903,230,23,3957,2,48,4,-1,17,18,13,4,13,0,False,False,False,1,1,2020-11-02T13:03:03.987,17,,
2020,8,2903,280,23,7241,13,16,9,1,0,0,0,0,0,0,False,False,False,0,1,2020-11-02T13:22:03.273,0,,
2020,8,2903,290,23,7688,13,7,5,11,0,0,0,0,0,0,False,False,False,0,3,2020-11-02T17:04:40.24,0,,
2020,8,2903,305,8,3606,13,3,3,14,0,0,0,0,0,0,False,False,False,0,2,2020-11-02T13:31:21.883,0,,
2020,8,2903,320,8,4000,3,48,10,-2,0,0,0,0,0,0,False,False,False,0,1,2020-11-02T13:37:19.61,0,,
2020,8,2903,335,23,596,2,35,10,8,8,0,8,0,8,0,False,False,False,0,4,2021-02-17T22:30:32.057,8,,
2020,8,2903,355,23,7246,13,11,6,15,0,0,0,0,0,0,False,False,False,0,4,2020-11-05T15:29:55.777,0,,
2020,8,2903,360,23,7688,2,50,9,-1,4,5,4,0,4,0,True,False,False,0,3,2020-11-05T15:30:41.807,4,,
2020,8,2903,380,23,3843,2,16,9,5,12,7,8,4,8,0,False,False,False,0,1,2020-11-02T14:04:12.98,12,,
2020,8,2903,410,8,5053,2,44,9,-5,6,11,2,4,2,0,False,False,False,1,1,2020-11-02T14:13:12.13,6,,
2020,8,2903,420,8,7652,2,3,3,10,9,-1,9,0,9,0,True,False,False,0,4,2021-02-17T22:34:40.323,9,,
2020,8,2903,435,8,232,2,26,3,2,19,17,16,3,16,0,False,False,False,1,3,2021-02-17T22:30:57.98,19,,
2020,8,2903,450,8,232,3,9,6,19,0,0,0,0,0,0,True,False,False,0,3,2020-11-02T14:30:32.163,0,,
2020,8,2903,480,23,2994,2,53,9,-3,1,4,0,1,0,0,True,False,False,0,4,2021-02-17T22:38:31.207,1,,
2020,8,2903,490,23,7250,2,4,10,5,9,4,7,2,7,0,False,False,False,0,4,2020-11-05T15:40:04.993,9,,
2020,8,2903,500,23,2994,2,13,9,2,6,4,6,0,6,0,True,False,False,0,4,2020-11-05T16:14:36.457,6,,
2020,8,2903,505,23,7250,2,4,9,6,11,5,9,2,9,0,False,False,False,0,3,2020-11-05T15:37:59.973,11,,
2020,8,2903,520,23,2994,2,5,3,5,6,1,6,0,6,0,False,False,False,0,3,2020-11-02T14:58:25.343,6,,
2020,8,2903,540,23,2256,13,3,3,4,0,0,0,0,0,0,False,False,False,0,2,2020-11-05T16:15:17.76,0,,
2020,8,2903,545,23,7250,2,26,9,4,4,0,4,0,4,6,True,False,False,0,4,2020-11-05T15:40:40.197,4,,
2020,8,2903,565,8,232,13,7,2,28,0,0,0,0,0,0,False,False,False,0,3,2020-11-02T15:19:27.917,0,,
2020,8,2903,575,8,4976,3,35,9,9,0,0,0,0,0,0,False,False,False,0,3,2020-11-02T15:23:49.773,0,,
2020,8,2903,590,23,2994,2,51,10,-3,7,10,7,0,7,0,False,False,False,0,3,2020-11-05T15:41:22.517,7,,
2020,8,2903,670,8,5053,2,45,5,-4,1,5,-1,2,-1,0,False,False,False,0,1,2020-11-02T16:06:12.183,1,,
2020,8,2903,675,8,3606,2,7,3,14,14,0,14,0,14,0,False,False,False,0,2,2021-02-17T22:34:40.323,14,,
2020,8,2903,680,8,7652,2,4,10,10,10,0,10,0,10,0,False,False,False,0,3,2020-11-02T16:10:14.593,10,,
2020,8,2903,685,8,232,13,13,10,5,0,0,0,0,0,0,False,False,False,0,3,2020-11-02T16:12:55.037,0,,
2020,8,2903,690,8,232,2,9,6,18,25,7,21,4,21,0,False,False,False,0,3,2020-11-02T16:14:50.75,25,,
2020,8,2903,695,8,232,3,4,10,4,0,0,0,0,0,0,False,False,False,0,3,2020-11-02T16:16:26.333,0,,
2020,8,2903,720,8,5053,3,5,3,3,0,0,0,0,0,0,False,False,False,0,1,2020-11-05T16:27:32.037,0,,
2020,8,2903,725,8,232,13,17,10,14,0,0,0,0,0,0,False,False,False,0,3,2020-11-02T16:29:32.74,0,,
2020,8,2903,735,8,232,13,36,8,19,0,0,0,0,0,0,False,False,False,0,3,2021-02-17T22:34:40.323,0,,
2020,8,2904,15,14,6546,2,13,10,2,24,22,23,1,23,0,True,False,False,0,2,2020-11-02T11:23:23.437,24,,
2020,8,2904,45,11,6810,13,32,9,2,0,0,0,0,0,0,False,False,False,0,4,2020-11-05T19:47:06.01,0,,
2020,8,2904,50,11,4492,3,8,7,21,0,0,0,0,0,0,False,False,False,0,3,2021-02-17T17:07:33.127,0,,
2020,8,2904,65,14,1114,2,13,9,3,5,2,5,0,5,0,False,False,False,0,3,2020-11-03T19:08:21.4,5,,
2020,8,2904,75,14,6543,13,11,5,13,0,0,0,0,0,0,False,False,False,0,1,2020-11-05T19:07:03.79,0,,
2020,8,2904,85,14,7582,2,44,3,-1,5,6,3,2,3,0,False,False,False,0,1,2020-11-02T12:09:31.28,5,,
2020,8,2904,95,14,1119,13,5,3,12,0,0,0,0,0,0,False,False,False,0,4,2020-11-02T12:13:56.047,0,,
2020,8,2904,100,14,4449,13,22,6,24,0,0,0,0,0,0,False,False,False,0,2,2020-11-05T19:07:03.79,0,,
2020,8,2904,115,11,914,2,35,7,18,25,7,21,4,21,6,True,False,False,0,3,2020-11-02T12:28:06.29,25,,
2020,8,2904,130,14,4449,2,51,9,-3,8,11,6,2,6,0,False,False,False,0,3,2021-03-04T15:12:19.613,8,,
2020,8,2904,140,14,7582,2,46,3,1,4,3,3,1,3,0,False,False,False,0,1,2020-11-05T18:49:18.31,4,,
2020,8,2904,145,14,895,2,54,4,-3,-2,1,-2,0,-2,0,False,False,False,0,4,2020-11-02T12:39:13.75,-2,,
2020,8,2904,150,14,5197,2,13,4,4,8,4,6,2,6,0,False,False,False,0,3,2020-11-05T19:47:17.06,8,,
2020,8,2904,170,14,7584,2,32,3,2,6,4,6,0,6,0,True,False,False,0,3,2020-11-02T12:49:22.703,6,,
2020,8,2904,195,11,6341,2,48,9,-2,6,8,4,2,4,0,False,False,False,0,1,2020-11-02T12:56:35.953,6,,
2020,8,2904,205,14,5197,2,12,5,14,15,1,15,0,15,0,False,False,False,0,4,2020-11-02T12:59:39.42,15,,
2020,8,2904,215,14,4070,2,6,1,15,21,6,18,3,18,0,False,False,False,0,2,2020-11-05T19:47:29.53,21,,
2020,8,2904,220,14,6543,2,45,5,-3,22,25,17,5,17,6,True,False,False,1,2,2020-11-02T13:15:16.903,22,,
2020,8,2904,235,11,6810,2,54,9,-1,11,12,8,3,8,0,True,False,False,0,4,2020-11-02T13:18:47.05,11,,
2020,8,2904,240,11,6810,13,5,9,14,0,0,0,0,0,0,True,False,False,0,4,2020-11-02T13:26:09.34,0,,
2020,8,2904,245,11,4492,13,6,4,9,0,0,0,0,0,0,False,False,False,0,2,2020-11-02T13:31:17.607,0,,
2020,8,2904,270,14,4070,13,5,5,11,0,0,0,0,0,0,False,False,False,0,2,2021-02-17T17:11:19.953,0,,
2020,8,2904,275,14,5197,2,35,10,14,14,0,14,0,14,0,False,False,False,0,4,2020-11-05T18:50:59.607,14,,
2020,8,2904,285,14,5197,3,51,9,-4,0,0,0,0,0,0,False,False,False,0,4,2021-03-04T15:12:39.433,0,,
2020,8,2904,300,14,4449,2,13,10,3,16,13,16,0,16,0,True,False,False,0,3,2020-11-02T13:59:13.04,16,,
2020,8,2904,305,14,1119,2,47,5,1,7,6,7,0,7,6,False,False,False,0,4,2020-11-02T14:01:09.523,7,,
2020,8,2904,325,11,4492,13,3,2,15,0,0,0,0,0,0,False,False,False,0,2,2021-02-17T17:13:50.877,0,,
2020,8,2904,340,14,1114,2,51,10,-3,4,7,0,4,0,0,False,False,False,0,3,2021-03-04T15:12:58.833,4,,
2020,8,2904,365,14,895,2,4,4,6,8,2,7,1,7,0,False,False,False,0,3,2020-11-02T14:21:03.527,8,,
2020,8,2904,370,14,6543,2,21,2,25,29,4,29,0,29,6,False,False,False,0,2,2020-11-05T19:47:59.883,29,,
2020,8,2904,385,11,4492,13,4,4,5,0,0,0,0,0,0,False,False,False,0,2,2020-11-02T14:27:34.817,0,,
2020,8,2904,390,11,6810,2,26,4,4,10,6,8,2,8,0,False,False,False,0,3,2020-11-02T14:29:40.44,10,,
2020,8,2904,400,11,100,2,4,4,14,16,2,15,1,15,0,False,False,False,0,3,2020-11-05T19:07:03.79,16,,
2020,8,2904,410,11,6810,2,53,10,-5,-2,3,-5,3,-5,0,False,False,False,0,4,2020-11-02T14:34:44.067,-2,,
2020,8,2904,415,11,6810,2,2,10,6,6,0,6,0,6,0,False,False,False,0,3,2020-11-02T15:01:24.743,6,,
2020,8,2904,425,11,6810,2,8,10,11,15,4,15,0,15,0,False,False,False,0,3,2020-11-02T14:37:49.123,15,,
2020,8,2904,460,11,6810,2,4,9,12,15,3,12,3,12,0,False,False,False,0,3,2020-11-02T14:46:27.153,15,,
2020,8,2904,465,11,792,2,32,3,-1,5,6,3,2,3,0,False,False,False,0,1,2020-11-02T14:48:41.503,5,,
2020,8,2904,470,11,6810,13,8,7,20,0,0,0,0,0,0,False,False,False,0,4,2020-11-02T18:28:56.617,0,,
2020,8,2904,475,11,100,2,13,9,5,14,9,7,7,7,0,False,False,False,1,2,2020-11-02T18:24:00.203,14,,
2020,8,2904,480,11,2714,2,30,10,-1,23,24,1,22,1,0,True,False,False,1,4,2020-11-05T18:53:47.71,23,,
2020,8,2904,485,11,6341,2,46,3,1,9,8,9,0,9,6,False,False,False,0,1,2020-11-02T14:57:59.433,9,,
2020,8,2904,520,11,914,13,12,9,13,0,0,0,0,0,0,False,False,False,0,2,2021-03-08T21:24:19.67,0,,
2020,8,2904,530,11,3820,2,6,1,17,17,0,17,0,17,0,False,False,False,0,3,2020-11-02T15:22:56.647,17,,
2020,8,2904,540,11,3820,13,4,5,9,0,0,0,0,0,0,False,False,False,0,2,2020-11-02T15:26:46.457,0,,
2020,8,2904,550,11,6810,2,32,5,1,10,9,10,0,10,0,False,False,False,0,4,2020-11-02T15:29:57.087,10,,
2020,8,2904,560,14,4070,13,4,3,8,0,0,0,0,0,0,False,False,False,0,2,2020-11-02T15:32:48.367,0,,
2020,8,2904,565,14,6543,3,13,10,3,0,0,0,0,0,0,True,False,False,0,2,2020-11-05T18:54:20.207,0,,
2020,8,2904,570,14,895,13,7,6,16,0,0,0,0,0,0,False,False,False,0,3,2020-11-02T15:40:26.643,0,,
2020,8,2904,580,11,914,2,6,9,9,10,1,10,0,10,0,False,False,False,0,3,2020-11-02T15:46:39.287,10,,
2020,8,2904,590,11,3820,2,6,1,16,17,1,17,0,17,0,False,False,False,0,3,2020-11-03T22:20:38.79,17,,
2020,8,2904,600,11,7732,2,4,9,2,2,0,1,1,1,0,False,False,False,0,1,2020-11-05T19:48:10.637,2,,
2020,8,2904,615,14,4449,3,4,4,12,0,0,0,0,0,0,False,False,False,0,3,2020-11-02T16:02:22.34,0,,
2020,8,2904,620,14,4070,2,6,8,16,18,2,16,2,16,0,False,False,False,0,2,2020-11-05T19:48:19.283,18,,
2020,8,2904,640,14,7495,13,7,2,41,0,0,0,0,0,0,False,False,False,0,3,2020-11-02T16:18:05.827,0,,
2020,8,2904,645,14,895,2,47,5,2,3,1,3,0,3,0,False,False,False,0,3,2021-02-17T17:15:01.747,3,,
2020,8,2904,670,11,914,13,4,5,4,0,0,0,0,0,0,False,False,False,0,2,2021-03-05T14:19:38.563,0,,
2020,8,2904,690,11,3820,13,6,9,6,0,0,0,0,0,0,False,False,False,0,2,2020-11-02T16:33:01.003,0,,
2020,8,2904,695,11,3820,2,12,1,57,73,16,69,4,69,0,False,False,False,0,2,2021-03-08T21:25:14.7,73,,
2020,8,2904,700,11,6810,13,12,10,8,0,0,0,0,0,0,False,False,False,0,4,2020-11-05T19:48:30.293,0,,
2020,8,2904,705,11,914,2,6,9,4,4,0,4,0,4,6,False,False,False,0,3,2020-11-02T16:40:40.037,4,,
2020,8,2904,725,14,7495,2,50,3,-1,13,14,11,2,11,0,False,False,False,0,2,2021-02-17T17:15:27.75,13,,
2020,8,2904,730,14,4449,13,13,5,8,0,0,0,0,0,0,True,False,False,0,4,2021-03-15T15:33:32.017,0,,
2020,8,2904,740,14,6543,2,13,3,3,3,0,3,0,3,0,False,False,False,0,3,2020-11-02T16:57:20.393,3,,
2020,8,2904,755,14,4449,2,29,2,18,20,2,18,2,18,0,False,False,False,0,3,2020-11-02T17:02:17.83,20,,
2020,8,2904,805,11,7732,2,28,9,-1,13,14,12,1,12,0,False,False,False,1,1,2020-11-02T18:25:21.57,13,,
2020,8,2904,820,11,100,13,13,10,3,0,0,0,0,0,0,False,False,False,0,3,2020-11-05T19:48:53.603,0,,
2020,8,2904,830,11,100,2,6,8,20,24,4,23,1,23,0,False,False,False,0,3,2020-11-05T19:49:06.38,24,,
2020,8,2904,840,11,7732,2,5,5,5,7,2,7,0,7,0,False,False,False,0,3,2020-11-02T17:40:51.697,7,,
2020,8,2904,845,11,3820,2,13,4,1,6,5,5,1,5,0,True,False,False,0,3,2020-11-02T17:43:14.8,6,,
2020,8,2904,850,11,914,13,9,2,17,0,0,0,0,0,0,False,False,False,0,2,2020-11-02T18:26:30.033,0,,
2020,8,2904,855,11,3820,3,6,9,12,0,0,0,0,0,0,False,False,False,0,2,2020-11-02T17:49:43.953,0,,
2020,8,2904,860,11,7732,13,16,9,6,0,0,0,0,0,0,False,False,False,0,1,2020-11-02T17:55:39.01,0,,
2020,8,2904,865,11,914,13,12,7,18,0,0,0,0,0,0,False,False,False,0,3,2020-11-05T19:49:22.853,0,,
2020,8,2904,885,14,1119,2,46,9,2,11,9,7,4,7,0,False,False,False,0,4,2020-11-05T18:18:16.327,11,,
2020,8,2905,15,12,4511,2,30,10,0,8,8,6,2,6,0,False,False,False,0,4,2020-11-02T18:28:54.313,8,,
2020,8,2905,35,12,556,2,5,3,3,5,2,5,0,5,0,False,False,False,0,3,2020-11-02T11:21:37.573,5,,
2020,8,2905,40,12,4511,2,30,3,-2,4,6,3,1,3,0,False,False,False,0,4,2020-11-05T12:55:58.64,4,,
2020,8,2905,50,12,4561,2,51,10,-4,1,5,0,1,0,0,True,False,False,0,1,2020-11-05T12:14:08.837,1,,
2020,8,2905,55,12,6876,2,4,4,4,13,9,9,4,9,0,False,False,False,0,4,2020-11-05T14:51:03.613,13,,
2020,8,2905,70,12,556,2,5,5,5,5,0,5,0,5,6,False,False,False,0,3,2021-02-17T17:18:42.517,5,,
2020,8,2905,100,18,1381,2,6,9,8,9,1,8,1,8,0,True,False,False,0,3,2020-11-03T14:09:04.48,9,,
2020,8,2905,110,18,813,2,32,3,1,12,11,11,1,11,0,False,False,False,0,3,2020-11-05T14:51:15.903,12,,
2020,8,2905,115,18,1381,3,50,3,-4,0,0,0,0,0,0,True,False,False,0,3,2020-11-05T14:51:25.66,0,,
2020,8,2905,130,18,4572,2,45,10,-3,13,16,6,7,6,0,False,False,False,2,1,2020-11-02T12:13:51.277,13,,
2020,8,2905,170,12,7742,3,45,5,0,0,0,0,0,0,0,False,False,False,0,1,2020-11-05T13:01:46.78,0,,
2020,8,2905,180,12,7742,2,46,3,1,16,15,5,11,5,0,False,False,False,1,1,2020-11-02T12:38:52.09,16,,
2020,8,2905,190,12,556,2,2,9,12,14,2,14,0,14,0,False,False,False,0,3,2020-11-02T18:30:25.037,14,,
2020,8,2905,200,12,6869,2,13,3,4,6,2,6,0,6,0,False,False,False,0,3,2020-11-05T12:14:08.837,6,,
2020,8,2905,210,12,556,13,20,2,17,0,0,0,0,0,0,False,False,False,0,2,2020-11-02T12:53:26.1,0,,
2020,8,2905,220,12,4561,2,12,5,4,5,1,5,0,5,0,False,False,False,0,2,2021-03-08T21:28:59.123,5,,
2020,8,2905,230,12,6357,13,7,5,7,0,0,0,0,0,0,False,False,False,0,3,2020-11-02T13:05:26.647,0,,
2020,8,2905,240,12,556,2,46,9,0,1,1,1,0,1,6,True,False,False,0,3,2020-11-05T13:08:29.69,1,,
2020,8,2905,270,18,6907,2,7,5,6,16,10,7,9,7,0,False,False,False,1,4,2020-11-02T13:23:34.83,16,,
2020,8,2905,275,18,7711,2,2,10,7,7,0,7,0,7,0,False,False,False,0,3,2020-11-02T13:26:15.437,7,,
2020,8,2905,295,18,7711,2,2,9,8,12,4,10,2,10,0,False,False,False,0,2,2020-11-05T12:14:08.837,12,,
2020,8,2905,300,18,1381,2,4,9,6,6,0,6,0,6,0,True,False,False,0,3,2020-11-03T14:09:14.217,6,,
2020,8,2905,380,18,7711,13,5,3,6,0,0,0,0,0,0,False,False,False,0,3,2020-11-05T12:14:08.837,0,,
2020,8,2905,385,18,6706,2,13,10,4,16,12,14,2,14,0,True,False,False,0,3,2020-11-05T12:14:08.837,16,,
2020,8,2905,395,18,4572,13,45,5,-5,0,0,0,0,0,0,False,False,False,0,1,2020-11-02T14:34:24.267,0,,
2020,8,2905,400,18,7711,13,7,2,26,0,0,0,0,0,0,False,False,False,0,3,2020-11-02T18:32:06.57,0,,
2020,8,2905,455,12,4511,2,35,8,39,45,6,44,1,44,0,False,False,False,0,3,2020-11-05T13:35:38.263,45,,
2020,8,2905,460,12,3965,3,34,4,-4,0,0,0,0,0,0,True,False,False,0,3,2020-11-02T15:02:29.38,0,,
2020,8,2905,465,12,3965,13,51,9,-5,0,0,0,0,0,0,True,False,False,0,1,2020-11-05T13:36:12.59,0,,
2020,8,2905,470,12,6356,3,2,10,14,0,0,0,0,0,0,False,False,False,0,3,2020-11-02T15:08:09.653,0,,
2020,8,2905,475,12,6356,13,12,2,37,0,0,0,0,0,0,False,False,False,0,3,2020-11-02T15:11:34.357,0,,
2020,8,2905,480,18,1381,2,18,10,-2,12,14,1,11,1,0,False,False,False,1,2,2020-11-05T12:50:30.543,12,,
2020,8,2905,495,18,4572,2,48,9,-5,50,55,9,41,9,6,False,False,False,1,1,2020-11-05T12:38:55.55,50,,
2020,8,2905,520,12,6357,2,7,6,17,19,2,17,2,17,0,False,False,False,0,3,2020-11-02T15:30:53.74,19,,
2020,8,2905,530,12,6876,13,35,2,29,0,0,0,0,0,0,False,False,False,0,4,2020-11-02T18:32:57.14,0,,
2020,8,2905,535,12,556,2,50,9,-3,6,9,6,0,6,0,False,False,False,0,3,2021-03-04T16:23:05.907,6,,
2020,8,2905,540,12,6356,2,6,9,11,12,1,12,0,12,0,False,False,False,0,3,2020-11-02T15:45:39.793,12,,
2020,8,2905,550,12,7742,2,47,10,3,8,5,4,4,4,0,False,False,False,0,1,2020-11-02T15:50:39.673,8,,
2020,8,2905,555,12,556,13,17,8,36,0,0,0,0,0,0,False,False,False,0,3,2020-11-02T15:54:03.417,0,,
2020,8,2905,565,12,6876,2,32,9,-3,6,9,6,0,6,0,False,False,False,0,4,2020-11-02T15:58:24.963,6,,
2020,8,2905,600,18,6907,2,12,9,5,6,1,5,1,5,0,False,False,False,0,4,2020-11-05T14:52:01.997,6,,
2020,8,2905,605,18,7711,2,50,10,-3,7,10,7,0,7,0,True,False,False,0,2,2021-03-04T16:23:32.49,7,,
2020,8,2905,620,12,3965,2,51,9,-4,7,11,7,0,7,0,True,False,False,0,3,2020-11-05T12:51:38.67,7,,
2020,8,2905,625,12,556,2,5,2,15,15,0,15,0,15,0,False,False,False,0,2,2020-11-02T16:27:35.157,15,,
2020,8,2905,640,12,556,13,7,6,17,0,0,0,0,0,0,False,False,False,0,2,2020-11-05T14:52:14.44,0,,
2020,8,2905,645,12,4511,13,7,2,17,0,0,0,0,0,0,True,False,False,0,3,2020-11-05T14:52:32.017,0,,
2020,8,2905,675,12,4511,2,51,5,0,5,5,4,1,4,0,False,False,False,0,4,2021-02-17T17:26:57.61,5,,
2020,8,2905,685,12,4561,2,48,10,-4,5,9,0,5,0,0,False,False,False,0,1,2020-11-02T16:52:02.82,5,,
2020,8,2905,690,12,4561,2,5,10,1,2,1,2,0,2,0,False,False,False,0,1,2020-11-05T12:14:08.837,2,,
2020,8,2905,705,12,556,13,6,1,18,0,0,0,0,0,0,False,False,False,0,2,2020-11-05T14:52:46.02,0,,
2020,8,2905,710,12,7460,2,8,7,18,26,8,0,26,0,0,False,False,False,0,2,2020-11-02T17:08:53.593,26,,
2020,8,2905,715,12,4561,2,44,3,-2,3,5,3,0,3,0,False,False,False,0,1,2020-11-05T13:41:20.677,3,,
2020,8,2905,720,12,6876,2,7,2,20,27,7,24,3,24,0,False,False,False,0,3,2020-11-02T18:06:44.77,27,,
2020,8,2905,725,12,556,2,7,3,7,7,0,7,0,7,6,False,False,False,0,3,2020-11-02T17:19:10.427,7,,
2020,8,2905,795,12,4561,2,46,3,1,7,6,7,0,7,0,False,False,False,0,1,2020-11-05T14:54:09.577,7,,
2020,8,2905,800,12,4561,2,46,3,3,7,4,7,0,7,0,False,False,False,0,1,2020-11-05T14:55:12.247,7,,
2020,8,2905,805,12,4511,2,12,3,14,17,3,14,3,14,0,False,False,False,0,3,2020-11-05T12:14:41.25,17,,
2020,8,2906,15,16,3938,2,2,4,12,13,1,12,1,12,0,False,False,False,0,3,2020-11-03T20:20:41.993,13,,
2020,8,2906,20,16,7176,2,4,9,8,9,1,8,1,8,0,False,False,False,0,3,2020-11-02T11:22:33.183,9,,
2020,8,2906,25,16,4143,2,2,9,9,15,6,15,0,15,0,False,False,False,0,3,2020-11-03T20:20:52.977,15,,
2020,8,2906,35,16,34,2,48,9,-4,18,22,17,1,17,0,True,False,False,0,1,2020-11-02T11:32:20.25,18,,
2020,8,2906,40,16,7176,2,34,4,-3,30,33,0,30,0,6,True,False,False,1,2,2020-11-03T20:21:04.477,30,,
2020,8,2906,60,22,7118,2,4,9,3,4,1,4,0,4,0,False,False,False,0,3,2021-02-17T17:30:06.667,4,,
2020,8,2906,65,22,7610,2,17,4,10,15,5,14,1,14,0,False,False,False,0,3,2020-11-02T12:41:27.363,15,,
2020,8,2906,75,22,7118,13,6,9,5,0,0,0,0,0,0,False,False,False,0,2,2020-11-05T21:23:55.37,0,,
2020,8,2906,80,22,6270,2,5,5,2,5,3,4,1,4,0,False,False,False,0,1,2020-11-02T11:58:29.32,5,,
2020,8,2906,95,22,7118,13,35,9,11,0,0,0,0,0,0,False,False,False,0,3,2020-11-05T21:24:36.74,0,,
2020,8,2906,100,22,6270,2,50,9,-3,-2,1,-3,1,-3,0,False,False,False,0,3,2020-11-05T20:38:06.533,-2,,
2020,8,2906,105,22,7118,13,4,10,9,0,0,0,0,0,0,False,False,False,0,2,2020-11-05T21:00:54.567,0,,
2020,8,2906,110,22,6270,2,50,3,-2,1,3,-1,2,-1,0,False,False,False,0,2,2020-11-02T12:21:36.277,1,,
2020,8,2906,125,16,6565,2,30,4,-4,5,9,2,3,2,0,False,False,False,0,4,2020-11-05T20:42:13.943,5,,
2020,8,2906,130,16,374,2,4,9,5,13,8,13,0,13,0,False,False,False,0,3,2020-11-02T12:34:53.66,13,,
2020,8,2906,140,16,3938,13,19,6,45,0,0,0,0,0,0,False,False,False,0,3,2020-11-03T20:21:16.807,0,,
2020,8,2906,145,16,6500,2,5,9,2,2,0,2,0,2,0,False,False,False,0,4,2020-11-03T20:30:27.89,2,,
2020,8,2906,150,16,6500,2,4,3,6,13,7,13,0,13,0,False,False,False,0,2,2020-11-05T20:36:22.873,13,,
2020,8,2906,155,16,3938,2,23,8,36,36,0,0,36,0,6,False,False,False,0,3,2020-11-02T12:58:07.297,36,,
2020,8,2906,175,22,7610,2,9,2,26,27,1,27,0,27,0,False,False,False,0,2,2020-11-02T13:04:01.18,27,,
2020,8,2906,180,22,6538,2,35,3,11,13,2,12,1,12,0,False,False,False,0,4,2020-11-05T20:38:46.833,13,,
2020,8,2906,200,22,6270,2,50,9,-1,5,6,5,0,5,0,True,False,False,1,3,2020-11-05T20:30:28.063,5,,
2020,8,2906,225,16,374,13,32,3,-3,0,0,0,0,0,0,False,False,False,0,4,2021-02-17T18:18:12.03,0,,
2020,8,2906,235,16,6499,2,45,5,0,7,7,5,2,5,0,False,False,False,0,1,2020-11-02T13:26:55.953,7,,
2020,8,2906,245,16,34,2,44,3,-4,4,8,2,2,2,0,True,False,False,0,1,2020-11-02T13:31:17.933,4,,
2020,8,2906,260,22,7118,2,6,9,6,15,9,15,0,15,0,False,False,False,0,2,2020-11-05T21:25:31.327,15,,
2020,8,2906,300,22,6270,2,5,5,3,8,5,7,1,7,0,False,False,False,0,3,2020-11-02T13:55:59.87,8,,
2020,8,2906,315,22,7118,13,2,9,5,0,0,0,0,0,0,False,False,False,0,2,2020-11-05T21:26:14.03,0,,
2020,8,2906,320,22,7609,2,44,9,-5,1,6,-1,2,-1,0,False,False,False,0,1,2020-11-05T21:04:09.483,1,,
2020,8,2906,335,16,374,2,17,1,15,15,0,15,0,15,0,False,False,False,0,4,2021-02-26T18:20:07.017,15,,
2020,8,2906,340,16,374,2,5,5,12,23,11,15,8,15,0,False,False,False,1,4,2020-11-05T21:06:49.377,23,,
2020,8,2906,350,16,7176,3,4,3,5,0,0,0,0,0,0,False,False,False,0,2,2020-11-02T14:22:49.433,0,,
2020,8,2906,355,16,7681,2,48,9,-5,-3,2,-3,0,-3,0,False,False,False,0,1,2020-11-02T14:24:24.167,-3,,
2020,8,2906,365,16,374,2,4,9,14,18,4,18,0,18,0,False,False,False,0,3,2020-11-02T14:27:31.283,18,,
2020,8,2906,370,16,7681,2,46,3,1,5,4,4,1,4,0,False,False,False,1,1,2020-11-05T21:07:15.697,5,,
2020,8,2906,375,16,374,2,55,10,-1,3,4,0,3,0,6,False,False,False,0,4,2020-11-05T20:27:02.023,3,,
2020,8,2906,390,22,6262,13,29,2,15,0,0,0,0,0,0,False,False,False,0,3,2020-11-02T14:40:20.263,0,,
2020,8,2906,400,22,7118,13,19,6,34,0,0,0,0,0,0,False,False,False,0,2,2020-11-02T14:44:23.417,0,,
2020,8,2906,410,22,6270,2,26,10,6,15,9,12,3,12,0,False,False,False,0,3,2021-02-17T17:34:33.453,15,,
2020,8,2906,430,22,7610,13,9,6,17,0,0,0,0,0,0,False,False,False,0,3,2020-11-02T14:52:29.423,0,,
2020,8,2906,440,22,6270,13,5,5,4,0,0,0,0,0,0,False,False,False,0,3,2020-11-02T14:57:29.477,0,,
2020,8,2906,455,16,3938,13,5,5,8,0,0,0,0,0,0,False,False,False,0,3,2020-11-05T21:31:46.953,0,,
2020,8,2906,465,16,374,13,7,2,20,0,0,0,0,0,0,False,False,False,0,4,2020-11-05T21:08:33.733,0,,
2020,8,2906,485,22,6270,3,12,3,7,0,0,0,0,0,0,False,False,False,0,3,2020-11-02T15:15:06.717,0,,
2020,8,2906,495,16,6500,13,19,1,50,0,0,0,0,0,0,False,False,False,0,3,2020-11-02T15:20:55.277,0,,
2020,8,2906,500,16,374,2,53,3,-4,-4,0,-4,0,-4,0,False,False,False,0,4,2020-11-02T15:24:32.387,-4,,
2020,8,2906,505,16,7176,2,4,10,14,14,0,14,0,14,0,False,False,False,0,2,2020-11-02T15:26:50.23,14,,
2020,8,2906,510,16,34,2,47,5,0,9,9,7,2,7,0,False,False,False,0,1,2020-11-02T15:32:49.08,9,,
2020,8,2906,520,16,374,2,2,10,8,25,17,12,13,12,0,False,False,False,1,3,2021-03-03T16:00:47.297,25,,
2020,8,2906,525,16,374,13,12,6,19,0,0,0,0,0,0,False,False,False,0,3,2021-02-17T17:36:15.033,0,,
2020,8,2906,530,16,7182,13,17,6,23,0,0,0,0,0,0,False,False,False,0,4,2020-11-02T18:02:37.02,0,,
2020,8,2906,540,16,7176,2,12,3,6,14,8,13,1,13,0,True,False,False,0,3,2021-02-17T17:36:51.517,14,,
2020,8,2906,550,22,7609,2,47,5,2,5,3,4,1,4,0,False,False,False,0,1,2020-11-02T15:54:25.99,5,,
2020,8,2906,555,22,6270,2,34,4,-4,-6,-2,-6,0,-6,0,True,False,False,0,3,2021-03-04T15:23:53.03,-6,,
2020,8,2906,560,22,7118,2,5,5,3,10,7,8,2,8,0,False,False,False,0,3,2021-02-17T17:37:41.717,10,,
2020,8,2906,570,16,4143,2,4,9,12,16,4,13,3,13,0,False,False,False,0,3,2020-11-02T16:05:53.807,16,,
2020,8,2906,575,16,3938,2,46,3,0,8,8,7,1,7,0,True,False,False,0,3,2020-11-02T16:08:24.023,8,,
2020,8,2906,580,16,4143,2,4,10,3,6,3,3,3,3,0,False,False,False,0,3,2020-11-02T16:10:24.523,6,,
2020,8,2906,585,16,7681,2,33,10,1,8,7,8,0,8,0,False,False,False,0,1,2020-11-02T16:14:28.83,8,,
2020,8,2906,590,16,7176,2,2,10,10,19,9,18,1,18,0,False,False,False,0,2,2020-11-02T16:16:33.31,19,,
2020,8,2906,595,16,4143,2,7,6,26,26,0,0,26,0,6,False,False,False,0,2,2020-11-02T16:19:57.423,26,,
2020,8,2906,620,22,6812,2,44,3,-1,6,7,5,1,5,0,True,False,False,0,3,2020-11-05T20:40:22.233,6,,
2020,8,2906,625,22,6270,2,16,4,4,8,4,6,2,6,0,False,False,False,0,1,2020-11-02T16:28:49.177,8,,
2020,8,2906,630,22,6262,2,53,9,-3,3,6,3,0,3,0,True,True,True,0,4,2021-02-17T17:39:10.767,3,,
2020,8,2906,650,16,374,13,13,10,3,0,0,0,0,0,0,False,False,False,0,3,2020-11-05T21:10:32.823,0,,
2020,8,2906,665,22,6270,13,12,6,20,0,0,0,0,0,0,False,False,False,0,3,2020-11-02T16:46:12.523,0,,
2020,8,2906,670,22,7118,13,19,2,25,0,0,0,0,0,0,False,False,False,0,2,2020-11-02T16:49:04.827,0,,
2020,8,2906,690,16,7176,3,19,6,15,0,0,0,0,0,0,False,False,False,0,2,2020-11-02T17:01:45.777,0,,
2020,8,2906,695,16,374,2,5,9,9,16,7,15,1,15,0,False,False,False,0,3,2020-11-05T20:44:45.023,16,,
2020,8,2906,700,16,7182,2,46,3,0,5,5,5,0,5,0,False,False,False,0,4,2020-11-03T20:24:36.55,5,,
2020,8,2906,705,16,4143,13,2,9,10,0,0,0,0,0,0,False,False,False,0,3,2020-11-05T21:11:49.073,0,,
2020,8,2906,710,16,3938,2,19,6,33,41,8,40,1,40,6,False,False,False,0,2,2020-11-02T17:10:34.867,41,,
2020,8,2906,755,16,7176,2,13,9,5,10,5,9,1,9,0,False,False,False,0,3,2020-11-05T21:12:41.573,10,,
2020,8,2906,765,16,6500,2,5,3,7,7,0,7,0,7,0,False,False,False,0,2,2021-03-04T15:24:18.05,7,,
2020,8,2906,790,16,7176,2,51,9,-2,0,2,0,0,0,0,False,False,False,0,3,2020-11-02T17:46:03.103,0,,
2020,8,2906,805,16,7210,3,50,5,0,0,0,0,0,0,0,False,False,False,0,2,2020-11-02T17:49:56.303,0,,
2020,8,2907,25,29,4866,13,27,4,1,0,0,0,0,0,0,False,False,False,0,4,2020-11-03T16:40:30.153,0,,
2020,8,2907,30,29,4875,13,49,3,3,0,0,0,0,0,0,False,False,False,0,2,2020-11-06T16:12:23.29,0,,
2020,8,2907,35,29,4866,13,35,5,14,0,0,0,0,0,0,False,False,False,0,3,2020-11-06T18:07:26.437,0,,
2020,8,2907,85,17,7087,2,2,9,7,8,1,8,0,8,0,False,False,False,0,2,2020-11-02T17:17:30.253,8,,
2020,8,2907,90,17,7087,13,9,6,36,0,0,0,0,0,0,False,False,False,0,2,2020-11-02T11:28:48.87,0,,
2020,8,2907,95,17,7024,2,5,3,0,0,0,0,0,0,0,False,False,False,0,1,2020-11-03T16:41:25.327,0,,
2020,8,2907,100,17,2253,13,49,10,-2,0,0,0,0,0,0,True,False,False,0,2,2020-11-02T11:37:08.847,0,,
2020,8,2907,120,29,7378,13,5,10,-2,0,0,0,0,0,0,False,False,False,0,1,2020-11-02T11:36:46.27,0,,
2020,8,2907,125,29,4866,2,47,5,1,1,0,1,0,1,0,False,False,False,0,3,2020-11-06T17:40:14.803,1,,
2020,8,2907,130,29,1958,2,5,3,13,17,4,16,1,16,0,False,False,False,0,3,2020-11-06T17:33:59.653,17,,
2020,8,2907,140,29,4850,13,46,3,1,0,0,0,0,0,0,True,False,False,0,4,2020-11-03T23:47:54.84,0,,
2020,8,2907,145,29,4866,13,49,10,3,0,0,0,0,0,0,False,False,False,0,3,2021-03-15T17:24:26.817,0,,
2020,8,2907,165,17,6274,13,9,6,26,0,0,0,0,0,0,False,False,False,0,3,2020-11-02T12:04:20.14,0,,
2020,8,2907,180,29,4866,2,38,9,2,14,12,6,8,6,0,False,False,False,2,4,2020-11-03T16:42:59.143,14,,
2020,8,2907,185,29,4866,2,4,9,4,8,4,7,1,7,0,False,False,False,0,3,2020-11-03T16:43:18.923,8,,
2020,8,2907,190,29,4866,13,13,4,2,0,0,0,0,0,0,False,False,False,0,3,2020-11-02T12:11:02.56,0,,
2020,8,2907,195,17,6276,2,30,3,2,8,6,6,2,6,0,False,False,False,0,4,2020-11-02T12:12:49.85,8,,
2020,8,2907,205,17,4305,2,4,2,15,15,0,15,0,15,0,False,False,False,0,2,2020-11-02T12:15:37.54,15,,
2020,8,2907,210,17,7024,3,55,10,-2,0,0,0,0,0,0,False,False,False,0,1,2021-02-17T17:47:32.517,0,,
2020,8,2907,220,17,2253,2,2,4,3,3,0,3,0,3,6,True,False,False,0,3,2020-11-02T12:19:33.797,3,,
2020,8,2907,245,29,7378,2,4,10,1,11,10,3,8,3,0,False,False,False,1,1,2020-11-02T12:26:42.743,11,,
2020,8,2907,255,29,4866,2,5,3,11,22,11,19,3,19,0,False,False,False,0,3,2020-11-02T12:28:38.533,22,,
2020,8,2907,270,29,4875,13,35,7,16,0,0,0,0,0,0,False,False,False,0,2,2020-11-03T17:06:33.817,0,,
2020,8,2907,315,29,4866,13,38,9,3,0,0,0,0,0,0,False,False,False,0,4,2020-11-03T17:07:23.657,0,,
2020,8,2907,320,29,4875,13,9,6,24,0,0,0,0,0,0,False,False,False,0,2,2020-11-06T17:32:26.71,0,,
2020,8,2907,355,29,1958,2,30,9,0,8,8,6,2,6,0,False,False,False,0,4,2020-11-03T16:47:17.487,8,,
2020,8,2907,365,29,3398,2,30,9,1,1,0,1,0,1,0,False,False,False,0,4,2020-11-03T16:49:00.72,1,,
2020,8,2907,370,29,4850,13,4,3,5,0,0,0,0,0,0,False,False,False,0,2,2021-03-05T14:21:04.48,0,,
2020,8,2907,375,17,7087,3,4,5,6,0,0,0,0,0,0,False,False,False,0,2,2020-11-02T13:16:50.03,0,,
2020,8,2907,385,17,7087,3,13,10,3,0,0,0,0,0,0,False,False,False,0,2,2021-02-17T17:48:14.577,0,,
2020,8,2907,400,29,4875,13,9,6,27,0,0,0,0,0,0,False,False,False,0,2,2020-11-02T13:24:11.427,0,,
2020,8,2907,430,29,4866,13,5,3,10,0,0,0,0,0,0,False,False,False,0,3,2020-11-02T13:32:01.833,0,,
2020,8,2907,435,29,4875,13,4,5,3,0,0,0,0,0,0,False,False,False,0,2,2020-11-02T13:33:30.443,0,,
2020,8,2907,445,29,4866,2,4,9,5,6,1,6,0,6,0,False,False,False,0,3,2021-02-17T17:48:45.583,6,,
2020,8,2907,450,29,4866,2,4,9,5,9,4,9,0,9,0,False,False,False,0,3,2020-11-02T13:38:13.747,9,,
2020,8,2907,455,29,4866,2,5,5,13,13,0,13,0,13,0,False,False,False,0,3,2020-11-02T13:39:41.31,13,,
2020,8,2907,460,29,4875,2,4,3,6,9,3,9,0,9,0,False,False,False,0,2,2020-11-02T13:41:21.7,9,,
2020,8,2907,470,29,4850,2,46,3,1,5,4,3,2,3,0,False,False,False,0,3,2020-11-06T17:34:22.107,5,,
2020,8,2907,475,29,4866,13,35,6,23,0,0,0,0,0,0,False,False,False,0,3,2020-11-03T17:08:00.78,0,,
2020,8,2907,480,29,7828,2,29,3,8,8,0,8,0,8,0,False,False,False,0,2,2020-11-06T18:07:53.067,8,,
2020,8,2907,485,29,3356,2,46,3,3,3,0,3,0,3,0,False,False,False,0,3,2021-03-15T17:24:45.62,3,,
2020,8,2907,500,29,4875,2,5,3,5,7,2,7,0,7,0,False,False,False,0,3,2020-11-03T16:51:30.237,7,,
2020,8,2907,550,17,7024,2,2,9,3,9,6,8,1,8,0,False,False,False,0,2,2020-11-02T14:35:34.167,9,,
2020,8,2907,575,29,4850,3,12,5,3,0,0,0,0,0,0,False,False,False,0,4,2020-11-06T17:41:58.477,0,,
2020,8,2907,585,17,7024,2,48,10,-5,7,12,5,2,5,0,False,False,False,0,1,2020-11-06T17:48:18.297,7,,
2020,8,2907,590,17,7634,2,46,3,2,10,8,8,2,8,0,False,False,False,0,3,2020-11-02T14:51:21.123,10,,
2020,8,2907,605,17,7024,13,48,3,-6,0,0,0,0,0,0,False,False,False,0,1,2020-11-02T15:05:35.667,0,,
2020,8,2907,620,29,4875,2,4,3,4,13,9,4,9,4,0,False,False,False,1,2,2020-11-06T17:37:00.52,13,,
2020,8,2907,630,29,3398,13,4,5,4,0,0,0,0,0,0,False,False,False,0,2,2020-11-06T17:32:43.33,0,,
2020,8,2907,635,29,4866,13,7,6,30,0,0,0,0,0,0,False,False,False,0,3,2020-11-03T17:09:08.287,0,,
2020,8,2907,650,17,4484,13,26,9,1,0,0,0,0,0,0,False,False,False,0,4,2020-11-02T15:25:29.927,0,,
2020,8,2907,655,17,4305,13,13,4,2,0,0,0,0,0,0,True,False,False,0,3,2020-11-02T15:26:53.723,0,,
2020,8,2907,665,29,4866,2,32,9,1,6,5,5,1,5,0,False,False,False,0,4,2020-11-06T17:42:19.647,6,,
2020,8,2907,675,29,1958,2,2,4,11,26,15,18,8,18,0,False,False,False,1,2,2021-03-15T17:25:00.667,26,,
2020,8,2907,685,29,4866,2,35,6,17,34,17,31,3,31,0,False,False,False,0,4,2020-11-03T16:57:26.853,34,,
2020,8,2907,695,29,3398,13,4,5,4,0,0,0,0,0,0,False,False,False,0,2,2020-11-02T17:32:56.443,0,,
2020,8,2907,700,29,4850,2,13,9,3,7,4,7,0,7,0,False,False,False,0,4,2020-11-02T15:50:55.933,7,,
2020,8,2907,705,29,4866,13,5,2,17,0,0,0,0,0,0,False,False,False,0,3,2021-03-15T17:25:45.777,0,,
2020,8,2907,730,17,7087,2,52,10,2,7,5,6,1,6,0,False,False,False,0,2,2020-11-02T16:03:17.423,7,,
2020,8,2907,755,29,4866,2,5,3,6,6,0,6,0,6,0,False,False,False,0,3,2020-11-02T16:07:27.527,6,,
2020,8,2907,760,29,1958,2,50,10,-3,8,11,3,5,3,0,False,False,False,0,3,2020-11-02T16:08:44.2,8,,
2020,8,2907,765,29,4875,2,50,9,-2,15,17,12,3,12,0,False,False,False,0,3,2020-11-02T16:10:22.317,15,,
2020,8,2907,770,29,7828,2,8,8,15,15,0,15,0,15,0,False,False,False,0,2,2020-11-06T16:12:23.29,15,,
2020,8,2907,775,29,7788,2,44,3,-1,19,20,12,7,12,0,False,False,False,3,1,2020-11-06T17:43:11.967,19,,
2020,8,2907,790,29,1958,2,35,3,11,11,0,11,0,11,6,False,False,False,0,4,2020-11-03T17:01:49.6,11,,
2020,8,2907,805,17,6276,2,32,5,2,8,6,8,0,8,0,True,False,False,0,4,2020-11-03T17:02:14.993,8,,
2020,8,2907,815,17,4752,2,46,3,2,10,8,10,0,10,0,True,False,False,0,3,2020-11-03T17:02:38.16,10,,
2020,8,2907,825,17,6274,2,5,3,8,8,0,8,0,8,0,False,False,False,0,3,2020-11-03T17:03:00.517,8,,
2020,8,2907,830,17,7024,13,4,9,4,0,0,0,0,0,0,False,False,False,0,3,2020-11-06T17:33:02.51,0,,
2020,8,2907,840,29,4866,2,4,9,5,9,4,9,0,9,0,False,False,False,1,2,2020-11-02T16:38:50.537,9,,
2020,8,2907,845,29,3398,2,5,5,4,13,9,5,8,5,0,False,False,False,0,3,2020-11-06T17:34:46.307,13,,
2020,8,2907,850,29,1958,2,39,4,6,9,3,7,2,7,0,False,False,False,0,3,2020-11-02T16:41:49.527,9,,
2020,8,2907,865,29,4866,2,5,5,5,7,2,7,0,7,0,False,False,False,0,3,2020-11-02T16:48:03.873,7,,
2020,8,2907,870,29,4866,2,50,9,-3,15,18,2,13,2,0,False,False,False,1,2,2020-11-06T17:43:28.833,15,,
2020,8,2907,875,29,4866,13,4,4,5,0,0,0,0,0,0,False,False,False,0,3,2020-11-06T17:33:17.307,0,,
2020,8,2907,880,29,4850,2,13,10,3,5,2,5,0,5,0,False,False,False,0,3,2020-11-02T16:52:06.953,5,,
2020,8,2907,885,29,4850,13,7,2,15,0,0,0,0,0,0,False,False,False,0,3,2020-11-06T17:36:28.27,0,,
2020,8,2907,955,29,4850,2,4,10,5,11,6,9,2,9,0,False,False,False,0,3,2020-11-06T17:36:13.237,11,,
2020,8,2907,960,29,3356,2,4,10,2,14,12,7,7,7,0,False,False,False,1,1,2021-03-15T17:25:57.44,14,,
2020,8,2907,970,29,4850,2,32,5,4,4,0,4,0,4,0,False,False,False,0,4,2020-11-06T16:12:23.29,4,,
2020,8,2907,975,29,1958,2,5,5,6,6,0,6,0,6,0,False,False,False,0,2,2020-11-06T17:35:57.07,6,,
2020,7,2908,10,15,6501,13,4,5,7,0,0,0,0,0,0,False,False,False,0,2,2020-10-26T10:12:42.363,0,,0.0
2020,7,2908,20,15,6501,3,39,4,6,0,0,0,0,0,0,False,False,False,0,3,2020-10-26T10:19:17.143,0,,0.0
2020,7,2908,30,26,6301,2,45,10,-4,7,11,3,4,3,0,False,False,False,0,1,2020-10-26T10:25:00.37,7,,4.0
2020,7,2908,35,26,6301,2,48,10,-6,14,20,9,5,9,0,False,False,False,0,1,2020-10-26T10:28:00.323,14,,5.0
2020,7,2908,45,26,7695,2,51,9,-6,-5,1,-5,0,-5,0,False,False,False,0,1,2020-11-01T10:37:45.577,-5,,0.0
2020,7,2908,50,26,309,2,2,9,8,27,19,17,10,17,0,False,False,False,1,2,2020-10-26T10:38:03.253,27,,10.0
2020,7,2908,60,26,6301,2,46,3,1,3,2,3,0,3,0,False,False,False,0,1,2020-10-26T10:42:59.767,3,,0.0
2020,7,2908,65,26,4282,13,17,7,20,0,0,0,0,0,0,False,False,False,0,3,2020-10-26T10:48:59.187,0,,0.0
2020,7,2908,100,26,309,13,5,2,17,0,0,0,0,0,0,False,False,False,0,4,2020-10-26T11:00:14.77,0,,0.0
2020,7,2908,110,26,4282,13,35,9,13,0,0,0,0,0,0,False,False,False,0,3,2020-10-26T17:45:23.197,0,,0.0
2020,7,2908,135,15,6501,13,4,10,12,0,0,0,0,0,0,False,False,False,0,3,2020-10-26T17:46:13.63,0,,0.0
2020,7,2908,145,26,4619,2,30,9,1,4,3,3,1,3,0,True,False,False,0,2,2020-10-26T17:53:30.04,4,,1.0
2020,7,2908,155,26,7695,2,45,5,-2,8,10,7,1,7,0,True,False,False,0,1,2020-11-01T13:57:08.133,8,,1.0
2020,7,2908,165,26,309,2,2,4,5,10,5,8,2,8,0,False,False,False,1,3,2020-10-26T11:33:57.723,10,,2.0
2020,7,2908,170,26,7514,13,7,6,44,0,0,0,0,0,0,False,False,False,0,3,2020-10-26T11:36:52.293,0,,0.0
2020,7,2908,175,26,7453,13,5,5,12,0,0,0,0,0,0,False,False,False,0,2,2020-10-26T17:36:43.773,0,,
2020,7,2908,195,26,1900,13,7,6,16,0,0,0,0,0,0,False,False,False,0,4,2021-04-02T13:16:48.61,0,,0.0
2020,7,2908,200,26,309,2,29,6,22,26,4,22,4,22,0,False,False,False,0,3,2020-10-26T11:56:47.21,26,,4.0
2020,7,2908,250,26,309,2,26,3,4,6,2,4,2,4,0,False,False,False,0,3,2020-10-26T13:05:11.187,6,,2.0
2020,7,2908,255,26,309,2,13,4,2,9,7,3,6,3,0,False,False,False,0,3,2020-10-26T13:04:47.487,9,,6.0
2020,7,2908,265,26,4282,2,4,4,6,11,5,6,5,6,0,False,False,False,1,3,2021-03-03T14:14:47.4,11,,5.0
2020,7,2908,270,26,7491,2,17,8,22,22,0,22,0,22,6,False,False,False,0,4,2021-02-25T15:06:05,22,,0.0
2020,7,2908,285,15,6501,2,35,8,25,26,1,26,0,26,0,False,False,False,0,2,2020-10-26T12:33:17.513,26,,0.0
2020,7,2908,295,15,4997,13,13,10,5,0,0,0,0,0,0,False,False,False,0,3,2020-11-01T14:23:37.653,0,,0.0
2020,7,2908,300,15,7591,2,39,10,5,36,31,5,31,5,0,False,False,False,3,3,2020-11-01T11:44:45.09,36,,31.0
2020,7,2908,330,26,309,13,5,5,9,0,0,0,0,0,0,False,False,False,0,3,2020-10-26T13:00:49.007,0,,0.0
2020,7,2908,335,26,4282,13,26,3,3,0,0,0,0,0,0,False,False,False,0,3,2020-11-01T14:24:25.243,0,,0.0
2020,7,2908,345,15,2757,2,17,8,15,22,7,20,2,20,0,False,False,False,0,4,2021-02-25T15:06:50.197,22,,2.0
2020,7,2908,360,15,8099,2,28,9,-2,5,7,-1,6,-1,0,False,False,False,1,1,2020-10-26T13:17:02.45,5,,6.0
2020,7,2908,375,26,4282,2,5,9,3,5,2,3,2,3,0,False,False,False,0,4,2021-02-17T18:22:52.927,5,,2.0
2020,7,2908,380,26,4282,13,13,10,2,0,0,0,0,0,0,False,False,False,0,3,2020-11-01T14:04:53.263,0,,0.0
2020,7,2908,410,15,2757,2,12,5,3,4,1,3,1,3,0,False,False,False,0,4,2020-10-26T13:35:47.173,4,,1.0
2020,7,2908,420,15,8099,2,47,5,-2,1,3,0,1,0,0,False,False,False,0,1,2020-10-26T13:39:56.873,1,,1.0
2020,7,2908,425,15,8099,3,5,5,1,0,0,0,0,0,0,False,False,False,0,1,2020-11-01T10:38:42.613,0,,0.0
2020,7,2908,430,15,7592,2,5,3,10,13,3,12,1,12,0,False,False,False,0,3,2020-11-01T14:05:24.26,13,,1.0
2020,7,2908,450,15,8099,2,47,10,-2,9,11,4,5,4,6,False,False,False,1,1,2020-10-26T13:54:22.017,9,,5.0
2020,7,2908,465,26,4619,13,6,7,27,0,0,0,0,0,0,False,False,False,0,3,2020-11-01T14:07:41.283,0,,0.0
2020,7,2908,490,26,309,2,4,10,5,9,4,5,4,5,0,False,False,False,1,2,2020-10-26T14:16:07.147,9,,4.0
2020,7,2908,515,26,6301,2,48,9,-5,9,14,8,1,8,0,False,False,False,0,1,2020-10-26T14:22:29.013,9,,1.0
2020,7,2908,520,26,7453,2,6,9,14,14,0,14,0,14,0,False,False,False,0,4,2020-11-01T11:28:12.637,14,,0.0
2020,7,2908,540,26,309,13,4,5,8,0,0,0,0,0,0,False,False,False,0,2,2020-10-26T14:33:49.243,0,,0.0
2020,7,2908,545,26,4619,13,9,2,19,0,0,0,0,0,0,False,False,False,0,2,2020-11-01T10:39:31.843,0,,0.0
2020,7,2908,580,26,7453,3,35,9,9,0,0,0,0,0,0,False,False,False,0,3,2020-10-26T14:50:57.207,0,,0.0
2020,7,2908,585,26,309,2,26,3,3,11,8,8,3,8,0,False,False,False,0,3,2020-11-01T11:51:34.517,11,,3.0
2020,7,2908,600,26,6301,13,12,2,18,0,0,0,0,0,0,False,False,False,0,1,2020-11-01T14:08:04.813,0,,
2020,7,2908,605,26,1900,2,43,6,26,26,0,26,0,26,6,False,False,False,0,4,2021-02-17T18:26:53.85,26,,0.0
2020,7,2908,630,15,4997,2,5,5,12,12,0,12,0,12,0,False,False,False,0,3,2020-10-26T17:34:58.943,12,,0.0
2020,7,2908,635,15,2757,2,13,10,5,6,1,6,0,6,0,False,False,False,0,4,2020-10-26T17:35:20.31,6,,0.0
2020,7,2908,640,15,8099,2,48,9,-3,3,6,3,0,3,0,False,False,False,0,1,2021-02-17T18:27:54.447,3,,0.0
2020,7,2908,645,15,6501,3,35,10,13,0,0,0,0,0,0,False,False,False,0,3,2020-10-26T15:30:41.71,0,,0.0
2020,7,2908,650,15,2407,2,19,6,28,28,0,28,0,28,6,False,False,False,0,2,2020-10-26T15:33:55.273,28,,0.0
2020,7,2908,665,26,6301,2,48,10,-4,10,14,2,8,2,0,False,False,False,1,1,2020-10-26T15:38:19.91,10,,8.0
2020,7,2908,670,26,7453,2,19,2,31,70,39,70,0,70,6,False,False,False,0,2,2020-11-01T11:45:19.44,70,,0.0
2020,7,2908,685,26,7695,2,5,10,3,8,5,6,2,6,0,False,False,False,0,1,2020-10-26T15:48:49.157,8,,2.0
2020,7,2908,750,15,8099,3,12,3,5,0,0,0,0,0,0,False,False,False,0,3,2020-11-01T10:40:25.7,0,,0.0
2020,7,2908,760,26,6301,13,44,3,-4,0,0,0,0,0,0,False,False,False,0,1,2020-10-26T17:49:12.11,0,,0.0
2020,7,2908,765,26,4282,2,4,4,6,7,1,6,1,6,0,False,False,False,0,4,2020-10-26T16:16:43.54,7,,1.0
2020,7,2908,780,26,309,2,6,9,4,14,10,7,7,7,0,False,False,False,0,2,2020-10-26T17:41:12.887,14,,7.0
2020,7,2908,785,26,7695,2,51,10,-6,10,16,2,8,2,0,False,False,False,1,1,2020-11-01T11:45:39.007,10,,8.0
2020,7,2908,790,26,7695,2,5,5,3,3,0,3,0,3,0,False,False,False,0,1,2020-11-01T10:50:08.673,3,,0.0
2020,7,2908,800,26,309,2,6,9,5,5,0,5,0,5,0,False,False,False,0,2,2021-02-25T15:08:12.747,5,,0.0
2020,7,2908,805,26,8177,3,47,5,1,0,0,0,0,0,0,False,False,False,0,1,2020-11-01T11:16:11.057,0,,0.0
2020,7,2908,830,15,7591,2,4,10,5,4,-1,4,0,4,0,False,False,False,0,3,2020-10-26T16:46:24.8,4,,0.0
2020,7,2908,835,15,7591,2,4,9,4,4,0,4,0,4,0,False,False,False,0,3,2020-10-26T16:48:56.043,4,,0.0
2020,7,2908,840,15,2407,13,19,6,36,0,0,0,0,0,0,False,False,False,0,2,2020-10-26T16:50:44.123,0,,0.0
2020,7,2908,850,15,6501,13,29,2,29,0,0,0,0,0,0,False,False,False,0,2,2020-10-26T16:55:41.217,0,,0.0
2020,7,2908,855,15,6501,13,7,2,26,0,0,0,0,0,0,False,False,False,0,3,2020-10-26T16:57:48.33,0,,0.0
2020,7,2908,880,26,309,2,6,10,5,8,3,6,2,6,0,False,False,False,1,2,2021-02-17T18:30:06.367,8,,2.0
2020,8,2909,25,20,306,2,44,3,-4,9,13,6,3,6,0,False,False,False,0,1,2020-11-02T11:30:28.017,9,,
2020,8,2909,40,20,1162,2,53,10,-3,7,10,7,0,7,0,False,False,False,0,4,2020-11-05T17:37:12.77,7,,
2020,8,2909,50,20,5140,2,48,9,-5,-1,4,-2,1,-2,0,False,False,False,0,1,2021-02-16T17:28:39.577,-1,,
2020,8,2909,55,20,5140,2,50,4,-1,1,2,0,1,0,0,False,False,False,1,1,2021-02-18T14:01:18.737,1,,
2020,8,2909,64,20,306,2,46,3,1,1,0,1,0,1,0,False,False,False,0,1,2020-11-05T19:11:26.513,1,,
2020,8,2909,75,6,6328,2,2,4,6,8,2,7,1,7,0,False,False,False,0,3,2020-11-02T12:03:02.8,8,,
2020,8,2909,80,6,7725,2,30,5,1,4,3,4,0,4,0,False,False,False,0,3,2021-02-17T22:41:20.287,4,,
2020,8,2909,85,6,6331,2,5,3,7,9,2,8,1,8,0,False,False,False,0,2,2020-11-02T12:09:08.71,9,,
2020,8,2909,100,6,6786,3,48,9,-3,0,0,0,0,0,0,False,False,False,0,1,2021-03-17T20:37:04.367,0,,
2020,8,2909,110,6,6328,2,39,4,5,11,6,11,0,11,0,False,False,False,0,4,2020-11-02T12:29:05.873,11,,
2020,8,2909,120,6,6328,3,30,3,1,0,0,0,0,0,0,False,False,False,0,3,2021-02-18T14:09:05.07,0,,
2020,8,2909,140,6,7725,2,5,5,6,7,1,7,0,7,0,False,False,False,0,3,2020-11-05T20:20:43.863,7,,
2020,8,2909,160,20,5140,2,16,9,3,47,44,44,3,44,0,False,False,False,0,1,2020-11-02T12:57:09.36,47,,
2020,8,2909,175,20,5140,2,5,9,5,14,9,11,3,11,0,False,False,False,1,3,2020-11-05T18:59:32.207,14,,
2020,8,2909,195,20,306,2,4,9,2,4,2,2,2,2,0,False,False,False,0,1,2020-11-02T13:17:39.663,4,,
2020,8,2909,210,6,7725,2,8,1,46,50,4,46,4,46,0,False,False,False,0,2,2020-11-05T18:05:47.33,50,,
2020,8,2909,220,6,464,2,7,6,24,24,0,24,0,24,6,False,False,False,0,3,2021-02-25T15:36:31.78,24,,
2020,8,2909,235,20,6388,13,35,4,13,0,0,0,0,0,0,False,False,False,0,3,2020-11-05T20:16:23.55,0,,
2020,8,2909,240,20,5140,2,16,4,5,5,0,5,0,5,0,False,False,False,0,1,2020-11-02T19:45:04.217,5,,
2020,8,2909,245,20,6388,13,19,2,34,0,0,0,0,0,0,False,False,False,0,2,2020-11-05T17:37:12.77,0,,
2020,8,2909,255,6,811,2,50,3,-3,-4,-1,-4,0,-4,0,False,False,False,0,2,2021-03-04T17:08:09.677,-4,,
2020,8,2909,260,6,666,3,2,9,10,0,0,0,0,0,0,False,False,False,0,2,2021-02-17T22:42:35.137,0,,
2020,8,2909,265,6,6786,3,32,3,2,0,0,0,0,0,0,False,False,False,0,4,2020-11-02T13:50:33.6,0,,
2020,8,2909,285,20,3747,2,26,10,4,5,1,5,0,5,0,False,False,False,0,2,2020-11-05T19:36:22.14,5,,
2020,8,2909,325,6,6337,2,46,3,2,2,0,2,0,2,0,False,False,False,0,1,2020-11-02T14:22:25.593,2,,
2020,8,2909,335,6,6786,3,16,9,2,0,0,0,0,0,0,False,False,False,0,1,2020-11-02T14:25:03.987,0,,
2020,8,2909,350,20,958,2,4,10,3,11,8,8,3,8,0,False,False,False,0,3,2020-11-02T14:29:22.107,11,,
2020,8,2909,360,20,7353,2,13,4,3,5,2,4,1,4,0,True,False,False,0,2,2020-11-05T19:43:42.6,5,,
2020,8,2909,370,20,5140,2,50,3,-3,12,15,-3,15,-3,0,False,False,False,0,2,2020-11-05T20:21:14.597,12,,
2020,8,2909,385,20,6388,2,5,5,3,4,1,3,1,3,0,False,False,False,0,3,2020-11-05T17:37:12.77,4,,
2020,8,2909,390,20,5140,2,47,5,2,8,6,8,0,8,0,False,False,False,0,1,2020-11-02T14:49:44.567,8,,
2020,8,2909,395,20,7353,13,21,2,29,0,0,0,0,0,0,False,False,False,0,2,2020-11-02T19:30:42.96,0,,
2020,8,2909,400,20,958,3,8,1,16,0,0,0,0,0,0,False,False,False,0,3,2020-11-02T14:56:15.65,0,,
2020,8,2909,405,20,958,2,8,7,16,16,0,16,0,16,6,False,False,False,0,2,2020-11-02T14:59:32.053,16,,
2020,8,2909,430,6,6328,2,4,9,6,9,3,8,1,8,0,False,False,False,0,3,2020-11-02T15:03:50.463,9,,
2020,8,2909,440,6,7725,2,30,5,1,5,4,5,0,5,0,True,False,False,0,2,2020-11-05T18:05:05.207,5,,
2020,8,2909,475,20,5140,13,44,3,-6,0,0,0,0,0,0,False,False,False,0,1,2020-11-02T15:25:31.44,0,,
2020,8,2909,480,20,8127,2,2,9,5,5,0,5,0,5,0,False,False,False,0,2,2020-11-02T15:28:12.73,5,,
2020,8,2909,495,6,464,2,4,9,3,5,2,4,1,4,0,True,False,False,0,3,2020-11-05T18:07:33.783,5,,
2020,8,2909,500,6,666,13,20,6,18,0,0,0,0,0,0,False,False,False,0,2,2021-03-05T14:22:31.527,0,,
2020,8,2909,515,20,8127,13,6,10,6,0,0,0,0,0,0,False,False,False,0,2,2021-01-12T23:39:41.463,0,,
2020,8,2909,520,20,7353,2,4,10,8,8,0,8,0,8,0,False,False,False,0,3,2020-11-02T15:49:14.627,8,,
2020,8,2909,535,20,5140,13,11,5,14,0,0,0,0,0,0,False,False,False,0,3,2020-11-02T19:46:24.473,0,,
2020,8,2909,550,6,7725,13,8,7,44,0,0,0,0,0,0,False,False,False,0,2,2020-11-05T18:08:27.993,0,,
2020,8,2909,580,20,5140,3,45,10,-5,0,0,0,0,0,0,False,False,False,0,1,2020-11-02T16:10:37.847,0,,
2020,8,2909,585,20,6388,2,4,9,12,12,0,12,0,12,0,False,False,False,0,2,2020-11-05T19:51:54.093,12,,
2020,8,2909,595,6,6328,2,6,8,16,16,0,15,1,15,0,False,False,False,1,3,2020-11-05T18:09:02.513,16,,
2020,8,2909,600,6,811,2,45,5,-6,5,11,3,2,3,0,True,False,False,0,2,2020-11-05T19:57:06.313,5,,
2020,8,2909,620,6,6328,2,13,9,3,6,3,5,1,5,0,False,False,False,0,3,2020-11-05T17:37:12.77,6,,
2020,8,2909,625,6,464,13,7,6,17,0,0,0,0,0,0,False,False,False,0,3,2020-11-05T19:59:12.2,0,,
2020,8,2909,630,20,958,2,2,4,7,11,4,11,0,11,0,False,False,False,0,3,2020-11-02T16:36:55.16,11,,
2020,8,2909,635,20,5140,2,2,4,6,13,7,10,3,10,0,False,False,False,0,3,2020-11-02T16:39:08.65,13,,
2020,8,2909,640,20,6388,2,32,10,-1,3,4,2,1,2,0,False,True,False,0,4,2020-11-05T19:06:57.043,4,,
2020,8,2909,650,20,6388,2,4,10,9,9,0,9,0,9,0,False,False,False,0,2,2020-11-02T16:48:11.067,9,,
2020,8,2909,660,20,4535,2,6,9,12,20,8,20,0,20,6,False,False,False,0,3,2020-11-02T16:53:49.387,20,,
2020,8,2909,680,6,6786,2,46,3,2,7,5,5,2,5,0,False,False,False,0,1,2020-11-02T16:59:05.153,7,,
2020,8,2909,685,6,6786,2,16,9,2,9,7,8,1,8,0,False,False,False,0,1,2020-11-02T17:02:43.473,9,,
2020,8,2909,695,6,464,2,8,7,20,28,8,28,0,28,0,False,False,False,0,2,2020-11-05T20:21:47.417,28,,
2020,8,2909,700,6,666,2,5,3,11,11,0,11,0,11,0,False,False,False,0,3,2020-11-05T20:22:09.993,11,,
2020,8,2909,705,6,6328,2,55,4,-4,-3,1,-6,3,-6,0,False,False,False,1,3,2021-03-04T15:27:10.73,-3,,
2020,8,2909,715,6,666,13,17,10,12,0,0,0,0,0,0,False,False,False,0,3,2020-11-02T19:31:15.423,0,,
2020,8,2909,730,6,7725,2,47,5,1,3,2,3,0,3,6,False,False,False,0,3,2020-11-02T17:25:48.1,3,,
2020,8,2909,755,20,958,2,5,5,4,4,0,3,1,3,0,False,False,False,0,3,2020-11-02T17:32:53.917,4,,
2020,8,2909,760,20,5140,2,44,9,-6,-3,3,-5,2,-5,0,False,False,False,0,1,2020-11-05T20:02:55.343,-3,,
2020,8,2909,775,6,7728,2,32,9,2,2,0,2,0,2,0,False,False,False,0,1,2020-11-02T19:31:46.257,2,,
2020,8,2909,785,6,6328,13,5,5,9,0,0,0,0,0,0,False,False,False,0,3,2020-11-05T20:23:49.5,0,,
2020,8,2909,790,6,666,13,2,4,4,0,0,0,0,0,0,False,False,False,0,3,2020-11-05T18:16:20.743,0,,
2020,8,2909,795,6,6328,2,13,10,5,11,6,11,0,11,0,True,False,False,0,2,2020-11-05T20:04:24.927,11,,
2020,8,2909,800,6,464,2,6,9,4,6,2,5,1,5,0,False,False,False,0,3,2020-11-02T17:52:08.213,6,,
2020,8,2909,810,6,666,2,5,5,2,2,0,2,0,2,0,False,False,False,0,3,2020-11-02T17:57:25.41,2,,
2020,8,2909,820,6,464,2,5,5,2,7,5,7,0,7,0,False,False,False,0,3,2020-11-02T18:00:03.9,7,,
2020,8,2909,825,6,666,13,31,10,2,0,0,0,0,0,0,False,False,False,0,3,2020-11-05T20:08:00.72,0,,
2020,8,2909,840,6,6328,2,5,6,15,15,0,15,0,15,0,False,False,False,0,3,2020-11-02T18:06:08.243,15,,
2020,8,2909,875,20,4828,2,32,5,1,10,9,2,8,2,0,False,False,False,1,3,2020-11-05T20:40:17.667,10,,
2020,8,2909,880,20,958,2,2,10,7,9,2,8,1,8,0,False,False,False,0,3,2020-11-02T18:15:01.72,9,,
2020,8,2909,895,20,5140,3,32,9,-4,0,0,0,0,0,0,False,False,False,0,1,2020-11-05T18:11:14.59,0,,
2020,8,2909,900,20,958,13,5,5,2,0,0,0,0,0,0,False,False,False,0,3,2020-11-02T18:27:15.31,0,,
2020,8,2909,905,20,4535,2,38,9,6,10,4,7,3,7,0,False,False,False,0,3,2020-11-05T17:37:12.77,10,,
2020,8,2909,930,6,464,2,5,6,16,17,1,16,1,16,0,False,False,False,0,2,2020-11-05T20:09:29.68,17,,
2020,8,2909,935,6,6328,3,5,5,6,0,0,0,0,0,0,False,False,False,0,3,2020-11-05T18:12:18.217,0,,
2020,8,2909,940,6,666,3,6,9,5,0,0,0,0,0,0,False,False,False,0,2,2020-11-02T18:44:05.343,0,,
2020,8,2909,955,20,7353,2,50,3,-5,6,11,2,4,2,0,True,False,False,0,3,2020-11-05T19:00:53.217,6,,
2020,8,2909,965,20,8127,13,7,2,15,0,0,0,0,0,0,False,False,False,0,3,2020-11-02T18:55:11.187,0,,
2020,8,2909,970,20,6388,2,4,4,11,14,3,12,2,12,0,False,False,False,0,3,2020-11-05T17:37:12.77,14,,
2020,8,2909,990,20,7353,13,4,10,11,0,0,0,0,0,0,False,False,False,0,3,2020-11-02T19:32:01.193,0,,
2020,8,2910,10,27,7408,2,49,9,-3,-3,0,-3,0,-3,0,False,False,False,0,2,2020-11-02T19:28:24.96,-3,,
2020,8,2910,20,27,7408,2,49,10,-3,7,10,6,1,6,0,False,False,False,0,3,2020-11-02T19:28:36.96,7,,
2020,8,2910,35,28,7619,2,2,10,13,19,6,18,1,18,0,False,False,False,0,3,2020-11-02T11:54:06.113,19,,
2020,8,2910,40,28,4922,13,2,4,13,0,0,0,0,0,0,False,False,False,0,3,2020-11-02T11:59:18.867,0,,
2020,8,2910,65,27,4835,3,5,9,6,0,0,0,0,0,0,False,False,False,0,2,2020-11-02T12:12:13.397,0,,
2020,8,2910,70,27,5069,2,18,3,-1,5,6,1,4,1,0,False,False,False,0,2,2020-11-02T19:37:49.49,5,,
2020,8,2910,75,27,5069,2,2,9,6,7,1,6,1,6,0,False,False,False,0,2,2020-11-02T12:16:19.77,7,,
2020,8,2910,85,27,505,13,47,5,3,0,0,0,0,0,0,True,False,False,0,3,2020-11-02T12:24:17.6,0,,
2020,8,2910,105,28,262,2,39,10,4,8,4,5,3,5,0,False,False,False,0,4,2020-11-05T18:20:34.547,8,,
2020,8,2910,115,28,6627,13,43,3,12,0,0,0,0,0,0,False,False,False,0,4,2020-11-02T12:37:51.997,0,,
2020,8,2910,135,28,4922,13,26,10,7,0,0,0,0,0,0,False,False,False,0,3,2020-11-02T12:51:39.65,0,,
2020,8,2910,145,27,7850,2,12,10,3,3,0,3,0,3,0,False,False,False,0,1,2020-11-02T12:55:19.02,3,,
2020,8,2910,150,27,2335,2,28,10,2,9,7,6,3,6,0,False,False,False,0,1,2020-11-02T12:57:07.577,9,,
2020,8,2910,155,27,650,2,4,9,11,12,1,11,1,11,0,False,False,False,1,3,2020-11-05T18:19:11.57,12,,
2020,8,2910,170,27,7408,2,6,9,9,46,37,46,0,46,6,False,False,False,1,2,2020-11-02T19:37:21.857,46,,
2020,8,2910,185,28,262,13,47,5,1,0,0,0,0,0,0,False,False,False,0,1,2020-11-02T13:16:21.33,0,,
2020,8,2910,195,28,4912,2,4,9,8,9,1,9,0,9,0,False,False,False,0,3,2020-11-05T16:59:24.887,9,,
2020,8,2910,200,28,262,2,5,5,13,13,0,13,0,13,0,False,False,False,0,1,2020-11-05T19:29:20.677,13,,
2020,8,2910,210,28,4912,13,4,10,5,0,0,0,0,0,0,False,False,False,0,3,2021-04-01T19:14:15.083,0,,
2020,8,2910,215,28,7619,2,2,9,5,6,1,6,0,6,0,False,False,False,0,2,2020-11-02T13:41:08.023,6,,
2020,8,2910,235,28,797,2,46,3,2,2,0,2,0,2,0,False,False,False,0,1,2020-11-02T13:48:30.62,2,,
2020,8,2910,240,28,4912,2,5,10,8,10,2,9,1,9,0,False,False,False,0,3,2020-11-02T13:50:35.017,10,,
2020,8,2910,275,27,650,2,4,10,9,11,2,10,1,10,0,False,False,False,0,2,2020-11-02T14:04:15.32,11,,
2020,8,2910,285,27,7408,2,3,6,15,15,0,15,0,15,0,False,False,False,0,2,2020-11-02T19:24:57.87,15,,
2020,8,2910,290,27,7408,13,6,7,17,0,0,0,0,0,0,False,False,False,0,2,2020-11-05T18:26:28.327,0,,
2020,8,2910,295,27,7408,2,19,6,30,35,5,33,2,33,0,False,False,False,0,2,2020-11-05T16:59:49.147,35,,
2020,8,2910,300,27,4835,2,51,10,-2,6,8,4,2,4,0,False,False,False,0,3,2020-11-02T14:35:49.963,6,,
2020,8,2910,315,27,7408,2,2,10,2,2,0,2,0,2,6,False,False,False,0,3,2020-11-05T18:22:30.71,2,,
2020,8,2910,335,28,7619,13,2,9,9,0,0,0,0,0,0,False,False,False,0,2,2020-11-05T17:07:41.823,0,,
2020,8,2910,340,28,4922,2,32,5,1,14,13,10,4,10,0,False,False,False,0,4,2020-11-02T19:23:14.38,14,,
2020,8,2910,355,28,4912,2,5,3,4,3,-1,3,0,3,0,False,False,False,0,3,2020-11-02T15:00:31.817,3,,
2020,8,2910,360,28,4932,2,54,3,-5,-6,-1,-5,-1,-5,0,True,False,False,0,3,2020-11-05T18:28:16.89,-6,,
2020,8,2910,385,27,505,13,47,5,2,0,0,0,0,0,0,True,False,False,0,3,2020-11-02T15:12:16.083,0,,
2020,8,2910,390,27,7408,13,4,9,9,0,0,0,0,0,0,False,False,False,0,3,2020-11-02T15:16:04.45,0,,
2020,8,2910,460,27,7850,2,48,9,-6,4,10,2,2,2,0,False,False,False,0,1,2020-11-02T15:46:01.68,4,,
2020,8,2910,465,27,7850,2,12,10,3,3,0,3,0,3,0,False,False,False,0,1,2020-11-05T17:03:51.82,3,,
2020,8,2910,470,27,7408,2,2,10,4,7,3,6,1,6,0,False,False,False,0,2,2020-11-02T19:27:27.457,7,,
2020,8,2910,485,27,7850,2,47,5,0,2,2,2,0,2,6,False,False,False,0,1,2020-11-02T15:53:21.843,2,,
2020,8,2910,500,27,7408,2,50,3,-1,9,10,-2,11,-2,0,False,False,False,1,3,2020-11-02T19:27:12.8,9,,
2020,8,2910,515,27,505,13,12,9,6,0,0,0,0,0,0,False,False,False,0,4,2020-11-02T16:13:26.58,0,,
2020,8,2910,520,27,505,13,17,9,6,0,0,0,0,0,0,True,False,False,0,3,2020-11-02T16:16:04.95,0,,
2020,8,2910,525,27,5069,2,13,9,6,6,0,6,0,6,6,False,False,False,0,3,2020-11-05T17:00:34.497,6,,
2020,8,2910,540,28,7619,2,4,10,5,6,1,6,0,6,0,True,False,False,0,3,2020-11-02T16:26:14.037,6,,
2020,8,2910,565,27,7408,2,4,9,14,14,0,14,0,14,0,False,False,False,0,2,2020-11-02T19:25:45.373,14,,
2020,8,2910,580,27,7408,2,5,3,10,12,2,11,1,11,0,False,False,False,0,3,2020-11-02T19:26:04.887,12,,
2020,8,2910,595,27,7850,2,4,4,1,5,4,3,2,3,0,False,False,False,0,1,2020-11-02T16:43:39.03,5,,
2020,8,2910,600,27,7408,13,19,6,30,0,0,0,0,0,0,False,False,False,0,2,2020-11-02T16:52:00.863,0,,
2020,8,2910,615,28,797,2,47,5,1,12,11,10,2,10,0,False,False,False,0,1,2020-11-05T18:41:45.927,12,,
2020,8,2910,620,28,7619,2,50,9,-4,9,13,6,3,6,0,False,False,False,0,3,2020-11-02T16:58:30.507,9,,
2020,8,2910,635,28,4922,2,9,6,19,25,6,19,6,19,0,False,False,False,0,3,2020-11-02T19:23:41.467,25,,
2020,8,2910,640,28,797,2,6,9,8,12,4,12,0,12,0,True,False,False,0,2,2020-11-02T17:10:06.77,12,,
2020,8,2910,645,28,7619,13,35,2,18,0,0,0,0,0,0,False,False,False,0,3,2020-11-02T17:11:39.413,0,,
2020,8,2910,650,28,4932,13,46,3,2,0,0,0,0,0,0,True,False,False,0,3,2020-11-02T17:14:06.45,0,,
2020,8,2910,660,28,4912,2,5,3,4,4,0,4,0,4,0,False,False,False,0,3,2020-11-02T17:20:17.457,4,,
2020,8,2910,670,28,7619,2,4,9,5,6,1,6,0,6,0,False,False,False,0,3,2020-11-02T17:22:28.77,6,,
2020,8,2910,675,28,7619,2,4,10,5,9,4,6,3,6,0,False,False,False,0,3,2020-11-02T17:31:08.497,9,,
2020,8,2910,700,27,7408,2,4,5,8,8,0,8,0,8,0,False,False,False,0,2,2020-11-02T19:26:54.493,8,,
2020,8,2910,710,27,6397,2,47,10,-3,17,20,15,2,15,0,True,False,False,0,4,2020-11-05T17:01:03.277,17,,
2020,8,2910,715,27,650,13,9,2,49,0,0,0,0,0,0,True,False,False,0,3,2020-11-02T18:05:44.11,0,,
2020,8,2910,725,27,7408,13,2,10,9,0,0,0,0,0,0,False,False,False,0,2,2020-11-03T17:15:35.073,0,,
2020,8,2910,735,28,4932,2,4,5,6,9,3,6,3,6,0,False,False,False,0,3,2020-11-02T18:15:03.94,9,,
2020,8,2910,740,28,7619,2,8,1,32,33,1,32,1,32,0,False,False,False,0,3,2020-11-02T18:16:38.923,33,,
2020,8,2910,745,28,4912,13,4,10,11,0,0,0,0,0,0,False,False,False,0,3,2020-11-02T18:18:08.557,0,,
2020,8,2910,750,28,7751,2,16,4,1,2,1,1,1,1,0,False,False,False,0,1,2020-11-02T18:19:16.103,2,,
2020,8,2910,755,28,4912,2,17,10,6,20,14,8,12,8,0,False,False,False,2,3,2020-11-02T18:20:52.733,20,,
2020,8,2910,760,28,6627,2,4,9,11,16,5,13,3,13,6,False,False,False,0,3,2020-11-02T18:22:27.527,16,,
2020,8,2910,775,27,650,2,4,5,4,6,2,5,1,5,0,False,False,False,0,2,2020-11-02T18:26:28.253,6,,
2020,8,2910,780,27,7408,2,4,5,9,9,0,9,0,9,0,False,False,False,0,2,2020-11-02T19:26:39.38,9,,
2020,8,2910,820,27,650,2,30,10,-1,4,5,1,3,1,0,True,False,False,0,4,2021-02-17T18:35:33.823,4,,
2020,8,2910,840,28,4912,2,4,10,5,11,6,9,2,9,0,False,False,False,0,2,2020-11-02T18:52:35.793,11,,
2020,8,2910,845,28,6627,13,13,9,2,0,0,0,0,0,0,False,False,False,0,3,2020-11-02T18:53:47.1,0,,
2020,8,2910,850,28,797,2,4,4,4,14,10,12,2,12,0,False,False,False,0,1,2020-11-02T18:55:44.887,14,,
2020,8,2910,855,28,4932,13,13,9,5,0,0,0,0,0,0,False,False,False,0,3,2020-11-02T18:58:03.48,0,,
2020,8,2910,860,28,4912,2,4,2,15,17,2,17,0,17,0,False,False,False,0,3,2020-11-02T19:38:44.743,17,,
2020,8,2910,865,28,4932,2,8,1,17,29,12,21,8,21,0,False,False,False,1,3,2020-11-02T19:01:19.293,29,,
2020,8,2910,870,28,6627,13,6,10,9,0,0,0,0,0,0,False,False,False,0,3,2020-11-02T19:04:42.723,0,,
2020,8,2910,875,28,4912,2,13,9,3,7,4,7,0,7,0,False,False,False,0,2,2020-11-05T18:27:30.26,7,,
2020,8,2910,885,28,7619,2,9,5,3,3,0,3,0,3,6,False,False,False,0,2,2020-11-05T17:01:25.77,3,,
2020,8,2911,20,9,322,13,12,5,11,0,0,0,0,0,0,False,False,False,0,2,2020-11-02T11:06:02.997,0,,
2020,8,2911,30,9,7816,2,5,5,10,12,2,11,1,11,0,False,False,False,0,3,2020-11-02T11:09:55.78,12,,
2020,8,2911,45,9,6436,2,50,5,-2,13,15,6,7,6,0,False,False,False,0,2,2020-11-06T16:07:31.653,13,,
2020,8,2911,80,9,6436,2,18,3,-2,6,8,2,4,2,0,False,False,False,0,2,2020-11-06T15:11:44.673,6,,
2020,8,2911,120,24,4385,3,48,9,-4,0,0,0,0,0,0,False,False,False,0,1,2020-11-02T11:45:21.743,0,,
2020,8,2911,125,24,7798,2,5,5,8,8,0,8,0,8,0,False,False,False,0,2,2020-11-02T11:47:47.9,8,,
2020,8,2911,140,24,6808,2,19,6,19,32,13,26,6,26,0,False,False,False,0,2,2020-11-02T11:52:32.133,32,,
2020,8,2911,150,24,6389,2,46,3,4,6,2,6,0,6,0,False,False,False,0,1,2020-11-02T11:54:34.5,6,,
2020,8,2911,155,24,7798,2,30,10,1,2,1,1,1,1,6,True,False,False,0,4,2020-11-02T11:56:37.483,2,,
2020,8,2911,180,9,4446,13,5,2,17,0,0,0,0,0,0,False,False,False,0,2,2020-11-02T12:11:28.9,0,,
2020,8,2911,190,9,6446,13,12,2,32,0,0,0,0,0,0,False,False,False,0,3,2020-11-02T12:14:40.977,0,,
2020,8,2911,205,24,6808,2,12,7,16,18,2,16,2,16,0,False,False,False,0,3,2020-11-06T15:08:20.373,18,,
2020,8,2911,210,24,4382,13,12,5,8,0,0,0,0,0,0,True,False,False,0,3,2021-02-25T15:38:42.597,0,,
2020,8,2911,230,9,4446,13,4,5,8,0,0,0,0,0,0,False,False,False,0,2,2020-11-02T12:34:28.13,0,,
2020,8,2911,235,9,6436,2,18,3,0,10,10,5,5,5,0,False,False,False,0,2,2020-11-06T16:43:50.497,10,,
2020,8,2911,250,9,6436,13,2,9,6,0,0,0,0,0,0,False,False,False,0,2,2020-11-02T12:43:44.413,0,,
2020,8,2911,280,24,6808,2,4,5,6,6,0,6,0,6,0,False,False,False,0,2,2020-11-02T12:52:13.813,6,,
2020,8,2911,290,24,7799,13,21,6,42,0,0,0,0,0,0,True,False,False,0,2,2020-11-06T15:04:26.003,0,,
2020,8,2911,315,9,7183,2,34,4,-4,14,18,11,3,11,0,True,False,False,0,3,2020-11-06T16:25:02.787,14,,
2020,8,2911,320,9,6436,2,50,9,-3,1,4,0,1,0,0,False,False,False,1,2,2020-11-06T15:51:12.547,1,,
2020,8,2911,325,9,322,13,12,5,10,0,0,0,0,0,0,False,False,False,0,4,2020-11-06T16:25:26.73,0,,
2020,8,2911,350,24,7798,3,18,3,-1,0,0,0,0,0,0,False,False,False,0,2,2020-11-02T13:17:32.617,0,,
2020,8,2911,355,24,6373,13,9,6,25,0,0,0,0,0,0,False,False,False,0,3,2020-11-02T13:20:27.647,0,,
2020,8,2911,360,24,7798,13,12,2,34,0,0,0,0,0,0,False,False,False,0,2,2020-11-02T13:24:14.923,0,,
2020,8,2911,380,9,6436,3,49,10,2,0,0,0,0,0,0,False,False,False,0,2,2021-03-10T19:48:44.077,0,,
2020,8,2911,390,24,6389,2,5,5,2,3,1,2,1,2,0,False,False,False,0,1,2020-11-02T13:32:33.357,3,,
2020,8,2911,395,24,7799,13,4,3,7,0,0,0,0,0,0,False,False,False,0,2,2020-11-02T13:34:23.43,0,,
2020,8,2911,400,24,4382,2,6,4,6,6,0,6,0,6,0,True,False,False,0,3,2020-11-02T13:37:23.247,6,,
2020,8,2911,410,24,6808,13,4,5,9,0,0,0,0,0,0,False,False,False,0,2,2020-11-02T13:39:45.02,0,,
2020,8,2911,415,9,6436,2,4,5,8,11,3,10,1,10,0,False,False,False,0,2,2020-11-02T13:42:24.593,11,,
2020,8,2911,430,9,4202,13,46,3,3,0,0,0,0,0,0,True,False,False,0,3,2020-11-02T13:46:20.99,0,,
2020,8,2911,435,9,7816,13,7,2,18,0,0,0,0,0,0,False,False,False,0,3,2020-11-06T14:30:30.987,0,,
2020,8,2911,470,24,6808,2,50,5,-1,4,5,3,1,3,0,False,False,False,0,2,2020-11-02T14:05:38.333,4,,
2020,8,2911,475,24,6808,13,19,2,22,0,0,0,0,0,0,False,False,False,0,2,2020-11-02T14:07:40.783,0,,
2020,8,2911,485,24,7798,2,46,3,1,6,5,1,5,1,0,True,False,False,1,3,2020-11-06T16:26:11.38,6,,
2020,8,2911,495,24,7799,13,8,7,44,0,0,0,0,0,0,False,False,False,0,2,2020-11-02T14:20:23.36,0,,
2020,8,2911,540,9,7816,2,50,9,-3,2,5,1,1,1,0,True,False,False,0,3,2020-11-02T14:36:41.493,2,,
2020,8,2911,555,24,4385,2,5,3,1,4,3,1,3,1,0,False,False,False,0,1,2020-11-02T14:41:39.57,4,,
2020,8,2911,560,24,4382,13,30,10,1,0,0,0,0,0,0,False,False,False,0,3,2020-11-02T14:44:36.877,0,,
2020,8,2911,565,24,6808,2,5,3,6,9,3,8,1,8,0,False,False,False,0,3,2020-11-06T15:50:12.097,9,,
2020,8,2911,575,24,4382,2,5,3,1,2,1,2,0,2,0,True,False,False,0,3,2020-11-02T14:52:59.873,2,,
2020,8,2911,580,24,6373,2,6,9,13,15,2,14,1,14,0,False,False,False,0,4,2020-11-06T16:17:51.333,15,,
2020,8,2911,595,24,6808,2,9,3,9,9,0,9,0,9,6,False,False,False,0,2,2020-11-02T15:00:24.647,9,,
2020,8,2911,610,9,6436,2,4,3,10,14,4,12,2,12,0,False,False,False,0,2,2020-11-02T15:09:57.987,14,,
2020,8,2911,620,9,6436,13,3,3,8,0,0,0,0,0,0,False,False,False,0,2,2020-11-02T15:12:48.217,0,,
2020,8,2911,630,9,6436,13,29,6,25,0,0,0,0,0,0,False,False,False,0,2,2020-11-02T15:19:25.067,0,,
2020,8,2911,635,9,6446,2,4,9,3,9,6,5,4,5,0,False,False,False,1,4,2020-11-02T15:21:32.073,9,,
2020,8,2911,655,9,6436,13,29,6,25,0,0,0,0,0,0,False,False,False,0,2,2020-11-02T15:26:36.503,0,,
2020,8,2911,665,9,6446,2,2,10,6,8,2,7,1,7,0,False,False,False,0,3,2020-11-06T14:30:30.987,8,,
2020,8,2911,670,9,7816,13,12,3,12,0,0,0,0,0,0,False,False,False,0,3,2020-11-02T15:32:05.44,0,,
2020,8,2911,685,24,4382,3,2,4,5,0,0,0,0,0,0,False,False,False,0,3,2020-11-02T15:37:27.19,0,,
2020,8,2911,700,9,322,2,4,10,5,5,0,5,0,5,0,False,False,False,0,3,2020-11-02T15:43:41.877,5,,
2020,8,2911,725,9,6446,2,4,9,5,7,2,6,1,6,0,False,False,False,0,4,2020-11-06T14:30:30.987,7,,
2020,8,2911,730,9,6436,2,18,3,-1,6,7,3,3,3,0,False,False,False,0,2,2020-11-06T15:12:53.113,6,,
2020,8,2911,740,9,6446,2,4,10,7,8,1,8,0,8,0,False,False,False,0,4,2020-11-06T16:22:50.613,8,,
2020,8,2911,765,9,6441,13,12,2,39,0,0,0,0,0,0,False,False,False,0,3,2021-02-17T18:20:20.923,0,,
2020,8,2911,820,24,4382,2,30,3,2,2,0,2,0,2,0,False,False,False,0,4,2020-11-02T16:38:41.843,2,,
2020,8,2911,830,24,7798,13,29,2,30,0,0,0,0,0,0,False,False,False,0,2,2020-11-02T16:40:58.377,0,,
2020,8,2911,835,9,6436,13,4,5,12,0,0,0,0,0,0,False,False,False,0,2,2020-11-02T16:42:10.67,0,,
2020,8,2911,840,9,7816,2,39,10,4,6,2,5,1,5,0,False,False,False,0,3,2020-11-02T16:43:43.063,6,,
2020,8,2911,845,9,322,3,12,9,7,0,0,0,0,0,0,False,False,False,0,2,2021-02-26T18:25:55.883,0,,
2020,8,2911,850,9,6446,2,4,10,7,15,8,12,3,12,0,False,False,False,0,3,2020-11-02T16:48:34.33,15,,
2020,8,2911,855,9,6446,2,5,5,4,6,2,6,0,6,0,False,False,False,0,3,2020-11-02T16:50:21.213,6,,
2020,8,2911,860,9,6446,13,47,5,4,0,0,0,0,0,0,False,False,False,0,3,2020-11-06T14:30:30.987,0,,
2020,8,2911,865,9,4202,2,48,9,-5,10,15,9,1,9,0,False,False,False,0,1,2020-11-02T16:54:19.327,10,,
2020,8,2911,880,9,7816,2,5,3,3,7,4,5,2,5,0,False,False,False,0,3,2020-11-02T16:59:37.87,7,,
2020,8,2911,885,9,6441,13,19,6,15,0,0,0,0,0,0,False,False,False,0,3,2020-11-06T16:26:43.963,0,,
2020,8,2911,890,9,7183,2,18,3,-1,10,11,9,1,9,0,False,False,False,0,2,2020-11-02T17:19:56.927,10,,
2020,8,2912,15,30,3823,2,5,3,7,9,2,9,0,9,0,False,False,False,0,3,2020-11-03T11:08:37.993,9,,
2020,8,2912,25,30,7268,2,5,6,19,19,0,19,0,19,0,True,False,False,0,2,2020-11-06T00:17:13.56,19,,
2020,8,2912,35,30,6414,2,47,10,-2,3,5,2,1,2,0,False,False,False,0,1,2020-11-03T11:27:25.03,3,,
2020,8,2912,40,30,2290,2,26,4,5,10,5,7,3,7,0,True,False,False,0,3,2020-11-04T18:16:31.647,10,,
2020,8,2912,45,30,793,13,29,3,12,0,0,0,0,0,0,False,False,False,0,3,2020-11-05T21:23:38.613,0,,
2020,8,2912,55,30,3823,13,12,2,18,0,0,0,0,0,0,False,False,False,0,3,2021-03-08T21:46:25.93,0,,
2020,8,2912,75,21,7090,2,5,3,6,8,2,8,0,8,0,False,False,False,0,3,2020-11-03T11:51:57.153,8,,
2020,8,2912,80,21,4422,2,13,10,3,9,6,5,4,5,0,False,False,False,0,4,2020-11-03T11:54:30.087,9,,
2020,8,2912,90,21,720,3,4,5,6,0,0,0,0,0,0,False,False,False,0,2,2020-11-03T12:07:13.813,0,,
2020,8,2912,95,21,4405,2,48,3,-6,18,24,1,17,1,0,False,False,False,0,1,2020-11-05T23:05:55.76,18,,
2020,8,2912,110,21,7090,13,19,6,28,0,0,0,0,0,0,False,False,False,0,2,2020-11-05T22:05:33.81,0,,
2020,8,2912,125,30,6414,2,4,4,3,3,0,3,0,3,0,False,True,True,0,1,2020-11-03T18:32:16.96,3,,
2020,8,2912,130,21,3680,2,34,4,-3,0,3,0,0,0,0,True,False,False,0,3,2020-11-03T12:30:25.083,0,,
2020,8,2912,135,21,7226,3,31,10,3,0,0,0,0,0,0,False,False,False,0,4,2020-11-04T23:10:52.123,0,,
2020,8,2912,145,21,2288,2,11,3,7,7,0,7,0,7,6,False,False,False,0,1,2020-11-04T23:11:53.377,7,,
2020,8,2912,160,30,7268,2,5,5,7,7,0,7,0,7,0,False,False,False,0,2,2020-11-03T12:41:02.61,7,,
2020,8,2912,175,30,3823,13,6,7,23,0,0,0,0,0,0,False,False,False,0,3,2020-11-03T18:47:16.7,0,,
2020,8,2912,185,30,6570,13,35,6,18,0,0,0,0,0,0,False,False,False,0,3,2020-11-05T22:05:48.26,0,,
2020,8,2912,200,21,4180,2,47,5,3,11,8,10,1,10,0,False,False,False,0,1,2020-11-03T12:58:42.16,11,,
2020,8,2912,210,21,3680,2,5,5,4,5,1,5,0,5,0,False,False,False,0,3,2020-11-03T13:03:31.793,5,,
2020,8,2912,220,21,7090,13,9,2,22,0,0,0,0,0,0,False,False,False,0,2,2020-11-04T23:12:21.013,0,,
2020,8,2912,235,21,3680,2,4,5,7,12,5,10,2,10,0,False,False,False,0,2,2020-11-03T18:35:04.23,12,,
2020,8,2912,250,21,7090,13,8,1,33,0,0,0,0,0,0,False,False,False,0,3,2020-11-03T18:52:04.927,0,,
2020,8,2912,275,30,4937,3,44,3,1,0,0,0,0,0,0,False,False,False,0,1,2020-11-03T18:50:22.827,0,,
2020,8,2912,280,30,793,2,5,10,10,14,4,14,0,14,0,False,False,False,0,3,2020-11-03T13:36:04.013,14,,
2020,8,2912,285,30,4937,2,48,9,-1,3,4,3,0,3,0,False,False,False,0,1,2021-02-17T17:58:18.167,3,,
2020,8,2912,290,30,7268,2,5,3,9,9,0,9,0,9,0,False,False,False,0,2,2021-02-17T17:58:57.313,9,,
2020,8,2912,305,30,3823,2,34,4,-3,2,5,-1,3,-1,0,True,False,False,0,3,2020-11-03T13:51:15.01,2,,
2020,8,2912,310,30,793,13,7,6,38,0,0,0,0,0,0,False,False,False,0,3,2020-11-03T13:53:54.543,0,,
2020,8,2912,315,30,3823,3,46,3,5,0,0,0,0,0,0,False,False,False,0,3,2020-11-03T13:55:50.027,0,,
2020,8,2912,330,21,7090,2,2,9,7,14,7,12,2,12,0,False,False,False,0,2,2020-11-03T14:00:30.817,14,,
2020,8,2912,340,21,7090,2,49,9,-3,11,14,11,0,11,0,False,False,False,0,2,2020-11-05T23:17:03.953,11,,
2020,8,2912,345,21,7090,13,6,10,5,0,0,0,0,0,0,False,False,False,0,2,2020-11-05T22:14:15.267,0,,
2020,8,2912,350,21,3680,2,2,9,9,11,2,11,0,11,0,False,False,False,0,2,2020-11-03T18:35:42.643,11,,
2020,8,2912,370,21,4422,13,47,5,2,0,0,0,0,0,0,True,False,False,0,3,2020-11-05T23:30:44.94,0,,
2020,8,2912,375,21,4422,2,46,3,2,12,10,7,5,7,0,True,False,False,0,1,2020-11-05T21:04:25.923,12,,
2020,8,2912,395,30,4937,2,4,10,1,8,7,8,0,8,0,False,False,False,0,1,2020-11-03T14:26:03.513,8,,
2020,8,2912,400,30,3823,2,6,9,8,9,1,8,1,8,0,False,False,False,0,3,2020-11-03T14:27:52.917,9,,
2020,8,2912,405,30,7893,2,6,1,15,15,0,15,0,15,0,False,False,False,0,2,2020-11-03T14:29:35.353,15,,
2020,8,2912,415,30,793,2,4,4,10,12,2,10,2,10,0,False,False,False,0,3,2020-11-03T18:59:13.09,12,,
2020,8,2912,420,30,4937,13,48,10,-2,0,0,0,0,0,0,False,False,False,0,1,2020-11-05T21:54:14.353,0,,
2020,8,2912,425,30,4937,2,46,9,0,8,8,8,0,8,0,False,False,False,0,1,2021-01-12T23:40:51.083,8,,
2020,8,2912,435,30,793,2,5,10,1,1,0,1,0,1,0,False,False,False,0,3,2020-11-03T14:38:22.297,1,,
2020,8,2912,480,21,3680,13,9,2,15,0,0,0,0,0,0,False,False,False,0,2,2021-03-09T19:59:55.427,0,,
2020,8,2912,485,30,6414,2,28,10,-2,9,11,5,4,5,0,False,False,False,0,1,2020-11-04T18:17:34.36,9,,
2020,8,2912,495,30,7268,13,11,6,23,0,0,0,0,0,0,False,False,False,0,3,2020-11-03T14:54:14.297,0,,
2020,8,2912,500,30,6414,2,31,5,3,8,5,8,0,8,0,False,False,False,0,1,2020-11-03T15:01:03.963,8,,
2020,8,2912,505,30,4937,13,5,5,3,0,0,0,0,0,0,False,False,False,0,3,2020-11-05T22:06:00.26,0,,
2020,8,2912,510,30,3823,2,12,5,8,8,0,8,0,8,0,False,False,False,0,3,2020-11-03T15:07:34.593,8,,
2020,8,2912,515,30,63,2,32,5,-3,4,7,0,4,0,0,False,False,False,0,4,2020-11-05T21:23:38.613,4,,
2020,8,2912,525,30,7268,13,12,9,6,0,0,0,0,0,0,False,False,False,0,3,2021-01-12T23:41:27.933,0,,
2020,8,2912,545,21,7226,2,53,10,-5,6,11,-4,10,-4,0,False,False,False,1,4,2020-11-05T22:32:57.483,6,,
2020,8,2912,550,21,3680,13,20,6,30,0,0,0,0,0,0,False,False,False,0,2,2020-11-04T23:13:33.683,0,,
2020,8,2912,570,30,63,2,17,4,10,16,6,13,3,13,0,False,False,False,0,4,2020-11-05T22:15:53.84,16,,
2020,8,2912,575,30,793,2,4,9,14,20,6,17,3,17,0,False,False,False,1,2,2020-11-05T21:02:34.56,20,,
2020,8,2912,580,30,3823,13,21,2,17,0,0,0,0,0,0,False,False,False,0,2,2020-11-03T15:48:28.613,0,,
2020,8,2912,585,30,63,2,2,4,3,3,0,3,0,3,6,False,False,False,0,4,2020-11-05T21:53:45.243,3,,
2020,8,2912,605,21,4422,2,13,9,3,10,7,6,4,6,0,False,False,False,0,4,2020-11-05T22:33:31.817,10,,
2020,8,2912,610,21,3680,2,54,3,-3,15,18,8,7,8,0,True,False,False,0,3,2020-11-04T23:25:37.11,15,,
2020,8,2912,615,21,4422,2,46,3,1,4,3,2,2,2,0,True,False,False,0,4,2020-11-04T23:26:05.393,4,,
2020,8,2912,625,21,7090,2,2,10,11,11,0,11,0,11,0,False,False,False,0,2,2020-11-03T16:09:52.977,11,,
2020,8,2912,630,21,4422,2,9,2,26,30,4,30,0,30,0,False,False,False,0,4,2020-11-03T19:03:11.497,30,,
2020,8,2912,640,21,720,2,5,10,5,9,4,5,4,5,0,False,False,False,0,4,2020-11-03T16:18:35.75,9,,
2020,8,2912,645,21,4422,13,46,3,3,0,0,0,0,0,0,False,False,False,0,4,2020-11-03T16:20:40.287,0,,
2020,8,2912,650,21,2288,2,50,5,-4,1,5,1,0,1,0,True,False,False,1,3,2021-02-17T18:06:40.353,1,,
2020,8,2912,675,30,7268,13,19,6,32,0,0,0,0,0,0,False,False,False,0,2,2021-02-17T18:07:25.233,0,,
2020,8,2912,695,21,7090,13,6,6,24,0,0,0,0,0,0,False,False,False,0,3,2020-11-05T22:09:45.343,0,,
2020,8,2912,700,21,576,2,2,4,7,12,5,8,4,8,0,False,False,False,0,3,2020-11-05T22:09:55.62,12,,
2020,8,2912,710,21,576,13,12,5,0,0,0,0,0,0,0,False,False,False,0,3,2021-03-05T14:24:47.177,0,,
2020,8,2912,725,30,3823,2,5,5,5,8,3,6,2,6,0,False,False,False,0,3,2020-11-03T16:53:02.39,8,,
2020,8,2912,735,30,7893,2,17,7,20,20,0,20,0,20,0,False,False,False,0,3,2020-11-03T19:03:52.703,20,,
2020,8,2912,740,30,2290,2,5,2,17,25,8,25,0,25,0,False,False,False,0,4,2021-02-17T18:10:03.307,25,,
2020,8,2912,745,30,793,2,9,5,8,8,0,8,0,8,6,False,False,False,0,2,2020-11-05T22:17:14.85,8,,
2020,8,2912,770,21,3680,2,26,5,0,1,1,1,0,1,0,False,False,False,0,3,2020-11-03T17:10:01.91,1,,
2020,8,2912,785,30,63,2,12,1,15,18,3,15,3,15,0,False,False,False,0,4,2020-11-03T17:14:41.733,18,,
2020,8,2912,800,30,793,13,9,2,15,0,0,0,0,0,0,False,False,False,0,3,2020-11-05T22:06:27.853,0,,
2020,8,2912,845,21,4422,13,39,4,5,0,0,0,0,0,0,False,False,False,0,3,2020-11-04T23:14:24.53,0,,
2020,8,2912,855,21,4422,2,13,9,6,6,0,6,0,6,0,False,False,False,0,3,2020-11-03T17:30:58.283,6,,
2020,8,2912,860,21,7090,2,12,5,2,12,10,2,10,2,0,False,False,False,1,2,2020-11-05T22:33:17.567,12,,
2020,8,2912,865,21,4422,13,17,10,11,0,0,0,0,0,0,False,False,False,0,3,2020-11-03T17:37:08.703,0,,
2020,8,2912,885,21,2288,13,46,3,1,0,0,0,0,0,0,False,False,False,0,1,2020-11-03T17:41:27.783,0,,
2020,8,2912,895,21,4422,13,5,5,9,0,0,0,0,0,0,False,False,False,0,3,2020-11-03T17:44:25.207,0,,
2020,8,2912,900,21,3680,2,12,8,18,20,2,20,0,20,0,False,False,False,0,3,2020-11-04T23:14:35.963,20,,
2020,8,2912,905,21,3680,2,4,5,10,10,0,10,0,10,0,False,False,False,0,2,2020-11-04T15:57:59.34,10,,
2020,8,2912,915,21,576,2,17,7,19,19,0,19,0,19,6,False,False,False,0,3,2020-11-03T17:52:02.67,19,,
2020,9,2913,10,12,4537,2,46,3,0,5,5,4,1,4,0,False,False,False,0,1,2020-11-06T14:18:58.477,5,,1.0
2020,9,2913,25,12,4537,2,48,10,-3,15,18,12,3,12,0,False,False,False,1,1,2020-11-06T14:23:34.207,15,,3.0
2020,9,2913,35,12,556,2,19,6,36,36,0,36,0,36,6,False,False,False,0,2,2020-11-06T17:49:42.643,36,,0.0
2020,9,2913,50,28,6360,2,5,3,3,6,3,4,2,4,0,False,False,False,0,3,2020-11-06T14:29:09.303,6,,2.0
2020,9,2913,55,28,6360,13,7,6,35,0,0,0,0,0,0,False,False,False,0,3,2020-11-06T14:30:37.053,0,,0.0
2020,9,2913,65,28,969,2,39,4,3,3,0,3,0,3,0,False,False,False,0,4,2020-11-06T14:32:46.643,3,,0.0
2020,9,2913,85,12,556,2,4,3,6,11,5,9,2,9,0,False,False,False,1,2,2020-11-06T17:50:04.283,11,,2.0
2020,9,2913,90,12,556,13,12,2,18,0,0,0,0,0,0,True,False,False,0,3,2020-11-06T18:06:41.63,0,,0.0
2020,9,2913,95,12,4511,2,2,4,4,5,1,5,0,5,0,False,False,False,0,3,2020-11-07T17:48:28.15,5,,0.0
2020,9,2913,100,12,556,13,9,6,24,0,0,0,0,0,0,False,False,False,0,3,2020-11-13T16:55:29.353,0,,0.0
2020,9,2913,115,28,6360,2,6,7,19,43,24,36,7,36,0,False,False,False,0,3,2020-11-06T14:46:52.513,43,,7.0
2020,9,2913,130,28,262,2,30,10,-3,4,7,2,2,2,0,False,False,False,0,4,2020-11-06T14:50:35.753,4,,2.0
2020,9,2913,155,28,6360,2,55,4,-4,5,9,3,2,3,0,True,False,False,0,4,2021-03-04T16:00:58.227,5,,2.0
2020,9,2913,165,28,5199,13,7,3,4,0,0,0,0,0,0,False,False,False,0,2,2020-11-06T15:01:17.963,0,,0.0
2020,9,2913,185,12,556,2,5,10,4,4,0,4,0,4,0,False,False,False,0,3,2020-11-06T15:04:46.513,4,,0.0
2020,9,2913,195,12,6357,3,13,5,4,0,0,0,0,0,0,False,False,False,0,3,2020-11-06T15:07:13.423,0,,0.0
2020,9,2913,215,28,6360,2,6,1,17,18,1,18,0,18,0,True,False,False,0,3,2020-11-13T14:58:24.743,18,,0.0
2020,9,2913,230,28,5199,13,6,10,14,0,0,0,0,0,0,False,False,False,0,2,2020-11-06T15:16:40.853,0,,0.0
2020,9,2913,235,28,797,13,46,3,5,0,0,0,0,0,0,False,False,False,0,1,2021-03-05T14:28:10.237,0,,0.0
2020,9,2913,240,12,3965,13,44,9,-6,0,0,0,0,0,0,True,False,False,0,3,2020-11-06T15:19:15.493,0,,0.0
2020,9,2913,255,12,4537,2,48,10,-4,-4,0,-4,0,-4,0,False,False,False,0,1,2020-11-06T15:23:38.103,-4,,0.0
2020,9,2913,260,12,3965,2,13,5,6,7,1,7,0,7,0,False,False,False,0,3,2020-11-06T15:26:07.233,7,,0.0
2020,9,2913,270,12,556,2,46,3,2,4,2,2,2,2,0,False,False,False,0,3,2020-11-06T15:28:12.713,4,,2.0
2020,9,2913,285,12,556,13,9,5,9,0,0,0,0,0,0,False,False,False,0,2,2020-11-06T15:32:51.853,0,,
2020,9,2913,290,12,467,2,32,5,1,1,0,1,0,1,6,False,False,False,0,4,2020-11-13T17:01:19.813,1,,0.0
2020,9,2913,310,28,7751,2,28,9,-1,3,4,2,1,2,0,False,False,False,0,1,2020-11-06T15:41:14.313,3,,1.0
2020,9,2913,315,28,969,13,6,4,10,0,0,0,0,0,0,False,False,False,0,3,2020-11-07T17:53:52.513,0,,0.0
2020,9,2913,325,12,6357,13,5,5,5,0,0,0,0,0,0,False,False,False,0,3,2020-11-06T15:45:05.943,0,,0.0
2020,9,2913,335,12,556,13,4,5,10,0,0,0,0,0,0,False,False,False,0,2,2021-03-05T14:28:33.37,0,,
2020,9,2913,350,12,4537,2,4,9,0,2,2,1,1,1,0,False,False,False,0,1,2020-11-13T17:01:32.86,2,,1.0
2020,9,2913,365,12,3965,2,44,3,3,11,8,9,2,9,0,True,False,False,0,3,2020-11-06T15:55:22.017,11,,2.0
2020,9,2913,375,12,6357,2,23,1,50,52,2,52,0,52,6,False,False,False,0,3,2020-11-06T15:58:13.41,52,,0.0
2020,9,2913,390,28,6360,13,8,1,33,0,0,0,0,0,0,False,False,False,0,3,2021-03-15T16:28:17.523,0,,0.0
2020,9,2913,395,28,5199,2,4,5,5,5,0,5,0,5,0,False,False,False,0,2,2020-11-06T16:02:09.497,5,,0.0
2020,9,2913,405,28,6360,3,6,9,6,0,0,0,0,0,0,False,False,False,0,2,2020-11-06T16:03:21.71,0,,0.0
2020,9,2913,430,28,6360,13,2,9,7,0,0,0,0,0,0,False,False,False,0,3,2020-11-13T17:01:48.477,0,,0.0
2020,9,2913,435,28,6627,13,26,9,5,0,0,0,0,0,0,False,False,False,0,4,2020-11-07T17:57:35.163,0,,
2020,9,2913,445,28,6627,2,5,9,3,6,3,5,1,5,0,False,False,False,0,4,2020-11-06T16:14:16.287,6,,1.0
2020,9,2913,450,28,4932,13,26,5,6,0,0,0,0,0,0,False,False,False,0,3,2020-11-06T16:15:53.757,0,,0.0
2020,9,2913,470,12,556,2,21,6,34,49,15,49,0,49,0,False,False,False,0,2,2020-11-06T16:19:45.767,49,,0.0
2020,9,2913,480,12,4537,2,4,9,3,3,0,3,0,3,0,False,False,False,0,1,2020-11-06T17:52:01.08,3,,0.0
2020,9,2913,485,12,556,2,47,5,5,11,6,11,0,11,0,False,False,False,0,3,2021-03-15T16:28:27.877,11,,0.0
2020,9,2913,490,12,6876,2,46,3,2,1,-1,1,0,1,0,False,False,False,0,2,2020-11-13T16:55:46.623,1,,0.0
2020,9,2913,495,12,556,2,51,3,1,8,7,6,2,6,0,True,False,False,0,3,2020-11-06T16:26:47.25,8,,2.0
2020,9,2913,500,12,6357,2,12,5,1,1,0,1,0,1,6,False,False,False,0,2,2020-11-06T16:27:54.17,1,,0.0
2020,9,2913,525,28,797,2,5,3,1,1,0,1,0,1,0,False,False,False,0,1,2020-11-07T17:57:52.587,1,,0.0
2020,9,2913,535,12,3965,2,48,10,-4,24,28,20,4,20,0,False,False,False,1,1,2020-11-06T16:38:05.1,24,,4.0
2020,9,2913,540,12,556,2,49,3,-3,9,12,7,2,7,0,False,False,False,0,2,2020-11-13T14:53:36.353,9,,2.0
2020,9,2913,550,12,556,2,51,10,2,7,5,7,0,7,0,False,False,False,0,3,2021-03-04T16:01:41.973,7,,0.0
2020,9,2913,585,28,6360,2,50,9,-1,47,48,41,6,41,0,True,False,False,0,2,2020-11-06T16:49:38.61,47,,6.0
2020,9,2913,595,28,6627,2,39,4,5,10,5,7,3,7,0,False,False,False,0,4,2020-11-06T16:51:54.553,10,,3.0
2020,9,2913,605,28,4932,3,2,10,7,0,0,0,0,0,0,False,False,False,0,3,2020-11-06T16:53:19.72,0,,0.0
2020,9,2913,610,28,6360,2,50,9,-5,9,14,7,2,7,0,False,False,False,0,3,2020-11-06T16:55:00.2,9,,2.0
2020,9,2913,625,12,6869,2,51,9,-2,3,5,2,1,2,0,False,False,False,0,3,2020-11-06T16:58:32.47,3,,1.0
2020,9,2913,630,12,556,2,9,2,26,34,8,34,0,34,0,False,False,False,0,3,2020-11-13T17:02:15.497,34,,0.0
2020,9,2913,660,12,3965,2,5,5,6,6,0,6,0,6,0,True,False,False,0,2,2020-11-13T16:56:04.853,6,,0.0
2020,9,2913,695,28,6627,2,17,7,19,36,17,34,2,34,0,False,False,False,0,4,2020-11-06T17:15:34.067,36,,2.0
2020,9,2913,700,28,5199,13,36,10,10,0,0,0,0,0,0,False,False,False,0,3,2020-11-06T17:18:26.24,0,,0.0
2020,9,2913,710,28,6360,2,9,2,22,41,19,41,0,41,6,False,False,False,1,3,2020-11-06T17:20:38.09,41,,0.0
2020,9,2913,745,28,797,2,50,5,-3,8,11,7,1,7,0,True,False,False,0,2,2020-11-06T17:26:25.643,8,,1.0
2020,9,2913,760,28,6360,2,2,10,5,11,6,9,2,9,0,False,False,False,0,3,2020-11-06T17:28:36.833,11,,2.0
2020,9,2913,765,28,7751,2,48,9,-7,7,14,6,1,6,0,False,False,False,0,1,2020-11-06T17:30:31.907,7,,1.0
2020,9,2913,770,28,4932,2,6,4,7,9,2,9,0,9,0,False,False,False,0,3,2020-11-06T17:31:32.497,9,,0.0
2020,9,2913,780,28,6360,2,50,10,-5,4,9,4,0,4,0,False,False,False,1,3,2020-11-13T16:57:24.783,4,,0.0
2020,9,2913,790,28,5199,2,2,9,7,8,1,8,0,8,0,False,False,False,0,2,2020-11-06T17:34:43.913,8,,0.0
2020,9,2913,795,28,4932,13,12,10,5,0,0,0,0,0,0,False,False,False,0,3,2020-11-06T17:35:32.387,0,,0.0
2020,9,2913,800,28,797,2,47,5,2,7,5,5,2,5,0,True,False,False,0,1,2020-11-06T17:36:51.557,7,,2.0
2020,9,2914,10,2,5214,2,46,3,6,11,5,11,0,11,0,False,False,False,0,4,2020-11-09T17:20:24.693,11,,0.0
2020,9,2914,20,2,661,2,5,3,5,5,0,5,0,5,0,False,False,False,0,3,2020-11-09T11:19:35.597,5,,0.0
2020,9,2914,25,2,7303,2,2,4,4,5,1,5,0,5,0,False,False,False,0,2,2020-11-09T11:21:21.613,5,,0.0
2020,9,2914,40,2,990,2,45,5,-4,-4,0,-4,0,-4,0,False,False,False,0,1,2020-11-13T19:07:36.933,-4,,0.0
2020,9,2914,45,2,5214,2,53,10,-3,7,10,5,2,5,0,True,False,False,0,4,2020-11-09T17:20:38.62,7,,2.0
2020,9,2914,50,2,661,13,2,10,1,0,0,0,0,0,0,False,False,False,0,2,2020-11-09T11:31:07.747,0,,0.0
2020,9,2914,70,10,6840,2,46,3,4,32,28,4,28,4,0,True,False,False,1,4,2020-11-13T19:11:06.013,32,,28.0
2020,9,2914,85,10,6285,2,13,10,3,9,6,8,1,8,0,False,False,False,0,3,2020-11-09T11:45:38.857,9,,1.0
2020,9,2914,110,2,6247,2,5,3,7,8,1,8,0,8,0,False,False,False,0,3,2020-11-09T11:50:13.443,8,,0.0
2020,9,2914,115,2,661,2,5,5,6,6,0,6,0,6,0,False,False,False,0,2,2020-11-13T19:08:51.793,6,,0.0
2020,9,2914,120,2,6247,2,50,9,0,3,3,1,2,1,0,False,False,False,0,2,2020-11-13T19:09:07.347,3,,2.0
2020,9,2914,150,2,661,13,13,4,-4,0,0,0,0,0,0,False,False,False,0,3,2020-11-09T12:01:26.977,0,,0.0
2020,9,2914,155,2,7303,2,19,8,51,51,0,51,0,51,6,False,False,False,0,2,2020-11-09T12:05:16.907,51,,0.0
2020,9,2914,170,10,7700,2,35,5,14,18,4,17,1,17,0,False,False,False,0,3,2021-02-25T15:22:59.67,18,,1.0
2020,9,2914,180,10,7701,2,2,10,12,14,2,12,2,12,0,False,False,False,0,3,2020-11-09T12:13:31.927,14,,2.0
2020,9,2914,200,10,7700,13,9,2,21,0,0,0,0,0,0,False,False,False,0,2,2020-11-10T22:23:07.557,0,,0.0
2020,9,2914,205,10,6481,13,12,10,7,0,0,0,0,0,0,False,False,False,0,2,2021-02-18T19:49:23.197,0,,0.0
2020,9,2914,210,10,4930,13,7,2,25,0,0,0,0,0,0,False,False,False,0,3,2020-11-13T19:15:01.593,0,,0.0
2020,9,2914,225,2,6247,13,31,4,12,0,0,0,0,0,0,False,False,False,0,3,2020-11-13T19:09:24.287,0,,0.0
2020,9,2914,230,2,6240,2,5,5,7,7,0,7,0,7,0,False,False,False,0,3,2020-11-13T19:08:00.01,7,,0.0
2020,9,2914,235,2,7303,2,4,9,5,5,0,5,0,5,0,False,False,False,0,3,2020-11-13T19:18:59.207,5,,0.0
2020,9,2914,240,2,661,2,39,9,6,11,5,8,3,8,0,False,False,False,0,3,2020-11-09T12:29:06.86,11,,3.0
2020,9,2914,250,2,7303,2,12,2,31,42,11,37,5,37,0,False,False,False,0,2,2020-11-11T15:08:29.32,42,,5.0
2020,9,2914,255,2,6247,13,8,9,13,0,0,0,0,0,0,False,False,False,0,2,2020-11-13T19:09:37.033,0,,0.0
2020,9,2914,265,2,6342,2,5,5,8,9,1,8,1,8,6,False,False,False,0,3,2020-11-10T17:05:47.56,9,,1.0
2020,9,2914,290,10,282,2,44,3,5,9,4,9,0,9,0,False,False,False,0,1,2020-11-09T12:51:50.717,9,,0.0
2020,9,2914,305,2,5214,2,30,5,-3,6,9,3,3,3,0,False,False,False,0,4,2020-11-13T19:20:20.05,6,,3.0
2020,9,2914,310,2,2223,2,12,10,1,12,11,8,4,8,0,False,False,False,0,4,2021-03-08T19:58:30.693,12,,4.0
2020,9,2914,325,2,661,13,4,2,15,0,0,0,0,0,0,False,False,False,0,2,2020-11-09T13:01:05.443,0,,
2020,9,2914,330,2,661,2,4,5,5,11,6,5,6,5,0,False,False,False,1,2,2020-11-09T13:03:48.79,11,,6.0
2020,9,2914,340,2,6240,2,7,2,21,21,0,21,0,21,0,False,False,False,0,2,2020-11-13T19:21:07.067,21,,0.0
2020,9,2914,355,2,7303,13,4,9,5,0,0,0,0,0,0,False,False,False,0,2,2021-03-15T16:37:31.08,0,,0.0
2020,9,2914,380,10,4930,2,2,10,7,7,0,7,0,7,0,False,False,False,0,2,2020-11-09T17:19:11.513,7,,0.0
2020,9,2914,390,10,7701,2,2,10,4,9,5,8,1,8,0,False,False,False,0,3,2020-11-09T13:19:40.03,9,,1.0
2020,9,2914,395,10,7701,3,2,4,6,0,0,0,0,0,0,False,False,False,0,3,2020-11-10T11:29:03.55,0,,0.0
2020,9,2914,410,10,4930,13,26,9,1,0,0,0,0,0,0,False,False,False,0,2,2020-11-09T13:24:28.093,0,,0.0
2020,9,2914,435,10,7700,2,35,10,11,12,1,12,0,12,0,False,True,False,0,3,2020-11-09T17:27:36.323,12,False,0.0
2020,9,2914,445,10,7700,13,7,6,26,0,0,0,0,0,0,False,False,False,0,3,2020-11-10T22:24:39.333,0,,
2020,9,2914,460,10,4930,2,13,10,5,9,4,7,2,7,0,False,False,False,0,3,2020-11-13T19:23:15.377,9,,2.0
2020,9,2914,465,10,4930,3,19,6,25,0,0,0,0,0,0,False,False,False,0,2,2020-11-10T22:24:50.683,0,,0.0
2020,9,2914,475,10,4930,13,13,10,3,0,0,0,0,0,0,False,False,False,0,3,2020-11-09T13:49:13.907,0,,0.0
2020,9,2914,490,2,7303,13,19,7,50,0,0,0,0,0,0,False,False,False,0,3,2021-03-05T14:30:23.267,0,,0.0
2020,9,2914,495,10,7700,13,6,9,-3,0,0,0,0,0,0,False,False,False,0,2,2021-03-15T16:38:33.85,0,,0.0
2020,9,2914,500,10,7700,2,5,3,5,3,-2,3,0,3,0,False,False,False,0,3,2020-11-13T19:25:25.717,3,,0.0
2020,9,2914,520,2,990,2,48,4,-3,6,9,2,4,2,0,True,False,False,0,1,2020-11-09T14:20:14.73,6,,4.0
2020,9,2914,530,2,5214,2,30,9,-2,-2,0,-2,0,-2,0,False,False,False,0,4,2020-11-09T14:48:18.917,-2,,
2020,9,2914,545,2,661,2,22,7,21,21,0,21,0,21,6,False,False,False,0,2,2020-11-09T14:52:28.123,21,,0.0
2020,9,2914,560,10,7701,13,47,5,1,0,0,0,0,0,0,False,False,False,0,3,2020-11-09T14:55:21.48,0,,0.0
2020,9,2914,570,10,7703,2,4,10,4,7,3,6,1,6,0,False,False,False,1,4,2020-11-09T14:58:32.767,7,,1.0
2020,9,2914,585,10,6840,2,31,10,2,2,0,2,0,2,0,False,False,False,0,4,2020-11-09T15:04:49.67,2,,0.0
2020,9,2914,605,2,6247,13,9,2,20,0,0,0,0,0,0,False,False,False,0,3,2021-02-18T19:50:37.953,0,,0.0
2020,9,2914,615,10,6481,3,44,3,-4,0,0,0,0,0,0,False,False,False,0,1,2021-02-18T19:51:21.237,0,,0.0
2020,9,2914,625,10,7700,2,4,10,5,7,2,5,2,5,0,False,False,False,0,3,2020-11-09T15:15:36.47,7,,2.0
2020,9,2914,630,10,7700,2,35,2,15,24,9,24,0,24,0,False,False,False,0,3,2020-11-09T15:17:11.033,24,,0.0
2020,9,2914,650,10,6285,2,4,9,3,3,0,3,0,3,0,False,False,False,0,3,2020-11-09T15:21:00.43,3,,0.0
2020,9,2914,655,10,7700,3,35,10,10,0,0,0,0,0,0,False,False,False,0,3,2021-02-18T19:52:00.45,0,,0.0
2020,9,2914,665,10,7700,2,4,5,14,20,6,16,4,16,6,False,False,False,1,2,2020-11-13T19:11:44.683,20,,4.0
2020,9,2914,680,2,5214,2,46,3,5,10,5,9,1,9,0,False,False,False,0,4,2020-11-09T15:34:26.313,10,,1.0
2020,9,2914,690,2,5214,2,17,1,22,24,2,22,2,22,0,False,False,False,0,3,2020-11-09T15:37:03.217,24,,2.0
2020,9,2914,705,2,6247,13,5,2,23,0,0,0,0,0,0,False,False,False,0,2,2020-11-13T17:51:05.427,0,,0.0
2020,9,2914,715,10,7700,13,6,8,16,0,0,0,0,0,0,False,False,False,0,3,2020-11-09T15:44:51.483,0,,0.0
2020,9,2914,720,2,5214,2,30,5,-1,8,9,6,2,6,0,False,False,False,0,4,2020-11-09T15:49:30.437,8,,2.0
2020,9,2914,740,10,7701,2,5,9,14,36,22,31,5,31,0,False,False,False,1,3,2020-11-13T19:16:00.797,36,,5.0
2020,9,2914,745,10,7701,13,5,2,17,0,0,0,0,0,0,False,False,False,0,3,2020-11-13T17:51:05.427,0,,0.0
2020,9,2914,750,10,7701,2,4,9,4,4,0,4,0,4,0,False,False,False,0,3,2020-11-09T15:58:38.377,4,,0.0
2020,9,2914,755,10,4930,13,9,2,24,0,0,0,0,0,0,False,False,False,0,2,2020-11-13T19:10:16.973,0,,0.0
2020,9,2914,760,10,7701,13,12,2,35,0,0,0,0,0,0,False,False,False,0,3,2021-03-08T19:59:06.46,0,,0.0
2020,9,2914,770,2,5214,2,50,4,-4,-4,0,-4,0,-4,0,False,False,False,0,4,2020-11-13T19:06:23.337,-4,,0.0
2020,9,2914,775,2,4670,3,4,4,2,0,0,0,0,0,0,False,False,False,0,1,2020-11-09T16:05:56.763,0,,0.0
2020,9,2914,790,10,6840,2,39,4,5,11,6,5,6,5,0,False,False,False,1,4,2020-11-13T17:51:05.427,11,,6.0
2020,9,2914,795,10,7700,13,4,3,13,0,0,0,0,0,0,False,False,False,0,2,2020-11-09T16:13:49.957,0,,
2020,9,2914,800,10,7702,13,4,10,3,0,0,0,0,0,0,False,False,False,0,2,2020-11-09T16:17:09.447,0,,0.0
2020,9,2914,805,10,3848,2,4,4,6,11,5,6,5,6,0,False,False,False,0,3,2020-11-09T16:19:05.623,11,,5.0
2020,9,2914,810,10,7700,13,29,6,17,0,0,0,0,0,0,False,False,False,0,2,2020-11-09T16:20:30.297,0,,0.0
2020,9,2914,820,10,4930,2,8,9,8,9,1,9,0,9,6,False,False,False,0,3,2021-02-25T15:24:55.51,9,,0.0
2020,9,2914,845,2,6240,2,30,5,-1,3,4,2,1,2,0,True,False,False,0,3,2020-11-13T19:10:39.893,3,,1.0
2020,9,2914,855,2,5214,13,12,7,20,0,0,0,0,0,0,False,False,False,1,4,2020-11-13T19:11:56.367,0,,0.0
2020,9,2914,870,10,7701,2,47,5,2,3,1,3,0,3,0,False,False,False,0,3,2020-11-09T16:37:09.343,3,,0.0
2020,9,2914,875,10,7701,2,2,9,6,9,3,9,0,9,0,False,False,False,0,3,2020-11-09T16:39:38.667,9,,0.0
2020,9,2914,880,10,7700,2,19,6,31,41,10,41,0,41,0,False,False,False,0,2,2020-11-10T22:25:09.87,41,,0.0
2020,9,2914,885,10,4930,2,18,5,-1,4,5,3,1,3,0,False,False,False,0,2,2020-11-09T16:57:33.963,4,,1.0
2020,9,2914,935,10,7700,13,6,1,21,0,0,0,0,0,0,False,False,False,0,2,2020-11-09T17:08:31.17,0,,0.0
2020,9,2914,940,10,6481,3,12,10,5,0,0,0,0,0,0,False,False,False,0,1,2021-03-08T19:59:33.297,0,,0.0
2020,9,2914,945,10,7700,13,19,7,20,0,0,0,0,0,0,False,False,False,0,3,2021-03-09T20:03:50.17,0,,0.0
2020,9,2915,10,4,6983,2,4,5,4,6,2,6,0,6,0,False,False,False,0,2,2020-11-09T10:57:54.123,6,,0.0
2020,9,2915,15,4,2853,2,13,9,1,14,13,7,7,7,0,False,False,False,1,3,2020-11-13T22:30:50.48,14,,7.0
2020,9,2915,20,4,5119,2,35,7,24,25,1,25,0,25,6,False,False,False,0,3,2020-11-09T11:01:39.827,25,,0.0
2020,9,2915,35,27,4835,13,47,5,1,0,0,0,0,0,0,False,False,False,0,4,2020-11-09T11:05:12.937,0,,0.0
2020,9,2915,40,27,7850,2,45,5,-3,5,8,4,1,4,0,True,False,False,0,1,2020-11-09T11:07:08.8,5,,1.0
2020,9,2915,50,27,5069,13,5,5,6,0,0,0,0,0,0,True,False,False,0,2,2020-11-09T11:08:52.173,0,,0.0
2020,9,2915,60,4,7646,2,24,5,12,15,3,14,1,14,0,False,False,False,0,3,2020-11-09T11:14:51.797,15,,1.0
2020,9,2915,65,4,7646,13,13,3,5,0,0,0,0,0,0,False,False,False,0,3,2021-02-18T15:02:33.517,0,,0.0
2020,9,2915,75,4,1412,2,5,5,10,13,3,13,0,13,0,False,False,False,0,3,2020-11-10T17:59:30.113,13,,0.0
2020,9,2915,80,4,594,2,4,9,5,9,4,9,0,9,0,False,False,False,0,3,2020-11-09T11:18:42.57,9,,0.0
2020,9,2915,85,4,594,2,4,4,5,7,2,6,1,6,0,False,False,False,0,3,2020-11-10T18:03:40.717,7,,1.0
2020,9,2915,95,4,6983,2,28,4,3,22,19,21,1,21,0,False,False,False,0,1,2020-11-10T17:58:20.753,22,,1.0
2020,9,2915,105,4,6983,2,44,9,-6,5,11,3,2,3,0,False,False,False,0,1,2020-11-09T11:27:43.263,5,,2.0
2020,9,2915,115,4,2629,2,6,4,1,1,0,1,0,1,6,False,False,False,0,4,2020-11-10T18:00:02.873,1,,0.0
2020,9,2915,140,27,5069,2,3,5,8,8,0,8,0,8,0,False,False,False,0,2,2021-03-04T16:03:46.087,8,,0.0
2020,9,2915,145,27,7408,2,6,10,12,14,2,13,1,13,0,False,False,False,0,3,2020-11-09T11:48:07.333,14,,1.0
2020,9,2915,150,27,650,2,4,9,12,12,0,12,0,12,0,False,False,False,0,3,2020-11-09T11:50:08.317,12,,0.0
2020,9,2915,160,27,4835,2,30,9,0,1,1,0,1,0,0,False,False,False,0,4,2020-11-13T22:26:24.05,1,,1.0
2020,9,2915,165,27,505,2,4,10,5,8,3,7,1,7,0,False,False,False,0,3,2020-11-09T11:56:37.707,8,,1.0
2020,9,2915,180,27,4835,13,12,5,5,0,0,0,0,0,0,False,False,False,0,4,2020-11-09T12:01:05.477,0,,0.0
2020,9,2915,185,4,1412,2,3,6,18,18,0,18,0,18,0,False,False,False,0,2,2020-11-09T16:07:55.633,18,,0.0
2020,9,2915,190,4,2853,2,5,5,9,9,0,9,0,9,0,False,False,False,0,3,2020-11-10T18:00:31.643,9,,0.0
2020,9,2915,195,4,1412,13,21,6,33,0,0,0,0,0,0,False,False,False,0,2,2020-11-09T12:07:17.797,0,,0.0
2020,9,2915,205,4,7645,2,4,5,10,10,0,10,0,10,0,False,False,False,0,2,2020-11-13T22:26:34.09,10,,0.0
2020,9,2915,215,4,1412,2,4,10,3,5,2,4,1,4,0,False,False,False,0,3,2020-11-09T12:12:06.713,5,,1.0
2020,9,2915,220,4,7646,2,12,9,11,12,1,11,1,11,0,False,False,False,0,3,2020-11-09T12:15:14.413,12,,1.0
2020,9,2915,230,4,1412,2,46,3,0,3,3,2,1,2,0,False,False,False,0,3,2020-11-10T18:00:48.083,3,,1.0
2020,9,2915,255,27,7850,2,4,9,3,3,0,3,0,3,0,False,False,False,0,1,2020-11-09T12:25:23.157,3,,0.0
2020,9,2915,260,27,7408,13,12,6,28,0,0,0,0,0,0,False,False,False,0,2,2021-02-18T15:08:33.127,0,,
2020,9,2915,270,27,7408,2,19,6,38,41,3,40,1,40,0,False,False,False,0,2,2020-11-09T12:31:40.43,41,,1.0
2020,9,2915,280,27,650,2,2,4,6,11,5,10,1,10,0,False,False,False,0,3,2020-11-13T22:27:39.24,11,,1.0
2020,9,2915,305,4,1412,2,4,3,14,18,4,17,1,17,0,False,False,False,0,2,2020-11-10T17:58:20.753,18,,1.0
2020,9,2915,310,4,2853,2,13,10,4,21,17,17,4,17,0,False,False,False,0,3,2020-11-09T12:46:10.567,21,,4.0
2020,9,2915,315,4,2853,2,4,5,11,21,10,20,1,20,0,False,False,False,0,2,2020-11-09T12:48:12.06,21,,1.0
2020,9,2915,320,4,1412,2,13,9,1,11,10,1,10,1,0,False,False,False,2,3,2020-11-09T12:50:08.183,11,,10.0
2020,9,2915,330,4,7646,2,2,4,4,4,0,4,0,4,6,False,False,False,0,3,2020-11-10T18:03:58.407,4,,0.0
2020,9,2915,350,27,4835,2,17,10,12,16,4,14,2,14,0,False,False,False,0,3,2020-11-09T12:58:27.6,16,,2.0
2020,9,2915,365,27,4835,2,35,5,11,19,8,17,2,17,0,False,False,False,0,3,2020-11-09T13:12:45.413,19,,2.0
2020,9,2915,375,27,7408,2,18,3,0,7,7,1,6,1,0,False,False,False,0,2,2020-11-09T13:14:32.65,7,,6.0
2020,9,2915,380,27,7852,13,39,9,7,0,0,0,0,0,0,False,False,False,0,3,2020-11-09T13:16:29.417,0,,0.0
2020,9,2915,385,27,7852,13,12,2,27,0,0,0,0,0,0,False,False,False,0,2,2020-11-09T13:17:49.913,0,,0.0
2020,9,2915,400,4,1412,13,4,3,6,0,0,0,0,0,0,False,False,False,0,2,2020-11-13T22:28:40.68,0,,0.0
2020,9,2915,405,4,2853,2,47,5,1,4,3,2,2,2,0,False,False,False,0,3,2020-11-09T13:21:52.543,4,,2.0
2020,9,2915,415,4,594,2,12,2,22,23,1,22,1,22,0,False,False,False,0,3,2021-03-08T20:02:42.143,23,,1.0
2020,9,2915,420,4,2853,2,5,5,6,6,0,6,0,6,0,False,False,False,0,2,2020-11-09T13:24:47.11,6,,0.0
2020,9,2915,425,4,2853,13,4,5,11,0,0,0,0,0,0,False,False,False,0,2,2020-11-09T13:26:30.313,0,,0.0
2020,9,2915,455,27,650,13,11,6,20,0,0,0,0,0,0,True,False,False,0,3,2020-11-09T13:37:39.003,0,,0.0
2020,9,2915,460,27,7408,13,13,10,3,0,0,0,0,0,0,False,False,False,0,2,2020-11-09T13:39:06.3,0,,0.0
2020,9,2915,475,4,1412,2,5,3,1,11,10,9,2,9,0,False,False,False,0,3,2020-11-09T13:44:44.917,11,,
2020,9,2915,480,4,7646,2,7,2,20,39,19,36,3,36,0,False,False,False,0,2,2020-11-09T13:47:43.41,39,,3.0
2020,9,2915,490,4,1412,2,49,9,-2,-2,0,-2,0,-2,0,False,False,False,0,2,2020-11-09T13:50:30.383,-2,,0.0
2020,9,2915,495,4,1412,13,6,9,4,0,0,0,0,0,0,False,False,False,0,2,2020-11-10T18:04:09.837,0,,0.0
2020,9,2915,515,27,650,13,4,10,8,0,0,0,0,0,0,False,False,False,0,3,2020-11-09T13:56:10.707,0,,0.0
2020,9,2915,520,27,5069,2,5,5,5,6,1,6,0,6,0,False,False,False,0,3,2020-11-09T13:57:32.763,6,,0.0
2020,9,2915,525,27,7408,2,6,7,15,27,12,25,2,25,0,False,False,False,0,2,2020-11-09T13:59:31.027,27,,2.0
2020,9,2915,535,27,4835,2,4,10,6,13,7,9,4,9,0,False,False,False,1,4,2021-03-03T17:05:39.693,13,,4.0
2020,9,2915,540,27,7408,2,3,5,9,10,1,10,0,10,0,False,False,False,0,2,2020-11-09T14:05:51.577,10,,0.0
2020,9,2915,550,27,505,2,13,10,4,5,1,4,1,4,0,False,False,False,0,4,2020-11-09T14:09:55.813,5,,1.0
2020,9,2915,555,27,4835,2,8,10,10,11,1,10,1,10,0,False,False,False,0,3,2020-11-09T14:11:50.767,11,,1.0
2020,9,2915,595,27,6397,2,6,9,10,26,16,23,3,23,0,False,False,False,0,4,2020-11-09T14:25:38.77,26,,3.0
2020,9,2915,600,27,650,13,5,2,20,0,0,0,0,0,0,False,False,False,0,3,2020-11-09T14:28:08.693,0,,
2020,9,2915,615,27,650,13,8,6,26,0,0,0,0,0,0,False,False,False,0,3,2020-11-13T22:54:31.28,0,,0.0
2020,9,2915,630,4,7645,2,48,9,-3,20,23,20,0,20,0,False,False,False,0,1,2020-11-09T14:35:47.18,20,,0.0
2020,9,2915,640,4,2853,2,22,9,13,25,12,25,0,25,0,False,False,False,0,3,2020-11-10T17:58:20.753,25,,0.0
2020,9,2915,660,4,2853,2,5,5,11,11,0,11,0,11,0,False,False,False,0,3,2020-11-09T14:45:01.373,11,,0.0
2020,9,2915,675,4,2853,13,4,6,15,0,0,0,0,0,0,False,False,False,0,2,2020-11-09T14:50:12.217,0,,0.0
2020,9,2915,680,4,1412,2,50,5,-2,33,35,29,4,29,0,False,False,False,0,2,2020-11-09T14:52:02.053,33,,4.0
2020,9,2915,685,4,2853,13,9,5,2,0,0,0,0,0,0,False,False,False,0,3,2020-11-09T14:54:02.937,0,,
2020,9,2915,715,27,7408,13,7,2,21,0,0,0,0,0,0,False,False,False,0,3,2020-11-13T22:54:31.28,0,,0.0
2020,9,2915,735,27,650,2,39,4,8,9,1,9,0,9,0,False,False,False,0,3,2020-11-09T15:08:16.85,9,,0.0
2020,9,2915,745,27,5069,2,12,2,55,55,0,55,0,55,6,False,False,False,0,2,2021-03-08T20:02:54.28,55,,0.0
2020,9,2915,765,4,2853,13,19,6,46,0,0,0,0,0,0,False,False,False,0,2,2020-11-13T22:25:56.08,0,,0.0
2020,9,2915,770,4,2853,2,13,10,3,7,4,3,4,3,0,False,False,False,1,3,2020-11-10T18:02:43.477,7,,4.0
2020,9,2915,785,27,505,13,4,10,10,0,0,0,0,0,0,False,False,False,0,3,2021-02-18T15:12:23.407,0,,0.0
2020,9,2915,790,27,650,2,13,10,2,8,6,5,3,5,0,False,False,False,1,3,2020-11-09T15:23:33.02,8,,3.0
2020,9,2915,825,27,7404,2,48,3,-6,50,56,37,13,37,0,False,False,False,1,1,2020-11-09T15:32:42.567,50,,13.0
2020,9,2915,830,27,7404,2,4,10,2,3,1,2,1,2,0,False,False,False,0,1,2020-11-09T15:34:15.173,3,,1.0
2020,9,2915,835,27,7404,2,6,9,2,11,9,10,1,10,0,False,False,False,0,1,2020-11-09T15:35:50.69,11,,1.0
2020,9,2915,840,27,7408,2,50,3,1,2,1,2,0,2,0,False,False,False,0,2,2020-11-09T15:38:01.813,2,,0.0
2020,9,2915,845,27,5069,2,13,4,2,2,0,2,0,2,0,False,False,False,0,3,2020-11-09T15:40:08.787,2,,0.0
2020,9,2915,855,27,5069,13,5,5,3,0,0,0,0,0,0,False,False,False,0,3,2020-11-09T15:42:02.6,0,,0.0
2020,9,2915,860,27,7408,2,2,4,6,7,1,6,1,6,6,False,False,False,0,3,2020-11-09T15:43:49.84,7,,1.0
2020,9,2916,15,14,7582,2,51,10,-5,2,7,-1,3,-1,0,False,False,False,0,1,2020-11-09T12:39:38.243,2,,3.0
2020,9,2916,25,14,6543,2,50,3,-4,3,7,0,3,0,0,True,False,False,1,2,2020-11-13T19:07:21.7,3,,3.0
2020,9,2916,40,3,2976,2,30,10,-3,4,7,3,1,3,0,False,False,False,0,1,2020-11-09T12:47:49.503,4,,1.0
2020,9,2916,65,14,7584,2,50,10,-3,13,16,8,5,8,0,False,False,False,0,3,2021-03-04T16:05:56.633,13,,5.0
2020,9,2916,70,14,4449,2,35,10,13,20,7,18,2,18,0,False,False,False,0,3,2021-02-18T14:57:46.203,20,,2.0
2020,9,2916,90,14,5197,13,7,5,6,0,0,0,0,0,0,False,False,False,0,4,2020-11-09T13:00:50.24,0,,
2020,9,2916,115,3,7671,2,48,10,-5,6,11,4,2,4,0,False,False,False,0,1,2020-11-10T03:47:07.643,6,,2.0
2020,9,2916,120,3,6936,2,5,5,4,4,0,4,0,4,0,True,False,False,0,3,2020-11-10T22:38:07.22,4,,0.0
2020,9,2916,130,3,6454,2,5,3,5,5,0,5,0,5,0,False,False,False,0,3,2020-11-10T22:37:46.38,5,,0.0
2020,9,2916,135,3,6936,3,5,5,8,0,0,0,0,0,0,False,False,False,0,2,2020-11-13T19:08:33.513,0,,0.0
2020,9,2916,145,14,7584,2,2,4,13,13,0,13,0,13,0,False,False,False,0,3,2020-11-09T13:16:30.363,13,,0.0
2020,9,2916,165,14,6543,2,50,5,-3,17,20,3,14,3,0,False,False,False,1,2,2020-11-09T13:20:21.26,17,,14.0
2020,9,2916,195,14,4070,3,13,10,4,0,0,0,0,0,0,False,False,False,0,3,2020-11-09T13:32:30.677,0,,0.0
2020,9,2916,210,3,6659,2,12,5,-4,4,8,3,1,3,0,False,False,False,0,1,2021-03-08T20:20:16.01,4,,1.0
2020,9,2916,225,3,6659,2,48,9,-3,7,10,5,2,5,0,False,False,False,0,1,2020-11-09T13:40:03.523,7,,2.0
2020,9,2916,240,14,1119,13,46,3,3,0,0,0,0,0,0,True,False,False,0,4,2020-11-09T13:45:42.883,0,,0.0
2020,9,2916,245,14,7582,2,48,5,-6,5,11,-3,8,-3,0,False,False,False,0,1,2020-11-13T19:06:14.307,5,,8.0
2020,9,2916,250,14,4070,13,4,7,17,0,0,0,0,0,0,False,False,False,0,2,2020-11-11T15:06:42.39,0,,0.0
2020,9,2916,260,3,6454,13,4,9,7,0,0,0,0,0,0,False,False,False,0,3,2020-11-09T13:51:19.22,0,,0.0
2020,9,2916,265,3,6454,13,53,4,-4,0,0,0,0,0,0,False,False,False,0,4,2020-11-09T13:54:00.9,0,,0.0
2020,9,2916,270,3,6454,2,4,4,11,13,2,11,2,11,0,False,False,False,0,3,2020-11-09T13:55:17.947,13,,2.0
2020,9,2916,275,3,6936,13,2,4,10,0,0,0,0,0,0,False,False,False,0,3,2020-11-09T13:56:45.98,0,,0.0
2020,9,2916,295,3,7672,2,13,3,5,11,6,11,0,11,0,False,False,False,0,3,2020-11-09T14:03:40.267,11,,
2020,9,2916,300,3,2688,2,2,10,6,9,3,10,-1,10,0,False,False,False,0,3,2020-11-09T14:05:52.007,9,,-1.0
2020,9,2916,310,14,895,13,39,4,5,0,0,0,0,0,0,False,False,False,0,3,2020-11-09T14:11:20.33,0,,0.0
2020,9,2916,325,14,7584,2,4,10,8,12,4,9,3,9,0,False,False,False,0,2,2020-11-10T21:57:08.837,12,,3.0
2020,9,2916,335,14,4070,2,6,9,6,10,4,9,1,9,0,False,False,False,0,2,2021-02-18T14:58:30.08,10,,1.0
2020,9,2916,340,14,4070,13,8,1,38,0,0,0,0,0,0,False,False,False,0,2,2020-11-09T14:20:09.37,0,,0.0
2020,9,2916,345,14,5197,2,8,9,14,17,3,14,3,14,0,False,False,False,0,3,2020-11-10T21:57:26.183,17,,3.0
2020,9,2916,355,14,8165,2,50,9,-1,5,6,3,2,3,0,False,False,False,0,2,2020-11-09T14:23:03.68,5,,2.0
2020,9,2916,365,14,1119,13,12,10,6,0,0,0,0,0,0,False,False,False,0,3,2020-11-09T14:26:38.897,0,,0.0
2020,9,2916,385,3,7671,2,48,9,-5,-1,4,-2,1,-2,0,False,False,False,0,1,2020-11-09T14:31:25.727,-1,,1.0
2020,9,2916,415,14,4449,2,2,10,7,9,2,8,1,8,0,False,False,False,0,3,2020-11-09T14:37:56.743,9,,1.0
2020,9,2916,445,3,2688,2,35,9,10,14,4,13,1,13,0,False,False,False,0,3,2021-02-18T14:59:35.11,14,,1.0
2020,9,2916,450,3,6936,2,2,9,8,14,6,12,2,12,0,False,False,False,0,3,2020-11-09T14:50:00.747,14,,2.0
2020,9,2916,455,3,2688,2,4,10,3,9,6,7,2,7,0,False,False,False,0,3,2020-11-09T14:51:37.073,9,,2.0
2020,9,2916,465,3,2976,2,17,10,14,21,7,21,0,21,0,False,False,False,0,4,2020-11-09T14:55:10.54,21,,0.0
2020,9,2916,485,14,4070,13,21,2,27,0,0,0,0,0,0,False,False,False,0,3,2020-11-09T15:01:23.567,0,,0.0
2020,9,2916,495,3,6936,2,6,1,17,20,3,19,1,19,0,False,False,False,0,3,2020-11-09T15:07:01.43,20,,1.0
2020,9,2916,505,3,2976,2,13,9,2,12,10,7,5,7,0,False,False,False,0,4,2020-11-13T19:10:57.137,12,,5.0
2020,9,2916,515,3,6454,2,30,9,-1,4,5,3,1,3,0,False,False,False,0,1,2020-11-13T19:05:58.323,4,,1.0
2020,9,2916,550,14,6546,2,48,10,-6,1,7,-1,2,-1,0,False,False,False,0,1,2020-11-13T19:11:46.753,1,,2.0
2020,9,2916,555,14,7584,13,7,6,37,0,0,0,0,0,0,False,False,False,0,3,2020-11-09T15:35:20.283,0,,0.0
2020,9,2916,560,14,895,13,12,2,19,0,0,0,0,0,0,False,False,False,0,3,2020-11-09T15:36:49.88,0,,0.0
2020,9,2916,570,3,6935,2,4,5,4,11,7,9,2,9,0,False,False,False,0,2,2020-11-09T15:39:00.427,11,,2.0
2020,9,2916,575,3,2976,2,12,10,9,9,0,9,0,9,0,False,False,False,0,4,2020-11-13T19:05:45.437,9,,0.0
2020,9,2916,630,3,2688,2,30,10,-1,5,6,4,1,4,0,False,False,False,0,3,2021-03-04T16:06:32.09,5,,1.0
2020,9,2916,665,14,5197,2,39,9,4,5,1,5,0,5,0,False,False,False,0,4,2020-11-09T16:01:54.69,5,,0.0
2020,9,2916,675,14,6546,2,48,9,-6,-2,4,-6,4,-6,0,False,False,False,1,1,2020-11-10T21:55:41.903,-2,,4.0
2020,9,2916,680,14,8165,2,51,10,-4,3,7,3,0,3,0,False,False,False,0,1,2020-11-13T19:16:29.113,3,,0.0
2020,9,2916,685,14,7584,2,12,2,19,18,-1,18,0,18,0,False,False,False,0,3,2020-11-13T19:12:46.843,18,,0.0
2020,9,2916,690,14,4449,2,13,10,3,6,3,3,3,3,0,False,False,False,1,3,2021-03-03T17:13:53.097,6,,3.0
2020,9,2916,705,14,895,2,26,4,4,6,2,6,0,6,0,False,False,False,0,3,2020-11-09T16:13:23.127,6,,0.0
2020,9,2916,715,14,895,13,13,3,5,0,0,0,0,0,0,False,False,False,0,4,2020-11-13T19:13:23.587,0,,0.0
2020,9,2916,755,14,4449,2,50,9,-5,5,10,1,4,1,0,False,False,False,0,3,2021-03-04T16:07:00.967,5,,4.0
2020,9,2916,765,14,7584,13,8,7,30,0,0,0,0,0,0,False,False,False,0,3,2020-11-13T19:14:14.93,0,,0.0
2020,9,2916,770,14,4449,13,35,7,16,0,0,0,0,0,0,False,False,False,0,3,2020-11-10T21:59:25.317,0,,0.0
2020,9,2916,805,14,4070,13,9,3,11,0,0,0,0,0,0,False,False,False,0,2,2021-03-17T19:16:52.243,0,,0.0
2020,9,2916,810,14,8165,2,50,10,-4,6,10,5,1,5,0,False,False,False,0,3,2021-03-04T16:07:18.487,6,,1.0
2020,9,2916,815,14,6543,13,32,5,-2,0,0,0,0,0,0,False,False,False,0,1,2020-11-09T16:47:15.547,0,,0.0
2020,9,2916,820,14,8165,2,51,9,4,13,9,13,0,13,0,False,False,False,0,3,2020-11-13T18:18:11.373,13,,0.0
2020,9,2916,825,14,4070,2,50,10,-2,4,6,2,2,2,0,False,False,False,0,3,2021-03-04T16:07:41.82,4,,2.0
2020,9,2916,830,14,5197,2,17,4,14,21,7,20,1,20,0,False,False,False,0,3,2020-11-09T16:50:52.69,21,,1.0
2020,9,2916,835,14,8165,2,50,9,-4,5,9,2,3,2,0,False,False,False,1,3,2021-03-04T16:08:00.013,5,,
2020,9,2916,845,14,7584,13,6,4,7,0,0,0,0,0,0,False,False,False,0,3,2020-11-09T16:54:32.043,0,,0.0
2020,9,2916,860,14,4449,2,50,10,-4,15,19,7,8,7,0,False,False,False,0,3,2021-03-04T16:08:18.52,15,,8.0
2020,9,2917,15,15,8099,13,44,3,-5,0,0,0,0,0,0,False,False,False,0,1,2020-11-11T20:23:25.123,0,,0.0
2020,9,2917,20,15,6501,2,19,6,36,73,37,67,6,67,6,False,False,False,0,2,2020-11-09T18:22:57.34,73,,6.0
2020,9,2917,40,13,876,2,51,9,2,57,55,57,0,57,6,False,False,False,0,3,2020-11-11T20:24:22.213,57,,0.0
2020,9,2917,60,15,922,13,2,10,6,0,0,0,0,0,0,False,False,False,0,3,2020-11-11T20:25:38.403,0,,0.0
2020,9,2917,65,15,6501,13,12,2,20,0,0,0,0,0,0,False,False,False,0,3,2021-03-08T20:34:50.903,0,,0.0
2020,9,2917,75,13,1430,2,30,9,1,19,18,17,2,17,0,False,False,False,0,4,2020-11-11T20:28:11.447,19,,2.0
2020,9,2917,80,13,876,2,35,7,19,19,0,19,0,19,0,False,False,False,0,3,2020-11-13T19:08:09.423,19,,0.0
2020,9,2917,85,13,6528,2,5,10,4,9,5,7,2,7,0,False,False,False,0,4,2020-11-11T20:43:40.813,9,,2.0
2020,9,2917,95,13,2455,13,45,5,-2,0,0,0,0,0,0,False,False,False,0,1,2020-11-11T20:32:12.46,0,,0.0
2020,9,2917,110,15,7591,2,50,9,-3,-1,2,-1,0,-1,0,False,False,False,0,2,2020-11-09T11:56:10.073,-1,,0.0
2020,9,2917,115,15,922,2,4,10,5,7,2,7,0,7,0,False,False,False,0,4,2020-11-09T11:58:27.257,7,,0.0
2020,9,2917,120,15,1561,2,28,10,3,4,1,4,0,4,0,False,False,False,0,1,2020-11-11T20:36:09.707,4,,0.0
2020,9,2917,135,15,8099,3,45,5,-5,0,0,0,0,0,0,False,False,False,0,1,2021-02-18T18:32:31.233,0,,0.0
2020,9,2917,140,15,6501,13,5,3,14,0,0,0,0,0,0,False,False,False,0,2,2020-11-11T20:41:05.49,0,,0.0
2020,9,2917,150,13,876,13,6,4,5,0,0,0,0,0,0,False,False,False,0,3,2020-11-09T12:14:08.697,0,,0.0
2020,9,2917,155,13,1430,13,12,5,10,0,0,0,0,0,0,False,False,False,0,3,2021-03-10T21:48:39.073,0,,0.0
2020,9,2917,160,13,496,2,26,10,6,5,-1,5,0,5,0,False,False,False,0,2,2020-11-11T20:45:10.587,5,,0.0
2020,9,2917,175,15,6501,2,13,10,0,0,0,0,0,0,0,False,False,False,0,2,2020-11-09T12:28:40.927,0,,0.0
2020,9,2917,180,15,4997,13,12,6,30,0,0,0,0,0,0,False,False,False,0,3,2020-11-11T20:46:58.8,0,,0.0
2020,9,2917,190,13,1430,2,30,9,0,7,7,3,4,3,0,True,False,False,0,1,2020-11-13T19:36:53.717,7,,4.0
2020,9,2917,205,13,876,13,5,2,15,0,0,0,0,0,0,False,False,False,0,3,2020-11-13T20:00:07.873,0,,0.0
2020,9,2917,215,13,6528,3,11,6,16,0,0,0,0,0,0,True,False,False,0,4,2020-11-11T20:54:47.053,0,,0.0
2020,9,2917,220,13,496,2,6,10,11,11,0,11,0,11,0,False,False,False,0,3,2020-11-13T19:08:09.423,11,,0.0
2020,9,2917,235,13,496,2,50,9,-3,5,8,3,2,3,0,False,False,False,0,3,2020-11-13T20:00:21.393,5,,2.0
2020,9,2917,255,13,6528,13,9,2,15,0,0,0,0,0,0,True,False,False,0,2,2020-11-09T13:14:19.07,0,,0.0
2020,9,2917,260,13,404,2,16,10,4,4,0,4,0,4,0,False,False,False,0,1,2020-11-09T18:28:14.6,4,,0.0
2020,9,2917,275,15,6501,2,18,5,-1,5,6,3,2,3,0,False,False,False,0,2,2020-11-13T19:42:13.88,5,,2.0
2020,9,2917,290,15,922,2,35,7,15,17,2,16,1,16,0,False,False,False,0,4,2020-11-09T18:34:21.81,17,,1.0
2020,9,2917,300,15,7592,3,6,4,11,0,0,0,0,0,0,False,False,False,0,3,2020-11-09T13:35:49.57,0,,0.0
2020,9,2917,305,15,2407,2,47,5,2,6,4,5,1,5,0,False,False,False,0,3,2020-11-11T20:58:07.017,6,,1.0
2020,9,2917,350,13,3951,2,5,3,5,6,1,6,0,6,0,False,False,False,0,3,2020-11-09T18:30:39.517,6,,0.0
2020,9,2917,355,13,6528,2,6,9,4,10,6,5,5,5,0,False,False,False,0,3,2020-11-13T19:47:22.69,10,,5.0
2020,9,2917,375,15,2407,13,4,2,17,0,0,0,0,0,0,False,False,False,0,2,2020-11-13T19:08:09.423,0,,0.0
2020,9,2917,395,13,876,13,19,2,32,0,0,0,0,0,0,False,False,False,0,2,2020-11-09T14:23:28.427,0,,0.0
2020,9,2917,400,13,3951,2,5,5,4,7,3,7,0,7,0,False,False,False,0,3,2021-02-18T18:34:15.733,7,,0.0
2020,9,2917,405,13,3951,13,19,2,52,0,0,0,0,0,0,False,False,False,0,2,2020-11-09T14:27:20.883,0,,
2020,9,2917,415,13,404,2,28,4,5,10,5,7,3,7,0,False,False,False,1,1,2020-11-09T14:32:05.01,10,,3.0
2020,9,2917,445,15,1561,2,48,10,0,12,12,10,2,10,0,False,False,False,0,1,2020-11-09T14:41:18.107,12,,2.0
2020,9,2917,455,15,1561,2,4,4,5,6,1,6,0,6,0,False,False,False,0,1,2020-11-09T14:44:09.217,6,,0.0
2020,9,2917,490,13,404,2,50,3,-3,12,15,3,9,3,0,False,False,False,1,2,2021-03-03T17:16:22.743,12,,9.0
2020,9,2917,510,15,2757,2,39,4,6,9,3,7,2,7,0,False,False,False,0,3,2020-11-13T19:08:09.423,9,,2.0
2020,9,2917,525,15,6501,2,5,3,4,5,1,5,0,5,0,False,False,False,0,3,2020-11-09T18:25:05.823,5,,0.0
2020,9,2917,530,15,2407,2,13,10,3,7,4,5,2,5,0,False,False,False,1,3,2020-11-09T15:22:53.953,7,,2.0
2020,9,2917,535,15,6501,2,7,7,25,27,2,27,0,27,0,False,False,False,0,2,2020-11-09T18:24:44.057,27,,0.0
2020,9,2917,550,15,2757,13,43,6,21,0,0,0,0,0,0,False,False,False,0,4,2021-03-05T14:38:03.857,0,,0.0
2020,9,2917,565,13,3951,2,19,2,21,77,56,77,0,77,6,False,False,False,0,3,2020-11-09T15:51:22.63,77,,0.0
2020,9,2917,585,15,6501,2,35,5,10,16,6,16,0,16,0,False,False,False,0,2,2021-02-25T15:32:53.527,16,,0.0
2020,9,2917,595,15,2407,2,4,3,3,4,1,4,0,4,0,False,False,False,0,2,2020-11-09T16:03:42.037,4,,0.0
2020,9,2917,600,15,2407,2,47,5,2,21,19,3,18,3,0,False,False,False,1,3,2021-03-03T17:18:09.81,21,,18.0
2020,9,2917,615,15,2407,2,51,5,-2,-1,1,-1,0,-1,0,False,False,False,0,3,2020-11-13T20:00:44.363,-1,,0.0
2020,9,2917,635,13,404,2,44,3,-5,6,11,4,2,4,0,True,False,False,0,1,2020-11-13T19:48:53.763,6,,2.0
2020,9,2917,655,13,4662,13,9,2,26,0,0,0,0,0,0,False,False,False,0,3,2020-11-09T16:36:30.98,0,,0.0
2020,9,2917,660,13,3951,2,50,10,-5,3,8,2,1,2,0,False,False,False,0,3,2020-11-13T19:49:32.71,3,,1.0
2020,9,2917,670,13,876,2,12,5,7,7,0,7,0,7,0,False,False,False,0,3,2020-11-13T19:01:03.62,7,,0.0
2020,9,2917,685,15,2407,2,4,5,5,5,0,5,0,5,0,False,False,False,0,2,2020-11-09T16:54:18.107,5,,0.0
2020,9,2917,690,15,6501,13,4,5,5,0,0,0,0,0,0,False,False,False,0,2,2020-11-09T16:57:32.797,0,,0.0
2020,9,2917,695,15,1561,13,12,5,6,0,0,0,0,0,0,False,False,False,0,1,2020-11-09T17:00:33.967,0,,
2020,9,2917,705,15,7592,2,12,3,3,9,6,9,0,9,0,False,False,False,0,3,2020-11-09T17:07:08.163,9,,0.0
2020,9,2917,720,13,876,13,7,6,30,0,0,0,0,0,0,False,False,False,0,3,2021-02-18T18:35:26.843,0,,0.0
2020,9,2917,740,15,6501,3,4,5,6,0,0,0,0,0,0,False,False,False,0,2,2020-11-09T17:24:37.91,0,,0.0
2020,9,2917,745,15,4997,2,6,4,6,6,0,6,0,6,0,False,False,False,0,3,2020-11-09T17:27:37.967,6,,0.0
2020,9,2917,765,13,3951,2,5,3,6,7,1,7,0,7,0,False,False,False,0,3,2020-11-09T17:39:21.26,7,,0.0
2020,9,2917,770,13,876,13,6,4,5,0,0,0,0,0,0,False,False,False,0,3,2020-11-09T17:41:56.163,0,,0.0
2020,9,2917,810,13,876,13,9,6,17,0,0,0,0,0,0,False,False,False,0,3,2020-11-09T17:51:16.98,0,,0.0
2020,9,2917,825,15,2407,2,3,5,11,10,-1,10,0,10,0,False,False,False,0,2,2020-11-13T20:01:00.34,10,,0.0
2020,9,2917,830,15,1561,2,4,10,4,13,9,11,2,11,0,False,False,False,0,1,2021-02-18T18:36:31.79,13,,2.0
2020,9,2917,835,15,6501,13,19,2,32,0,0,0,0,0,0,False,False,False,0,2,2020-11-09T17:59:38.74,0,,0.0
2020,9,2917,840,15,922,2,4,4,8,12,4,10,2,10,0,False,False,False,0,3,2020-11-09T18:02:11.223,12,,2.0
2020,9,2917,845,15,6501,2,5,2,19,20,1,20,0,20,0,False,False,False,0,2,2020-11-09T18:38:17.603,20,,0.0
2020,9,2917,855,15,922,2,5,9,6,12,6,10,2,10,0,False,False,False,0,3,2020-11-09T18:07:22.447,12,,2.0
2020,9,2918,10,5,4799,2,51,9,-5,7,12,4,3,4,0,True,False,False,0,1,2020-11-09T11:27:40.967,7,,3.0
2020,9,2918,15,5,3477,2,5,10,3,4,1,4,0,4,0,True,False,False,0,3,2020-11-10T17:55:46.153,4,,0.0
2020,9,2918,25,5,4803,2,30,9,-3,1,4,-2,3,-2,0,False,False,False,0,4,2020-11-13T17:01:30.03,1,,3.0
2020,9,2918,30,5,2554,2,45,10,0,12,12,8,4,8,0,False,False,False,0,1,2020-11-09T11:33:52.703,12,,4.0
2020,9,2918,65,5,5220,2,13,4,3,7,4,5,2,5,0,False,False,False,0,3,2020-11-09T12:03:26.18,7,,2.0
2020,9,2918,75,5,4719,2,46,3,-1,0,1,0,0,0,0,False,False,False,0,1,2020-11-09T12:06:36.207,0,,
2020,9,2918,95,5,3477,2,51,3,1,0,-1,0,0,0,0,False,False,False,0,3,2020-11-09T12:11:30.013,0,,0.0
2020,9,2918,100,5,4803,2,4,10,4,5,1,5,0,5,0,False,False,False,0,3,2020-11-09T12:12:35.183,5,,0.0
2020,9,2918,105,5,4799,2,46,9,-1,9,10,9,0,9,6,True,False,False,0,1,2020-11-10T18:02:34.66,9,,0.0
2020,9,2918,130,16,3938,2,6,10,13,14,1,14,0,14,0,False,False,False,0,3,2020-11-10T21:08:18.04,14,,0.0
2020,9,2918,135,16,3938,3,4,5,4,0,0,0,0,0,0,False,False,False,0,2,2020-11-10T21:02:14.483,0,,0.0
2020,9,2918,140,16,374,2,4,9,9,10,1,10,0,10,0,True,False,False,0,4,2020-11-09T12:21:33.437,10,,0.0
2020,9,2918,145,16,3938,2,5,3,4,3,-1,3,0,3,0,False,False,False,0,3,2020-11-09T12:22:38.983,3,,0.0
2020,9,2918,150,16,7681,2,18,5,-1,8,9,6,2,6,0,True,False,False,1,2,2020-11-09T12:24:48.8,8,,2.0
2020,9,2918,160,16,7681,13,11,3,14,0,0,0,0,0,0,False,False,False,0,1,2020-11-09T12:27:23.113,0,,0.0
2020,9,2918,165,16,3938,13,7,2,18,0,0,0,0,0,0,False,False,False,0,4,2020-11-10T21:02:25.54,0,,0.0
2020,9,2918,170,16,3938,13,4,1,16,0,0,0,0,0,0,False,False,False,0,3,2020-11-09T12:31:07.157,0,,0.0
2020,9,2918,190,5,5220,2,2,10,5,11,6,11,0,11,0,False,False,False,0,2,2020-11-09T12:35:21.157,11,,0.0
2020,9,2918,195,5,3477,13,35,6,26,0,0,0,0,0,0,False,False,False,0,3,2020-11-10T21:08:18.04,0,,0.0
2020,9,2918,215,5,6372,2,17,7,16,28,12,26,2,26,0,False,False,False,0,3,2020-11-09T12:41:27.523,28,,2.0
2020,9,2918,225,5,4799,2,4,9,3,7,4,5,2,5,0,False,False,False,0,1,2020-11-09T12:44:14.29,7,,2.0
2020,9,2918,230,5,4803,2,34,4,-4,14,18,14,0,14,6,True,False,False,0,3,2020-11-09T12:45:17.683,14,,0.0
2020,9,2918,245,16,7176,2,4,3,4,6,2,6,0,6,0,False,False,False,0,2,2020-11-09T12:47:22.75,6,,0.0
2020,9,2918,250,16,7176,2,23,1,32,32,0,32,0,32,0,False,False,False,0,3,2020-11-09T12:48:57.207,32,,0.0
2020,9,2918,255,16,3938,13,8,6,37,0,0,0,0,0,0,False,False,False,0,3,2020-11-09T12:50:28.337,0,,0.0
2020,9,2918,260,16,374,13,2,9,7,0,0,0,0,0,0,False,False,False,0,3,2020-11-09T12:52:28.237,0,,0.0
2020,9,2918,265,16,3938,13,4,4,14,0,0,0,0,0,0,False,False,False,0,3,2020-11-09T12:53:55.003,0,,0.0
2020,9,2918,285,5,4803,13,35,10,11,0,0,0,0,0,0,False,False,False,0,3,2020-11-10T18:03:25.133,0,,
2020,9,2918,295,5,4799,2,16,10,3,8,5,6,2,6,0,False,False,False,0,1,2020-11-09T13:00:37.573,8,,2.0
2020,9,2918,300,5,5220,2,13,10,2,6,4,4,2,4,0,False,False,False,0,3,2020-11-10T18:03:42.51,6,,
2020,9,2918,310,5,4799,2,28,10,0,9,9,8,1,8,0,False,False,False,0,1,2020-11-09T13:03:46.46,9,,1.0
2020,9,2918,320,16,374,2,35,7,16,23,7,20,3,20,0,False,False,False,0,3,2020-11-09T13:08:34.307,23,,3.0
2020,9,2918,325,16,3938,2,47,5,1,7,6,4,3,4,0,False,False,False,0,2,2020-11-09T13:10:32.31,7,,3.0
2020,9,2918,335,16,374,2,32,9,0,5,5,3,2,3,0,True,False,False,0,4,2020-11-09T13:16:07.013,5,,2.0
2020,9,2918,340,16,374,2,5,10,6,8,2,7,1,7,0,False,False,False,0,3,2020-11-09T13:17:06.48,8,,1.0
2020,9,2918,345,16,3938,2,51,9,-3,14,17,10,4,10,0,True,False,False,0,3,2021-02-18T16:55:40.56,14,,4.0
2020,9,2918,350,16,4143,2,13,10,1,1,0,1,0,1,6,False,False,False,0,2,2020-11-09T13:20:22.503,1,,0.0
2020,9,2918,365,5,3477,2,13,10,0,3,3,2,1,2,0,False,False,False,0,3,2020-11-09T13:22:58.347,3,,1.0
2020,9,2918,370,5,3477,2,2,4,4,11,7,9,2,9,0,True,False,False,0,3,2020-11-09T13:24:16.8,11,,2.0
2020,9,2918,390,5,5220,13,2,10,5,0,0,0,0,0,0,False,False,False,0,2,2020-11-13T17:05:02.533,0,,
2020,9,2918,395,5,3477,2,51,3,-5,12,17,11,1,11,0,True,False,False,0,3,2020-11-13T17:05:55.43,12,,1.0
2020,9,2918,405,5,6425,13,7,6,27,0,0,0,0,0,0,False,False,False,0,3,2020-11-09T13:34:08.877,0,,0.0
2020,9,2918,410,5,3477,2,50,10,-3,-6,-3,-6,0,-6,0,False,False,False,1,3,2020-11-13T17:07:20.31,0,,0.0
2020,9,2918,430,16,374,2,5,3,8,10,2,10,0,10,0,False,False,False,0,3,2020-11-09T13:39:23.893,10,,0.0
2020,9,2918,435,16,3938,2,4,4,9,9,0,9,0,9,0,False,False,False,1,3,2020-11-09T13:40:59.283,9,,0.0
2020,9,2918,445,16,3938,13,19,6,30,0,0,0,0,0,0,False,False,False,0,3,2020-11-10T21:08:18.04,0,,0.0
2020,9,2918,450,16,3938,2,4,10,10,10,0,10,0,10,0,False,False,False,0,3,2020-11-09T13:44:22.74,10,,0.0
2020,9,2918,460,16,4143,2,3,3,9,5,-4,9,-4,9,0,False,False,False,0,2,2021-02-18T16:57:49.92,5,,-4.0
2020,9,2918,465,16,6499,13,44,3,-4,0,0,0,0,0,0,False,False,False,0,1,2020-11-09T13:47:50,0,,
2020,9,2918,475,16,374,2,12,7,21,36,15,26,10,26,0,False,False,False,1,3,2020-11-10T21:02:37.2,36,,
2020,9,2918,480,16,4143,2,12,2,20,28,8,30,-2,30,0,False,True,True,0,2,2020-11-09T13:52:41.487,28,,-2.0
2020,9,2918,495,16,374,2,6,10,11,14,3,12,2,12,0,False,False,False,0,3,2020-11-09T14:05:05.247,14,,2.0
2020,9,2918,505,16,374,2,11,3,9,29,20,27,2,27,0,False,False,False,1,4,2020-11-13T17:04:17.48,29,,2.0
2020,9,2918,510,16,3938,13,4,9,5,0,0,0,0,0,0,False,False,False,0,3,2020-11-09T14:09:13.49,0,,0.0
2020,9,2918,515,16,34,2,48,10,-6,-5,1,-5,0,-5,0,False,False,False,0,1,2020-11-10T01:09:56.593,-5,,0.0
2020,9,2918,540,5,3477,13,2,10,3,0,0,0,0,0,0,False,False,False,0,2,2020-11-09T14:25:10.647,0,,0.0
2020,9,2918,545,5,3477,2,13,10,0,8,8,7,1,7,0,False,False,False,0,3,2020-11-09T14:28:04.68,8,,1.0
2020,9,2918,550,5,6425,2,38,9,1,8,7,8,0,8,0,False,True,False,0,4,2020-11-09T14:29:21.603,8,,0.0
2020,9,2918,570,16,7681,3,28,10,-3,0,0,0,0,0,0,False,False,False,0,1,2020-11-09T15:08:01.637,0,,0.0
2020,9,2918,575,16,374,2,30,10,-3,3,6,1,2,1,0,True,False,False,0,4,2020-11-09T14:37:12.03,3,,2.0
2020,9,2918,580,16,374,2,19,2,26,44,18,31,13,31,0,False,False,False,1,3,2020-11-10T21:08:18.04,44,,13.0
2020,9,2918,590,16,7681,2,47,5,2,4,2,4,0,4,6,False,False,False,0,1,2020-11-09T14:43:18.253,4,,0.0
2020,9,2918,610,5,4799,2,12,5,3,3,0,3,0,3,0,False,False,False,0,1,2020-11-09T14:47:31.02,3,,0.0
2020,9,2918,615,5,4799,2,44,9,-1,3,4,1,2,1,0,True,False,False,0,1,2020-11-09T14:48:33.713,3,,2.0
2020,9,2918,635,5,3477,13,5,6,19,0,0,0,0,0,0,False,False,False,0,3,2020-11-13T16:21:55.437,0,,0.0
2020,9,2918,650,16,7176,2,26,10,2,10,8,8,2,8,0,True,False,False,0,2,2020-11-09T15:01:17.033,10,,2.0
2020,9,2918,655,16,7176,3,4,3,8,0,0,0,0,0,0,False,False,False,0,2,2020-11-09T15:02:28.913,0,,0.0
2020,9,2918,665,16,7176,13,6,4,14,0,0,0,0,0,0,False,False,False,0,3,2020-11-10T21:08:18.04,0,,
2020,9,2918,670,16,3938,13,35,10,8,0,0,0,0,0,0,False,False,False,0,3,2020-11-10T21:08:18.04,0,,0.0
2020,9,2918,675,16,3938,2,7,2,26,26,0,26,0,26,0,False,False,False,0,2,2020-11-10T21:08:18.04,26,,0.0
2020,9,2918,680,16,3938,2,35,8,28,28,0,28,0,28,6,False,False,False,0,3,2020-11-09T15:11:38.42,28,,0.0
2020,9,2918,695,5,4803,2,35,7,23,28,5,28,0,28,0,False,False,False,0,3,2020-11-09T15:15:32.127,28,,0.0
2020,9,2918,705,5,3477,13,19,2,31,0,0,0,0,0,0,False,False,False,0,3,2020-11-09T15:21:03.467,0,,0.0
2020,9,2918,710,5,2554,13,28,10,-1,0,0,0,0,0,0,True,False,False,0,1,2020-11-10T17:56:24.46,0,,0.0
2020,9,2918,720,5,4799,2,7,6,21,24,3,24,0,24,0,False,False,False,0,1,2021-02-25T15:35:38.513,24,,0.0
2020,9,2918,730,5,4803,2,31,10,-1,3,4,2,1,2,0,False,False,False,0,4,2020-11-13T17:02:24.533,3,,1.0
2020,9,2918,750,16,3938,13,4,9,9,0,0,0,0,0,0,False,False,False,0,3,2020-11-13T17:03:01.7,0,,0.0
2020,9,2918,755,16,7681,2,44,3,-2,8,10,1,7,1,0,True,False,False,1,1,2020-11-10T20:59:51.79,8,,7.0
2020,9,2918,760,16,374,2,12,9,6,13,7,6,7,6,0,False,False,False,1,3,2020-11-09T15:47:17.453,13,,7.0
2020,9,2918,770,16,374,13,8,8,15,0,0,0,0,0,0,False,False,False,0,4,2020-11-09T15:49:38.013,0,,0.0
2020,9,2918,775,16,4143,13,12,3,11,0,0,0,0,0,0,False,False,False,0,4,2020-11-10T21:03:24.97,0,,
2020,9,2918,785,16,3938,2,3,5,2,2,0,2,0,2,6,False,False,False,0,2,2020-11-13T14:45:25.78,2,,0.0
2020,9,2918,810,5,4803,2,5,3,5,11,6,10,1,10,0,False,False,False,0,3,2020-11-09T16:00:35.06,11,,1.0
2020,9,2918,815,5,2554,2,44,3,-7,2,9,0,2,0,0,False,False,False,1,1,2020-11-10T18:09:03.17,2,,2.0
2020,9,2918,820,5,4799,2,46,3,-1,9,10,1,8,1,0,False,False,False,1,1,2020-11-09T16:12:18.713,9,,8.0
2020,9,2918,825,5,3477,2,9,2,19,22,3,22,0,22,0,False,False,False,0,3,2020-11-13T16:21:55.437,22,,0.0
2020,9,2918,830,5,4803,2,13,9,4,11,7,9,2,9,0,False,False,False,0,4,2020-11-09T16:14:55.557,11,,2.0
2020,9,2918,835,5,2554,2,26,9,1,5,4,2,3,2,0,True,False,False,1,1,2020-11-09T16:17:14.807,5,,3.0
2020,9,2918,840,5,3477,2,2,9,2,3,1,2,1,2,0,False,False,False,0,2,2020-11-13T16:21:55.437,3,,1.0
2020,9,2918,890,16,6499,2,48,9,-5,3,8,2,1,2,0,False,False,False,1,1,2020-11-13T17:08:23.27,3,,1.0
2020,9,2918,905,5,4803,2,2,4,7,9,2,7,2,7,0,False,False,False,0,3,2020-11-09T16:29:25.337,9,,2.0
2020,9,2918,910,5,4799,2,47,5,0,1,1,1,0,1,0,False,False,False,0,1,2020-11-10T18:09:35.813,1,,
2020,9,2918,915,5,3477,13,2,10,4,0,0,0,0,0,0,False,False,False,0,3,2020-11-09T16:32:06.7,0,,
2020,9,2918,920,5,2554,2,4,10,1,9,8,2,7,2,0,False,False,False,0,1,2020-11-09T16:33:39.08,9,,7.0
2020,9,2918,925,5,2554,2,4,9,0,6,6,4,2,4,0,False,False,False,0,1,2020-11-10T18:09:50.473,6,,2.0
2020,9,2918,930,5,4803,2,17,8,21,23,2,23,0,23,0,False,False,False,0,3,2020-11-13T16:21:55.437,23,,0.0
2020,9,2918,940,5,4799,2,47,5,-1,0,1,-1,1,-1,0,False,False,False,0,1,2020-11-09T16:37:39.42,0,,1.0
2020,9,2918,950,5,5220,13,5,5,6,0,0,0,0,0,0,False,False,False,0,2,2020-11-09T16:40:02.367,0,,0.0
2020,9,2919,10,11,3820,13,19,6,46,0,0,0,0,0,0,False,False,False,0,2,2021-02-18T16:48:55.577,0,,0.0
2020,9,2919,20,11,100,2,5,3,1,1,0,1,0,1,0,False,False,False,0,3,2020-11-09T11:16:22.2,1,,0.0
2020,9,2919,40,18,813,2,35,10,12,22,10,18,4,18,0,False,False,False,0,4,2020-11-09T11:27:55.863,22,,4.0
2020,9,2919,50,18,7711,2,35,5,14,22,8,18,4,18,0,False,False,False,0,3,2020-11-09T11:33:00.033,22,,4.0
2020,9,2919,75,11,3820,2,5,3,5,5,0,5,0,5,0,False,False,False,0,3,2021-02-18T16:50:09.523,5,,0.0
2020,9,2919,85,11,792,2,5,10,0,-1,-1,-1,0,-1,0,False,False,False,0,1,2021-02-18T16:50:49.837,-1,,0.0
2020,9,2919,90,11,100,2,49,9,-3,13,16,12,1,12,0,False,False,False,0,3,2020-11-09T11:52:03.357,13,,1.0
2020,9,2919,115,11,2714,2,30,9,0,0,0,0,0,0,0,False,False,False,0,4,2021-02-18T16:51:18.4,0,,0.0
2020,9,2919,140,18,1381,2,6,1,22,30,8,23,7,23,0,False,False,False,1,3,2020-11-11T16:41:54.613,30,,7.0
2020,9,2919,150,18,6907,2,35,9,9,9,0,9,0,9,6,False,False,False,0,4,2020-11-09T17:04:24.31,9,,0.0
2020,9,2919,165,11,6810,2,6,10,6,9,3,7,2,7,0,False,False,False,0,3,2020-11-09T12:19:45.01,9,,2.0
2020,9,2919,175,11,100,2,45,5,-3,6,9,6,0,6,0,True,False,False,0,2,2020-11-13T13:17:46.523,6,,0.0
2020,9,2919,195,11,6629,2,32,3,3,4,1,4,0,4,0,False,False,False,0,1,2020-11-13T12:50:16.313,4,,0.0
2020,9,2919,205,11,792,2,48,4,-2,10,12,6,4,6,0,False,False,False,1,1,2020-11-09T12:39:55.47,10,,4.0
2020,9,2919,210,11,792,2,4,4,3,5,2,4,1,4,0,False,False,False,0,1,2020-11-09T12:41:36.29,5,,1.0
2020,9,2919,220,11,100,2,2,9,6,12,6,10,2,10,0,False,False,False,0,3,2020-11-13T12:53:07.97,12,,2.0
2020,9,2919,230,11,7732,2,46,3,4,5,1,5,0,5,0,False,True,False,0,1,2020-11-09T12:50:30.85,5,False,0.0
2020,9,2919,250,18,6907,13,4,10,3,0,0,0,0,0,0,False,False,False,0,3,2021-03-15T16:47:46.48,0,,0.0
2020,9,2919,260,18,4572,2,28,9,2,17,15,2,15,2,0,False,False,False,1,1,2020-11-13T13:28:37.213,17,,15.0
2020,9,2919,275,18,813,13,30,3,2,0,0,0,0,0,0,True,False,False,0,4,2020-11-10T14:44:30.93,0,,0.0
2020,9,2919,290,11,914,13,2,10,7,0,0,0,0,0,0,False,False,False,0,2,2020-11-09T13:12:13.55,0,,
2020,9,2919,300,11,7733,2,8,9,12,20,8,16,4,16,0,False,False,False,0,2,2020-11-09T13:23:14.917,20,,4.0
2020,9,2919,310,11,100,2,46,3,2,8,6,8,0,8,0,True,False,False,0,3,2020-11-10T22:06:51.973,8,,0.0
2020,9,2919,330,11,6810,2,2,9,6,11,5,8,3,8,0,True,False,False,0,3,2020-11-10T22:19:03.417,11,,3.0
2020,9,2919,335,11,914,2,5,3,6,15,9,6,9,6,6,False,False,False,1,3,2020-11-09T13:38:00.413,15,,9.0
2020,9,2919,355,18,1381,2,2,10,5,8,3,5,3,5,0,False,False,False,0,2,2020-11-09T13:42:04.147,8,,3.0
2020,9,2919,365,18,813,2,39,4,5,10,5,8,2,8,0,False,False,False,0,4,2020-11-09T13:44:32.073,10,,2.0
2020,9,2919,370,18,4572,2,6,9,3,29,26,29,0,29,0,False,False,False,0,1,2020-11-09T13:46:33.203,29,,0.0
2020,9,2919,380,18,566,2,48,9,-3,22,25,21,1,21,6,False,False,False,0,1,2020-11-09T13:49:52.297,22,,1.0
2020,9,2919,395,11,7732,3,12,10,4,0,0,0,0,0,0,False,False,False,0,1,2020-11-09T13:54:06.547,0,,0.0
2020,9,2919,425,18,1381,13,12,2,18,0,0,0,0,0,0,False,False,False,0,3,2020-11-09T14:03:39.543,0,,0.0
2020,9,2919,435,18,813,2,31,4,4,8,4,5,3,5,0,False,False,False,0,4,2020-11-10T22:08:25.593,8,,3.0
2020,9,2919,450,11,100,3,13,5,4,0,0,0,0,0,0,False,False,False,0,3,2020-11-13T13:51:16.537,0,,0.0
2020,9,2919,455,11,100,13,5,5,5,0,0,0,0,0,0,False,False,False,0,3,2020-11-10T22:07:18.96,0,,0.0
2020,9,2919,465,18,7711,13,21,2,39,0,0,0,0,0,0,False,False,False,0,2,2020-11-13T12:46:16.807,0,,0.0
2020,9,2919,475,18,7711,2,9,2,27,35,8,35,0,35,0,False,False,False,0,3,2020-11-13T13:35:36.787,35,,0.0
2020,9,2919,490,18,6907,13,13,5,7,0,0,0,0,0,0,False,False,False,0,4,2020-11-09T14:29:05.123,0,,0.0
2020,9,2919,495,18,7711,13,9,6,21,0,0,0,0,0,0,False,False,False,0,3,2020-11-09T14:33:41.557,0,,
2020,9,2919,510,18,6907,2,30,9,0,1,1,1,0,1,6,False,False,False,0,4,2020-11-10T14:44:48.073,1,,0.0
2020,9,2919,525,11,6810,2,5,5,4,9,5,7,2,7,0,True,False,False,0,3,2020-11-13T13:51:31.857,9,,2.0
2020,9,2919,540,11,914,2,2,10,11,16,5,12,4,12,0,False,False,False,0,3,2020-11-11T16:43:30.683,16,,4.0
2020,9,2919,545,11,792,13,48,9,-4,0,0,0,0,0,0,False,False,False,0,1,2020-11-09T14:56:45.873,0,,0.0
2020,9,2919,550,11,7732,3,5,3,5,0,0,0,0,0,0,False,False,False,0,1,2020-11-09T14:56:23.593,0,,0.0
2020,9,2919,555,11,3820,2,12,4,13,14,1,12,2,12,0,False,False,False,0,2,2020-11-09T14:58:49.853,14,,2.0
2020,9,2919,560,11,6810,13,6,4,8,0,0,0,0,0,0,False,False,False,0,4,2021-03-05T14:40:09.17,0,,0.0
2020,9,2919,575,18,1381,13,19,2,27,0,0,0,0,0,0,False,False,False,0,2,2021-02-18T16:58:53.943,0,,0.0
2020,9,2919,590,11,100,2,5,3,5,9,4,9,0,9,0,False,False,False,0,3,2020-11-13T13:37:20.587,9,,0.0
2020,9,2919,595,11,792,13,12,5,9,0,0,0,0,0,0,True,False,False,0,3,2021-02-18T17:03:28.14,0,,0.0
2020,9,2919,605,11,6810,13,36,4,5,0,0,0,0,0,0,False,False,False,0,4,2020-11-09T15:21:50.197,0,,0.0
2020,9,2919,625,18,7711,2,13,9,4,7,3,4,3,4,0,False,False,False,0,2,2020-11-09T15:34:18.407,7,,3.0
2020,9,2919,635,11,914,2,6,9,5,12,7,5,7,5,0,False,False,False,2,2,2020-11-09T15:38:36.423,12,,7.0
2020,9,2919,640,11,7732,2,4,9,3,9,6,4,5,4,0,False,False,False,0,1,2020-11-13T13:37:49.58,9,,5.0
2020,9,2919,650,11,7732,2,6,10,4,19,15,18,1,18,0,False,False,False,1,1,2020-11-09T15:46:17.59,19,,1.0
2020,9,2919,665,11,100,13,5,3,11,0,0,0,0,0,0,False,False,False,0,3,2020-11-09T15:54:04.17,0,,0.0
2020,9,2919,695,11,100,2,7,5,14,28,14,28,0,28,0,True,False,False,0,3,2020-11-11T16:44:26.903,28,,0.0
2020,9,2919,700,11,6810,13,5,2,20,0,0,0,0,0,0,False,False,False,0,3,2020-11-11T16:45:44.003,0,,0.0
2020,9,2919,735,11,6810,2,29,5,2,2,0,2,0,2,6,False,False,False,0,2,2020-11-09T16:17:45.44,2,,0.0
2020,9,2919,820,18,1381,13,35,5,10,0,0,0,0,0,0,False,False,False,0,3,2020-11-13T13:38:50.643,0,,0.0
2020,9,2919,825,11,914,3,2,3,8,0,0,0,0,0,0,False,False,False,0,2,2020-11-09T16:45:36.59,0,,0.0
2020,9,2919,835,11,6341,2,4,4,2,12,10,12,0,12,0,False,False,False,0,1,2020-11-09T16:48:58.087,12,,0.0
2020,9,2919,840,11,3820,3,2,4,6,0,0,0,0,0,0,False,False,False,0,3,2020-11-09T16:50:26.227,0,,0.0
2020,9,2919,845,11,7733,2,2,9,5,11,6,9,2,9,0,False,False,False,0,3,2020-11-10T22:07:52.413,11,,2.0
2020,9,2919,850,11,6810,2,4,9,7,8,1,8,0,8,0,False,False,False,0,3,2020-11-09T16:54:16.357,8,,0.0
2020,9,2919,855,11,6341,2,17,9,4,13,9,12,1,12,0,False,False,False,0,1,2020-11-09T16:56:35.433,13,,1.0
2020,9,2919,865,11,3820,2,4,5,9,9,0,9,0,9,0,False,False,False,0,2,2020-11-09T16:59:43.53,9,,0.0
2020,9,2919,870,11,6341,2,4,9,1,11,10,11,0,11,0,False,False,False,0,1,2020-11-13T13:40:05.787,11,,0.0
2020,9,2920,10,31,6793,3,6,10,11,0,0,0,0,0,0,False,False,False,0,3,2021-02-18T17:11:38.077,0,,0.0
2020,9,2920,20,31,6793,13,5,5,10,0,0,0,0,0,0,False,False,False,0,3,2020-11-09T11:09:04.323,0,,0.0
2020,9,2920,30,6,811,2,51,9,-6,8,14,5,3,5,0,True,False,False,0,1,2020-11-09T11:14:47.36,8,,3.0
2020,9,2920,35,6,666,2,11,3,13,24,11,23,1,23,0,False,False,False,0,4,2020-11-12T19:02:05.713,24,,1.0
2020,9,2920,45,6,6328,2,51,10,-4,4,8,3,1,3,0,True,False,False,0,3,2020-11-09T11:23:56.007,4,,1.0
2020,9,2920,50,6,464,2,5,5,4,4,0,4,0,4,0,False,False,False,0,2,2020-11-09T11:25:45.8,4,,0.0
2020,9,2920,60,31,6724,3,30,9,-1,0,0,0,0,0,0,False,False,False,0,4,2020-11-12T22:01:23.627,0,,0.0
2020,9,2920,70,31,6793,13,21,2,35,0,0,0,0,0,0,False,False,False,0,2,2020-11-09T11:36:01.893,0,,0.0
2020,9,2920,80,6,811,2,5,5,4,5,1,4,1,4,0,False,False,False,0,3,2020-11-12T22:01:30.407,5,,1.0
2020,9,2920,115,31,6793,2,6,4,12,38,26,12,26,12,0,False,False,False,3,2,2020-11-12T18:29:29.283,38,,26.0
2020,9,2920,125,31,6390,2,26,9,1,6,5,6,0,6,0,False,False,False,0,2,2020-11-09T11:55:44.7,6,,0.0
2020,9,2920,130,31,6724,13,2,10,4,0,0,0,0,0,0,True,False,False,0,2,2020-11-09T11:57:58.013,0,,0.0
2020,9,2920,155,6,6328,13,4,4,10,0,0,0,0,0,0,False,False,False,0,3,2020-11-12T22:01:39.277,0,,0.0
2020,9,2920,175,31,6724,13,32,3,1,0,0,0,0,0,0,True,False,False,0,4,2020-11-09T12:13:23.507,0,,0.0
2020,9,2920,200,6,464,13,5,5,3,0,0,0,0,0,0,False,False,False,0,3,2020-11-09T17:22:16.43,0,,0.0
2020,9,2920,210,31,5080,3,6,10,12,0,0,0,0,0,0,False,False,False,0,3,2020-11-09T12:25:04.977,0,,0.0
2020,9,2920,235,6,666,2,47,5,-1,4,5,3,1,3,0,False,False,False,0,4,2020-11-09T12:31:25.417,4,,1.0
2020,9,2920,240,6,464,13,2,10,4,0,0,0,0,0,0,False,False,False,0,2,2020-11-09T12:33:27.977,0,,0.0
2020,9,2920,245,6,6328,13,26,9,0,0,0,0,0,0,0,True,False,False,0,2,2020-11-12T19:07:47.847,0,,0.0
2020,9,2920,305,31,6793,2,6,4,11,17,6,10,7,10,0,False,False,False,1,3,2020-11-09T12:56:15.993,17,,7.0
2020,9,2920,315,31,6793,13,24,5,12,0,0,0,0,0,0,False,False,False,0,3,2021-03-15T16:54:17.95,0,,0.0
2020,9,2920,320,31,6724,2,4,4,9,9,0,9,0,9,0,False,False,False,0,3,2020-11-12T22:01:56.22,9,,0.0
2020,9,2920,335,31,6793,2,9,6,29,40,11,29,11,29,6,False,False,False,1,3,2020-11-12T21:29:11.953,40,,11.0
2020,9,2920,350,6,666,2,32,10,1,14,13,10,4,10,0,True,False,False,0,3,2020-11-12T17:51:18.7,14,,4.0
2020,9,2920,365,6,811,2,52,10,3,9,6,7,2,7,0,False,False,False,1,2,2020-11-09T13:22:22.863,9,,2.0
2020,9,2920,415,6,464,2,2,4,6,6,0,6,0,6,0,False,False,False,0,3,2020-11-09T17:18:12.763,6,,
2020,9,2920,420,6,7725,2,4,9,4,7,3,6,1,6,0,False,False,False,0,3,2020-11-09T13:37:29.327,7,,1.0
2020,9,2920,425,6,6786,2,16,9,3,6,3,6,0,6,0,False,False,False,0,1,2020-11-09T17:35:56.127,6,,0.0
2020,9,2920,430,6,7725,13,5,3,12,0,0,0,0,0,0,False,False,False,0,2,2020-11-12T22:02:49.8,0,,0.0
2020,9,2920,450,6,6328,2,9,6,25,34,9,34,0,34,0,False,False,False,0,3,2020-11-12T21:29:11.953,34,,0.0
2020,9,2920,455,6,7725,13,19,2,25,0,0,0,0,0,0,False,False,False,0,3,2021-03-15T16:54:35.62,0,,0.0
2020,9,2920,465,6,811,2,12,4,5,5,0,5,0,5,0,False,False,False,0,2,2020-11-09T14:10:34.393,5,,0.0
2020,9,2920,500,31,6793,13,6,4,6,0,0,0,0,0,0,False,False,False,0,2,2020-11-09T14:19:47.283,0,,0.0
2020,9,2920,505,31,5080,13,3,3,9,0,0,0,0,0,0,True,False,False,0,2,2021-02-25T12:21:37.153,0,,0.0
2020,9,2920,515,6,7725,2,12,5,5,5,0,5,0,5,0,False,False,False,0,4,2021-03-08T20:47:31.213,5,,0.0
2020,9,2920,520,6,464,2,5,5,6,7,1,7,0,7,0,False,False,False,0,3,2020-11-12T19:15:40.787,7,,0.0
2020,9,2920,525,6,7725,2,35,2,20,22,2,20,2,20,0,False,False,False,0,2,2020-11-09T14:31:50.7,22,,2.0
2020,9,2920,540,6,6790,2,6,7,20,18,-2,20,-2,20,0,False,False,False,0,2,2020-11-09T16:52:05.36,18,,-2.0
2020,9,2920,555,6,666,2,51,10,-2,3,5,3,0,3,0,False,False,False,0,3,2020-11-09T14:44:56.403,3,,0.0
2020,9,2920,560,6,6786,2,48,10,-7,-4,3,-4,0,-4,0,False,True,True,0,1,2020-11-12T17:43:31.103,-7,,0.0
2020,9,2920,575,6,464,2,9,2,16,23,7,16,7,16,0,False,False,False,0,2,2020-11-09T14:56:37.033,23,,7.0
2020,9,2920,580,6,464,2,4,3,4,4,0,4,0,4,0,False,False,False,0,2,2021-03-15T16:54:45.017,4,,0.0
2020,9,2920,590,6,7725,13,4,5,5,0,0,0,0,0,0,False,False,False,0,2,2020-11-09T15:07:34.523,0,,0.0
2020,9,2920,605,6,7725,13,9,2,27,0,0,0,0,0,0,False,False,False,0,3,2020-11-12T21:29:11.953,0,,0.0
2020,9,2920,610,6,6328,2,4,10,5,5,0,5,0,5,0,False,False,False,0,2,2020-11-09T15:12:25.74,5,,0.0
2020,9,2920,620,6,6790,2,4,10,5,5,0,5,0,5,0,False,False,False,0,3,2020-11-12T22:03:17.99,5,,0.0
2020,9,2920,625,6,7725,2,47,5,3,8,5,6,2,6,0,False,False,False,0,1,2020-11-12T19:18:02.147,8,,2.0
2020,9,2920,640,6,7725,13,2,10,4,0,0,0,0,0,0,False,False,False,0,3,2020-11-09T15:28:46.917,0,,0.0
2020,9,2920,655,31,5080,13,12,6,36,0,0,0,0,0,0,True,False,False,0,4,2021-03-08T20:48:09.413,0,,0.0
2020,9,2920,670,31,6793,2,42,10,4,6,2,4,2,4,0,False,False,False,0,2,2020-11-12T21:29:11.953,6,,2.0
2020,9,2920,675,31,6724,2,2,4,5,12,7,5,7,5,0,True,False,False,1,3,2020-11-12T17:52:27.397,12,,7.0
2020,9,2920,685,31,5096,2,2,4,10,30,20,24,6,24,0,False,False,False,0,4,2020-11-09T15:46:33.247,30,,6.0
2020,9,2920,690,31,5096,2,47,5,1,2,1,2,0,2,6,False,False,False,0,4,2020-11-09T15:48:35.217,2,,0.0
2020,9,2920,705,6,464,2,4,9,5,5,0,5,0,5,0,False,False,False,0,3,2020-11-09T15:51:46.433,5,,0.0
2020,9,2920,710,6,464,2,24,6,21,27,6,21,6,21,0,False,False,False,0,3,2020-11-09T15:53:52.187,27,,6.0
2020,9,2920,715,6,6786,2,4,4,2,13,11,9,4,9,0,False,False,False,0,1,2020-11-09T17:36:12.247,13,,4.0
2020,9,2920,720,6,7725,2,4,5,1,1,0,1,0,1,0,False,False,False,0,2,2020-11-09T15:57:26.347,1,,0.0
2020,9,2920,735,6,6328,2,2,10,8,12,4,10,2,10,0,False,False,False,0,3,2021-03-15T16:54:53.397,12,,2.0
2020,9,2920,740,6,6328,13,2,10,6,0,0,0,0,0,0,False,False,False,0,3,2020-11-10T19:42:35.357,0,,0.0
2020,9,2920,745,6,6337,2,47,5,1,6,5,5,1,5,6,False,False,False,0,1,2020-11-09T16:11:15.02,6,,1.0
2020,9,2920,780,31,6724,2,30,10,-2,-2,0,-2,0,-2,0,False,False,False,0,4,2020-11-09T16:18:28.153,-2,,0.0
2020,9,2920,790,6,6328,2,39,4,5,4,-1,4,0,4,0,False,True,True,0,3,2020-11-09T16:24:32.317,4,,0.0
2020,9,2920,825,6,6337,2,28,4,2,16,14,14,2,14,0,False,False,False,0,1,2020-11-12T22:03:42.24,16,,2.0
2020,9,2920,835,6,6337,2,4,10,1,1,0,1,0,1,0,False,False,False,0,1,2020-11-09T16:41:34.57,1,,0.0
2020,9,2920,840,6,666,2,32,9,-5,2,7,2,0,2,0,False,False,False,0,3,2020-11-12T22:03:51.527,2,,0.0
2020,9,2920,850,6,6328,13,2,4,4,0,0,0,0,0,0,False,False,False,0,3,2020-11-09T16:48:55.893,0,,
2020,9,2920,855,6,7725,13,19,6,31,0,0,0,0,0,0,False,False,False,0,2,2020-11-09T16:53:49.607,0,,0.0
2020,9,2920,860,6,6337,2,46,3,1,12,11,12,0,12,0,False,False,False,0,1,2020-11-09T16:56:08.367,12,,0.0
2020,9,2920,865,6,464,2,2,9,9,11,2,10,1,10,0,False,False,False,0,3,2020-11-12T22:04:19.453,11,,1.0
2020,9,2920,875,6,666,2,4,10,8,8,0,8,0,8,6,False,False,False,0,3,2020-11-10T19:42:56.67,8,,0.0
2020,9,2921,10,21,7090,2,4,3,6,6,0,6,0,6,0,False,False,False,0,2,2020-11-09T11:03:36.127,6,,0.0
2020,9,2921,25,21,4422,2,4,10,6,6,0,6,0,6,0,False,False,False,0,2,2020-11-13T16:37:41.257,6,,0.0
2020,9,2921,30,21,4422,13,5,5,5,0,0,0,0,0,0,False,False,False,0,1,2020-11-13T16:44:35.183,0,,0.0
2020,9,2921,35,21,3680,2,26,9,2,3,1,2,1,2,0,False,False,False,1,3,2021-03-03T17:31:28.18,3,,1.0
2020,9,2921,45,32,7807,2,28,9,0,21,21,17,4,17,0,False,False,False,0,1,2020-11-09T18:46:57.837,21,,4.0
2020,9,2921,50,21,8259,2,24,2,32,50,18,48,2,48,0,False,False,False,0,3,2020-11-09T11:36:03.947,50,,2.0
2020,9,2921,65,21,4405,3,32,9,0,0,0,0,0,0,0,False,False,False,0,1,2020-11-10T23:20:54.493,0,,0.0
2020,9,2921,70,21,3680,13,2,4,6,0,0,0,0,0,0,False,False,False,0,3,2020-11-13T14:43:38.407,0,,0.0
2020,9,2921,90,32,1427,13,17,9,0,0,0,0,0,0,0,False,False,False,0,4,2020-11-13T17:39:49.587,0,,0.0
2020,9,2921,100,32,1427,13,5,5,10,0,0,0,0,0,0,False,False,False,0,3,2020-11-13T16:45:54.857,0,,0.0
2020,9,2921,115,21,963,2,44,3,-2,4,6,0,4,0,0,False,False,False,0,1,2020-11-09T12:17:14.08,4,,4.0
2020,9,2921,120,21,3680,2,5,5,3,2,-1,2,0,2,0,False,False,False,0,3,2020-11-13T14:41:09.057,2,,0.0
2020,9,2921,130,21,4422,3,38,10,3,0,0,0,0,0,0,False,False,False,0,3,2021-02-18T15:06:46.577,0,,0.0
2020,9,2921,135,21,4422,2,52,9,0,7,7,5,2,5,0,False,False,False,0,3,2020-11-13T16:48:14.95,7,,2.0
2020,9,2921,145,21,4180,13,46,3,0,0,0,0,0,0,0,False,False,False,0,1,2020-11-10T23:21:30.13,0,,0.0
2020,9,2921,155,21,8259,2,18,5,1,8,7,4,4,4,0,False,False,False,1,2,2020-11-13T17:40:07.677,8,,4.0
2020,9,2921,175,32,3885,2,51,5,-2,7,9,6,1,6,0,False,False,False,0,3,2020-11-13T14:45:50.617,7,,1.0
2020,9,2921,185,32,7128,2,12,5,11,11,0,11,0,11,0,True,False,False,0,1,2021-03-08T20:53:21.227,11,,0.0
2020,9,2921,190,32,7807,2,46,9,0,11,11,3,8,3,0,True,False,False,1,1,2020-11-10T18:43:52.167,11,,8.0
2020,9,2921,195,32,7128,2,4,9,11,12,1,12,0,12,0,False,False,False,0,2,2020-11-10T18:37:38.06,12,,0.0
2020,9,2921,205,32,7128,2,13,9,4,6,2,2,4,2,0,False,False,False,1,3,2020-11-09T18:35:04.267,6,,4.0
2020,9,2921,230,32,8237,2,4,4,9,9,0,9,0,9,0,False,False,False,0,3,2020-11-13T16:11:35.02,9,,
2020,9,2921,235,32,7128,2,50,10,-3,0,3,0,0,0,0,False,False,False,0,2,2020-11-13T16:12:37.6,0,,0.0
2020,9,2921,265,21,4422,13,30,5,-9,0,0,0,0,0,0,False,False,False,0,4,2020-11-10T23:21:42.567,0,,0.0
2020,9,2921,275,21,3680,2,13,10,4,21,17,14,7,14,0,False,False,False,2,3,2021-03-03T17:32:54.567,21,,7.0
2020,9,2921,280,21,3680,13,26,9,4,0,0,0,0,0,0,False,False,False,0,3,2020-11-09T13:44:44.013,0,,0.0
2020,9,2921,285,21,8259,13,5,3,5,0,0,0,0,0,0,False,False,False,0,3,2021-02-18T15:12:19.313,0,,0.0
2020,9,2921,290,21,2288,2,4,10,3,8,5,7,1,7,0,False,False,False,0,1,2020-11-10T23:21:55.24,8,,1.0
2020,9,2921,350,21,5015,2,2,5,10,10,0,10,0,10,0,False,False,False,0,2,2020-11-10T23:22:34.797,10,,0.0
2020,9,2921,375,21,4422,2,17,8,16,16,0,16,0,16,6,False,False,False,0,3,2020-11-13T16:18:11.823,16,,0.0
2020,9,2921,395,32,3885,2,4,3,2,7,5,6,1,6,0,True,False,False,0,2,2020-11-13T16:18:54.59,7,,1.0
2020,9,2921,400,32,1427,2,13,10,3,6,3,4,2,4,0,False,False,False,0,3,2020-11-13T16:55:16.603,6,,2.0
2020,9,2921,405,32,3885,13,12,10,-4,0,0,0,0,0,0,False,False,False,0,1,2021-02-25T15:39:42.207,0,,0.0
2020,9,2921,410,32,1427,2,4,9,4,14,10,10,4,10,0,False,False,False,0,3,2020-11-09T18:08:53.463,14,,4.0
2020,9,2921,420,32,6430,2,8,8,22,32,10,31,1,31,0,False,False,False,0,2,2020-11-09T18:09:05.047,32,,1.0
2020,9,2921,430,32,3885,13,28,4,0,0,0,0,0,0,0,False,False,False,0,1,2021-03-05T14:41:40.533,0,,0.0
2020,9,2921,435,21,4422,13,47,5,2,0,0,0,0,0,0,False,False,False,0,3,2020-11-10T23:22:52.103,0,,0.0
2020,9,2921,475,32,6430,2,11,6,24,45,21,45,0,45,0,False,False,False,0,3,2020-11-13T16:57:41.35,45,,0.0
2020,9,2921,480,32,3885,2,51,5,-3,8,11,8,0,8,0,False,False,False,0,3,2020-11-13T14:47:52.377,8,,0.0
2020,9,2921,520,21,7226,2,46,9,2,8,6,2,6,2,0,False,False,False,1,3,2020-11-09T15:04:41.33,8,,6.0
2020,9,2921,530,21,4422,2,5,3,6,7,1,7,0,7,0,False,False,False,0,3,2020-11-13T16:22:19.447,7,,0.0
2020,9,2921,535,21,3680,2,13,9,3,3,0,3,0,3,0,False,False,False,0,3,2020-11-10T23:23:44.477,3,,0.0
2020,9,2921,545,21,8259,2,2,9,7,7,0,7,0,7,0,False,False,False,0,2,2020-11-13T17:48:02.333,7,,0.0
2020,9,2921,555,21,7090,13,2,10,5,0,0,0,0,0,0,False,False,False,0,2,2020-11-13T14:38:50.847,0,,
2020,9,2921,565,21,4422,2,2,4,7,12,5,8,4,8,0,False,False,False,0,3,2020-11-13T15:39:12.53,12,,4.0
2020,9,2921,580,32,6430,13,39,4,6,0,0,0,0,0,0,False,False,False,0,3,2020-11-13T14:39:07.927,0,,0.0
2020,9,2921,585,32,3885,2,28,10,0,6,6,4,2,4,0,False,False,False,0,1,2021-02-18T15:14:57.39,6,,2.0
2020,9,2921,590,32,6430,2,13,10,4,33,29,9,24,9,0,False,False,False,3,3,2021-03-03T17:34:16.7,33,,24.0
2020,9,2921,600,32,3885,2,28,10,-6,7,13,7,0,7,0,False,False,False,0,1,2020-11-13T17:00:21.2,7,,0.0
2020,9,2921,605,32,8237,2,6,4,11,15,4,14,1,14,0,False,False,False,0,3,2020-11-09T19:02:40.983,15,,1.0
2020,9,2921,610,32,7807,2,12,10,-2,3,5,3,0,3,0,False,False,False,0,1,2021-03-08T20:54:44.82,3,,0.0
2020,9,2921,620,32,3885,2,45,10,-6,6,12,5,1,5,0,False,False,False,0,1,2020-11-13T14:23:41.513,6,,1.0
2020,9,2921,650,21,3680,2,4,10,4,4,0,4,0,4,0,False,False,False,0,3,2020-11-09T15:59:05.583,4,,0.0
2020,9,2921,660,21,4422,3,17,7,17,0,0,0,0,0,0,False,False,False,0,3,2020-11-13T17:01:47.733,0,,0.0
2020,9,2921,670,21,2288,2,31,4,1,8,7,6,2,6,0,False,False,False,0,1,2020-11-13T17:02:04.863,8,,2.0
2020,9,2921,680,32,3885,2,5,5,4,8,4,8,0,8,0,True,False,False,0,3,2020-11-10T18:44:13.82,8,,0.0
2020,9,2921,685,32,8237,2,51,9,-2,8,10,6,2,6,0,False,False,False,0,3,2020-11-13T16:23:06.78,8,,2.0
2020,9,2921,690,32,7128,2,35,6,20,68,48,20,48,20,6,False,False,False,1,3,2020-11-13T16:24:00.407,68,,48.0
2020,9,2921,710,21,8259,2,6,9,7,7,0,7,0,7,0,False,False,False,0,2,2021-02-18T15:15:48.127,7,,0.0
2020,9,2921,720,21,4405,2,47,5,3,9,6,8,1,8,0,False,False,False,0,1,2020-11-10T23:26:18.033,9,,1.0
2020,9,2921,730,21,3680,2,13,9,2,6,4,4,2,4,0,False,False,False,0,2,2020-11-13T17:02:32.893,6,,
2020,9,2921,735,21,3680,2,2,9,6,6,0,6,0,6,0,False,False,False,0,2,2020-11-13T17:18:39.263,6,,0.0
2020,9,2921,755,32,3885,3,47,5,-2,0,0,0,0,0,0,True,False,False,0,3,2020-11-13T17:43:13.69,0,,0.0
2020,9,2921,760,32,1427,2,4,9,6,8,2,6,2,6,0,False,False,False,0,3,2020-11-13T14:25:11.963,8,,2.0
2020,9,2921,765,32,3885,2,12,3,0,5,5,5,0,5,0,False,False,False,0,1,2021-03-08T20:55:16.703,5,,0.0
2020,9,2921,770,32,7128,2,13,4,4,8,4,6,2,6,0,False,False,False,0,2,2020-11-13T17:14:22.82,8,,2.0
2020,9,2921,775,32,8237,2,51,9,-3,7,10,7,0,7,0,False,False,False,0,3,2020-11-13T14:52:00.02,7,,0.0
2020,9,2921,780,32,7128,2,18,5,-1,10,11,9,1,9,0,False,False,False,0,2,2020-11-13T16:26:44.84,10,,1.0
2020,9,2921,785,32,3885,2,4,10,5,11,6,7,4,7,0,True,False,False,1,2,2020-11-13T16:27:59.78,11,,4.0
2020,9,2921,790,32,3885,13,28,4,1,0,0,0,0,0,0,False,False,False,0,1,2020-11-13T17:22:04.517,0,,0.0
2020,9,2921,795,32,1427,13,6,9,2,0,0,0,0,0,0,False,False,False,0,3,2020-11-13T16:29:57.967,0,,0.0
2020,9,2921,800,32,3885,13,12,4,0,0,0,0,0,0,0,False,False,False,0,1,2021-03-08T20:55:34.377,0,,0.0
2020,9,2921,805,21,720,2,47,10,0,0,0,0,0,0,0,False,False,False,0,4,2020-11-13T17:22:27.943,0,,0.0
2020,9,2921,840,32,7494,2,4,3,4,4,0,4,0,4,0,False,False,False,0,2,2020-11-13T17:43:57.193,4,,0.0
2020,9,2921,845,32,7128,13,4,9,13,0,0,0,0,0,0,False,False,False,0,2,2020-11-13T17:22:41.69,0,,0.0
2020,9,2922,20,26,309,13,13,10,4,0,0,0,0,0,0,False,False,False,0,3,2020-11-09T10:51:43.43,0,,0.0
2020,9,2922,25,26,7453,13,8,1,39,0,0,0,0,0,0,True,False,False,0,2,2020-11-09T10:53:59.607,0,,0.0
2020,9,2922,30,26,4282,13,5,3,10,0,0,0,0,0,0,True,False,False,0,3,2020-11-12T02:25:03.07,0,,0.0
2020,9,2922,40,23,2994,13,4,10,5,0,0,0,0,0,0,False,False,False,0,3,2020-11-13T20:46:55.397,0,,0.0
2020,9,2922,45,23,7688,13,39,4,6,0,0,0,0,0,0,False,False,False,0,3,2020-11-12T02:25:27.353,0,,0.0
2020,9,2922,75,26,309,2,6,10,12,16,4,12,4,12,0,False,False,False,1,3,2020-11-13T21:01:22.693,16,,4.0
2020,9,2922,110,23,7240,2,45,5,-3,6,9,1,5,1,0,True,False,False,1,1,2020-11-12T02:26:04.103,6,,5.0
2020,9,2922,115,23,596,2,32,5,0,0,0,0,0,0,0,False,False,False,0,4,2020-11-12T02:26:14.64,0,,0.0
2020,9,2922,120,23,2256,13,4,7,16,0,0,0,0,0,0,False,False,False,0,2,2020-11-13T21:06:25.833,0,,0.0
2020,9,2922,125,23,3843,2,5,5,7,19,12,12,7,12,0,True,False,False,1,1,2020-11-13T20:48:33.623,19,,7.0
2020,9,2922,150,26,309,2,13,10,3,3,0,3,0,3,0,False,False,False,0,3,2020-11-12T02:26:58.04,3,,0.0
2020,9,2922,155,26,4282,2,5,3,7,11,4,10,1,10,0,True,False,False,0,3,2020-11-13T21:08:28.503,11,,1.0
2020,9,2922,165,26,309,2,51,10,-3,17,20,13,4,13,0,False,False,False,0,3,2020-11-12T02:27:24.393,17,,4.0
2020,9,2922,175,26,309,3,2,9,6,0,0,0,0,0,0,False,False,False,0,3,2020-11-12T02:27:37.153,0,,0.0
2020,9,2922,180,26,309,2,16,4,3,13,10,8,5,8,0,True,False,False,0,1,2020-11-12T02:27:48.067,13,,5.0
2020,9,2922,195,26,6277,3,16,9,5,0,0,0,0,0,0,False,False,False,0,1,2020-11-13T21:09:49.103,0,,0.0
2020,9,2922,225,23,2994,2,5,3,6,8,2,8,0,8,0,False,False,False,0,3,2020-11-12T02:28:21.827,8,,0.0
2020,9,2922,245,23,2994,13,13,5,4,0,0,0,0,0,0,True,False,False,0,3,2020-11-13T21:15:53.42,0,,0.0
2020,9,2922,255,26,309,2,5,9,4,4,0,4,0,4,0,False,False,False,0,3,2020-11-12T02:28:47.313,4,,0.0
2020,9,2922,260,26,4282,13,4,4,6,0,0,0,0,0,0,False,False,False,0,4,2020-11-12T02:28:57.717,0,,0.0
2020,9,2922,290,23,2994,2,50,9,-3,4,7,0,4,0,0,True,False,False,0,3,2020-11-09T12:53:11.77,4,,4.0
2020,9,2922,320,26,7453,2,13,10,2,9,7,8,1,8,0,False,False,False,0,3,2020-11-12T02:29:28.313,9,,1.0
2020,9,2922,325,26,4282,2,4,4,10,10,0,10,0,10,0,False,False,False,0,3,2020-11-13T21:01:22.693,10,,0.0
2020,9,2922,335,26,4619,2,8,7,19,21,2,19,2,19,0,False,False,False,1,3,2020-11-13T21:18:05.03,21,,2.0
2020,9,2922,350,26,7453,13,19,2,28,0,0,0,0,0,0,False,False,False,0,2,2021-03-09T16:54:50.563,0,,
2020,9,2922,365,26,4619,2,2,4,4,16,12,14,2,14,0,False,False,False,0,3,2020-11-12T02:30:25.38,16,,2.0
2020,9,2922,375,26,309,2,35,8,19,27,8,27,0,27,6,False,False,False,0,3,2020-11-13T21:37:28.427,27,,0.0
2020,9,2922,390,23,7250,2,50,3,-3,7,10,4,3,4,0,False,False,False,1,2,2021-03-04T17:16:49.883,7,,3.0
2020,9,2922,430,23,2994,13,11,2,25,0,0,0,0,0,0,False,False,False,0,4,2020-11-13T20:47:27.143,0,,0.0
2020,9,2922,440,23,2256,2,19,6,44,45,1,44,1,44,6,False,False,False,0,2,2020-11-12T02:31:37.87,45,,1.0
2020,9,2922,460,26,7696,13,51,3,-9,0,0,0,0,0,0,True,False,False,0,2,2020-11-13T21:38:34.467,0,,0.0
2020,9,2922,465,26,4619,2,13,10,3,5,2,3,2,3,0,False,False,False,0,2,2021-02-18T17:03:11.16,5,,2.0
2020,9,2922,485,23,7688,13,35,6,31,0,0,0,0,0,0,False,False,False,0,3,2021-03-09T16:58:35.933,0,,0.0
2020,9,2922,490,23,7250,2,12,2,49,53,4,51,2,51,0,False,False,False,0,3,2020-11-12T02:35:31.933,53,,2.0
2020,9,2922,500,23,2994,13,8,9,12,0,0,0,0,0,0,False,False,False,0,3,2020-11-12T02:35:44.943,0,,0.0
2020,9,2922,515,23,2994,2,8,9,2,2,0,3,-1,3,6,False,False,False,0,3,2020-11-09T14:19:48.893,2,,-1.0
2020,9,2922,530,26,4282,2,5,9,5,5,0,5,0,5,0,False,False,False,0,4,2020-11-09T14:21:54.563,5,,0.0
2020,9,2922,555,26,7514,2,35,6,47,50,3,47,3,47,0,False,False,False,0,3,2020-11-12T02:36:14.183,50,,3.0
2020,9,2922,560,26,4619,13,9,5,11,0,0,0,0,0,0,False,False,False,0,3,2021-03-09T17:08:16.45,0,,0.0
2020,9,2922,565,26,7491,13,17,9,11,0,0,0,0,0,0,False,False,False,0,3,2020-11-12T02:36:34.623,0,,0.0
2020,9,2922,570,26,4282,13,7,3,11,0,0,0,0,0,0,False,False,False,0,3,2020-11-13T20:47:37.603,0,,0.0
2020,9,2922,595,23,2994,2,30,10,-3,3,6,1,2,1,0,True,False,False,0,4,2020-11-09T14:44:49.703,3,,2.0
2020,9,2922,615,23,7688,13,9,2,34,0,0,0,0,0,0,False,False,False,0,3,2020-11-13T20:47:58.783,0,,0.0
2020,9,2922,640,26,309,2,2,10,7,10,3,10,0,10,0,False,False,False,0,2,2020-11-12T02:37:19.59,10,,0.0
2020,9,2922,650,26,4282,2,4,10,5,7,2,6,1,6,0,False,False,False,0,4,2020-11-12T02:37:31.067,7,,1.0
2020,9,2922,655,26,4619,2,19,2,23,23,0,23,0,23,0,False,False,False,0,2,2020-11-13T21:01:22.693,23,,0.0
2020,9,2922,665,26,7695,2,46,9,0,12,12,9,3,9,0,False,False,False,0,1,2020-11-13T21:26:49.48,12,,3.0
2020,9,2922,685,26,7491,13,8,10,9,0,0,0,0,0,0,False,False,False,0,3,2021-03-01T14:02:21.047,0,,0.0
2020,9,2922,690,26,4282,13,7,5,9,0,0,0,0,0,0,False,False,False,0,3,2020-11-12T02:38:13.437,0,,
2020,9,2922,695,26,8177,2,48,3,-7,4,11,4,0,4,6,False,False,False,0,1,2021-03-15T17:01:10.753,4,,0.0
2020,9,2922,715,23,2994,13,35,8,30,0,0,0,0,0,0,False,False,False,0,3,2021-02-18T17:06:12.993,0,,0.0
2020,9,2922,720,23,7250,13,2,9,6,0,0,0,0,0,0,False,False,False,0,3,2020-11-09T15:31:53.873,0,,0.0
2020,9,2922,735,23,2256,2,5,3,10,10,0,10,0,10,0,False,False,False,0,2,2020-11-12T02:38:53.637,10,,0.0
2020,9,2922,745,23,7241,2,5,3,4,3,-1,3,0,3,0,False,False,False,0,1,2020-11-09T15:40:20.003,3,,0.0
2020,9,2922,755,23,2994,2,51,3,-1,5,6,3,2,3,0,True,False,False,0,4,2020-11-13T21:30:42.987,5,,2.0
2020,9,2922,770,26,309,2,26,5,2,5,3,5,0,5,0,False,False,False,0,3,2020-11-09T15:45:24.903,5,,0.0
2020,9,2922,775,26,6277,2,48,10,-6,4,10,2,2,2,0,False,False,False,0,1,2020-11-09T15:47:21.393,4,,2.0
2020,9,2922,780,26,309,2,2,10,6,8,2,8,0,8,0,False,False,False,0,2,2021-02-18T17:07:26.29,8,,0.0
2020,9,2922,785,26,7695,13,4,10,4,0,0,0,0,0,0,False,False,False,0,1,2020-11-09T15:51:23.313,0,,
2020,9,2922,795,26,7695,2,16,4,2,5,3,4,1,4,0,False,False,False,0,1,2020-11-09T15:55:44.297,5,,1.0
2020,9,2922,820,26,6277,2,16,10,4,11,7,5,6,5,0,False,False,False,1,1,2020-11-09T16:01:55.913,11,,6.0
2020,9,2922,830,26,7695,2,4,4,5,5,0,5,0,5,0,False,False,False,0,1,2020-11-09T16:04:01.54,5,,0.0
2020,9,2922,835,26,7695,2,45,10,-6,5,11,-4,9,-4,0,False,False,False,1,1,2020-11-13T20:49:41.863,5,,9.0
2020,9,2922,840,26,7695,2,4,4,3,4,1,4,0,4,0,False,False,False,0,1,2020-11-09T16:08:34.13,4,,0.0
2020,9,2922,850,26,4619,2,7,2,16,16,0,16,0,16,0,False,False,False,0,3,2021-03-09T17:15:37.86,16,,0.0
2020,9,2922,860,26,4619,13,9,5,4,0,0,0,0,0,0,False,False,False,0,2,2021-03-09T17:16:32.69,0,,0.0
2020,9,2922,875,26,7491,13,9,5,4,0,0,0,0,0,0,False,False,False,0,2,2021-03-09T17:17:25.553,0,,0.0
2020,9,2923,10,17,6274,2,32,3,1,6,5,4,2,4,0,False,False,False,0,4,2020-11-09T11:01:06.217,6,,2.0
2020,9,2923,45,1,6406,2,12,3,-1,4,5,2,2,2,0,False,False,False,0,1,2021-03-08T21:00:52.3,4,,2.0
2020,9,2923,70,1,245,13,19,6,27,0,0,0,0,0,0,False,False,False,0,2,2020-11-09T11:28:54.14,0,,
2020,9,2923,75,1,6405,13,50,3,-3,0,0,0,0,0,0,False,False,False,0,2,2021-03-04T17:19:00.16,0,,0.0
2020,9,2923,85,1,6405,2,2,10,7,8,1,8,0,8,0,False,False,False,0,2,2020-11-09T11:32:34.973,8,,0.0
2020,9,2923,90,1,6405,2,4,10,4,10,6,8,2,8,0,False,False,False,1,2,2020-11-13T21:47:57.43,10,,2.0
2020,9,2923,105,1,525,2,2,4,11,17,6,14,3,14,0,False,False,False,0,3,2020-11-09T11:41:03.693,17,,3.0
2020,9,2923,115,1,7315,13,7,3,14,0,0,0,0,0,0,False,False,False,0,3,2021-02-25T15:46:34.957,0,,0.0
2020,9,2923,125,1,2416,2,30,3,0,4,4,4,0,4,6,False,False,False,0,4,2020-11-09T11:55:08.58,4,,0.0
2020,9,2923,140,17,7087,2,4,5,5,5,0,5,0,5,0,False,False,False,0,2,2020-11-09T12:01:23.423,5,,0.0
2020,9,2923,165,17,7087,13,19,6,29,0,0,0,0,0,0,False,False,False,0,2,2020-11-09T12:08:55.14,0,,0.0
2020,9,2923,180,17,7087,2,29,3,11,11,0,11,0,11,0,False,False,False,0,2,2020-11-09T12:16:15.22,11,,0.0
2020,9,2923,190,17,6274,2,35,6,17,17,0,17,0,17,0,False,False,False,0,4,2020-11-09T17:46:43.62,17,,0.0
2020,9,2923,200,17,6276,2,33,4,4,19,15,16,3,16,0,False,False,False,0,4,2020-11-09T17:48:53.313,19,,3.0
2020,9,2923,205,17,4484,13,5,3,2,0,0,0,0,0,0,False,False,False,0,4,2020-11-09T17:48:45.723,0,,0.0
2020,9,2923,225,1,525,2,6,7,16,16,0,16,0,16,0,False,False,False,0,3,2020-11-09T12:34:31.78,16,,0.0
2020,9,2923,250,1,6405,2,8,1,48,56,8,56,0,56,6,False,False,False,0,2,2020-11-09T12:44:23.127,56,,0.0
2020,9,2923,265,17,7087,2,19,6,30,35,5,34,1,34,0,False,False,False,0,2,2020-11-09T12:46:03.527,35,,1.0
2020,9,2923,270,17,2253,13,19,6,35,0,0,0,0,0,0,False,False,False,0,2,2020-11-09T14:09:06.91,0,,
2020,9,2923,275,17,2253,2,47,5,3,3,0,3,0,3,0,True,False,False,0,3,2020-11-09T12:51:02.99,3,,0.0
2020,9,2923,300,17,4305,13,30,9,-4,0,0,0,0,0,0,True,False,False,0,4,2020-11-09T17:47:20.253,0,,0.0
2020,9,2923,305,17,7087,2,4,10,4,9,5,8,1,8,6,False,False,False,0,2,2020-11-09T13:07:51.177,9,,1.0
2020,9,2923,320,1,5152,2,2,9,14,16,2,16,0,16,0,False,False,False,0,4,2020-11-13T21:49:19.447,16,,0.0
2020,9,2923,335,1,525,2,3,3,7,10,3,10,0,10,0,False,False,False,0,3,2020-11-09T13:19:23.563,10,,0.0
2020,9,2923,365,1,525,13,12,5,9,0,0,0,0,0,0,False,False,False,0,3,2020-11-09T13:35:26.093,0,,0.0
2020,9,2923,385,17,4305,2,4,9,4,4,0,4,0,4,0,False,False,False,0,3,2020-11-09T13:37:42.483,4,,0.0
2020,9,2923,390,17,2253,2,12,5,12,16,4,12,4,12,0,False,False,False,1,2,2020-11-13T22:07:55.293,16,,4.0
2020,9,2923,430,1,7315,2,4,5,4,4,0,4,0,4,0,False,False,False,0,3,2020-11-09T17:49:06.46,4,,0.0
2020,9,2923,435,1,7315,2,39,4,7,6,-1,6,0,6,0,False,False,False,1,3,2020-11-13T21:47:04.893,6,,0.0
2020,9,2923,450,17,4305,2,4,3,7,16,9,15,1,15,0,False,False,False,1,2,2020-11-09T13:58:33.937,16,,1.0
2020,9,2923,465,17,7051,2,44,3,-2,17,19,15,2,15,0,False,False,False,0,1,2020-11-09T14:03:18.093,17,,2.0
2020,9,2923,500,1,245,2,2,9,14,17,3,17,0,17,0,False,False,False,0,2,2020-11-09T14:13:43.48,17,,0.0
2020,9,2923,510,1,3563,2,46,3,4,7,3,7,0,7,0,False,False,False,0,1,2020-11-10T17:20:23.093,7,,0.0
2020,9,2923,515,1,6405,2,4,10,14,14,0,14,0,14,0,False,False,False,0,2,2020-11-13T21:57:25.06,14,,0.0
2020,9,2923,520,1,245,13,19,6,18,0,0,0,0,0,0,False,False,False,0,2,2021-02-18T14:28:04.76,0,,
2020,9,2923,530,1,5032,2,7,2,21,21,0,21,0,21,6,False,False,False,0,4,2020-11-13T22:06:48.157,21,,0.0
2020,9,2923,550,17,2253,13,9,2,23,0,0,0,0,0,0,False,False,False,0,3,2020-11-09T14:39:24.98,0,,
2020,9,2923,555,17,2253,2,4,9,5,9,4,7,2,7,0,False,False,False,0,3,2020-11-09T14:41:06.38,9,,2.0
2020,9,2923,570,17,7634,13,2,4,5,0,0,0,0,0,0,False,False,False,0,3,2020-11-09T14:47:44.84,0,,0.0
2020,9,2923,585,1,525,2,12,10,11,11,0,11,0,11,0,False,False,False,0,3,2020-11-09T14:55:49.717,11,,0.0
2020,9,2923,595,1,245,2,4,3,4,6,2,6,0,6,0,False,False,False,0,2,2020-11-10T17:36:33.143,6,,0.0
2020,9,2923,600,1,6405,13,30,10,-2,0,0,0,0,0,0,True,False,False,0,4,2021-02-24T20:10:06.643,0,,0.0
2020,9,2923,610,1,6406,2,32,3,-1,4,5,3,1,3,0,False,False,False,0,3,2020-11-09T15:07:41.767,4,,1.0
2020,9,2923,620,1,245,13,12,6,29,0,0,0,0,0,0,False,False,False,0,2,2020-11-09T15:18:35.423,0,,
2020,9,2923,635,1,245,13,4,9,5,0,0,0,0,0,0,True,False,False,0,3,2020-11-09T15:26:02.227,0,,
2020,9,2923,645,1,6406,2,16,9,1,10,9,3,7,3,0,True,False,False,1,1,2020-11-10T17:41:27.467,10,,7.0
2020,9,2923,675,17,2253,2,4,10,12,14,2,14,0,14,0,False,False,False,0,2,2020-11-13T22:00:50.153,14,,0.0
2020,9,2923,690,17,2253,2,13,10,4,5,1,4,1,4,0,False,False,False,0,3,2020-11-09T15:54:02.98,5,,1.0
2020,9,2923,700,17,6274,2,47,5,0,0,0,0,0,0,0,False,False,False,0,4,2020-11-09T16:00:10.467,0,,
2020,9,2923,705,17,2253,2,4,1,17,17,0,17,0,17,0,False,False,False,0,3,2020-11-09T17:47:59.58,17,,0.0
2020,9,2923,710,17,4305,2,4,10,5,6,1,6,0,6,0,False,False,False,0,3,2020-11-09T16:04:22.513,6,,0.0
2020,9,2923,720,17,4383,2,9,5,11,11,0,11,0,11,6,False,False,False,0,2,2020-11-09T16:09:08.977,11,,0.0
2020,9,2923,740,1,6406,2,12,9,-7,9,16,5,4,5,0,False,False,False,1,1,2021-03-08T21:01:37.133,9,,
2020,9,2923,745,1,245,2,5,3,7,7,0,7,0,7,0,False,False,False,0,2,2020-11-09T16:36:04.59,7,,0.0
2020,9,2923,795,17,6274,2,7,6,19,19,0,19,0,19,0,False,False,False,0,3,2020-11-13T20:39:57.123,19,,0.0
2020,9,2923,800,17,2253,13,19,6,20,0,0,0,0,0,0,False,False,False,0,2,2020-11-09T16:59:35.263,0,,0.0
2020,9,2923,805,17,6274,13,5,5,2,0,0,0,0,0,0,False,False,False,0,3,2020-11-09T17:01:39.34,0,,0.0
2020,9,2923,810,17,4305,2,6,10,9,9,0,9,0,9,0,False,False,False,0,2,2020-11-09T17:05:05.877,9,,0.0
2020,9,2923,830,1,6405,2,8,2,32,35,3,34,1,34,0,True,False,False,0,3,2020-11-09T18:27:41.477,35,,1.0
2020,9,2923,850,1,6405,13,47,5,2,0,0,0,0,0,0,True,False,False,0,2,2020-11-10T17:37:15.897,0,,0.0
2020,9,2924,15,25,7060,3,4,5,10,0,0,0,0,0,0,False,False,False,0,2,2021-03-02T14:07:43.027,0,,0.0
2020,9,2924,40,25,7060,13,19,6,41,0,0,0,0,0,0,False,False,False,0,2,2020-11-13T16:35:00.087,0,,0.0
2020,9,2924,50,25,7666,3,9,2,35,0,0,0,0,0,0,False,False,False,0,3,2020-11-09T11:16:11.103,0,,0.0
2020,9,2924,65,9,6436,2,4,4,6,6,0,6,0,6,0,False,False,False,0,3,2020-11-09T11:22:14.103,6,,0.0
2020,9,2924,70,9,322,2,9,6,28,32,4,31,1,31,0,False,False,False,0,3,2020-11-13T17:33:18.357,32,,1.0
2020,9,2924,95,9,6436,13,3,5,12,0,0,0,0,0,0,False,False,False,0,2,2020-11-09T11:32:09.56,0,,0.0
2020,9,2924,110,9,7183,2,16,4,1,1,0,1,0,1,0,False,False,False,0,1,2020-11-09T11:41:39.723,1,,0.0
2020,9,2924,130,25,4587,2,48,10,-4,-4,0,-4,0,-4,0,False,False,False,1,1,2020-11-09T11:46:31.373,-4,,0.0
2020,9,2924,140,25,7060,2,52,4,-1,6,7,6,0,6,0,False,False,False,0,2,2020-11-13T16:20:15.22,6,,0.0
2020,9,2924,155,9,6446,2,5,10,10,10,0,10,0,10,0,False,False,False,0,3,2020-11-09T11:55:45.833,10,,0.0
2020,9,2924,175,25,7666,2,2,10,10,14,4,14,0,14,0,False,False,False,0,2,2020-11-09T12:01:42.923,14,,0.0
2020,9,2924,180,25,7665,2,46,3,5,7,2,6,1,6,0,False,False,False,0,3,2020-11-09T12:04:22.303,7,,1.0
2020,9,2924,185,25,4583,2,13,4,3,5,2,5,0,5,0,False,False,False,0,3,2020-11-09T12:06:23.313,5,,0.0
2020,9,2924,190,25,7665,2,5,10,2,8,6,8,0,8,0,False,False,False,0,1,2020-11-13T16:46:23.53,8,,0.0
2020,9,2924,220,9,6436,13,18,5,-1,0,0,0,0,0,0,False,False,False,0,2,2020-11-13T16:36:52.903,0,,0.0
2020,9,2924,235,9,6446,2,5,6,16,16,0,16,0,16,0,True,False,False,0,3,2020-11-13T17:31:56.447,16,,0.0
2020,9,2924,245,9,6436,13,6,4,5,0,0,0,0,0,0,False,False,False,0,3,2020-11-13T16:30:25.52,0,,0.0
2020,9,2924,250,9,7816,2,24,2,20,20,0,20,0,20,6,False,False,False,0,3,2020-11-09T12:32:51.74,20,,0.0
2020,9,2924,275,25,7060,13,13,9,1,0,0,0,0,0,0,False,False,False,0,3,2021-03-02T13:51:38.757,0,,0.0
2020,9,2924,295,9,322,2,26,9,4,4,0,4,0,4,0,False,False,False,0,3,2020-11-09T12:46:04.647,4,,0.0
2020,9,2924,310,25,4583,2,39,4,5,8,3,5,3,5,0,False,False,False,0,3,2020-11-09T12:49:25.9,8,,3.0
2020,9,2924,315,25,7666,2,5,5,8,9,1,9,0,9,0,False,False,False,0,3,2020-11-09T12:51:07.093,9,,0.0
2020,9,2924,320,25,7060,2,6,4,3,13,10,8,5,8,0,False,False,False,0,3,2020-11-13T16:49:08.267,13,,5.0
2020,9,2924,330,25,7666,13,8,1,42,0,0,0,0,0,0,False,False,False,0,2,2020-11-13T16:31:44.473,0,,0.0
2020,9,2924,335,25,7060,2,13,10,0,4,4,4,0,4,0,False,False,False,1,2,2021-01-12T23:43:47.283,4,,0.0
2020,9,2924,345,25,609,2,5,5,9,9,0,9,0,9,0,False,False,False,0,4,2020-11-09T13:04:37.077,9,,0.0
2020,9,2924,350,25,7666,2,5,3,10,10,0,10,0,10,0,False,False,False,0,2,2020-11-09T13:06:21.627,10,,0.0
2020,9,2924,355,25,609,2,47,5,1,5,4,5,0,5,0,False,False,False,0,3,2020-11-09T13:07:44.067,5,,0.0
2020,9,2924,360,25,6486,2,20,2,17,17,0,17,0,17,6,False,False,False,0,2,2020-11-09T13:10:07.26,17,,0.0
2020,9,2924,375,9,6446,2,6,1,15,20,5,15,5,15,0,False,False,False,0,4,2020-11-13T17:20:28.563,20,,
2020,9,2924,380,9,7816,2,4,10,10,14,4,14,0,14,0,False,True,True,0,3,2020-11-09T13:21:45.537,14,False,0.0
2020,9,2924,385,25,7666,2,47,5,2,1,-1,1,0,1,0,False,False,False,0,3,2020-11-09T13:27:02.737,1,,0.0
2020,9,2924,390,25,4587,2,4,4,2,2,0,2,0,2,0,False,False,False,0,1,2020-11-09T17:14:30.827,2,,0.0
2020,9,2924,395,25,4583,2,12,1,16,18,2,18,0,18,0,False,False,False,0,3,2021-03-09T20:06:22.96,18,,
2020,9,2924,405,25,609,13,29,5,10,0,0,0,0,0,0,False,False,False,0,2,2020-11-13T16:31:59.65,0,,0.0
2020,9,2924,440,9,6436,2,2,10,10,10,0,10,0,10,0,False,False,False,0,2,2020-11-09T13:44:46.913,10,,0.0
2020,9,2924,455,9,6441,13,4,5,5,0,0,0,0,0,0,False,False,False,0,2,2020-11-09T13:49:54.413,0,,0.0
2020,9,2924,460,9,322,2,5,3,7,8,1,8,0,8,0,False,False,False,0,3,2020-11-09T13:51:24.54,8,,0.0
2020,9,2924,470,9,2568,2,53,9,-5,-4,1,-4,0,-4,0,False,False,False,0,4,2020-11-09T13:54:48.003,-4,,0.0
2020,9,2924,475,9,6436,13,9,2,27,0,0,0,0,0,0,False,False,False,0,2,2020-11-09T13:56:17.367,0,,0.0
2020,9,2924,480,9,6446,13,32,10,3,0,0,0,0,0,0,False,False,False,0,3,2020-11-13T16:20:15.22,0,,0.0
2020,9,2924,495,25,181,2,46,3,2,2,0,2,0,2,0,False,False,False,0,4,2021-02-18T14:48:27.147,2,,0.0
2020,9,2924,505,25,6486,13,9,2,25,0,0,0,0,0,0,False,False,False,0,3,2021-03-15T17:05:22.96,0,,0.0
2020,9,2924,515,9,7183,13,6,10,5,0,0,0,0,0,0,False,False,False,0,2,2021-02-25T15:49:22.007,0,,0.0
2020,9,2924,535,9,4202,2,16,9,3,16,13,3,13,3,0,True,False,False,1,1,2020-11-11T01:04:14.793,16,,13.0
2020,9,2924,545,9,6446,2,4,3,6,8,2,6,2,6,0,False,False,False,0,2,2020-11-09T14:19:37.24,8,,2.0
2020,9,2924,550,9,7816,2,5,10,5,5,0,5,0,5,0,False,False,False,0,3,2020-11-13T17:30:37.587,5,,0.0
2020,9,2924,580,25,4583,2,51,5,-2,20,22,10,10,10,0,False,False,False,1,3,2020-11-13T16:53:31.357,20,,10.0
2020,9,2924,585,25,609,13,13,5,3,0,0,0,0,0,0,False,False,False,0,3,2020-11-13T16:36:05.713,0,,0.0
2020,9,2924,590,25,7666,3,5,3,10,0,0,0,0,0,0,False,False,False,0,3,2020-11-09T17:10:15.98,0,,0.0
2020,9,2924,595,25,4583,2,2,10,12,20,8,18,2,18,0,False,False,False,0,3,2020-11-09T14:35:59.803,20,,2.0
2020,9,2924,600,25,7666,13,19,6,38,0,0,0,0,0,0,False,False,False,0,3,2020-11-09T14:38:21.593,0,,
2020,9,2924,605,25,609,2,32,9,1,1,0,1,0,1,0,False,False,False,0,4,2021-02-26T19:43:10.82,1,,
2020,9,2924,610,25,4583,2,5,3,9,9,0,9,0,9,0,False,False,False,0,3,2020-11-13T16:20:15.22,9,,0.0
2020,9,2924,620,25,4583,2,23,1,23,31,8,26,5,26,6,False,False,False,0,3,2020-11-09T14:49:10.567,31,,5.0
2020,9,2924,635,9,6446,2,4,4,9,14,5,14,0,14,0,False,False,False,0,3,2020-11-13T17:22:29.467,14,,0.0
2020,9,2924,655,9,2568,13,4,3,5,0,0,0,0,0,0,True,False,False,0,3,2020-11-11T01:04:26.86,0,,0.0
2020,9,2924,665,25,7060,3,46,3,1,0,0,0,0,0,0,False,False,False,0,3,2021-02-18T14:50:45.25,0,,0.0
2020,9,2924,670,25,6259,2,46,3,2,8,6,8,0,8,0,False,False,False,0,3,2020-11-09T15:14:30.747,8,,0.0
2020,9,2924,675,25,7666,2,52,10,0,7,7,3,4,3,0,False,False,False,0,3,2021-03-04T17:23:50.86,7,,4.0
2020,9,2924,680,25,6259,2,18,3,-1,8,9,8,0,8,0,False,False,False,0,2,2020-11-13T16:20:15.22,8,,0.0
2020,9,2924,685,25,7060,2,46,3,1,9,8,6,3,6,0,False,False,False,0,3,2020-11-09T15:19:18.393,9,,3.0
2020,9,2924,690,25,7666,2,13,9,2,14,12,8,6,8,0,False,False,False,0,3,2020-11-09T15:21:41.573,14,,6.0
2020,9,2924,705,25,609,13,6,4,4,0,0,0,0,0,0,False,False,False,0,3,2020-11-13T16:39:13.343,0,,0.0
2020,9,2924,710,25,7060,2,18,5,-1,3,4,3,0,3,0,False,False,False,0,2,2020-11-13T16:20:15.22,3,,0.0
2020,9,2924,715,25,7666,13,8,10,10,0,0,0,0,0,0,False,False,False,0,2,2020-11-09T15:36:15.38,0,,0.0
2020,9,2924,730,9,6446,13,4,10,10,0,0,0,0,0,0,False,False,False,0,3,2020-11-09T15:39:01.36,0,,0.0
2020,9,2924,735,9,322,2,5,5,9,9,0,9,0,9,0,False,False,False,0,3,2020-11-09T15:40:05.483,9,,0.0
2020,9,2924,755,9,322,13,5,5,7,0,0,0,0,0,0,False,False,False,0,3,2020-11-09T15:45:49.927,0,,0.0
2020,9,2924,765,25,4583,13,47,5,0,0,0,0,0,0,0,False,False,False,0,3,2020-11-09T15:47:54.657,0,,0.0
2020,9,2924,770,25,7666,3,5,5,9,0,0,0,0,0,0,False,False,False,0,3,2021-02-18T14:51:30.65,0,,0.0
2020,9,2924,775,25,7666,13,17,8,31,0,0,0,0,0,0,False,False,False,0,3,2021-02-18T14:52:11.88,0,,
2020,9,2924,780,25,7666,2,18,5,0,9,9,9,0,9,0,False,False,False,0,2,2020-11-13T16:20:15.22,9,,0.0
2020,9,2924,785,25,7060,2,5,3,9,42,33,12,30,12,0,False,False,False,2,3,2021-03-03T14:39:30.393,42,,30.0
2020,9,2924,790,25,7666,2,49,5,-2,5,7,5,0,5,0,False,False,False,0,2,2020-11-09T15:59:44.92,5,,0.0
2020,9,2924,795,25,609,2,46,3,2,8,6,8,0,8,6,False,False,False,1,3,2020-11-09T16:01:26.293,8,,0.0
2020,9,2924,810,9,322,2,2,9,7,14,7,8,6,8,0,False,False,False,1,2,2021-03-03T14:39:53.813,14,,6.0
2020,9,2924,820,9,6446,13,5,3,10,0,0,0,0,0,0,False,False,False,0,3,2020-11-13T16:33:01.8,0,,0.0
2020,9,2924,825,9,7816,13,35,2,19,0,0,0,0,0,0,False,False,False,0,3,2020-11-13T17:29:50.857,0,,0.0
2020,9,2924,830,9,4202,2,12,10,0,2,2,0,2,0,0,True,False,False,0,1,2021-03-08T21:03:00.043,2,,2.0
2020,9,2924,875,9,7816,2,12,6,32,32,0,32,0,32,0,False,False,False,0,3,2021-03-08T21:03:17.213,32,,0.0
2020,9,2924,880,9,7816,13,35,1,19,0,0,0,0,0,0,False,False,False,0,3,2020-11-13T16:33:35.543,0,,0.0
2020,9,2924,885,9,4202,3,5,3,11,0,0,0,0,0,0,False,False,False,0,3,2020-11-09T16:27:06.747,0,,0.0
2020,9,2924,890,9,6436,2,6,8,16,20,4,20,0,20,0,False,False,False,0,2,2020-11-13T17:24:15.55,20,,0.0
2020,9,2924,905,9,6441,2,5,3,6,6,0,6,0,6,0,False,False,False,0,2,2020-11-13T17:24:59.167,6,,0.0
2020,9,2924,910,9,7816,13,19,1,23,0,0,0,0,0,0,False,False,False,0,3,2020-11-11T01:20:05.833,0,,0.0
2020,9,2925,10,30,4516,13,5,8,19,0,0,0,0,0,0,True,False,False,0,3,2020-11-13T19:55:42.11,0,,0.0
2020,9,2925,20,30,63,13,5,9,4,0,0,0,0,0,0,False,False,False,0,4,2020-11-09T11:38:11.597,0,,0.0
2020,9,2925,30,20,5140,2,45,5,-4,6,10,5,1,5,0,False,False,False,0,1,2020-11-13T20:26:51.787,6,,1.0
2020,9,2925,35,20,3763,2,5,5,4,8,4,8,0,8,0,False,False,False,0,2,2020-11-09T11:42:55.393,8,,0.0
2020,9,2925,40,20,1162,2,12,5,11,11,0,11,0,11,0,False,False,False,1,4,2020-11-13T18:48:51.63,11,,0.0
2020,9,2925,45,20,8131,2,4,10,4,6,2,5,1,5,0,False,False,False,0,3,2020-11-13T19:26:35.91,6,,1.0
2020,9,2925,55,20,958,2,35,9,14,19,5,17,2,17,0,False,False,False,0,4,2020-11-09T11:55:34.56,19,,2.0
2020,9,2925,65,20,5140,13,5,3,5,0,0,0,0,0,0,False,False,False,0,4,2020-11-13T20:25:38.45,0,,0.0
2020,9,2925,70,20,6388,2,9,5,14,14,0,14,0,14,6,False,False,False,0,3,2020-11-09T18:03:21.973,14,,0.0
2020,9,2925,85,30,4516,13,11,2,30,0,0,0,0,0,0,False,False,False,0,3,2021-03-08T15:50:43.7,0,,0.0
2020,9,2925,95,30,6414,2,4,9,5,5,0,5,0,5,0,False,False,False,0,3,2020-11-09T12:11:43.6,5,,0.0
2020,9,2925,100,30,6414,2,51,10,-5,4,9,1,3,1,0,False,False,False,0,1,2020-11-09T12:13:38.943,4,,3.0
2020,9,2925,110,20,7353,2,5,7,15,40,25,16,24,16,0,False,False,False,3,3,2021-03-03T14:54:59.493,40,,24.0
2020,9,2925,120,20,3763,2,39,4,3,5,2,5,0,5,0,False,False,False,0,2,2020-11-13T19:33:24.083,5,,0.0
2020,9,2925,125,20,306,2,28,9,0,2,2,2,0,2,0,False,False,False,0,1,2020-11-13T20:24:15.983,2,,0.0
2020,9,2925,140,20,958,2,6,4,9,11,2,10,1,10,0,False,True,True,0,3,2020-11-09T12:33:27.68,11,,1.0
2020,9,2925,150,30,37,13,8,1,44,0,0,0,0,0,0,False,False,False,0,3,2020-11-13T20:32:30.823,0,,0.0
2020,9,2925,155,30,63,3,5,5,10,0,0,0,0,0,0,False,False,False,0,4,2020-11-13T20:33:06.277,0,,0.0
2020,9,2925,170,20,3763,2,5,9,5,8,3,7,1,7,0,False,False,False,0,3,2020-11-09T13:06:58.34,8,,1.0
2020,9,2925,185,20,7888,2,36,10,7,7,0,7,0,7,6,False,False,False,0,4,2020-11-10T00:59:56.927,7,,0.0
2020,9,2925,205,30,7268,13,5,5,8,0,0,0,0,0,0,False,False,False,0,2,2020-11-13T20:33:38.383,0,,0.0
2020,9,2925,210,30,4516,2,6,9,4,7,3,5,2,5,0,False,False,False,0,3,2020-11-09T13:31:16.88,7,,2.0
2020,9,2925,230,20,5140,2,48,9,-7,-6,1,-7,1,-7,0,False,False,False,1,1,2021-03-03T14:55:44.613,-6,,1.0
2020,9,2925,235,20,4535,2,35,7,18,21,3,20,1,20,0,False,False,False,0,3,2020-11-09T13:42:31.403,21,,1.0
2020,9,2925,250,20,213,2,22,9,12,12,0,12,0,12,6,False,False,False,0,2,2020-11-13T20:06:49.783,12,,0.0
2020,9,2925,265,30,7893,2,2,9,10,11,1,10,1,10,0,False,False,False,0,2,2020-11-09T13:49:23.153,11,,1.0
2020,9,2925,270,30,6414,13,48,9,-4,0,0,0,0,0,0,False,False,False,0,1,2021-03-05T14:45:13.78,0,,0.0
2020,9,2925,275,20,3763,13,29,5,13,0,0,0,0,0,0,False,False,False,0,2,2021-02-25T15:52:04.16,0,,0.0
2020,9,2925,285,20,213,2,13,10,5,9,4,7,2,7,0,False,False,False,0,3,2020-11-13T18:55:20.217,9,,2.0
2020,9,2925,310,30,4516,2,8,7,19,20,1,19,1,19,0,False,False,False,0,2,2020-11-13T20:09:09.923,20,,1.0
2020,9,2925,315,30,4937,2,44,3,-2,7,9,3,4,3,0,False,False,False,1,1,2020-11-13T20:09:43.49,7,,4.0
2020,9,2925,325,30,37,2,46,3,4,6,2,6,0,6,0,True,False,False,0,3,2020-11-13T19:41:04.64,6,,0.0
2020,9,2925,330,30,4937,2,44,3,-3,2,5,0,2,0,0,True,False,False,0,1,2020-11-09T14:17:31.13,2,,2.0
2020,9,2925,335,30,63,2,47,5,0,2,2,1,1,1,0,False,False,False,0,4,2020-11-09T14:19:04.537,2,,1.0
2020,9,2925,345,30,4516,3,13,10,4,0,0,0,0,0,0,False,False,False,0,3,2020-11-13T20:35:12.02,0,,0.0
2020,9,2925,350,30,63,13,36,2,35,0,0,0,0,0,0,False,False,False,0,3,2020-11-13T20:35:19.093,0,,0.0
2020,9,2925,360,20,3763,2,8,1,16,20,4,16,4,16,0,False,False,False,1,2,2020-11-13T20:10:47.433,20,,4.0
2020,9,2925,370,20,213,2,6,10,12,12,0,12,0,12,0,False,False,False,0,3,2020-11-13T18:33:57.833,12,,0.0
2020,9,2925,375,20,213,13,26,5,1,0,0,0,0,0,0,False,False,False,0,3,2020-11-09T14:35:44.42,0,,0.0
2020,9,2925,380,20,7888,2,38,4,1,3,2,3,0,3,0,False,False,False,0,4,2020-11-13T20:11:56.863,3,,0.0
2020,9,2925,390,20,958,13,6,9,9,0,0,0,0,0,0,False,False,False,0,3,2020-11-13T20:36:19.94,0,,0.0
2020,9,2925,405,30,37,2,4,10,10,10,0,10,0,10,0,False,False,False,0,2,2020-11-13T20:12:07.66,10,,0.0
2020,9,2925,410,30,793,2,6,10,12,22,10,20,2,20,0,False,False,False,0,3,2020-11-13T20:12:27.82,22,,2.0
2020,9,2925,415,30,37,13,4,2,28,0,0,0,0,0,0,False,False,False,0,2,2020-11-10T01:00:49.303,0,,0.0
2020,9,2925,445,20,213,2,5,5,5,5,0,5,0,5,0,False,False,False,0,3,2020-11-13T18:45:44.07,5,,0.0
2020,9,2925,455,20,8131,2,5,3,4,5,1,5,0,5,0,False,False,False,0,2,2020-11-09T15:11:40.067,5,,0.0
2020,9,2925,470,30,6414,2,44,9,-5,0,5,0,0,0,0,False,False,False,0,1,2020-11-13T19:45:49.183,0,,0.0
2020,9,2925,475,30,793,2,5,10,12,12,0,12,0,12,0,False,False,False,0,3,2020-11-09T15:26:36.267,12,,0.0
2020,9,2925,480,30,63,13,4,10,9,0,0,0,0,0,0,False,False,False,0,4,2020-11-13T20:37:11.443,0,,
2020,9,2925,485,30,793,13,9,5,1,0,0,0,0,0,0,False,False,False,0,2,2020-11-13T19:46:27.353,0,,0.0
2020,9,2925,495,30,63,13,35,4,1,0,0,0,0,0,0,False,False,False,0,4,2020-11-13T20:37:43.6,0,,0.0
2020,9,2925,500,30,793,13,29,3,1,0,0,0,0,0,0,False,False,False,0,2,2020-11-09T15:39:32.573,0,,0.0
2020,9,2925,505,20,6388,13,5,5,7,0,0,0,0,0,0,True,False,False,0,3,2020-11-09T15:41:33.1,0,,0.0
2020,9,2925,515,20,3763,2,5,5,6,10,4,6,4,6,0,False,False,False,1,3,2021-03-03T14:56:04.14,10,,4.0
2020,9,2925,530,20,5140,2,48,10,-6,-5,1,-5,0,-5,0,False,False,False,0,1,2021-02-18T15:33:05.823,-5,,0.0
2020,9,2925,535,20,5140,2,44,3,3,5,2,4,1,4,0,False,False,False,0,1,2020-11-13T20:13:08.627,5,,1.0
2020,9,2925,545,30,4937,2,46,3,2,4,2,4,0,4,0,False,False,False,0,1,2020-11-09T15:59:36.153,4,,0.0
2020,9,2925,550,30,37,2,2,9,9,15,6,12,3,12,0,False,False,False,0,2,2020-11-09T16:01:29.36,15,,3.0
2020,9,2925,555,30,4937,2,46,3,1,2,1,1,1,1,0,False,False,False,0,1,2020-11-13T20:13:59.493,2,,1.0
2020,9,2925,560,30,7268,2,4,3,11,10,-1,10,0,10,0,False,False,False,0,2,2020-11-09T16:09:45.19,10,,0.0
2020,9,2925,580,30,793,2,4,8,16,16,0,16,0,16,0,False,False,False,0,2,2020-11-12T17:31:47.967,16,,0.0
2020,9,2925,590,30,63,13,35,9,13,0,0,0,0,0,0,False,False,False,0,3,2020-11-09T16:20:48.457,0,,0.0
2020,9,2925,610,20,7888,2,13,3,4,29,25,27,2,27,0,False,False,False,0,4,2020-11-10T01:25:24.697,29,,2.0
2020,9,2925,620,20,5140,2,44,3,2,9,7,5,4,5,0,True,False,False,0,1,2020-11-10T15:51:06.873,9,,4.0
2020,9,2925,630,20,306,2,28,5,-4,1,5,1,0,1,0,False,False,False,0,1,2021-02-18T15:36:15.463,1,,0.0
2020,9,2925,660,20,1162,2,2,9,3,3,0,3,0,3,6,False,False,False,0,2,2020-11-09T17:06:52.197,3,,0.0
2020,9,2925,675,30,793,2,6,9,13,14,1,14,0,14,0,False,False,False,0,2,2020-11-12T17:33:12.057,14,,0.0
2020,9,2925,680,30,4937,2,31,3,-1,6,7,0,6,0,0,False,False,False,0,1,2020-11-13T20:15:23.603,6,,6.0
2020,9,2925,685,30,2290,13,6,9,14,0,0,0,0,0,0,False,False,False,0,4,2020-11-13T20:15:43.373,0,,
2020,9,2925,690,30,4937,2,32,9,-1,20,21,16,4,16,0,False,False,False,0,1,2020-11-09T17:17:55.047,20,,4.0
2020,9,2925,705,30,4516,2,4,4,14,14,0,14,0,14,0,False,False,False,0,3,2020-11-09T17:24:06.853,14,,0.0
2020,9,2925,730,20,568,2,46,3,0,12,12,10,2,10,0,False,False,False,0,1,2020-11-13T20:15:56.793,12,,2.0
2020,9,2926,25,22,2391,2,12,10,3,5,2,5,0,5,0,False,False,False,0,4,2021-03-08T21:08:47.49,5,,0.0
2020,9,2926,30,22,7610,2,2,9,10,26,16,14,12,14,0,False,False,False,1,2,2020-11-10T11:17:18.483,26,,12.0
2020,9,2926,45,22,256,2,4,10,3,5,2,4,1,4,0,False,False,False,0,3,2020-11-10T11:25:48.173,5,,1.0
2020,9,2926,60,22,256,13,19,6,17,0,0,0,0,0,0,False,False,False,0,2,2021-02-18T15:45:18.957,0,,0.0
2020,9,2926,85,19,7175,2,39,4,5,9,4,6,3,6,0,True,False,False,0,3,2020-11-12T00:00:17.51,9,,3.0
2020,9,2926,95,19,1510,2,28,4,4,5,1,5,0,5,0,False,False,False,0,1,2020-11-10T16:50:55.207,5,,0.0
2020,9,2926,100,19,3233,2,4,3,8,8,0,8,0,8,0,False,False,False,0,2,2020-11-10T11:49:47.087,8,,0.0
2020,9,2926,105,19,7175,2,7,8,25,33,8,28,5,28,0,True,False,False,0,3,2020-11-13T20:47:55.823,33,,5.0
2020,9,2926,125,22,1113,2,12,10,4,5,1,5,0,5,0,False,False,False,0,1,2021-03-08T21:09:05.73,5,,0.0
2020,9,2926,130,22,7610,13,6,4,11,0,0,0,0,0,0,False,False,False,0,2,2020-11-10T16:46:43.32,0,,0.0
2020,9,2926,135,22,7609,2,46,3,2,11,9,9,2,9,0,True,False,False,0,1,2020-11-12T00:00:41.533,11,,2.0
2020,9,2926,155,22,7610,2,13,3,4,4,0,4,0,4,0,False,False,False,0,3,2020-11-10T12:15:32.857,4,,0.0
2020,9,2926,175,19,7175,2,5,5,10,11,1,11,0,11,0,False,False,False,0,2,2020-11-10T12:23:51.21,11,,0.0
2020,9,2926,190,19,1328,2,4,4,3,4,1,3,1,3,0,False,False,False,0,1,2020-11-13T19:26:01.163,4,,1.0
2020,9,2926,210,22,6270,2,47,5,3,13,10,9,4,9,0,False,False,False,0,1,2021-02-18T15:46:14.697,13,,4.0
2020,9,2926,220,22,7610,2,4,8,17,17,0,17,0,17,0,False,False,False,0,3,2020-11-10T16:51:58.183,17,,0.0
2020,9,2926,225,22,256,2,21,8,40,50,10,48,2,48,6,False,False,False,0,3,2020-11-13T20:31:34.48,50,,2.0
2020,9,2926,260,19,1510,2,31,4,1,5,4,3,2,3,0,False,False,False,0,1,2020-11-10T13:01:38.823,5,,2.0
2020,9,2926,265,19,7175,2,2,4,4,5,1,5,0,5,0,True,False,False,0,3,2020-11-12T00:00:52.76,5,,0.0
2020,9,2926,275,22,2391,2,35,10,11,23,12,16,7,16,0,True,False,False,0,4,2020-11-12T00:01:03.757,23,,7.0
2020,9,2926,285,22,7610,13,35,9,13,0,0,0,0,0,0,False,False,False,0,3,2021-02-18T15:46:49.21,0,,0.0
2020,9,2926,295,22,7610,13,21,8,32,0,0,0,0,0,0,False,False,False,0,2,2020-11-10T13:16:04.307,0,,0.0
2020,9,2926,310,19,7456,2,32,3,2,6,4,5,1,5,0,True,False,False,0,4,2021-02-18T15:47:20.9,6,,1.0
2020,9,2926,315,19,7175,2,4,10,12,13,1,10,3,10,0,False,False,False,1,3,2020-11-13T20:24:42.593,13,,3.0
2020,9,2926,340,19,7175,2,6,7,15,15,0,15,0,15,0,False,False,False,0,3,2020-11-10T13:31:37.593,15,,0.0
2020,9,2926,345,19,7175,2,2,4,4,9,5,7,2,7,0,True,False,False,0,3,2020-11-12T00:01:28.797,9,,
2020,9,2926,350,19,3233,13,2,3,10,0,0,0,0,0,0,False,False,False,0,3,2020-11-13T20:35:47.623,0,,0.0
2020,9,2926,355,19,7177,2,50,10,-3,-1,2,-1,0,-1,0,False,False,False,0,3,2021-02-18T15:48:13.107,-1,,0.0
2020,9,2926,365,19,7175,2,13,4,2,7,5,4,3,4,0,False,False,False,1,3,2020-11-10T13:42:28.15,7,,3.0
2020,9,2926,385,22,7610,2,13,9,4,15,11,7,8,7,0,False,False,False,1,2,2020-11-13T20:25:02.21,15,,8.0
2020,9,2926,390,22,256,13,19,2,45,0,0,0,0,0,0,False,False,False,0,2,2020-11-10T13:50:19.01,0,,
2020,9,2926,395,22,3170,2,7,6,20,20,0,20,0,20,6,False,False,False,0,3,2020-11-10T14:02:11.983,20,,0.0
2020,9,2926,435,19,7175,2,6,7,15,20,5,20,0,20,0,True,False,False,0,3,2020-11-12T00:01:39.853,20,,0.0
2020,9,2926,445,19,3233,2,4,3,6,8,2,8,0,8,0,False,False,False,0,2,2020-11-10T14:13:38.693,8,,0.0
2020,9,2926,465,19,7456,2,47,10,-1,0,1,-1,1,-1,0,False,False,False,0,1,2020-11-10T14:21:27.71,0,,1.0
2020,9,2926,470,19,7175,2,46,3,0,6,6,6,0,6,0,False,False,False,0,3,2020-11-13T20:25:14.193,6,,0.0
2020,9,2926,500,22,1113,2,28,4,1,8,7,7,1,7,0,False,False,False,0,1,2020-11-13T20:36:47.58,8,,1.0
2020,9,2926,510,22,3170,2,13,10,3,6,3,4,2,4,0,False,False,False,0,3,2020-11-10T14:35:55.143,6,,2.0
2020,9,2926,525,22,256,2,35,9,14,19,5,19,0,19,0,False,False,False,0,3,2020-11-13T20:25:28.7,19,,0.0
2020,9,2926,540,22,256,2,16,4,6,12,6,8,4,8,0,False,False,False,0,3,2020-11-10T14:52:24.03,12,,4.0
2020,9,2926,555,22,256,2,9,2,15,15,0,15,0,15,6,False,False,False,0,2,2020-11-13T20:40:30.82,15,,0.0
2020,9,2926,580,19,1510,2,48,4,0,1,1,0,1,0,0,False,False,False,0,1,2020-11-11T23:59:35.58,1,,1.0
2020,9,2926,585,19,3233,2,4,3,9,10,1,9,1,9,0,False,False,False,0,2,2020-11-13T20:41:17.82,10,,1.0
2020,9,2926,590,19,3233,13,19,6,39,0,0,0,0,0,0,False,False,False,0,2,2021-02-18T15:56:54.377,0,,0.0
2020,9,2926,595,19,7175,2,12,9,6,11,5,9,2,9,0,True,False,False,1,3,2020-11-12T00:01:51.037,11,,2.0
2020,9,2926,630,19,3233,2,4,5,5,8,3,7,1,7,0,False,False,False,0,2,2020-11-10T15:21:53.743,8,,1.0
2020,9,2926,655,19,1328,2,6,10,1,4,3,2,2,2,0,False,False,False,0,1,2020-11-13T20:43:53.527,4,,2.0
2020,9,2926,675,22,7610,13,8,1,54,0,0,0,0,0,0,False,False,False,0,3,2021-03-05T14:46:59.323,0,,0.0
2020,9,2926,680,19,3233,13,12,3,1,0,0,0,0,0,0,False,False,False,0,2,2020-11-10T15:47:32.94,0,,0.0
2020,9,2926,685,19,7175,13,8,7,35,0,0,0,0,0,0,False,False,False,0,3,2020-11-13T19:26:01.163,0,,0.0
2020,9,2926,690,19,7175,13,5,10,14,0,0,0,0,0,0,False,False,False,0,3,2021-02-25T15:56:15.59,0,,
2020,9,2926,705,19,7175,13,6,1,17,0,0,0,0,0,0,False,False,False,0,2,2021-02-18T15:58:08.697,0,,0.0
2020,9,2926,710,19,3233,13,5,2,15,0,0,0,0,0,0,False,False,False,0,2,2020-11-13T20:45:08.18,0,,0.0
2020,9,2926,715,19,7175,2,6,8,19,19,0,19,0,19,0,False,False,False,0,2,2020-11-10T16:52:57.767,19,,0.0
2020,9,2926,725,19,3233,2,4,5,11,31,20,31,0,31,0,False,False,False,0,2,2020-11-10T16:09:38.91,31,,0.0
2020,9,2926,760,22,7609,2,28,4,3,8,5,5,3,5,0,False,False,False,0,1,2020-11-10T16:16:56.883,8,,3.0
2020,9,2926,770,22,256,13,35,6,18,0,0,0,0,0,0,False,False,False,0,3,2020-11-11T05:31:01.337,0,,0.0
2020,9,2926,780,19,1328,13,28,9,0,0,0,0,0,0,0,False,False,False,0,1,2021-02-18T15:59:13.687,0,,0.0
2020,9,2926,785,19,1328,2,48,9,-4,11,15,11,0,11,0,False,False,False,0,1,2020-11-10T16:26:58.473,11,,0.0
2020,9,2926,805,19,1328,2,48,4,-7,5,12,-6,11,-6,0,False,False,False,1,1,2020-11-13T20:26:55.243,5,,11.0
2020,9,2926,825,19,7175,2,6,2,20,20,0,20,0,20,0,False,False,False,0,2,2020-11-10T16:49:23.28,20,,0.0
2020,10,2927,10,31,6888,2,47,10,1,13,12,12,1,12,0,True,False,False,0,1,2020-11-20T15:34:37.093,13,,1.0
2020,10,2927,15,31,6793,2,6,4,12,21,9,18,3,18,0,False,False,False,0,2,2020-11-13T12:26:58.56,21,,3.0
2020,10,2927,30,31,5080,2,2,5,6,20,14,16,4,16,0,False,False,False,0,2,2020-11-13T12:35:38.997,20,,4.0
2020,10,2927,35,31,4844,2,47,5,3,5,2,5,0,5,6,False,False,False,0,1,2020-11-20T15:03:15.133,5,,0.0
2020,10,2927,50,14,7582,2,46,3,-1,11,12,9,2,9,0,True,False,False,0,1,2020-11-14T20:11:55.427,11,,2.0
2020,10,2927,55,14,7584,2,6,10,4,5,1,5,0,5,0,False,False,False,0,2,2020-11-13T12:53:23.737,5,,0.0
2020,10,2927,85,14,1114,2,4,5,7,12,5,6,6,6,0,False,False,False,1,2,2020-11-15T01:18:44.887,12,,6.0
2020,10,2927,90,14,5197,2,4,10,5,6,1,5,1,5,0,False,False,False,0,2,2020-11-13T13:09:10.847,6,,1.0
2020,10,2927,100,14,7584,13,3,5,13,0,0,0,0,0,0,False,False,False,0,2,2020-11-18T17:55:59.737,0,,0.0
2020,10,2927,115,31,5096,2,4,9,5,8,3,8,0,8,0,True,False,False,0,4,2020-11-14T18:26:50.193,8,,0.0
2020,10,2927,125,31,6793,3,9,6,30,0,0,0,0,0,0,False,False,False,0,3,2020-11-20T14:56:02.13,0,,0.0
2020,10,2927,145,14,1114,2,4,3,3,9,6,9,0,9,0,False,False,False,0,2,2020-11-13T13:41:06.513,9,,0.0
2020,10,2927,155,14,895,2,4,4,6,9,3,7,2,7,0,False,False,False,0,3,2020-11-20T15:43:54.413,9,,2.0
2020,10,2927,165,14,4449,2,13,10,4,18,14,8,10,8,0,False,False,False,0,3,2020-11-13T13:48:18.083,18,,10.0
2020,10,2927,170,14,4449,13,7,3,13,0,0,0,0,0,0,True,False,False,0,3,2020-11-13T13:49:56.883,0,,0.0
2020,10,2927,175,14,7584,2,5,5,6,7,1,7,0,7,0,False,False,False,0,3,2020-11-13T13:51:23.86,7,,0.0
2020,10,2927,180,14,6546,3,2,5,3,0,0,0,0,0,0,False,False,False,0,2,2020-11-13T13:52:58.44,0,,0.0
2020,10,2927,210,31,6724,2,13,9,2,5,3,3,2,3,0,True,False,False,0,3,2020-11-20T15:44:12.333,5,,2.0
2020,10,2927,225,31,5080,13,35,5,12,0,0,0,0,0,0,True,False,False,0,3,2020-11-14T18:27:23.423,0,,0.0
2020,10,2927,235,31,6390,2,51,5,0,3,3,3,0,3,0,False,False,False,0,3,2020-11-13T14:07:50.027,3,,0.0
2020,10,2927,250,14,6543,2,48,10,-7,11,18,5,6,5,0,False,False,False,0,1,2020-11-13T14:15:29.373,11,,6.0
2020,10,2927,255,14,6543,13,2,10,4,0,0,0,0,0,0,False,False,False,0,3,2020-11-20T16:02:02.667,0,,0.0
2020,10,2927,265,14,7584,2,35,7,21,30,9,26,4,26,0,False,False,False,0,3,2020-11-20T15:36:18.083,30,,4.0
2020,10,2927,270,14,5197,13,5,9,4,0,0,0,0,0,0,False,False,False,0,4,2020-11-20T15:59:42.34,0,,0.0
2020,10,2927,275,14,7582,2,48,9,-5,14,19,7,7,7,0,False,False,False,1,1,2021-03-03T14:58:50.397,14,,7.0
2020,10,2927,285,14,6543,2,5,3,2,13,11,8,5,8,6,False,False,False,0,1,2020-11-20T15:45:10.01,13,,5.0
2020,10,2927,300,31,3504,2,48,3,-5,6,11,-1,7,-1,0,False,False,False,0,1,2020-11-13T14:42:16.153,6,,7.0
2020,10,2927,310,31,3504,13,44,3,-2,0,0,0,0,0,0,False,False,False,0,1,2020-11-13T18:04:07.35,0,,0.0
2020,10,2927,325,31,6793,13,2,9,8,0,0,0,0,0,0,False,False,False,0,2,2020-11-20T16:00:25.597,0,,0.0
2020,10,2927,335,31,5080,2,35,7,17,18,1,17,1,17,0,True,False,False,0,3,2020-11-13T17:52:52.477,18,,1.0
2020,10,2927,345,31,6390,13,9,2,18,0,0,0,0,0,0,False,False,False,0,3,2020-11-15T01:28:46.09,0,,
2020,10,2927,355,31,6793,13,13,10,2,0,0,0,0,0,0,False,False,False,0,3,2020-11-13T17:57:16.767,0,,
2020,10,2927,375,14,1114,2,4,10,7,11,4,11,0,11,0,False,False,False,0,2,2020-11-13T15:08:48.993,11,,0.0
2020,10,2927,390,14,4449,2,32,10,0,3,3,1,2,1,0,False,False,False,0,3,2020-11-13T18:01:20.35,3,,2.0
2020,10,2927,395,14,8165,2,29,6,18,21,3,20,1,20,0,False,False,False,0,3,2020-11-13T15:19:42.27,21,,1.0
2020,10,2927,400,14,6543,2,4,9,2,8,6,4,4,4,0,False,False,False,0,1,2020-11-20T15:45:40.03,8,,4.0
2020,10,2927,415,14,1114,2,4,3,3,8,5,8,0,8,0,False,False,False,0,2,2020-11-20T15:45:53.33,8,,0.0
2020,10,2927,420,14,1114,13,22,2,22,0,0,0,0,0,0,False,False,False,0,2,2020-11-20T15:46:41.45,0,,0.0
2020,10,2927,425,14,6543,2,48,9,-6,11,17,9,2,9,0,False,False,False,0,1,2020-11-13T18:04:42.803,11,,2.0
2020,10,2927,435,14,6543,2,46,3,-1,2,3,2,0,2,0,False,False,False,0,1,2020-11-13T15:27:42.893,2,,0.0
2020,10,2927,465,14,895,2,4,9,9,14,5,12,2,12,0,False,False,False,0,3,2020-11-13T15:32:18.82,14,,2.0
2020,10,2927,485,14,4070,13,19,6,36,0,0,0,0,0,0,False,False,False,0,2,2020-11-13T15:37:27.983,0,,0.0
2020,10,2927,490,14,5197,2,13,9,5,11,6,9,2,9,0,False,False,False,0,3,2020-11-13T15:38:59.79,11,,2.0
2020,10,2927,495,14,4449,2,5,10,3,9,6,5,4,5,0,False,False,False,0,3,2020-11-13T15:40:08.863,9,,4.0
2020,10,2927,500,14,5197,2,47,10,2,2,0,2,0,2,0,False,False,False,0,4,2020-11-20T14:58:46.753,2,,0.0
2020,10,2927,510,14,7584,2,2,10,7,7,0,7,0,7,0,False,False,False,0,2,2020-11-13T15:45:33.043,7,,0.0
2020,10,2927,520,14,895,2,46,3,1,1,0,1,0,1,0,False,False,False,0,4,2020-11-13T15:52:40.393,1,,0.0
2020,10,2927,525,14,4449,2,34,4,-4,3,7,2,1,2,0,True,False,False,0,2,2020-11-13T15:55:37.667,3,,1.0
2020,10,2927,600,31,5096,13,7,2,17,0,0,0,0,0,0,True,False,False,0,4,2020-11-13T16:16:10.333,0,,0.0
2020,10,2927,610,31,6724,13,4,4,9,0,0,0,0,0,0,True,False,False,0,3,2020-11-15T01:25:16.9,0,,0.0
2020,10,2927,630,31,5096,2,13,4,6,6,0,6,0,6,0,False,False,False,0,4,2021-02-25T15:50:28.093,6,,0.0
2020,10,2927,655,31,6390,2,5,3,5,5,0,5,0,5,0,False,False,False,0,3,2020-11-13T16:44:28.927,5,,0.0
2020,10,2927,665,31,5096,13,11,5,10,0,0,0,0,0,0,False,False,False,0,4,2020-11-20T15:57:19.783,0,,0.0
2020,10,2927,675,31,6793,3,4,5,8,0,0,0,0,0,0,False,False,False,0,3,2020-11-13T16:56:01.07,0,,0.0
2020,10,2927,680,31,6724,13,6,4,13,0,0,0,0,0,0,False,False,False,0,3,2020-11-13T16:58:04.427,0,,0.0
2020,10,2927,695,14,7584,2,13,10,5,40,35,30,10,30,0,True,False,False,0,3,2020-11-15T01:29:47.557,40,,10.0
2020,10,2927,705,14,7584,2,13,9,4,6,2,5,1,5,0,False,False,False,0,3,2020-11-13T17:06:01.683,6,,1.0
2020,10,2927,730,31,5080,2,4,5,7,7,0,7,0,7,0,False,False,False,0,2,2020-11-13T17:52:26.46,7,,0.0
2020,10,2927,735,31,5080,2,4,5,4,4,0,4,0,4,0,False,False,False,0,2,2020-11-14T18:26:17.423,4,,0.0
2020,10,2927,740,31,4545,2,45,5,-5,8,13,8,0,8,0,False,False,False,0,1,2020-11-13T17:17:42.86,8,,0.0
2020,10,2927,755,31,5080,2,5,2,18,18,0,18,0,18,0,False,False,False,0,2,2020-11-13T17:52:07.763,18,,0.0
2020,10,2927,765,31,7913,3,13,10,4,0,0,0,0,0,0,False,False,False,0,2,2020-11-13T17:28:16.147,0,,0.0
2020,10,2927,770,31,5096,13,4,10,4,0,0,0,0,0,0,False,False,False,0,3,2020-11-13T17:30:20.92,0,,0.0
2020,10,2927,775,31,5096,13,7,5,12,0,0,0,0,0,0,False,False,False,0,3,2020-11-20T15:00:25.663,0,,0.0
2020,10,2927,800,14,7584,2,50,5,-1,6,7,0,6,0,0,False,False,False,1,2,2020-11-13T17:40:53.76,6,,6.0
2020,10,2928,10,5,3477,2,5,3,5,5,0,5,0,5,0,True,False,False,0,2,2020-11-19T15:07:26.197,5,,0.0
2020,10,2928,15,5,4719,2,30,10,-4,0,4,-2,2,-2,0,True,False,False,0,1,2020-11-16T14:20:55.34,0,,2.0
2020,10,2928,20,5,3477,2,13,10,1,2,1,1,1,1,0,True,False,False,0,3,2020-11-16T14:19:56.06,2,,1.0
2020,10,2928,35,30,6414,2,28,4,2,6,4,6,0,6,0,False,True,True,0,1,2020-11-16T13:30:33.26,6,,0.0
2020,10,2928,40,5,4803,2,5,5,5,5,0,5,0,5,0,False,False,False,0,3,2021-03-04T19:06:16.963,5,,0.0
2020,10,2928,45,5,4803,2,45,5,-4,-3,1,-3,0,-3,0,False,False,False,0,1,2020-11-16T14:20:22.697,-3,,0.0
2020,10,2928,55,5,3477,2,4,9,9,9,0,9,0,9,0,False,False,False,0,3,2020-11-16T14:20:34.03,9,,0.0
2020,10,2928,70,5,4419,2,7,5,7,7,0,7,0,7,6,False,False,False,0,4,2020-11-16T13:51:34.32,7,,0.0
2020,10,2928,85,30,4516,2,4,8,17,23,6,19,4,19,0,False,False,False,0,2,2020-11-16T13:56:50.79,23,,4.0
2020,10,2928,90,30,37,13,8,1,37,0,0,0,0,0,0,False,False,False,0,3,2020-11-19T16:43:28.933,0,,0.0
2020,10,2928,100,30,793,2,11,6,16,19,3,19,0,19,0,False,False,False,0,3,2020-11-16T14:05:31.973,19,,0.0
2020,10,2928,110,30,6414,13,28,9,0,0,0,0,0,0,0,False,False,False,0,1,2020-11-16T14:10:08.027,0,,0.0
2020,10,2928,115,30,4516,2,5,5,12,14,2,13,1,13,0,False,False,False,0,3,2020-11-16T14:12:20.85,14,,1.0
2020,10,2928,125,30,4937,2,46,3,-2,3,5,0,3,0,0,False,False,False,0,1,2020-11-16T14:19:30.203,3,,3.0
2020,10,2928,130,30,2290,2,5,3,5,5,0,5,0,5,6,False,False,False,0,3,2020-11-16T14:23:17.433,5,,0.0
2020,10,2928,145,5,4803,2,51,9,-5,6,11,6,0,6,0,True,False,False,0,1,2020-11-19T14:11:07.233,6,,0.0
2020,10,2928,155,5,5220,2,21,6,33,38,5,35,3,35,0,True,False,False,0,2,2021-02-18T17:37:01.84,38,,3.0
2020,10,2928,160,5,5220,2,50,3,-2,24,26,9,15,9,6,False,False,False,0,2,2020-11-16T19:58:48.86,24,,15.0
2020,10,2928,175,30,37,2,50,9,-1,3,4,1,2,1,0,False,False,False,0,2,2020-11-19T16:22:02.41,3,,2.0
2020,10,2928,190,30,37,2,2,9,6,9,3,6,3,6,0,False,False,False,0,2,2020-11-16T14:50:56.84,9,,3.0
2020,10,2928,210,30,4937,2,9,3,4,8,4,5,3,5,0,False,False,False,0,2,2021-02-25T15:53:27.09,8,,3.0
2020,10,2928,225,30,2290,2,5,3,7,7,0,7,0,7,0,False,False,False,0,4,2020-11-19T14:11:07.233,7,,0.0
2020,10,2928,235,30,37,2,26,5,-2,2,4,0,2,0,0,False,False,False,0,3,2020-11-16T15:11:56.003,2,,2.0
2020,10,2928,240,30,793,13,6,10,5,0,0,0,0,0,0,False,False,False,0,2,2020-11-16T15:13:18.4,0,,0.0
2020,10,2928,270,5,6425,2,39,9,6,7,1,7,0,7,0,False,False,False,0,4,2020-11-16T15:20:10.467,7,,0.0
2020,10,2928,275,5,3477,2,5,10,5,5,0,5,0,5,0,False,False,False,0,3,2020-11-17T20:13:55.177,5,,0.0
2020,10,2928,305,5,2554,2,28,5,-5,1,6,0,1,0,0,False,False,False,0,1,2020-11-16T15:36:16.913,1,,1.0
2020,10,2928,310,5,4803,13,11,3,9,0,0,0,0,0,0,False,False,False,0,3,2020-11-16T15:38:57.117,0,,0.0
2020,10,2928,330,30,4937,3,4,3,3,0,0,0,0,0,0,False,False,False,0,1,2020-11-16T19:25:22.17,0,,0.0
2020,10,2928,340,30,7268,2,18,5,-2,4,6,4,0,4,0,False,False,False,0,2,2020-11-16T15:46:15.383,4,,0.0
2020,10,2928,345,30,4516,2,4,4,14,15,1,14,1,14,0,False,False,False,0,3,2020-11-16T20:01:10.797,15,,1.0
2020,10,2928,350,30,793,13,7,6,19,0,0,0,0,0,0,False,False,False,0,2,2020-11-16T20:00:47.82,0,,0.0
2020,10,2928,355,30,37,2,4,10,9,16,7,11,5,11,0,False,False,False,0,3,2020-11-16T15:54:36.243,16,,5.0
2020,10,2928,370,30,63,2,9,6,18,44,26,20,24,20,0,False,False,False,1,4,2021-02-25T15:55:14.67,44,,24.0
2020,10,2928,380,30,793,2,6,9,3,3,0,3,0,3,6,False,False,False,0,2,2020-11-16T16:03:36.273,3,,0.0
2020,10,2928,395,5,5220,13,24,2,36,0,0,0,0,0,0,False,False,False,0,2,2020-11-16T20:01:36.487,0,,0.0
2020,10,2928,400,5,2554,2,47,5,-1,5,6,5,0,5,0,False,False,False,0,1,2020-11-16T16:16:16.667,5,,0.0
2020,10,2928,405,5,2554,3,32,5,1,0,0,0,0,0,0,False,False,False,0,4,2021-02-18T17:38:46.45,0,,0.0
2020,10,2928,430,30,793,2,5,9,4,6,2,3,3,3,0,False,False,False,0,3,2020-11-16T16:30:18.6,6,,3.0
2020,10,2928,440,30,37,2,13,10,5,6,1,6,0,6,0,False,False,False,0,2,2020-11-16T16:33:44.623,6,,0.0
2020,10,2928,445,30,4516,2,49,9,-1,31,32,1,30,1,0,False,False,False,1,2,2020-11-19T15:23:38.62,31,,30.0
2020,10,2928,460,30,793,13,6,10,7,0,0,0,0,0,0,False,False,False,0,2,2020-11-16T16:41:20.823,0,,0.0
2020,10,2928,465,30,793,13,2,10,6,0,0,0,0,0,0,False,False,False,0,2,2020-11-19T14:18:13.587,0,,0.0
2020,10,2928,490,5,5220,2,4,3,7,17,10,11,6,11,0,False,False,False,0,2,2020-11-16T16:52:52.187,17,,6.0
2020,10,2928,500,5,2554,2,45,10,-4,2,6,2,0,2,0,False,False,False,0,1,2020-11-16T16:56:43.963,2,,0.0
2020,10,2928,505,5,5220,13,26,9,4,0,0,0,0,0,0,False,False,False,0,3,2020-11-16T16:59:16.713,0,,0.0
2020,10,2928,530,5,5220,13,6,10,13,0,0,0,0,0,0,False,False,False,0,2,2021-03-05T14:49:10.047,0,,0.0
2020,10,2928,535,30,793,13,8,7,38,0,0,0,0,0,0,False,False,False,0,3,2020-11-16T19:26:38.397,0,,
2020,10,2928,545,30,4516,2,13,4,5,5,0,5,0,5,0,False,False,False,0,3,2020-11-16T19:26:51.717,5,,
2020,10,2928,550,30,63,13,8,1,42,0,0,0,0,0,0,False,False,False,0,4,2021-02-18T17:39:57.057,0,,0.0
2020,10,2928,555,30,2290,2,32,5,8,19,11,16,3,16,0,False,False,False,0,4,2020-11-16T17:19:10.607,19,,3.0
2020,10,2928,565,30,793,2,6,8,18,22,4,18,4,18,0,False,False,False,1,2,2020-11-16T17:24:14.207,22,,4.0
2020,10,2928,580,30,7893,13,6,9,3,0,0,0,0,0,0,False,False,False,0,3,2020-11-16T17:33:51.047,0,,0.0
2020,10,2928,615,5,3477,13,13,3,7,0,0,0,0,0,0,False,False,False,0,3,2021-02-25T15:56:37.877,0,,0.0
2020,10,2928,630,30,793,3,2,10,10,0,0,0,0,0,0,False,False,False,0,2,2021-03-02T15:43:07.443,0,,0.0
2020,10,2928,635,30,4516,2,13,10,4,6,2,5,1,5,0,True,False,False,0,3,2020-11-17T08:43:59.33,6,,1.0
2020,10,2928,645,30,793,2,13,4,1,14,13,4,10,4,0,False,False,False,0,3,2020-11-16T17:54:56.987,14,,10.0
2020,10,2928,705,30,37,2,5,5,8,8,0,8,0,8,0,False,False,False,0,3,2020-11-16T18:14:02.687,8,,0.0
2020,10,2928,710,30,4516,2,18,9,-1,3,4,-3,6,-3,0,False,False,False,1,2,2020-11-16T18:17:04.547,3,,6.0
2020,10,2928,720,30,37,2,5,5,4,25,21,23,2,23,0,False,False,False,0,3,2020-11-16T18:20:05.007,25,,2.0
2020,10,2928,730,30,793,2,18,5,1,13,12,5,8,5,0,False,False,False,0,2,2020-11-19T15:27:58.987,13,,8.0
2020,10,2928,750,5,8195,2,16,10,0,2,2,2,0,2,0,False,False,False,0,1,2020-11-16T18:30:36.677,2,,0.0
2020,10,2928,755,5,2554,2,28,10,-2,4,6,2,2,2,0,False,False,False,0,1,2020-11-19T14:11:07.233,4,,2.0
2020,10,2928,765,5,4719,2,12,3,-5,-5,0,-5,0,-5,0,True,False,False,0,1,2021-03-08T20:08:41.047,-5,,0.0
2020,10,2928,800,30,63,2,7,10,7,7,0,7,0,7,6,False,False,False,0,4,2020-11-16T18:49:37.71,7,,0.0
2020,10,2928,815,5,5220,2,5,2,17,17,0,17,0,17,0,False,False,False,0,2,2020-11-19T14:11:07.233,17,,0.0
2020,10,2928,820,5,4803,13,4,9,14,0,0,0,0,0,0,False,False,False,0,3,2020-11-16T18:57:26.827,0,,0.0
2020,10,2928,825,5,3477,13,19,2,33,0,0,0,0,0,0,False,False,False,0,2,2020-11-16T18:57:07.713,0,,0.0
2020,10,2929,20,8,232,2,4,3,5,9,4,6,3,6,0,False,False,False,0,2,2020-11-19T18:21:24.077,9,,3.0
2020,10,2929,30,8,3606,2,2,9,7,9,2,7,2,7,0,False,False,False,0,2,2020-11-16T18:19:27.37,9,,2.0
2020,10,2929,45,8,3606,13,5,6,18,0,0,0,0,0,0,False,False,False,0,3,2020-11-19T18:22:47.493,0,,
2020,10,2929,55,8,5053,2,44,3,0,6,6,4,2,4,0,False,False,False,0,1,2020-11-16T13:40:43.027,6,,2.0
2020,10,2929,80,13,3951,2,5,5,5,8,3,6,2,6,0,False,False,False,0,3,2020-11-19T18:23:44.833,8,,2.0
2020,10,2929,105,8,6633,13,5,3,7,0,0,0,0,0,0,False,False,False,0,3,2020-11-16T13:57:08.623,0,,0.0
2020,10,2929,125,13,3951,13,19,5,12,0,0,0,0,0,0,False,False,False,0,2,2021-03-17T19:18:45.747,0,,0.0
2020,10,2929,130,13,3951,2,12,5,12,12,0,12,0,12,0,False,False,False,0,3,2020-11-19T19:22:37.253,12,,0.0
2020,10,2929,140,13,876,2,5,3,5,7,2,7,0,7,0,False,False,False,0,3,2020-11-16T14:16:16.5,7,,0.0
2020,10,2929,150,13,3951,2,50,9,-4,10,14,7,3,7,0,False,False,False,0,3,2020-11-16T14:19:39.673,10,,3.0
2020,10,2929,160,13,496,2,45,5,-1,2,3,2,0,2,0,True,False,False,0,3,2020-11-16T14:23:38.663,2,,0.0
2020,10,2929,180,13,6528,2,4,4,5,5,0,5,0,5,0,False,False,False,0,4,2020-11-16T14:35:42.277,5,,0.0
2020,10,2929,185,13,496,3,5,5,1,0,0,0,0,0,0,False,False,False,0,3,2020-11-19T18:33:05.327,0,,0.0
2020,10,2929,205,8,232,2,12,10,12,18,6,15,3,15,0,False,False,False,0,3,2020-11-16T14:46:48.68,18,,3.0
2020,10,2929,220,8,3606,13,9,6,15,0,0,0,0,0,0,False,False,False,0,3,2020-11-19T18:34:17.07,0,,0.0
2020,10,2929,245,13,2136,2,3,5,6,6,0,6,0,6,0,False,False,False,0,3,2020-11-16T18:52:13.68,6,,0.0
2020,10,2929,250,13,876,2,4,10,4,9,5,9,0,9,0,False,False,False,0,3,2020-11-19T18:36:45.633,9,,0.0
2020,10,2929,265,13,876,2,4,9,5,8,3,7,1,7,0,False,False,False,0,3,2020-11-16T15:08:51.07,8,,1.0
2020,10,2929,280,13,3951,2,52,10,3,4,1,4,0,4,0,False,False,False,0,2,2020-11-16T15:13:42.127,4,,0.0
2020,10,2929,295,8,3883,2,35,10,11,11,0,11,0,11,0,False,False,False,0,4,2020-11-16T15:23:04.793,11,,0.0
2020,10,2929,315,8,3606,2,6,4,13,18,5,17,1,17,0,False,False,False,0,2,2020-11-16T18:19:53.417,18,,1.0
2020,10,2929,325,8,5053,2,46,9,-4,12,16,4,8,4,0,False,False,False,1,1,2020-11-19T18:18:15.58,12,,8.0
2020,10,2929,330,8,232,13,5,10,3,0,0,0,0,0,0,False,False,False,0,3,2020-11-16T15:35:42.793,0,,0.0
2020,10,2929,335,8,7651,2,2,9,5,6,1,6,0,6,0,False,False,False,0,3,2020-11-16T15:37:49.25,6,,0.0
2020,10,2929,345,8,5053,3,5,3,6,0,0,0,0,0,0,False,False,False,0,3,2020-11-16T15:40:14.18,0,,0.0
2020,10,2929,350,8,232,13,12,2,25,0,0,0,0,0,0,False,False,False,0,3,2020-11-19T18:39:26.543,0,,0.0
2020,10,2929,400,13,3951,13,35,2,24,0,0,0,0,0,0,False,False,False,0,3,2020-11-16T16:05:54.433,0,,0.0
2020,10,2929,405,13,3951,13,19,2,20,0,0,0,0,0,0,False,False,False,0,3,2020-11-19T18:52:15.343,0,,0.0
2020,10,2929,410,13,404,13,12,10,0,0,0,0,0,0,0,False,False,False,0,1,2021-03-08T19:55:18.627,0,,0.0
2020,10,2929,440,8,5053,2,48,9,-3,10,13,5,5,5,0,False,False,False,0,1,2020-11-16T16:19:53.2,10,,5.0
2020,10,2929,465,13,4662,2,30,10,1,5,4,3,2,3,0,True,False,False,0,4,2020-11-16T16:28:11.35,5,,2.0
2020,10,2929,470,13,876,2,5,5,4,4,0,4,0,4,0,False,False,False,0,3,2020-11-16T16:30:02.41,4,,0.0
2020,10,2929,495,13,876,13,7,6,35,0,0,0,0,0,0,False,False,False,0,3,2020-11-16T16:37:54.21,0,,0.0
2020,10,2929,500,13,3652,2,44,3,-4,-2,2,-2,0,-2,0,False,False,False,0,1,2020-11-16T16:39:28.617,-2,,0.0
2020,10,2929,505,13,876,2,50,10,-4,10,14,6,4,6,0,False,False,False,0,2,2021-03-04T17:21:32.407,10,,4.0
2020,10,2929,535,8,3606,2,5,2,21,21,0,21,0,21,0,False,False,False,0,2,2020-11-16T18:26:41.867,21,,0.0
2020,10,2929,545,8,232,2,50,9,-3,2,5,1,1,1,0,False,False,False,0,2,2020-11-16T16:58:17.74,2,,1.0
2020,10,2929,550,8,7651,2,4,9,9,10,1,9,1,9,0,False,False,False,1,3,2020-11-19T18:17:51.097,10,,1.0
2020,10,2929,555,8,3606,13,9,3,14,0,0,0,0,0,0,False,False,False,0,3,2020-11-16T17:02:43.083,0,,
2020,10,2929,600,13,6528,13,4,10,4,0,0,0,0,0,0,False,False,False,0,4,2020-11-16T17:13:50.25,0,,0.0
2020,10,2929,610,13,496,3,35,10,10,0,0,0,0,0,0,False,False,False,0,3,2020-11-16T17:18:24.75,0,,0.0
2020,10,2929,625,8,3883,13,6,9,10,0,0,0,0,0,0,False,False,False,0,4,2020-11-16T17:23:22.047,0,,0.0
2020,10,2929,655,8,6439,13,46,9,1,0,0,0,0,0,0,False,False,False,0,1,2020-11-19T18:45:16.753,0,,0.0
2020,10,2929,670,13,1430,2,30,10,0,15,15,5,10,5,0,False,False,False,1,1,2020-11-19T18:46:13.073,15,,10.0
2020,10,2929,675,13,876,13,39,4,3,0,0,0,0,0,0,False,False,False,0,3,2020-11-19T18:16:49.36,0,,0.0
2020,10,2929,680,13,3951,2,50,9,-3,4,7,1,3,1,0,False,False,False,0,3,2021-02-19T15:08:59.593,4,,3.0
2020,10,2929,685,13,496,2,35,6,23,29,6,24,5,24,0,False,False,False,0,3,2020-11-16T17:45:47.893,29,,5.0
2020,10,2929,690,13,876,2,50,3,-6,1,7,-1,2,-1,0,True,False,False,0,3,2020-11-19T18:47:28.77,1,,2.0
2020,10,2929,695,13,496,2,4,10,8,10,2,10,0,10,0,False,False,False,0,2,2020-11-16T17:50:16.31,10,,0.0
2020,10,2929,700,13,4662,2,11,7,16,16,0,16,0,16,6,False,False,False,0,4,2020-11-16T17:53:42.26,16,,0.0
2020,10,2930,15,32,8237,2,6,1,18,22,4,20,2,20,0,False,False,False,0,3,2020-11-16T13:13:13.8,22,,2.0
2020,10,2930,35,32,7128,2,5,3,11,19,8,17,2,17,0,False,False,False,0,3,2020-11-16T13:27:25.663,19,,2.0
2020,10,2930,65,11,914,2,49,9,-3,5,8,4,1,4,0,True,False,False,0,2,2020-11-16T13:42:40.647,5,,1.0
2020,10,2930,80,11,3820,2,21,6,40,55,15,0,55,0,6,False,False,False,0,2,2020-11-16T13:53:52.803,55,,55.0
2020,10,2930,100,32,3885,2,13,9,1,9,8,6,3,6,0,False,False,False,1,3,2020-11-16T13:59:08.603,9,,3.0
2020,10,2930,110,32,3708,2,28,9,2,7,5,7,0,7,0,False,False,False,0,1,2020-11-16T14:03:23.587,7,,0.0
2020,10,2930,125,32,3885,13,12,5,0,0,0,0,0,0,0,False,False,False,0,3,2020-11-16T14:11:38.64,0,,0.0
2020,10,2930,130,32,3885,13,47,10,1,0,0,0,0,0,0,False,False,False,0,1,2020-11-19T21:24:23.773,0,,0.0
2020,10,2930,145,11,2714,13,7,5,14,0,0,0,0,0,0,False,False,False,0,4,2020-11-16T14:20:42.69,0,,0.0
2020,10,2930,165,11,914,2,5,5,4,4,0,4,0,4,0,False,False,False,0,3,2020-11-16T14:45:14.15,4,,0.0
2020,10,2930,175,11,914,13,12,3,9,0,0,0,0,0,0,False,False,False,0,3,2020-11-16T14:36:36.63,0,,0.0
2020,10,2930,190,32,3885,2,44,3,-3,3,6,1,2,1,0,False,False,False,0,1,2020-11-16T14:40:38.113,3,,2.0
2020,10,2930,205,32,3885,13,39,4,5,0,0,0,0,0,0,True,False,False,0,3,2020-11-19T19:49:21.127,0,,0.0
2020,10,2930,220,11,792,2,32,5,0,9,9,8,1,8,0,False,False,False,0,1,2020-11-16T14:55:30.49,9,,1.0
2020,10,2930,230,11,7733,3,6,10,12,0,0,0,0,0,0,False,False,False,0,3,2020-11-19T19:49:21.127,0,,0.0
2020,10,2930,235,11,6810,13,11,6,17,0,0,0,0,0,0,False,False,False,0,3,2020-11-16T15:04:33.887,0,,0.0
2020,10,2930,240,11,914,2,9,6,27,27,0,0,27,0,6,False,False,False,0,3,2020-11-16T15:09:50.69,27,,27.0
2020,10,2930,255,32,3885,13,48,4,0,0,0,0,0,0,0,False,False,False,0,1,2021-02-18T17:55:54.35,0,,0.0
2020,10,2930,260,32,3885,2,13,9,3,7,4,6,1,6,0,False,False,False,0,3,2020-11-16T15:15:57.33,7,,1.0
2020,10,2930,265,32,7807,2,44,3,-2,0,2,-1,1,-1,0,False,False,False,0,1,2021-02-18T17:56:38.87,0,,1.0
2020,10,2930,270,32,6430,2,26,10,1,13,12,1,12,1,0,False,False,False,0,3,2020-11-19T20:51:30.75,13,,12.0
2020,10,2930,275,32,3885,2,4,10,1,8,7,8,0,8,0,False,False,False,0,1,2020-11-16T15:24:53.513,8,,0.0
2020,10,2930,285,32,3885,13,24,2,23,0,0,0,0,0,0,True,False,False,0,3,2020-11-16T15:31:55.86,0,,0.0
2020,10,2930,305,11,3820,13,3,5,11,0,0,0,0,0,0,False,False,False,0,2,2020-11-19T19:56:08.47,0,,0.0
2020,10,2930,320,32,7128,2,4,9,6,6,0,5,1,5,0,False,False,False,0,3,2020-11-16T15:45:58.36,6,,1.0
2020,10,2930,325,32,3885,2,16,9,4,4,0,4,0,4,0,False,False,False,0,1,2020-11-16T15:48:27.06,4,,0.0
2020,10,2930,335,32,1427,2,39,4,5,10,5,8,2,8,0,False,False,False,0,4,2021-02-18T17:57:05.647,10,,2.0
2020,10,2930,340,32,8237,2,18,5,-1,6,7,5,1,5,0,False,False,False,0,2,2020-11-16T16:01:04.843,6,,1.0
2020,10,2930,360,32,7494,2,4,9,5,8,3,7,1,7,0,False,True,False,0,3,2020-11-17T04:14:34.003,6,,1.0
2020,10,2930,365,32,3885,2,44,3,-2,7,9,0,7,0,0,False,False,False,1,1,2020-11-16T16:11:20.507,7,,7.0
2020,10,2930,370,32,1427,2,12,3,0,0,0,0,0,0,0,False,False,False,0,3,2020-11-16T16:14:09.147,0,,
2020,10,2930,375,32,7128,2,6,4,3,3,0,3,0,3,0,False,True,True,0,3,2020-11-16T20:18:10,2,,0.0
2020,10,2930,380,11,914,2,8,4,13,19,6,17,2,17,0,False,False,False,0,3,2020-11-16T16:22:13.803,19,,2.0
2020,10,2930,385,11,6810,2,47,5,3,8,5,0,8,0,0,False,False,False,0,3,2020-11-16T16:24:02.173,8,,8.0
2020,10,2930,390,11,3820,2,6,5,4,6,2,6,0,6,0,False,False,False,0,2,2020-11-16T16:26:36.077,6,,0.0
2020,10,2930,400,11,100,2,51,9,-1,2,3,2,0,2,0,False,False,False,0,3,2020-11-16T16:28:56.19,2,,0.0
2020,10,2930,410,11,914,2,13,10,4,4,0,4,0,4,0,True,False,False,0,2,2020-11-16T16:37:12.887,4,,0.0
2020,10,2930,415,11,6810,3,47,5,4,0,0,0,0,0,0,False,False,False,0,3,2020-11-16T16:38:45.33,0,,0.0
2020,10,2930,450,11,100,2,49,9,-2,8,10,8,0,8,0,True,False,False,0,3,2020-11-16T16:57:47.7,8,,0.0
2020,10,2930,455,11,3820,13,2,4,0,0,0,0,0,0,0,False,False,False,0,2,2020-11-16T16:56:30.223,0,,
2020,10,2930,465,11,7732,2,48,10,-3,26,29,14,12,14,0,False,False,False,2,1,2020-11-19T20:57:35.83,26,,12.0
2020,10,2930,475,11,2714,2,47,5,2,4,2,3,1,3,0,False,False,False,0,4,2020-11-16T17:07:28.68,4,,1.0
2020,10,2930,480,11,6810,2,4,10,4,5,1,4,1,4,0,False,False,False,0,4,2020-11-16T17:10:06.97,5,,1.0
2020,10,2930,485,11,914,2,5,6,18,18,0,18,0,18,0,False,False,False,0,3,2021-02-18T17:57:41.613,18,,0.0
2020,10,2930,500,11,7732,2,26,10,1,15,14,3,12,3,6,True,False,False,1,2,2020-11-19T21:37:27.08,15,,12.0
2020,10,2930,515,32,7807,2,28,5,0,13,13,5,8,5,0,False,False,False,1,1,2020-11-16T17:23:35.94,13,,8.0
2020,10,2930,525,32,8237,2,51,3,-1,6,7,6,0,6,0,False,False,False,0,3,2021-03-04T19:10:31.73,6,,0.0
2020,10,2930,530,32,6430,2,18,5,-1,11,12,5,6,5,0,False,False,False,2,2,2020-11-16T17:30:41.003,11,,6.0
2020,10,2930,535,32,7494,2,51,9,-4,1,5,1,0,1,0,False,False,False,0,3,2020-11-16T17:32:40.397,1,,0.0
2020,10,2930,545,32,7128,2,2,9,7,20,13,18,2,18,0,False,False,False,0,2,2020-11-16T17:35:08.633,20,,2.0
2020,10,2930,555,32,3885,3,12,5,8,0,0,0,0,0,0,False,False,False,0,1,2020-11-16T17:38:59.517,0,,0.0
2020,10,2930,570,32,1427,2,4,1,15,15,0,15,0,15,0,False,False,False,0,3,2020-11-19T19:49:21.127,15,,0.0
2020,10,2930,590,11,2714,2,32,5,0,5,5,4,1,4,0,False,False,False,0,4,2020-11-16T17:50:06.613,5,,1.0
2020,10,2930,600,11,914,13,9,6,20,0,0,0,0,0,0,False,False,False,0,3,2020-11-16T17:54:52.523,0,,0.0
2020,10,2930,610,32,6430,2,6,1,19,19,0,19,0,19,0,False,False,False,0,3,2021-02-18T17:58:08.873,19,,0.0
2020,10,2930,615,32,1427,2,12,5,12,14,2,14,0,14,0,False,False,False,0,3,2020-11-16T18:01:09.77,14,,0.0
2020,10,2930,630,32,8237,2,18,3,-1,4,5,4,0,4,0,False,False,False,1,2,2020-11-16T18:08:49.793,4,,0.0
2020,10,2930,640,32,7128,2,2,9,7,11,4,11,0,11,0,False,False,False,0,2,2021-02-18T17:58:42.807,11,,0.0
2020,10,2930,645,32,7807,2,45,10,-5,-1,4,-1,0,-1,0,False,False,False,0,1,2020-11-16T18:15:53.037,-1,,0.0
2020,10,2930,650,32,8237,2,6,4,13,13,0,13,0,13,0,False,False,False,0,3,2020-11-16T18:17:45.483,13,,0.0
2020,10,2930,655,32,7807,2,16,10,3,8,5,4,4,4,0,False,False,False,0,1,2020-11-16T18:20:01.08,8,,4.0
2020,10,2930,660,32,8237,2,51,9,-2,8,10,6,2,6,0,False,False,False,0,3,2020-11-19T21:00:49.927,8,,2.0
2020,10,2930,680,11,6810,2,53,10,-1,8,9,6,2,6,0,False,False,False,0,4,2020-11-16T18:28:26.193,8,,
2020,10,2930,685,11,100,2,50,9,-3,0,3,0,0,0,0,True,False,False,0,3,2020-11-19T19:49:21.127,0,,0.0
2020,10,2930,690,11,7732,2,2,10,3,13,10,5,8,5,0,True,False,False,1,2,2020-11-16T18:35:08.193,13,,8.0
2020,10,2930,715,32,7494,2,5,2,21,23,2,23,0,23,0,False,False,False,0,3,2020-11-19T19:49:21.127,23,,0.0
2020,10,2930,720,32,1427,2,17,8,19,27,8,24,3,24,0,False,False,False,0,3,2020-11-16T18:46:30.19,27,,3.0
2020,10,2930,750,11,7732,2,45,5,-4,9,13,9,0,9,0,False,False,False,0,1,2020-11-16T18:56:48.4,9,,0.0
2020,10,2930,755,11,7732,2,46,9,-3,5,8,3,2,3,0,False,False,False,0,1,2020-11-19T19:49:21.127,5,,2.0
2020,10,2930,765,11,914,2,4,5,10,10,0,10,0,10,0,False,False,False,0,2,2020-11-16T19:04:47.053,10,,0.0
2020,10,2930,790,11,6820,13,32,5,0,0,0,0,0,0,0,True,False,False,0,4,2020-11-16T19:14:38.817,0,,0.0
2020,10,2930,820,32,1427,13,17,2,19,0,0,0,0,0,0,False,False,False,0,3,2020-11-16T19:26:06.1,0,,0.0
2020,10,2930,825,32,7494,2,4,3,4,5,1,5,0,5,0,False,False,False,0,3,2020-11-19T19:49:21.127,5,,0.0
2020,10,2930,830,32,7128,2,13,10,2,4,2,4,0,4,0,False,False,False,0,3,2020-11-16T19:31:58.723,4,,
2020,10,2930,840,32,7128,2,7,6,20,26,6,26,0,26,0,False,False,False,0,2,2020-11-19T21:41:07.343,26,,0.0
2020,10,2930,845,32,3885,2,13,4,2,5,3,5,0,5,0,True,False,False,0,3,2020-11-16T19:37:31.047,5,,0.0
2020,10,2930,850,32,6430,13,9,2,25,0,0,0,0,0,0,False,False,False,0,2,2020-11-16T20:17:31.563,0,,0.0
2020,10,2930,855,32,7128,13,13,9,2,0,0,0,0,0,0,False,False,False,0,3,2020-11-16T19:41:58.463,0,,0.0
2020,10,2930,860,32,7128,13,2,9,4,0,0,0,0,0,0,False,False,False,0,2,2020-11-16T19:43:50.81,0,,
2020,10,2930,865,32,3885,13,4,3,5,0,0,0,0,0,0,True,False,False,0,2,2020-11-16T19:46:38.973,0,,0.0
2020,10,2930,875,32,7128,13,12,7,15,0,0,0,0,0,0,False,False,False,0,2,2021-03-08T20:20:18.957,0,,
2020,10,2930,880,32,3885,13,44,3,-4,0,0,0,0,0,0,False,False,False,0,1,2020-11-16T19:53:29.577,0,,0.0
2020,10,2930,885,32,7128,13,2,9,6,0,0,0,0,0,0,False,False,False,0,2,2020-11-16T19:55:20.167,0,,0.0
2020,10,2930,890,32,6430,2,2,4,11,11,0,11,0,11,0,False,False,False,0,2,2020-11-16T19:57:21.793,11,,0.0
2020,10,2930,900,32,6711,13,29,2,25,0,0,0,0,0,0,False,False,False,0,3,2020-11-19T20:26:02.82,0,,0.0
2020,10,2930,905,32,7128,2,13,3,6,11,5,11,0,11,0,False,False,False,0,3,2020-11-16T20:02:06.45,11,,0.0
2020,10,2930,920,32,7494,3,13,9,3,0,0,0,0,0,0,True,False,False,0,3,2020-11-17T15:48:54.357,0,,0.0
2020,10,2930,925,32,7494,2,5,5,5,11,6,11,0,11,0,False,False,False,0,3,2020-11-16T20:07:28.94,11,,0.0
2020,10,2930,940,11,7733,2,2,9,7,10,3,9,1,9,0,False,False,False,0,3,2020-11-19T19:49:21.127,10,,1.0
2020,10,2930,950,11,7733,13,7,6,52,0,0,0,0,0,0,False,False,False,0,3,2020-11-19T19:49:21.127,0,,
2020,10,2930,955,11,914,2,17,10,5,9,4,9,0,9,0,False,False,False,0,3,2020-11-16T20:14:14.353,9,,0.0
2020,10,2931,10,12,556,2,49,9,0,5,5,2,3,2,0,False,False,False,0,2,2020-11-16T13:13:00.453,5,,3.0
2020,10,2931,20,12,4511,13,12,8,27,0,0,0,0,0,0,False,False,False,0,4,2021-03-08T20:03:38.93,0,,0.0
2020,10,2931,30,15,6501,2,5,5,5,11,6,8,3,8,0,True,False,False,0,3,2020-11-16T13:28:43.527,11,,3.0
2020,10,2931,55,15,2407,13,5,5,6,0,0,0,0,0,0,False,False,False,0,3,2020-11-19T17:54:27.44,0,,0.0
2020,10,2931,70,12,4537,2,46,3,2,6,4,5,1,5,0,False,False,False,0,1,2020-11-16T13:40:41.277,6,,1.0
2020,10,2931,80,12,4511,13,35,6,31,0,0,0,0,0,0,False,False,False,0,3,2020-11-16T19:24:43.637,0,,
2020,10,2931,95,12,4561,13,16,10,4,0,0,0,0,0,0,False,False,False,0,1,2021-02-25T16:02:12.423,0,,
2020,10,2931,100,12,4561,2,48,10,-3,10,13,7,3,7,0,False,False,False,0,1,2020-11-16T13:56:01.203,10,,3.0
2020,10,2931,125,15,4997,2,50,9,-2,6,8,5,1,5,0,False,False,False,0,2,2020-11-16T14:06:44.477,6,,1.0
2020,10,2931,130,15,8099,13,51,10,-4,0,0,0,0,0,0,True,False,False,0,1,2020-11-17T18:58:12.417,0,,0.0
2020,10,2931,140,12,556,2,49,10,0,1,1,0,1,0,0,False,False,False,0,2,2020-11-16T14:12:21.06,1,,1.0
2020,10,2931,145,12,4511,2,5,5,5,6,1,5,1,5,0,False,False,False,0,3,2020-11-16T14:15:15.35,6,,1.0
2020,10,2931,150,12,556,13,4,5,9,0,0,0,0,0,0,False,False,False,0,2,2020-11-16T14:17:53.3,0,,0.0
2020,10,2931,170,15,2407,13,2,10,4,0,0,0,0,0,0,False,False,False,0,3,2020-11-16T14:27:21.963,0,,0.0
2020,10,2931,190,12,556,2,5,3,2,6,4,5,1,5,0,False,False,False,0,3,2020-11-16T14:34:05.227,6,,1.0
2020,10,2931,200,12,6357,2,19,2,41,78,37,78,0,78,6,False,False,False,0,2,2020-11-19T17:34:56.1,78,,0.0
2020,10,2931,215,15,2407,2,5,5,5,8,3,7,1,7,0,True,False,False,0,2,2020-11-16T19:39:43.86,8,,1.0
2020,10,2931,225,15,8099,2,47,10,-2,1,3,0,1,0,0,False,False,False,0,1,2020-11-16T14:45:00.773,1,,1.0
2020,10,2931,230,15,6501,13,19,6,44,0,0,0,0,0,0,False,False,False,0,2,2020-11-16T14:47:16.28,0,,0.0
2020,10,2931,240,15,2407,13,4,9,13,0,0,0,0,0,0,True,False,False,0,3,2020-11-16T14:48:58.167,0,,0.0
2020,10,2931,260,12,4537,2,48,10,-4,11,15,10,1,10,0,False,False,False,0,1,2020-11-16T14:56:39.657,11,,1.0
2020,10,2931,265,12,556,2,51,9,-4,-3,1,-4,1,-4,0,False,False,False,0,3,2020-11-16T14:59:13.96,-3,,1.0
2020,10,2931,295,12,556,2,5,5,11,11,0,11,0,11,0,False,False,False,0,2,2020-11-16T15:10:49.39,11,,
2020,10,2931,300,12,6357,2,12,8,18,22,4,21,1,21,0,False,False,False,0,3,2020-11-16T19:40:56.07,22,,1.0
2020,10,2931,310,12,556,13,4,9,10,0,0,0,0,0,0,False,False,False,0,3,2020-11-19T17:33:43.33,0,,0.0
2020,10,2931,315,12,4561,2,47,5,0,12,12,2,10,2,0,False,False,False,1,1,2020-11-19T17:35:37.487,12,,10.0
2020,10,2931,320,12,3965,2,44,9,-3,3,6,1,2,1,0,True,False,False,0,3,2020-11-19T16:55:04.447,3,,2.0
2020,10,2931,340,12,556,2,13,9,2,18,16,18,0,18,0,False,False,False,0,3,2020-11-16T15:44:17.463,18,,0.0
2020,10,2931,365,15,4997,2,5,3,7,7,0,7,0,7,0,True,False,False,0,3,2020-11-16T16:09:59.917,7,,0.0
2020,10,2931,375,15,4886,2,4,9,0,5,5,4,1,4,0,False,False,False,0,1,2020-11-16T15:52:26.387,5,,1.0
2020,10,2931,380,15,922,13,6,9,12,0,0,0,0,0,0,False,False,False,0,3,2021-03-05T14:50:12.79,0,,0.0
2020,10,2931,385,12,556,13,13,10,4,0,0,0,0,0,0,False,False,False,0,3,2020-11-16T15:57:58.18,0,,0.0
2020,10,2931,390,12,4537,2,50,5,-3,11,14,8,3,8,0,False,False,False,0,2,2020-11-16T15:59:38.253,11,,3.0
2020,10,2931,405,12,4561,2,4,3,2,3,1,2,1,2,0,False,False,False,0,2,2020-11-16T16:02:33.413,3,,1.0
2020,10,2931,415,12,556,2,36,1,22,22,0,22,0,22,6,False,False,False,0,3,2020-11-16T16:06:46.797,22,,
2020,10,2931,420,12,556,2,50,10,-3,11,14,10,1,10,0,False,False,False,1,3,2020-11-19T17:42:40.523,11,,1.0
2020,10,2931,455,15,2407,2,5,2,18,18,0,18,0,18,0,False,False,False,0,2,2020-11-16T16:19:03.11,18,,0.0
2020,10,2931,465,15,4997,3,42,4,5,0,0,0,0,0,0,False,False,False,0,3,2020-11-16T16:24:43.5,0,,0.0
2020,10,2931,480,12,556,2,2,9,8,22,14,14,8,14,0,False,True,True,0,2,2020-11-16T16:31:57.477,22,,8.0
2020,10,2931,500,15,4997,2,2,4,10,12,2,12,0,12,6,False,False,False,0,3,2020-11-16T16:41:55.877,12,,0.0
2020,10,2931,515,12,4511,2,30,3,0,4,4,2,2,2,0,False,False,False,0,4,2020-11-16T16:44:59.433,4,,2.0
2020,10,2931,520,12,4537,2,51,10,-4,14,18,3,11,3,0,True,False,False,1,1,2020-11-19T17:37:57.36,14,,11.0
2020,10,2931,525,12,556,13,19,2,35,0,0,0,0,0,0,False,False,False,0,2,2021-02-18T18:11:03.61,0,,0.0
2020,10,2931,555,12,6357,13,19,2,21,0,0,0,0,0,0,False,False,False,0,2,2020-11-16T17:16:27.813,0,,0.0
2020,10,2931,560,15,8099,2,47,5,-2,2,4,-1,3,-1,0,False,False,False,1,1,2021-03-03T15:21:28.847,2,,3.0
2020,10,2931,570,15,6501,2,26,10,5,7,2,6,1,6,0,False,False,False,0,3,2020-11-16T17:22:39.19,7,,1.0
2020,10,2931,580,15,4997,2,50,9,-2,13,15,-2,15,-2,0,False,False,False,1,3,2020-11-19T17:38:33.933,13,,15.0
2020,10,2931,590,15,7335,13,8,1,25,0,0,0,0,0,0,False,False,False,0,3,2020-11-16T17:31:54.597,0,,0.0
2020,10,2931,595,15,7335,13,12,5,5,0,0,0,0,0,0,False,False,False,0,3,2020-11-16T17:35:22.663,0,,0.0
2020,10,2931,605,12,6357,2,35,5,11,31,20,26,5,26,0,False,False,False,0,4,2020-11-16T19:40:24.233,31,,5.0
2020,10,2931,610,12,4537,3,51,9,-2,0,0,0,0,0,0,False,False,False,0,3,2021-02-18T18:12:04.703,0,,0.0
2020,10,2931,620,12,6357,13,13,10,4,0,0,0,0,0,0,False,False,False,0,3,2020-11-17T17:20:10.483,0,,0.0
2020,10,2931,625,15,6501,2,35,10,14,21,7,17,4,17,0,False,False,False,0,3,2020-11-19T18:22:40.773,21,,4.0
2020,10,2931,640,15,6501,2,50,10,-2,17,19,17,0,17,0,False,False,False,0,3,2020-11-18T03:07:54.797,17,,0.0
2020,10,2931,655,15,4886,3,5,5,6,0,0,0,0,0,0,False,False,False,0,1,2020-11-16T18:03:57.087,0,,0.0
2020,10,2931,660,15,922,2,13,5,5,7,2,6,1,6,0,False,False,False,0,3,2020-11-16T19:41:31.533,7,,1.0
2020,10,2931,680,12,4561,3,48,10,-2,0,0,0,0,0,0,False,False,False,0,1,2020-11-16T18:13:15.907,0,,0.0
2020,10,2931,685,12,4511,2,19,2,15,23,8,23,0,23,0,False,False,False,0,2,2020-11-16T18:15:33.697,23,,0.0
2020,10,2931,690,12,4537,2,44,3,-5,7,12,0,7,0,0,False,True,False,1,1,2020-11-17T01:01:56.15,7,,7.0
2020,10,2931,700,12,6357,2,51,3,-1,18,19,10,8,10,0,False,False,False,2,3,2020-11-16T18:22:19.317,18,,8.0
2020,10,2931,705,12,556,2,26,3,6,6,0,6,0,6,6,False,False,False,0,2,2020-11-16T18:24:41.567,6,,0.0
2020,10,2931,720,15,2407,2,30,5,0,10,10,9,1,9,0,True,False,False,0,4,2020-11-17T18:58:28.903,10,,1.0
2020,10,2931,730,15,4997,2,4,10,6,9,3,7,2,7,0,False,False,False,0,4,2020-11-16T18:34:25.03,9,,2.0
2020,10,2931,740,15,2407,13,5,9,5,0,0,0,0,0,0,False,False,False,0,3,2020-11-19T16:33:37.873,0,,
2020,10,2931,745,15,2407,2,13,10,6,7,1,7,0,7,0,False,False,False,0,3,2021-02-25T16:03:15.783,7,,0.0
2020,10,2931,760,15,2757,13,6,9,8,0,0,0,0,0,0,False,False,False,0,4,2021-02-18T18:13:02.5,0,,0.0
2020,10,2931,765,15,2407,13,13,9,2,0,0,0,0,0,0,False,False,False,0,3,2020-11-16T18:50:39.893,0,,0.0
2020,10,2931,770,15,922,13,13,9,5,0,0,0,0,0,0,False,False,False,0,3,2020-11-19T18:03:42.277,0,,0.0
2020,10,2931,810,15,4997,13,2,10,8,0,0,0,0,0,0,True,False,False,0,3,2020-11-17T18:58:43.727,0,,0.0
2020,10,2931,815,15,922,2,26,10,7,8,1,8,0,8,0,False,False,False,0,3,2020-11-16T19:05:54.887,8,,0.0
2020,10,2931,860,15,8099,13,12,5,3,0,0,0,0,0,0,False,False,False,0,1,2020-11-16T19:14:55.74,0,,0.0
2020,10,2932,15,21,7090,2,2,10,14,22,8,20,2,20,0,False,False,False,0,2,2020-11-16T15:10:56.41,22,,2.0
2020,10,2932,30,21,4405,3,12,5,-3,0,0,0,0,0,0,False,False,False,0,1,2021-03-08T20:23:26.323,0,,0.0
2020,10,2932,45,21,4422,2,55,4,-3,4,7,1,3,1,0,False,False,False,0,4,2021-03-02T18:29:39.597,4,,3.0
2020,10,2932,65,24,4382,2,51,3,-2,8,10,-2,10,-2,0,False,False,False,1,3,2021-02-18T18:51:11.37,8,,10.0
2020,10,2932,75,24,264,13,8,7,17,0,0,0,0,0,0,False,False,False,0,3,2020-11-19T17:08:00.223,0,,0.0
2020,10,2932,85,24,6373,13,4,10,12,0,0,0,0,0,0,False,False,False,0,4,2020-11-19T17:08:00.223,0,,0.0
2020,10,2932,90,24,7798,2,49,10,-2,10,12,7,3,7,0,False,False,False,0,2,2020-11-19T17:49:15.007,10,,3.0
2020,10,2932,105,24,6808,2,5,5,9,8,-1,8,0,8,0,False,False,False,0,2,2020-11-16T14:15:07.983,8,,0.0
2020,10,2932,115,24,4382,2,46,3,3,5,2,5,0,5,0,False,False,False,0,3,2020-11-16T14:19:45.377,5,,0.0
2020,10,2932,120,24,7798,13,2,10,3,0,0,0,0,0,0,False,False,False,0,2,2020-11-19T17:08:00.223,0,,0.0
2020,10,2932,135,21,7226,2,46,3,1,11,10,9,2,9,0,False,False,False,0,4,2020-11-16T14:33:29.85,11,,2.0
2020,10,2932,145,21,8259,2,2,9,7,9,2,8,1,8,0,False,False,False,0,2,2021-02-18T18:51:40.747,9,,1.0
2020,10,2932,150,21,3680,2,4,5,11,12,1,12,0,12,0,False,False,False,1,2,2020-11-16T14:32:41.243,12,,0.0
2020,10,2932,165,21,3680,2,47,5,3,3,0,3,0,3,0,False,False,False,0,3,2020-11-17T23:26:07.85,3,,0.0
2020,10,2932,220,24,565,2,17,4,13,22,9,18,4,18,0,False,False,False,0,3,2020-11-16T15:23:47.447,22,,4.0
2020,10,2932,225,24,565,2,11,5,14,19,5,19,0,19,0,False,False,False,0,4,2020-11-16T15:27:06.007,19,,0.0
2020,10,2932,260,21,7090,2,2,9,7,8,1,7,1,7,0,False,False,False,0,2,2020-11-16T15:37:39.84,8,,1.0
2020,10,2932,265,21,576,13,26,10,4,0,0,0,0,0,0,False,False,False,0,2,2020-11-16T15:40:05.76,0,,0.0
2020,10,2932,285,24,7798,2,4,5,13,15,2,15,0,15,0,False,False,False,0,2,2020-11-16T15:47:41.623,15,,0.0
2020,10,2932,290,24,7798,2,39,4,6,6,0,6,0,6,0,False,False,False,0,3,2020-11-16T15:49:40.987,6,,0.0
2020,10,2932,300,24,565,13,12,5,10,0,0,0,0,0,0,False,False,False,0,4,2020-11-18T01:05:23.797,0,,0.0
2020,10,2932,305,24,6937,2,47,5,1,1,0,1,0,1,0,True,False,False,0,1,2020-11-16T20:53:18.613,1,,0.0
2020,10,2932,315,24,4382,13,7,6,16,0,0,0,0,0,0,False,False,False,0,3,2020-11-16T20:44:07.703,0,,
2020,10,2932,320,24,6808,13,32,5,-4,0,0,0,0,0,0,True,False,False,0,4,2020-11-19T18:27:58.4,0,,0.0
2020,10,2932,330,24,6808,13,19,6,42,0,0,0,0,0,0,False,False,False,0,2,2020-11-19T17:08:00.223,0,,0.0
2020,10,2932,340,21,3680,2,45,5,0,4,4,3,1,3,0,True,False,False,0,3,2020-11-17T23:27:00.463,4,,1.0
2020,10,2932,350,21,2288,2,9,6,16,17,1,17,0,17,0,True,False,False,0,2,2020-11-17T23:36:22.343,17,,0.0
2020,10,2932,355,21,4422,2,35,9,12,11,-1,11,0,11,0,False,False,False,0,4,2020-11-16T16:31:35.757,11,,0.0
2020,10,2932,385,21,7226,2,46,3,1,1,0,1,0,1,0,False,False,False,0,4,2020-11-16T16:41:56.287,1,,0.0
2020,10,2932,390,21,3680,2,26,10,3,4,1,3,1,3,0,False,False,False,0,3,2021-02-18T18:53:40.287,4,,1.0
2020,10,2932,410,24,6937,13,4,10,4,0,0,0,0,0,0,False,False,False,0,1,2020-11-16T16:48:48.79,0,,0.0
2020,10,2932,430,24,7798,13,23,8,47,0,0,0,0,0,0,False,False,False,0,3,2020-11-19T17:08:00.223,0,,0.0
2020,10,2932,440,21,576,2,4,9,7,6,-1,6,0,6,0,False,False,False,0,3,2020-11-16T17:02:30.583,6,,0.0
2020,10,2932,445,21,576,13,2,10,8,0,0,0,0,0,0,False,False,False,0,3,2020-11-16T17:04:16.28,0,,0.0
2020,10,2932,455,21,576,13,4,10,9,0,0,0,0,0,0,False,False,False,0,3,2020-11-16T17:10:48.283,0,,0.0
2020,10,2932,485,24,6373,2,39,10,5,6,1,5,1,5,0,False,False,False,0,4,2020-11-16T17:24:26.367,6,,1.0
2020,10,2932,490,24,4382,2,51,9,-3,5,8,3,2,3,0,False,False,False,1,3,2021-02-18T18:54:09.367,5,,2.0
2020,10,2932,515,21,3680,2,9,6,23,27,4,23,4,23,0,False,False,False,0,2,2020-11-19T18:27:38.503,27,,4.0
2020,10,2932,520,21,576,2,9,2,36,38,2,36,2,36,0,False,False,False,0,3,2020-11-17T23:27:38.1,38,,2.0
2020,10,2932,560,24,7798,2,12,7,15,16,1,16,0,16,0,False,False,False,0,2,2021-03-08T20:24:23.16,16,,0.0
2020,10,2932,570,24,6373,2,39,4,5,8,3,7,1,7,0,True,False,False,0,3,2020-11-16T17:55:08.61,8,,1.0
2020,10,2932,575,24,4382,2,35,9,8,16,8,16,0,16,0,False,False,False,0,4,2020-11-19T17:08:00.223,16,,0.0
2020,10,2932,580,24,4382,2,5,5,2,5,3,3,2,3,0,False,False,False,0,3,2020-11-16T18:01:40.947,5,,2.0
2020,10,2932,610,21,4405,2,4,4,3,7,4,4,3,4,0,False,False,False,1,1,2020-11-17T23:28:12.417,7,,3.0
2020,10,2932,645,24,4382,13,32,5,1,0,0,0,0,0,0,False,False,False,0,3,2020-11-16T18:26:13.543,0,,0.0
2020,10,2932,670,21,7090,13,2,10,11,0,0,0,0,0,0,False,False,False,0,2,2020-11-17T23:28:24.177,0,,0.0
2020,10,2932,680,21,7090,3,13,9,6,0,0,0,0,0,0,False,False,False,0,3,2020-11-17T23:28:35.393,0,,0.0
2020,10,2932,690,24,6937,2,46,3,0,9,9,0,9,0,0,False,False,False,1,1,2020-11-18T01:12:19.543,9,,9.0
2020,10,2932,705,24,6373,13,17,8,18,0,0,0,0,0,0,False,False,False,0,3,2020-11-16T18:52:33.66,0,,0.0
2020,10,2932,730,21,7090,2,2,3,8,16,8,13,3,13,0,False,False,False,0,2,2020-11-17T23:29:04.45,16,,3.0
2020,10,2932,735,21,3680,2,13,9,4,9,5,7,2,7,0,False,False,False,0,2,2021-02-25T16:06:13.193,9,,
2020,10,2932,745,21,7090,2,50,3,0,7,7,6,1,6,0,False,False,False,0,2,2021-03-04T17:25:59.71,7,,1.0
2020,10,2932,750,21,4422,13,9,6,15,0,0,0,0,0,0,False,False,False,0,4,2020-11-17T23:29:27.403,0,,0.0
2020,10,2932,755,21,2288,2,28,3,-1,0,1,0,0,0,0,False,False,False,0,1,2020-11-16T19:36:19.737,0,,0.0
2020,10,2932,775,24,565,2,9,3,13,13,0,13,0,13,0,False,False,False,0,4,2021-02-25T16:07:33.937,13,,0.0
2020,10,2932,780,24,6373,2,4,9,5,7,2,5,2,5,0,False,False,False,0,3,2020-11-16T19:43:59.657,7,,2.0
2020,10,2932,785,24,565,2,4,9,5,6,1,6,0,6,0,False,False,False,0,4,2020-11-16T19:46:24.347,6,,0.0
2020,10,2932,795,24,6937,3,45,10,-1,0,0,0,0,0,0,False,False,False,0,1,2020-11-16T19:51:48.25,0,,0.0
2020,10,2932,800,24,6808,3,5,1,15,0,0,0,0,0,0,False,False,False,0,3,2020-11-16T19:55:14.787,0,,0.0
2020,10,2932,805,24,7798,13,29,2,16,0,0,0,0,0,0,False,False,False,0,2,2020-11-16T19:57:41.987,0,,0.0
2020,10,2932,815,21,7090,2,21,6,39,40,1,40,0,40,0,False,False,False,0,2,2020-11-16T20:02:58.94,40,,0.0
2020,10,2932,820,21,3680,2,34,4,-4,-3,1,-3,0,-3,0,True,False,False,0,3,2020-11-16T20:04:57.003,-3,,0.0
2020,10,2932,855,24,6373,2,5,3,10,12,2,12,0,12,0,False,False,False,0,3,2020-11-16T20:12:53.677,12,,0.0
2020,10,2932,860,24,6937,3,4,9,3,0,0,0,0,0,0,False,False,False,0,1,2020-11-16T20:14:26.923,0,,0.0
2020,10,2932,865,24,6808,13,5,2,16,0,0,0,0,0,0,False,False,False,0,2,2020-11-16T20:16:22.993,0,,0.0
2020,10,2932,875,24,6389,2,12,10,8,11,3,11,0,11,0,False,False,False,0,1,2021-03-08T20:25:10.927,11,,0.0
2020,10,2933,10,25,609,13,32,5,2,0,0,0,0,0,0,False,False,False,0,4,2020-11-19T19:08:07.563,0,,0.0
2020,10,2933,15,25,7060,2,49,9,-3,13,16,13,0,13,0,True,False,False,0,3,2020-11-16T20:41:19.73,13,,0.0
2020,10,2933,25,25,609,13,13,10,2,0,0,0,0,0,0,False,False,False,0,4,2020-11-19T19:08:20.16,0,,0.0
2020,10,2933,30,25,7666,13,19,2,28,0,0,0,0,0,0,False,False,False,0,2,2020-11-16T13:30:51.3,0,,0.0
2020,10,2933,50,25,4583,2,55,4,-3,1,4,-2,3,-2,0,False,False,False,0,4,2020-11-16T13:38:00.357,1,,3.0
2020,10,2933,70,7,910,13,5,5,4,0,0,0,0,0,0,False,False,False,0,3,2020-11-16T13:43:05.453,0,,0.0
2020,10,2933,75,7,7659,2,6,9,5,8,3,5,3,5,0,False,False,False,0,2,2020-11-19T17:03:54.673,8,,3.0
2020,10,2933,80,7,910,13,8,1,23,0,0,0,0,0,0,False,False,False,0,2,2020-11-16T13:47:02.733,0,,0.0
2020,10,2933,105,25,7060,2,4,9,4,10,6,9,1,9,0,False,False,False,0,3,2020-11-16T13:54:06.397,10,,1.0
2020,10,2933,110,25,7060,3,13,9,2,0,0,0,0,0,0,False,False,False,0,2,2020-11-16T13:57:51.59,0,,0.0
2020,10,2933,125,7,3521,13,9,6,25,0,0,0,0,0,0,False,False,False,0,3,2020-11-16T20:44:47.277,0,,0.0
2020,10,2933,130,7,6383,13,5,5,8,0,0,0,0,0,0,False,False,False,0,3,2020-11-16T14:23:58.443,0,,0.0
2020,10,2933,140,25,6259,2,34,4,-3,-6,-3,-6,0,-6,0,True,False,False,0,3,2020-11-16T20:41:43.027,0,,0.0
2020,10,2933,155,25,4587,2,28,4,0,4,4,3,1,3,0,False,False,False,0,1,2020-11-16T14:32:16.757,4,,1.0
2020,10,2933,160,25,609,13,9,5,12,0,0,0,0,0,0,True,False,False,0,2,2020-11-16T14:34:22.763,0,,0.0
2020,10,2933,180,7,931,2,44,3,-4,-4,0,-4,0,-4,0,False,False,False,0,1,2020-11-16T15:23:02.37,-4,,0.0
2020,10,2933,185,7,931,2,28,9,-2,5,7,-1,6,-1,0,False,False,False,1,1,2020-11-16T15:25:29.923,5,,6.0
2020,10,2933,195,25,7060,2,19,6,35,46,11,39,7,39,0,False,False,False,0,2,2020-11-16T15:29:13.647,46,,7.0
2020,10,2933,200,25,6486,2,5,5,5,16,11,5,11,5,0,False,False,False,1,2,2020-11-19T19:06:00.69,16,,11.0
2020,10,2933,205,25,7060,2,2,10,10,12,2,11,1,11,6,False,False,False,0,2,2020-11-16T15:32:15.493,12,,1.0
2020,10,2933,230,7,3521,2,26,5,3,20,17,17,3,17,0,False,False,False,0,3,2020-11-16T15:37:43.977,20,,3.0
2020,10,2933,240,7,7659,2,2,9,6,9,3,6,3,6,0,False,True,True,0,3,2020-11-16T15:41:24.7,9,,3.0
2020,10,2933,255,25,6486,2,12,10,8,14,6,10,4,10,0,True,False,False,1,3,2020-11-17T20:44:02.263,14,,4.0
2020,10,2933,260,25,7060,13,4,10,-3,0,0,0,0,0,0,False,False,False,0,3,2020-11-16T15:49:53.223,0,,0.0
2020,10,2933,275,7,7659,2,19,2,22,54,32,46,8,46,0,False,False,False,0,3,2020-11-16T15:54:45.797,54,,8.0
2020,10,2933,280,7,3521,2,4,9,5,5,0,5,0,5,0,False,False,False,0,3,2020-11-16T15:57:08.913,5,,0.0
2020,10,2933,285,7,4455,2,6,9,7,7,0,7,0,7,0,False,False,False,0,2,2020-11-16T15:59:00.48,7,,0.0
2020,10,2933,290,7,931,13,5,9,6,0,0,0,0,0,0,False,False,False,0,1,2021-03-17T19:20:06.68,0,,0.0
2020,10,2933,305,7,7659,2,2,9,1,2,1,2,0,2,6,False,False,False,0,2,2020-11-17T18:53:22.417,2,,0.0
2020,10,2933,320,25,4583,3,2,10,5,0,0,0,0,0,0,False,False,False,0,3,2020-11-19T19:06:15.787,0,,0.0
2020,10,2933,325,25,6259,2,49,5,-3,4,7,2,2,2,0,False,False,False,0,2,2020-11-17T20:42:40.537,4,,2.0
2020,10,2933,330,25,7666,2,13,9,2,15,13,15,0,15,0,False,False,False,0,3,2020-11-16T16:21:34.86,15,,0.0
2020,10,2933,335,25,4583,2,17,8,19,24,5,22,2,22,0,False,False,False,0,3,2020-11-16T16:26:52.237,24,,2.0
2020,10,2933,340,25,7060,2,13,4,-1,-2,-1,-2,0,-2,0,False,False,False,0,2,2020-11-16T16:28:31.037,-2,,
2020,10,2933,345,25,7666,13,23,7,20,0,0,0,0,0,0,False,False,False,0,3,2020-11-16T16:31:22.597,0,,
2020,10,2933,350,25,7666,3,12,5,5,0,0,0,0,0,0,False,False,False,0,2,2020-11-16T16:33:27.187,0,,0.0
2020,10,2933,360,25,4583,2,35,9,8,8,0,8,0,8,6,False,False,False,0,3,2020-11-16T16:38:04.99,8,,0.0
2020,10,2933,380,7,7659,2,8,10,10,13,3,11,2,11,0,False,False,False,0,3,2021-02-18T18:59:26.983,13,,2.0
2020,10,2933,385,7,3521,2,6,4,5,8,3,6,2,6,0,False,False,False,0,3,2020-11-19T17:03:54.673,8,,2.0
2020,10,2933,395,7,3445,13,6,10,4,0,0,0,0,0,0,False,False,False,0,3,2020-11-16T16:52:27.657,0,,0.0
2020,10,2933,410,25,7060,2,21,5,13,18,5,16,2,16,0,False,False,False,0,2,2020-11-16T16:58:34.033,18,,2.0
2020,10,2933,415,25,7060,13,4,5,8,0,0,0,0,0,0,False,False,False,0,2,2020-11-16T17:00:20.217,0,,0.0
2020,10,2933,420,25,609,2,17,8,16,24,8,21,3,21,0,False,False,False,0,3,2020-11-16T17:02:06.207,24,,3.0
2020,10,2933,425,25,7060,2,18,3,0,17,17,15,2,15,0,False,False,False,1,2,2020-11-16T17:04:48.803,17,,2.0
2020,10,2933,440,25,7060,13,19,2,22,0,0,0,0,0,0,False,False,False,0,2,2020-11-16T17:09:57.583,0,,0.0
2020,10,2933,445,25,4583,2,49,3,3,3,0,3,0,3,0,False,False,False,0,2,2021-02-18T18:59:56.19,3,,0.0
2020,10,2933,465,7,931,2,2,3,5,13,8,11,2,11,0,False,False,False,0,2,2020-11-16T17:23:43.61,13,,2.0
2020,10,2933,470,7,3521,2,13,10,4,5,1,4,1,4,0,False,False,False,0,3,2020-11-16T17:25:33.033,5,,1.0
2020,10,2933,475,7,6975,2,2,9,4,9,5,8,1,8,0,False,False,False,0,2,2020-11-16T17:27:08.547,9,,1.0
2020,10,2933,480,7,7659,2,6,10,5,16,11,6,10,6,0,False,False,False,1,3,2020-11-19T17:03:54.673,16,,10.0
2020,10,2933,505,7,6975,3,12,3,3,0,0,0,0,0,0,False,False,False,0,4,2020-11-16T17:33:20.163,0,,0.0
2020,10,2933,510,7,6383,2,17,4,9,19,10,18,1,18,0,False,False,False,1,3,2020-11-19T19:06:33.553,19,,1.0
2020,10,2933,530,7,7659,13,20,2,29,0,0,0,0,0,0,False,False,False,0,2,2020-11-16T18:41:48.49,0,,0.0
2020,10,2933,535,7,931,2,4,5,3,3,0,3,0,3,0,False,False,False,0,2,2020-11-16T18:48:38.227,3,,0.0
2020,10,2933,540,7,6383,13,4,5,12,0,0,0,0,0,0,False,False,False,0,2,2020-11-16T18:50:28.063,0,,0.0
2020,10,2933,560,25,4583,2,4,5,6,6,0,6,0,6,0,False,False,False,0,3,2020-11-16T20:57:06.233,6,,0.0
2020,10,2933,580,7,7659,2,8,10,10,13,3,12,1,12,0,False,False,False,0,2,2021-02-18T19:00:46.803,13,,1.0
2020,10,2933,590,7,3445,13,8,7,20,0,0,0,0,0,0,False,False,False,0,2,2020-11-16T19:12:16.223,0,,0.0
2020,10,2933,595,7,3521,13,5,5,11,0,0,0,0,0,0,False,False,False,0,3,2020-11-16T19:14:01,0,,0.0
2020,10,2933,610,25,4583,13,13,4,4,0,0,0,0,0,0,False,False,False,0,3,2020-11-16T19:18:03.913,0,,0.0
2020,10,2933,615,25,7666,2,5,5,10,11,1,11,0,11,0,False,False,False,0,3,2020-11-16T19:19:16.997,11,,0.0
2020,10,2933,620,25,4587,2,2,10,2,8,6,5,3,5,0,False,False,False,0,3,2020-11-16T19:20:25.74,8,,3.0
2020,10,2933,625,25,7666,13,5,5,11,0,0,0,0,0,0,False,False,False,0,3,2020-11-19T19:04:49.857,0,,0.0
2020,10,2933,630,25,609,2,26,3,6,14,8,10,4,10,0,False,False,False,0,3,2020-11-16T19:26:12.41,14,,4.0
2020,10,2933,635,25,7666,13,7,2,24,0,0,0,0,0,0,False,False,False,0,3,2020-11-16T19:25:53.117,0,,0.0
2020,10,2933,640,25,4583,13,4,3,8,0,0,0,0,0,0,False,False,False,0,3,2020-11-16T19:27:43.173,0,,0.0
2020,10,2933,645,25,4583,2,12,10,11,12,1,11,1,11,0,False,False,False,0,3,2021-02-18T19:01:15.383,12,,1.0
2020,10,2933,655,25,4583,13,12,3,11,0,0,0,0,0,0,False,False,False,0,3,2021-03-08T19:57:57.797,0,,0.0
2020,10,2933,660,25,7666,2,8,10,11,11,0,10,1,10,6,False,False,False,0,2,2020-11-16T19:33:06.403,11,,1.0
2020,10,2933,675,7,910,3,8,4,13,0,0,0,0,0,0,False,False,False,0,2,2020-11-16T19:35:49.287,0,,0.0
2020,10,2933,680,7,7659,13,4,5,12,0,0,0,0,0,0,False,False,False,0,3,2020-11-19T17:03:54.673,0,,0.0
2020,10,2933,685,7,910,13,5,6,16,0,0,0,0,0,0,False,False,False,0,2,2020-11-19T19:08:36.817,0,,0.0
2020,10,2933,700,25,4583,13,12,7,16,0,0,0,0,0,0,False,False,False,0,3,2020-11-16T19:42:54.04,0,,
2020,10,2933,705,25,4583,2,26,10,0,6,6,4,2,4,0,False,False,False,0,3,2020-11-16T19:44:51.513,6,,2.0
2020,10,2933,710,25,4583,13,13,10,2,0,0,0,0,0,0,False,False,False,0,3,2020-11-16T19:46:11.303,0,,
2020,10,2933,715,25,7060,13,17,8,18,0,0,0,0,0,0,False,False,False,0,2,2020-11-16T19:47:56.247,0,,0.0
2020,10,2933,720,25,7666,13,19,2,32,0,0,0,0,0,0,False,False,False,0,2,2020-11-16T19:49:15.823,0,,0.0
2020,10,2933,735,7,931,13,5,5,4,0,0,0,0,0,0,False,False,False,0,1,2020-11-16T19:52:14.027,0,,0.0
2020,10,2933,740,7,3521,2,46,3,0,0,0,0,0,0,0,False,False,False,0,3,2021-02-18T19:01:50.38,0,,0.0
2020,10,2933,750,25,7666,13,7,6,45,0,0,0,0,0,0,False,False,False,0,2,2020-11-19T17:03:54.673,0,,0.0
2020,10,2933,755,25,4583,2,39,9,6,9,3,8,1,8,0,False,False,False,1,3,2021-03-08T18:38:43.907,9,,1.0
2020,10,2933,765,25,609,13,38,3,6,0,0,0,0,0,0,False,False,False,0,4,2020-11-19T19:05:31.813,0,,0.0
2020,10,2933,780,7,910,13,19,6,27,0,0,0,0,0,0,False,False,False,0,2,2020-11-16T20:08:06.657,0,,0.0
2020,10,2933,785,7,6383,2,50,9,-1,5,6,2,3,2,0,False,False,False,0,2,2020-11-16T20:09:21.57,5,,3.0
2020,10,2933,805,25,4583,2,13,9,2,8,6,7,1,7,0,False,False,False,0,3,2020-11-16T20:13:36.707,8,,1.0
2020,10,2933,820,25,7666,2,2,10,4,5,1,4,1,4,6,False,False,False,0,2,2020-11-16T20:15:57.1,5,,1.0
2020,10,2933,845,7,3521,2,5,5,4,3,-1,3,0,3,0,False,False,False,0,3,2020-11-16T20:19:49.213,3,,0.0
2020,10,2933,875,7,931,3,16,10,5,0,0,0,0,0,0,False,False,False,0,1,2020-11-16T20:27:27.63,0,,0.0
2020,10,2934,10,1,245,2,49,3,-2,2,4,-1,3,-1,0,False,False,False,0,2,2020-11-19T21:53:12.667,2,,3.0
2020,10,2934,35,1,6406,2,5,5,5,9,4,8,1,8,0,False,False,False,1,3,2020-11-16T13:26:18.793,9,,1.0
2020,10,2934,40,1,5152,2,45,5,2,7,5,6,1,6,0,False,False,False,0,4,2020-11-16T13:28:02.457,7,,1.0
2020,10,2934,60,1,245,13,2,9,5,0,0,0,0,0,0,False,False,False,0,2,2020-11-19T23:17:24.063,0,,0.0
2020,10,2934,65,1,245,13,9,5,5,0,0,0,0,0,0,False,False,False,0,2,2020-11-16T13:37:29.89,0,,0.0
2020,10,2934,80,4,6953,2,31,4,2,6,4,3,3,3,0,False,False,False,0,4,2020-11-16T13:40:39.753,6,,3.0
2020,10,2934,85,4,2853,2,2,4,9,10,1,10,0,10,0,True,False,False,0,3,2021-02-18T17:25:19.9,10,,0.0
2020,10,2934,90,4,1412,13,22,6,33,0,0,0,0,0,0,False,False,False,0,3,2020-11-17T18:15:11.303,0,,0.0
2020,10,2934,100,4,1412,2,50,10,-2,31,33,25,6,25,0,False,False,False,0,2,2020-11-16T13:50:43.23,31,,6.0
2020,10,2934,110,4,5224,2,51,9,-5,12,17,10,2,10,6,False,False,False,1,6,2020-11-16T13:56:35.837,12,,2.0
2020,10,2934,125,1,245,2,5,3,4,4,0,4,0,4,0,False,False,False,0,3,2020-11-16T14:00:31.04,4,,0.0
2020,10,2934,135,1,245,2,52,4,3,6,3,6,0,6,0,False,False,False,0,2,2020-11-16T14:03:51.51,6,,0.0
2020,10,2934,145,4,1412,2,13,10,6,7,1,6,1,6,0,False,False,False,0,3,2020-11-16T14:07:42.213,7,,1.0
2020,10,2934,160,4,2853,2,39,4,5,5,0,5,0,5,0,False,False,False,0,2,2020-11-17T18:15:11.303,5,,0.0
2020,10,2934,170,4,1412,2,3,5,13,11,-2,11,0,11,0,False,False,False,0,2,2020-11-19T23:17:34.567,11,,0.0
2020,10,2934,185,4,594,2,26,9,2,9,7,3,6,3,0,False,False,False,1,3,2020-11-16T14:24:41.16,9,,6.0
2020,10,2934,190,4,1412,13,35,2,20,0,0,0,0,0,0,False,False,False,0,3,2021-02-18T17:26:51.01,0,,0.0
2020,10,2934,205,1,245,2,35,8,17,28,11,20,8,20,0,False,False,False,1,2,2020-11-19T21:44:58.973,28,,8.0
2020,10,2934,220,1,245,13,4,8,15,0,0,0,0,0,0,False,False,False,0,3,2020-11-16T14:33:41.89,0,,0.0
2020,10,2934,235,1,5152,2,39,9,5,9,4,7,2,7,0,False,False,False,0,4,2020-11-19T22:21:50.987,9,,2.0
2020,10,2934,240,1,6405,2,49,10,-3,5,8,1,4,1,0,False,False,False,0,3,2020-11-16T14:54:47.58,5,,4.0
2020,10,2934,255,1,525,2,50,10,-4,4,8,1,3,1,0,False,False,False,0,3,2020-11-16T15:00:16.19,4,,3.0
2020,10,2934,290,4,2853,2,4,10,14,14,0,14,0,14,0,False,False,False,0,3,2020-11-16T19:58:16.207,14,,0.0
2020,10,2934,300,4,6983,3,48,10,-3,0,0,0,0,0,0,False,False,False,0,1,2020-11-16T15:13:09.417,0,,0.0
2020,10,2934,310,4,5119,2,13,9,2,2,0,2,0,2,0,False,False,False,0,3,2020-11-16T15:15:32.297,2,,0.0
2020,10,2934,330,1,4307,2,4,4,4,9,5,8,1,8,0,False,False,False,1,1,2020-11-16T15:36:59.503,9,,1.0
2020,10,2934,345,1,6405,13,4,5,5,0,0,0,0,0,0,False,False,False,0,2,2020-11-16T15:43:03.537,0,,0.0
2020,10,2934,355,1,5152,2,6,9,6,7,1,6,1,6,0,False,False,False,0,3,2020-11-16T15:47:49.997,7,,1.0
2020,10,2934,360,1,5152,2,47,5,3,11,8,9,2,9,0,False,False,False,0,3,2020-11-16T20:11:36.363,11,,2.0
2020,10,2934,385,1,6406,2,44,3,-5,1,6,-1,2,-1,0,True,False,False,0,1,2020-11-16T15:57:23.72,1,,2.0
2020,10,2934,410,1,6405,13,2,10,3,0,0,0,0,0,0,False,False,False,0,2,2020-11-16T16:03:47.59,0,,0.0
2020,10,2934,415,1,525,13,5,5,3,0,0,0,0,0,0,False,False,False,0,3,2020-11-16T16:07:13.033,0,,0.0
2020,10,2934,435,4,594,2,47,5,1,5,4,4,1,4,0,False,False,False,0,3,2020-11-16T16:11:47.797,5,,1.0
2020,10,2934,440,4,594,13,8,8,20,0,0,0,0,0,0,False,False,False,0,3,2020-11-19T23:20:28.93,0,,0.0
2020,10,2934,455,4,594,2,5,3,7,9,2,7,2,7,0,False,False,False,0,3,2020-11-16T20:07:23.177,9,,2.0
2020,10,2934,460,4,6953,3,12,5,5,0,0,0,0,0,0,False,False,False,0,3,2020-11-19T23:21:00.89,0,,0.0
2020,10,2934,485,4,1412,2,4,9,5,5,0,5,0,5,0,False,False,False,0,3,2020-11-16T16:41:02.227,5,,0.0
2020,10,2934,490,4,2853,2,4,3,6,6,0,6,0,6,0,False,False,False,0,2,2020-11-16T16:42:25.453,6,,0.0
2020,10,2934,495,4,594,2,4,9,5,13,8,13,0,13,0,False,False,False,0,3,2020-11-16T16:43:38.967,13,,0.0
2020,10,2934,500,4,1412,2,4,3,5,11,6,11,0,11,0,False,False,False,0,2,2020-11-19T21:50:35.68,11,,0.0
2020,10,2934,520,4,2853,2,50,5,0,0,0,0,0,0,0,False,False,False,1,2,2020-11-16T16:51:48.823,0,,0.0
2020,10,2934,545,4,594,13,17,8,28,0,0,0,0,0,0,False,False,False,0,3,2020-11-19T22:26:18.287,0,,
2020,10,2934,555,4,594,2,35,7,16,22,6,22,0,22,6,False,False,False,0,3,2020-11-16T17:09:20.88,22,,0.0
2020,10,2934,575,1,6405,2,12,5,9,9,0,9,0,9,0,False,False,False,0,2,2021-02-18T17:30:12.307,9,,0.0
2020,10,2934,580,1,245,2,35,2,24,35,11,31,4,31,0,False,False,False,0,2,2020-11-16T17:18:23.55,35,,4.0
2020,10,2934,585,1,6405,2,44,3,1,6,5,6,0,6,0,False,False,False,0,2,2020-11-19T22:27:36.617,6,,0.0
2020,10,2934,590,1,525,2,5,5,4,10,6,2,8,2,0,False,False,False,2,3,2021-03-03T15:32:12.44,10,,
2020,10,2934,595,1,6406,2,46,3,3,11,8,8,3,8,0,False,False,False,1,1,2020-11-16T17:29:10.067,11,,3.0
2020,10,2934,600,1,6405,2,4,10,7,7,0,7,0,7,0,False,False,False,0,2,2020-11-16T17:32:31.193,7,,0.0
2020,10,2934,635,4,594,13,39,4,5,0,0,0,0,0,0,False,False,False,0,3,2020-11-19T23:21:20.283,0,,0.0
2020,10,2934,640,4,2853,2,4,10,-4,5,9,-2,7,-2,0,False,False,False,0,2,2020-11-19T21:50:48.56,5,,7.0
2020,10,2934,660,1,525,13,5,9,7,0,0,0,0,0,0,False,False,False,0,3,2020-11-16T17:52:18.993,0,,0.0
2020,10,2934,685,4,6983,2,4,10,0,21,21,19,2,19,0,False,False,False,0,1,2020-11-19T22:28:42.933,21,,
2020,10,2934,690,4,6953,13,8,7,24,0,0,0,0,0,0,True,False,False,0,3,2021-03-05T14:53:30.32,0,,0.0
2020,10,2934,705,1,6405,13,5,5,9,0,0,0,0,0,0,False,False,False,0,2,2020-11-16T18:11:08.103,0,,
2020,10,2934,725,4,1412,2,50,9,-3,7,10,3,4,3,0,False,False,False,0,3,2020-11-16T18:18:05.183,7,,4.0
2020,10,2934,740,4,594,2,4,9,5,7,2,6,1,6,0,False,False,False,0,3,2020-11-16T18:20:54.763,7,,1.0
2020,10,2934,745,4,1412,13,19,2,34,0,0,0,0,0,0,False,False,False,0,2,2021-02-18T17:32:44.453,0,,0.0
2020,10,2934,755,4,6983,2,28,4,-6,-5,1,-5,0,-5,0,False,False,False,1,1,2020-11-19T22:29:38.45,-5,,0.0
2020,10,2934,790,1,525,3,17,1,20,0,0,0,0,0,0,False,False,False,0,3,2021-03-09T20:08:44.933,0,,0.0
2020,10,2934,795,4,6953,2,30,9,-3,10,13,3,7,3,0,False,False,False,1,4,2020-11-16T18:37:38.517,10,,7.0
2020,10,2934,800,4,6983,13,12,10,5,0,0,0,0,0,0,False,False,False,0,1,2020-11-19T23:27:08.237,0,,
2020,10,2934,810,4,594,2,4,3,8,12,4,10,2,10,0,False,False,False,0,3,2020-11-16T18:42:32.393,12,,2.0
2020,10,2934,820,4,1412,2,12,2,24,24,0,24,0,24,0,False,False,False,0,3,2020-11-16T18:57:10.86,24,,
2020,10,2934,825,4,2853,2,51,3,-6,21,27,19,2,19,0,True,False,False,0,3,2020-11-16T18:59:20.36,21,,2.0
2020,10,2934,855,4,7646,13,35,3,11,0,0,0,0,0,0,False,False,False,0,3,2021-03-05T14:54:24.553,0,,0.0
2020,10,2934,865,1,245,13,2,9,4,0,0,0,0,0,0,False,False,False,0,3,2020-11-19T23:21:50.243,0,,0.0
2020,10,2934,880,4,2853,2,26,9,3,6,3,3,3,3,0,False,False,False,0,3,2020-11-16T19:17:05.053,6,,3.0
2020,10,2934,885,4,7646,13,12,6,15,0,0,0,0,0,0,False,False,False,0,2,2021-02-18T17:32:08.283,0,,0.0
2020,10,2934,890,4,594,2,5,3,4,4,0,4,0,4,0,False,False,False,0,3,2020-11-16T19:20:27.447,4,,0.0
2020,10,2934,895,4,7645,13,12,9,5,0,0,0,0,0,0,False,False,False,0,1,2020-11-16T19:21:51.377,0,,0.0
2020,10,2934,905,4,2853,2,4,9,4,5,1,5,0,5,0,False,False,False,0,3,2020-11-16T19:24:15.8,5,,0.0
2020,10,2934,915,4,7646,13,2,9,9,0,0,0,0,0,0,False,False,False,0,3,2020-11-16T19:26:28.423,0,,0.0
2020,10,2934,920,4,594,2,5,5,4,7,3,5,2,5,0,False,False,False,0,3,2020-11-16T19:27:57.253,7,,2.0
2020,10,2934,925,4,7645,2,48,9,-7,-3,4,-5,2,-5,0,False,False,False,1,1,2021-03-03T15:32:36.4,-3,,2.0
2020,10,2934,930,4,594,2,6,1,17,17,0,17,0,17,0,False,False,False,0,3,2020-11-19T23:22:11.637,17,,0.0
2020,10,2934,935,4,2853,2,51,3,-2,1,3,0,1,0,0,False,False,False,0,3,2020-11-16T19:34:30.007,1,,
2020,10,2934,940,4,594,2,4,10,2,4,2,4,0,4,0,False,False,False,0,3,2020-11-16T19:36:06.043,4,,0.0
2020,10,2934,950,4,2853,2,7,6,21,21,0,21,0,21,6,False,False,False,0,3,2020-11-19T23:22:30.77,21,,0.0
2020,10,2934,965,1,7315,2,4,4,14,14,0,14,0,14,0,False,False,False,1,3,2020-11-16T19:42:44.347,14,,0.0
2020,10,2934,975,1,245,2,2,9,4,9,5,8,1,8,0,False,False,False,0,2,2020-11-16T19:44:06.983,9,,1.0
2020,10,2934,985,1,525,2,12,5,6,9,3,9,0,9,0,False,False,False,0,3,2020-11-16T19:45:57.543,9,,0.0
2020,10,2934,995,1,245,2,12,6,43,43,0,43,0,43,6,False,False,False,0,2,2021-03-08T20:51:04.943,43,,0.0
2020,10,2935,10,10,7700,13,35,8,16,0,0,0,0,0,0,False,False,False,0,3,2020-11-16T13:48:20.063,0,,0.0
2020,10,2935,20,10,6282,2,46,9,0,1,1,0,1,0,0,False,False,False,0,1,2020-11-19T21:54:04.92,1,,1.0
2020,10,2935,40,23,7250,2,26,10,5,25,20,23,2,23,0,False,False,False,0,3,2020-11-19T21:31:54.877,25,,2.0
2020,10,2935,45,23,7688,2,5,5,3,9,6,7,2,7,0,False,False,False,0,3,2020-11-16T14:10:19.587,9,,2.0
2020,10,2935,75,10,6840,2,5,5,4,9,5,9,0,9,0,False,False,False,0,4,2020-11-19T21:33:01.137,9,,0.0
2020,10,2935,85,10,4930,2,35,5,10,14,4,14,0,14,0,False,False,False,0,3,2020-11-16T14:32:20.567,14,,0.0
2020,10,2935,90,10,7700,2,4,7,17,17,0,17,0,17,0,False,False,False,0,3,2020-11-19T23:02:58.78,17,,0.0
2020,10,2935,95,10,7700,13,19,6,32,0,0,0,0,0,0,False,False,False,0,2,2020-11-16T14:37:58.997,0,,0.0
2020,10,2935,105,10,6285,13,7,6,22,0,0,0,0,0,0,False,False,False,0,3,2020-11-16T14:42:41.17,0,,0.0
2020,10,2935,130,23,7688,3,19,6,36,0,0,0,0,0,0,False,False,False,0,2,2021-04-01T19:21:51.953,0,,0.0
2020,10,2935,145,10,6840,2,53,10,-5,0,5,-2,2,-2,0,False,False,False,0,4,2020-11-16T14:58:35.347,0,,2.0
2020,10,2935,150,10,7701,2,2,9,4,11,7,11,0,11,0,False,False,False,0,3,2020-11-19T21:35:48.057,11,,0.0
2020,10,2935,175,10,4930,13,6,10,7,0,0,0,0,0,0,False,False,False,0,2,2020-11-16T15:13:36.23,0,,0.0
2020,10,2935,180,10,7701,13,17,1,31,0,0,0,0,0,0,False,False,False,0,3,2021-03-05T14:56:51.673,0,,0.0
2020,10,2935,190,23,3957,2,46,9,2,2,0,2,0,2,0,False,False,False,0,1,2020-11-19T22:27:24.17,2,,0.0
2020,10,2935,195,23,2256,13,9,6,24,0,0,0,0,0,0,False,False,False,0,2,2020-11-19T23:02:58.78,0,,
2020,10,2935,240,23,7241,2,48,10,-3,3,6,0,3,0,0,False,False,False,0,1,2020-11-16T16:03:16.067,3,,3.0
2020,10,2935,245,23,2256,13,6,1,15,0,0,0,0,0,0,False,False,False,0,2,2020-11-19T21:36:59.88,0,,0.0
2020,10,2935,260,10,6481,3,12,5,3,0,0,0,0,0,0,False,False,False,0,1,2020-11-16T16:10:45.987,0,,0.0
2020,10,2935,265,10,7701,13,4,10,4,0,0,0,0,0,0,False,False,False,0,3,2020-11-16T16:13:30.673,0,,0.0
2020,10,2935,270,10,7700,2,22,2,25,26,1,25,1,25,0,False,False,False,0,2,2020-11-16T16:15:29.963,26,,1.0
2020,10,2935,275,10,4930,2,19,2,25,27,2,27,0,27,0,False,False,False,0,2,2020-11-16T16:17:22.163,27,,0.0
2020,10,2935,280,10,6285,13,4,10,2,0,0,0,0,0,0,False,False,False,0,4,2020-11-16T20:29:31.647,0,,0.0
2020,10,2935,290,10,7701,2,5,5,1,1,0,1,0,1,0,False,False,False,0,3,2020-11-16T16:22:54.56,1,,0.0
2020,10,2935,310,23,2994,2,4,5,5,8,3,6,2,6,0,False,False,False,0,2,2021-03-04T19:12:33.067,8,,2.0
2020,10,2935,320,23,7241,2,12,3,1,8,7,2,6,2,0,False,False,False,1,1,2021-03-08T20:53:34.323,8,,6.0
2020,10,2935,330,23,7688,2,46,3,1,1,0,1,0,1,0,True,False,False,0,4,2020-11-19T23:02:58.78,1,,0.0
2020,10,2935,335,23,7250,13,12,2,23,0,0,0,0,0,0,False,False,False,0,3,2020-11-16T20:24:55.447,0,,
2020,10,2935,345,23,7689,2,7,6,15,16,1,15,1,15,0,False,False,False,0,3,2020-11-19T22:30:53.72,16,,1.0
2020,10,2935,360,23,2256,3,8,4,6,0,0,0,0,0,0,False,False,False,0,3,2020-11-19T23:02:58.78,0,,0.0
2020,10,2935,380,10,6840,2,5,5,5,9,4,6,3,6,0,False,False,False,0,4,2020-11-16T16:57:46.84,9,,3.0
2020,10,2935,385,10,282,3,45,5,-3,0,0,0,0,0,0,False,False,False,0,1,2021-04-01T19:28:39.377,0,,0.0
2020,10,2935,405,10,7701,2,6,1,16,27,11,23,4,23,0,False,False,False,1,3,2021-03-03T16:04:49.2,27,,4.0
2020,10,2935,415,10,4930,13,12,5,10,0,0,0,0,0,0,False,False,False,0,2,2020-11-19T18:44:51.033,0,,0.0
2020,10,2935,420,10,4930,2,26,9,4,14,10,10,4,10,0,False,False,False,0,2,2020-11-16T20:25:37.047,14,,4.0
2020,10,2935,425,10,4930,2,6,10,4,6,2,6,0,6,0,False,False,False,0,3,2020-11-16T17:18:22.423,6,,0.0
2020,10,2935,435,10,7700,13,2,9,10,0,0,0,0,0,0,False,False,False,0,2,2020-11-19T22:34:47.147,0,,0.0
2020,10,2935,455,23,2994,13,17,1,16,0,0,0,0,0,0,False,False,False,0,3,2020-11-16T17:49:50.813,0,,0.0
2020,10,2935,460,23,2256,2,4,3,8,8,0,8,0,8,0,False,False,False,0,2,2020-11-19T23:02:58.78,8,,0.0
2020,10,2935,480,23,2994,3,9,6,34,0,0,0,0,0,0,True,False,False,0,3,2020-11-19T23:02:58.78,0,,0.0
2020,10,2935,495,23,2994,2,17,1,19,24,5,22,2,22,0,False,False,False,0,3,2020-11-19T22:35:54.947,24,,2.0
2020,10,2935,505,23,2256,13,5,6,19,0,0,0,0,0,0,False,False,False,0,3,2020-11-16T18:04:33.017,0,,0.0
2020,10,2935,510,23,7241,2,44,3,-2,0,2,-1,1,-1,0,False,False,False,0,1,2020-11-19T23:02:58.78,0,,1.0
2020,10,2935,530,10,7701,13,13,10,4,0,0,0,0,0,0,False,False,False,0,3,2020-11-16T20:31:14.727,0,,0.0
2020,10,2935,535,10,7700,13,12,2,16,0,0,0,0,0,0,False,False,False,0,2,2020-11-16T18:11:43.257,0,,0.0
2020,10,2935,560,23,7250,2,50,5,-1,5,6,4,1,4,0,False,False,False,0,3,2020-11-16T18:18:51.02,5,,1.0
2020,10,2935,570,23,7688,2,12,6,19,21,2,19,2,19,0,False,False,False,0,3,2020-11-16T18:21:31.95,21,,2.0
2020,10,2935,595,23,7241,2,16,4,7,13,6,10,3,10,0,False,False,False,0,1,2020-11-16T18:30:15.85,13,,3.0
2020,10,2935,600,23,2994,2,6,4,5,5,0,5,0,5,0,False,False,False,0,4,2020-11-16T18:31:50.977,5,,0.0
2020,10,2935,625,10,6840,13,4,4,5,0,0,0,0,0,0,False,False,False,0,4,2020-11-19T22:37:37.603,0,,0.0
2020,10,2935,635,23,4949,2,47,10,-1,6,7,4,2,4,0,True,False,False,1,4,2020-11-17T15:43:11.27,6,,2.0
2020,10,2935,645,23,7246,13,8,4,4,0,0,0,0,0,0,False,False,False,0,3,2020-11-19T23:02:58.78,0,,0.0
2020,10,2935,660,10,7701,13,12,5,5,0,0,0,0,0,0,False,False,False,0,3,2021-03-08T20:54:43.153,0,,0.0
2020,10,2935,670,10,7701,13,2,9,4,0,0,0,0,0,0,False,False,False,0,3,2020-11-19T22:39:04.31,0,,
2020,10,2935,680,10,6840,13,33,10,14,0,0,0,0,0,0,False,False,False,0,4,2021-04-01T19:29:01.49,0,,0.0
2020,10,2935,715,10,6285,2,4,9,4,6,2,6,0,6,0,False,True,True,0,3,2020-11-17T02:14:32.863,6,,0.0
2020,10,2935,735,10,6285,2,4,5,7,7,0,7,0,7,0,False,False,False,0,2,2020-11-17T02:01:37.45,7,,0.0
2020,10,2935,740,10,7701,2,4,9,4,11,7,4,7,4,0,False,False,False,1,3,2021-03-03T16:05:20.843,11,,7.0
2020,10,2935,745,10,6285,13,4,10,10,0,0,0,0,0,0,False,False,False,0,2,2020-11-19T23:02:58.78,0,,
2020,10,2935,755,10,7701,13,2,4,5,0,0,0,0,0,0,False,False,False,0,3,2020-11-16T19:32:04.743,0,,0.0
2020,10,2935,760,10,7701,13,13,9,1,0,0,0,0,0,0,False,False,False,0,3,2020-11-16T20:31:50.383,0,,0.0
2020,10,2935,765,10,6285,2,12,5,13,13,0,13,0,13,0,False,False,False,0,3,2020-11-19T21:49:25.163,13,,0.0
2020,10,2935,770,10,6286,2,5,5,8,8,0,8,0,8,0,False,False,False,0,3,2020-11-16T19:36:28.357,8,,0.0
2020,10,2935,775,10,6286,2,5,5,4,4,0,4,0,4,0,False,False,False,0,4,2020-11-16T19:38:01.763,4,,0.0
2020,10,2935,780,10,282,3,16,4,3,0,0,0,0,0,0,False,False,False,0,1,2020-11-19T22:39:35.68,0,,0.0
2020,10,2935,785,10,6840,13,6,10,4,0,0,0,0,0,0,False,False,False,0,4,2020-11-19T23:02:58.78,0,,0.0
2020,10,2935,795,10,6285,2,6,10,7,7,0,7,0,7,6,False,False,False,0,3,2020-11-17T02:02:43.993,7,,0.0
2020,10,2935,865,10,7700,2,4,9,7,9,2,7,2,7,0,False,False,False,1,2,2020-11-16T19:58:48.233,9,,2.0
2020,10,2935,875,10,6840,13,39,4,5,0,0,0,0,0,0,False,False,False,0,4,2020-11-19T23:02:58.78,0,,0.0
2020,10,2935,880,10,6282,2,6,5,8,14,6,8,6,8,0,True,False,False,1,2,2021-03-03T16:05:38.65,14,,6.0
2020,10,2935,885,10,7700,2,9,2,16,16,0,16,0,16,0,False,False,False,0,2,2021-02-25T16:14:32.05,16,,0.0
2020,10,2935,890,10,6286,13,17,8,15,0,0,0,0,0,0,False,False,False,0,3,2020-11-17T02:27:15.633,0,,0.0
2020,6,2936,15,22,256,13,9,6,30,0,0,0,0,0,0,False,False,False,0,3,2020-10-22T15:49:23.283,0,,
2020,6,2936,20,22,256,13,19,6,29,0,0,0,0,0,0,False,False,False,0,2,2020-10-19T10:45:01.507,0,,
2020,6,2936,40,17,2253,13,8,10,13,0,0,0,0,0,0,False,False,False,0,2,2020-10-19T10:51:58.893,0,,
2020,6,2936,55,22,7118,13,9,6,24,0,0,0,0,0,0,False,False,False,0,3,2020-10-19T10:57:11.653,0,,
2020,6,2936,60,22,6270,13,11,6,32,0,0,0,0,0,0,False,False,False,0,3,2020-10-19T10:59:51.673,0,,
2020,6,2936,70,17,7024,2,32,3,-5,6,11,4,2,4,0,False,False,False,0,1,2020-10-22T18:35:09.233,6,,
2020,6,2936,80,17,4305,2,4,5,4,8,4,7,1,7,0,False,False,False,0,2,2020-10-22T18:38:31.497,8,,
2020,6,2936,90,17,7024,2,4,10,4,6,2,6,0,6,0,False,False,False,0,1,2020-10-19T11:15:35.173,6,,
2020,6,2936,105,17,4484,2,30,10,-2,4,6,4,0,4,6,False,False,False,0,4,2020-10-19T11:21:05.033,4,,
2020,6,2936,120,22,3170,2,30,5,-1,1,2,0,1,0,0,True,False,False,0,3,2020-10-19T11:24:27.073,1,,
2020,6,2936,125,22,2391,2,39,4,7,9,2,7,2,7,0,False,False,False,0,2,2020-10-22T15:49:23.283,9,,
2020,6,2936,130,22,6270,2,4,10,6,18,12,6,12,6,0,False,False,False,2,3,2020-10-19T11:28:56.03,18,,
2020,6,2936,135,22,256,2,50,9,0,2,2,1,1,1,0,False,False,False,0,2,2020-10-19T11:30:40.363,2,,
2020,6,2936,155,22,3170,2,16,10,8,9,1,8,1,8,0,False,False,False,0,3,2020-10-22T15:49:23.283,9,,
2020,6,2936,165,22,3170,2,39,4,5,8,3,8,0,8,0,False,False,False,0,3,2020-10-22T15:49:23.283,8,,
2020,6,2936,175,22,256,2,13,10,3,9,6,6,3,6,0,False,False,False,0,3,2020-10-19T17:37:14.87,9,,
2020,6,2936,195,17,4913,2,4,4,1,10,9,8,2,8,0,False,False,False,0,1,2020-10-22T18:43:57.17,10,,
2020,6,2936,205,17,2253,2,4,9,8,10,2,9,1,9,0,False,False,False,0,3,2020-10-19T12:07:58.287,10,,
2020,6,2936,215,17,7024,2,48,9,-5,16,21,14,2,14,0,False,False,False,0,1,2020-10-19T12:15:45.713,16,,
2020,6,2936,225,17,7087,2,2,9,3,3,0,3,0,3,6,False,False,False,0,2,2020-10-19T12:19:20.133,3,,
2020,6,2936,260,17,2253,3,2,9,7,0,0,0,0,0,0,False,False,False,0,3,2020-10-19T12:39:42.05,0,,
2020,6,2936,285,22,3170,3,12,5,9,0,0,0,0,0,0,True,False,False,0,2,2020-10-20T20:40:11.977,0,,
2020,6,2936,290,22,7118,13,35,9,12,0,0,0,0,0,0,True,False,False,0,3,2021-03-05T19:27:19.823,0,,
2020,6,2936,295,17,4913,2,48,10,-3,-3,0,-3,0,-3,0,False,False,False,0,1,2020-10-19T12:53:47.777,-3,,
2020,6,2936,305,17,2253,13,3,5,12,0,0,0,0,0,0,False,False,False,0,2,2020-10-19T12:56:13.267,0,,
2020,6,2936,310,17,4305,2,50,9,0,3,3,2,1,2,0,False,False,False,0,2,2020-10-19T12:59:10.027,3,,
2020,6,2936,330,22,3170,2,26,10,3,1,-2,2,-1,2,0,True,False,False,0,3,2020-10-20T20:40:34.007,1,,
2020,6,2936,335,22,3170,13,5,6,15,0,0,0,0,0,0,True,False,False,0,3,2020-10-22T15:49:23.283,0,,
2020,6,2936,350,17,4484,2,17,1,20,43,23,41,2,41,0,False,False,False,0,3,2020-10-19T13:22:29.71,43,,
2020,6,2936,360,17,6276,2,47,5,4,4,0,4,0,4,6,False,False,False,0,4,2020-10-19T13:25:28.577,4,,
2020,6,2936,380,22,7609,3,11,3,0,0,0,0,0,0,0,False,False,False,0,1,2020-10-22T18:53:57.96,0,,
2020,6,2936,385,22,7609,2,44,9,-6,2,8,1,1,1,0,False,False,False,0,1,2020-10-19T13:31:54.827,2,,
2020,6,2936,400,17,7024,2,28,10,0,7,7,4,3,4,0,False,False,False,0,1,2020-10-19T13:35:27.253,7,,
2020,6,2936,410,17,4305,2,4,8,15,30,15,26,4,26,0,False,False,False,0,2,2020-10-19T13:41:04.8,30,,
2020,6,2936,420,17,6274,13,8,4,11,0,0,0,0,0,0,False,False,False,0,3,2021-03-05T19:27:45.677,0,,
2020,6,2936,425,22,1113,2,28,9,0,9,9,5,4,5,0,False,False,False,1,1,2020-10-22T18:22:09.44,9,,
2020,6,2936,435,22,3170,13,12,4,6,0,0,0,0,0,0,False,False,False,0,3,2020-10-22T15:44:12.583,0,,
2020,6,2936,440,22,3170,13,7,6,20,0,0,0,0,0,0,False,False,False,0,2,2020-10-19T13:49:42.057,0,,
2020,6,2936,475,17,2253,13,2,9,3,0,0,0,0,0,0,False,False,False,0,2,2020-10-19T14:09:47.117,0,,
2020,6,2936,540,22,3170,13,13,9,4,0,0,0,0,0,0,False,False,False,0,2,2020-10-22T15:49:23.283,0,,
2020,6,2936,545,22,3170,2,51,3,0,4,4,3,1,3,0,False,False,False,0,3,2020-10-19T14:41:00.39,4,,
2020,6,2936,555,17,7087,2,2,10,11,15,4,12,3,12,0,False,False,False,0,3,2021-02-16T22:33:57.837,15,,
2020,6,2936,560,17,2253,2,7,6,15,18,3,15,3,15,0,False,False,False,0,3,2020-10-19T14:53:53.527,18,,
2020,6,2936,565,17,4484,2,12,9,-4,4,8,3,1,3,0,False,False,False,0,4,2020-10-19T14:59:00.167,4,,
2020,6,2936,570,17,2253,2,18,3,0,7,7,2,5,2,0,False,False,False,1,2,2020-10-19T15:01:34.23,7,,
2020,6,2936,585,17,6276,13,2,4,7,0,0,0,0,0,0,False,False,False,0,4,2020-10-19T15:07:59.407,0,,
2020,6,2936,610,22,7118,2,6,10,6,8,2,8,0,8,0,False,False,False,0,2,2020-10-19T15:17:11.8,8,,
2020,6,2936,645,17,2253,13,4,3,12,0,0,0,0,0,0,False,False,False,0,2,2020-10-19T15:28:22.04,0,,
2020,6,2936,660,22,6812,13,5,3,4,0,0,0,0,0,0,False,False,False,0,1,2020-10-19T15:32:28.917,0,,
2020,6,2936,680,17,7087,13,19,6,47,0,0,0,0,0,0,False,False,False,0,2,2021-03-05T19:28:22.193,0,,
2020,6,2936,690,22,3170,2,35,3,11,13,2,12,1,12,0,True,False,False,0,3,2020-10-22T15:49:23.283,13,,
2020,6,2936,695,22,1113,2,12,3,4,6,2,6,0,6,0,False,False,False,0,1,2021-03-08T19:58:45.687,6,,
2020,6,2936,700,22,6270,13,16,10,1,0,0,0,0,0,0,True,False,False,0,3,2021-02-16T22:36:25.057,0,,
2020,6,2936,705,22,256,2,35,5,12,22,10,18,4,18,0,True,False,False,0,3,2020-10-19T16:00:52.7,22,,
2020,6,2936,710,22,256,13,19,2,30,0,0,0,0,0,0,False,False,False,0,2,2020-10-19T16:03:03.28,0,,
2020,6,2936,715,22,1113,2,46,9,0,6,6,3,3,3,0,True,False,False,0,1,2021-02-16T22:28:26.477,6,,
2020,6,2936,740,17,6274,13,7,7,16,0,0,0,0,0,0,False,False,False,0,3,2021-03-09T19:45:02.863,0,,
2020,6,2936,750,22,1113,2,47,10,0,3,3,2,1,2,0,False,False,False,0,1,2020-10-19T16:29:10.903,3,,
2020,6,2936,755,22,2391,13,47,5,3,0,0,0,0,0,0,False,False,False,0,4,2020-10-19T16:32:38.647,0,,
2020,6,2936,760,22,3170,2,42,10,4,12,8,9,3,9,0,False,False,False,0,3,2020-10-19T16:35:24.773,12,,
2020,6,2936,770,22,256,2,6,4,4,21,17,19,2,19,0,False,False,False,1,3,2020-10-22T19:11:57.043,21,,
2020,6,2936,775,22,7118,13,19,2,33,0,0,0,0,0,0,False,False,False,0,2,2020-10-19T16:41:51.747,0,,
2020,6,2936,780,22,2391,2,13,9,6,8,2,8,0,8,0,False,False,False,0,4,2020-10-19T16:45:35.543,8,,
2020,6,2936,790,22,256,2,35,10,8,17,9,14,3,14,0,False,False,False,1,3,2020-10-19T16:49:26.467,17,,
2020,6,2936,795,22,7609,2,44,9,-1,7,8,1,6,1,0,False,False,False,0,1,2021-02-25T14:58:51.96,7,,
2020,6,2936,815,22,256,13,6,4,7,0,0,0,0,0,0,False,False,False,0,3,2020-10-19T16:56:32.57,0,,
2020,6,2936,830,17,7051,2,46,3,1,2,1,2,0,2,0,False,False,False,0,1,2020-10-22T19:04:19.123,2,,
2020,6,2936,835,17,4305,2,4,10,7,7,0,7,0,7,0,False,False,False,0,2,2021-02-16T22:30:54.227,7,,
2020,10,2937,10,29,4866,2,50,9,-2,8,10,7,1,7,0,False,False,False,1,2,2021-03-04T19:20:09.34,8,,1.0
2020,10,2937,15,29,1958,2,51,10,-7,5,12,4,1,4,0,True,False,False,0,3,2020-11-16T18:19:59.603,5,,1.0
2020,10,2937,30,29,4875,2,4,3,5,11,6,11,0,11,0,False,False,False,0,2,2020-11-16T13:21:21.403,11,,0.0
2020,10,2937,35,29,4866,2,23,7,31,31,0,31,0,31,0,False,False,False,0,3,2020-11-19T17:48:19.887,31,,0.0
2020,10,2937,50,29,4866,13,26,9,4,0,0,0,0,0,0,False,False,False,0,3,2021-02-18T18:47:52.81,0,,0.0
2020,10,2937,70,27,5069,2,51,9,-5,7,12,7,0,7,0,True,False,False,0,3,2021-02-18T18:54:07.51,7,,0.0
2020,10,2937,75,27,505,2,17,7,17,22,5,22,0,22,0,False,False,False,0,3,2021-02-19T18:30:04.96,22,,0.0
2020,10,2937,80,27,7852,2,44,3,-1,21,22,21,0,21,0,True,False,False,0,3,2021-02-18T18:57:06.86,21,,0.0
2020,10,2937,90,27,7852,2,4,10,5,8,3,7,1,7,0,False,False,False,0,4,2020-11-16T13:39:14.76,8,,1.0
2020,10,2937,120,29,3398,2,7,6,21,39,18,36,3,36,0,False,False,False,0,3,2020-11-16T13:49:04.253,39,,3.0
2020,10,2937,130,29,3398,2,53,4,0,14,14,7,7,7,0,False,False,False,0,4,2020-11-19T18:20:53.237,14,,7.0
2020,10,2937,135,29,4850,2,35,10,10,16,6,13,3,13,0,False,False,False,0,4,2020-11-16T13:54:29.7,16,,3.0
2020,10,2937,160,27,5069,13,19,2,15,0,0,0,0,0,0,False,False,False,0,2,2021-03-04T19:20:31.31,0,,
2020,10,2937,165,27,650,13,19,2,34,0,0,0,0,0,0,False,False,False,0,2,2020-11-19T17:12:03.393,0,,0.0
2020,10,2937,170,27,4835,2,39,4,4,6,2,5,1,5,0,False,False,False,0,3,2021-02-18T19:40:36.777,6,,1.0
2020,10,2937,175,27,650,2,12,4,6,7,1,7,0,7,0,False,False,False,0,2,2021-02-19T18:30:34.673,7,,0.0
2020,10,2937,190,27,650,2,6,4,10,10,0,10,0,10,0,True,False,False,0,3,2021-02-18T20:41:28.067,10,,0.0
2020,10,2937,195,27,650,13,8,7,45,0,0,0,0,0,0,False,False,False,0,3,2020-11-19T17:19:36.597,0,,0.0
2020,10,2937,220,29,1958,2,5,5,7,8,1,8,0,8,0,False,False,False,0,3,2020-11-16T14:23:29.857,8,,0.0
2020,10,2937,225,29,4875,2,5,3,9,9,0,9,0,9,0,False,False,False,0,2,2020-11-16T14:25:56.737,9,,0.0
2020,10,2937,230,29,3398,13,4,4,3,0,0,0,0,0,0,False,False,False,0,4,2020-11-19T18:21:09.353,0,,0.0
2020,10,2937,235,29,4875,2,4,3,5,9,4,7,2,7,0,False,False,False,0,2,2020-11-16T14:29:03.033,9,,2.0
2020,10,2937,260,29,3356,2,51,9,-5,11,16,8,3,8,0,False,False,False,0,3,2020-11-19T17:49:49.833,11,,3.0
2020,10,2937,270,29,4875,2,30,10,0,10,10,7,3,7,0,False,False,False,0,3,2020-11-19T16:29:12.573,10,,3.0
2020,10,2937,280,29,4866,2,2,10,7,9,2,9,0,9,0,False,False,False,0,3,2020-11-19T16:58:59.353,9,,0.0
2020,10,2937,300,27,650,2,4,9,5,6,1,6,0,6,0,False,False,False,0,2,2020-11-16T15:02:59.093,6,,0.0
2020,10,2937,305,27,650,2,11,3,13,39,26,39,0,39,0,True,False,False,0,3,2020-11-19T18:21:22.423,39,,0.0
2020,10,2937,315,27,7852,13,35,7,24,0,0,0,0,0,0,False,False,False,0,3,2020-11-16T15:06:42.67,0,,0.0
2020,10,2937,320,27,7404,2,45,5,-4,5,9,4,1,4,0,True,False,False,0,1,2020-11-16T15:07:54.363,5,,1.0
2020,10,2937,335,29,7828,2,6,10,14,15,1,15,0,15,0,False,False,False,0,2,2020-11-19T17:50:26.86,15,,0.0
2020,10,2937,350,27,6397,13,11,6,22,0,0,0,0,0,0,True,False,False,0,4,2020-11-17T17:12:09.97,0,,0.0
2020,10,2937,355,29,3398,2,4,10,6,7,1,6,1,6,0,False,False,False,0,4,2020-11-16T15:22:25.03,7,,1.0
2020,10,2937,365,29,3398,3,4,10,5,0,0,0,0,0,0,True,False,False,0,3,2020-11-19T17:00:14.76,0,,0.0
2020,10,2937,370,29,4850,2,2,10,6,11,5,7,4,7,0,False,False,False,1,3,2020-11-16T15:25:22.427,11,,4.0
2020,10,2937,375,29,4850,3,26,10,5,0,0,0,0,0,0,False,False,False,0,3,2020-11-19T18:21:44.06,0,,0.0
2020,10,2937,390,29,4875,2,50,10,0,8,8,7,1,7,0,False,False,False,0,2,2020-11-16T15:30:36.513,8,,1.0
2020,10,2937,405,27,7404,2,47,5,1,2,1,1,1,1,0,False,False,False,0,1,2020-11-16T15:32:09.68,2,,1.0
2020,10,2937,410,27,7404,2,6,4,3,12,9,12,0,12,0,False,False,False,0,1,2020-11-16T15:33:17.61,12,,0.0
2020,10,2937,420,27,7850,2,28,10,-1,10,11,8,2,8,0,False,False,False,0,1,2020-11-16T15:35:52.793,10,,2.0
2020,10,2937,435,27,7850,2,12,10,0,13,13,1,12,1,0,False,False,False,1,1,2021-03-08T20:57:02.363,13,,12.0
2020,10,2937,445,27,505,13,12,3,1,0,0,0,0,0,0,False,False,False,0,3,2021-03-08T20:57:46.853,0,,0.0
2020,10,2937,450,27,650,13,2,9,8,0,0,0,0,0,0,False,False,False,0,3,2020-11-19T18:23:29.543,0,,0.0
2020,10,2937,455,27,5069,3,5,5,5,0,0,0,0,0,0,False,False,False,0,2,2020-11-19T18:23:38.947,0,,0.0
2020,10,2937,505,29,4866,2,50,9,-3,5,8,4,1,4,0,False,False,False,0,3,2020-11-19T17:50:55.12,5,,1.0
2020,10,2937,510,29,4866,13,8,1,25,0,0,0,0,0,0,False,False,False,0,3,2020-11-16T16:00:47.873,0,,0.0
2020,10,2937,515,29,4875,2,4,6,17,17,0,17,0,17,0,False,False,False,0,3,2021-02-18T21:43:04.123,17,,0.0
2020,10,2937,520,29,4875,2,6,8,20,21,1,21,0,21,0,False,False,False,0,2,2020-11-16T18:29:52.81,21,,0.0
2020,10,2937,525,29,4875,13,5,6,17,0,0,0,0,0,0,False,False,False,0,3,2020-11-16T16:06:23.937,0,,0.0
2020,10,2937,530,29,7378,2,48,10,-5,5,10,4,1,4,0,False,False,False,0,1,2021-02-19T18:35:52.567,5,,1.0
2020,10,2937,540,29,1958,2,50,3,0,7,7,6,1,6,0,False,False,False,0,2,2020-11-16T16:24:52.297,7,,1.0
2020,10,2937,545,29,4875,2,18,3,2,9,7,6,3,6,0,False,False,False,0,3,2021-02-19T18:36:36.75,9,,3.0
2020,10,2937,565,29,4850,13,5,5,4,0,0,0,0,0,0,False,False,False,0,4,2020-11-16T16:34:17.99,0,,
2020,10,2937,590,27,3656,13,12,3,8,0,0,0,0,0,0,False,False,False,0,1,2020-11-19T18:24:15.983,0,,0.0
2020,10,2937,605,29,4875,3,6,10,14,0,0,0,0,0,0,False,False,False,0,2,2020-11-19T17:07:09.463,0,,0.0
2020,10,2937,615,29,3356,2,45,5,-2,7,9,5,2,5,0,False,False,False,0,1,2020-11-19T17:54:17.813,7,,2.0
2020,10,2937,620,29,4866,2,45,5,-3,-3,0,-3,0,-3,0,True,False,False,0,3,2020-11-19T18:24:31.393,-3,,0.0
2020,10,2937,630,29,1958,2,50,9,-2,8,10,6,2,6,0,False,False,False,0,3,2020-11-19T16:25:22.57,8,,2.0
2020,10,2937,645,27,7408,2,4,9,5,9,4,7,2,7,0,False,False,False,0,3,2020-11-16T16:54:24.687,9,,2.0
2020,10,2937,670,27,7408,13,19,6,38,0,0,0,0,0,0,False,False,False,0,2,2021-03-04T19:20:56.54,0,,0.0
2020,10,2937,685,29,1958,2,5,5,5,5,0,5,0,5,0,True,False,False,0,3,2020-11-16T18:21:15.68,5,,0.0
2020,10,2937,690,29,3398,13,19,6,30,0,0,0,0,0,0,False,False,False,0,3,2020-11-16T17:08:41.603,0,,0.0
2020,10,2937,700,27,7408,2,35,6,19,19,0,19,0,19,0,False,False,False,0,3,2020-11-19T18:24:52.543,19,,0.0
2020,10,2937,705,27,6397,2,12,10,2,16,14,13,3,13,0,False,False,False,1,4,2021-03-08T20:58:26.073,16,,3.0
2020,10,2937,720,27,505,2,32,3,7,11,4,11,0,11,0,False,False,False,0,3,2020-11-16T17:23:29.91,11,,0.0
2020,10,2937,725,27,3656,2,12,3,4,4,0,4,0,4,0,False,False,False,0,1,2021-02-19T17:20:09.59,4,,0.0
2020,10,2937,740,27,505,13,5,5,7,0,0,0,0,0,0,False,False,False,0,3,2021-03-05T15:01:10.457,0,,0.0
2020,10,2937,780,29,1958,13,4,1,15,0,0,0,0,0,0,False,False,False,0,3,2020-11-19T17:56:20.73,0,,0.0
2020,10,2937,790,27,5069,2,5,5,6,9,3,9,0,9,0,False,False,False,0,2,2021-02-19T17:40:53.523,9,,0.0
2020,10,2937,795,27,7850,13,4,10,2,0,0,0,0,0,0,False,False,False,0,1,2020-11-19T18:25:18.443,0,,0.0
2020,10,2937,810,27,650,2,13,9,2,4,2,3,1,3,0,False,False,False,0,3,2020-11-16T17:53:31.84,4,,1.0
2020,10,2937,815,27,7496,13,12,6,31,0,0,0,0,0,0,False,False,False,0,2,2020-11-19T18:29:04.46,0,,
2020,10,2937,820,27,7408,13,5,6,15,0,0,0,0,0,0,False,False,False,0,2,2021-02-19T18:06:05.657,0,,0.0
2020,10,2937,830,27,7852,2,52,9,3,8,5,8,0,8,0,False,False,False,0,3,2021-02-19T18:14:53.133,8,,0.0
2020,10,2937,845,27,650,13,19,2,26,0,0,0,0,0,0,False,False,False,0,2,2020-11-16T18:02:02.68,0,,0.0
2020,10,2938,15,28,7619,2,2,9,7,12,5,10,2,10,0,False,False,False,0,2,2020-11-16T18:29:11.78,12,,2.0
2020,10,2938,35,28,6360,2,13,4,3,5,2,4,1,4,0,False,False,False,0,3,2020-11-16T13:51:35.247,5,,1.0
2020,10,2938,40,28,7619,13,4,6,20,0,0,0,0,0,0,False,False,False,0,3,2020-11-19T23:39:45.9,0,,0.0
2020,10,2938,45,28,969,2,5,5,1,8,7,1,7,1,0,False,False,False,2,3,2020-11-19T22:16:44.687,8,,7.0
2020,10,2938,50,28,4912,2,5,3,2,4,2,2,2,2,0,False,False,False,0,3,2020-11-19T22:33:55.187,4,,2.0
2020,10,2938,60,28,7619,2,6,4,5,14,9,13,1,13,0,False,False,False,0,3,2020-11-17T17:03:54.513,14,,1.0
2020,10,2938,70,28,7619,2,47,10,1,4,3,4,0,4,6,True,False,False,0,3,2020-11-16T18:31:47.66,4,,0.0
2020,10,2938,90,20,7353,2,18,5,-3,3,6,1,2,1,0,False,False,False,1,2,2020-11-19T20:50:48.063,3,,2.0
2020,10,2938,95,20,3763,13,2,9,8,0,0,0,0,0,0,False,False,False,0,3,2020-11-16T14:19:45.99,0,,0.0
2020,10,2938,110,28,797,3,42,9,6,0,0,0,0,0,0,True,False,False,0,2,2020-11-19T22:38:19.84,0,,0.0
2020,10,2938,135,28,6360,2,2,10,9,14,5,9,5,9,0,False,False,False,0,2,2020-11-16T14:26:26.303,14,,5.0
2020,10,2938,150,28,6627,2,11,2,17,22,5,22,0,22,0,False,False,False,0,4,2020-11-16T19:11:14.113,22,,0.0
2020,10,2938,190,20,958,13,17,1,27,0,0,0,0,0,0,False,False,False,0,4,2020-11-16T14:39:22.343,0,,0.0
2020,10,2938,195,20,5140,3,48,9,-2,0,0,0,0,0,0,False,False,False,0,1,2020-11-19T22:19:28.56,0,,0.0
2020,10,2938,210,28,797,2,2,4,7,13,6,7,6,7,0,True,False,False,0,3,2020-11-17T17:05:24.12,13,,6.0
2020,10,2938,220,28,6627,13,7,5,14,0,0,0,0,0,0,False,False,False,0,4,2020-11-16T15:05:44.383,0,,0.0
2020,10,2938,225,28,969,2,16,9,2,8,6,3,5,3,0,False,False,False,0,1,2020-11-16T15:07:50.313,8,,5.0
2020,10,2938,235,20,3763,2,5,9,13,15,2,13,2,13,0,False,False,False,0,3,2020-11-19T20:50:48.063,15,,2.0
2020,10,2938,245,20,5140,2,51,10,-6,1,7,-1,2,-1,0,False,False,False,0,1,2020-11-19T20:50:48.063,1,,2.0
2020,10,2938,250,20,958,13,5,5,7,0,0,0,0,0,0,True,False,False,0,3,2020-11-19T22:49:38.077,0,,0.0
2020,10,2938,315,28,4912,2,26,9,3,7,4,6,1,6,0,False,False,False,1,2,2020-11-16T16:15:23.64,7,,1.0
2020,10,2938,320,28,969,2,6,10,10,12,2,11,1,11,0,False,False,False,0,4,2020-11-19T22:57:26.323,12,,1.0
2020,10,2938,335,28,7619,2,5,9,6,11,5,9,2,9,0,False,False,False,0,3,2020-11-16T15:38:40.113,11,,2.0
2020,10,2938,345,28,7619,13,30,10,0,0,0,0,0,0,0,False,False,False,0,4,2020-11-19T22:58:27.803,0,,0.0
2020,10,2938,355,20,5140,2,5,10,3,8,5,8,0,8,0,False,False,False,0,1,2020-11-16T15:43:36.317,8,,0.0
2020,10,2938,360,20,5140,2,48,10,-4,34,38,34,0,34,0,False,False,False,0,1,2020-11-19T23:43:08.16,34,,0.0
2020,10,2938,365,20,6388,13,2,9,6,0,0,0,0,0,0,False,False,False,0,2,2021-02-03T18:48:21.063,0,,0.0
2020,10,2938,370,20,7353,2,4,3,5,7,2,7,0,7,0,False,False,False,0,2,2020-11-16T15:50:42.503,7,,0.0
2020,10,2938,380,20,213,2,46,3,1,5,4,5,0,5,0,False,False,False,0,4,2020-11-16T15:52:48.257,5,,0.0
2020,10,2938,385,20,5140,2,47,5,0,3,3,3,0,3,6,False,False,False,0,1,2020-11-19T22:20:14.82,3,,0.0
2020,10,2938,400,28,797,2,44,9,-7,14,21,14,0,14,0,False,False,False,0,1,2020-11-19T23:06:25.587,14,,
2020,10,2938,420,28,7619,13,50,9,-4,0,0,0,0,0,0,False,False,False,0,3,2021-03-04T17:30:03.953,0,,0.0
2020,10,2938,445,20,5140,2,51,10,-4,15,19,0,15,0,0,False,False,False,4,3,2021-11-16T18:42:20.38,15,,
2020,10,2938,450,20,7353,2,18,3,-2,11,13,11,0,11,0,False,False,False,1,2,2021-02-18T18:39:29.897,11,,0.0
2020,10,2938,480,28,7619,2,5,3,5,13,8,5,8,5,0,True,False,False,0,3,2020-11-19T22:23:52.933,13,,8.0
2020,10,2938,495,28,969,2,4,3,7,8,1,8,0,8,0,False,False,False,0,3,2020-11-16T16:36:31.583,8,,0.0
2020,10,2938,500,28,7619,13,12,4,7,0,0,0,0,0,0,False,False,False,0,3,2020-11-19T23:40:55.89,0,,
2020,10,2938,510,28,6360,2,2,9,6,7,1,6,1,6,0,False,False,False,2,2,2020-11-16T16:44:58.48,7,,1.0
2020,10,2938,515,28,7751,2,47,10,0,1,1,1,0,1,0,False,False,False,0,1,2020-11-16T16:48:27.57,1,,0.0
2020,10,2938,520,28,7619,13,6,4,8,0,0,0,0,0,0,False,False,False,0,3,2020-11-16T16:50:09.067,0,,0.0
2020,10,2938,525,20,5140,2,4,9,3,3,0,3,0,3,0,False,False,False,0,1,2020-11-19T23:38:51.25,3,,0.0
2020,10,2938,550,28,797,13,5,10,-2,0,0,0,0,0,0,False,False,False,0,1,2020-11-19T20:50:48.063,0,,0.0
2020,10,2938,565,20,5140,2,5,4,2,19,17,17,2,17,0,False,False,False,0,1,2020-11-19T20:50:48.063,19,,2.0
2020,10,2938,570,20,3763,2,5,9,4,12,8,12,0,12,0,False,False,False,0,3,2020-11-16T18:21:07.247,12,,0.0
2020,10,2938,585,20,5140,2,11,3,10,15,5,11,4,11,0,False,False,False,0,1,2020-11-16T18:20:57.317,15,,4.0
2020,10,2938,605,20,7353,2,50,9,-3,3,6,0,3,0,0,False,False,False,1,2,2021-03-03T16:20:52.463,3,,3.0
2020,10,2938,615,20,3763,13,9,5,4,0,0,0,0,0,0,False,False,False,0,3,2021-02-25T16:17:50.02,0,,0.0
2020,10,2938,625,20,3763,13,7,3,5,0,0,0,0,0,0,False,False,False,0,3,2020-11-16T18:20:05.933,0,,0.0
2020,10,2938,640,28,262,13,26,10,4,0,0,0,0,0,0,False,False,False,0,1,2020-11-19T22:15:51.573,0,,0.0
2020,10,2938,645,28,969,13,5,5,6,0,0,0,0,0,0,True,False,False,0,3,2020-11-17T17:05:51.04,0,,0.0
2020,10,2938,650,28,4912,2,6,10,11,11,0,11,0,11,0,False,False,False,0,2,2020-11-16T17:22:04.707,11,,0.0
2020,10,2938,660,28,7619,2,34,4,-4,-1,3,-1,0,-1,0,True,False,False,0,3,2020-11-16T17:24:46.693,-1,,0.0
2020,10,2938,665,28,7751,2,44,9,-7,-5,2,-5,0,-5,0,False,False,False,0,1,2020-11-19T23:20:25.09,-5,,0.0
2020,10,2938,670,28,6360,13,8,1,45,0,0,0,0,0,0,False,False,False,0,3,2021-02-18T18:42:06.283,0,,0.0
2020,10,2938,690,20,3763,13,8,4,14,0,0,0,0,0,0,False,False,False,0,2,2020-11-16T17:32:17.93,0,,0.0
2020,10,2938,695,20,3763,13,12,1,16,0,0,0,0,0,0,False,False,False,0,2,2020-11-16T17:33:45.123,0,,0.0
2020,10,2938,730,28,7229,2,48,4,-6,27,33,-3,30,-3,0,False,False,False,1,1,2020-11-19T22:24:24.563,27,,30.0
2020,10,2938,735,28,4912,2,26,10,3,4,1,4,0,4,0,False,False,False,0,3,2020-11-19T20:50:48.063,4,,0.0
2020,10,2938,740,28,7619,13,19,2,36,0,0,0,0,0,0,False,False,False,0,2,2021-02-18T18:43:05.967,0,,
2020,10,2938,750,28,7619,13,20,6,17,0,0,0,0,0,0,False,False,False,0,2,2020-11-19T20:50:48.063,0,,0.0
2020,10,2938,755,28,7619,13,2,4,2,0,0,0,0,0,0,False,False,False,0,2,2020-11-16T17:47:34.947,0,,0.0
2020,10,2938,815,28,6360,3,6,10,5,0,0,0,0,0,0,False,False,False,0,3,2021-02-18T18:44:10.173,0,,0.0
2020,10,2938,820,28,969,2,12,2,20,26,6,26,0,26,0,True,False,False,0,3,2020-11-19T20:47:38.393,26,,0.0
2020,10,2938,825,28,7619,2,12,2,22,22,0,22,0,22,0,False,False,False,0,3,2020-11-16T19:15:59.687,22,,0.0
2020,10,2938,830,28,7619,13,2,4,5,0,0,0,0,0,0,False,False,False,0,2,2020-11-19T23:37:00.753,0,,0.0
2020,10,2938,835,28,4912,13,21,6,18,0,0,0,0,0,0,False,False,False,0,2,2020-11-19T20:50:48.063,0,,0.0
2020,10,2939,10,3,902,2,45,5,0,17,17,9,8,9,0,False,False,False,1,1,2021-03-03T16:26:43.963,17,,8.0
2020,10,2939,20,3,6659,13,4,4,2,0,0,0,0,0,0,False,False,False,0,1,2020-11-16T13:22:56.7,0,,0.0
2020,10,2939,25,3,6936,13,24,2,38,0,0,0,0,0,0,False,False,False,0,3,2020-11-19T17:05:49.927,0,,0.0
2020,10,2939,65,19,1510,2,48,9,-4,3,7,0,3,0,0,False,False,False,0,1,2020-11-19T17:10:24.037,3,,3.0
2020,10,2939,75,19,7175,13,4,4,5,0,0,0,0,0,0,False,False,False,0,3,2020-11-16T13:45:39.083,0,,0.0
2020,10,2939,80,19,1328,2,5,5,3,4,1,4,0,4,0,True,False,False,0,3,2020-11-16T17:59:23.687,4,,0.0
2020,10,2939,115,3,6454,2,39,4,5,13,8,11,2,11,0,False,False,False,0,4,2020-11-16T14:03:12.17,13,,2.0
2020,10,2939,125,3,2688,2,4,10,9,21,12,16,5,16,0,False,False,False,1,3,2020-11-19T16:41:46.41,21,,5.0
2020,10,2939,135,3,7672,2,51,5,-2,19,21,7,12,7,0,True,False,False,0,3,2020-11-16T14:08:56.107,19,,12.0
2020,10,2939,160,3,2688,2,34,4,-4,6,10,-4,10,-4,6,True,False,False,1,3,2020-11-16T14:20:07.71,6,,10.0
2020,10,2939,175,19,7175,2,6,10,13,19,6,17,2,17,0,False,False,False,0,3,2020-11-16T18:27:55.947,19,,2.0
2020,10,2939,180,19,1510,13,7,6,19,0,0,0,0,0,0,False,False,False,0,1,2020-11-19T17:05:49.927,0,,0.0
2020,10,2939,200,19,6273,2,35,9,8,20,12,18,2,18,0,False,False,False,0,4,2020-11-19T16:40:12.58,20,,2.0
2020,10,2939,205,19,1510,2,51,5,-3,7,10,6,1,6,6,False,False,False,0,1,2020-11-19T17:05:49.927,7,,1.0
2020,10,2939,240,3,6454,2,13,9,6,11,5,6,5,6,0,False,False,False,0,4,2020-11-16T14:48:38.403,11,,5.0
2020,10,2939,250,3,6659,2,47,5,2,31,29,30,1,30,0,False,False,False,0,1,2020-11-16T14:51:46.74,31,,1.0
2020,10,2939,255,3,5017,2,47,5,0,2,2,1,1,1,0,True,False,False,1,3,2020-11-19T17:13:23.137,2,,1.0
2020,10,2939,260,3,6936,13,7,3,9,0,0,0,0,0,0,False,False,False,0,3,2020-11-16T14:57:07.75,0,,0.0
2020,10,2939,265,3,6918,2,47,5,-2,3,5,2,1,2,0,False,False,False,0,1,2020-11-16T15:00:17.617,3,,1.0
2020,10,2939,270,3,6454,13,26,10,6,0,0,0,0,0,0,False,False,False,0,3,2020-11-19T17:20:24.207,0,,0.0
2020,10,2939,295,19,1328,2,48,9,-8,4,12,-4,8,-4,0,False,False,False,1,1,2020-11-16T17:59:51.74,4,,8.0
2020,10,2939,320,19,7175,2,5,5,4,4,0,4,0,4,0,False,False,False,0,3,2020-11-19T17:14:06.493,4,,0.0
2020,10,2939,340,19,1510,2,11,2,24,24,0,24,0,24,6,False,False,False,0,1,2020-11-19T17:14:45.267,24,,0.0
2020,10,2939,360,3,6936,2,4,5,5,8,3,7,1,7,0,False,False,False,0,2,2020-11-16T15:31:07.503,8,,1.0
2020,10,2939,370,3,2688,2,26,5,4,9,5,8,1,8,0,True,False,False,0,3,2020-11-16T15:33:16.097,9,,1.0
2020,10,2939,375,3,6454,2,4,10,6,9,3,7,2,7,0,False,False,False,0,3,2020-11-16T15:34:30.41,9,,2.0
2020,10,2939,385,3,7672,2,5,3,12,12,0,12,0,12,0,False,False,False,0,2,2020-11-16T15:36:28.393,12,,0.0
2020,10,2939,395,3,6936,2,12,5,6,6,0,6,0,6,0,False,False,False,0,2,2020-11-16T15:38:23.563,6,,0.0
2020,10,2939,400,3,6936,13,19,2,32,0,0,0,0,0,0,False,False,False,0,2,2021-03-05T15:02:38.77,0,,0.0
2020,10,2939,430,19,7175,2,5,6,15,26,11,20,6,20,0,True,False,False,0,3,2020-11-19T16:37:45.063,26,,6.0
2020,10,2939,450,3,902,2,5,10,3,7,4,6,1,6,0,False,False,False,0,1,2020-11-16T15:57:13.29,7,,1.0
2020,10,2939,490,19,7456,2,28,4,3,8,5,6,2,6,0,False,False,False,0,1,2020-11-16T16:11:02.763,8,,2.0
2020,10,2939,510,19,7175,13,6,4,2,0,0,0,0,0,0,False,False,False,0,3,2020-11-17T23:42:39.313,0,,0.0
2020,10,2939,525,3,2976,2,28,10,3,4,1,3,1,3,0,True,False,False,0,1,2020-11-17T20:12:33.983,4,,1.0
2020,10,2939,530,3,7672,2,2,10,6,14,8,8,6,8,0,False,False,False,1,2,2020-11-16T16:23:50.327,14,,6.0
2020,10,2939,540,3,6454,2,35,6,16,18,2,18,0,18,0,False,False,False,0,3,2020-11-16T16:26:39.817,18,,
2020,10,2939,550,3,2688,3,17,7,19,0,0,0,0,0,0,False,False,False,0,3,2020-11-19T17:16:12.173,0,,0.0
2020,10,2939,555,3,6454,2,12,5,8,8,0,8,0,8,0,False,False,False,0,3,2020-11-19T16:38:06.83,8,,0.0
2020,10,2939,575,3,6454,2,39,4,4,6,2,5,1,5,0,False,False,False,0,4,2020-11-16T16:44:39.99,6,,1.0
2020,10,2939,590,3,2688,2,35,7,18,18,0,18,0,18,6,False,False,False,0,3,2020-11-16T18:30:25.923,18,,0.0
2020,10,2939,620,19,7175,2,4,10,6,6,0,6,0,6,0,False,False,False,0,3,2020-11-16T17:01:53.893,6,,0.0
2020,10,2939,635,3,2688,13,12,7,20,0,0,0,0,0,0,False,False,False,0,3,2020-11-16T17:05:23.277,0,,0.0
2020,10,2939,640,3,2688,2,26,3,3,10,7,3,7,3,0,False,False,False,1,3,2020-11-16T17:07:11.91,10,,7.0
2020,10,2939,670,19,7456,2,12,5,4,12,8,12,0,12,0,False,False,False,0,1,2021-03-08T21:01:02.107,12,,0.0
2020,10,2939,685,19,1510,2,30,10,0,1,1,1,0,1,0,False,False,False,0,1,2020-11-16T17:20:00.857,1,,0.0
2020,10,2939,700,3,6454,3,39,4,3,0,0,0,0,0,0,False,False,False,0,4,2020-11-19T17:05:49.927,0,,0.0
2020,10,2939,715,3,6454,2,4,4,8,11,3,9,2,9,0,False,False,False,1,3,2020-11-16T17:30:00.903,11,,2.0
2020,10,2939,720,3,6936,13,6,1,22,0,0,0,0,0,0,False,False,False,0,2,2021-02-18T18:02:59.383,0,,0.0
2020,10,2939,745,19,7175,2,4,4,3,4,1,4,0,4,0,True,False,False,0,3,2020-11-19T16:38:19.89,4,,0.0
2020,10,2939,800,3,6454,2,51,10,0,3,3,3,0,3,0,False,False,False,0,3,2020-11-16T17:51:28.297,3,,0.0
2020,10,2939,810,3,7671,2,28,9,0,1,1,1,0,1,0,False,False,False,0,1,2020-11-16T17:53:50.317,1,,0.0
2020,10,2939,815,3,7671,3,4,5,11,0,0,0,0,0,0,False,False,False,0,2,2020-11-16T17:55:09.043,0,,0.0
2020,10,2940,15,18,4572,2,31,9,2,2,0,2,0,2,0,False,False,False,0,1,2020-11-19T14:33:26.43,2,,0
2020,10,2940,30,18,4152,2,31,4,5,8,3,7,1,7,0,False,False,False,0,1,2021-02-19T14:35:54.707,8,,1
2020,10,2940,40,18,1381,2,4,9,9,9,0,9,0,9,0,False,False,False,0,3,2020-11-17T13:52:23.707,9,,0
2020,10,2940,50,18,813,2,2,4,5,12,7,12,0,12,0,False,True,True,0,4,2020-11-17T13:56:34.147,12,False,0
2020,10,2940,55,6,7725,2,49,3,-2,0,2,0,0,0,0,False,False,False,0,2,2020-11-17T14:01:12.643,0,,0
2020,10,2940,60,6,6328,13,6,1,22,0,0,0,0,0,0,True,False,False,0,3,2021-03-05T15:05:29.47,0,,0
2020,10,2940,75,18,6706,2,13,4,6,12,6,10,2,10,0,False,False,False,0,3,2020-11-19T14:33:36.533,12,,2
2020,10,2940,85,18,7711,2,5,3,6,6,0,6,0,6,0,False,False,False,0,2,2020-11-17T14:07:37.087,6,,0
2020,10,2940,90,18,1381,2,9,6,17,17,0,17,0,17,6,False,False,False,0,3,2020-11-18T18:45:53.553,17,,0
2020,10,2940,110,6,248,2,47,5,2,7,5,7,0,7,0,False,False,False,0,1,2020-11-17T14:14:14.163,7,,0
2020,10,2940,115,6,464,2,51,9,-4,7,11,5,2,5,0,False,False,False,0,3,2020-11-19T14:53:20.967,7,,2
2020,10,2940,120,6,7725,2,47,5,3,3,0,3,0,3,0,False,False,False,0,3,2020-11-19T14:53:50.603,3,,0
2020,10,2940,125,6,464,2,5,5,5,5,0,5,0,5,0,False,False,False,0,2,2020-11-17T14:20:41.293,5,,0
2020,10,2940,135,6,464,2,22,6,24,24,0,24,0,24,0,False,False,False,0,3,2020-11-17T14:24:33.473,24,,0
2020,10,2940,145,6,666,13,29,5,14,0,0,0,0,0,0,False,False,False,0,4,2020-11-17T14:26:00.26,0,,0
2020,10,2940,150,6,811,2,4,5,9,9,0,9,0,9,0,False,False,False,0,2,2020-11-19T14:46:20.37,9,,0
2020,10,2940,155,6,666,13,2,10,7,0,0,0,0,0,0,False,False,False,0,3,2020-11-17T14:30:16.627,0,,0
2020,10,2940,165,6,6328,13,7,5,5,0,0,0,0,0,0,False,False,False,0,3,2020-11-19T14:46:20.37,0,,0
2020,10,2940,180,18,7711,13,19,6,37,0,0,0,0,0,0,False,False,False,0,3,2020-11-19T14:46:20.37,0,,0
2020,10,2940,195,18,7711,2,5,5,10,23,13,20,3,20,0,False,False,False,1,3,2020-11-17T14:37:15.743,23,,3
2020,10,2940,205,18,4572,2,48,10,-3,-3,0,-3,0,-3,0,False,False,False,0,1,2020-11-19T14:34:10.733,-3,,0
2020,10,2940,210,18,7711,2,50,9,0,4,4,3,1,3,0,False,False,False,0,3,2020-11-17T14:41:19.117,4,,1
2020,10,2940,225,6,464,2,2,10,7,8,1,7,1,7,0,False,False,False,0,3,2020-11-17T14:44:14.57,8,,1
2020,10,2940,240,6,7728,2,12,9,7,7,0,7,0,7,0,False,False,False,0,4,2020-11-17T14:47:58.06,7,,0
2020,10,2940,265,18,4572,2,45,10,-6,9,15,9,0,9,0,False,False,False,1,1,2020-11-19T14:50:34.1,9,,0
2020,10,2940,275,18,6361,2,5,5,5,9,4,7,2,7,0,False,False,False,0,4,2020-11-17T14:58:50.443,9,,2
2020,10,2940,290,18,7711,2,4,9,5,13,8,8,5,8,0,False,False,False,0,3,2020-11-17T15:04:47.643,13,,5
2020,10,2940,305,18,1381,2,4,9,5,11,6,11,0,11,0,False,False,False,0,3,2020-11-17T15:07:06.87,11,,0
2020,10,2940,315,18,1381,3,6,9,6,0,0,0,0,0,0,False,False,False,0,2,2020-11-17T15:08:41.21,0,,0
2020,10,2940,320,6,6328,2,4,4,6,21,15,21,0,21,0,False,False,False,0,3,2020-11-17T15:09:53.43,21,,0
2020,10,2940,330,6,6337,13,47,5,0,0,0,0,0,0,0,False,False,False,0,1,2020-11-17T15:12:01.55,0,,0
2020,10,2940,335,6,6328,13,5,2,19,0,0,0,0,0,0,False,False,False,0,3,2020-11-19T14:34:24.493,0,,0
2020,10,2940,390,18,7711,2,2,9,7,14,7,13,1,13,0,False,False,False,0,2,2020-11-17T15:24:54.287,14,,1
2020,10,2940,400,18,1381,3,6,4,4,0,0,0,0,0,0,False,False,False,0,3,2021-02-19T14:37:39.883,0,,0
2020,10,2940,405,18,6706,2,26,9,2,4,2,2,2,2,0,True,False,False,0,3,2020-11-18T18:46:21.347,4,,2
2020,10,2940,415,18,1381,13,8,1,20,0,0,0,0,0,0,False,False,False,0,3,2020-11-17T15:30:21.653,0,,0
2020,10,2940,425,18,813,13,6,10,11,0,0,0,0,0,0,False,False,False,0,4,2020-11-17T15:32:10.063,0,,0
2020,10,2940,440,6,464,2,30,10,0,3,3,3,0,3,0,False,False,False,0,3,2020-11-19T15:06:17.293,3,,0
2020,10,2940,450,6,464,13,6,1,22,0,0,0,0,0,0,False,False,False,0,2,2020-11-17T15:37:22.503,0,,0
2020,10,2940,465,18,6361,2,46,3,2,2,0,2,0,2,0,False,False,False,0,4,2020-11-17T15:40:13.42,2,,0
2020,10,2940,480,6,248,2,46,3,-1,-1,0,-1,0,-1,0,False,False,False,0,1,2020-11-17T15:44:08.16,-1,,0
2020,10,2940,490,6,464,13,4,5,11,0,0,0,0,0,0,False,False,False,0,2,2020-11-17T15:49:19.31,0,,0
2020,10,2940,500,18,813,2,35,9,9,8,-1,8,0,8,0,False,False,False,0,4,2020-11-17T15:55:02.497,8,,0
2020,10,2940,515,18,7711,2,8,1,16,54,38,42,12,42,0,False,False,False,0,3,2021-03-03T16:34:46.787,54,,12
2020,10,2940,525,18,6897,13,2,9,7,0,0,0,0,0,0,False,False,False,0,2,2020-11-19T14:34:47.387,0,,0
2020,10,2940,530,18,7711,2,6,4,5,7,2,7,0,7,0,False,False,False,0,3,2020-11-19T14:46:20.37,7,,0
2020,10,2940,595,18,813,2,4,9,5,22,17,6,16,6,0,False,False,False,2,4,2020-11-17T16:20:51.353,22,,16
2020,10,2940,600,18,7711,2,3,2,15,14,-1,14,0,14,0,False,False,False,0,2,2020-11-17T17:22:54.427,14,,0
2020,10,2940,615,18,1381,2,5,5,6,6,0,6,0,6,6,False,False,False,0,3,2020-11-17T16:24:35.283,6,,0
2020,10,2940,630,6,6328,2,4,10,5,7,2,7,0,7,0,False,False,False,0,3,2020-11-17T16:27:39.95,7,,0
2020,10,2940,640,6,6328,13,13,9,2,0,0,0,0,0,0,False,False,False,0,3,2020-11-17T16:30:38.95,0,,0
2020,10,2940,660,18,4572,2,12,3,3,8,5,8,0,8,0,True,False,False,0,2,2020-11-17T16:37:55.52,8,,0
2020,10,2940,675,18,7711,13,2,3,9,0,0,0,0,0,0,False,False,False,0,2,2020-11-17T16:41:31.41,0,,0
2020,10,2940,690,6,811,2,46,3,1,10,9,8,2,8,0,False,False,False,1,1,2020-11-19T15:03:08.63,10,,2
2020,10,2940,705,6,464,2,50,10,-6,-4,2,-5,1,-5,0,True,False,False,0,3,2020-11-17T17:13:28.557,-4,,1
2020,10,2940,710,6,6328,13,12,8,28,0,0,0,0,0,0,False,False,False,0,3,2020-11-17T16:49:38.897,0,,0
2020,10,2940,725,18,813,2,32,10,0,21,21,19,2,19,0,False,False,False,1,4,2020-11-17T16:53:13.037,21,,2
2020,10,2940,785,6,6337,2,31,9,3,18,15,12,6,12,0,False,False,False,1,1,2020-11-17T17:00:08.213,18,,6
2020,10,2940,795,6,7728,13,5,5,7,0,0,0,0,0,0,False,False,False,0,3,2021-02-25T16:22:47.957,0,,0
2020,10,2940,800,6,464,13,7,2,18,0,0,0,0,0,0,False,False,False,0,3,2020-11-17T17:02:49.513,0,,0
2020,10,2940,805,6,7728,13,5,3,11,0,0,0,0,0,0,False,False,False,0,3,2020-11-17T17:03:55.67,0,,0
2020,11,2941,15,27,505,2,5,10,6,10,4,8,2,8,0,False,False,False,0,3,2021-02-22T16:10:35.787,10,,2.0
2020,11,2941,20,27,153,2,28,9,-2,9,11,7,2,7,0,True,False,False,0,1,2021-02-22T16:08:30.193,9,,2.0
2020,11,2941,35,27,650,2,12,3,4,4,0,4,0,4,0,False,False,False,0,3,2021-02-22T16:10:48.167,4,,0.0
2020,11,2941,45,27,650,2,4,5,8,10,2,10,0,10,0,False,False,False,0,2,2020-11-20T12:36:35.63,10,,0.0
2020,11,2941,65,27,7408,2,12,2,25,25,0,25,0,25,6,False,False,False,0,3,2020-11-20T12:42:48.317,25,,0.0
2020,11,2941,80,1,4307,2,45,5,-5,3,8,2,1,2,0,False,False,False,0,1,2020-11-20T12:46:54.097,3,,1.0
2020,11,2941,90,1,245,13,5,6,16,0,0,0,0,0,0,False,False,False,0,2,2020-11-20T12:50:55.04,0,,0.0
2020,11,2941,135,1,525,2,53,9,-3,1,4,1,0,1,0,False,False,False,0,4,2021-02-22T16:11:04.237,1,,0.0
2020,11,2941,145,27,4835,2,47,5,0,5,5,3,2,3,0,True,False,False,0,1,2021-02-19T16:18:53.55,5,,2.0
2020,11,2941,155,27,7408,2,19,2,29,41,12,40,1,40,0,False,False,False,0,2,2021-02-22T16:11:32.097,41,,
2020,11,2941,160,27,153,13,12,6,47,0,0,0,0,0,0,False,False,False,0,1,2020-11-20T13:19:08.677,0,,0.0
2020,11,2941,195,1,245,2,3,3,9,7,-2,7,0,7,0,False,False,False,0,2,2021-03-01T15:41:34.36,7,,0.0
2020,11,2941,200,1,4307,13,46,3,0,0,0,0,0,0,0,False,False,False,0,1,2020-11-20T13:33:28.147,0,,0.0
2020,11,2941,205,1,2416,2,35,6,20,25,5,25,0,25,0,False,False,False,0,4,2020-11-20T13:36:28.07,25,,0.0
2020,11,2941,235,27,153,2,4,4,2,7,5,5,2,5,0,False,False,False,0,1,2021-02-22T16:11:46.223,7,,2.0
2020,11,2941,245,27,4835,3,4,5,8,0,0,0,0,0,0,False,False,False,0,2,2020-11-20T13:50:11.623,0,,0.0
2020,11,2941,255,27,7850,2,49,10,-4,11,15,9,2,9,0,False,False,False,0,3,2020-11-20T13:52:19.653,11,,2.0
2020,11,2941,270,27,650,2,5,3,6,10,4,9,1,9,0,False,False,False,0,3,2020-11-20T13:57:12.277,10,,1.0
2020,11,2941,280,27,650,2,21,5,11,11,0,11,0,11,6,False,False,False,0,2,2020-11-20T14:00:45.107,11,,0.0
2020,11,2941,300,1,4307,2,4,9,3,18,15,13,5,13,0,False,False,False,1,1,2021-02-22T16:12:11.813,18,,5.0
2020,11,2941,310,1,525,2,50,10,-3,5,8,2,3,2,0,False,False,False,0,3,2020-11-20T14:10:07.82,5,,3.0
2020,11,2941,315,1,525,2,5,3,8,13,5,9,4,9,0,False,False,False,0,3,2020-11-20T14:11:49.663,13,,4.0
2020,11,2941,325,1,6405,2,4,5,11,11,0,11,0,11,0,False,False,False,0,2,2020-11-25T16:48:06.757,11,,0.0
2020,11,2941,335,1,5152,13,12,7,18,0,0,0,0,0,0,False,False,False,0,4,2021-02-22T16:12:27.237,0,,0.0
2020,11,2941,340,1,6405,13,21,2,27,0,0,0,0,0,0,False,False,False,0,2,2020-11-20T14:20:27.867,0,,0.0
2020,11,2941,360,27,5069,2,18,3,-3,2,5,2,0,2,0,False,False,False,0,2,2020-11-20T14:27:38.7,2,,0.0
2020,11,2941,375,1,6406,2,46,9,-1,6,7,6,0,6,0,False,False,False,0,1,2020-11-20T14:32:02.41,6,,0.0
2020,11,2941,410,27,650,2,46,9,2,3,1,3,0,3,0,False,False,False,0,3,2021-02-22T16:13:12.577,3,,0.0
2020,11,2941,415,27,650,2,13,3,7,10,3,10,0,10,0,False,False,False,0,3,2020-11-20T14:39:31.587,10,,0.0
2020,11,2941,425,27,7850,2,28,4,0,8,8,6,2,6,0,False,False,False,0,1,2021-02-22T16:13:36.83,8,,2.0
2020,11,2941,445,27,7408,13,12,7,50,0,0,0,0,0,0,False,False,False,0,2,2020-11-20T14:53:23.177,0,,
2020,11,2941,450,27,7408,3,6,9,9,0,0,0,0,0,0,False,False,False,0,2,2021-01-15T21:39:34.19,0,,0.0
2020,11,2941,465,1,4307,2,47,10,-3,7,10,7,0,7,0,False,False,False,0,1,2020-11-25T15:20:11.223,7,,0.0
2020,11,2941,480,1,245,13,6,1,18,0,0,0,0,0,0,False,False,False,0,2,2020-11-20T15:06:36.267,0,,
2020,11,2941,485,1,6405,2,3,5,13,13,0,13,0,13,0,False,False,False,0,2,2020-11-25T15:20:11.223,13,,0.0
2020,11,2941,490,1,245,13,12,9,12,0,0,0,0,0,0,False,False,False,0,3,2020-11-25T16:59:40.497,0,,0.0
2020,11,2941,495,1,6405,2,5,5,14,14,0,14,0,14,0,False,False,False,0,2,2020-11-20T15:15:29.383,14,,0.0
2020,11,2941,505,1,2416,2,28,9,0,4,4,3,1,3,0,False,False,False,0,1,2020-11-20T15:27:39.17,4,,1.0
2020,11,2941,510,1,245,2,5,3,6,6,0,6,0,6,0,False,False,False,0,3,2021-02-22T16:13:54.913,6,,0.0
2020,11,2941,520,1,4307,2,51,10,-6,3,9,1,2,1,0,True,False,False,0,1,2021-02-22T16:14:12.1,3,,2.0
2020,11,2941,525,1,6406,2,2,4,7,8,1,8,0,8,0,True,False,False,0,3,2021-02-22T16:08:42.62,8,,0.0
2020,11,2941,530,1,5152,2,2,9,4,4,0,4,0,4,6,False,False,False,0,2,2020-11-20T15:37:51.1,4,,0.0
2020,11,2941,545,27,7408,2,4,3,13,22,9,19,3,19,0,False,False,False,3,2,2020-11-20T15:41:19.667,22,,3.0
2020,11,2941,550,27,7408,3,35,4,8,0,0,0,0,0,0,False,False,False,0,3,2020-11-20T15:44:16.193,0,,0.0
2020,11,2941,555,27,505,2,4,10,5,10,5,8,2,8,0,False,False,False,0,3,2020-11-20T15:45:35.697,10,,2.0
2020,11,2941,575,27,650,2,26,3,2,5,3,3,2,3,0,False,False,False,1,3,2020-11-20T15:51:19.807,5,,2.0
2020,11,2941,615,1,245,2,5,3,11,11,0,11,0,11,0,False,False,False,0,3,2021-02-22T16:14:27.193,11,,0.0
2020,11,2941,625,1,525,2,46,3,1,2,1,2,0,2,0,False,False,False,0,3,2020-11-20T16:10:09.443,2,,0.0
2020,11,2941,635,1,6406,2,4,9,12,19,7,15,4,15,0,False,False,False,0,3,2020-11-20T16:13:17.83,19,,4.0
2020,11,2941,640,1,245,2,12,3,4,4,0,4,0,4,0,False,False,False,0,2,2020-11-25T16:40:43.973,4,,0.0
2020,11,2941,645,1,525,13,26,9,3,0,0,0,0,0,0,False,False,False,0,3,2020-11-20T16:21:12.433,0,,0.0
2020,11,2941,650,1,245,2,6,9,4,23,19,4,19,4,0,False,False,False,1,3,2020-11-20T16:23:25.743,23,,19.0
2020,11,2941,655,1,525,2,12,5,7,18,11,18,0,18,0,False,False,False,0,3,2020-11-20T16:25:18.013,18,,0.0
2020,11,2941,680,1,6406,2,13,10,3,3,0,3,0,3,6,False,False,False,0,3,2021-02-22T16:07:35.557,3,,0.0
2020,11,2941,705,27,5069,2,44,9,-3,7,10,4,3,4,0,False,False,False,0,3,2021-03-04T19:07:19.25,7,,
2020,11,2941,710,27,7408,2,49,9,-2,-1,1,-2,1,-2,0,False,False,False,0,2,2020-11-25T17:00:13.697,-1,,1.0
2020,11,2941,720,27,650,2,49,5,-1,7,8,7,0,7,0,False,False,False,0,2,2020-11-20T16:45:34.21,7,,0.0
2020,11,2941,735,1,245,2,4,9,4,8,4,6,2,6,0,False,False,False,1,2,2021-03-03T16:44:38.103,8,,
2020,11,2941,750,27,6397,2,12,9,8,10,2,10,0,10,0,False,False,False,0,4,2021-03-03T16:45:02.037,10,,0.0
2020,11,2941,765,27,650,2,5,3,7,7,0,7,0,7,0,False,False,False,0,2,2020-11-20T17:05:56.39,7,,0.0
2020,11,2941,780,27,4835,2,51,5,0,9,9,8,1,8,0,False,False,False,0,4,2021-02-22T16:08:57.573,9,,1.0
2020,11,2941,785,27,5069,2,26,9,2,3,1,3,0,3,0,False,False,False,0,3,2020-11-25T16:39:43.403,3,,0.0
2020,11,2941,810,1,525,2,4,9,4,6,2,6,0,6,0,False,False,False,0,3,2020-11-20T17:18:38.667,6,,0.0
2020,11,2941,815,1,525,2,46,3,1,6,5,6,0,6,0,False,False,False,0,3,2020-11-20T17:19:30.147,6,,0.0
2020,11,2941,825,1,7315,2,51,10,-3,6,9,3,3,3,0,False,False,False,0,3,2020-11-20T17:20:39.387,6,,3.0
2020,11,2941,830,1,6405,2,4,10,12,12,0,12,0,12,0,False,False,False,0,2,2020-11-20T17:22:06.71,12,,0.0
2020,11,2941,835,1,245,13,4,3,5,0,0,0,0,0,0,False,False,False,0,2,2021-02-22T16:07:35.557,0,,0.0
2020,11,2941,840,1,525,2,50,9,-2,11,13,11,0,11,0,False,False,False,0,3,2020-11-20T17:24:07.977,11,,0.0
2020,11,2941,850,1,6405,13,12,5,-3,0,0,0,0,0,0,False,False,False,0,2,2021-02-19T16:23:31.627,0,,0.0
2020,11,2941,855,1,525,13,17,1,25,0,0,0,0,0,0,False,False,False,0,3,2020-11-20T17:34:20.473,0,,0.0
2020,11,2941,870,1,7315,13,7,2,26,0,0,0,0,0,0,False,False,False,0,3,2020-11-20T17:34:11.49,0,,0.0
2020,11,2942,15,3,2688,13,7,2,27,0,0,0,0,0,0,True,False,False,0,3,2020-11-23T12:11:50.62,0,,0.0
2020,11,2942,20,3,590,3,12,2,15,0,0,0,0,0,0,False,False,False,0,2,2020-11-24T02:48:11.883,0,,0.0
2020,11,2942,30,31,6793,13,24,6,45,0,0,0,0,0,0,False,False,False,0,2,2020-11-24T03:05:50.333,0,,
2020,11,2942,45,31,6390,2,32,10,-4,14,18,8,6,8,0,False,False,False,1,3,2020-11-23T12:24:50.943,14,,6.0
2020,11,2942,55,31,6724,2,5,3,4,7,3,5,2,5,0,True,False,False,0,3,2020-11-27T15:03:24.69,7,,2.0
2020,11,2942,65,31,5096,2,38,4,1,8,7,8,0,8,0,False,False,False,0,4,2020-11-23T12:29:33.73,8,,0.0
2020,11,2942,75,31,5096,2,38,3,1,1,0,1,0,1,6,False,False,False,0,4,2020-11-27T15:04:40.57,1,,0.0
2020,11,2942,95,3,7672,2,34,4,-4,5,9,4,1,4,0,True,False,False,0,2,2020-11-27T15:06:37.28,5,,1.0
2020,11,2942,110,3,6936,3,6,10,14,0,0,0,0,0,0,False,False,False,0,2,2020-11-27T14:24:02.223,0,,0.0
2020,11,2942,115,3,6454,2,4,4,12,14,2,13,1,13,0,False,False,False,0,3,2020-11-24T02:51:01.88,14,,1.0
2020,11,2942,135,3,6454,13,7,2,15,0,0,0,0,0,0,False,False,False,0,3,2020-11-24T02:49:53.757,0,,0.0
2020,11,2942,170,31,3504,2,48,9,-2,-1,1,-2,1,-2,0,False,False,False,0,1,2020-11-24T02:51:56.743,-1,,1.0
2020,11,2942,180,31,6390,2,4,5,4,7,3,4,3,4,0,False,False,False,0,2,2020-11-23T13:02:43.457,7,,3.0
2020,11,2942,185,31,5096,13,35,10,9,0,0,0,0,0,0,False,False,False,0,3,2021-03-05T15:13:56.12,0,,0.0
2020,11,2942,190,3,2688,13,12,5,11,0,0,0,0,0,0,False,False,False,0,3,2020-11-23T13:05:45.357,0,,0.0
2020,11,2942,215,3,2688,13,26,5,2,0,0,0,0,0,0,True,False,False,0,3,2020-11-23T13:12:17.937,0,,0.0
2020,11,2942,240,31,6793,13,5,3,10,0,0,0,0,0,0,False,False,False,0,3,2020-11-23T13:19:58.487,0,,0.0
2020,11,2942,270,3,6936,13,8,1,36,0,0,0,0,0,0,False,False,False,0,3,2020-11-23T13:28:11.57,0,,0.0
2020,11,2942,280,3,6454,2,35,7,25,30,5,27,3,27,0,False,False,False,0,3,2020-11-23T13:30:01.84,30,,3.0
2020,11,2942,290,3,5017,2,30,10,-3,5,8,2,3,2,0,True,False,False,1,2,2020-11-23T13:36:12.783,5,,3.0
2020,11,2942,320,31,5080,13,35,7,21,0,0,0,0,0,0,False,False,False,0,3,2020-11-23T13:43:42.76,0,,0.0
2020,11,2942,325,31,5080,13,3,3,13,0,0,0,0,0,0,False,False,False,0,2,2020-11-24T02:53:25.163,0,,0.0
2020,11,2942,330,31,7913,2,3,5,7,7,0,7,0,7,0,False,False,False,0,2,2020-11-25T17:29:38.657,7,,0.0
2020,11,2942,340,31,6793,13,4,9,13,0,0,0,0,0,0,False,False,False,0,3,2020-11-23T13:49:56.91,0,,0.0
2020,11,2942,345,31,6793,3,35,9,12,0,0,0,0,0,0,True,False,False,0,3,2020-11-23T13:51:42.393,0,,
2020,11,2942,360,31,5096,2,30,10,-3,6,9,6,0,6,0,False,False,False,0,1,2021-02-19T15:45:43.807,6,,0.0
2020,11,2942,395,31,5096,3,44,3,-5,0,0,0,0,0,0,False,False,False,0,1,2020-11-23T14:02:04.71,0,,0.0
2020,11,2942,435,31,3504,13,12,3,-1,0,0,0,0,0,0,False,False,False,0,1,2021-03-08T20:24:09.357,0,,0.0
2020,11,2942,440,31,4545,2,48,9,-5,2,7,0,2,0,0,False,False,False,0,1,2020-11-23T14:11:59.987,2,,2.0
2020,11,2942,450,3,590,2,18,3,-2,4,6,1,3,1,0,False,False,False,0,2,2020-11-23T14:15:01.467,4,,3.0
2020,11,2942,455,3,6454,2,4,4,4,6,2,5,1,5,0,False,False,False,0,4,2020-11-23T14:16:26.157,6,,1.0
2020,11,2942,470,3,7671,2,45,10,-3,6,9,2,4,2,0,True,False,False,0,1,2020-11-23T14:20:49.05,6,,4.0
2020,11,2942,485,3,6454,2,7,6,30,31,1,31,0,31,6,True,False,False,0,3,2020-11-27T15:29:17.277,31,,0.0
2020,11,2942,510,31,6793,2,4,3,5,12,7,6,6,6,0,False,False,False,1,2,2020-11-23T14:31:39.703,12,,6.0
2020,11,2942,515,31,5080,2,7,2,26,50,24,35,15,35,0,True,False,False,0,3,2020-11-24T16:13:17.127,50,,15.0
2020,11,2942,520,31,6793,13,35,5,7,0,0,0,0,0,0,False,False,False,0,2,2021-02-25T16:11:10.62,0,,0.0
2020,11,2942,530,31,5096,2,32,10,-1,5,6,3,2,3,0,True,False,False,0,4,2020-11-27T14:03:12.6,5,,2.0
2020,11,2942,550,3,6936,13,5,5,6,0,0,0,0,0,0,False,False,False,0,3,2020-11-27T15:15:28.647,0,,0.0
2020,11,2942,555,3,7673,2,26,10,6,14,8,9,5,9,0,False,False,False,0,3,2020-11-23T14:44:41.347,14,,5.0
2020,11,2942,560,3,590,2,18,3,-2,5,7,2,3,2,0,False,False,False,0,2,2021-02-19T15:46:43.73,5,,3.0
2020,11,2942,565,3,590,2,18,3,-2,3,5,1,2,1,0,False,False,False,0,2,2020-11-23T14:47:08.557,3,,2.0
2020,11,2942,575,3,7672,13,7,6,47,0,0,0,0,0,0,False,False,False,0,3,2021-03-05T15:14:24.503,0,,0.0
2020,11,2942,590,31,6724,2,6,10,10,12,2,10,2,10,0,True,False,False,0,3,2020-11-23T14:58:24.483,12,,2.0
2020,11,2942,600,31,5080,2,3,6,16,16,0,16,0,16,0,False,False,False,0,2,2020-11-23T15:00:14.157,16,,0.0
2020,11,2942,610,31,2865,2,13,9,2,9,7,7,2,7,0,False,False,False,0,4,2020-11-23T15:03:47.17,9,,2.0
2020,11,2942,630,31,6724,2,5,3,5,5,0,5,0,5,0,True,False,False,0,3,2020-11-24T02:58:08.82,5,,0.0
2020,11,2942,635,31,6724,13,2,4,4,0,0,0,0,0,0,False,False,False,0,3,2020-11-23T15:11:25.08,0,,0.0
2020,11,2942,660,3,2688,2,4,9,4,6,2,5,1,5,0,False,False,False,0,3,2020-11-23T15:16:34.233,6,,1.0
2020,11,2942,680,3,6454,13,35,7,16,0,0,0,0,0,0,False,False,False,0,3,2020-11-23T15:20:38.903,0,,0.0
2020,11,2942,705,31,6724,2,6,9,8,9,1,8,1,8,0,False,False,False,0,4,2020-11-23T15:27:30.983,9,,1.0
2020,11,2942,710,31,5080,2,5,5,12,22,10,19,3,19,0,True,False,False,0,4,2020-11-23T15:29:18.557,22,,3.0
2020,11,2942,720,31,6793,2,51,3,4,25,21,4,21,4,0,False,False,False,3,3,2020-11-27T14:52:11.717,25,,21.0
2020,11,2942,735,31,6793,2,6,10,5,14,9,5,9,5,6,False,False,False,4,2,2020-11-23T15:36:20.453,14,,9.0
2020,11,2942,755,3,2688,2,4,10,4,8,4,4,4,4,0,False,False,False,1,2,2020-11-23T15:39:46.833,8,,4.0
2020,11,2942,770,3,6454,2,35,9,10,15,5,12,3,12,0,False,False,False,0,3,2020-11-24T02:59:19.867,15,,3.0
2020,11,2942,780,3,590,2,12,10,-3,16,19,15,1,15,0,False,False,False,0,3,2020-11-24T02:59:42.693,16,,1.0
2020,11,2942,790,3,2688,2,39,10,3,9,6,7,2,7,0,False,False,False,0,3,2020-11-23T15:46:50.31,9,,2.0
2020,11,2942,800,3,2688,13,2,4,5,0,0,0,0,0,0,False,False,False,0,3,2020-11-23T15:47:59.517,0,,0.0
2020,11,2942,845,3,7671,2,48,9,-5,9,14,8,1,8,0,False,False,False,0,1,2020-11-23T15:54:24.987,9,,1.0
2020,11,2942,855,31,5080,2,35,5,13,14,1,13,1,13,0,True,False,False,0,3,2020-11-23T15:56:52.727,14,,1.0
2020,11,2942,865,31,5080,2,6,10,7,11,4,9,2,9,0,True,False,False,0,3,2020-11-23T16:23:28.97,11,,2.0
2020,11,2942,875,31,6793,2,5,5,11,11,0,11,0,11,0,False,False,False,0,3,2020-11-23T16:26:50.91,11,,0.0
2020,11,2943,10,5,3477,2,51,3,-3,9,12,5,4,5,0,True,False,False,1,2,2020-11-29T12:29:39.187,9,,4.0
2020,11,2943,30,5,4803,2,11,3,10,12,2,11,1,11,0,False,False,False,0,3,2021-03-09T17:50:03.607,12,,1.0
2020,11,2943,35,5,4719,13,5,5,1,0,0,0,0,0,0,False,False,False,0,1,2020-11-23T19:14:02.67,0,,0.0
2020,11,2943,50,5,5220,13,5,5,9,0,0,0,0,0,0,False,False,False,0,3,2020-11-29T12:38:51.8,0,,0.0
2020,11,2943,70,11,6341,2,13,3,2,7,5,7,0,7,0,False,False,False,0,3,2020-11-23T12:00:44.18,7,,0.0
2020,11,2943,75,11,7733,13,4,9,2,0,0,0,0,0,0,False,False,False,0,2,2020-11-23T12:03:07.453,0,,0.0
2020,11,2943,80,11,792,3,47,10,-1,0,0,0,0,0,0,False,False,False,0,1,2020-11-23T12:05:51.91,0,,0.0
2020,11,2943,85,11,6810,13,5,3,12,0,0,0,0,0,0,True,False,False,0,3,2021-03-09T17:52:03.44,0,,0.0
2020,11,2943,100,5,2554,2,44,3,-5,8,13,7,1,7,0,False,False,False,2,1,2020-11-23T18:43:36.38,8,,1.0
2020,11,2943,115,5,5220,2,2,9,7,14,7,10,4,10,0,False,False,False,1,2,2020-11-29T12:30:01.317,14,,4.0
2020,11,2943,120,5,5220,2,19,6,38,52,14,44,8,44,0,False,False,False,0,2,2020-11-23T18:44:00.813,52,,8.0
2020,11,2943,125,5,4803,2,34,4,-3,10,13,6,4,6,0,True,False,False,1,3,2020-11-29T12:30:20.607,10,,4.0
2020,11,2943,195,5,4803,2,46,3,1,2,1,1,1,1,0,False,False,False,1,3,2021-02-19T15:50:36.74,2,,1.0
2020,11,2943,200,5,5220,13,7,3,4,0,0,0,0,0,0,False,False,False,0,3,2020-11-29T11:27:43.84,0,,0.0
2020,11,2943,205,11,3820,2,4,5,4,6,2,6,0,6,0,False,False,False,0,2,2020-11-23T13:19:55.983,6,,0.0
2020,11,2943,210,11,914,2,7,6,19,21,2,20,1,20,0,False,False,False,1,3,2020-11-23T13:25:36.643,21,,1.0
2020,11,2943,225,11,6341,13,48,9,-7,0,0,0,0,0,0,False,False,False,0,1,2020-11-23T13:30:52.933,0,,0.0
2020,11,2943,240,5,4803,3,50,9,-4,0,0,0,0,0,0,False,False,False,0,3,2020-11-23T18:46:40.377,0,,0.0
2020,11,2943,245,5,4803,2,48,9,-7,4,11,3,1,3,0,False,False,False,1,1,2020-11-24T18:46:59.913,4,,1.0
2020,11,2943,260,11,7733,2,4,5,8,9,1,9,0,9,0,False,False,False,0,2,2020-11-29T11:27:43.84,9,,0.0
2020,11,2943,275,11,6810,3,26,9,7,0,0,0,0,0,0,False,False,False,0,3,2020-11-23T13:57:44.017,0,,0.0
2020,11,2943,285,5,3477,2,39,4,5,6,1,6,0,6,0,False,False,False,0,3,2020-11-23T18:47:04.623,6,,0.0
2020,11,2943,300,5,4803,2,30,10,1,3,2,3,0,3,0,False,False,False,0,3,2020-11-23T14:10:08.59,3,,0.0
2020,11,2943,305,5,4803,13,35,2,29,0,0,0,0,0,0,False,False,False,0,3,2020-11-23T18:47:32.227,0,,0.0
2020,11,2943,320,11,6810,2,53,10,-4,11,15,9,2,9,0,True,False,False,0,4,2020-11-23T14:28:24.153,11,,2.0
2020,11,2943,325,11,2714,13,4,9,12,0,0,0,0,0,0,False,False,False,0,4,2020-11-23T14:29:15.423,0,,0.0
2020,11,2943,350,5,5220,2,13,4,3,8,5,8,0,8,0,False,False,False,0,3,2020-11-29T11:27:43.84,8,,0.0
2020,11,2943,360,5,2554,2,4,9,1,7,6,5,2,5,0,False,False,False,0,1,2020-11-23T19:04:56.393,7,,2.0
2020,11,2943,365,5,3477,13,13,9,5,0,0,0,0,0,0,False,False,False,0,2,2020-11-23T14:53:52.89,0,,0.0
2020,11,2943,370,5,4803,2,5,5,7,15,8,10,5,10,0,False,False,False,0,3,2020-11-29T12:42:29.667,15,,5.0
2020,11,2943,375,5,3477,13,13,9,3,0,0,0,0,0,0,True,False,False,0,2,2021-03-17T19:43:34.417,0,,0.0
2020,11,2943,385,5,5220,13,19,6,30,0,0,0,0,0,0,False,False,False,0,2,2020-11-23T15:10:17.027,0,,0.0
2020,11,2943,395,5,3477,2,4,5,5,7,2,7,0,7,0,False,False,False,0,2,2020-11-23T19:05:19.353,7,,0.0
2020,11,2943,425,11,3820,2,4,9,5,5,0,5,0,5,0,False,False,False,0,2,2020-11-23T15:18:26.913,5,,0.0
2020,11,2943,430,11,6810,13,38,10,2,0,0,0,0,0,0,False,False,False,0,4,2021-03-12T15:22:40.537,0,,0.0
2020,11,2943,435,11,914,13,47,5,2,0,0,0,0,0,0,False,False,False,0,3,2021-02-19T15:52:45.777,0,,0.0
2020,11,2943,450,5,3477,2,35,9,8,18,10,16,2,16,0,False,False,False,0,3,2020-11-23T15:35:58.317,18,,2.0
2020,11,2943,455,5,5220,2,12,2,20,20,0,20,0,20,0,False,False,False,0,2,2020-11-23T15:42:10.35,20,,0.0
2020,11,2943,460,5,5044,13,11,5,6,0,0,0,0,0,0,False,False,False,0,6,2020-11-23T19:15:07.193,0,,0.0
2020,11,2943,470,5,4803,2,7,2,17,17,0,17,0,17,6,False,False,False,0,3,2020-11-23T15:54:36.53,17,,0.0
2020,11,2943,485,11,4487,2,51,10,-2,1,3,0,1,0,0,False,False,False,0,3,2021-03-04T19:10:04.767,1,,1.0
2020,11,2943,490,11,4487,2,49,9,-2,4,6,3,1,3,0,False,False,False,0,3,2020-11-23T16:02:00.973,4,,1.0
2020,11,2943,495,11,6810,2,7,6,17,19,2,17,2,17,0,False,False,False,0,3,2021-03-09T17:57:17.08,19,,2.0
2020,11,2943,500,11,914,2,21,7,51,51,0,51,0,51,0,False,False,False,0,3,2021-03-08T20:28:23.9,51,,
2020,11,2943,505,11,3820,2,50,9,0,5,5,5,0,5,0,False,False,False,0,2,2021-03-04T19:10:49.76,5,,0.0
2020,11,2943,510,11,4487,13,8,7,31,0,0,0,0,0,0,False,False,False,0,3,2020-11-23T16:15:50.547,0,,0.0
2020,11,2943,525,5,3477,2,49,5,-3,-3,0,-3,0,-3,0,True,False,False,0,2,2020-11-23T16:25:34.063,-3,,0.0
2020,11,2943,530,5,5220,2,5,3,9,11,2,11,0,11,0,False,False,False,0,3,2021-03-09T17:59:09.573,11,,0.0
2020,11,2943,535,5,5220,2,12,3,7,12,5,10,2,10,0,False,False,False,0,3,2020-11-23T16:30:42.75,12,,2.0
2020,11,2943,545,5,5220,2,2,9,5,10,5,6,4,6,0,False,False,False,1,2,2020-11-23T16:36:03.09,10,,4.0
2020,11,2943,555,5,3477,2,50,3,-2,-2,0,-3,1,-3,0,False,False,False,0,2,2020-11-23T16:41:49.89,-2,,1.0
2020,11,2943,560,5,4803,2,13,9,5,7,2,7,0,7,0,False,False,False,0,3,2020-11-29T12:46:19.883,7,,0.0
2020,11,2943,585,11,4487,2,5,3,5,5,0,5,0,5,0,False,False,False,0,3,2020-11-23T16:52:49.983,5,,0.0
2020,11,2943,590,11,6810,2,5,10,12,35,23,23,12,23,0,False,False,False,1,4,2020-11-23T16:56:52.683,35,,12.0
2020,11,2943,605,11,4487,3,16,10,6,0,0,0,0,0,0,False,False,False,0,3,2020-11-23T17:05:07.447,0,,0.0
2020,11,2943,625,5,3477,2,5,5,7,11,4,11,0,11,0,False,False,False,0,3,2020-11-23T17:16:26.96,11,,0.0
2020,11,2943,660,5,5220,13,35,5,7,0,0,0,0,0,0,False,False,False,0,3,2020-11-29T12:48:22.117,0,,0.0
2020,11,2943,665,11,6341,13,6,4,4,0,0,0,0,0,0,False,False,False,0,1,2020-11-23T17:36:22.877,0,,0.0
2020,11,2943,675,11,914,2,5,5,6,8,2,7,1,7,0,True,False,False,0,3,2020-11-23T17:40:58.217,8,,1.0
2020,11,2943,680,11,914,2,13,9,4,4,0,4,0,4,0,False,False,False,0,3,2020-11-29T12:49:31.92,4,,0.0
2020,11,2943,695,11,6341,13,48,10,-2,0,0,0,0,0,0,False,False,False,0,1,2020-11-23T17:53:01.533,0,,0.0
2020,11,2943,700,11,914,13,5,6,21,0,0,0,0,0,0,True,False,False,0,3,2021-03-09T18:00:37.59,0,,0.0
2020,11,2943,755,11,6341,2,48,4,-2,14,16,10,4,10,0,False,False,False,1,1,2020-11-29T12:31:23.47,14,,4.0
2020,11,2943,760,11,914,2,6,8,15,18,3,16,2,16,0,False,False,False,0,2,2020-11-23T18:18:14.337,18,,2.0
2020,11,2943,765,11,2714,2,47,5,1,3,2,3,0,3,0,False,False,False,0,4,2020-11-23T18:20:15.613,3,,0.0
2020,11,2943,775,11,6810,2,53,10,-4,3,7,1,2,1,0,False,False,False,0,4,2020-11-23T18:24:59.153,3,,2.0
2020,11,2943,785,11,4487,13,4,1,16,0,0,0,0,0,0,False,False,False,0,3,2021-03-09T18:02:15.32,0,,0.0
2020,11,2943,805,5,3750,3,33,9,5,0,0,0,0,0,0,False,False,False,0,4,2020-11-23T18:42:48.903,0,,0.0
2020,11,2944,10,8,4976,3,17,10,14,0,0,0,0,0,0,False,False,False,0,4,2020-11-24T18:37:18.333,0,,0.0
2020,11,2944,20,8,3606,13,5,5,13,0,0,0,0,0,0,False,False,False,0,2,2020-11-23T11:39:25.167,0,,
2020,11,2944,25,8,6633,13,12,5,13,0,0,0,0,0,0,False,False,False,0,2,2021-02-22T16:13:12.04,0,,0.0
2020,11,2944,40,24,6373,2,12,10,14,22,8,20,2,20,0,False,False,False,0,3,2020-11-23T11:51:17.82,22,,2.0
2020,11,2944,95,8,6633,2,6,4,12,13,1,13,0,13,0,False,False,False,0,3,2021-02-22T18:20:27.567,13,,0.0
2020,11,2944,115,8,232,2,2,10,8,13,5,8,5,8,0,False,False,False,0,2,2020-11-23T12:34:13.24,13,,5.0
2020,11,2944,120,8,3606,2,23,1,39,43,4,43,0,43,0,False,False,False,0,3,2021-02-22T18:20:27.567,43,,0.0
2020,11,2944,130,8,7652,13,7,3,14,0,0,0,0,0,0,False,False,False,0,3,2021-02-25T16:18:58.86,0,,
2020,11,2944,140,8,3883,13,5,9,2,0,0,0,0,0,0,False,False,False,0,4,2021-02-25T16:19:54.86,0,,0.0
2020,11,2944,160,24,7798,2,5,6,15,16,1,16,0,16,0,False,False,False,0,3,2020-11-23T13:03:44.02,16,,0.0
2020,11,2944,170,24,6373,2,9,2,20,32,12,29,3,29,0,False,False,False,0,4,2020-11-25T18:08:34.883,32,,3.0
2020,11,2944,175,24,6937,2,47,5,2,3,1,2,1,2,0,False,False,False,0,1,2020-11-23T13:26:09.69,3,,1.0
2020,11,2944,180,24,6937,13,44,9,-4,0,0,0,0,0,0,False,False,False,0,1,2021-03-05T15:17:11.36,0,,0.0
2020,11,2944,215,24,4382,2,49,10,-4,1,5,0,1,0,0,False,False,False,0,3,2021-02-22T15:34:51.41,1,,1.0
2020,11,2944,240,8,3883,2,24,6,18,21,3,20,1,20,0,True,False,False,0,4,2021-02-22T20:08:38.303,21,,1.0
2020,11,2944,260,8,3606,13,29,2,20,0,0,0,0,0,0,False,False,False,0,2,2020-11-23T19:05:56.603,0,,0.0
2020,11,2944,290,24,4382,2,50,10,-3,4,7,1,3,1,0,False,False,False,0,3,2021-03-03T13:34:02.413,4,,3.0
2020,11,2944,335,8,3883,2,32,5,3,7,4,5,2,5,0,False,False,False,0,4,2020-11-23T14:43:49.18,7,,2.0
2020,11,2944,350,24,6373,13,53,10,-4,0,0,0,0,0,0,False,False,False,0,4,2020-11-23T14:47:26.66,0,,0.0
2020,11,2944,365,24,6373,2,32,5,3,12,9,6,6,6,0,False,False,False,0,4,2020-11-23T14:51:30.06,12,,6.0
2020,11,2944,380,8,5053,2,31,9,1,10,9,7,3,7,0,False,False,False,0,1,2020-11-23T14:54:12.893,10,,3.0
2020,11,2944,390,8,3883,2,46,3,5,5,0,5,0,5,0,False,False,False,0,4,2020-11-23T14:57:35.53,5,,0.0
2020,11,2944,395,8,3883,3,51,3,4,0,0,0,0,0,0,True,False,False,0,4,2021-02-22T20:08:49.667,0,,0.0
2020,11,2944,445,24,565,2,12,8,19,19,0,19,0,19,6,False,False,False,0,4,2021-03-08T20:31:09.203,19,,0.0
2020,11,2944,460,8,6633,2,21,6,33,42,9,41,1,41,0,False,False,False,0,2,2020-11-23T15:15:32.44,42,,1.0
2020,11,2944,490,24,6808,13,29,2,15,0,0,0,0,0,0,False,False,False,0,2,2021-02-25T16:20:55.863,0,,0.0
2020,11,2944,500,24,264,13,6,7,16,0,0,0,0,0,0,False,False,False,0,2,2020-11-23T15:29:54.81,0,,0.0
2020,11,2944,510,8,3606,2,35,9,9,9,0,9,0,9,0,False,False,False,0,2,2020-11-23T15:35:01.69,9,,0.0
2020,11,2944,515,8,6633,13,12,6,46,0,0,0,0,0,0,False,False,False,0,3,2021-02-22T17:27:14.463,0,,0.0
2020,11,2944,620,24,6808,13,3,3,10,0,0,0,0,0,0,False,False,False,0,2,2020-11-23T17:01:22.743,0,,0.0
2020,11,2944,625,24,6808,2,35,10,8,8,0,8,0,8,0,False,False,False,0,3,2020-11-23T17:03:06.22,8,,0.0
2020,11,2944,630,24,565,2,29,2,22,29,7,29,0,29,0,False,False,False,0,4,2020-11-25T18:03:16.73,29,,0.0
2020,11,2944,640,24,6937,13,28,4,1,0,0,0,0,0,0,False,False,False,0,1,2020-11-24T17:58:06.577,0,,0.0
2020,11,2944,645,24,6808,13,8,7,25,0,0,0,0,0,0,False,False,False,0,2,2020-11-23T17:13:13.713,0,,0.0
2020,11,2944,660,8,6633,2,3,6,16,18,2,16,2,16,0,False,False,False,0,2,2020-11-25T17:58:22.033,18,,2.0
2020,11,2944,690,24,565,2,4,4,9,14,5,10,4,10,0,False,False,False,0,3,2020-11-23T17:26:44.463,14,,
2020,11,2944,695,24,4382,13,5,7,16,0,0,0,0,0,0,False,False,False,0,3,2020-11-25T16:41:55.827,0,,0.0
2020,11,2944,705,24,6808,13,3,10,14,0,0,0,0,0,0,False,False,False,0,3,2020-11-25T15:25:41.777,0,,0.0
2020,11,2944,725,8,3606,2,5,3,14,13,-1,13,0,13,0,False,False,False,0,3,2020-11-25T18:32:03.443,13,,0.0
2020,11,2944,750,8,232,2,5,5,3,10,7,4,6,4,0,False,False,False,0,3,2021-02-22T18:20:27.567,10,,6.0
2020,11,2944,785,24,6808,13,4,3,11,0,0,0,0,0,0,False,False,False,0,2,2020-11-23T18:00:45.117,0,,0.0
2020,11,2944,790,24,4382,2,13,9,4,4,0,4,0,4,0,False,False,False,0,3,2020-11-23T18:02:55.43,4,,0.0
2020,11,2944,795,24,6808,13,5,5,10,0,0,0,0,0,0,False,False,False,0,2,2020-11-25T16:43:09.297,0,,0.0
2020,11,2944,800,24,7798,2,3,10,11,11,0,11,0,11,0,False,False,False,0,3,2020-11-25T18:03:33.643,11,,0.0
2020,11,2944,805,24,6937,2,4,4,0,3,3,1,2,1,0,False,False,False,0,1,2020-11-23T18:08:02.617,3,,2.0
2020,11,2944,810,24,6937,2,5,5,2,9,7,2,7,2,0,False,False,False,0,1,2020-11-25T17:59:09.537,9,,7.0
2020,11,2944,815,24,6389,2,4,5,5,5,0,5,0,5,0,False,False,False,0,2,2020-11-23T18:11:34.44,5,,0.0
2020,11,2944,820,24,6373,3,24,2,35,0,0,0,0,0,0,False,False,False,0,3,2020-11-23T18:14:04.03,0,,
2020,11,2944,825,24,264,13,5,5,7,0,0,0,0,0,0,False,False,False,0,3,2021-03-05T15:17:33.823,0,,0.0
2020,11,2944,860,24,6389,2,46,3,1,7,6,7,0,7,0,False,False,False,0,1,2020-11-25T18:35:57.243,7,,0.0
2020,11,2944,865,24,6373,2,46,3,2,7,5,2,5,2,0,False,False,False,1,3,2020-11-23T18:29:56.98,7,,5.0
2020,11,2944,870,24,6389,2,4,4,5,14,9,12,2,12,0,False,False,False,0,1,2021-02-22T15:37:43.473,14,,2.0
2020,11,2944,875,24,7798,2,12,5,4,7,3,7,0,7,0,False,False,False,0,2,2020-11-23T18:34:06.977,7,,0.0
2020,11,2944,880,24,7798,13,35,10,12,0,0,0,0,0,0,False,False,False,0,3,2020-11-23T18:35:48.387,0,,0.0
2020,11,2944,890,24,7798,2,22,6,19,18,-1,18,0,18,0,False,False,False,0,2,2020-11-25T18:36:38.53,18,,0.0
2020,11,2944,895,24,6373,2,12,10,4,4,0,4,0,4,6,False,False,False,0,4,2020-11-23T19:05:40.027,4,,0.0
2020,11,2945,15,13,1430,2,12,5,10,13,3,10,3,10,0,False,False,False,1,3,2020-11-25T17:32:39.287,13,,3.0
2020,11,2945,20,13,876,2,4,4,4,6,2,6,0,6,0,False,False,False,0,3,2020-11-25T16:37:39.8,6,,0.0
2020,11,2945,30,13,404,13,12,7,17,0,0,0,0,0,0,False,False,False,0,1,2020-11-23T12:13:43.597,0,,0.0
2020,11,2945,45,19,1328,2,48,3,-4,34,38,27,7,27,0,False,False,False,0,1,2020-11-25T16:29:56.89,34,,7.0
2020,11,2945,50,19,3233,2,6,1,16,17,1,17,0,17,0,False,False,False,0,2,2020-11-23T12:21:35.46,17,,0.0
2020,11,2945,60,19,1510,2,51,10,-4,7,11,5,2,5,0,False,False,False,1,1,2020-11-25T16:26:07.79,7,,2.0
2020,11,2945,100,13,496,2,30,9,0,4,4,3,1,3,0,True,False,False,0,3,2020-11-25T16:40:52.03,4,,1.0
2020,11,2945,105,13,876,2,19,7,24,44,20,40,4,40,0,False,False,False,0,3,2020-11-25T16:42:09.39,44,,4.0
2020,11,2945,115,13,3951,2,49,9,-3,2,5,-2,4,-2,0,True,False,False,0,3,2021-03-04T19:44:31.977,2,,4.0
2020,11,2945,120,13,6528,2,35,3,14,22,8,18,4,18,0,True,False,False,0,4,2020-11-24T13:22:17.557,22,,4.0
2020,11,2945,125,13,496,2,35,9,3,3,0,3,0,3,6,False,False,False,0,3,2021-02-25T16:25:24.623,3,,0.0
2020,11,2945,150,19,7172,13,48,10,-2,0,0,0,0,0,0,False,False,False,0,1,2020-11-23T13:20:43.803,0,,0.0
2020,11,2945,155,19,2404,13,4,3,4,0,0,0,0,0,0,False,False,False,0,2,2020-11-23T13:23:14.667,0,,0.0
2020,11,2945,160,19,1510,2,50,10,-1,-2,-1,-2,0,-2,0,True,False,False,0,3,2020-11-25T16:27:11.15,-2,,0.0
2020,11,2945,175,13,1430,2,6,4,12,16,4,12,4,12,0,False,False,False,1,4,2020-11-23T14:13:55.82,16,,4.0
2020,11,2945,180,13,404,13,12,5,7,0,0,0,0,0,0,False,False,False,0,2,2020-11-23T14:16:06.22,0,,0.0
2020,11,2945,195,13,3951,2,12,4,14,17,3,15,2,15,0,False,False,False,1,3,2020-11-25T16:28:00.76,17,,
2020,11,2945,200,13,6529,13,35,9,14,0,0,0,0,0,0,False,False,False,0,3,2021-02-22T20:19:26.66,0,,0.0
2020,11,2945,210,19,6273,13,35,9,7,0,0,0,0,0,0,False,False,False,0,4,2021-03-08T14:52:42.33,0,,0.0
2020,11,2945,235,19,7175,2,35,3,14,20,6,19,1,19,0,False,False,False,0,3,2021-02-25T16:26:56.547,20,,1.0
2020,11,2945,245,19,1510,2,51,5,-4,7,11,7,0,7,0,False,False,False,0,1,2020-11-25T16:26:33.217,7,,
2020,11,2945,250,19,1328,13,31,10,4,0,0,0,0,0,0,False,False,False,0,1,2020-11-25T15:17:05.443,0,,0.0
2020,11,2945,255,19,1328,2,48,10,-7,9,16,8,1,8,0,False,False,False,0,1,2021-02-22T20:23:21.2,9,,1.0
2020,11,2945,270,13,6529,2,4,9,4,4,0,4,0,4,0,False,False,False,0,3,2020-11-25T16:56:55.91,4,,
2020,11,2945,280,13,6528,2,12,9,4,6,2,5,1,5,0,False,False,False,1,4,2021-03-08T20:36:21.783,6,,1.0
2020,11,2945,295,13,6528,2,35,2,19,25,6,22,3,22,0,False,False,False,0,3,2020-11-25T17:00:12.647,25,,3.0
2020,11,2945,300,13,876,2,9,3,13,21,8,19,2,19,0,False,False,False,0,2,2020-11-25T17:03:27.047,21,,2.0
2020,11,2945,305,13,876,3,5,10,2,0,0,0,0,0,0,False,False,False,0,3,2021-02-22T20:25:01.497,0,,0.0
2020,11,2945,325,19,3233,3,3,2,19,0,0,0,0,0,0,False,False,False,0,2,2020-11-25T15:34:18.887,0,,0.0
2020,11,2945,335,19,1328,2,47,10,-2,0,2,-2,2,-2,0,False,False,False,0,1,2020-11-25T17:04:09.987,0,,2.0
2020,11,2945,345,13,4662,13,35,8,16,0,0,0,0,0,0,False,False,False,0,4,2020-11-23T17:09:50.643,0,,0.0
2020,11,2945,365,13,4662,2,46,3,0,18,18,3,15,3,0,False,False,False,1,4,2021-03-03T17:13:42.463,18,,15.0
2020,11,2945,370,13,3951,2,13,5,4,9,5,4,5,4,0,False,False,False,1,3,2020-11-25T17:33:56.427,9,,5.0
2020,11,2945,375,13,6528,2,35,9,12,24,12,19,5,19,0,False,False,False,0,4,2020-11-23T17:37:20.297,24,,5.0
2020,11,2945,380,13,404,2,47,5,-2,4,6,3,1,3,0,False,False,False,0,1,2020-11-23T17:41:12.707,4,,1.0
2020,11,2945,390,13,876,2,12,3,14,14,0,14,0,14,6,True,False,False,0,3,2020-11-24T13:21:10.32,14,,
2020,11,2945,395,13,876,2,6,9,13,14,1,13,1,13,0,False,False,False,0,2,2020-11-23T17:46:49.54,14,,1.0
2020,11,2945,405,13,6529,2,5,3,4,4,0,4,0,4,0,False,False,False,0,3,2021-02-22T20:37:15.78,4,,0.0
2020,11,2945,415,13,6529,2,12,10,6,6,0,6,0,6,6,False,False,False,0,2,2021-02-22T20:26:54.917,6,,0.0
2020,11,2945,450,19,7173,2,44,3,-4,6,10,2,4,2,0,True,False,False,0,3,2020-11-25T17:35:00.487,6,,4.0
2020,11,2945,455,19,7173,2,5,5,13,13,0,13,0,13,0,False,False,False,0,3,2020-11-25T17:35:40.587,13,,0.0
2020,11,2945,475,13,3951,3,5,5,4,0,0,0,0,0,0,False,False,False,0,3,2020-11-25T15:17:05.443,0,,0.0
2020,11,2945,490,19,6531,13,35,9,13,0,0,0,0,0,0,False,False,False,0,4,2020-11-23T18:37:19.957,0,,0.0
2020,11,2945,500,19,3233,2,6,1,18,30,12,26,4,26,0,False,False,False,0,2,2021-02-22T20:30:15.717,30,,4.0
2020,11,2945,505,19,7172,13,4,4,2,0,0,0,0,0,0,False,False,False,0,1,2020-11-25T17:10:12.313,0,,0.0
2020,11,2945,515,19,1328,2,51,9,-4,2,6,1,1,1,0,False,False,False,0,1,2020-11-23T18:46:44.54,2,,1.0
2020,11,2945,520,19,3233,2,8,1,41,42,1,42,0,42,6,False,False,False,0,3,2020-11-25T17:36:48.037,42,,0.0
2020,11,2945,535,13,404,2,4,9,2,7,5,4,3,4,0,False,False,False,2,1,2020-11-25T17:12:24.017,7,,3.0
2020,11,2945,550,13,3951,2,4,3,13,13,0,13,0,13,0,False,False,False,0,2,2020-11-23T18:56:07.507,13,,0.0
2020,11,2945,555,13,3951,2,17,8,19,22,3,19,3,19,0,False,False,False,0,3,2021-02-22T20:32:00.54,22,,3.0
2020,11,2945,560,13,3951,13,8,1,41,0,0,0,0,0,0,False,False,False,0,2,2020-11-23T18:58:55.15,0,,0.0
2020,11,2945,565,13,404,2,50,9,-2,9,11,5,4,5,0,False,False,False,0,3,2020-11-23T19:00:09.537,9,,4.0
2020,11,2945,570,13,6528,2,47,10,1,6,5,3,3,3,0,False,False,False,0,4,2020-11-25T17:17:11.677,6,,3.0
2020,11,2945,580,13,4662,2,12,5,1,4,3,2,2,2,0,False,False,False,0,2,2021-03-08T20:37:52.607,4,,2.0
2020,11,2945,585,13,6529,13,8,1,28,0,0,0,0,0,0,False,False,False,0,2,2020-11-23T19:05:57.427,0,,0.0
2020,11,2945,605,19,2404,2,13,10,1,15,14,2,13,2,0,False,False,False,1,3,2020-11-23T19:11:45.363,15,,13.0
2020,11,2945,615,19,3233,2,5,2,19,19,0,19,0,19,0,False,False,False,0,2,2020-11-25T15:17:05.443,19,,0.0
2020,11,2945,630,19,1328,2,31,4,2,9,7,7,2,7,0,False,False,False,0,1,2020-11-25T15:17:05.443,9,,2.0
2020,11,2945,635,19,3233,2,50,5,-3,8,11,8,0,8,0,False,False,False,0,2,2021-02-22T20:32:58.32,8,,0.0
2020,11,2945,645,19,7173,2,4,10,10,12,2,11,1,11,0,False,False,False,0,3,2020-11-23T20:27:17.723,12,,1.0
2020,11,2945,650,19,1328,13,44,9,-2,0,0,0,0,0,0,False,False,False,0,1,2021-02-22T20:33:50.123,0,,0.0
2020,11,2945,655,19,3233,2,5,6,16,16,0,16,0,16,0,False,False,False,0,2,2020-11-25T15:17:05.443,16,,0.0
2020,11,2945,680,19,7175,2,48,9,-5,4,9,3,1,3,0,True,False,False,0,1,2020-11-25T17:19:39.53,4,,1.0
2020,11,2945,695,13,3652,2,45,5,-4,4,8,3,1,3,0,True,False,False,0,1,2020-11-23T19:33:43.317,4,,1.0
2020,11,2945,705,13,3951,2,6,10,14,14,0,13,1,13,0,False,False,False,0,3,2021-02-24T16:50:07.273,14,,1.0
2020,11,2945,710,13,3951,2,50,9,-1,20,21,9,11,9,0,False,False,False,0,2,2021-03-03T17:17:27.92,20,,11.0
2020,11,2945,720,13,3652,2,44,3,-3,4,7,4,0,4,0,False,False,False,0,1,2020-11-23T19:40:12.863,4,,0.0
2020,11,2945,725,13,6528,13,9,6,18,0,0,0,0,0,0,False,False,False,0,4,2021-02-24T16:50:24.027,0,,0.0
2020,11,2945,740,19,7172,2,4,4,4,11,7,10,1,10,0,False,False,False,0,1,2020-11-23T19:44:11.617,11,,1.0
2020,11,2945,745,19,7173,3,44,9,-3,0,0,0,0,0,0,True,False,False,0,3,2020-11-25T17:39:00.007,0,,0.0
2020,11,2945,750,19,1328,13,31,10,1,0,0,0,0,0,0,False,False,False,0,1,2020-11-25T15:17:05.443,0,,0.0
2020,11,2945,755,19,7175,2,39,10,6,14,8,12,2,12,0,False,False,False,0,3,2020-11-25T15:17:05.443,14,,2.0
2020,11,2945,760,19,7173,2,46,3,3,4,1,4,0,4,0,True,False,False,0,3,2020-11-25T17:39:28.037,4,,0.0
2020,11,2945,765,19,7173,2,13,4,5,6,1,6,0,6,0,False,False,False,0,3,2020-11-23T19:50:46.267,6,,0.0
2020,11,2945,775,19,1328,2,48,9,-5,10,15,7,3,7,0,False,False,False,0,1,2020-11-23T19:52:33.12,10,,3.0
2020,11,2945,785,19,7173,3,13,10,5,0,0,0,0,0,0,False,False,False,0,3,2020-11-23T19:54:24.763,0,,0.0
2020,11,2945,800,19,7173,13,2,10,6,0,0,0,0,0,0,False,False,False,0,2,2021-03-01T18:48:16.59,0,,0.0
2020,11,2945,810,19,6273,13,12,4,3,0,0,0,0,0,0,False,False,False,0,4,2021-04-02T13:36:26.127,0,,0.0
2020,11,2945,845,19,6273,2,47,5,6,9,3,9,0,9,0,True,False,False,0,3,2020-11-25T17:25:28.697,9,,0.0
2020,11,2945,850,19,6273,2,19,2,50,50,0,50,0,50,0,False,False,False,0,3,2020-11-24T18:54:50.79,50,,0.0
2020,11,2946,10,12,556,2,9,2,26,33,7,32,1,32,0,False,False,False,0,3,2020-11-27T18:32:21.327,33,,1.0
2020,11,2946,15,12,6691,2,5,5,6,8,2,7,1,7,0,False,False,False,0,3,2021-03-09T18:10:23.063,8,,1.0
2020,11,2946,25,14,6543,2,46,3,3,15,12,12,3,12,0,False,False,False,0,1,2021-03-09T18:11:22.597,15,,
2020,11,2946,30,14,4449,2,4,4,10,14,4,11,3,11,0,False,False,False,0,3,2021-03-09T18:12:37.603,14,,3.0
2020,11,2946,35,14,1114,13,35,10,14,0,0,0,0,0,0,False,False,False,0,3,2020-11-27T18:32:21.343,0,,0.0
2020,11,2946,40,14,5197,2,4,10,6,9,3,7,2,7,0,False,True,True,0,3,2021-03-09T18:15:12.07,8,False,2.0
2020,11,2946,60,12,4511,2,30,5,2,4,2,3,1,3,0,False,False,False,0,4,2020-11-23T11:54:25.183,4,,1.0
2020,11,2946,65,12,467,2,13,9,5,8,3,6,2,6,0,False,False,False,0,4,2020-11-23T11:57:00.57,8,,2.0
2020,11,2946,75,12,4511,2,17,8,22,25,3,25,0,25,6,False,False,False,0,4,2020-11-23T12:18:27.423,25,,0.0
2020,11,2946,100,14,1114,2,6,9,8,13,5,12,1,12,0,False,False,False,0,2,2021-03-09T18:27:33.737,13,,1.0
2020,11,2946,110,14,7584,2,13,10,5,45,40,45,0,45,6,False,False,False,0,3,2021-03-09T18:28:47.243,45,,0.0
2020,11,2946,125,12,6357,13,19,6,18,0,0,0,0,0,0,False,False,False,0,2,2021-02-19T20:13:47.363,0,,0.0
2020,11,2946,160,14,6543,13,44,3,-4,0,0,0,0,0,0,True,False,False,0,1,2020-11-24T22:50:37.767,0,,0.0
2020,11,2946,165,14,1114,2,50,5,-2,0,2,-1,1,-1,0,False,False,False,0,2,2021-02-19T20:14:09.873,0,,1.0
2020,11,2946,170,14,7582,2,32,10,-2,9,11,4,5,4,0,False,False,False,0,1,2020-11-23T12:51:07.193,9,,5.0
2020,11,2946,190,12,6357,13,9,2,20,0,0,0,0,0,0,False,False,False,0,3,2021-03-05T15:18:49.57,0,,0.0
2020,11,2946,195,14,7582,2,48,9,-6,0,6,-3,3,-3,0,False,False,False,0,1,2020-11-23T14:39:20.913,0,,3.0
2020,11,2946,220,12,556,2,6,4,14,20,6,14,6,14,0,False,False,False,1,2,2020-11-27T19:32:42.59,20,,6.0
2020,11,2946,225,12,4537,2,45,5,-3,5,8,2,3,2,0,False,False,False,0,1,2020-11-23T14:50:10.853,5,,3.0
2020,11,2946,250,12,6356,2,51,9,-3,23,26,7,16,7,0,True,False,False,0,3,2021-02-19T20:15:24.377,23,,16.0
2020,11,2946,270,14,895,13,42,4,8,0,0,0,0,0,0,False,False,False,0,3,2021-03-05T15:19:08.587,0,,0.0
2020,11,2946,275,12,6876,2,4,3,7,8,1,7,1,7,0,False,False,False,0,2,2020-11-23T15:14:47.823,8,,1.0
2020,11,2946,285,12,6876,2,30,5,1,12,11,11,1,11,0,False,False,False,0,4,2020-11-23T15:17:40.64,12,,1.0
2020,11,2946,290,12,556,2,51,9,-2,5,7,4,1,4,6,False,False,False,0,3,2021-02-19T20:15:48.48,5,,1.0
2020,11,2946,310,14,7582,2,47,10,2,6,4,3,3,3,0,False,False,False,0,1,2020-11-25T18:55:53.02,6,,3.0
2020,11,2946,320,14,7584,2,4,10,3,5,2,4,1,4,0,False,False,False,0,3,2021-03-09T18:32:12.713,5,,1.0
2020,11,2946,340,14,4449,2,6,7,15,20,5,15,5,15,0,False,False,False,1,2,2020-11-27T19:33:02.573,20,,5.0
2020,11,2946,345,14,1114,13,19,2,34,0,0,0,0,0,0,False,False,False,0,2,2020-11-23T15:36:58.767,0,,0.0
2020,11,2946,350,14,7584,2,13,9,3,16,13,13,3,13,0,False,False,False,0,2,2020-11-23T15:38:41.02,16,,3.0
2020,11,2946,370,14,895,2,17,7,17,17,0,17,0,17,6,False,False,False,0,4,2020-11-23T15:43:18.247,17,,0.0
2020,11,2946,385,12,556,2,5,5,4,5,1,5,0,5,0,False,False,False,0,3,2020-11-23T15:46:57.843,5,,0.0
2020,11,2946,415,12,6357,13,23,8,48,0,0,0,0,0,0,False,False,False,0,2,2020-11-23T19:23:18.377,0,,
2020,11,2946,420,12,4561,2,47,5,0,4,4,3,1,3,6,True,False,False,0,1,2020-11-24T16:59:57.96,4,,1.0
2020,11,2946,490,14,8165,2,44,3,-3,1,4,1,0,1,0,True,False,False,0,3,2020-11-23T16:15:59.187,1,,0.0
2020,11,2946,495,14,6543,2,6,9,4,9,5,6,3,6,0,False,False,False,0,2,2021-02-25T16:30:00.027,9,,3.0
2020,11,2946,510,14,1114,13,8,8,19,0,0,0,0,0,0,False,False,False,0,3,2020-11-23T16:22:13.263,0,,0.0
2020,11,2946,530,12,4537,2,4,4,2,3,1,3,0,3,0,False,False,False,0,1,2020-11-23T16:26:25.403,3,,0.0
2020,11,2946,535,12,6357,13,19,2,18,0,0,0,0,0,0,False,False,False,0,2,2020-11-27T19:58:05.813,0,,0.0
2020,11,2946,545,14,4070,13,35,2,15,0,0,0,0,0,0,False,False,False,0,3,2020-11-23T16:33:37.347,0,,0.0
2020,11,2946,550,14,895,13,6,4,5,0,0,0,0,0,0,False,False,False,0,3,2020-11-23T16:34:48.24,0,,0.0
2020,11,2946,555,14,7582,2,45,5,-5,9,14,6,3,6,0,False,False,False,0,1,2020-11-23T16:36:21.463,9,,3.0
2020,11,2946,565,14,4070,13,23,1,28,0,0,0,0,0,0,False,False,False,0,3,2020-11-27T18:32:21.343,0,,0.0
2020,11,2946,570,14,6543,2,16,10,5,9,4,7,2,7,0,False,False,False,0,1,2020-11-23T16:44:58.543,9,,2.0
2020,11,2946,580,14,1114,2,7,6,20,23,3,23,0,23,0,False,False,False,0,3,2020-11-23T16:48:50.653,23,,0.0
2020,11,2946,590,14,6543,2,16,9,3,6,3,4,2,4,6,False,False,False,0,1,2020-11-23T16:55:53.03,6,,
2020,11,2946,595,14,1119,2,4,9,6,6,0,6,0,6,6,False,False,False,0,4,2020-11-23T16:57:59.657,6,,0.0
2020,11,2946,610,12,6876,2,30,9,-2,3,5,0,3,0,0,False,False,False,0,4,2020-11-23T17:02:41.117,3,,3.0
2020,11,2946,620,12,556,13,2,9,6,0,0,0,0,0,0,False,False,False,0,2,2020-11-23T17:09:44.307,0,,0.0
2020,11,2946,645,14,4449,2,5,2,17,20,3,19,1,19,0,False,False,False,0,3,2020-11-23T17:15:42.01,20,,1.0
2020,11,2946,650,14,5197,2,54,10,-2,8,10,5,3,5,0,False,False,False,0,4,2020-11-27T18:32:21.343,8,,3.0
2020,11,2946,665,14,895,2,6,4,5,8,3,5,3,5,0,False,False,False,0,3,2020-11-23T17:40:10.263,8,,3.0
2020,11,2946,700,14,4449,2,2,10,5,8,3,7,1,7,0,False,False,False,0,2,2020-11-23T17:57:44.89,8,,
2020,11,2946,705,14,895,13,4,10,6,0,0,0,0,0,0,False,False,False,0,3,2020-11-27T19:58:47.547,0,,0.0
2020,11,2946,720,12,6357,2,30,5,0,9,9,8,1,8,0,True,False,False,0,3,2020-11-23T18:02:36.753,9,,1.0
2020,11,2946,735,12,4537,2,4,3,8,14,6,11,3,11,0,False,False,False,1,2,2020-11-27T19:33:51.373,14,,3.0
2020,11,2946,740,12,6691,2,12,3,8,10,2,10,0,10,0,False,False,False,0,3,2021-03-01T19:18:41.793,10,,0.0
2020,11,2946,750,12,556,2,2,9,5,11,6,9,2,9,0,False,False,False,0,3,2020-11-23T18:12:52.863,11,,2.0
2020,11,2946,755,12,4511,2,47,10,1,1,0,1,0,1,0,False,False,False,0,4,2020-11-23T18:14:06.667,1,,0.0
2020,11,2946,760,12,4511,2,4,3,7,7,0,7,0,7,0,False,False,False,0,2,2020-11-27T18:32:21.343,7,,0.0
2020,11,2946,765,12,4561,13,5,3,7,0,0,0,0,0,0,False,False,False,0,1,2021-03-08T14:54:10.843,0,,0.0
2020,11,2946,770,14,4070,2,6,10,14,14,0,14,0,14,0,False,False,False,0,2,2020-11-23T18:20:17.397,14,,0.0
2020,11,2946,800,14,6546,2,48,10,-4,15,19,11,4,11,0,False,False,False,0,1,2021-02-19T20:20:07.78,15,,4.0
2020,11,2946,810,14,6543,2,2,10,1,13,12,8,5,8,0,False,False,False,0,2,2020-11-23T18:33:20.503,13,,5.0
2020,11,2946,825,14,1119,13,32,5,3,0,0,0,0,0,0,False,False,False,0,4,2020-11-23T18:36:29.177,0,,0.0
2020,11,2946,845,14,5197,13,4,4,9,0,0,0,0,0,0,False,False,False,0,3,2021-04-02T13:42:08.163,0,,0.0
2020,11,2946,855,12,6691,3,2,9,7,0,0,0,0,0,0,False,False,False,0,3,2021-02-19T20:23:17.947,0,,0.0
2020,11,2946,860,12,6691,13,8,4,13,0,0,0,0,0,0,False,False,False,0,3,2020-11-23T18:48:26.387,0,,0.0
2020,11,2946,865,12,6357,2,17,1,44,47,3,46,1,46,0,False,False,False,0,3,2020-11-23T18:50:02.07,47,,1.0
2020,11,2946,875,12,556,2,6,10,12,14,2,12,2,12,0,False,False,False,1,2,2020-11-27T19:34:01.38,14,,2.0
2020,11,2946,885,12,556,2,6,4,12,18,6,17,1,17,0,False,False,False,0,3,2020-11-23T18:54:17.01,18,,1.0
2020,11,2946,895,12,4511,2,2,4,2,7,5,4,3,4,0,False,False,False,0,2,2020-11-27T18:32:21.343,7,,3.0
2020,11,2946,900,12,556,13,7,3,8,0,0,0,0,0,0,False,False,False,0,3,2021-03-09T20:12:11.963,0,,0.0
2020,11,2946,925,12,4537,2,51,10,-7,8,15,6,2,6,0,False,False,False,0,1,2020-11-23T19:01:12.903,8,,2.0
2020,11,2946,930,12,6357,2,51,9,-2,0,2,0,0,0,0,True,True,True,0,3,2021-02-19T20:24:51.53,-1,False,0.0
2020,11,2947,10,15,4997,2,5,2,17,17,0,17,0,17,0,False,False,False,0,3,2020-11-23T11:02:51.807,17,,0.0
2020,11,2947,25,15,8099,2,5,5,3,15,12,3,12,3,0,False,False,False,1,1,2020-11-25T17:40:02.813,15,,12.0
2020,11,2947,45,15,4886,13,17,5,12,0,0,0,0,0,0,False,False,False,0,1,2021-02-25T16:51:01.403,0,,0.0
2020,11,2947,60,25,7060,2,6,10,2,7,5,7,0,7,0,False,False,False,0,2,2020-11-24T20:28:13.337,7,,0.0
2020,11,2947,70,25,7666,13,2,10,5,0,0,0,0,0,0,False,False,False,0,2,2020-11-23T11:35:31.2,0,,0.0
2020,11,2947,75,25,7060,2,5,5,7,7,0,7,0,7,0,False,False,False,0,3,2020-11-23T11:46:19.853,7,,0.0
2020,11,2947,80,25,7060,3,2,9,3,0,0,0,0,0,0,False,False,False,0,2,2020-11-24T20:28:31.207,0,,0.0
2020,11,2947,100,15,4997,2,26,10,5,9,4,8,1,8,0,False,False,False,0,3,2020-11-23T11:53:51.857,9,,1.0
2020,11,2947,110,15,6501,13,8,8,33,0,0,0,0,0,0,False,False,False,0,2,2020-11-23T11:58:59.997,0,,0.0
2020,11,2947,120,15,4886,13,48,9,-6,0,0,0,0,0,0,False,False,False,0,1,2020-11-23T12:05:00.423,0,,0.0
2020,11,2947,140,25,7060,2,4,3,8,8,0,8,0,8,0,False,False,False,0,2,2020-11-23T12:14:37.743,8,,0.0
2020,11,2947,150,25,4583,2,13,9,0,1,1,1,0,1,0,False,False,False,0,3,2020-11-23T12:18:23.367,1,,0.0
2020,11,2947,155,25,7666,2,5,5,10,10,0,10,0,10,0,False,False,False,0,3,2020-11-23T12:20:59.927,10,,0.0
2020,11,2947,170,25,609,13,13,10,3,0,0,0,0,0,0,False,False,False,0,4,2020-11-23T12:28:41.847,0,,0.0
2020,11,2947,190,15,4997,13,4,9,5,0,0,0,0,0,0,True,False,False,0,3,2020-11-24T19:10:39.233,0,,0.0
2020,11,2947,205,25,7060,2,9,6,20,22,2,22,0,22,0,False,False,False,0,2,2021-02-25T16:52:03.897,22,,0.0
2020,11,2947,215,25,7666,2,5,5,10,10,0,10,0,10,0,True,False,False,0,3,2020-11-25T18:28:24.4,10,,0.0
2020,11,2947,220,25,7666,13,19,6,38,0,0,0,0,0,0,False,False,False,0,2,2020-11-23T12:47:47.507,0,,0.0
2020,11,2947,225,25,4587,2,48,9,-3,14,17,12,2,12,0,False,False,False,0,1,2020-11-25T19:05:03.497,14,,2.0
2020,11,2947,240,25,7060,13,3,3,11,0,0,0,0,0,0,False,False,False,0,2,2020-11-23T12:54:40.02,0,,0.0
2020,11,2947,260,15,2407,13,5,3,5,0,0,0,0,0,0,False,False,False,0,3,2020-11-23T12:58:30.55,0,,0.0
2020,11,2947,265,15,2407,3,6,7,21,0,0,0,0,0,0,False,False,False,0,2,2020-11-25T18:29:50.157,0,,0.0
2020,11,2947,275,25,4583,2,50,9,-2,5,7,5,0,5,0,False,False,False,0,3,2020-11-25T17:40:02.813,5,,0.0
2020,11,2947,285,25,7060,2,6,10,3,4,1,4,0,4,0,False,False,False,0,2,2020-11-23T13:17:46.803,4,,0.0
2020,11,2947,290,25,6486,2,5,3,12,12,0,12,0,12,0,False,False,False,0,3,2020-11-23T13:20:05.34,12,,0.0
2020,11,2947,300,25,7666,2,19,2,30,31,1,30,1,30,6,False,False,False,0,2,2020-11-23T13:24:50.753,31,,1.0
2020,11,2947,315,15,6501,2,50,9,-3,-4,-1,-4,0,-4,0,False,False,False,0,2,2020-11-25T18:21:07.98,-4,,0.0
2020,11,2947,330,15,6501,2,4,3,4,18,14,15,3,15,0,False,False,False,1,2,2020-11-25T19:06:05.697,18,,3.0
2020,11,2947,335,15,2407,2,51,10,-3,13,16,-2,15,-2,0,False,False,False,1,3,2020-11-25T19:06:33.633,13,,15.0
2020,11,2947,345,15,922,13,16,10,9,0,0,0,0,0,0,False,False,False,0,4,2021-03-05T15:21:19.66,0,,0.0
2020,11,2947,355,25,609,2,4,9,2,2,0,2,0,2,0,False,False,False,0,4,2020-11-23T13:46:20.717,2,,0.0
2020,11,2947,365,25,4587,2,31,10,-2,-2,0,-2,0,-2,0,False,False,False,0,1,2020-11-23T13:49:09.583,-2,,0.0
2020,11,2947,370,25,7060,2,6,7,18,20,2,20,0,20,0,False,False,False,0,2,2020-11-23T17:15:23.477,20,,0.0
2020,11,2947,380,25,609,13,33,6,24,0,0,0,0,0,0,False,False,False,0,4,2020-11-25T18:33:05.813,0,,0.0
2020,11,2947,385,25,7060,2,29,6,18,23,5,20,3,20,0,False,False,False,0,2,2020-11-25T18:26:24.917,23,,3.0
2020,11,2947,410,15,6501,2,4,9,14,19,5,18,1,18,0,False,False,False,0,2,2020-11-23T14:04:16.56,19,,1.0
2020,11,2947,420,15,922,13,17,8,31,0,0,0,0,0,0,False,False,False,0,3,2020-11-25T17:40:02.813,0,,0.0
2020,11,2947,425,25,7060,2,18,3,-1,6,7,4,2,4,0,False,False,False,0,2,2020-11-23T14:09:06.453,6,,2.0
2020,11,2947,430,25,4583,13,17,8,20,0,0,0,0,0,0,False,False,False,0,3,2021-02-19T20:28:35.483,0,,0.0
2020,11,2947,445,25,7666,13,19,2,41,0,0,0,0,0,0,False,False,False,0,2,2020-11-23T14:15:08.583,0,,
2020,11,2947,450,25,6486,13,35,8,24,0,0,0,0,0,0,False,False,False,0,3,2020-11-23T14:18:44.513,0,,0.0
2020,11,2947,465,25,6259,2,34,4,-4,-2,2,-7,5,-7,0,True,False,False,2,3,2020-11-25T19:07:08.293,-2,,5.0
2020,11,2947,475,25,6486,13,9,2,29,0,0,0,0,0,0,False,False,False,0,2,2020-11-23T14:26:05.663,0,,0.0
2020,11,2947,495,15,4997,13,17,1,31,0,0,0,0,0,0,False,False,False,0,3,2020-11-23T14:31:06.503,0,,0.0
2020,11,2947,500,15,922,2,5,5,14,15,1,14,1,14,0,False,False,False,0,3,2021-02-19T20:29:06.537,15,,1.0
2020,11,2947,520,15,922,13,5,10,-7,0,0,0,0,0,0,False,False,False,0,4,2020-11-23T14:39:26.953,0,,0.0
2020,11,2947,540,25,7060,2,6,10,1,5,4,3,2,3,0,False,False,False,0,2,2020-11-23T14:44:26.617,5,,2.0
2020,11,2947,545,25,4583,2,47,5,2,4,2,4,0,4,0,False,False,False,0,3,2020-11-23T14:46:32.257,4,,0.0
2020,11,2947,555,25,6259,2,34,4,-4,1,5,1,0,1,0,True,False,False,0,3,2020-11-23T14:49:48.837,1,,0.0
2020,11,2947,560,25,7060,13,26,9,1,0,0,0,0,0,0,False,False,False,0,3,2020-11-23T14:53:03.823,0,,0.0
2020,11,2947,565,25,6259,2,18,3,0,8,8,8,0,8,0,False,False,False,0,2,2020-11-23T14:55:26.897,8,,0.0
2020,11,2947,575,15,6501,2,4,9,4,8,4,7,1,7,0,False,False,False,0,3,2020-11-23T14:58:53.233,8,,1.0
2020,11,2947,585,15,6501,13,13,10,-1,0,0,0,0,0,0,False,False,False,0,3,2020-11-23T15:02:13.39,0,,0.0
2020,11,2947,605,25,7060,2,49,9,-2,3,5,3,0,3,0,False,False,False,0,2,2020-11-23T15:07:04.387,3,,0.0
2020,11,2947,610,25,7060,2,2,10,2,4,2,3,1,3,0,False,False,False,0,2,2020-11-23T15:09:01.15,4,,1.0
2020,11,2947,630,25,7060,2,49,5,-4,2,6,1,1,1,0,False,False,False,1,2,2020-11-23T15:19:42.12,2,,1.0
2020,11,2947,635,25,609,13,38,4,6,0,0,0,0,0,0,False,False,False,0,4,2020-11-23T15:22:02.463,0,,0.0
2020,11,2947,650,15,4997,13,2,4,6,0,0,0,0,0,0,False,False,False,0,3,2020-11-24T19:10:23.027,0,,
2020,11,2947,660,15,4997,13,24,5,8,0,0,0,0,0,0,False,False,False,0,3,2021-02-25T16:53:39.75,0,,0.0
2020,11,2947,665,15,4886,13,5,9,5,0,0,0,0,0,0,False,False,False,0,3,2020-11-23T15:34:26.52,0,,0.0
2020,11,2947,680,25,4583,2,2,10,5,9,4,6,3,6,0,False,False,False,0,3,2020-11-23T15:37:14.883,9,,3.0
2020,11,2947,685,25,7666,3,9,2,26,0,0,0,0,0,0,True,False,False,0,3,2021-02-19T20:30:44.98,0,,0.0
2020,11,2947,690,25,609,2,46,9,-1,9,10,5,4,5,0,False,False,False,0,4,2020-11-23T15:42:52.94,9,,4.0
2020,11,2947,695,25,7060,13,29,3,10,0,0,0,0,0,0,False,False,False,0,2,2020-11-25T17:40:02.813,0,,0.0
2020,11,2947,700,25,7666,13,3,2,15,0,0,0,0,0,0,False,False,False,0,2,2020-11-23T15:48:10.923,0,,0.0
2020,11,2947,705,25,7666,13,7,2,31,0,0,0,0,0,0,False,False,False,0,3,2020-11-25T17:40:02.813,0,,
2020,11,2947,710,25,7666,2,13,10,2,8,6,7,1,7,0,True,False,False,2,3,2020-11-25T19:08:33.977,8,,1.0
2020,11,2947,720,25,609,2,4,9,5,5,0,5,0,5,0,False,False,False,0,4,2020-11-23T15:55:39.163,5,,0.0
2020,11,2947,725,25,4587,2,51,10,-3,-2,1,-3,1,-3,0,False,False,False,0,3,2020-11-23T15:57:04.947,-2,,1.0
2020,11,2947,740,15,8099,2,5,3,5,6,1,6,0,6,0,False,False,False,0,1,2020-11-23T17:20:18.287,6,,0.0
2020,11,2947,745,15,922,2,8,1,17,17,0,17,0,17,0,False,False,False,0,3,2020-11-25T17:40:02.813,17,,0.0
2020,11,2947,755,15,2407,13,5,2,16,0,0,0,0,0,0,False,False,False,0,2,2020-11-23T16:10:39.683,0,,0.0
2020,11,2947,760,15,4997,2,6,10,7,12,5,10,2,10,0,False,False,False,0,3,2020-11-23T16:12:19.78,12,,
2020,11,2947,765,15,6501,13,4,6,18,0,0,0,0,0,0,False,False,False,0,2,2021-03-05T15:21:46.253,0,,0.0
2020,11,2947,780,25,6259,2,5,3,5,13,8,13,0,13,0,True,False,False,0,3,2020-11-23T17:18:33.647,13,,0.0
2020,11,2947,785,25,609,2,17,10,14,20,6,19,1,19,6,False,False,False,0,4,2020-11-23T17:55:33.597,20,,1.0
2020,11,2947,800,15,8114,13,47,5,2,0,0,0,0,0,0,False,False,False,0,3,2020-11-25T18:52:47.33,0,,0.0
2020,11,2947,810,15,8114,2,31,10,7,10,3,9,1,9,0,False,False,False,0,4,2020-11-25T18:53:34.08,10,,1.0
2020,11,2947,815,15,8114,13,17,1,24,0,0,0,0,0,0,False,False,False,0,3,2020-11-23T16:44:28.93,0,,0.0
2020,11,2947,845,15,7361,2,50,3,-1,-1,0,-1,0,-1,0,False,False,False,0,2,2020-11-25T17:40:02.813,-1,,0.0
2020,11,2947,850,15,4702,2,47,5,2,3,1,2,1,2,0,False,False,False,0,3,2020-11-25T18:54:33.27,3,,1.0
2020,11,2947,855,15,7361,2,47,5,2,3,1,2,1,2,0,False,False,False,1,4,2021-03-03T17:27:59.3,3,,1.0
2020,11,2947,860,15,7361,2,28,5,-2,3,5,2,1,2,0,False,False,False,1,1,2020-11-25T18:55:18.887,3,,1.0
2020,11,2948,10,2,990,2,46,3,2,3,1,3,0,3,0,False,False,False,0,1,2020-11-23T11:12:01.07,3,,0.0
2020,11,2948,15,2,5223,2,19,1,44,46,2,44,2,44,0,False,False,False,0,2,2020-11-23T11:13:47.563,46,,2.0
2020,11,2948,20,2,7303,2,3,5,11,10,-1,10,0,10,0,True,False,False,0,2,2020-11-23T11:15:09.51,10,,0.0
2020,11,2948,30,2,2835,2,47,5,1,4,3,3,1,3,0,False,False,False,0,1,2020-11-23T11:17:27.457,4,,1.0
2020,11,2948,35,2,5214,13,9,9,10,0,0,0,0,0,0,False,False,False,0,3,2020-11-23T11:24:14.923,0,,0.0
2020,11,2948,50,20,3763,2,4,5,3,8,5,7,1,7,0,False,False,False,1,2,2020-11-25T19:03:44.25,8,,1.0
2020,11,2948,80,2,6247,2,50,9,0,1,1,0,1,0,0,False,False,False,1,2,2020-11-23T11:35:25.887,1,,1.0
2020,11,2948,115,20,3763,13,5,3,9,0,0,0,0,0,0,False,False,False,0,2,2020-11-24T15:59:41.36,0,,
2020,11,2948,120,20,7888,2,26,9,6,19,13,13,6,13,0,False,False,False,0,3,2020-11-24T15:57:45.603,19,,6.0
2020,11,2948,135,20,3763,13,13,10,4,0,0,0,0,0,0,False,False,False,0,3,2021-02-19T21:15:18.727,0,,0.0
2020,11,2948,140,20,3763,2,49,9,0,0,0,0,0,0,0,False,False,False,0,2,2020-11-25T18:59:20.95,0,,0.0
2020,11,2948,160,2,661,2,2,9,13,17,4,16,1,16,0,False,False,False,0,2,2020-11-23T11:56:36.833,17,,1.0
2020,11,2948,185,2,990,13,46,9,1,0,0,0,0,0,0,False,False,False,0,1,2020-11-23T12:00:13.507,0,,0.0
2020,11,2948,190,2,2835,2,28,10,-1,-1,0,-1,0,-1,0,False,False,False,0,1,2020-11-25T19:44:03.133,-1,,
2020,11,2948,205,2,5214,13,31,10,0,0,0,0,0,0,0,False,False,False,0,4,2020-11-25T19:00:02.3,0,,0.0
2020,11,2948,220,20,3763,2,35,6,19,23,4,23,0,23,0,True,False,False,0,3,2020-11-23T12:13:42.45,23,,0.0
2020,11,2948,225,20,3763,2,5,3,9,9,0,9,0,9,0,False,False,False,0,2,2020-11-25T19:44:43.323,9,,0.0
2020,11,2948,235,20,3763,3,4,9,13,0,0,0,0,0,0,False,False,False,0,3,2020-11-25T19:45:44.203,0,,0.0
2020,11,2948,245,20,5140,3,48,9,-6,0,0,0,0,0,0,False,False,False,0,1,2020-11-23T13:04:55.5,0,,0.0
2020,11,2948,265,2,5223,2,2,5,6,8,2,6,2,6,0,False,False,False,0,2,2020-11-25T18:17:24.133,8,,2.0
2020,11,2948,285,20,213,13,5,5,5,0,0,0,0,0,0,True,False,False,0,2,2020-11-25T19:48:20.613,0,,0.0
2020,11,2948,290,20,7353,2,51,10,-5,2,7,2,0,2,0,False,False,False,0,2,2021-02-19T21:16:32.217,2,,0.0
2020,11,2948,310,2,6247,2,5,3,11,11,0,11,0,11,0,False,False,False,0,3,2020-11-25T19:49:52.063,11,,0.0
2020,11,2948,315,2,6247,2,7,6,17,17,0,17,0,17,0,False,False,False,0,3,2020-11-25T18:24:54.223,17,,0.0
2020,11,2948,325,2,6240,13,35,3,12,0,0,0,0,0,0,False,False,False,0,2,2020-11-23T12:58:33.283,0,,0.0
2020,11,2948,335,2,6247,13,5,3,12,0,0,0,0,0,0,False,False,False,0,3,2021-03-17T19:46:08.52,0,,0.0
2020,11,2948,350,20,3763,2,6,9,14,16,2,14,2,14,0,False,False,False,0,2,2020-11-25T18:19:34.293,16,,2.0
2020,11,2948,360,20,213,2,8,7,44,44,0,44,0,44,0,False,False,False,0,3,2020-11-23T13:14:30.627,44,,0.0
2020,11,2948,380,20,958,2,4,9,5,6,1,6,0,6,0,False,False,False,0,3,2020-11-25T20:53:46.407,6,,0.0
2020,11,2948,405,2,5223,2,6,10,5,7,2,7,0,7,0,False,False,False,0,2,2020-11-23T13:33:53.34,7,,0.0
2020,11,2948,415,2,5223,2,2,4,11,11,0,11,0,11,0,False,False,False,0,3,2020-11-23T13:38:51.557,11,,0.0
2020,11,2948,420,2,5223,13,2,4,8,0,0,0,0,0,0,False,False,False,0,2,2020-11-23T15:56:56.637,0,,
2020,11,2948,425,2,5223,13,7,2,22,0,0,0,0,0,0,False,False,False,0,2,2020-11-23T13:41:50.997,0,,0.0
2020,11,2948,430,2,4670,2,4,10,3,5,2,3,2,3,0,False,False,False,0,1,2020-11-23T15:57:12.277,5,,
2020,11,2948,435,2,6247,2,32,9,0,8,8,7,1,7,0,False,False,False,0,3,2020-11-23T13:45:06.793,8,,1.0
2020,11,2948,440,2,6240,13,2,10,5,0,0,0,0,0,0,False,False,False,0,2,2020-11-23T13:46:09.897,0,,0.0
2020,11,2948,455,2,5214,13,19,6,47,0,0,0,0,0,0,False,False,False,0,3,2020-11-25T18:26:34.623,0,,0.0
2020,11,2948,480,20,3763,2,4,7,15,15,0,15,0,15,0,False,False,False,0,2,2020-11-23T13:55:32.66,15,,0.0
2020,11,2948,485,20,3763,2,2,9,7,9,2,7,2,7,0,False,False,False,0,2,2020-11-23T13:57:02.863,9,,2.0
2020,11,2948,495,20,306,2,32,9,-5,25,30,22,3,22,0,False,False,False,1,1,2020-11-25T18:28:34.743,25,,3.0
2020,11,2948,510,20,3763,13,2,9,5,0,0,0,0,0,0,False,False,False,0,2,2021-02-25T16:56:29.857,0,,0.0
2020,11,2948,515,20,3763,2,2,10,5,5,0,5,0,5,0,False,False,False,0,2,2020-11-23T16:42:19.61,5,,0.0
2020,11,2948,540,2,6247,2,50,10,-2,4,6,2,2,2,0,True,False,False,0,3,2020-11-24T16:30:23.237,4,,2.0
2020,11,2948,560,20,213,2,8,7,50,57,7,57,0,57,0,False,False,False,0,2,2020-11-23T14:21:50.327,57,,
2020,11,2948,570,20,3763,2,6,7,19,19,0,19,0,19,0,False,False,False,0,2,2020-11-23T14:26:55.647,19,,0.0
2020,11,2948,585,20,213,2,50,3,-3,7,10,2,5,2,0,True,False,False,0,2,2020-11-23T14:29:43.103,7,,5.0
2020,11,2948,605,2,6247,13,29,6,23,0,0,0,0,0,0,False,False,False,0,3,2020-11-24T16:29:06.957,0,,0.0
2020,11,2948,615,20,958,13,29,6,19,0,0,0,0,0,0,False,False,False,0,2,2020-11-23T15:57:52.417,0,,
2020,11,2948,620,20,958,2,29,3,13,16,3,15,1,15,0,False,False,False,0,2,2021-02-25T16:57:34.96,16,,
2020,11,2948,625,20,306,2,48,9,-7,11,18,8,3,8,0,False,False,False,0,1,2020-11-25T19:57:27.917,11,,3.0
2020,11,2948,630,20,213,2,4,9,4,6,2,5,1,5,0,True,False,False,0,3,2020-11-23T14:45:26.98,6,,1.0
2020,11,2948,670,2,6240,2,13,10,4,3,-1,3,0,3,0,True,False,False,0,2,2020-11-24T16:31:03.72,3,,0.0
2020,11,2948,675,2,5223,13,4,10,14,0,0,0,0,0,0,False,False,False,0,3,2020-11-25T19:59:57.213,0,,0.0
2020,11,2948,705,20,213,2,30,4,-2,9,11,9,0,9,0,False,False,False,0,3,2020-11-25T19:01:24.82,9,,0.0
2020,11,2948,725,2,2223,13,5,5,4,0,0,0,0,0,0,False,False,False,0,4,2021-02-19T21:18:03.68,0,,0.0
2020,11,2948,730,2,6247,2,26,5,3,8,5,5,3,5,0,False,False,False,0,3,2020-11-23T15:14:20.593,8,,3.0
2020,11,2948,735,2,6247,13,6,9,10,0,0,0,0,0,0,False,False,False,0,3,2020-11-23T15:19:21.737,0,,0.0
2020,11,2948,740,2,6247,13,5,9,10,0,0,0,0,0,0,False,False,False,0,3,2020-11-23T15:20:43.463,0,,0.0
2020,11,2948,750,2,661,2,6,8,19,22,3,19,3,19,0,False,False,False,0,2,2020-11-25T20:03:34.093,22,,3.0
2020,11,2948,755,2,6247,3,4,7,16,0,0,0,0,0,0,False,False,False,0,3,2020-11-25T20:04:09.073,0,,0.0
2020,11,2948,765,2,5223,13,2,10,6,0,0,0,0,0,0,False,False,False,0,2,2021-03-05T15:23:17.88,0,,0.0
2020,11,2948,850,2,5223,2,9,2,17,18,1,18,0,18,0,False,False,False,0,2,2020-11-23T15:39:41.107,18,,0.0
2020,11,2948,855,2,5223,13,8,8,33,0,0,0,0,0,0,False,False,False,0,3,2021-02-19T21:20:21.377,0,,0.0
2020,11,2948,860,2,6247,3,6,4,6,0,0,0,0,0,0,False,False,False,0,3,2020-11-23T15:49:36.983,0,,0.0
2020,11,2948,865,2,6247,2,13,10,6,9,3,7,2,7,0,True,False,False,0,2,2020-11-23T15:51:03.8,9,,2.0
2020,11,2948,870,2,6240,2,12,9,14,25,11,24,1,24,0,False,False,False,0,3,2021-03-08T20:52:30.953,25,,1.0
2020,11,2949,10,32,7807,2,28,10,-2,10,12,-1,11,-1,0,False,False,False,1,1,2020-11-23T11:59:11.567,10,,11.0
2020,11,2949,15,32,1427,2,46,9,0,0,0,0,0,0,0,False,False,False,0,4,2020-11-23T12:04:09.34,0,,0.0
2020,11,2949,20,32,6430,2,5,3,6,8,2,8,0,8,0,False,False,False,0,3,2020-11-25T22:17:01.243,8,,0.0
2020,11,2949,45,7,6975,2,29,2,16,18,2,16,2,16,0,False,False,False,0,3,2020-11-23T12:20:38.953,18,,2.0
2020,11,2949,50,7,931,2,50,10,-4,9,13,2,7,2,0,False,False,False,0,3,2021-02-19T16:08:57.457,9,,7.0
2020,11,2949,55,7,931,2,47,5,1,5,4,4,1,4,0,False,False,False,0,1,2020-11-25T22:37:18.437,5,,1.0
2020,11,2949,60,7,3521,2,6,4,5,6,1,6,0,6,0,False,False,False,0,3,2020-11-23T12:30:25.163,6,,0.0
2020,11,2949,65,7,7659,2,5,5,6,6,0,6,0,6,0,False,False,False,0,3,2021-02-19T16:09:30.257,6,,0.0
2020,11,2949,70,7,7659,13,17,8,39,0,0,0,0,0,0,False,False,False,0,2,2020-11-25T22:39:20.943,0,,0.0
2020,11,2949,75,7,6383,2,6,10,5,5,0,5,0,5,0,False,False,False,0,2,2020-11-23T12:37:35.92,5,,0.0
2020,11,2949,80,7,3521,2,29,3,12,13,1,13,0,13,0,False,False,False,0,3,2021-02-25T17:00:27.03,13,,0.0
2020,11,2949,85,7,7659,2,51,3,-5,-5,0,-6,1,-6,0,True,False,False,0,4,2021-03-04T19:51:55.79,-5,,1.0
2020,11,2949,90,7,3521,2,4,10,9,11,2,9,2,9,0,False,False,False,0,2,2020-11-25T21:28:41.52,11,,2.0
2020,11,2949,95,7,6383,13,8,1,15,0,0,0,0,0,0,False,False,False,0,3,2020-11-25T21:29:31.743,0,,0.0
2020,11,2949,110,32,7128,2,8,7,40,42,2,40,2,40,0,False,False,False,0,2,2021-02-19T16:09:59.263,42,,2.0
2020,11,2949,115,32,7128,2,51,10,-4,2,6,2,0,2,0,False,False,False,0,2,2020-11-25T22:17:17.537,2,,0.0
2020,11,2949,155,7,910,2,2,9,12,12,0,12,0,12,0,False,False,False,0,2,2020-11-23T18:53:00.32,12,,0.0
2020,11,2949,160,7,3521,2,4,10,4,12,8,4,8,4,0,False,False,False,1,3,2020-11-23T13:13:49.547,12,,8.0
2020,11,2949,165,7,910,2,7,6,19,19,0,19,0,19,0,False,False,False,0,2,2021-03-05T13:31:58.697,19,,0.0
2020,11,2949,170,7,7659,13,8,6,32,0,0,0,0,0,0,False,False,False,0,3,2020-11-23T13:17:49.927,0,,0.0
2020,11,2949,190,7,931,2,13,4,4,8,4,5,3,5,0,True,False,False,0,2,2020-11-25T21:32:21.077,8,,3.0
2020,11,2949,210,7,910,13,2,10,3,0,0,0,0,0,0,False,False,False,0,2,2020-11-23T13:36:13.46,0,,0.0
2020,11,2949,225,32,1427,3,54,10,2,0,0,0,0,0,0,False,False,False,0,4,2020-11-25T22:06:44.14,0,,0.0
2020,11,2949,235,32,7128,13,19,6,37,0,0,0,0,0,0,False,False,False,0,2,2020-11-25T22:44:27.487,0,,0.0
2020,11,2949,245,7,3521,2,26,10,2,9,7,5,4,5,0,False,False,False,0,3,2020-11-23T13:51:41.103,9,,4.0
2020,11,2949,255,7,4455,13,46,9,1,0,0,0,0,0,0,False,False,False,0,1,2021-02-19T16:10:51.933,0,,0.0
2020,11,2949,270,7,7659,2,8,1,21,25,4,22,3,22,0,False,False,False,0,2,2021-02-19T16:11:17.343,25,,3.0
2020,11,2949,280,7,910,2,26,3,4,5,1,4,1,4,6,False,False,False,0,2,2020-11-23T14:08:03.67,5,,1.0
2020,11,2949,295,32,1427,13,35,3,10,0,0,0,0,0,0,False,False,False,0,4,2020-11-23T14:11:47.857,0,,0.0
2020,11,2949,305,32,7494,2,5,5,2,3,1,3,0,3,0,False,False,False,0,3,2020-11-25T22:46:03.07,3,,0.0
2020,11,2949,325,7,931,2,4,5,4,15,11,10,5,10,0,False,False,False,0,3,2020-11-23T14:25:09.637,15,,5.0
2020,11,2949,335,7,3521,2,26,3,3,11,8,9,2,9,0,False,False,False,0,3,2020-11-25T21:37:03.413,11,,2.0
2020,11,2949,345,7,910,13,9,6,23,0,0,0,0,0,0,False,False,False,0,2,2021-03-17T19:47:30.157,0,,
2020,11,2949,360,7,6975,13,6,10,4,0,0,0,0,0,0,False,False,False,0,2,2020-11-25T21:37:55.753,0,,0.0
2020,11,2949,365,7,910,13,6,9,14,0,0,0,0,0,0,False,False,False,0,2,2020-11-23T14:39:21.977,0,,0.0
2020,11,2949,375,7,4455,2,50,10,-1,2,3,0,2,0,0,False,False,False,0,2,2020-11-23T14:41:57.18,2,,2.0
2020,11,2949,395,32,3885,2,18,3,-1,4,5,3,1,3,0,True,False,False,0,2,2020-11-23T14:44:48.267,4,,1.0
2020,11,2949,410,32,3885,2,31,9,2,11,9,11,0,11,0,False,False,False,0,1,2020-11-23T15:12:25.537,11,,0.0
2020,11,2949,415,32,1427,13,39,4,10,0,0,0,0,0,0,False,False,False,0,3,2021-03-05T15:24:53.41,0,,0.0
2020,11,2949,420,7,3521,2,4,10,4,4,0,4,0,4,0,False,False,False,0,3,2020-11-25T21:38:40.787,4,,0.0
2020,11,2949,430,7,910,13,3,8,19,0,0,0,0,0,0,False,False,False,0,2,2020-11-25T22:21:14.347,0,,0.0
2020,11,2949,435,7,3521,2,51,9,0,5,5,2,3,2,0,False,False,False,0,3,2020-11-25T21:17:15.867,5,,3.0
2020,11,2949,460,7,931,3,47,5,1,0,0,0,0,0,0,False,False,False,0,1,2020-11-23T16:15:45.377,0,,0.0
2020,11,2949,465,7,910,13,8,1,20,0,0,0,0,0,0,False,False,False,0,2,2020-11-23T16:17:34.52,0,,0.0
2020,11,2949,480,32,7807,13,47,4,6,0,0,0,0,0,0,False,False,False,0,1,2021-03-08T20:59:05.337,0,,0.0
2020,11,2949,485,32,8237,2,50,10,0,7,7,3,4,3,0,False,False,False,0,2,2020-11-23T16:23:22.217,7,,4.0
2020,11,2949,495,7,4341,2,50,9,0,8,8,3,5,3,0,False,False,False,0,2,2020-11-25T22:17:59.74,8,,5.0
2020,11,2949,500,7,7659,3,2,9,9,0,0,0,0,0,0,False,False,False,0,3,2021-02-19T16:12:19.57,0,,0.0
2020,11,2949,505,7,3521,13,9,2,19,0,0,0,0,0,0,False,False,False,0,3,2021-03-03T13:35:31.49,0,,0.0
2020,11,2949,520,32,7128,2,5,5,14,14,0,14,0,14,0,False,False,False,0,3,2020-11-23T18:47:04.647,14,,0.0
2020,11,2949,535,32,7494,2,13,3,3,3,0,3,0,3,6,False,False,False,0,4,2020-11-25T21:42:40.423,3,,0.0
2020,11,2949,555,7,910,2,18,5,-1,5,6,-1,6,-1,0,False,False,False,1,2,2021-03-04T19:15:24.343,5,,6.0
2020,11,2949,575,32,7128,2,2,9,10,25,15,21,4,21,0,False,False,False,0,2,2021-02-19T16:13:15.053,25,,4.0
2020,11,2949,580,32,8237,13,19,6,29,0,0,0,0,0,0,False,False,False,0,2,2020-11-23T17:06:43.943,0,,
2020,11,2949,590,32,7128,13,2,10,4,0,0,0,0,0,0,False,False,False,0,2,2020-11-23T17:10:41.223,0,,0.0
2020,11,2949,610,7,7659,13,21,2,25,0,0,0,0,0,0,False,False,False,0,3,2020-11-23T17:18:06.287,0,,0.0
2020,11,2949,625,7,6975,3,28,10,0,0,0,0,0,0,0,False,False,False,0,4,2020-11-23T17:22:27.727,0,,0.0
2020,11,2949,635,7,3521,13,3,3,14,0,0,0,0,0,0,True,False,False,0,3,2021-02-19T16:13:43.4,0,,0.0
2020,11,2949,650,32,6430,2,18,5,-1,12,13,10,2,10,0,False,False,False,0,2,2020-11-23T17:30:20.463,12,,2.0
2020,11,2949,670,32,3885,2,45,10,-4,11,15,11,0,11,0,False,True,False,0,1,2020-11-23T19:05:34.1,11,,0.0
2020,11,2949,680,32,7494,2,5,5,5,7,2,7,0,7,0,False,False,False,0,2,2020-11-23T17:41:41.567,7,,0.0
2020,11,2949,695,32,7128,2,50,10,-2,7,9,6,1,6,0,True,False,False,0,2,2020-11-23T18:48:03.43,1,,1.0
2020,11,2949,705,32,1427,2,47,5,1,6,5,2,4,2,0,False,False,False,0,3,2020-11-25T21:18:28.73,6,,4.0
2020,11,2949,710,32,3885,3,48,10,-8,0,0,0,0,0,0,False,False,False,0,1,2020-11-25T21:48:36.85,0,,0.0
2020,11,2949,730,7,6975,2,12,5,11,11,0,11,0,11,0,False,False,False,0,2,2021-03-08T21:00:41.037,11,,0.0
2020,11,2949,785,7,3521,2,5,5,14,14,0,14,0,14,0,False,False,False,0,2,2020-11-23T18:54:50.493,14,,0.0
2020,11,2949,790,7,7659,13,5,5,8,0,0,0,0,0,0,False,False,False,0,3,2020-11-25T22:22:21.453,0,,0.0
2020,11,2949,795,7,910,13,5,5,12,0,0,0,0,0,0,False,False,False,0,2,2020-11-25T21:49:34.01,0,,0.0
2020,11,2949,805,7,7659,13,12,6,22,0,0,0,0,0,0,False,False,False,0,2,2021-03-08T21:01:21.57,0,,0.0
2020,11,2949,845,7,7659,13,9,2,18,0,0,0,0,0,0,False,False,False,0,2,2021-03-05T15:25:24.427,0,,0.0
2020,8,2950,20,10,7700,2,13,9,4,4,0,4,0,4,0,False,False,False,0,3,2020-11-06T18:40:13.89,4,,
2020,8,2950,40,26,7453,13,8,1,34,0,0,0,0,0,0,False,False,False,0,3,2020-11-02T11:39:55.643,0,,
2020,8,2950,55,10,7700,13,35,2,21,0,0,0,0,0,0,False,False,False,0,3,2020-11-02T11:48:54.56,0,,
2020,8,2950,60,10,7701,2,6,9,5,5,0,5,0,5,0,False,False,False,0,3,2020-11-02T11:50:51.483,5,,
2020,8,2950,75,26,309,2,30,10,-2,3,5,2,1,2,0,False,False,False,0,3,2020-11-02T11:54:47.103,3,,
2020,8,2950,85,26,309,2,5,5,4,6,2,4,2,4,0,False,False,False,0,3,2020-11-02T11:58:56.54,6,,
2020,8,2950,90,26,4619,2,4,10,4,4,0,4,0,4,0,False,False,False,0,3,2020-11-02T12:01:23.503,4,,
2020,8,2950,100,26,4619,13,6,10,7,0,0,0,0,0,0,False,False,False,0,2,2020-11-02T12:06:58.747,0,,
2020,8,2950,105,26,6301,13,48,5,-6,0,0,0,0,0,0,False,False,False,0,1,2020-11-02T12:09:07.47,0,,
2020,8,2950,130,10,6840,2,53,10,-6,3,9,3,0,3,0,False,False,False,0,4,2020-11-02T12:17:54.603,3,,
2020,8,2950,145,26,4282,2,53,9,-5,8,13,5,3,5,0,False,False,False,0,4,2020-11-03T23:34:09.89,8,,
2020,8,2950,150,26,309,2,3,5,7,6,-1,6,0,6,0,False,False,False,0,2,2020-11-06T18:40:13.89,6,,
2020,8,2950,160,26,309,13,7,6,26,0,0,0,0,0,0,False,False,False,0,2,2020-11-02T12:34:53.523,0,,
2020,8,2950,170,26,4619,2,6,8,18,19,1,18,1,18,0,True,False,False,0,2,2020-11-03T23:43:20.093,19,,
2020,8,2950,180,26,309,2,51,10,-3,4,7,0,4,0,0,False,False,False,0,3,2021-03-04T19:04:24.513,4,,
2020,8,2950,205,10,6840,2,4,9,4,4,0,4,0,4,0,False,False,False,0,4,2020-11-02T12:59:47.89,4,,
2020,8,2950,210,10,7700,2,2,9,9,11,2,9,2,9,0,False,False,False,0,2,2020-11-06T18:40:13.89,11,,
2020,8,2950,225,10,282,2,4,9,2,4,2,1,3,1,0,False,False,False,1,1,2020-11-02T13:11:38.847,4,,
2020,8,2950,240,26,4282,2,5,10,5,7,2,6,1,6,0,False,False,False,0,4,2020-11-02T13:17:12.48,7,,
2020,8,2950,245,26,6301,2,2,10,1,4,3,4,0,4,0,False,False,False,0,2,2020-11-03T23:43:57.647,4,,
2020,8,2950,255,26,3653,3,51,10,-7,0,0,0,0,0,0,True,False,False,0,1,2020-11-06T18:40:13.89,0,,
2020,8,2950,260,26,309,13,13,9,4,0,0,0,0,0,0,False,False,False,0,3,2021-02-17T16:53:53.493,0,,
2020,8,2950,270,10,282,13,46,3,0,0,0,0,0,0,0,False,False,False,0,1,2020-11-06T19:53:34.863,0,,
2020,8,2950,275,10,6840,2,4,9,5,12,7,9,3,9,0,False,False,False,0,4,2020-11-02T13:46:04.277,12,,
2020,8,2950,285,10,7700,13,19,6,28,0,0,0,0,0,0,False,False,False,0,2,2020-11-02T13:47:57.797,0,,
2020,8,2950,290,10,6285,2,4,10,5,12,7,9,3,9,0,False,False,False,0,2,2020-11-02T13:53:23.563,12,,
2020,8,2950,300,10,6840,2,31,10,2,9,7,7,2,7,0,False,False,False,0,4,2020-11-02T13:55:21.483,9,,
2020,8,2950,310,26,3653,2,45,10,-5,7,12,1,6,1,0,False,False,False,1,1,2020-11-06T19:54:18.32,7,,
2020,8,2950,320,26,309,2,4,5,7,7,0,7,0,7,0,False,False,False,0,2,2020-11-02T14:03:39.363,7,,
2020,8,2950,330,26,6301,2,28,9,5,34,29,15,19,15,0,False,False,False,1,1,2020-11-02T14:16:38.18,34,,
2020,8,2950,335,26,309,2,35,10,13,22,9,19,3,19,0,False,False,False,0,3,2021-02-17T16:54:47.49,22,,
2020,8,2950,340,26,7695,2,34,4,-4,-7,-3,-6,-1,-6,0,True,False,False,0,2,2020-11-02T14:23:56.107,-7,,
2020,8,2950,350,26,3653,2,16,9,2,6,4,4,2,4,0,False,False,False,0,1,2020-11-02T19:06:46.967,6,,
2020,8,2950,360,26,309,2,20,4,9,9,0,9,0,9,6,False,False,False,0,3,2020-11-02T14:29:38.277,9,,
2020,8,2950,375,10,6840,2,4,10,5,6,1,6,0,6,0,False,False,False,0,4,2020-11-02T14:33:56.89,6,,
2020,8,2950,380,10,6481,13,47,5,0,0,0,0,0,0,0,False,False,False,0,1,2020-11-02T14:36:28.777,0,,
2020,8,2950,385,10,7700,13,4,5,6,0,0,0,0,0,0,False,False,False,0,2,2020-11-02T19:05:14.26,0,,
2020,8,2950,415,26,3653,2,16,4,0,11,11,8,3,8,0,False,False,False,0,1,2020-11-02T14:48:10.787,11,,
2020,8,2950,425,26,3653,2,46,3,0,1,1,1,0,1,0,False,False,False,0,1,2021-02-17T16:56:51.11,1,,
2020,8,2950,435,26,4619,2,29,6,33,36,3,36,0,36,0,False,False,False,0,2,2020-11-02T14:51:39.913,36,,
2020,8,2950,440,26,8177,2,12,5,2,2,0,2,0,2,6,False,False,False,0,1,2020-11-02T14:54:58.42,2,,
2020,8,2950,490,26,3653,2,28,9,1,3,2,2,1,2,0,False,False,False,0,1,2020-11-02T15:17:42.573,3,,
2020,8,2950,515,26,4619,2,9,2,24,24,0,24,0,24,6,False,False,False,0,2,2020-11-02T15:26:54.39,24,,
2020,8,2950,540,10,6481,13,32,9,-4,0,0,0,0,0,0,False,False,False,0,1,2020-11-06T20:00:33.63,0,,
2020,8,2950,555,26,309,13,4,10,4,0,0,0,0,0,0,False,False,False,0,2,2020-11-02T15:42:28.197,0,,
2020,8,2950,575,26,4619,13,5,5,14,0,0,0,0,0,0,False,False,False,0,3,2020-11-06T19:46:08.853,0,,
2020,8,2950,580,26,7453,13,19,2,34,0,0,0,0,0,0,False,False,False,0,2,2020-11-02T15:51:01.533,0,,
2020,8,2950,600,10,6840,13,17,8,20,0,0,0,0,0,0,False,False,False,0,4,2020-11-02T15:57:33.487,0,,
2020,8,2950,605,10,6285,2,6,4,14,18,4,18,0,18,0,False,False,False,0,3,2020-11-06T18:40:13.89,18,,
2020,8,2950,610,10,7700,13,2,9,12,0,0,0,0,0,0,False,False,False,0,2,2020-11-06T18:40:13.89,0,,
2020,8,2950,635,26,309,2,4,4,6,5,-1,5,0,5,0,False,False,False,0,3,2020-11-02T16:39:20.32,5,,
2020,8,2950,640,26,6301,13,11,2,15,0,0,0,0,0,0,False,False,False,0,1,2021-02-17T17:00:09.857,0,,
2020,8,2950,645,26,3653,3,45,5,-7,0,0,0,0,0,0,False,False,False,0,1,2020-11-02T16:19:53.593,0,,
2020,8,2950,650,26,7453,2,32,5,0,3,3,3,0,3,0,False,False,False,0,3,2020-11-02T16:22:43.727,3,,
2020,8,2950,665,10,7700,13,24,2,32,0,0,0,0,0,0,True,False,False,0,3,2021-03-05T14:26:21.75,0,,
2020,8,2950,680,26,4619,13,9,2,19,0,0,0,0,0,0,False,False,False,0,3,2020-11-02T16:35:47.4,0,,
2020,8,2950,685,10,7700,2,4,7,15,15,0,15,0,15,0,False,False,False,0,2,2020-11-03T21:50:59.91,15,,
2020,8,2950,695,10,282,2,44,3,-3,2,5,-3,5,-3,0,False,False,False,2,1,2020-11-02T16:49:02.24,2,,
2020,8,2950,710,10,7700,13,12,5,10,0,0,0,0,0,0,False,False,False,0,2,2020-11-02T16:52:07.653,0,,
2020,8,2950,715,10,7700,2,6,8,21,43,22,38,5,38,0,False,False,False,0,2,2020-11-02T16:53:58.327,43,,
2020,8,2950,725,10,6840,2,39,10,7,7,0,7,0,7,0,False,False,False,0,4,2020-11-02T16:58:34.95,7,,
2020,8,2950,735,10,6285,2,4,4,4,10,6,8,2,8,0,False,False,False,0,3,2020-11-02T17:03:17.533,10,,
2020,8,2950,740,10,7703,2,17,9,9,9,0,9,0,9,6,False,False,False,0,4,2020-11-06T20:02:27.66,9,,
2020,8,2950,760,26,4619,2,12,6,15,16,1,15,1,15,0,False,False,False,0,2,2021-03-08T22:05:09.167,16,,
2020,8,2950,790,26,4619,13,9,2,24,0,0,0,0,0,0,False,False,False,0,2,2021-03-17T19:14:21.92,0,,
2020,8,2950,810,10,6285,2,8,1,17,40,23,40,0,40,6,False,False,False,0,3,2020-11-06T18:40:13.89,40,,
2020,8,2950,825,26,4282,2,32,10,-1,5,6,2,3,2,0,True,False,False,1,4,2020-11-06T20:05:06.253,5,,
2020,8,2950,835,26,309,2,4,3,5,5,0,5,0,5,0,False,False,False,0,2,2020-11-02T18:12:35.563,5,,
2020,8,2950,850,26,6301,2,48,9,-6,15,21,7,8,7,0,False,False,False,1,1,2020-11-02T18:17:15.603,15,,
2020,8,2950,880,26,4282,2,4,9,7,13,6,6,7,6,0,False,False,False,2,3,2020-11-06T19:47:15.347,13,,
2020,8,2950,900,10,282,2,47,5,1,6,5,3,3,3,0,False,False,False,0,1,2020-11-02T18:29:23.397,6,,
2020,8,2950,920,10,282,2,47,5,1,2,1,2,0,2,0,False,False,False,0,1,2020-11-02T18:34:35.907,2,,
2020,8,2950,925,10,6840,13,29,2,25,0,0,0,0,0,0,True,False,False,0,4,2020-11-06T18:40:13.89,0,,
2020,8,2950,930,10,7703,13,4,9,4,0,0,0,0,0,0,False,False,False,0,2,2020-11-02T18:37:59.507,0,,
2020,8,2950,935,10,7701,2,13,9,4,7,3,6,1,6,0,False,False,False,0,3,2020-11-02T18:40:08.093,7,,
2020,8,2950,940,10,6285,2,12,10,4,14,10,8,6,8,0,False,False,False,0,2,2020-11-06T19:46:30.36,14,,
2020,8,2950,945,10,6481,2,47,5,2,3,1,3,0,3,0,False,False,False,0,1,2020-11-02T18:43:07.163,3,,
2020,8,2950,950,10,282,2,47,5,2,2,0,2,0,2,0,False,False,False,0,1,2020-11-02T18:45:23.027,2,,
2020,8,2950,955,10,282,2,47,5,4,5,1,4,1,4,0,False,False,False,0,1,2021-02-26T19:14:54.687,5,,
2020,8,2950,965,10,6840,2,4,10,4,6,2,4,2,4,0,True,False,False,0,4,2020-11-02T18:55:03.347,6,,
2020,8,2950,975,10,6285,13,7,2,18,0,0,0,0,0,0,False,False,False,0,3,2021-02-17T17:01:57.773,0,,
2020,8,2950,985,10,7703,13,7,2,18,0,0,0,0,0,0,False,False,False,0,3,2021-02-25T15:41:56.85,0,,
2020,8,2950,990,10,7701,2,30,5,1,1,0,1,0,1,6,False,False,False,0,4,2020-11-06T20:11:00.383,1,,
2020,11,2951,20,9,7816,13,39,9,7,0,0,0,0,0,0,False,False,False,0,3,2020-11-27T17:52:17.03,0,,0.0
2020,11,2951,40,18,813,2,4,10,5,10,5,7,3,7,0,False,False,False,0,4,2020-11-27T17:41:13.51,10,,3.0
2020,11,2951,60,9,7816,2,7,2,16,21,5,17,4,17,0,False,False,False,0,3,2020-11-23T11:31:20.553,21,,4.0
2020,11,2951,65,9,4202,2,51,5,-2,6,8,5,1,5,6,False,False,False,0,3,2020-11-27T18:37:11.027,6,,1.0
2020,11,2951,80,18,1381,2,35,2,17,28,11,25,3,25,0,False,False,False,0,3,2020-11-27T17:56:12.347,28,,3.0
2020,11,2951,110,18,6907,2,6,9,6,12,6,10,2,10,0,False,False,False,0,2,2020-11-23T12:01:18.973,12,,2.0
2020,11,2951,115,18,6907,2,4,9,6,11,5,8,3,8,0,False,False,False,0,4,2020-11-27T17:41:26.823,11,,3.0
2020,11,2951,130,18,1381,2,2,9,7,8,1,8,0,8,0,False,False,False,0,3,2020-11-27T16:14:20.603,8,,0.0
2020,11,2951,165,9,322,13,4,5,13,0,0,0,0,0,0,False,False,False,0,2,2020-11-27T16:14:20.603,0,,0.0
2020,11,2951,200,9,6446,2,5,10,4,4,0,4,0,4,0,False,False,False,0,3,2020-11-27T18:37:24.563,4,,0.0
2020,11,2951,210,9,322,2,2,9,8,14,6,9,5,9,0,False,False,False,0,2,2021-02-19T21:09:08.963,14,,5.0
2020,11,2951,215,9,6446,13,2,9,11,0,0,0,0,0,0,False,False,False,0,4,2020-11-27T16:14:20.603,0,,0.0
2020,11,2951,220,18,7711,2,9,6,25,27,2,25,2,25,0,False,False,False,0,2,2020-11-23T12:57:36.443,27,,2.0
2020,11,2951,240,18,4572,2,48,9,-2,4,6,3,1,3,0,False,False,False,0,1,2020-11-23T13:06:48.977,4,,1.0
2020,11,2951,245,18,6889,2,19,2,17,33,16,23,10,23,0,False,False,False,0,2,2020-11-23T17:36:25.09,33,,
2020,11,2951,290,9,6436,2,35,10,13,19,6,17,2,17,0,False,False,False,0,4,2020-11-27T18:37:35.283,19,,2.0
2020,11,2951,300,9,7816,2,9,3,4,4,0,4,0,4,6,False,False,False,0,3,2021-02-25T17:02:51.627,4,,0.0
2020,11,2951,315,18,6907,13,32,5,-1,0,0,0,0,0,0,False,False,False,0,4,2021-02-19T21:10:10.273,0,,0.0
2020,11,2951,325,18,1381,2,6,10,5,11,6,10,1,10,0,False,False,False,0,2,2021-02-25T17:03:47.263,11,,1.0
2020,11,2951,330,18,7711,13,21,2,20,0,0,0,0,0,0,False,False,False,0,2,2020-11-23T13:58:57.427,0,,0.0
2020,11,2951,340,9,7816,13,2,10,6,0,0,0,0,0,0,True,False,False,0,3,2020-11-27T17:10:28.32,0,,
2020,11,2951,345,9,2568,2,5,3,13,13,0,13,0,13,0,False,False,False,0,4,2020-11-23T14:08:05.84,13,,0.0
2020,11,2951,350,9,7816,2,51,3,-6,3,9,2,1,2,0,True,False,False,0,3,2020-11-27T18:36:10.34,3,,1.0
2020,11,2951,355,9,4446,2,6,10,4,6,2,4,2,4,0,False,False,False,0,3,2020-11-27T16:14:20.603,6,,2.0
2020,11,2951,365,9,6436,3,9,2,23,0,0,0,0,0,0,False,False,False,0,3,2020-11-23T14:16:58.147,0,,0.0
2020,11,2951,370,9,6441,3,5,3,4,0,0,0,0,0,0,True,False,False,0,3,2020-11-27T18:37:51.283,0,,0.0
2020,11,2951,375,18,4572,2,48,9,-4,26,30,26,0,26,0,False,False,False,0,1,2020-11-23T14:23:38.98,26,,0.0
2020,11,2951,385,18,4572,2,16,9,5,7,2,7,0,7,0,False,True,True,0,1,2020-11-23T14:30:36.72,3,,0.0
2020,11,2951,390,9,322,2,4,3,4,5,1,5,0,5,0,False,False,False,0,2,2020-11-23T14:32:47.123,5,,0.0
2020,11,2951,395,9,322,2,2,9,6,10,4,7,3,7,0,False,False,False,0,2,2020-11-23T14:34:11.947,10,,3.0
2020,11,2951,400,9,322,2,7,6,23,32,9,26,6,26,0,False,False,False,0,2,2020-11-23T14:36:31.887,32,,6.0
2020,11,2951,415,9,7816,13,9,5,1,0,0,0,0,0,0,False,False,False,0,3,2021-02-25T17:04:37.97,0,,0.0
2020,11,2951,450,18,1381,2,35,6,27,51,24,50,1,50,0,False,False,False,0,3,2020-11-23T14:49:34.47,51,,1.0
2020,11,2951,455,18,813,2,32,5,0,6,6,5,1,5,0,False,False,False,0,4,2020-11-23T14:51:58.64,6,,1.0
2020,11,2951,480,18,1381,2,9,5,2,2,0,2,0,2,6,False,False,False,0,2,2020-11-23T14:58:56.99,2,,0.0
2020,11,2951,500,9,322,2,2,9,5,10,5,6,4,6,0,False,False,False,0,2,2020-11-23T15:03:50.653,10,,4.0
2020,11,2951,515,9,6436,3,6,9,5,0,0,0,0,0,0,False,False,False,0,2,2020-11-23T15:08:15.973,0,,0.0
2020,11,2951,520,9,7816,2,51,3,0,6,6,6,0,6,0,False,False,False,0,3,2020-11-27T17:10:39.65,6,,0.0
2020,11,2951,535,18,4572,2,46,3,0,8,8,8,0,8,0,False,False,False,0,1,2020-11-23T17:25:11.79,8,,0.0
2020,11,2951,545,18,6897,2,5,5,4,13,9,7,6,7,0,False,False,False,0,3,2020-11-23T17:38:20.17,9,,6.0
2020,11,2951,550,18,7711,2,5,6,20,20,0,20,0,20,0,False,False,False,0,3,2020-11-23T15:25:48.893,20,,0.0
2020,11,2951,565,18,1381,2,5,5,5,7,2,7,0,7,0,False,False,False,0,3,2020-11-27T18:26:59.157,7,,0.0
2020,11,2951,590,18,1381,2,5,5,3,3,0,3,0,3,6,True,False,False,0,3,2020-11-23T15:37:26.17,3,,0.0
2020,11,2951,605,9,6446,2,6,10,5,9,4,6,3,6,0,False,False,False,0,4,2020-11-23T15:40:59.797,9,,3.0
2020,11,2951,650,18,1381,2,4,10,9,13,4,13,0,13,0,False,False,False,0,2,2020-11-23T15:54:47.35,13,,0.0
2020,11,2951,660,18,7711,2,22,6,38,39,1,39,0,39,6,False,False,False,0,3,2020-11-23T15:59:34.957,39,,0.0
2020,11,2951,700,9,6441,2,6,10,5,7,2,6,1,6,0,False,False,False,0,2,2020-11-23T16:12:37.583,7,,1.0
2020,11,2951,705,9,924,2,12,10,-6,-3,3,-6,3,-6,0,False,False,False,0,6,2021-02-19T21:11:03.247,-3,,3.0
2020,11,2951,715,18,813,2,32,3,0,12,12,11,1,11,0,False,False,False,0,4,2020-11-23T16:19:14.597,12,,1.0
2020,11,2951,730,18,1381,13,5,3,13,0,0,0,0,0,0,False,False,False,0,3,2020-11-23T16:25:05.773,0,,0.0
2020,11,2951,740,9,6436,2,5,5,8,10,2,10,0,10,0,False,False,False,0,3,2020-11-27T18:38:04.763,10,,0.0
2020,11,2951,750,9,6436,13,8,7,20,0,0,0,0,0,0,False,False,False,0,2,2020-11-27T18:38:15.403,0,,0.0
2020,11,2951,770,9,322,2,5,3,10,10,0,10,0,10,0,False,False,False,0,3,2020-11-23T16:37:36.447,10,,0.0
2020,11,2951,780,9,4202,2,46,3,1,5,4,4,1,4,0,False,False,False,0,1,2020-11-23T16:39:22.863,5,,1.0
2020,11,2951,785,9,6446,2,2,9,6,10,4,7,3,7,0,False,False,False,0,3,2020-11-23T16:41:31.727,10,,3.0
2020,11,2951,795,9,6446,13,2,10,4,0,0,0,0,0,0,False,False,False,0,2,2021-02-19T21:12:25.9,0,,0.0
2020,11,2951,810,9,6446,2,13,9,2,2,0,2,0,2,6,False,False,False,0,4,2020-11-27T18:32:19.053,2,,0.0
2020,11,2951,825,18,4572,2,18,3,-1,4,5,4,0,4,0,True,False,False,0,2,2020-11-24T15:02:00.027,4,,0.0
2020,11,2951,830,18,7711,3,42,10,3,0,0,0,0,0,0,False,False,False,0,3,2020-11-23T16:58:36.173,0,,0.0
2020,11,2951,835,18,1381,13,5,5,8,0,0,0,0,0,0,False,False,False,0,3,2020-11-23T17:01:20.483,0,,0.0
2020,11,2951,840,18,1381,13,12,8,33,0,0,0,0,0,0,False,False,False,0,2,2020-11-23T17:04:36.343,0,,0.0
2020,11,2952,20,23,2994,2,9,6,22,26,4,23,3,23,0,True,False,False,0,4,2020-11-24T16:34:25.81,26,,3.0
2020,11,2952,30,23,2256,2,35,6,19,29,10,26,3,26,0,False,False,False,1,3,2020-11-23T11:28:06.377,29,,3.0
2020,11,2952,55,16,7681,2,55,10,-5,8,13,7,1,7,0,False,False,False,0,1,2020-11-23T11:42:01.673,8,,1.0
2020,11,2952,60,16,6500,2,2,4,7,10,3,10,0,10,0,False,False,False,0,3,2020-11-23T11:45:46.27,10,,0.0
2020,11,2952,75,16,3938,2,35,10,14,14,0,14,0,14,0,False,False,False,0,2,2020-11-23T12:01:58.56,14,,0.0
2020,11,2952,80,16,3938,2,2,9,4,6,2,4,2,4,0,False,False,False,0,3,2020-11-23T12:01:47.517,6,,2.0
2020,11,2952,90,16,374,3,32,3,2,0,0,0,0,0,0,False,False,False,0,4,2021-02-19T20:56:35.737,0,,0.0
2020,11,2952,95,16,3938,2,47,5,2,6,4,6,0,6,0,False,False,False,0,3,2020-11-23T12:11:37.707,6,,0.0
2020,11,2952,100,16,3938,2,4,5,4,8,4,8,0,8,0,True,False,False,0,2,2020-11-25T21:06:35.58,8,,0.0
2020,11,2952,115,16,6500,2,55,4,-3,4,7,-2,6,-2,0,False,False,False,2,4,2021-01-29T14:34:48.993,4,,6.0
2020,11,2952,125,16,3938,2,30,3,-2,3,5,3,0,3,6,False,False,False,0,3,2020-11-23T12:35:43.89,3,,0.0
2020,11,2952,145,23,7250,2,8,4,11,16,5,13,3,13,0,False,False,False,0,3,2020-11-25T21:17:02.473,16,,3.0
2020,11,2952,160,23,2994,2,45,5,-2,7,9,1,6,1,0,True,False,False,1,4,2021-02-19T20:57:29.49,7,,6.0
2020,11,2952,165,23,7240,2,32,10,0,11,11,10,1,10,0,False,False,False,0,1,2020-11-23T12:50:03.027,11,,1.0
2020,11,2952,170,23,2256,2,9,6,17,17,0,17,0,17,6,False,False,False,0,2,2020-11-23T12:52:18.887,17,,0.0
2020,11,2952,190,16,7681,3,4,9,4,0,0,0,0,0,0,True,False,False,0,2,2020-11-23T12:56:02.287,0,,0.0
2020,11,2952,200,16,4143,2,6,7,17,17,0,17,0,17,0,False,False,False,0,2,2020-11-25T18:57:57.317,17,,0.0
2020,11,2952,215,16,374,2,7,6,17,21,4,19,2,19,0,True,False,False,0,4,2020-11-23T13:06:21.757,21,,2.0
2020,11,2952,220,16,4143,13,29,6,16,0,0,0,0,0,0,False,False,False,0,3,2020-11-25T21:38:58.953,0,,
2020,11,2952,225,16,6500,13,6,4,6,0,0,0,0,0,0,False,False,False,0,3,2020-11-23T13:13:07.187,0,,
2020,11,2952,230,16,374,13,24,6,21,0,0,0,0,0,0,False,False,False,0,3,2021-03-01T21:54:54.92,0,,
2020,11,2952,235,16,3938,13,35,3,3,0,0,0,0,0,0,False,False,False,0,3,2021-02-19T20:58:16.213,0,,0.0
2020,11,2952,255,23,4949,2,32,10,0,18,18,11,7,11,0,False,False,False,1,3,2020-11-23T13:32:03.097,18,,7.0
2020,11,2952,270,23,116,2,44,9,-4,14,18,2,12,2,0,True,False,False,2,4,2021-02-19T20:58:50.877,14,,12.0
2020,11,2952,280,23,2994,2,46,9,0,11,11,4,7,4,0,False,False,False,1,4,2021-03-03T17:39:27.12,11,,7.0
2020,11,2952,290,23,2256,2,42,9,7,11,4,9,2,9,0,False,False,False,0,3,2020-11-23T13:54:58.84,11,,2.0
2020,11,2952,300,23,2256,2,34,4,-4,4,8,2,2,2,0,True,False,False,0,3,2020-11-23T13:59:09.267,4,,2.0
2020,11,2952,305,23,7689,13,9,5,1,0,0,0,0,0,0,False,False,False,0,3,2020-11-23T14:01:23.607,0,,0.0
2020,11,2952,325,16,4143,2,4,9,3,0,-3,1,-1,1,0,False,False,False,0,3,2020-11-23T18:34:58.313,0,,
2020,11,2952,340,16,4143,13,12,8,22,0,0,0,0,0,0,False,False,False,0,2,2020-11-23T14:14:59.447,0,,0.0
2020,11,2952,350,23,7689,2,13,9,1,1,0,1,0,1,0,False,False,False,0,3,2020-11-23T14:18:04.847,1,,0.0
2020,11,2952,360,23,2994,2,12,3,5,18,13,5,13,5,0,False,False,False,1,4,2021-02-25T17:07:20.897,18,,13.0
2020,11,2952,370,23,2256,3,5,9,12,0,0,0,0,0,0,True,False,False,0,3,2020-11-24T16:35:15.463,0,,0.0
2020,11,2952,385,16,6499,2,46,3,0,11,11,11,0,11,0,True,False,False,0,1,2020-11-24T20:32:02.45,11,,0.0
2020,11,2952,390,16,6499,2,44,9,-5,8,13,8,0,8,0,False,False,False,0,1,2021-02-19T20:59:49.747,8,,0.0
2020,11,2952,395,16,6500,2,5,3,3,3,0,3,0,3,0,False,False,False,0,3,2020-11-23T14:37:52.89,3,,0.0
2020,11,2952,400,16,374,2,2,9,7,19,12,7,12,7,0,False,False,False,1,2,2020-11-23T14:40:09.037,19,,12.0
2020,11,2952,415,16,3938,13,3,5,12,0,0,0,0,0,0,False,False,False,0,4,2020-11-25T21:39:44.813,0,,0.0
2020,11,2952,425,16,3938,13,4,3,8,0,0,0,0,0,0,False,False,False,0,3,2021-02-19T21:01:30.003,0,,
2020,11,2952,430,16,374,2,12,10,11,11,0,11,0,11,0,False,False,False,0,3,2020-11-25T21:25:52.463,11,,0.0
2020,11,2952,440,16,4143,13,4,10,11,0,0,0,0,0,0,False,False,False,0,3,2021-03-05T15:26:58.463,0,,0.0
2020,11,2952,465,16,4143,2,4,10,5,6,1,5,1,5,0,False,False,False,0,2,2020-11-25T18:57:57.317,6,,1.0
2020,11,2952,470,16,4143,2,26,3,4,3,-1,3,0,3,0,False,False,False,0,2,2020-11-23T15:12:47.587,3,,0.0
2020,11,2952,475,16,3938,2,51,10,-2,9,11,9,0,9,0,False,False,False,0,3,2020-11-23T15:14:50.797,9,,0.0
2020,11,2952,495,16,374,2,4,10,3,8,5,3,5,3,0,False,False,False,1,3,2020-11-23T15:32:11.197,8,,5.0
2020,11,2952,505,16,34,2,46,3,1,11,10,6,5,6,0,False,False,False,1,1,2020-11-23T15:36:59.157,11,,5.0
2020,11,2952,515,16,374,2,12,3,12,12,0,12,0,12,0,False,False,False,0,4,2020-11-23T15:41:09.44,12,,0.0
2020,11,2952,525,16,3938,2,47,5,6,13,7,13,0,13,0,True,False,False,0,3,2020-11-23T15:45:28.247,13,,0.0
2020,11,2952,530,16,374,13,8,4,14,0,0,0,0,0,0,False,False,False,0,3,2020-11-23T18:40:53.787,0,,0.0
2020,11,2952,560,23,2994,2,2,10,6,16,10,14,2,14,0,False,False,False,0,3,2020-11-23T16:05:56.093,16,,2.0
2020,11,2952,565,23,2256,2,4,3,3,7,4,5,2,5,0,False,False,False,1,2,2020-11-25T21:27:14.383,7,,2.0
2020,11,2952,570,23,7241,2,4,9,3,9,6,6,3,6,0,False,False,False,0,1,2020-11-25T21:28:50.913,9,,3.0
2020,11,2952,585,23,3957,2,28,10,0,3,3,0,3,0,0,False,False,False,1,1,2020-11-25T21:07:38.85,3,,3.0
2020,11,2952,590,23,7250,2,6,4,10,21,11,14,7,14,0,False,False,False,0,3,2020-11-25T21:29:21.703,21,,7.0
2020,11,2952,605,23,2994,2,35,9,3,3,0,3,0,3,6,False,False,False,0,4,2020-11-23T16:25:19.637,3,,0.0
2020,11,2952,625,16,4143,2,4,9,3,3,0,3,0,3,0,False,False,False,0,3,2020-11-25T18:57:57.317,3,,0.0
2020,11,2952,635,16,6500,13,12,2,22,0,0,0,0,0,0,True,False,False,0,2,2020-11-23T16:51:02.59,0,,0.0
2020,11,2952,655,23,2256,3,21,2,35,0,0,0,0,0,0,False,False,False,0,2,2021-02-19T21:02:19.433,0,,0.0
2020,11,2952,665,16,3938,13,19,6,27,0,0,0,0,0,0,False,False,False,0,2,2020-11-23T16:48:17.087,0,,0.0
2020,11,2952,670,16,7182,2,46,3,5,5,0,5,0,5,0,False,False,False,0,4,2021-02-19T21:02:45.803,5,,0.0
2020,11,2952,675,16,3938,2,5,5,6,15,9,15,0,15,0,False,False,False,0,3,2020-11-23T16:56:55.57,15,,0.0
2020,11,2952,685,16,4143,2,5,5,6,6,0,6,0,6,0,False,False,False,0,2,2020-11-23T18:41:10.33,6,,0.0
2020,11,2952,700,16,4143,2,13,4,3,9,6,4,5,4,0,False,False,False,0,3,2020-11-25T18:57:57.317,9,,5.0
2020,11,2952,710,16,374,2,12,2,16,19,3,19,0,19,0,False,False,False,0,3,2021-02-19T21:05:30.313,19,,0.0
2020,11,2952,720,16,3938,2,5,3,9,9,0,9,0,9,0,True,False,False,0,3,2020-11-23T17:15:48.557,9,,0.0
2020,11,2952,750,23,7240,3,12,6,18,0,0,0,0,0,0,False,False,False,0,4,2020-11-23T17:25:59.153,0,,0.0
2020,11,2952,755,23,2256,2,7,9,14,20,6,19,1,19,0,False,False,False,0,2,2020-11-23T17:28:49.69,20,,1.0
2020,11,2952,765,23,7688,2,45,5,-1,5,6,2,3,2,0,True,False,False,1,3,2021-02-19T21:06:05.497,5,,3.0
2020,11,2952,780,23,7240,3,47,5,0,0,0,0,0,0,0,False,False,False,0,1,2020-11-23T17:45:24.833,0,,0.0
2020,11,2952,790,23,2256,13,17,8,23,0,0,0,0,0,0,False,False,False,0,3,2020-11-25T18:57:57.317,0,,
2020,11,2952,815,23,2994,2,47,5,0,7,7,5,2,5,0,True,False,False,0,4,2020-11-24T16:35:40.23,7,,2.0
2020,11,2952,825,23,596,2,12,5,1,1,0,1,0,1,6,False,False,False,0,4,2020-11-23T18:02:10.92,1,,0.0
2020,11,2952,840,16,3938,2,39,4,9,10,1,9,1,9,0,False,False,False,1,3,2020-11-23T18:05:22.887,10,,1.0
2020,11,2952,850,16,3938,2,5,3,10,9,-1,9,0,9,0,True,False,False,0,2,2020-11-25T18:57:57.317,9,,0.0
2020,11,2952,855,16,7176,2,35,10,11,16,5,13,3,13,0,False,False,False,0,3,2020-11-23T18:10:27.54,16,,3.0
2020,11,2952,860,16,374,2,8,1,15,15,0,15,0,15,0,False,False,False,0,3,2020-11-23T18:41:47.903,15,,0.0
2020,11,2952,865,16,6499,2,46,3,-1,3,4,3,0,3,0,False,False,False,0,1,2020-11-24T20:29:13.723,3,,0.0
2020,11,2952,875,16,374,2,12,1,22,22,0,22,0,22,6,False,False,False,0,3,2021-03-08T21:17:35.227,22,,0.0
2020,11,2952,890,23,2256,13,19,6,32,0,0,0,0,0,0,False,False,False,0,3,2021-03-05T15:27:33.497,0,,0.0
2020,11,2953,15,30,37,2,5,9,6,6,0,6,0,6,0,True,False,False,0,3,2020-11-25T08:00:41.34,6,,0.0
2020,11,2953,20,30,37,2,2,9,7,7,0,7,0,7,0,False,False,False,0,3,2020-11-24T11:37:22.92,7,,0.0
2020,11,2953,35,30,793,13,5,3,4,0,0,0,0,0,0,False,False,False,0,3,2020-11-24T11:41:44.057,0,,0.0
2020,11,2953,45,29,4866,2,42,9,5,5,0,5,0,5,0,False,False,False,0,3,2021-02-19T15:59:07.833,5,,0.0
2020,11,2953,55,29,4850,2,30,9,-2,6,8,6,0,6,0,False,False,False,0,4,2020-11-24T11:48:12.153,6,,0.0
2020,11,2953,65,29,4866,2,39,9,4,8,4,7,1,7,0,False,False,False,0,3,2020-11-24T12:17:41.25,8,,1.0
2020,11,2953,70,29,4866,2,4,9,5,5,0,5,0,5,0,False,False,False,0,4,2020-11-24T11:52:29.52,5,,0.0
2020,11,2953,80,29,4866,2,6,4,14,37,23,14,23,14,0,False,False,False,3,2,2021-03-09T20:14:38.507,37,,23.0
2020,11,2953,90,29,4866,2,47,5,4,7,3,6,1,6,0,False,False,False,0,3,2020-11-24T12:00:59.943,7,,1.0
2020,11,2953,105,29,4875,13,3,5,4,0,0,0,0,0,0,False,False,False,0,2,2021-02-19T16:05:34.83,0,,0.0
2020,11,2953,110,29,1958,2,12,5,4,4,0,4,0,4,6,False,False,False,0,2,2021-02-25T17:23:57.083,4,,0.0
2020,11,2953,125,30,6414,3,48,9,-3,0,0,0,0,0,0,False,False,False,0,1,2020-11-24T12:08:26.053,0,,0.0
2020,11,2953,130,30,63,13,46,3,3,0,0,0,0,0,0,False,False,False,0,4,2020-11-24T12:10:56.377,0,,0.0
2020,11,2953,135,30,793,13,9,6,30,0,0,0,0,0,0,False,False,False,0,3,2020-11-24T12:13:05.183,0,,
2020,11,2953,140,30,4516,2,51,5,-1,6,7,4,2,4,0,False,False,False,0,3,2020-11-24T16:55:47.457,6,,2.0
2020,11,2953,150,30,4516,2,4,9,7,7,0,7,0,7,0,False,False,False,0,3,2020-11-24T16:56:07.13,7,,0.0
2020,11,2953,160,30,63,2,7,3,14,16,2,14,2,14,0,False,False,False,0,4,2020-11-24T12:22:00.733,16,,2.0
2020,11,2953,175,30,793,2,18,3,-1,4,5,4,0,4,0,False,False,False,0,2,2020-11-24T12:25:45.34,4,,0.0
2020,11,2953,180,30,793,2,5,5,1,9,8,2,7,2,6,False,False,False,2,3,2020-11-24T12:27:22.747,9,,7.0
2020,11,2953,195,29,1958,2,51,3,-8,-1,7,-7,6,-7,0,True,False,False,1,4,2020-11-24T12:43:00.41,-1,,6.0
2020,11,2953,200,29,4875,2,50,5,0,6,6,4,2,4,0,False,False,False,0,2,2020-11-24T12:44:08.123,6,,2.0
2020,11,2953,205,29,1958,2,5,5,3,3,0,3,0,3,0,False,False,False,0,2,2020-11-27T12:45:36.447,3,,0.0
2020,11,2953,215,30,4937,3,5,10,3,0,0,0,0,0,0,False,False,False,0,1,2020-11-24T12:47:45.387,0,,0.0
2020,11,2953,220,30,4516,2,49,10,-3,4,7,3,1,3,0,False,False,False,0,3,2020-11-24T12:49:53.197,4,,1.0
2020,11,2953,225,30,2290,2,5,5,6,7,1,7,0,7,0,False,False,False,0,3,2020-11-24T12:50:57.5,7,,0.0
2020,11,2953,235,30,63,13,36,7,15,0,0,0,0,0,0,False,False,False,0,4,2020-11-24T12:54:43.047,0,,0.0
2020,11,2953,240,30,2290,2,5,3,8,9,1,9,0,9,0,False,False,False,0,3,2020-11-24T12:55:46.923,9,,0.0
2020,11,2953,245,30,793,13,19,6,42,0,0,0,0,0,0,False,False,False,0,2,2020-11-24T12:57:20.887,0,,0.0
2020,11,2953,250,30,37,2,50,5,0,2,2,2,0,2,0,False,False,False,0,2,2021-03-04T19:53:42.353,2,,0.0
2020,11,2953,255,30,7268,13,17,7,25,0,0,0,0,0,0,False,False,False,0,3,2020-11-24T13:01:28.173,0,,
2020,11,2953,265,30,793,2,5,6,15,18,3,15,3,15,0,False,False,False,0,2,2020-11-24T13:04:52.113,18,,3.0
2020,11,2953,285,29,4866,2,5,10,5,8,3,5,3,5,0,False,False,False,1,3,2020-11-24T13:08:54.85,8,,3.0
2020,11,2953,295,29,1958,2,8,7,16,19,3,17,2,17,0,False,False,False,0,2,2020-11-24T13:12:07.91,19,,2.0
2020,11,2953,300,29,3398,2,4,10,4,7,3,4,3,4,0,False,False,False,1,3,2020-11-24T13:13:03.83,7,,3.0
2020,11,2953,305,29,4866,2,5,3,3,24,21,20,4,20,0,False,False,False,1,3,2020-11-24T13:14:15.417,24,,4.0
2020,11,2953,310,29,4866,13,31,9,-3,0,0,0,0,0,0,False,False,False,0,4,2020-11-24T13:16:40.46,0,,0.0
2020,11,2953,315,29,4866,2,50,3,0,6,6,3,3,3,0,False,False,False,0,2,2020-11-24T13:18:25.91,6,,3.0
2020,11,2953,325,29,7828,2,2,9,5,7,2,7,0,7,6,False,False,False,0,2,2020-11-24T13:20:30.797,7,,0.0
2020,11,2953,345,30,37,2,29,5,12,12,0,12,0,12,0,False,False,False,0,2,2020-11-24T13:24:29.167,12,,0.0
2020,11,2953,350,30,37,2,5,5,6,4,-2,4,0,4,0,False,False,False,0,3,2020-11-24T13:25:58.6,4,,0.0
2020,11,2953,360,30,37,2,4,4,7,7,0,7,0,7,0,False,False,False,0,3,2020-11-24T13:28:25.233,7,,0.0
2020,11,2953,370,30,793,13,19,2,45,0,0,0,0,0,0,False,False,False,0,2,2020-11-24T13:29:44.027,0,,0.0
2020,11,2953,375,30,4516,2,50,10,-3,1,4,-1,2,-1,0,False,False,False,0,3,2020-11-24T17:01:36.957,1,,2.0
2020,11,2953,380,30,4516,13,4,9,10,0,0,0,0,0,0,True,False,False,0,3,2020-11-24T13:32:20.93,0,,0.0
2020,11,2953,390,29,3398,2,5,5,4,5,1,4,1,4,0,True,False,False,0,3,2020-11-27T12:46:30.647,5,,1.0
2020,11,2953,395,29,4866,2,4,9,5,9,4,9,0,9,0,False,False,False,1,3,2020-11-24T13:36:19.77,9,,0.0
2020,11,2953,400,29,4866,13,32,3,-4,0,0,0,0,0,0,False,False,False,0,4,2020-11-25T18:01:31.5,0,,0.0
2020,11,2953,405,29,3356,2,4,9,2,8,6,8,0,8,0,False,False,False,0,1,2020-11-24T13:39:02.343,8,,0.0
2020,11,2953,415,29,4850,2,50,3,1,4,3,1,3,1,0,False,False,False,0,2,2020-11-24T13:40:29.77,4,,3.0
2020,11,2953,425,29,1958,2,50,5,0,35,35,33,2,33,0,False,False,False,1,2,2020-11-27T12:47:22.887,35,,2.0
2020,11,2953,445,29,4850,2,26,10,-1,-1,0,-1,0,-1,0,False,False,False,0,4,2020-11-27T11:41:31.687,-1,,0.0
2020,11,2953,450,29,1958,2,4,10,6,12,6,8,4,8,0,False,False,False,0,3,2020-11-24T13:54:45.957,12,,4.0
2020,11,2953,455,29,7378,13,48,9,1,0,0,0,0,0,0,False,False,False,0,1,2021-03-05T15:30:01.697,0,,0.0
2020,11,2953,465,30,63,13,11,6,15,0,0,0,0,0,0,True,False,False,0,3,2020-11-24T14:00:10.933,0,,0.0
2020,11,2953,470,30,4937,3,44,3,-4,0,0,0,0,0,0,False,False,False,0,1,2020-11-24T14:01:11.677,0,,0.0
2020,11,2953,490,29,1958,2,39,4,5,6,1,6,0,6,0,False,False,False,0,3,2020-11-24T14:08:04.81,6,,0.0
2020,11,2953,495,29,4875,2,26,9,4,8,4,6,2,6,0,False,False,False,1,3,2020-11-27T12:51:02.71,8,,2.0
2020,11,2953,500,29,1958,2,12,6,15,16,1,16,0,16,0,False,False,False,0,3,2020-11-24T14:12:34.617,16,,0.0
2020,11,2953,510,29,3398,2,30,3,1,2,1,2,0,2,0,False,False,False,0,4,2020-11-24T14:15:10.223,2,,0.0
2020,11,2953,515,29,1958,2,4,9,5,7,2,7,0,7,0,False,False,False,0,3,2020-11-24T14:16:26.187,7,,0.0
2020,11,2953,530,30,37,2,49,3,-1,10,11,10,0,10,0,False,False,False,0,2,2020-11-24T14:24:18.77,10,,0.0
2020,11,2953,535,30,4516,13,19,8,30,0,0,0,0,0,0,True,False,False,0,2,2020-11-24T14:31:39.837,0,,0.0
2020,11,2953,550,29,4850,2,16,10,10,18,8,14,4,14,0,False,False,False,1,3,2020-11-27T13:03:08.443,18,,4.0
2020,11,2953,555,29,4875,2,6,9,12,18,6,16,2,16,0,False,False,False,0,3,2020-11-24T14:36:21.637,18,,2.0
2020,11,2953,560,29,4850,3,47,5,1,0,0,0,0,0,0,False,False,False,0,3,2020-11-24T14:37:26.267,0,,0.0
2020,11,2953,565,29,7788,2,44,3,2,4,2,4,0,4,6,False,False,False,0,1,2021-02-25T17:25:52.15,4,,0.0
2020,11,2953,585,30,37,13,4,3,9,0,0,0,0,0,0,False,False,False,0,2,2020-11-24T14:45:03.25,0,,0.0
2020,11,2953,590,30,37,3,19,6,40,0,0,0,0,0,0,False,False,False,0,2,2020-11-24T14:47:07.33,0,,0.0
2020,11,2953,605,29,7378,2,48,9,-5,5,10,-3,8,-3,0,False,False,False,2,1,2020-11-24T14:55:53.82,5,,8.0
2020,11,2953,610,29,4866,2,5,5,7,17,10,15,2,15,0,False,False,False,1,2,2020-11-27T13:03:33.067,17,,2.0
2020,11,2953,615,29,3398,2,47,5,2,5,3,5,0,5,0,False,False,False,0,3,2020-11-27T13:03:46.563,5,,0.0
2020,11,2953,620,29,4875,13,21,7,46,0,0,0,0,0,0,False,False,False,0,2,2020-11-24T15:02:12.257,0,,0.0
2020,11,2953,630,29,1958,2,50,9,-3,-3,0,-3,0,-3,0,False,False,False,0,3,2020-11-24T15:03:58.18,-3,,0.0
2020,11,2953,650,30,793,13,4,7,15,0,0,0,0,0,0,False,False,False,0,2,2020-11-25T15:09:42.44,0,,0.0
2020,11,2953,670,29,1958,13,26,10,4,0,0,0,0,0,0,False,False,False,0,3,2020-11-24T15:19:11.42,0,,0.0
2020,11,2953,675,29,1958,13,50,3,-2,0,0,0,0,0,0,False,False,False,0,2,2020-11-24T15:20:14.123,0,,0.0
2020,11,2953,685,30,63,2,4,9,5,9,4,7,2,7,0,False,False,False,0,4,2020-11-24T15:26:31.047,9,,2.0
2020,11,2953,695,30,37,13,4,3,8,0,0,0,0,0,0,False,False,False,0,2,2020-11-25T08:00:26.147,0,,0.0
2020,11,2953,700,30,4937,3,44,3,-4,0,0,0,0,0,0,False,False,False,0,1,2020-11-24T15:32:29.27,0,,0.0
2020,11,2953,705,30,793,2,4,9,8,8,0,8,0,8,0,False,False,False,0,2,2021-03-08T14:59:47.4,8,,0.0
2020,11,2953,720,29,7378,2,45,5,-2,-1,1,-1,0,-1,0,False,False,False,0,1,2020-11-24T15:48:49.6,-1,,0.0
2020,11,2953,735,30,4937,2,48,5,-5,9,14,7,2,7,0,False,False,False,0,1,2020-11-24T15:51:46.407,9,,2.0
2020,11,2953,750,30,63,13,4,10,5,0,0,0,0,0,0,False,False,False,0,3,2020-11-24T15:54:56.23,0,,0.0
2020,11,2953,755,30,37,2,50,3,0,9,9,6,3,6,0,False,False,False,0,2,2020-11-24T15:56:24.707,9,,3.0
2020,11,2953,760,30,4516,3,47,5,1,0,0,0,0,0,0,True,False,False,0,4,2020-11-24T15:58:22.837,0,,0.0
2020,11,2953,775,29,1958,13,6,10,9,0,0,0,0,0,0,False,False,False,0,2,2021-03-05T15:30:24.53,0,,0.0
2020,11,2953,780,30,37,13,9,6,24,0,0,0,0,0,0,False,False,False,0,3,2020-11-24T16:08:15.017,0,,0.0
2020,11,2953,785,30,4516,2,39,4,6,10,4,8,2,8,0,False,False,False,0,4,2020-11-24T16:09:40.113,10,,2.0
2020,11,2953,805,30,793,2,3,3,11,10,-1,10,0,10,0,False,False,False,0,2,2020-11-24T16:15:04.537,10,,0.0
2020,11,2953,810,30,4516,2,5,5,5,13,8,10,3,10,6,False,False,False,0,3,2020-11-27T12:40:48.807,13,,3.0
2020,11,2953,825,29,1958,2,35,9,11,23,12,21,2,21,0,False,False,False,0,3,2020-11-24T16:18:57.747,23,,2.0
2020,11,2953,830,29,4875,13,2,9,11,0,0,0,0,0,0,False,False,False,0,3,2020-11-24T16:20:16.777,0,,0.0
2020,11,2953,835,29,1958,2,2,9,4,9,5,6,3,6,0,True,False,False,0,3,2020-11-24T16:22:01.417,9,,3.0
2020,11,2953,840,29,4866,2,7,2,17,19,2,19,0,19,0,False,False,False,0,2,2020-11-24T17:02:15.463,19,,0.0
2020,11,2953,880,30,2290,2,4,10,6,7,1,7,0,7,0,False,False,False,0,3,2020-11-24T16:32:30.847,7,,0.0
2020,11,2953,885,30,4516,2,35,10,11,12,1,12,0,12,0,False,False,False,0,3,2020-11-24T16:38:20.59,12,,0.0
2020,11,2953,895,30,37,13,5,3,7,0,0,0,0,0,0,False,False,False,0,2,2020-11-24T16:37:04.943,0,,0.0
2020,11,2953,900,30,2290,13,17,8,31,0,0,0,0,0,0,False,False,False,0,3,2021-03-05T15:30:52.63,0,,0.0
2020,12,2954,15,13,6529,3,8,2,39,0,0,0,0,0,0,False,False,False,0,3,2021-02-22T16:22:54.223,0,,0.0
2020,12,2954,20,13,3951,2,6,4,10,10,0,10,0,10,0,False,False,False,0,2,2020-11-27T11:02:38.15,10,,0.0
2020,12,2954,25,13,876,2,4,10,5,11,6,9,2,9,0,False,False,False,0,2,2020-11-27T17:55:28.34,11,,2.0
2020,12,2954,30,13,6880,13,4,4,7,0,-7,0,0,0,0,False,False,False,0,3,2021-02-22T16:25:13.933,0,,0.0
2020,12,2954,60,11,6810,2,38,10,3,10,7,10,0,10,0,False,False,False,0,4,2021-02-22T17:34:25.793,10,,0.0
2020,12,2954,65,11,6341,2,44,3,5,6,1,6,0,6,0,False,False,False,0,1,2021-03-08T21:26:17.57,6,,0.0
2020,12,2954,70,11,6810,2,33,8,23,51,28,48,3,48,0,True,False,False,0,4,2020-11-28T19:17:59.91,51,,3.0
2020,12,2954,75,11,914,13,35,8,20,0,0,0,0,0,0,False,False,False,0,3,2020-11-28T19:15:17.427,0,,
2020,12,2954,115,13,404,13,50,9,-4,0,0,0,0,0,0,True,False,False,0,2,2021-03-04T19:57:56.337,0,,0.0
2020,12,2954,120,13,3951,13,12,5,7,0,0,0,0,0,0,False,False,False,0,2,2020-12-03T15:21:08.623,0,,0.0
2020,12,2954,130,11,6629,13,46,9,-6,0,0,0,0,0,0,False,False,False,0,1,2021-03-05T14:41:56.39,0,,0.0
2020,12,2954,150,13,404,2,44,3,5,14,9,7,7,7,0,False,False,False,0,1,2021-03-08T21:26:30.58,14,,7.0
2020,12,2954,155,13,404,13,11,6,21,0,0,0,0,0,0,False,False,False,0,1,2020-11-27T12:45:43.793,0,,
2020,12,2954,165,13,3652,2,47,5,2,2,0,0,2,0,6,False,False,False,0,1,2020-12-03T15:21:51.213,2,,2.0
2020,12,2954,190,11,6810,2,53,10,-4,17,21,15,2,15,0,True,False,False,0,4,2020-11-28T19:18:09.433,17,,2.0
2020,12,2954,195,11,7733,2,2,8,16,16,0,16,0,16,0,False,False,False,0,3,2020-11-27T12:59:37.07,16,,0.0
2020,12,2954,220,11,6341,2,47,5,6,14,8,12,2,12,0,False,False,False,0,1,2020-11-27T13:09:04.67,14,,2.0
2020,12,2954,255,13,3951,13,7,6,17,0,0,0,0,0,0,False,False,False,0,3,2020-11-27T17:22:00.423,0,,
2020,12,2954,280,13,3951,2,12,6,23,23,0,0,23,0,6,False,False,False,0,2,2020-11-27T13:36:56.617,23,,
2020,12,2954,285,13,404,2,20,6,28,33,5,0,33,0,6,False,False,False,0,2,2020-12-03T15:24:04.593,33,,33.0
2020,12,2954,305,11,914,2,6,4,12,12,0,12,0,12,0,False,False,False,0,3,2020-11-27T13:44:20.54,12,,0.0
2020,12,2954,320,11,6341,2,28,3,0,12,12,0,12,0,0,False,False,False,1,1,2020-12-03T15:09:02.327,12,,12.0
2020,12,2954,335,11,4487,13,13,10,0,0,0,0,0,0,0,True,False,False,0,2,2020-12-03T15:06:16.887,0,,0.0
2020,12,2954,345,13,3951,2,2,10,12,12,0,12,0,12,0,False,False,False,0,3,2020-12-03T15:26:31.36,12,,0.0
2020,12,2954,355,13,3951,2,2,4,11,37,26,37,0,37,0,False,False,False,0,3,2020-12-03T15:26:58.083,37,,0.0
2020,12,2954,370,13,876,2,12,7,27,27,0,0,27,0,0,False,False,False,0,3,2021-03-08T21:24:46.683,27,,27.0
2020,12,2954,380,13,3951,2,12,9,2,4,2,2,2,2,0,False,False,False,0,2,2020-12-03T15:03:40.843,4,,
2020,12,2954,390,13,404,2,48,10,-8,-4,4,-5,1,-5,0,False,False,False,0,1,2021-02-22T17:41:29.49,-4,,1.0
2020,12,2954,395,13,6528,13,9,6,23,0,0,0,0,0,0,False,False,False,0,3,2020-12-03T13:48:39.183,0,,0.0
2020,12,2954,415,11,914,13,5,10,10,0,0,0,0,0,0,False,False,False,0,3,2020-11-27T14:24:49.187,0,,0.0
2020,12,2954,420,11,3820,13,17,8,51,0,0,0,0,0,0,False,False,False,0,3,2020-12-03T15:28:04.933,0,,
2020,12,2954,425,11,6341,2,48,3,-3,20,23,20,0,20,0,False,False,False,0,1,2020-12-03T15:28:15.907,20,,0.0
2020,12,2954,430,11,914,13,5,3,13,0,0,0,0,0,0,False,False,False,0,2,2020-11-27T14:42:56.76,0,,0.0
2020,12,2954,435,11,6810,2,4,10,1,2,1,1,1,1,0,False,False,False,0,3,2021-02-22T17:44:18.11,2,,1.0
2020,12,2954,520,11,557,13,11,9,14,0,0,0,0,0,0,False,False,False,0,6,2020-12-03T15:08:14.56,0,,0.0
2020,12,2954,525,11,914,2,5,5,5,6,1,5,1,5,0,True,False,False,0,2,2020-12-03T15:06:53.583,6,,1.0
2020,12,2954,530,11,914,13,6,4,14,0,0,0,0,0,0,False,False,False,0,3,2020-11-27T15:12:11.247,0,,0.0
2020,12,2954,545,13,876,2,4,5,10,10,0,10,0,10,0,False,False,False,0,2,2020-12-03T15:37:10.253,10,,0.0
2020,12,2954,555,13,3951,2,7,8,16,38,22,29,9,29,0,False,False,False,0,3,2021-02-22T17:46:55.857,38,,9.0
2020,12,2954,565,13,6529,2,30,5,3,8,5,3,5,3,0,False,False,False,1,4,2020-12-03T15:07:08.47,8,,5.0
2020,12,2954,580,13,6528,3,6,9,8,0,0,0,0,0,0,False,False,False,0,2,2020-12-03T15:49:52.643,0,,0.0
2020,12,2954,595,11,914,2,49,10,-4,3,7,1,2,1,0,True,False,False,0,3,2021-02-22T17:48:22.947,3,,2.0
2020,12,2954,605,11,3820,2,4,5,6,7,1,6,1,6,0,False,False,False,0,2,2020-11-27T15:40:59.79,7,,1.0
2020,12,2954,620,11,914,13,22,7,43,0,0,0,0,0,0,False,False,False,0,2,2021-03-08T21:26:48.897,0,,0.0
2020,12,2954,635,13,876,2,4,9,6,19,13,16,3,16,0,False,False,False,0,3,2020-11-27T15:48:44.74,19,,3.0
2020,12,2954,640,13,876,2,6,10,14,18,4,16,2,16,0,False,False,False,0,3,2020-12-03T13:48:39.183,18,,2.0
2020,12,2954,645,13,6529,2,4,10,9,9,0,9,0,9,0,False,False,False,0,3,2020-11-27T15:52:29.157,9,,0.0
2020,12,2954,665,13,3951,2,19,6,40,40,0,0,40,0,6,False,False,False,0,2,2021-01-12T23:46:35.973,40,,40.0
2020,12,2954,685,11,6810,3,47,10,2,0,0,0,0,0,0,False,False,False,0,4,2020-12-03T15:45:27.757,0,,0.0
2020,12,2954,690,11,6810,2,5,3,3,9,6,5,4,5,0,True,False,False,0,3,2020-12-03T15:07:38.577,9,,4.0
2020,12,2954,695,11,917,2,13,4,3,21,18,16,5,16,0,False,False,False,0,3,2020-11-27T17:36:56.65,21,,
2020,12,2954,700,11,2714,2,32,5,2,10,8,9,1,9,0,True,False,False,1,4,2020-12-03T15:10:13.407,10,,1.0
2020,12,2954,710,13,3951,2,19,6,19,34,15,33,1,33,6,True,False,False,0,3,2021-02-22T17:51:54.553,34,,1.0
2020,12,2954,725,11,3634,2,44,3,-3,4,7,2,2,2,0,False,False,False,0,1,2020-12-03T15:05:02.363,4,,2.0
2020,12,2954,730,11,3634,2,18,3,0,2,2,1,1,1,0,False,False,False,0,2,2020-11-27T16:14:37.61,2,,1.0
2020,12,2954,735,11,6810,13,4,4,11,0,0,0,0,0,0,False,False,False,0,3,2020-11-27T16:16:13.987,0,,0.0
2020,12,2954,740,11,917,2,42,10,5,5,0,5,0,5,0,False,False,False,0,3,2020-11-27T16:17:47.503,5,,0.0
2020,12,2954,745,11,3634,2,28,4,1,10,9,7,3,7,0,False,False,False,0,1,2020-11-27T16:21:27.593,10,,3.0
2020,12,2954,750,11,3820,2,6,9,9,9,0,9,0,9,0,False,False,False,0,2,2020-11-27T17:32:34.72,9,,0.0
2020,12,2954,755,11,3820,3,5,5,4,0,0,0,0,0,0,False,False,False,0,2,2020-12-03T15:45:58.863,0,,0.0
2020,12,2954,760,11,914,2,49,10,-1,4,5,3,1,3,0,False,False,False,0,3,2020-12-03T15:11:50.46,4,,1.0
2020,12,2954,765,11,914,13,19,2,39,0,0,0,0,0,0,False,False,False,0,2,2020-11-27T17:48:01.743,0,,0.0
2020,12,2954,770,11,7733,2,4,5,10,11,1,11,0,11,0,False,False,False,0,2,2020-11-27T16:28:58.99,11,,0.0
2020,12,2954,775,11,914,2,6,8,16,16,0,16,0,16,0,False,False,False,0,2,2020-11-27T16:30:34.113,16,,0.0
2020,12,2954,780,11,917,2,35,10,14,14,0,14,0,14,6,False,False,False,0,3,2020-12-03T16:04:52.607,14,,0.0
2020,12,2954,825,11,914,2,39,4,4,7,3,7,0,7,0,False,False,False,0,3,2020-11-27T16:45:09.167,7,,0.0
2020,12,2954,830,11,3820,13,8,6,19,0,0,0,0,0,0,False,False,False,0,2,2020-12-03T15:04:17.237,0,,0.0
2020,12,2954,835,11,917,2,4,9,7,7,0,7,0,7,0,False,False,False,0,3,2020-11-27T16:48:25.847,7,,0.0
2020,12,2954,840,11,917,2,39,4,4,6,2,6,0,6,0,False,False,False,0,3,2020-11-27T16:50:04.997,6,,0.0
2020,12,2954,845,11,3634,2,28,9,0,5,5,4,1,4,0,False,False,False,0,1,2020-11-27T16:51:36.21,5,,1.0
2020,12,2954,850,11,6810,13,6,9,11,0,0,0,0,0,0,False,False,False,0,3,2020-11-27T16:53:16.837,0,,0.0
2020,12,2954,880,11,914,13,6,1,20,0,0,0,0,0,0,False,False,False,0,2,2021-02-22T17:55:07.117,0,,0.0
2020,12,2955,15,32,7807,2,46,3,-1,-1,0,-1,0,-1,0,True,False,False,0,1,2020-11-28T13:29:23.88,-1,,0.0
2020,12,2955,30,9,6446,2,5,5,5,5,0,5,0,5,0,False,False,False,0,3,2020-11-27T11:19:22.193,5,,0.0
2020,12,2955,50,9,4202,3,4,4,4,0,0,0,0,0,0,False,False,False,0,1,2020-11-27T11:26:25.42,0,,0.0
2020,12,2955,60,9,322,2,22,8,16,25,9,23,2,23,0,False,False,False,0,3,2020-12-03T16:54:23.77,25,,2.0
2020,12,2955,70,9,6446,2,53,10,-3,3,6,3,0,3,0,False,False,False,0,4,2020-11-27T11:36:45.127,3,,0.0
2020,12,2955,75,9,322,13,17,7,15,0,0,0,0,0,0,False,False,False,0,3,2020-12-03T16:54:23.77,0,,0.0
2020,12,2955,90,32,7807,2,46,3,-1,7,8,5,2,5,0,False,False,False,1,1,2020-12-03T18:50:44.733,7,,2.0
2020,12,2955,105,32,7128,2,35,2,28,28,0,28,0,28,0,False,False,False,0,3,2020-11-27T12:01:17.513,28,,0.0
2020,12,2955,110,32,7128,13,7,6,21,0,0,0,0,0,0,False,False,False,0,3,2021-02-22T15:38:47.33,0,,0.0
2020,12,2955,120,32,6430,13,21,8,28,0,0,0,0,0,0,False,False,False,0,3,2020-12-03T18:48:44.783,0,,
2020,12,2955,125,32,7807,2,5,3,4,4,0,4,0,4,0,False,False,False,0,1,2020-11-27T17:27:50.49,4,,0.0
2020,12,2955,135,32,7128,13,12,8,17,0,0,0,0,0,0,False,False,False,0,3,2020-12-03T18:48:57.03,0,,
2020,12,2955,140,32,1427,2,32,5,4,6,2,6,0,6,0,False,False,False,0,4,2020-12-03T18:50:58.58,6,,0.0
2020,12,2955,155,32,1427,2,5,5,3,4,1,3,1,3,0,True,False,False,0,4,2020-11-28T13:29:35.27,4,,1.0
2020,12,2955,175,9,322,2,5,5,10,10,0,10,0,10,0,False,False,False,0,3,2020-11-27T12:35:20.763,10,,0.0
2020,12,2955,185,9,4202,2,2,10,6,7,1,7,0,7,0,True,False,False,0,2,2020-11-28T16:57:52.123,7,,0.0
2020,12,2955,200,9,322,2,19,2,37,54,17,54,0,54,6,False,False,False,0,2,2020-12-03T16:54:23.77,54,,0.0
2020,12,2955,220,32,7807,2,46,9,0,6,6,5,1,5,0,False,False,False,0,1,2021-02-22T15:39:38.743,6,,1.0
2020,12,2955,240,32,3885,2,26,10,0,9,9,9,0,9,0,False,False,False,0,3,2020-11-27T13:00:04.43,9,,0.0
2020,12,2955,245,32,7128,2,42,4,4,8,4,8,0,8,0,False,False,False,1,3,2020-11-28T12:43:55.33,8,,0.0
2020,12,2955,260,32,7807,2,45,5,-3,5,8,1,4,1,0,False,False,False,1,1,2021-02-22T15:43:05.467,5,,4.0
2020,12,2955,270,32,7807,3,44,3,-3,0,0,0,0,0,0,False,False,False,0,1,2020-11-27T13:17:30.853,0,,0.0
2020,12,2955,275,32,1427,2,39,4,5,5,0,5,0,5,0,False,False,False,0,4,2020-11-27T13:19:12.63,5,,0.0
2020,12,2955,295,9,6436,2,4,5,7,7,0,7,0,7,0,False,False,False,0,2,2020-11-27T13:24:48.117,7,,0.0
2020,12,2955,305,9,7816,2,34,4,-4,0,4,0,0,0,0,True,False,False,0,3,2020-11-28T16:59:01.177,0,,0.0
2020,12,2955,310,9,7816,13,4,5,7,0,0,0,0,0,0,False,False,False,0,2,2021-11-16T18:57:11.923,0,,0.0
2020,12,2955,325,32,3885,2,45,10,-4,12,16,12,0,12,0,False,False,False,1,1,2020-11-27T13:37:24.083,12,,0.0
2020,12,2955,335,32,1427,2,4,9,5,5,0,5,0,5,6,False,False,False,0,3,2020-11-27T13:40:37.643,5,,0.0
2020,12,2955,350,9,7816,2,6,4,8,9,1,9,0,9,0,True,False,False,0,3,2020-12-03T18:53:29.707,9,,0.0
2020,12,2955,355,9,6446,2,39,4,7,7,0,7,0,7,0,False,False,False,0,3,2020-11-27T13:49:35.643,7,,0.0
2020,12,2955,365,9,322,2,6,9,6,9,3,9,0,9,0,False,False,False,0,2,2020-11-27T13:51:37.507,9,,0.0
2020,12,2955,375,9,6436,2,12,5,9,9,0,9,0,9,0,False,False,False,0,2,2020-12-03T18:53:43.91,9,,0.0
2020,12,2955,390,9,322,13,19,2,41,0,0,0,0,0,0,False,False,False,0,2,2020-12-03T19:23:12.43,0,,
2020,12,2955,395,9,6436,2,49,9,-3,1,4,1,0,1,0,False,False,False,0,2,2021-03-04T18:35:40.747,1,,0.0
2020,12,2955,400,9,6436,2,13,9,3,4,1,4,0,4,0,False,False,False,0,3,2020-11-27T14:06:00.613,4,,0.0
2020,12,2955,410,9,6436,2,50,3,-1,1,2,0,1,0,0,False,False,False,0,2,2020-11-27T14:07:41.697,1,,1.0
2020,12,2955,460,32,7128,2,2,9,9,9,0,9,0,9,0,False,False,False,0,2,2021-02-22T15:45:06.353,9,,0.0
2020,12,2955,475,32,1791,2,4,10,7,15,8,12,3,12,0,False,False,False,0,2,2020-11-27T14:29:16.56,15,,3.0
2020,12,2955,505,9,6436,2,8,8,17,19,2,17,2,17,0,False,False,False,0,3,2020-12-03T18:51:15.5,19,,2.0
2020,12,2955,515,9,6436,3,4,3,9,0,0,0,0,0,0,False,False,False,0,2,2021-02-22T15:46:36.167,0,,0.0
2020,12,2955,535,32,7128,2,4,3,9,9,0,9,0,9,0,False,False,False,0,2,2020-11-27T14:54:41.14,9,,0.0
2020,12,2955,545,32,7128,2,6,6,19,20,1,20,0,20,0,False,False,False,0,3,2020-11-27T14:58:41.03,20,,0.0
2020,12,2955,555,32,7494,2,5,3,8,8,0,8,0,8,0,False,False,False,0,3,2020-11-27T15:02:58.77,8,,0.0
2020,12,2955,570,32,7807,13,4,10,5,0,0,0,0,0,0,False,False,False,0,2,2020-12-03T18:49:25.94,0,,0.0
2020,12,2955,575,32,7128,13,13,3,-3,0,0,0,0,0,0,False,False,False,0,3,2021-03-05T14:54:06.913,0,,0.0
2020,12,2955,590,9,7816,3,4,9,10,0,0,0,0,0,0,False,False,False,0,3,2020-11-27T15:33:01.907,0,,0.0
2020,12,2955,620,32,7128,2,50,5,-1,10,11,8,2,8,0,False,False,False,0,2,2020-11-27T15:42:44.3,10,,2.0
2020,12,2955,640,9,6446,2,46,3,3,3,0,3,0,3,0,False,False,False,0,4,2020-11-27T15:51:24.18,3,,0.0
2020,12,2955,650,9,322,13,19,2,24,0,0,0,0,0,0,False,False,False,0,2,2020-12-03T16:54:41.157,0,,0.0
2020,12,2955,655,9,322,2,4,10,6,7,1,7,0,7,0,False,False,False,0,3,2020-12-03T18:50:11.137,7,,0.0
2020,12,2955,690,9,7816,2,4,10,7,7,0,7,0,7,0,False,False,False,0,3,2020-11-27T16:14:19.307,7,,0.0
2020,12,2955,695,9,4202,13,28,9,3,0,0,0,0,0,0,False,False,False,0,1,2020-11-27T16:16:59.117,0,,
2020,12,2955,700,9,322,2,6,9,5,7,2,7,0,7,0,False,False,False,0,3,2020-12-03T18:55:00.973,7,,0.0
2020,12,2955,705,9,7816,2,51,10,0,2,2,2,0,2,0,False,False,False,0,3,2020-11-27T16:22:37.997,2,,0.0
2020,12,2955,710,9,6436,13,4,5,10,0,0,0,0,0,0,False,False,False,0,2,2020-12-03T18:49:40.827,0,,0.0
2020,12,2955,725,32,7128,2,2,10,8,8,0,8,0,8,0,False,False,False,0,2,2020-11-27T16:30:51.493,8,,0.0
2020,12,2955,785,9,4202,13,45,5,-10,0,0,0,0,0,0,False,False,False,0,1,2021-03-05T14:55:35.99,0,,0.0
2020,12,2955,800,9,6446,2,51,10,1,6,5,4,2,4,0,False,False,False,0,3,2020-12-03T18:50:25.15,6,,2.0
2020,12,2955,805,9,7183,2,4,4,4,4,0,4,0,4,0,False,False,False,0,1,2020-11-27T17:31:39.473,4,,0.0
2020,12,2955,810,9,7183,2,4,4,5,6,1,6,0,6,0,False,False,False,0,1,2020-11-27T16:57:08.74,6,,0.0
2020,12,2955,825,9,7816,2,13,4,3,3,0,3,0,3,0,True,False,False,0,3,2020-11-28T17:00:38.593,3,,0.0
2020,12,2956,10,3,6936,2,51,3,-4,5,9,3,2,3,0,True,False,False,0,3,2021-02-22T17:00:12.853,5,,2.0
2020,12,2956,20,3,6918,2,44,3,-3,-1,2,-2,1,-2,0,True,False,False,0,1,2020-12-03T18:16:25.723,-1,,1.0
2020,12,2956,35,25,7666,13,29,2,29,0,0,0,0,0,0,True,False,False,0,3,2020-12-05T12:37:11.127,0,,0.0
2020,12,2956,40,25,609,13,6,4,10,0,0,0,0,0,0,True,False,False,0,3,2021-04-02T13:49:53.41,0,,0.0
2020,12,2956,60,25,7081,2,13,10,0,13,13,6,7,6,0,False,False,False,1,1,2020-12-05T11:47:21.96,13,,7.0
2020,12,2956,70,25,609,2,46,9,1,1,0,1,0,1,0,True,False,False,0,4,2020-12-03T13:17:50.097,1,,0.0
2020,12,2956,75,25,609,2,5,9,4,4,0,4,0,4,0,False,False,False,0,3,2020-12-05T12:47:42.36,4,,0.0
2020,12,2956,80,25,7081,13,12,9,1,0,0,0,0,0,0,False,False,False,0,3,2021-03-05T15:01:25.287,0,,0.0
2020,12,2956,95,3,7673,13,5,10,2,0,0,0,0,0,0,False,False,False,0,3,2021-03-05T15:02:19.76,0,,0.0
2020,12,2956,115,3,7672,2,5,3,4,5,1,4,1,4,0,False,False,False,0,3,2020-12-03T18:16:59.58,5,,1.0
2020,12,2956,140,3,6918,2,46,9,-3,6,9,-1,7,-1,0,False,False,False,1,1,2020-12-03T13:44:29.37,6,,7.0
2020,12,2956,175,25,609,2,2,10,4,5,1,4,1,4,0,False,False,False,0,2,2020-12-03T13:58:53.363,5,,1.0
2020,12,2956,185,25,4583,2,49,9,0,3,3,2,1,2,0,True,False,False,0,3,2020-12-03T14:02:21.07,3,,1.0
2020,12,2956,190,25,7665,2,5,3,5,17,12,7,10,7,0,False,False,False,1,3,2020-12-03T14:04:16.327,17,,10.0
2020,12,2956,205,25,609,2,29,6,22,27,5,27,0,27,0,False,False,False,0,3,2020-12-03T14:09:57.797,27,,0.0
2020,12,2956,210,25,609,2,5,3,6,6,0,6,0,6,0,False,False,False,0,2,2020-12-03T16:07:33.39,6,,0.0
2020,12,2956,215,25,4583,2,4,4,5,11,6,7,4,7,0,False,False,False,0,3,2020-12-03T16:07:04.427,11,,4.0
2020,12,2956,225,25,7666,13,2,9,7,0,0,0,0,0,0,False,False,False,0,2,2020-12-03T14:20:13.54,0,,0.0
2020,12,2956,230,25,7060,3,2,9,2,0,0,0,0,0,0,False,False,False,0,2,2020-12-03T14:22:02.65,0,,0.0
2020,12,2956,250,3,6936,2,2,10,4,7,3,7,0,7,0,False,False,False,0,2,2020-12-04T23:01:46.47,7,,0.0
2020,12,2956,270,25,7060,2,2,10,3,5,2,3,2,3,0,False,False,False,0,2,2020-12-03T14:32:06.55,5,,2.0
2020,12,2956,275,25,7060,2,5,5,3,4,1,3,1,3,0,False,False,False,0,2,2021-02-22T17:01:09.46,4,,1.0
2020,12,2956,280,25,7060,2,49,9,-3,7,10,4,3,4,0,False,False,False,0,2,2020-12-03T14:35:26.257,7,,3.0
2020,12,2956,285,25,7060,13,18,3,-2,0,0,0,0,0,0,False,False,False,0,3,2020-12-03T14:37:48.713,0,,0.0
2020,12,2956,290,25,7060,13,18,3,-3,0,0,0,0,0,0,False,False,False,0,2,2020-12-03T14:39:06.123,0,,0.0
2020,12,2956,295,25,7666,2,6,8,17,22,5,17,5,17,0,False,False,False,1,2,2020-12-03T14:42:33.95,22,,5.0
2020,12,2956,300,25,6259,2,13,9,-1,8,9,7,1,7,0,False,False,False,0,3,2020-12-03T14:42:13.613,8,,1.0
2020,12,2956,305,25,7081,2,28,10,-2,13,15,1,12,1,0,False,False,False,1,1,2020-12-05T12:27:04.45,13,,12.0
2020,12,2956,310,25,4583,2,51,9,-2,-1,1,-1,0,-1,0,True,False,False,0,4,2020-12-03T14:45:48.817,-1,,0.0
2020,12,2956,315,25,6486,13,21,3,9,0,0,0,0,0,0,False,False,False,0,3,2020-12-03T14:47:15.32,0,,0.0
2020,12,2956,320,25,609,3,17,10,4,0,0,0,0,0,0,True,False,False,0,4,2020-12-04T21:12:44.46,0,,0.0
2020,12,2956,340,3,590,13,6,9,11,0,0,0,0,0,0,False,False,False,0,3,2020-12-03T14:55:37.103,0,,0.0
2020,12,2956,370,3,6936,13,11,2,16,0,0,0,0,0,0,False,False,False,0,3,2020-12-03T15:05:44.15,0,,0.0
2020,12,2956,405,3,670,13,32,10,1,0,0,0,0,0,0,False,False,False,0,4,2020-12-03T15:16:13.773,0,,0.0
2020,12,2956,420,25,7666,13,9,6,37,0,0,0,0,0,0,False,False,False,0,2,2020-12-03T15:38:47.79,0,,
2020,12,2956,430,25,7060,2,3,3,5,5,0,5,0,5,0,False,False,False,0,2,2020-12-03T15:42:06.123,5,,0.0
2020,12,2956,435,25,4583,13,2,10,3,0,0,0,0,0,0,False,False,False,0,3,2020-12-03T15:43:59.443,0,,0.0
2020,12,2956,440,25,7666,13,2,10,6,0,0,0,0,0,0,False,False,False,0,3,2020-12-03T15:46:27.16,0,,0.0
2020,12,2956,460,3,6936,13,19,2,24,0,0,0,0,0,0,False,False,False,0,3,2020-12-03T15:55:12.893,0,,
2020,12,2956,475,3,6936,2,51,9,-1,3,4,0,3,0,0,False,False,False,2,3,2020-12-05T12:17:17.51,3,,3.0
2020,12,2956,495,25,7060,2,5,3,9,11,2,9,2,9,0,True,False,False,0,3,2020-12-03T16:10:36.59,11,,2.0
2020,12,2956,505,25,609,2,12,9,2,4,2,3,1,3,0,False,False,False,0,3,2021-03-08T21:31:29.963,4,,1.0
2020,12,2956,510,25,7666,2,2,10,1,1,0,1,0,1,0,False,False,False,0,2,2020-12-03T16:14:56.03,1,,0.0
2020,12,2956,540,25,609,13,17,9,13,0,0,0,0,0,0,False,False,False,0,3,2020-12-04T21:13:35.507,0,,0.0
2020,12,2956,545,25,4583,2,5,5,4,5,1,5,0,5,0,False,True,False,0,3,2021-02-15T18:06:25.577,5,,0.0
2020,12,2956,550,25,7060,2,2,10,2,6,4,5,1,5,0,False,False,False,0,2,2020-12-03T16:34:01.677,6,,1.0
2020,12,2956,555,25,7666,2,5,5,11,10,-1,10,0,10,0,False,False,False,0,2,2020-12-03T16:33:27.883,10,,0.0
2020,12,2956,560,25,7666,2,5,9,5,8,3,6,2,6,0,False,False,False,0,3,2020-12-03T16:35:13.907,8,,2.0
2020,12,2956,570,25,7060,13,24,8,25,0,0,0,0,0,0,False,False,False,0,3,2020-12-03T16:38:14.02,0,,0.0
2020,12,2956,575,25,609,2,4,4,3,7,4,6,1,6,0,False,False,False,0,3,2020-12-03T16:39:35.593,7,,1.0
2020,12,2956,590,25,4583,2,46,9,0,8,8,2,6,2,0,True,False,False,1,3,2020-12-03T16:45:52.85,8,,6.0
2020,12,2956,600,25,4583,2,5,5,1,1,0,1,0,1,6,False,False,False,0,3,2020-12-03T16:48:20.25,1,,0.0
2020,12,2956,620,3,6936,13,19,8,47,0,0,0,0,0,0,False,False,False,0,3,2020-12-03T16:57:11.17,0,,0.0
2020,12,2956,625,3,6918,2,28,3,-2,7,9,5,2,5,0,False,False,False,0,1,2020-12-05T12:32:01.983,7,,
2020,12,2956,635,3,7672,2,4,9,8,8,0,8,0,8,0,False,False,False,0,3,2020-12-03T17:03:30.15,8,,0.0
2020,12,2956,645,25,7081,2,48,9,-4,7,11,5,2,5,0,False,False,False,0,1,2020-12-03T17:05:31.293,7,,2.0
2020,12,2956,650,25,7060,2,2,10,2,7,5,2,5,2,0,False,False,False,1,2,2020-12-03T17:06:57.103,7,,5.0
2020,12,2956,655,25,4583,2,4,9,4,5,1,5,0,5,0,False,False,False,0,3,2020-12-03T17:08:09.553,5,,0.0
2020,12,2956,660,25,7666,2,12,3,0,8,8,0,8,0,0,False,False,False,1,2,2020-12-03T17:10:49.287,8,,8.0
2020,12,2956,665,25,4583,2,4,10,2,5,3,4,1,4,0,False,False,False,0,3,2020-12-03T17:12:02.177,5,,1.0
2020,12,2956,670,25,7666,2,4,9,2,3,1,3,0,3,0,False,False,False,0,3,2020-12-03T17:13:09,3,,0.0
2020,12,2956,675,25,609,3,46,3,-1,0,0,0,0,0,0,True,False,False,0,4,2020-12-04T21:12:59.453,0,,0.0
2020,12,2956,685,3,6936,13,5,5,6,0,0,0,0,0,0,False,False,False,0,3,2020-12-03T18:11:30.2,0,,0.0
2020,12,2956,695,3,7672,2,6,4,7,7,0,7,0,7,0,False,False,False,0,3,2020-12-05T11:47:21.96,7,,0.0
2020,12,2956,705,3,590,13,4,3,7,0,0,0,0,0,0,False,False,False,0,2,2020-12-03T18:11:50.737,0,,0.0
2020,12,2956,710,3,6936,13,12,2,19,0,0,0,0,0,0,False,False,False,0,2,2020-12-05T12:37:59.1,0,,0.0
2020,12,2956,715,3,670,13,38,10,1,0,0,0,0,0,0,False,False,False,0,4,2020-12-03T17:34:44.05,0,,0.0
2020,12,2956,735,25,7060,3,11,6,15,0,0,0,0,0,0,False,False,False,0,3,2020-12-03T17:41:32.607,0,,0.0
2020,12,2956,755,3,6936,2,19,2,17,70,53,17,53,17,6,False,False,False,2,2,2020-12-05T11:47:21.96,70,,53.0
2020,12,2956,770,25,7060,2,5,10,3,3,0,3,0,3,0,False,True,False,0,3,2020-12-03T17:47:32.38,1,,0.0
2020,12,2956,775,25,6486,2,13,5,3,3,0,3,0,3,0,False,False,False,0,3,2021-02-22T17:02:18.77,3,,0.0
2020,12,2956,785,25,6486,2,35,8,15,16,1,15,1,15,0,False,False,False,0,3,2020-12-03T17:51:49.647,16,,1.0
2020,12,2957,15,2,5214,13,4,9,4,0,0,0,0,0,0,False,False,False,0,2,2020-12-03T19:36:16.077,0,,0.0
2020,12,2957,20,2,6472,13,48,10,-5,0,0,0,0,0,0,False,False,False,0,1,2020-11-30T11:59:09.623,0,,0.0
2020,12,2957,25,2,6249,2,32,3,2,11,9,11,0,11,0,False,False,False,0,4,2020-12-03T17:05:42.693,11,,0.0
2020,12,2957,35,23,2256,3,6,4,11,0,0,0,0,0,0,False,False,False,0,3,2021-02-22T14:22:47.59,0,,
2020,12,2957,45,23,7241,2,46,9,-2,2,4,-2,4,-2,0,False,False,False,1,1,2020-11-30T14:55:30.743,2,,4.0
2020,12,2957,50,23,7250,2,32,3,2,2,0,2,0,2,0,False,False,False,0,3,2020-11-30T12:10:34.303,2,,0.0
2020,12,2957,70,2,5223,2,6,9,14,16,2,16,0,16,0,True,False,False,0,3,2020-12-03T19:38:20.333,16,,0.0
2020,12,2957,80,2,5223,13,19,2,20,0,0,0,0,0,0,True,False,False,0,2,2020-12-01T17:36:55.613,0,,0.0
2020,12,2957,85,2,6342,2,50,5,0,0,0,0,0,0,0,False,False,False,0,2,2020-12-01T17:33:55.353,0,,0.0
2020,12,2957,110,2,7303,3,9,6,21,0,0,0,0,0,0,False,False,False,0,3,2020-11-30T12:36:43.647,0,,0.0
2020,12,2957,115,2,7303,13,12,7,21,0,0,0,0,0,0,False,False,False,0,3,2021-03-08T21:33:13.28,0,,0.0
2020,12,2957,135,23,7241,2,28,10,0,9,9,5,4,5,0,False,False,False,0,1,2020-12-01T17:57:36.097,4,,4.0
2020,12,2957,140,23,2256,2,4,3,2,7,5,7,0,7,0,False,False,False,0,2,2020-11-30T12:44:24.413,7,,0.0
2020,12,2957,145,23,2994,2,53,9,-2,-1,1,-2,1,-2,0,False,False,False,0,4,2020-11-30T12:46:01.96,-1,,1.0
2020,12,2957,155,2,6249,3,30,9,3,0,0,0,0,0,0,False,False,False,0,4,2021-02-22T14:26:28.687,0,,0.0
2020,12,2957,165,2,7303,2,4,9,7,11,4,9,2,9,0,False,False,False,0,2,2020-11-30T12:54:28.593,11,,2.0
2020,12,2957,170,2,5214,2,46,3,5,12,7,5,7,5,0,False,False,False,1,4,2020-12-03T19:15:34.51,12,,7.0
2020,12,2957,175,2,5214,13,2,9,10,0,0,0,0,0,0,False,False,False,0,2,2021-03-05T15:05:30.58,0,,0.0
2020,12,2957,180,23,7250,2,51,9,-3,16,19,8,8,8,0,False,False,False,1,3,2020-12-03T19:39:16.913,16,,8.0
2020,12,2957,190,23,2994,13,19,6,40,0,0,0,0,0,0,False,False,False,0,2,2020-12-03T19:31:38.877,0,,0.0
2020,12,2957,195,23,2256,2,51,10,0,7,7,5,2,5,0,False,False,False,0,3,2020-11-30T13:02:18.187,7,,2.0
2020,12,2957,200,23,7688,2,19,2,32,36,4,36,0,36,0,False,False,False,0,2,2020-12-01T17:58:02.403,36,,0.0
2020,12,2957,210,23,2994,13,5,3,3,0,0,0,0,0,0,False,False,False,0,3,2020-12-03T19:39:43.447,0,,0.0
2020,12,2957,220,23,7250,2,4,9,4,8,4,6,2,6,0,False,False,False,1,3,2020-12-01T17:58:23.477,8,,
2020,12,2957,230,23,7250,2,50,3,-2,11,13,11,0,11,0,False,False,False,1,2,2020-12-03T17:05:42.693,11,,0.0
2020,12,2957,265,23,2994,13,4,5,6,0,0,0,0,0,0,False,False,False,0,2,2020-12-01T17:58:45.257,0,,
2020,12,2957,270,23,7250,2,51,9,-3,2,5,0,2,0,0,False,False,False,0,3,2020-12-03T19:13:57.07,2,,2.0
2020,12,2957,275,23,4949,2,44,3,-4,3,7,0,3,0,0,True,False,False,1,3,2020-11-30T13:24:03.233,3,,3.0
2020,12,2957,280,23,7688,13,8,8,45,0,0,0,0,0,0,False,False,False,0,2,2020-11-30T13:25:51.93,0,,0.0
2020,12,2957,290,2,5223,2,4,10,4,6,2,6,0,6,0,False,False,False,0,2,2020-11-30T13:27:57.017,6,,0.0
2020,12,2957,300,2,6240,2,12,4,14,17,3,15,2,15,0,False,False,False,0,2,2021-03-08T21:34:06.623,17,,2.0
2020,12,2957,310,2,5214,2,53,9,-2,12,14,7,5,7,0,False,False,False,0,4,2020-12-01T17:34:14.943,12,,5.0
2020,12,2957,315,2,6240,3,6,9,7,0,0,0,0,0,0,False,False,False,0,2,2021-03-05T15:06:55.273,0,,
2020,12,2957,320,2,6247,2,4,9,14,14,0,14,0,14,0,False,False,False,0,3,2020-11-30T13:46:49.493,14,,0.0
2020,12,2957,325,2,5214,13,30,3,-1,0,0,0,0,0,0,True,False,False,0,4,2020-12-03T19:32:48.287,0,,0.0
2020,12,2957,340,2,6247,13,19,2,22,0,0,0,0,0,0,False,False,False,0,2,2020-12-03T19:33:22.133,0,,0.0
2020,12,2957,360,2,6472,2,48,10,-5,2,7,-3,5,-3,0,True,False,False,1,1,2020-12-01T17:39:03.363,2,,5.0
2020,12,2957,365,2,6247,2,50,3,1,8,7,2,6,2,0,False,False,False,3,2,2020-12-03T19:16:07.4,8,,6.0
2020,12,2957,375,2,5223,2,7,9,4,4,0,4,0,4,6,False,False,False,0,2,2020-11-30T14:04:09.753,4,,0.0
2020,12,2957,390,23,7688,2,26,5,1,1,0,1,0,1,0,True,False,False,0,3,2020-11-30T14:06:42.44,1,,0.0
2020,12,2957,400,23,2256,2,4,3,13,13,0,13,0,13,0,False,False,False,0,2,2020-11-30T14:48:34.83,13,,0.0
2020,12,2957,405,23,2994,2,51,10,1,11,10,8,3,8,0,False,False,False,1,4,2020-12-03T19:14:45.737,11,,3.0
2020,12,2957,410,23,2256,13,19,6,21,0,0,0,0,0,0,False,False,False,0,2,2020-12-03T19:46:03.693,0,,
2020,12,2957,415,23,7689,13,4,5,5,0,0,0,0,0,0,False,False,False,0,2,2020-11-30T14:14:44.087,0,,0.0
2020,12,2957,420,23,7250,3,5,5,12,0,0,0,0,0,0,False,False,False,0,3,2020-11-30T14:50:12.967,0,,0.0
2020,12,2957,425,23,7689,2,6,4,14,15,1,15,0,15,0,False,False,False,0,2,2020-11-30T14:18:17.54,15,,0.0
2020,12,2957,435,2,5214,3,4,10,5,0,0,0,0,0,0,False,False,False,0,3,2020-11-30T14:21:02.527,0,,0.0
2020,12,2957,440,2,6472,2,4,10,5,8,3,8,0,8,0,True,False,False,0,3,2020-11-30T14:22:55.183,8,,0.0
2020,12,2957,455,2,5214,2,4,10,12,10,-2,10,0,10,0,False,False,False,0,3,2020-11-30T14:53:34.09,10,,0.0
2020,12,2957,465,2,6240,13,2,9,7,0,0,0,0,0,0,False,False,False,0,2,2020-11-30T14:28:24.52,0,,
2020,12,2957,470,2,4670,13,47,5,0,0,0,0,0,0,0,False,False,False,0,1,2020-11-30T14:30:14.883,0,,0.0
2020,12,2957,475,2,5223,13,19,2,26,0,0,0,0,0,0,False,False,False,0,2,2020-11-30T14:31:23.687,0,,0.0
2020,12,2957,480,2,5214,2,32,5,3,14,11,9,5,9,0,False,False,False,1,4,2020-12-03T19:16:17.847,14,,5.0
2020,12,2957,510,23,2256,3,3,3,14,0,0,0,0,0,0,False,False,False,0,2,2020-12-03T19:49:46.18,0,,0.0
2020,12,2957,530,2,5223,2,5,5,5,6,1,5,1,5,0,False,False,False,0,3,2020-11-30T15:06:40.993,6,,1.0
2020,12,2957,545,23,3957,3,45,5,0,0,0,0,0,0,0,False,False,False,0,1,2020-11-30T15:10:49.32,0,,0.0
2020,12,2957,550,23,3957,13,5,9,3,0,0,0,0,0,0,False,False,False,0,1,2021-03-05T15:08:17.803,0,,0.0
2020,12,2957,565,23,7688,2,6,8,18,19,1,19,0,19,0,False,False,False,0,3,2020-11-30T15:16:51.513,19,,0.0
2020,12,2957,575,23,7250,2,26,10,4,11,7,8,3,8,0,False,False,False,0,3,2020-12-03T19:54:02.17,11,,3.0
2020,12,2957,580,23,2256,2,4,9,12,12,0,12,0,12,0,False,False,False,0,2,2020-11-30T15:21:30.787,12,,0.0
2020,12,2957,585,23,7241,2,45,5,-5,11,16,3,8,3,0,False,False,False,1,1,2021-03-03T18:50:10.037,11,,8.0
2020,12,2957,595,23,7250,13,12,1,20,0,0,0,0,0,0,False,False,False,0,3,2020-12-03T19:34:17.21,0,,0.0
2020,12,2957,600,23,2256,2,5,5,14,15,1,15,0,15,0,False,False,False,0,2,2020-11-30T15:26:59.4,15,,0.0
2020,12,2957,605,23,7688,3,13,5,3,0,0,0,0,0,0,True,False,False,0,3,2020-12-01T17:59:52.287,0,,0.0
2020,12,2957,615,23,3957,2,12,5,-2,-1,1,-1,0,-1,0,False,False,False,0,1,2021-03-08T21:35:04.033,-1,,0.0
2020,12,2957,635,2,2835,13,32,10,-3,0,0,0,0,0,0,True,False,False,0,1,2021-04-02T13:44:51.403,0,,0.0
2020,12,2957,645,2,5223,13,21,6,27,0,0,0,0,0,0,False,False,False,0,2,2020-12-03T17:05:42.693,0,,
2020,12,2957,650,2,6247,2,30,5,0,12,12,11,1,11,0,True,False,False,0,4,2020-11-30T15:41:02,12,,1.0
2020,12,2957,660,2,5223,2,2,9,10,11,1,11,0,11,0,False,False,False,0,3,2020-12-03T19:14:10.627,11,,0.0
2020,12,2957,665,2,4670,3,48,4,-1,0,0,0,0,0,0,False,False,False,0,1,2021-02-22T14:34:41.8,0,,
2020,12,2957,675,2,6472,2,4,10,3,3,0,3,0,3,0,True,False,False,0,1,2020-12-01T17:40:08.933,3,,0.0
2020,12,2957,680,2,5223,2,44,3,-4,7,11,5,2,5,0,True,False,False,0,2,2021-02-22T14:36:49.303,7,,2.0
2020,12,2957,685,2,6247,13,13,5,4,0,0,0,0,0,0,False,False,False,0,3,2020-12-03T17:05:42.693,0,,0.0
2020,12,2957,690,2,5223,13,29,5,4,0,0,0,0,0,0,False,False,False,0,2,2020-12-01T17:35:39.233,0,,0.0
2020,12,2957,700,2,6342,2,13,3,4,4,0,4,0,4,6,False,False,False,0,3,2021-02-22T18:19:37.013,4,,0.0
2020,12,2957,745,2,6472,2,46,3,-5,-3,2,-4,1,-4,0,True,False,False,0,1,2020-12-03T17:53:55.457,-3,,1.0
2020,12,2957,765,23,7250,2,4,4,10,19,9,11,8,11,0,False,False,False,1,3,2021-03-03T18:50:44.753,19,,8.0
2020,12,2957,810,23,2994,2,30,5,-2,4,6,4,0,4,0,False,False,False,0,4,2020-11-30T16:41:42.217,4,,0.0
2020,12,2957,820,23,3957,13,28,10,2,0,0,0,0,0,0,False,False,False,0,1,2020-11-30T16:44:00.24,0,,0.0
2020,12,2957,875,23,2994,2,4,5,5,9,4,9,0,9,0,False,False,False,0,2,2020-11-30T17:19:17.683,9,,0.0
2020,12,2957,880,23,2994,13,4,9,5,0,0,0,0,0,0,False,False,False,0,4,2020-12-03T20:11:58.467,0,,0.0
2020,12,2957,900,23,7250,2,47,5,0,12,12,7,5,7,0,False,False,False,1,3,2020-12-03T20:13:00.953,12,,5.0
2020,12,2958,15,26,309,13,49,10,-4,0,0,0,0,0,0,False,False,False,0,3,2020-11-30T11:42:46.203,0,,0.0
2020,12,2958,20,26,309,13,5,10,5,0,0,0,0,0,0,False,False,False,0,3,2020-11-30T11:45:36.607,0,,0.0
2020,12,2958,25,26,4282,13,39,9,10,0,0,0,0,0,0,False,False,False,0,3,2020-11-30T17:41:29.33,0,,0.0
2020,12,2958,35,4,6983,2,44,3,-6,5,11,5,0,5,0,False,False,False,0,1,2020-11-30T11:50:41.917,5,,0.0
2020,12,2958,45,4,2853,13,19,7,52,0,0,0,0,0,0,False,False,False,0,3,2020-11-30T11:54:50.583,0,,
2020,12,2958,55,4,6953,2,35,9,2,2,0,2,0,2,6,True,False,False,0,4,2020-11-30T12:02:50.123,2,,0.0
2020,12,2958,75,26,7514,2,13,9,2,8,6,3,5,3,0,False,False,False,0,3,2020-12-03T16:14:41.807,8,,5.0
2020,12,2958,80,26,309,2,2,9,7,11,4,8,3,8,0,False,False,False,0,3,2020-11-30T12:14:40.21,11,,3.0
2020,12,2958,95,26,4616,2,47,10,1,9,8,9,0,9,0,False,False,False,0,1,2020-11-30T12:19:08.12,9,,0.0
2020,12,2958,110,26,4282,13,17,10,12,0,0,0,0,0,0,False,False,False,0,4,2020-11-30T17:41:42.433,0,,0.0
2020,12,2958,115,26,4616,2,28,3,-5,14,19,10,4,10,0,True,False,False,0,1,2020-12-03T14:27:05.26,14,,4.0
2020,12,2958,125,26,4282,2,46,3,1,5,4,4,1,4,0,True,False,False,0,4,2020-12-01T21:17:49.39,5,,1.0
2020,12,2958,130,26,309,2,4,9,5,5,0,5,0,5,6,True,False,False,0,3,2020-11-30T12:33:05.09,5,,0.0
2020,12,2958,145,4,1377,2,32,5,1,3,2,2,1,2,0,True,False,False,0,1,2020-12-03T14:27:05.26,3,,1.0
2020,12,2958,165,26,3653,2,31,4,-3,2,5,2,0,2,0,False,False,False,0,1,2020-12-03T17:48:32.793,2,,0.0
2020,12,2958,170,26,309,13,2,4,5,0,0,0,0,0,0,False,False,False,0,3,2020-12-03T18:51:21.83,0,,0.0
2020,12,2958,175,26,309,13,6,7,15,0,0,0,0,0,0,True,False,False,0,3,2020-11-30T12:47:42.353,0,,0.0
2020,12,2958,195,4,2853,2,3,5,8,8,0,7,1,7,0,False,False,False,0,2,2020-12-01T17:51:16.897,8,,
2020,12,2958,200,4,594,13,12,9,5,0,0,0,0,0,0,False,False,False,0,3,2021-03-09T12:29:04.233,0,,0.0
2020,12,2958,215,26,7491,13,46,3,1,0,0,0,0,0,0,False,False,False,0,4,2020-11-30T13:01:30.183,0,,0.0
2020,12,2958,220,26,7453,2,12,5,9,12,3,12,0,12,0,False,False,False,0,2,2021-02-25T17:03:07.527,12,,0.0
2020,12,2958,235,26,4616,2,45,10,-5,7,12,4,3,4,0,False,False,False,0,1,2020-11-30T13:07:59.587,7,,3.0
2020,12,2958,240,26,4616,13,2,10,0,0,0,0,0,0,0,False,False,False,0,2,2020-11-30T13:09:32.77,0,,0.0
2020,12,2958,260,4,6983,2,48,10,-4,14,18,13,1,13,0,True,False,False,0,1,2020-12-03T18:51:32.913,14,,1.0
2020,12,2958,265,4,6953,13,33,5,14,0,0,0,0,0,0,False,False,False,0,4,2020-12-03T15:48:51.64,0,,
2020,12,2958,270,4,7645,2,48,9,-3,2,5,0,2,0,0,False,False,False,0,1,2020-11-30T13:19:26.467,2,,2.0
2020,12,2958,285,4,7646,2,21,2,20,20,0,20,0,20,6,False,False,False,0,2,2020-11-30T13:25:05.113,20,,0.0
2020,12,2958,305,26,4282,2,39,4,6,11,5,7,4,7,0,False,False,False,1,4,2020-12-03T14:27:05.26,11,,4.0
2020,12,2958,315,26,309,3,2,9,5,0,0,0,0,0,0,False,False,False,0,3,2020-11-30T13:33:17.21,0,,0.0
2020,12,2958,320,26,7514,13,6,4,13,0,0,0,0,0,0,False,False,False,0,3,2020-12-03T16:12:27.42,0,,0.0
2020,12,2958,335,4,7646,2,4,3,13,15,2,13,2,13,0,False,False,False,0,2,2020-11-30T13:39:15.05,15,,2.0
2020,12,2958,345,4,594,2,2,4,8,14,6,14,0,14,0,False,False,False,0,3,2020-11-30T13:45:45.973,14,,0.0
2020,12,2958,350,4,594,13,49,5,-2,0,0,0,0,0,0,False,False,False,0,2,2020-11-30T13:47:57.69,0,,0.0
2020,12,2958,355,4,7645,2,5,10,3,7,4,6,1,6,0,False,False,False,0,1,2020-12-03T14:27:05.26,7,,1.0
2020,12,2958,370,4,7646,13,12,5,0,0,0,0,0,0,0,False,False,False,0,3,2020-11-30T13:57:30.793,0,,0.0
2020,12,2958,390,4,6983,2,48,9,-4,1,5,-3,4,-3,0,False,False,False,0,1,2020-12-01T17:50:30.97,1,,4.0
2020,12,2958,405,26,4616,2,4,10,1,4,3,4,0,4,0,False,False,False,0,1,2020-11-30T14:04:42.3,4,,0.0
2020,12,2958,415,26,4616,2,48,9,-2,11,13,9,2,9,0,False,False,False,0,1,2020-11-30T14:07:02.393,11,,2.0
2020,12,2958,420,26,4619,13,19,2,33,0,0,0,0,0,0,False,False,False,0,2,2020-11-30T14:09:26.023,0,,0.0
2020,12,2958,425,26,7453,2,13,10,3,10,7,9,1,9,0,False,False,False,0,3,2020-11-30T14:11:14.167,10,,1.0
2020,12,2958,440,26,309,2,39,4,5,9,4,7,2,7,0,False,False,False,0,3,2020-11-30T14:13:32.56,9,,2.0
2020,12,2958,445,26,4616,2,4,4,3,7,4,5,2,5,0,False,False,False,1,1,2020-11-30T14:14:41.79,7,,2.0
2020,12,2958,485,4,2853,2,51,10,-2,4,6,3,1,3,0,False,False,False,0,3,2020-11-30T18:18:01.533,4,,1.0
2020,12,2958,490,4,2853,2,4,5,4,4,0,4,0,4,0,False,False,False,0,2,2020-11-30T14:24:18.367,4,,0.0
2020,12,2958,500,4,2853,2,4,5,5,6,1,6,0,6,0,False,False,False,0,3,2020-12-03T15:51:19.86,6,,0.0
2020,12,2958,510,4,2853,2,2,9,6,8,2,7,1,7,0,False,False,False,0,2,2020-11-30T14:30:57.97,8,,1.0
2020,12,2958,525,4,2853,13,2,9,3,0,0,0,0,0,0,False,False,False,0,2,2020-12-03T15:53:57.763,0,,0.0
2020,12,2958,545,26,4282,2,7,5,11,13,2,11,2,11,0,False,False,False,0,4,2020-11-30T17:43:04.81,13,,2.0
2020,12,2958,555,26,4282,2,4,10,4,10,6,4,6,4,0,False,False,False,0,4,2020-11-30T17:43:21.223,10,,6.0
2020,12,2958,560,26,309,13,4,9,4,0,0,0,0,0,0,False,False,False,0,3,2020-12-03T17:49:19.453,0,,0.0
2020,12,2958,565,26,4619,2,4,5,4,4,0,4,0,4,0,False,False,False,0,2,2020-11-30T15:23:43.137,4,,0.0
2020,12,2958,580,26,4616,3,16,10,4,0,0,0,0,0,0,False,False,False,0,1,2020-12-03T17:50:17.097,0,,0.0
2020,12,2958,585,26,4616,2,47,5,4,9,5,8,1,8,0,False,False,False,0,3,2020-12-03T14:27:05.26,9,,1.0
2020,12,2958,605,4,594,2,35,3,7,11,4,10,1,10,0,False,False,False,0,3,2021-02-25T17:04:44.59,11,,1.0
2020,12,2958,615,4,2853,2,4,5,6,6,0,6,0,6,0,False,False,False,0,3,2021-02-22T14:45:24.12,6,,0.0
2020,12,2958,630,26,4619,2,2,10,13,13,0,13,0,13,0,False,False,False,0,3,2020-11-30T15:45:43.253,13,,0.0
2020,12,2958,640,26,309,2,35,10,12,15,3,12,3,12,0,False,False,False,0,3,2020-12-03T14:27:05.26,15,,3.0
2020,12,2958,645,26,4616,13,46,9,2,0,0,0,0,0,0,False,False,False,0,1,2020-11-30T15:53:12.583,0,,0.0
2020,12,2958,650,26,4619,2,4,5,9,9,0,9,0,9,0,False,False,False,0,2,2020-11-30T15:54:54.317,9,,0.0
2020,12,2958,685,26,4616,2,48,9,-5,4,9,-5,9,-5,0,False,False,False,1,1,2021-03-03T18:55:26.11,4,,9.0
2020,12,2958,695,26,4619,13,21,2,31,0,0,0,0,0,0,False,False,False,0,3,2020-12-03T14:27:05.26,0,,
2020,12,2958,735,4,7646,2,19,6,38,44,6,42,2,42,0,False,False,False,0,2,2020-11-30T16:24:15.613,44,,2.0
2020,12,2958,745,26,4282,2,30,10,-2,5,7,2,3,2,0,False,False,False,0,4,2021-02-22T14:49:10.517,5,,3.0
2020,12,2958,750,26,4616,13,46,9,4,0,0,0,0,0,0,False,False,False,0,1,2020-12-03T14:27:05.26,0,,0.0
2020,12,2958,765,4,2853,2,4,5,2,2,0,2,0,2,0,False,False,False,0,2,2020-11-30T16:36:25.307,2,,0.0
2020,12,2958,780,4,2853,13,22,6,18,0,0,0,0,0,0,False,False,False,0,2,2020-11-30T16:42:33.35,0,,0.0
2020,12,2958,790,26,4616,2,47,5,1,3,2,3,0,3,0,False,False,False,0,1,2020-11-30T16:45:13.173,3,,0.0
2020,12,2958,795,26,4282,13,8,8,17,0,0,0,0,0,0,False,False,False,0,3,2021-03-05T15:11:58.717,0,,0.0
2020,12,2958,830,4,2853,2,4,9,4,9,5,8,1,8,0,False,False,False,0,2,2020-11-30T17:08:20.543,9,,1.0
2020,12,2958,850,26,4616,13,48,10,-4,0,0,0,0,0,0,True,False,False,0,1,2020-11-30T17:12:29.167,0,,0.0
2020,12,2958,855,26,4282,2,4,9,6,8,2,7,1,7,0,False,False,False,0,3,2020-11-30T17:44:06.867,8,,1.0
2020,12,2958,860,26,7453,3,4,5,9,0,0,0,0,0,0,False,False,False,0,2,2020-11-30T17:15:29.157,0,,0.0
2020,12,2958,865,26,7453,2,4,5,11,11,0,11,0,11,0,False,False,False,0,2,2020-11-30T17:19:14.473,11,,0.0
2020,12,2958,870,26,4616,2,31,10,0,14,14,12,2,12,0,False,False,False,1,1,2020-12-03T16:18:12.85,14,,2.0
2020,12,2958,875,26,4282,2,8,1,15,15,0,15,0,15,0,False,False,False,0,3,2020-11-30T17:44:20.36,15,,0.0
2020,12,2958,885,26,4616,2,46,9,1,3,2,3,0,3,0,False,False,False,0,1,2020-12-03T17:56:58.043,3,,0.0
2020,12,2958,890,26,7514,13,19,2,21,0,0,0,0,0,0,False,False,False,0,2,2020-11-30T17:24:35.22,0,,0.0
2020,12,2958,900,26,7453,2,19,2,46,46,0,46,0,46,0,False,False,False,0,2,2020-11-30T17:27:49.81,46,,
2020,12,2958,905,26,7514,2,12,8,50,55,5,50,5,50,0,False,False,False,1,2,2020-11-30T17:31:31.403,55,,5.0
2020,12,2958,915,26,4619,13,9,9,1,0,0,0,0,0,0,False,False,False,0,3,2021-02-22T18:16:19.46,0,,
2020,12,2958,920,26,4619,13,9,3,1,0,0,0,0,0,0,False,False,False,0,2,2021-02-25T17:07:49.253,0,,0.0
2020,12,2959,10,21,3680,2,5,5,6,6,0,6,0,6,0,False,False,False,0,3,2020-12-01T22:25:51.037,6,,0.0
2020,12,2959,25,21,4405,2,6,10,1,4,3,4,0,4,0,False,False,False,0,1,2020-12-01T22:26:03.953,4,,0.0
2020,12,2959,30,21,4422,2,9,2,25,53,28,49,4,49,0,False,False,False,0,3,2021-02-22T15:08:58.093,53,,4.0
2020,12,2959,85,21,576,2,4,4,6,6,0,6,0,6,0,False,False,False,0,3,2020-11-30T12:03:37.057,6,,0.0
2020,12,2959,95,21,4422,13,30,10,2,0,0,0,0,0,0,True,False,False,0,4,2020-12-01T22:40:51.513,0,,0.0
2020,12,2959,115,7,3521,2,4,9,3,9,6,6,3,6,0,False,False,False,0,3,2020-11-30T11:44:29.653,9,,3.0
2020,12,2959,135,7,6975,2,6,10,10,16,6,14,2,14,0,False,False,False,0,2,2020-11-30T17:01:12.347,16,,2.0
2020,12,2959,140,7,910,13,19,6,37,0,0,0,0,0,0,False,False,False,0,2,2021-02-22T15:09:54.233,0,,0.0
2020,12,2959,150,7,7659,2,52,9,3,11,8,11,0,11,0,False,False,False,0,2,2020-11-30T11:56:34.517,11,,0.0
2020,12,2959,160,21,576,13,47,5,2,0,0,0,0,0,0,True,False,False,0,4,2020-11-30T12:03:19.61,0,,0.0
2020,12,2959,170,21,576,13,2,10,6,0,0,0,0,0,0,False,False,False,0,3,2020-11-30T12:07:28.803,0,,0.0
2020,12,2959,185,21,4422,2,4,4,12,12,0,12,0,12,0,False,False,False,0,3,2020-11-30T16:59:20.17,12,,0.0
2020,12,2959,200,7,3521,2,50,9,-3,1,4,1,0,1,0,False,False,False,0,2,2021-03-04T18:46:10.17,1,,0.0
2020,12,2959,210,7,910,13,4,2,22,0,0,0,0,0,0,False,False,False,0,2,2020-11-30T12:22:02.127,0,,0.0
2020,12,2959,225,21,7090,13,19,6,52,0,0,0,0,0,0,False,False,False,0,2,2020-11-30T12:26:30.933,0,,0.0
2020,12,2959,230,21,3680,2,5,5,9,9,0,9,0,9,0,False,False,False,0,2,2020-11-30T12:27:55.143,9,,0.0
2020,12,2959,235,21,5015,2,39,10,4,11,7,7,4,7,0,False,False,False,0,3,2020-11-30T12:29:33.847,11,,4.0
2020,12,2959,245,21,4405,13,48,9,-6,0,0,0,0,0,0,False,False,False,0,1,2020-12-01T22:26:55.627,0,,0.0
2020,12,2959,250,21,2288,2,45,5,-2,7,9,4,3,4,0,False,False,False,1,1,2021-03-03T19:01:35.2,7,,3.0
2020,12,2959,255,21,7090,13,9,9,6,0,0,0,0,0,0,False,False,False,0,2,2020-12-01T22:27:46.41,0,,0.0
2020,12,2959,265,21,576,2,4,3,9,10,1,10,0,10,0,False,False,False,0,3,2020-11-30T12:38:04.153,10,,0.0
2020,12,2959,275,21,4422,2,17,1,18,18,0,18,0,18,0,False,True,True,0,4,2020-11-30T16:18:12.897,16,,0.0
2020,12,2959,285,7,4716,2,5,5,5,5,0,5,0,5,0,False,False,False,0,4,2020-11-30T12:46:42.15,5,,0.0
2020,12,2959,295,7,931,2,45,5,-3,1,4,1,0,1,0,False,False,False,0,1,2020-11-30T12:49:26.973,1,,0.0
2020,12,2959,310,7,6975,2,53,9,-6,4,10,1,3,1,0,False,False,False,0,4,2021-02-22T15:14:05.443,4,,
2020,12,2959,315,7,910,3,2,9,10,0,0,0,0,0,0,False,False,False,0,2,2020-11-30T12:55:42.293,0,,0.0
2020,12,2959,320,7,7659,2,2,4,7,10,3,10,0,10,0,False,False,False,0,3,2020-11-30T12:57:22.207,10,,0.0
2020,12,2959,335,21,3680,2,4,8,15,16,1,16,0,16,0,True,False,False,0,2,2020-12-01T22:28:02.38,16,,0.0
2020,12,2959,360,21,4422,13,2,9,11,0,0,0,0,0,0,True,False,False,0,3,2020-11-30T16:24:14.87,0,,0.0
2020,12,2959,365,21,4422,2,4,10,5,5,0,5,0,5,0,False,False,False,0,2,2020-11-30T13:39:12.577,5,,0.0
2020,12,2959,370,21,576,2,3,3,7,7,0,7,0,7,0,False,False,False,0,3,2020-11-30T13:41:07.257,7,,0.0
2020,12,2959,375,21,576,3,4,10,7,0,0,0,0,0,0,False,False,False,0,3,2020-11-30T13:42:28.027,0,,0.0
2020,12,2959,380,21,3680,2,12,10,5,5,0,5,0,5,0,False,False,False,0,2,2020-11-30T13:44:05.38,5,,0.0
2020,12,2959,395,21,2288,13,42,10,4,0,0,0,0,0,0,True,False,False,0,3,2020-12-01T22:41:18.383,0,,0.0
2020,12,2959,435,7,931,3,46,3,1,0,0,0,0,0,0,False,False,False,0,1,2020-11-30T13:55:03.267,0,,0.0
2020,12,2959,455,21,4405,3,44,3,-4,0,0,0,0,0,0,False,False,False,0,1,2020-12-03T22:14:32.74,0,,0.0
2020,12,2959,460,21,4422,2,9,6,36,44,8,37,7,37,0,False,False,False,0,3,2021-02-22T15:27:10.243,44,,7.0
2020,12,2959,475,21,4405,2,4,9,2,2,0,2,0,2,0,False,False,False,0,1,2020-11-30T15:20:15.58,2,,0.0
2020,12,2959,485,21,4405,2,48,9,-6,-9,-3,-8,-1,-8,0,False,False,False,0,1,2021-02-22T15:28:48.437,-9,,-1.0
2020,12,2959,490,21,576,13,13,9,8,0,0,0,0,0,0,False,False,False,0,2,2020-12-03T20:43:06.4,0,,0.0
2020,12,2959,505,7,4455,2,45,5,-4,2,6,-2,4,-2,0,False,False,False,1,1,2020-11-30T14:20:33.807,2,,4.0
2020,12,2959,510,7,3521,13,17,1,21,0,0,0,0,0,0,False,False,False,0,3,2020-12-03T21:45:37.643,0,,0.0
2020,12,2959,530,21,4422,13,39,4,7,0,0,0,0,0,0,False,False,False,0,3,2020-11-30T14:28:42.303,0,,0.0
2020,12,2959,535,21,576,2,5,3,13,13,0,13,0,13,0,False,False,False,0,3,2020-12-03T21:46:43.867,13,,0.0
2020,12,2959,550,21,3680,13,20,2,18,0,0,0,0,0,0,False,False,False,0,2,2020-11-30T14:34:18.23,0,,0.0
2020,12,2959,560,7,7659,2,26,9,0,4,4,4,0,4,0,False,False,False,0,3,2020-12-03T19:23:48.393,4,,0.0
2020,12,2959,565,7,6975,13,39,4,5,0,0,0,0,0,0,False,False,False,0,4,2020-11-30T17:01:44.82,0,,0.0
2020,12,2959,570,7,6383,13,5,3,12,0,0,0,0,0,0,False,False,False,0,3,2020-12-03T19:43:26.847,0,,0.0
2020,12,2959,580,7,6985,2,47,10,-1,13,14,10,3,10,0,False,False,False,0,1,2020-12-03T20:55:45.177,13,,3.0
2020,12,2959,590,7,3521,13,4,10,2,0,0,0,0,0,0,False,False,False,0,3,2021-03-05T15:14:33.607,0,,0.0
2020,12,2959,605,21,4422,2,32,3,0,-1,-1,-1,0,-1,0,False,False,False,0,4,2020-11-30T14:58:03.957,-1,,0.0
2020,12,2959,610,21,3680,2,2,9,6,8,2,8,0,8,0,False,False,False,0,2,2020-11-30T14:59:21.81,8,,0.0
2020,12,2959,630,21,2288,13,45,5,1,0,0,0,0,0,0,False,False,False,0,1,2020-11-30T15:05:31.013,0,,0.0
2020,12,2959,650,7,7659,2,13,9,4,9,5,9,0,9,0,True,False,False,0,2,2020-12-03T21:47:17.2,9,,
2020,12,2959,655,7,3521,13,4,4,11,0,0,0,0,0,0,False,False,False,0,3,2020-12-01T18:43:36.883,0,,0.0
2020,12,2959,660,7,6975,2,32,10,0,7,7,5,2,5,0,False,False,False,0,4,2020-11-30T17:02:05.25,7,,2.0
2020,12,2959,685,21,3680,2,3,2,15,15,0,15,0,15,0,False,False,False,0,2,2020-12-01T22:29:36.56,15,,0.0
2020,12,2959,695,21,3680,2,4,9,5,5,0,5,0,5,0,False,False,False,0,3,2021-02-22T15:32:20.82,5,,0.0
2020,12,2959,700,21,576,13,9,2,30,0,0,0,0,0,0,False,False,False,0,3,2020-11-30T15:29:10.383,0,,0.0
2020,12,2959,710,7,7659,2,6,4,4,9,5,7,2,7,0,False,False,False,0,3,2020-12-03T21:48:46.883,9,,
2020,12,2959,715,7,6975,2,17,10,14,14,0,14,0,14,0,False,False,False,0,4,2020-11-30T17:02:20.603,14,,0.0
2020,12,2959,720,7,6975,2,4,5,4,4,0,4,0,4,0,False,True,True,0,4,2020-12-03T22:23:55.397,3,,0.0
2020,12,2959,765,7,3521,2,46,3,2,5,3,5,0,5,0,False,False,False,0,3,2020-11-30T15:46:53.463,5,,0.0
2020,12,2959,770,7,7659,2,6,8,17,18,1,18,0,18,0,False,False,False,0,2,2020-11-30T15:48:55.83,18,,0.0
2020,12,2959,775,7,931,2,4,4,2,16,14,6,10,6,0,False,False,False,2,1,2020-12-03T20:58:32.49,16,,10.0
2020,12,2959,785,7,6383,13,9,6,18,0,0,0,0,0,0,False,False,False,0,2,2020-11-30T15:54:14.197,0,,0.0
2020,12,2959,790,7,3521,3,17,1,18,0,0,0,0,0,0,False,False,False,0,3,2020-11-30T16:20:28.147,0,,
2020,12,2959,800,7,7659,2,6,9,1,1,0,1,0,1,6,False,False,False,0,3,2020-12-03T19:23:48.393,1,,0.0
2020,12,2959,835,21,4405,2,47,5,4,10,6,10,0,10,0,False,False,False,0,1,2021-02-22T15:33:41.837,10,,
2020,12,2960,15,31,5080,2,47,10,4,12,8,12,0,12,0,False,False,False,0,4,2020-12-03T15:42:30.48,12,,0.0
2020,12,2960,30,31,3504,2,47,5,2,4,2,3,1,3,0,False,False,False,0,1,2020-12-03T16:35:49.12,4,,1.0
2020,12,2960,40,31,6793,2,35,10,8,7,-1,7,0,7,0,False,False,False,0,3,2020-12-03T15:44:01.607,7,,0.0
2020,12,2960,50,31,2865,2,4,9,5,8,3,6,2,6,0,False,False,False,0,3,2020-11-30T11:13:59.04,8,,2.0
2020,12,2960,75,14,6543,2,5,5,2,12,10,8,4,8,0,False,False,False,0,3,2020-11-30T11:21:25.11,12,,4.0
2020,12,2960,100,14,6546,2,28,5,2,21,19,11,10,11,0,False,False,False,0,1,2020-11-30T11:35:24.693,21,,10.0
2020,12,2960,110,14,895,2,5,5,10,12,2,12,0,12,0,False,False,False,0,4,2020-11-30T11:40:08.463,12,,0.0
2020,12,2960,120,14,7584,3,2,10,4,0,0,0,0,0,0,False,False,False,0,2,2020-11-30T11:43:38.803,0,,0.0
2020,12,2960,125,14,895,2,17,4,11,11,0,11,0,11,6,False,False,False,0,3,2020-11-30T11:45:42.707,11,,0.0
2020,12,2960,140,31,3504,2,44,3,-4,3,7,0,3,0,0,False,False,False,0,1,2020-11-30T11:50:13.987,3,,3.0
2020,12,2960,155,31,5080,2,26,3,2,9,7,9,0,9,0,False,False,False,0,3,2020-12-03T16:14:04.607,9,,
2020,12,2960,160,31,6793,2,2,10,10,69,59,25,44,25,6,False,False,False,1,3,2020-11-30T11:59:59.957,69,,44.0
2020,12,2960,185,14,895,2,7,6,16,19,3,19,0,19,0,False,False,False,0,4,2020-11-30T12:07:07.157,19,,0.0
2020,12,2960,190,14,6543,2,48,10,-6,19,25,16,3,16,0,False,False,False,0,1,2020-11-30T12:09:39.133,19,,3.0
2020,12,2960,200,14,7584,2,13,3,5,14,9,14,0,14,0,False,False,False,0,3,2020-12-03T17:03:55.993,14,,0.0
2020,12,2960,205,14,1114,13,35,9,10,0,0,0,0,0,0,False,False,False,0,3,2020-11-30T18:14:43.567,0,,
2020,12,2960,235,31,3504,13,45,5,0,0,0,0,0,0,0,False,False,False,0,1,2020-11-30T12:29:06.577,0,,0.0
2020,12,2960,240,31,6724,13,16,9,6,0,0,0,0,0,0,True,False,False,0,3,2020-12-03T17:08:16.8,0,,0.0
2020,12,2960,255,14,6543,13,5,3,3,0,0,0,0,0,0,False,False,False,0,1,2020-12-03T16:08:45.627,0,,0.0
2020,12,2960,260,14,6543,2,13,10,2,5,3,4,1,4,0,True,False,False,0,3,2020-12-03T17:09:17.46,5,,1.0
2020,12,2960,270,31,2865,2,35,10,12,12,0,12,0,12,0,False,False,False,0,4,2020-12-03T16:16:04.947,12,,0.0
2020,12,2960,285,31,3504,13,45,5,-5,0,0,0,0,0,0,False,False,False,0,1,2020-12-03T15:47:49.7,0,,0.0
2020,12,2960,290,31,5080,13,21,2,29,0,0,0,0,0,0,False,False,False,0,2,2020-12-03T15:48:11.117,0,,
2020,12,2960,305,31,5080,2,7,3,14,21,7,20,1,20,0,False,False,False,0,4,2020-12-03T16:12:18.137,21,,1.0
2020,12,2960,340,14,6543,2,45,5,-1,10,11,9,1,9,0,False,False,False,1,6,2021-02-22T16:26:23.403,10,,1.0
2020,12,2960,345,14,895,13,6,10,14,0,0,0,0,0,0,False,False,False,0,3,2020-12-03T16:16:38.027,0,,0.0
2020,12,2960,350,14,6543,2,48,9,-6,4,10,3,1,3,0,False,False,False,0,1,2020-11-30T13:30:53.587,4,,1.0
2020,12,2960,355,14,7584,3,13,10,4,0,0,0,0,0,0,True,False,False,0,3,2020-12-01T21:00:04.083,0,,0.0
2020,12,2960,440,14,895,13,7,2,21,0,0,0,0,0,0,False,False,False,0,3,2020-11-30T14:00:09.64,0,,
2020,12,2960,445,14,6543,3,11,3,1,0,0,0,0,0,0,False,False,False,0,1,2020-12-03T15:48:55.443,0,,0.0
2020,12,2960,450,14,7584,13,4,5,11,0,0,0,0,0,0,False,False,False,0,3,2020-12-03T15:49:27.863,0,,0.0
2020,12,2960,455,14,8165,2,52,4,1,1,0,1,0,1,0,False,False,False,0,3,2020-11-30T14:08:56.3,1,,0.0
2020,12,2960,480,31,6793,13,4,3,3,0,0,0,0,0,0,False,False,False,0,2,2020-11-30T14:27:28.13,0,,0.0
2020,12,2960,490,31,5080,2,17,8,28,37,9,33,4,33,0,False,False,False,0,2,2020-12-03T15:50:17.857,37,,4.0
2020,12,2960,530,14,1114,2,3,3,12,12,0,12,0,12,0,False,False,False,0,2,2020-12-03T17:42:25.5,12,,0.0
2020,12,2960,540,14,7584,3,6,10,4,0,0,0,0,0,0,False,False,False,0,2,2020-11-30T14:54:21.043,0,,0.0
2020,12,2960,545,14,895,13,4,10,12,0,0,0,0,0,0,False,False,False,0,3,2020-11-30T14:56:46.99,0,,0.0
2020,12,2960,560,31,6888,2,30,10,-1,16,17,9,7,9,0,True,False,False,0,1,2020-11-30T15:19:46.767,16,,7.0
2020,12,2960,570,31,6793,13,6,5,14,0,0,0,0,0,0,False,False,False,0,3,2020-11-30T15:18:47.52,0,,0.0
2020,12,2960,575,31,4545,13,48,10,-4,0,0,0,0,0,0,False,False,False,0,1,2020-11-30T15:22:39.713,0,,0.0
2020,12,2960,595,14,7584,13,8,7,20,0,0,0,0,0,0,False,False,False,0,4,2020-12-03T16:17:05.587,0,,0.0
2020,12,2960,600,14,7584,13,13,5,7,0,0,0,0,0,0,False,False,False,0,3,2020-12-03T17:15:20.377,0,,
2020,12,2960,640,31,4037,13,5,5,10,0,0,0,0,0,0,False,False,False,0,3,2020-12-03T16:13:37.947,0,,0.0
2020,12,2960,650,14,1114,2,5,10,8,14,6,12,2,12,0,False,False,False,0,2,2020-11-30T18:04:45.487,14,,2.0
2020,12,2960,660,14,4449,3,4,9,11,0,0,0,0,0,0,False,False,False,0,3,2020-12-03T17:43:02.73,0,,0.0
2020,12,2960,665,14,4449,13,22,2,36,0,0,0,0,0,0,False,False,False,0,2,2021-03-05T15:17:00.14,0,,0.0
2020,12,2960,690,31,2865,2,13,5,3,10,7,10,0,10,0,False,False,False,0,4,2020-12-03T16:53:22.423,10,,0.0
2020,12,2960,725,14,1114,13,6,10,5,0,0,0,0,0,0,False,False,False,0,2,2020-12-03T17:43:44.11,0,,0.0
2020,12,2960,730,14,6543,2,28,9,3,9,6,9,0,9,0,False,False,False,0,6,2020-11-30T16:35:13.21,9,,0.0
2020,12,2960,745,14,4449,13,4,10,11,0,0,0,0,0,0,False,False,False,0,3,2020-11-30T18:20:54.473,0,,0.0
2020,12,2960,750,14,5197,2,5,3,9,11,2,9,2,9,0,False,False,False,0,4,2020-11-30T16:41:22.35,11,,2.0
2020,12,2960,755,14,1114,2,8,8,38,50,12,45,5,45,0,False,False,False,0,2,2020-12-03T17:48:17.96,50,,5.0
2020,12,2960,795,31,6793,2,3,5,12,12,0,12,0,12,0,False,False,False,0,2,2020-12-03T17:18:51.097,12,,0.0
2020,12,2960,820,31,6793,2,5,5,10,10,0,11,-1,11,0,False,False,False,0,3,2020-11-30T18:03:18.547,10,,-1.0
2020,12,2960,845,14,1119,13,4,10,4,0,0,0,0,0,0,False,False,False,0,4,2020-11-30T17:12:13.97,0,,0.0
2020,12,2960,850,14,6546,13,11,5,8,0,0,0,0,0,0,False,False,False,0,1,2020-11-30T17:13:34.583,0,,0.0
2020,12,2960,855,14,4449,2,8,7,22,23,1,23,0,23,0,False,False,False,0,3,2020-12-03T17:46:54.6,23,,0.0
2020,12,2960,860,14,7584,2,32,5,2,14,12,7,7,7,0,False,False,False,0,3,2020-12-03T17:19:54.057,14,,7.0
2020,12,2960,865,14,6546,2,48,9,-6,7,13,5,2,5,0,False,False,False,0,1,2020-11-30T17:25:19.397,7,,2.0
2020,12,2960,870,14,5197,2,13,10,3,8,5,5,3,5,0,False,False,False,0,3,2020-11-30T17:27:04.003,8,,3.0
2020,12,2960,875,14,6546,2,28,10,-4,7,11,5,2,5,0,False,False,False,0,1,2020-11-30T17:29:16.837,7,,2.0
2020,12,2960,880,14,895,13,5,2,15,0,0,0,0,0,0,False,False,False,0,3,2020-12-03T15:52:38.167,0,,0.0
2020,12,2960,885,14,6543,2,2,9,3,3,0,3,0,3,0,False,False,False,0,2,2020-11-30T17:41:15.723,3,,0.0
2020,12,2960,890,14,6543,2,28,9,3,4,1,3,1,3,0,False,False,False,0,1,2020-12-03T17:48:47.127,4,,1.0
2020,12,2960,895,14,1114,13,21,2,28,0,0,0,0,0,0,False,False,False,0,2,2020-11-30T17:41:53.76,0,,
2020,12,2960,900,14,6543,13,21,2,24,0,0,0,0,0,0,False,False,False,0,2,2020-12-03T17:48:54.357,0,,
2020,12,2960,905,14,1114,2,29,5,5,5,0,5,0,5,6,False,False,False,0,2,2021-03-04T18:48:47.25,5,,0.0
2020,12,2960,930,14,7584,13,4,5,7,0,0,0,0,0,0,False,False,False,0,2,2020-11-30T17:50:51.647,0,,0.0
2020,12,2960,945,14,7584,13,19,2,30,0,0,0,0,0,0,False,False,False,0,2,2020-12-03T17:49:27.557,0,,0.0
2020,12,2961,15,15,7591,2,4,5,7,11,4,7,4,7,0,False,False,False,2,2,2020-12-03T19:23:09.553,11,,4.0
2020,12,2961,30,15,8114,3,5,5,12,0,0,0,0,0,0,False,False,False,0,4,2020-12-03T19:41:54.273,0,,0.0
2020,12,2961,35,15,8099,2,50,3,-3,-2,1,-3,1,-3,0,False,False,False,0,2,2020-11-30T13:21:33.267,-2,,1.0
2020,12,2961,75,15,4997,13,23,1,40,0,0,0,0,0,0,False,False,False,0,3,2021-02-22T16:32:36.303,0,,0.0
2020,12,2961,90,15,922,2,46,9,1,8,7,6,2,6,0,False,False,False,0,1,2020-11-30T13:36:26.443,8,,2.0
2020,12,2961,105,8,232,2,30,9,-3,21,24,19,2,19,0,False,False,False,0,3,2020-11-30T13:40:54.403,21,,2.0
2020,12,2961,110,8,6439,2,48,10,-1,14,15,13,1,13,0,False,False,False,1,1,2021-02-22T16:33:59.81,14,,1.0
2020,12,2961,115,8,6994,2,26,9,2,11,9,9,2,9,0,False,False,False,0,4,2020-12-03T20:04:10.36,11,,2.0
2020,12,2961,125,8,232,2,29,9,5,5,0,5,0,5,6,False,False,False,0,3,2021-02-22T16:35:03.67,5,,0.0
2020,12,2961,155,15,7592,2,35,10,13,13,0,13,0,13,0,False,False,False,0,3,2020-12-03T20:04:38.29,13,,0.0
2020,12,2961,160,15,4997,13,24,6,27,0,0,0,0,0,0,False,False,False,0,3,2020-12-03T20:04:50.33,0,,
2020,12,2961,170,15,7591,2,12,5,6,7,1,7,0,7,0,False,False,False,0,3,2020-11-30T14:00:59.96,7,,0.0
2020,12,2961,190,15,7592,13,29,5,6,0,0,0,0,0,0,False,False,False,0,2,2021-01-15T21:44:32.94,0,,0.0
2020,12,2961,200,15,4997,13,13,10,6,0,0,0,0,0,0,False,False,False,0,3,2021-01-15T21:44:53.207,0,,0.0
2020,12,2961,225,8,5098,3,3,2,15,0,0,0,0,0,0,False,False,False,0,2,2020-12-03T19:43:29.053,0,,0.0
2020,12,2961,235,8,6633,2,35,8,16,17,1,16,1,16,0,False,False,False,0,3,2020-11-30T17:30:03.8,17,,1.0
2020,12,2961,245,8,232,2,23,8,27,27,0,27,0,27,0,False,False,False,0,3,2020-11-30T14:22:28.543,27,,0.0
2020,12,2961,255,8,232,13,24,6,16,0,0,0,0,0,0,True,False,False,0,3,2020-12-03T20:27:45.843,0,,0.0
2020,12,2961,260,8,6633,2,5,10,4,4,0,4,0,4,0,False,False,False,0,3,2020-12-03T19:45:35.02,4,,0.0
2020,12,2961,265,8,3606,13,2,10,5,0,0,0,0,0,0,False,False,False,0,2,2021-01-15T21:45:15.96,0,,0.0
2020,12,2961,275,8,232,13,5,3,5,0,0,0,0,0,0,False,False,False,0,3,2021-02-22T16:35:53.107,0,,0.0
2020,12,2961,290,15,4997,2,35,10,11,20,9,17,3,17,0,False,False,False,0,2,2020-12-03T19:47:14.787,20,,3.0
2020,12,2961,310,15,7592,2,35,6,22,46,24,44,2,44,6,False,False,False,0,3,2020-12-03T20:06:36.047,46,,2.0
2020,12,2961,325,8,7652,13,9,2,34,0,0,0,0,0,0,False,False,False,0,2,2020-12-03T19:47:58.063,0,,
2020,12,2961,340,8,232,2,7,6,22,23,1,22,1,22,0,False,False,False,0,2,2020-12-03T18:51:04.34,23,,1.0
2020,12,2961,355,8,232,13,13,10,5,0,0,0,0,0,0,True,False,False,0,3,2021-02-22T16:37:20.167,0,,0.0
2020,12,2961,360,8,232,2,2,4,8,15,7,13,2,13,0,True,False,False,0,3,2020-12-03T19:19:10.643,15,,2.0
2020,12,2961,375,8,3883,2,7,3,9,9,0,9,0,9,6,True,False,False,0,4,2021-02-25T17:15:58.76,9,,0.0
2020,12,2961,390,15,4997,2,5,2,18,18,0,18,0,18,0,False,False,False,0,3,2020-11-30T15:15:09.813,18,,0.0
2020,12,2961,395,15,8099,2,46,9,-2,6,8,2,4,2,0,False,False,False,1,1,2020-12-03T20:07:00.323,6,,4.0
2020,12,2961,400,15,4997,13,19,6,39,0,0,0,0,0,0,False,False,False,0,3,2020-11-30T15:18:48.153,0,,0.0
2020,12,2961,405,15,922,2,5,3,5,6,1,6,0,6,0,False,False,False,0,3,2020-11-30T17:32:05.327,6,,0.0
2020,12,2961,415,15,8099,13,6,10,4,0,0,0,0,0,0,False,False,False,0,1,2021-03-01T18:31:21.727,0,,0.0
2020,12,2961,420,15,8099,2,6,4,3,9,6,9,0,9,0,False,False,False,0,1,2020-12-03T18:53:32.687,9,,0.0
2020,12,2961,445,8,7652,2,13,10,7,13,6,12,1,12,0,False,True,True,0,4,2020-11-30T15:28:27.457,13,,1.0
2020,12,2961,465,15,8099,2,47,10,-2,14,16,14,0,14,0,False,False,False,0,1,2020-11-30T17:32:24.247,14,,0.0
2020,12,2961,475,15,922,2,17,10,2,2,0,2,0,2,6,False,False,False,0,3,2021-02-22T16:38:12.403,2,,0.0
2020,12,2961,495,8,3883,2,53,10,-5,4,9,2,2,2,0,False,False,False,0,4,2020-11-30T15:42:04.25,4,,2.0
2020,12,2961,510,8,6439,2,12,3,0,5,5,5,0,5,0,False,False,False,0,1,2020-12-03T20:08:28.027,5,,0.0
2020,12,2961,515,8,3606,2,4,7,15,15,0,15,0,15,0,False,False,False,0,3,2020-11-30T15:50:19.093,15,,0.0
2020,12,2961,520,8,6633,2,3,3,10,10,0,10,0,10,0,False,False,False,0,2,2020-12-03T19:18:46.193,10,,0.0
2020,12,2961,535,8,5053,13,11,6,23,0,0,0,0,0,0,False,False,False,0,1,2020-11-30T15:56:56.847,0,,0.0
2020,12,2961,555,15,4997,2,47,5,1,6,5,5,1,5,0,False,False,False,0,3,2020-11-30T16:00:48.623,6,,1.0
2020,12,2961,560,15,7592,2,35,2,17,20,3,18,2,18,0,False,False,False,0,3,2020-11-30T16:02:05.033,20,,2.0
2020,12,2961,570,15,8099,2,51,9,-5,4,9,-3,7,-3,0,False,False,False,1,1,2020-11-30T16:04:40.953,4,,7.0
2020,12,2961,575,15,7592,13,5,3,6,0,0,0,0,0,0,False,False,False,0,3,2020-12-03T20:14:46.973,0,,0.0
2020,12,2961,600,8,232,2,5,5,9,14,5,9,5,9,0,False,False,False,1,3,2020-11-30T16:11:26.423,14,,5.0
2020,12,2961,625,8,7652,13,16,10,1,0,0,0,0,0,0,False,False,False,0,1,2021-02-22T16:39:01.29,0,,0.0
2020,12,2961,645,15,7591,2,50,10,-2,13,15,11,2,11,0,False,False,False,0,3,2020-11-30T16:24:08.147,13,,2.0
2020,12,2961,660,15,7591,13,5,5,11,0,0,0,0,0,0,False,False,False,0,3,2020-12-03T20:28:41.13,0,,0.0
2020,12,2961,665,15,7592,13,6,4,7,0,0,0,0,0,0,False,False,False,0,3,2021-03-15T17:32:22.127,0,,0.0
2020,12,2961,685,8,232,2,4,9,12,19,7,13,6,13,0,False,False,False,0,3,2020-11-30T16:36:38.07,19,,6.0
2020,12,2961,695,8,232,2,6,10,12,19,7,18,1,18,0,False,False,False,0,3,2020-11-30T16:40:08.677,19,,1.0
2020,12,2961,720,8,5053,13,47,5,2,0,0,0,0,0,0,False,False,False,0,1,2020-11-30T16:49:30.117,0,,0.0
2020,12,2961,730,15,7592,13,8,7,38,0,0,0,0,0,0,False,False,False,0,2,2020-12-03T19:52:28.193,0,,0.0
2020,12,2961,735,15,2757,2,6,4,10,10,0,10,0,10,0,False,False,False,0,3,2020-11-30T16:54:28.497,10,,0.0
2020,12,2961,740,15,2757,13,7,6,22,0,0,0,0,0,0,False,False,False,0,3,2020-11-30T16:56:20.08,0,,0.0
2020,12,2961,745,15,7592,2,8,1,15,17,2,15,2,15,0,False,False,False,0,2,2020-11-30T16:58:02.513,17,,2.0
2020,12,2961,755,15,922,13,8,7,22,0,0,0,0,0,0,False,False,False,0,3,2020-12-03T20:29:06.97,0,,0.0
2020,12,2961,765,15,2757,13,24,8,16,0,0,0,0,0,0,False,False,False,0,3,2020-11-30T17:04:20.387,0,,0.0
2020,12,2961,780,15,2757,2,31,10,1,7,6,7,0,7,0,False,False,False,0,4,2020-12-03T20:17:21.303,7,,0.0
2020,12,2961,845,8,6439,2,48,9,-2,13,15,11,2,11,0,False,False,False,0,1,2020-12-03T19:53:03.89,13,,2.0
2020,12,2962,15,5,6425,2,18,5,-1,4,5,0,4,0,0,False,False,False,1,2,2020-12-03T20:37:52.86,4,,4.0
2020,12,2962,20,5,5220,13,35,2,16,0,0,0,0,0,0,True,False,False,0,3,2020-12-01T18:11:24.333,0,,0.0
2020,12,2962,35,18,4572,2,45,5,-4,5,9,3,2,3,0,False,False,False,0,1,2020-12-03T20:57:09.287,5,,2.0
2020,12,2962,40,18,4572,2,48,10,-4,12,16,11,1,11,0,False,False,False,0,1,2020-11-30T11:45:18.26,12,,1.0
2020,12,2962,50,18,7711,2,4,9,6,6,0,6,0,6,0,False,False,False,0,3,2020-12-03T20:57:59.243,6,,0.0
2020,12,2962,65,18,6361,2,30,9,2,5,3,4,1,4,0,False,False,False,0,4,2020-11-30T11:51:48.63,5,,1.0
2020,12,2962,80,18,6361,13,23,7,23,0,0,0,0,0,0,False,False,False,0,4,2020-12-03T21:21:41.707,0,,0.0
2020,12,2962,95,18,6706,2,30,9,0,2,2,2,0,2,0,False,False,False,0,4,2020-12-03T21:11:56.177,2,,0.0
2020,12,2962,100,18,7711,2,2,9,11,12,1,12,0,12,6,False,False,False,0,3,2020-12-03T21:21:41.707,12,,0.0
2020,12,2962,130,5,5220,13,5,5,9,0,0,0,0,0,0,False,False,False,0,3,2020-12-03T21:00:42.103,0,,0.0
2020,12,2962,135,5,2554,13,48,9,-6,0,0,0,0,0,0,False,False,False,0,1,2020-11-30T12:11:33.473,0,,0.0
2020,12,2962,140,5,2554,13,28,9,-1,0,0,0,0,0,0,False,False,False,0,1,2020-11-30T12:27:27.547,0,,0.0
2020,12,2962,155,18,7711,13,5,5,7,0,0,0,0,0,0,False,False,False,0,2,2020-11-30T12:31:44.91,0,,0.0
2020,12,2962,160,18,6897,2,6,9,3,3,0,3,0,3,0,False,False,False,0,2,2020-12-03T21:01:43.853,3,,0.0
2020,12,2962,180,5,3477,13,24,2,28,0,0,0,0,0,0,False,False,False,0,3,2020-11-30T12:39:28.313,0,,0.0
2020,12,2962,185,5,4803,2,26,10,4,17,13,10,7,10,0,True,False,False,0,2,2020-12-01T18:11:37.583,17,,7.0
2020,12,2962,225,5,2554,13,16,4,5,0,0,0,0,0,0,True,False,False,0,1,2021-03-05T15:19:11.25,0,,0.0
2020,12,2962,245,18,6706,2,46,3,3,8,5,6,2,6,0,False,False,False,0,3,2020-12-03T21:21:41.707,8,,2.0
2020,12,2962,255,18,4572,2,48,10,-4,-3,1,-3,0,-3,0,False,False,False,0,1,2020-11-30T12:58:19.557,-3,,0.0
2020,12,2962,260,18,6894,2,32,9,5,6,1,6,0,6,0,False,False,False,0,4,2020-11-30T13:00:09.357,6,,0.0
2020,12,2962,270,5,5220,2,6,8,17,18,1,17,1,17,0,False,False,False,0,3,2020-12-03T21:21:41.707,18,,1.0
2020,12,2962,280,5,2554,2,5,5,3,10,7,9,1,9,0,True,False,False,0,1,2020-12-03T19:47:56.403,10,,1.0
2020,12,2962,285,5,6265,2,18,6,0,1,1,1,0,1,0,True,False,False,1,2,2021-03-01T18:56:59.657,1,,0.0
2020,12,2962,295,5,4803,2,34,4,-4,5,9,3,2,3,0,True,False,False,0,3,2020-11-30T13:13:39.37,5,,2.0
2020,12,2962,310,5,5220,13,8,7,39,0,0,0,0,0,0,False,False,False,0,3,2020-11-30T13:42:21.993,0,,0.0
2020,12,2962,325,5,3477,2,13,10,2,41,39,41,0,41,6,True,False,False,0,2,2020-11-30T13:45:04.153,41,,0.0
2020,12,2962,345,18,6706,2,4,4,7,9,2,9,0,9,0,False,False,False,0,3,2020-11-30T13:48:50.34,9,,0.0
2020,12,2962,350,18,4572,2,28,4,1,7,6,5,2,5,0,False,False,False,0,1,2020-11-30T13:50:11.497,7,,2.0
2020,12,2962,380,18,813,2,4,9,12,12,0,12,0,12,0,False,False,False,0,4,2020-11-30T13:54:45.953,12,,0.0
2020,12,2962,395,18,7711,13,19,2,34,0,0,0,0,0,0,False,False,False,0,2,2020-11-30T13:58:33.6,0,,0.0
2020,12,2962,435,18,3506,13,11,6,21,0,0,0,0,0,0,False,False,False,0,3,2020-12-03T19:05:53.97,0,,0.0
2020,12,2962,475,18,813,2,32,5,3,6,3,3,3,3,0,False,False,False,0,4,2020-12-01T14:44:56.35,6,,3.0
2020,12,2962,480,18,6897,2,46,3,4,5,1,5,0,5,0,False,False,False,0,3,2020-12-03T21:04:07.167,5,,0.0
2020,12,2962,485,18,7711,3,30,10,-3,0,0,0,0,0,0,False,False,False,0,3,2021-02-22T16:49:45.017,0,,0.0
2020,12,2962,490,18,6897,2,4,10,9,9,0,9,0,9,0,False,False,False,0,3,2020-12-01T14:45:09.993,9,,0.0
2020,12,2962,495,18,7711,13,35,10,12,0,0,0,0,0,0,False,False,False,0,2,2020-11-30T14:41:32.31,0,,0.0
2020,12,2962,515,5,3477,2,2,10,4,7,3,4,3,4,0,False,False,False,0,2,2020-11-30T14:46:12.927,7,,3.0
2020,12,2962,520,5,5220,2,3,7,18,25,7,19,6,19,0,False,False,False,2,3,2020-12-03T20:40:47.043,25,,6.0
2020,12,2962,525,5,3750,2,32,10,2,11,9,9,2,9,0,False,False,False,0,4,2020-11-30T14:49:57.257,11,,2.0
2020,12,2962,535,5,4803,2,51,3,-8,6,14,6,0,6,0,True,False,False,0,2,2020-12-03T21:21:41.707,6,,0.0
2020,12,2962,545,5,5220,13,24,6,16,0,0,0,0,0,0,False,False,False,0,2,2020-12-03T20:36:35.043,0,,0.0
2020,12,2962,570,18,6897,2,5,2,17,17,0,17,0,17,0,False,False,False,0,3,2020-11-30T15:14:08.013,17,,0.0
2020,12,2962,580,18,7711,2,4,9,9,9,0,9,0,9,0,True,False,False,0,3,2020-12-03T19:06:21.787,9,,0.0
2020,12,2962,585,18,6706,2,8,7,15,16,1,16,0,16,0,False,False,False,0,2,2020-11-30T15:19:58.127,16,,0.0
2020,12,2962,590,18,7711,2,51,10,-3,0,3,-3,3,-3,0,False,False,False,1,3,2020-11-30T15:21:48.41,0,,3.0
2020,12,2962,600,18,813,2,6,4,6,7,1,6,1,6,0,False,False,False,0,4,2020-11-30T15:24:26.803,7,,1.0
2020,12,2962,605,18,6706,2,12,3,12,15,3,13,2,13,0,False,False,False,0,3,2020-11-30T15:26:02.543,15,,
2020,12,2962,615,18,7711,2,35,6,16,18,2,16,2,16,0,True,False,False,0,3,2020-11-30T15:30:24.567,18,,2.0
2020,12,2962,635,18,813,13,12,4,6,0,0,0,0,0,0,False,False,False,0,4,2020-11-30T15:35:45.85,0,,0.0
2020,12,2962,640,18,7711,13,9,3,6,0,0,0,0,0,0,False,False,False,0,3,2020-11-30T15:37:24.257,0,,0.0
2020,12,2962,655,5,3477,2,12,3,7,8,1,8,0,8,0,False,False,False,0,2,2020-12-01T19:16:04.007,8,,
2020,12,2962,660,5,2554,2,46,3,2,10,8,8,2,8,0,False,False,False,1,1,2021-02-22T16:51:07.813,10,,2.0
2020,12,2962,670,5,5220,2,6,4,5,5,0,5,0,5,0,False,False,False,0,2,2020-12-01T18:35:56.383,5,,0.0
2020,12,2962,675,5,3477,13,19,6,49,0,0,0,0,0,0,False,False,False,0,2,2020-12-03T19:06:39.373,0,,0.0
2020,12,2962,680,5,3477,2,21,2,31,34,3,34,0,34,0,False,False,False,0,2,2020-11-30T16:19:43.84,34,,0.0
2020,12,2962,690,5,3477,3,2,4,10,0,0,0,0,0,0,False,False,False,0,3,2020-12-03T20:32:16.473,0,,0.0
2020,12,2962,695,5,4803,2,13,9,4,9,5,8,1,8,0,True,False,False,0,3,2020-12-03T20:37:09.77,9,,1.0
2020,12,2962,720,18,813,2,13,9,5,6,1,5,1,5,0,False,False,False,0,4,2020-12-03T21:21:41.707,6,,1.0
2020,12,2962,725,18,6897,2,4,8,16,17,1,16,1,16,0,False,False,False,0,2,2020-12-03T21:09:37.363,17,,1.0
2020,12,2962,730,18,813,2,46,3,2,5,3,5,0,5,0,False,False,False,0,4,2020-12-03T21:21:41.707,5,,0.0
2020,12,2962,745,18,6897,2,4,9,6,6,0,6,0,6,0,False,False,False,0,3,2020-11-30T16:36:30.457,6,,0.0
2020,12,2962,765,18,6897,2,6,10,14,17,3,14,3,14,0,False,False,False,1,2,2020-11-30T16:40:14.497,17,,3.0
2020,12,2962,770,18,7711,2,26,5,6,10,4,7,3,7,6,False,False,False,1,2,2020-11-30T16:42:04.343,10,,3.0
2020,12,2962,790,5,5220,2,39,9,5,13,8,6,7,6,0,False,False,False,1,3,2020-11-30T16:46:16.97,13,,7.0
2020,12,2962,810,5,8195,3,46,3,0,0,0,0,0,0,0,False,False,False,0,1,2020-11-30T16:53:39.487,0,,0.0
2020,12,2962,815,5,6425,13,38,9,2,0,0,0,0,0,0,True,False,False,0,4,2020-12-03T21:21:41.707,0,,0.0
2020,12,2962,845,5,5220,13,2,10,3,0,0,0,0,0,0,False,False,False,0,3,2020-12-03T21:21:41.707,0,,0.0
2020,12,2962,865,18,7711,2,5,2,16,15,-1,15,0,15,0,False,False,False,0,2,2020-11-30T17:16:20.33,15,,0.0
2020,12,2962,870,18,6706,2,47,5,2,6,4,6,0,6,0,False,False,False,0,3,2020-11-30T17:17:32.883,6,,0.0
2020,12,2962,875,18,813,2,39,4,6,7,1,6,1,6,0,False,False,False,0,4,2020-12-03T21:21:41.707,7,,1.0
2020,12,2962,880,18,6706,2,4,9,11,12,1,12,0,12,0,False,False,False,0,3,2020-11-30T17:19:57.147,12,,0.0
2020,12,2962,885,18,813,2,8,7,19,25,6,23,2,23,0,False,False,False,0,4,2020-11-30T17:21:49.347,25,,2.0
2020,12,2962,890,18,7711,13,2,9,6,0,0,0,0,0,0,False,False,False,0,2,2020-11-30T17:23:30.673,0,,0.0
2020,12,2962,895,18,6706,2,17,9,10,10,0,10,0,10,6,False,False,False,0,3,2020-11-30T17:24:37.107,10,,0.0
2020,12,2962,915,5,4803,2,8,1,32,35,3,32,3,32,0,False,False,False,0,3,2020-11-30T17:31:35.253,35,,3.0
2020,12,2962,925,5,2554,2,47,5,1,4,3,4,0,4,0,False,False,False,0,4,2020-11-30T17:33:35.237,4,,0.0
2020,12,2962,930,5,3477,2,4,5,12,12,0,12,0,12,0,False,False,False,0,2,2020-12-03T21:21:41.707,12,,0.0
2020,12,2963,20,19,7175,13,9,3,-5,0,0,0,0,0,0,False,False,False,0,3,2021-03-05T15:38:43.06,0,,0.0
2020,12,2963,25,1,7315,2,34,4,-4,19,23,7,12,7,0,True,False,False,2,3,2021-03-04T18:50:19.48,19,,12.0
2020,12,2963,55,19,3233,13,3,6,19,0,0,0,0,0,0,False,False,False,0,2,2020-11-30T11:51:34.55,0,,0.0
2020,12,2963,65,19,7175,13,5,5,8,0,0,0,0,0,0,False,False,False,0,3,2020-11-30T11:56:37.08,0,,
2020,12,2963,80,19,3233,2,50,10,-4,17,21,11,6,11,0,True,False,False,0,2,2021-03-04T18:51:07.577,17,,6.0
2020,12,2963,95,19,3233,13,2,9,6,0,0,0,0,0,0,False,False,False,0,2,2020-11-30T12:11:39.287,0,,0.0
2020,12,2963,110,1,2416,2,32,5,-1,4,5,2,2,2,0,False,False,False,0,4,2021-03-08T16:35:09.23,4,,2.0
2020,12,2963,115,1,6405,2,5,5,7,8,1,8,0,8,0,False,False,False,0,2,2020-11-30T12:23:53.203,8,,0.0
2020,12,2963,120,1,6406,2,50,9,-2,5,7,5,0,5,0,False,False,False,0,3,2020-11-30T13:23:50.077,5,,0.0
2020,12,2963,135,1,245,2,12,7,17,16,-1,16,0,16,0,False,False,False,0,3,2020-12-03T16:59:29.2,16,,0.0
2020,12,2963,150,1,245,2,5,3,7,9,2,9,0,9,0,False,False,False,0,2,2020-11-30T12:45:26.7,9,,0.0
2020,12,2963,165,1,7315,13,45,5,-6,0,0,0,0,0,0,True,False,False,0,3,2020-12-03T17:25:34.85,0,,0.0
2020,12,2963,170,1,7315,13,22,2,18,0,0,0,0,0,0,False,False,False,0,3,2020-12-03T16:22:59.69,0,,0.0
2020,12,2963,195,19,7175,2,13,10,2,13,11,8,5,8,0,False,False,False,1,3,2020-12-03T17:13:30.677,13,,5.0
2020,12,2963,200,19,7173,13,2,9,7,0,0,0,0,0,0,False,False,False,0,2,2020-12-03T17:00:16.573,0,,0.0
2020,12,2963,205,19,7175,2,2,4,4,7,3,7,0,7,0,True,False,False,0,3,2020-11-30T13:12:00.813,7,,0.0
2020,12,2963,240,1,4307,2,4,4,4,6,2,6,0,6,0,False,False,False,0,1,2020-11-30T13:26:45.57,6,,0.0
2020,12,2963,250,1,7315,2,13,9,3,8,5,7,1,7,0,False,False,False,0,3,2020-12-01T20:26:01.023,8,,1.0
2020,12,2963,265,1,6406,13,32,9,0,0,0,0,0,0,0,False,False,False,0,1,2020-12-03T16:22:59.69,0,,0.0
2020,12,2963,285,19,7175,13,35,8,17,0,0,0,0,0,0,True,False,False,0,3,2020-11-30T18:51:10.67,0,,0.0
2020,12,2963,310,1,6405,13,19,2,31,0,0,0,0,0,0,False,False,False,0,2,2020-11-30T14:13:54.903,0,,0.0
2020,12,2963,315,1,5152,2,12,5,13,17,4,14,3,14,0,False,False,False,0,3,2020-11-30T14:19:05.583,17,,3.0
2020,12,2963,320,1,7315,2,51,9,-5,4,9,4,0,4,0,True,False,False,0,3,2021-02-22T19:47:57.64,4,,0.0
2020,12,2963,325,1,6405,13,11,5,13,0,0,0,0,0,0,True,False,False,0,3,2021-03-08T16:35:21.53,0,,0.0
2020,12,2963,330,1,245,2,5,3,8,9,1,9,0,9,0,False,False,False,0,2,2020-11-30T14:27:42.613,9,,0.0
2020,12,2963,345,1,245,2,2,9,6,13,7,11,2,11,0,False,False,False,0,3,2020-11-30T14:34:09.293,13,,2.0
2020,12,2963,355,1,6405,2,50,5,-2,6,8,6,0,6,0,False,False,False,0,2,2020-12-01T20:26:16.7,6,,0.0
2020,12,2963,375,1,6405,3,2,4,7,0,0,0,0,0,0,False,False,False,0,3,2020-11-30T14:48:28.213,0,,0.0
2020,12,2963,380,1,7316,2,2,9,4,7,3,6,1,6,0,False,False,False,0,2,2020-11-30T14:53:43.593,7,,1.0
2020,12,2963,410,1,6406,2,50,5,-2,-1,1,-1,0,-1,0,False,False,False,0,2,2020-11-30T15:10:42.213,-1,,0.0
2020,12,2963,415,1,6406,2,4,5,7,7,0,7,0,7,0,False,False,False,0,3,2021-02-22T19:50:41.857,7,,0.0
2020,12,2963,420,1,5152,13,6,2,17,0,0,0,0,0,0,False,False,False,0,4,2020-11-30T15:18:27.153,0,,0.0
2020,12,2963,445,19,3233,2,3,3,12,11,-1,11,0,11,0,False,False,False,0,2,2020-11-30T18:47:24.983,11,,0.0
2020,12,2963,450,19,7175,2,5,5,5,7,2,7,0,7,0,False,False,False,0,3,2020-11-30T18:47:36.88,7,,0.0
2020,12,2963,470,19,3233,13,35,9,4,0,0,0,0,0,0,False,False,False,0,3,2020-11-30T15:49:16.45,0,,0.0
2020,12,2963,495,1,245,13,2,9,-1,0,0,0,0,0,0,False,False,False,0,2,2021-03-05T15:39:24.977,0,,0.0
2020,12,2963,545,1,4307,13,47,5,0,0,0,0,0,0,0,False,False,False,0,1,2020-11-30T16:19:38.37,0,,0.0
2020,12,2963,550,1,6406,2,4,10,3,3,0,3,0,3,0,False,False,False,0,3,2020-11-30T16:21:47.667,3,,0.0
2020,12,2963,575,19,3233,13,12,2,21,0,0,0,0,0,0,False,False,False,0,2,2020-12-03T16:17:31.337,0,,0.0
2020,12,2963,585,1,6405,2,4,10,4,5,1,4,1,4,0,False,False,False,0,3,2020-11-30T16:38:58.743,5,,1.0
2020,12,2963,595,1,245,2,5,3,8,8,0,8,0,8,0,False,False,False,0,2,2020-11-30T16:47:12.327,8,,0.0
2020,12,2963,605,1,4307,2,4,4,3,3,0,3,0,3,0,False,False,False,0,1,2020-11-30T16:51:27.673,3,,0.0
2020,12,2963,610,1,245,13,3,3,5,0,0,0,0,0,0,False,False,False,0,2,2020-11-30T18:27:13.067,0,,
2020,12,2963,630,1,4307,2,47,10,1,6,5,6,0,6,0,False,False,False,0,1,2021-02-22T19:56:04.36,6,,0.0
2020,12,2963,650,1,5152,13,35,10,12,0,0,0,0,0,0,False,False,False,0,3,2020-11-30T17:12:34.003,0,,0.0
2020,12,2963,655,1,245,13,29,3,12,0,0,0,0,0,0,False,False,False,0,2,2021-02-25T17:18:23.987,0,,0.0
2020,12,2963,660,1,5152,13,7,5,12,0,0,0,0,0,0,False,False,False,0,4,2020-12-03T17:36:12.06,0,,
2020,12,2963,675,1,2416,2,5,3,5,6,1,6,0,6,0,False,False,False,0,4,2020-11-30T17:27:20.08,6,,0.0
2020,12,2963,705,19,7175,2,6,4,13,17,4,16,1,16,0,True,False,False,0,3,2020-11-30T17:39:18.547,17,,1.0
2020,12,2963,710,19,7172,13,16,4,3,0,0,0,0,0,0,False,False,False,0,1,2020-11-30T17:41:44.97,0,,
2020,12,2963,720,19,7175,2,13,4,4,8,4,5,3,5,0,True,False,False,0,3,2020-11-30T17:46:38.8,8,,3.0
2020,12,2963,740,19,3233,13,4,3,7,0,0,0,0,0,0,False,False,False,0,2,2021-03-05T15:40:06.197,0,,0.0
2020,12,2963,750,1,7315,2,5,3,0,2,2,2,0,2,0,False,False,False,0,3,2021-02-22T19:58:31.7,2,,0.0
2020,12,2963,795,19,1328,2,48,9,-6,-1,5,-3,2,-3,0,False,False,False,0,1,2020-11-30T18:11:01.35,-1,,2.0
2020,12,2963,815,19,3233,2,4,9,5,5,0,5,0,5,0,False,False,False,0,3,2020-11-30T18:19:42.537,5,,0.0
2020,12,2964,15,22,3170,2,35,9,11,16,5,14,2,14,0,False,False,False,0,2,2020-12-03T14:36:50.87,16,,2.0
2020,12,2964,25,22,256,13,9,6,26,0,0,0,0,0,0,True,False,False,0,3,2020-11-30T11:29:12.833,0,,
2020,12,2964,35,22,256,2,7,2,34,37,3,37,0,37,0,False,False,False,0,3,2020-12-03T16:06:30.05,37,,0.0
2020,12,2964,45,22,1113,2,45,5,-3,6,9,3,3,3,0,False,False,False,0,1,2020-11-30T11:36:18.58,6,,3.0
2020,12,2964,70,17,6276,2,46,3,1,2,1,1,1,1,0,False,False,False,0,4,2020-11-30T11:41:18.78,2,,1.0
2020,12,2964,75,17,6276,2,4,4,9,12,3,10,2,10,0,False,False,False,0,3,2020-11-30T11:46:03.9,12,,2.0
2020,12,2964,90,17,4383,2,2,4,9,12,3,9,3,9,0,False,False,False,0,3,2020-11-30T11:50:07.763,12,,3.0
2020,12,2964,95,17,7634,2,13,4,3,8,5,6,2,6,0,False,False,False,0,3,2021-02-22T17:41:59.873,8,,2.0
2020,12,2964,100,17,2253,13,2,9,10,0,0,0,0,0,0,False,False,False,0,3,2020-11-30T11:54:55.59,0,,0.0
2020,12,2964,110,17,4484,13,7,5,13,0,0,0,0,0,0,False,False,False,0,4,2020-12-03T14:36:50.87,0,,0.0
2020,12,2964,125,22,3170,2,39,4,4,6,2,5,1,5,0,False,False,False,0,3,2020-11-30T12:01:53.18,6,,1.0
2020,12,2964,145,22,3170,13,5,2,18,0,0,0,0,0,0,False,False,False,0,2,2020-11-30T12:09:08.377,0,,0.0
2020,12,2964,155,17,6276,2,5,3,5,5,0,5,0,5,0,False,False,False,0,4,2020-11-30T12:11:32.537,5,,0.0
2020,12,2964,165,17,6274,2,7,3,12,22,10,22,0,22,0,False,False,False,0,3,2020-12-01T18:24:39.373,22,,0.0
2020,12,2964,170,17,4305,2,49,10,-2,5,7,4,1,4,0,False,False,False,0,3,2020-12-03T15:14:42.51,5,,1.0
2020,12,2964,175,17,7687,13,29,3,11,0,0,0,0,0,0,False,False,False,0,2,2021-02-22T17:43:46.853,0,,0.0
2020,12,2964,180,17,6274,13,5,5,9,0,0,0,0,0,0,True,False,False,0,3,2020-11-30T12:24:33.87,0,,0.0
2020,12,2964,195,22,7610,2,6,8,19,19,0,19,0,19,0,False,False,False,0,2,2020-11-30T12:27:14.51,19,,0.0
2020,12,2964,215,22,7610,13,12,5,7,0,0,0,0,0,0,False,False,False,0,2,2020-12-02T01:12:32.527,0,,0.0
2020,12,2964,230,17,2253,2,2,9,6,11,5,8,3,8,0,False,False,False,0,2,2020-11-30T17:33:22.25,11,,3.0
2020,12,2964,235,17,4383,2,4,5,4,7,3,5,2,5,0,False,False,False,0,2,2020-11-30T12:48:11.477,7,,2.0
2020,12,2964,240,17,6274,13,5,3,13,0,0,0,0,0,0,False,False,False,0,3,2020-11-30T12:49:54.17,0,,
2020,12,2964,245,17,3516,2,48,10,-2,6,8,3,3,3,0,False,False,False,1,1,2020-11-30T12:52:44.977,6,,3.0
2020,12,2964,250,17,3516,2,46,9,0,5,5,3,2,3,0,False,False,False,0,1,2020-11-30T12:55:02.95,5,,2.0
2020,12,2964,255,17,2253,2,29,2,17,19,2,17,2,17,0,False,True,False,0,3,2020-11-30T17:35:22.04,19,,2.0
2020,12,2964,260,17,2253,2,29,2,16,17,1,17,0,17,0,False,False,False,0,3,2020-11-30T17:35:45.703,17,,0.0
2020,12,2964,275,17,6274,2,7,3,13,13,0,13,0,13,6,True,False,False,0,3,2020-11-30T13:05:42.697,13,,0.0
2020,12,2964,290,22,256,3,35,7,16,0,0,0,0,0,0,False,False,False,0,3,2020-11-30T13:13:15.97,0,,0.0
2020,12,2964,300,22,6812,13,12,2,17,0,0,0,0,0,0,False,False,False,0,1,2020-11-30T13:16:28.81,0,,0.0
2020,12,2964,310,17,2253,2,4,5,4,19,15,4,15,4,0,False,False,False,3,2,2021-03-03T19:25:14.013,19,,15.0
2020,12,2964,315,17,4913,2,48,9,-3,13,16,13,0,13,0,False,False,False,0,1,2021-02-22T17:47:17.583,13,,0.0
2020,12,2964,320,17,4913,2,46,3,2,4,2,4,0,4,0,False,False,False,0,3,2020-11-30T13:23:25.467,4,,0.0
2020,12,2964,325,17,2253,13,9,6,23,0,0,0,0,0,0,False,False,False,0,2,2020-11-30T13:26:06.193,0,,0.0
2020,12,2964,350,22,1113,2,46,9,0,0,0,0,0,0,0,False,False,False,0,1,2020-12-03T15:49:02.893,0,,0.0
2020,12,2964,355,22,7610,2,26,10,8,30,22,29,1,29,0,False,False,False,0,2,2020-11-30T13:36:06.267,30,,1.0
2020,12,2964,365,22,1113,2,12,5,5,6,1,6,0,6,0,False,False,False,0,1,2021-02-22T17:48:14.653,6,,0.0
2020,12,2964,385,22,256,13,19,2,30,0,0,0,0,0,0,True,False,False,0,3,2020-11-30T13:51:42.65,0,,0.0
2020,12,2964,395,22,7610,3,13,5,5,0,0,0,0,0,0,False,False,False,0,2,2021-02-22T17:49:16.103,0,,0.0
2020,12,2964,410,22,3170,2,4,10,8,9,1,8,1,8,0,False,False,False,1,3,2021-03-03T19:25:31.82,9,,1.0
2020,12,2964,435,17,4383,13,4,5,7,0,0,0,0,0,0,False,False,False,0,2,2020-11-30T14:42:06.817,0,,0.0
2020,12,2964,445,17,6274,3,6,4,11,0,0,0,0,0,0,False,False,False,0,3,2020-11-30T14:45:09.547,0,,0.0
2020,12,2964,460,22,256,2,9,6,23,27,4,27,0,27,0,True,False,False,0,3,2021-02-22T17:50:21.127,27,,0.0
2020,12,2964,470,22,7610,13,9,2,29,0,0,0,0,0,0,False,False,False,0,2,2020-11-30T14:53:26.15,0,,
2020,12,2964,480,22,3170,13,5,5,10,0,0,0,0,0,0,False,False,False,0,3,2020-11-30T14:57:47.353,0,,0.0
2020,12,2964,485,17,2253,13,4,5,5,0,0,0,0,0,0,False,False,False,0,2,2020-11-30T15:00:55.563,0,,0.0
2020,12,2964,490,17,2253,2,4,3,14,25,11,23,2,23,0,False,False,False,1,2,2020-11-30T17:36:41.113,25,,2.0
2020,12,2964,495,17,6274,13,6,4,4,0,0,0,0,0,0,False,False,False,0,3,2020-11-30T15:04:40.747,0,,0.0
2020,12,2964,500,17,2253,3,4,6,15,0,0,0,0,0,0,False,False,False,0,2,2020-11-30T15:06:55.833,0,,0.0
2020,12,2964,515,22,256,2,50,5,-1,12,13,0,12,0,0,False,False,False,0,2,2020-11-30T15:11:18.117,12,,12.0
2020,12,2964,520,22,7610,2,4,3,3,3,0,3,0,3,0,False,False,False,0,2,2020-11-30T15:12:35.093,3,,0.0
2020,12,2964,525,22,256,2,49,5,-1,3,4,0,3,0,0,False,False,False,0,2,2020-11-30T17:41:17.447,3,,3.0
2020,12,2964,530,22,6812,2,44,9,-6,1,7,-1,2,-1,0,False,False,False,0,1,2020-11-30T15:16:17.06,1,,2.0
2020,12,2964,550,17,2253,13,2,9,4,0,0,0,0,0,0,False,False,False,0,2,2020-11-30T15:28:21.853,0,,0.0
2020,12,2964,555,17,4305,2,5,5,10,10,0,10,0,10,0,True,False,False,0,3,2020-11-30T15:30:28.82,10,,0.0
2020,12,2964,575,22,7610,13,8,8,44,0,0,0,0,0,0,False,False,False,0,2,2020-11-30T15:36:23.547,0,,0.0
2020,12,2964,580,22,7610,13,35,8,18,0,0,0,0,0,0,False,False,False,0,2,2020-12-03T16:37:03.517,0,,0.0
2020,12,2964,590,17,3516,13,48,9,-2,0,0,0,0,0,0,False,False,False,0,1,2020-11-30T15:41:52.673,0,,0.0
2020,12,2964,595,17,6442,2,5,5,8,7,-1,7,0,7,0,False,False,False,0,3,2020-11-30T15:43:53.203,7,,0.0
2020,12,2964,600,17,2253,2,2,9,7,7,0,7,0,7,0,False,False,False,0,3,2020-11-30T17:37:02.297,7,,0.0
2020,12,2964,610,17,3516,13,5,5,6,0,0,0,0,0,0,False,False,False,0,3,2020-11-30T15:49:17.24,0,,0.0
2020,12,2964,635,22,7610,2,26,9,6,15,9,11,4,11,0,False,False,False,1,3,2020-12-03T15:57:58.397,15,,4.0
2020,12,2964,650,17,2253,13,9,5,14,0,0,0,0,0,0,False,False,False,0,2,2020-12-03T14:36:50.87,0,,0.0
2020,12,2964,655,17,2253,2,2,4,4,6,2,4,2,4,0,False,False,False,0,3,2020-11-30T17:37:21.053,6,,2.0
2020,12,2964,670,22,256,13,9,2,24,0,0,0,0,0,0,True,False,False,0,3,2020-12-03T16:06:54.337,0,,0.0
2020,12,2964,675,22,7118,2,46,3,4,7,3,7,0,7,0,False,False,False,0,3,2020-12-03T16:37:14.17,7,,0.0
2020,12,2964,690,17,2253,13,29,5,11,0,0,0,0,0,0,False,False,False,0,2,2020-11-30T17:37:38.903,0,,
2020,12,2964,695,17,2253,2,29,5,13,15,2,15,0,15,0,False,False,False,0,3,2021-02-22T17:52:33.167,15,,0.0
2020,12,2964,705,17,3516,3,47,5,1,0,0,0,0,0,0,False,False,False,0,1,2020-11-30T16:44:28.077,0,,0.0
2020,12,2964,710,17,4305,3,19,6,33,0,0,0,0,0,0,False,False,False,0,3,2020-11-30T16:46:22.25,0,,
2020,12,2964,725,17,4484,2,4,9,5,7,2,6,1,6,6,False,False,False,0,3,2020-11-30T16:51:40.297,7,,1.0
2020,12,2964,745,22,256,13,5,5,7,0,0,0,0,0,0,False,False,False,0,3,2021-03-05T15:23:44.867,0,,0.0
2020,12,2965,50,20,3763,13,29,2,18,0,0,0,0,0,0,False,False,False,0,2,2021-02-25T17:26:52.987,0,,0
2020,12,2965,85,10,7700,13,19,6,21,0,0,0,0,0,0,False,False,False,0,2,2020-11-30T23:20:06.34,0,,0
2020,12,2965,135,20,306,2,32,3,-6,2,8,-1,3,-1,0,False,False,False,0,1,2021-02-22T16:05:08.567,2,,3
2020,12,2965,145,20,3763,2,2,9,3,3,0,3,0,3,0,False,False,False,0,2,2020-12-03T17:11:41.593,3,,0
2020,12,2965,230,10,4930,13,5,2,23,0,0,0,0,0,0,False,False,False,0,3,2021-03-09T12:38:50.89,0,,0
2020,12,2965,235,10,4930,13,2,10,7,0,0,0,0,0,0,False,False,False,0,2,2020-11-30T23:24:11.8,0,,0
2020,12,2965,260,20,5140,13,48,0,0,0,0,0,0,0,0,False,False,False,0,1,2020-12-03T19:19:58.41,0,,0
2020,12,2965,265,20,5140,2,50,10,-3,-2,1,-2,0,-2,0,True,False,False,0,3,2020-12-01T14:33:53.92,-2,,0
2020,12,2965,280,10,6840,13,9,2,28,0,0,0,0,0,0,False,False,False,0,3,2020-11-30T23:24:49.223,0,,0
2020,12,2965,285,10,3848,13,12,2,16,0,0,0,0,0,0,False,False,False,0,3,2020-11-30T23:25:00.517,0,,0
2020,12,2965,305,20,958,13,6,4,9,0,0,0,0,0,0,False,False,False,0,3,2020-11-30T23:25:24.643,0,,0
2020,12,2965,335,20,3763,2,2,9,3,3,0,3,0,3,0,False,False,False,0,2,2020-11-30T23:25:35.15,3,,0
2020,12,2965,350,20,7888,2,53,10,-4,8,12,1,7,1,0,False,False,False,0,4,2020-11-30T23:25:56.76,8,,7
2020,12,2965,380,10,6285,13,29,2,28,0,0,0,0,0,0,False,False,False,0,2,2021-03-05T15:41:43.643,0,,0
2020,12,2965,390,20,3763,2,4,8,18,24,6,22,2,22,0,False,False,False,0,2,2020-12-03T19:05:55.94,24,,2
2020,12,2965,450,10,6840,2,31,9,-2,13,15,9,4,9,0,False,False,False,0,4,2021-03-04T20:00:24.24,13,,4
2020,12,2965,460,10,6286,13,6,10,9,0,0,0,0,0,0,False,False,False,0,4,2021-03-05T15:42:18.083,0,,0
2020,12,2965,465,20,958,13,24,6,26,0,0,0,0,0,0,True,False,False,0,3,2020-11-30T23:27:10.253,0,,0
2020,12,2965,475,20,3763,13,4,8,18,0,0,0,0,0,0,False,False,False,0,2,2021-03-09T20:17:45.763,0,,0
2020,12,2965,530,20,213,2,47,5,4,4,0,4,0,4,0,False,False,False,0,3,2020-12-03T17:11:41.593,4,,0
2020,12,2965,610,20,3763,2,29,6,19,20,1,19,1,19,0,False,False,False,0,2,2020-12-03T19:08:11.78,20,,1
2020,12,2965,635,20,6388,2,30,5,-3,16,19,12,4,12,0,True,False,False,0,4,2021-02-22T16:13:26.493,16,,4
2020,12,2966,10,28,262,2,47,5,3,4,1,3,1,3,0,True,False,False,0,4,2020-11-30T11:22:37.273,4,,1.0
2020,12,2966,20,28,969,13,6,4,12,0,0,0,0,0,0,False,False,False,0,3,2020-12-03T21:53:26.33,0,,0.0
2020,12,2966,35,29,1958,2,4,10,5,11,6,8,3,8,0,False,False,False,0,3,2020-11-30T11:51:26.987,11,,3.0
2020,12,2966,40,29,4875,2,46,3,2,7,5,7,0,7,0,False,False,False,0,3,2020-12-03T21:53:37.44,7,,0.0
2020,12,2966,50,29,3356,2,50,10,-3,11,14,9,2,9,0,True,False,False,0,3,2020-12-03T20:52:45.167,11,,2.0
2020,12,2966,55,29,3356,2,28,4,1,4,3,2,2,2,0,False,True,True,1,1,2020-11-30T12:01:05.593,4,,2.0
2020,12,2966,75,28,7224,13,6,10,8,0,0,0,0,0,0,False,False,False,0,2,2021-03-05T15:31:11.803,0,,0.0
2020,12,2966,85,29,1958,2,7,2,22,30,8,29,1,29,0,False,False,False,0,4,2021-02-22T16:41:57.067,30,,1.0
2020,12,2966,95,29,4875,2,4,3,5,6,1,5,1,5,0,False,False,False,0,2,2020-11-30T12:18:57.337,6,,1.0
2020,12,2966,100,29,4866,13,47,5,2,0,0,0,0,0,0,True,False,False,0,3,2020-11-30T12:21:00.263,0,,0.0
2020,12,2966,120,28,7224,2,34,9,-4,33,37,12,21,12,0,True,False,False,0,3,2020-12-03T20:45:06.507,33,,21.0
2020,12,2966,130,28,7224,2,35,6,15,26,11,18,8,18,0,False,False,False,0,3,2020-11-30T12:30:31.863,26,,8.0
2020,12,2966,150,29,4875,2,5,3,5,5,0,5,0,5,0,False,False,False,0,2,2020-12-03T21:54:10.34,5,,0.0
2020,12,2966,165,29,1958,13,7,2,27,0,0,0,0,0,0,False,False,False,0,3,2020-11-30T12:47:30.777,0,,0.0
2020,12,2966,180,29,1958,2,50,9,-1,8,9,6,2,6,0,False,False,False,0,2,2020-11-30T12:53:21.35,8,,2.0
2020,12,2966,200,28,7224,2,34,4,-4,3,7,1,2,1,0,True,False,False,0,3,2020-11-30T13:01:17.643,3,,2.0
2020,12,2966,210,28,4912,2,26,3,3,4,1,3,1,3,0,True,False,False,0,3,2020-12-03T21:54:21.837,4,,1.0
2020,12,2966,255,28,969,2,6,9,10,12,2,10,2,10,0,False,False,False,0,3,2020-12-03T16:18:27.713,12,,2.0
2020,12,2966,280,28,969,13,8,8,15,0,0,0,0,0,0,False,False,False,0,3,2020-11-30T13:31:16.767,0,,0.0
2020,12,2966,300,29,1958,13,39,4,6,0,0,0,0,0,0,False,False,False,0,3,2020-11-30T13:39:03.663,0,,0.0
2020,12,2966,310,28,7224,2,50,9,-3,9,12,-2,11,-2,0,False,False,False,3,2,2020-12-03T20:45:20.957,9,,11.0
2020,12,2966,325,28,6627,2,32,3,0,3,3,1,2,1,0,True,False,False,0,4,2020-12-01T17:32:25.113,3,,2.0
2020,12,2966,335,28,7224,2,50,10,-6,-6,0,-6,0,-6,0,False,False,False,0,3,2020-12-03T21:07:25.4,-6,,0.0
2020,12,2966,360,29,4850,2,16,10,4,6,2,5,1,5,0,False,False,False,1,3,2020-12-03T21:54:42.367,6,,1.0
2020,12,2966,370,29,4850,2,50,5,-1,10,11,6,4,6,0,False,False,False,0,2,2020-11-30T14:10:43.467,10,,4.0
2020,12,2966,375,29,1958,2,5,5,9,9,0,9,0,9,0,False,False,False,0,3,2020-12-03T22:03:59.01,9,,0.0
2020,12,2966,380,29,1958,13,9,5,13,0,0,0,0,0,0,False,False,False,0,3,2020-11-30T14:15:39.207,0,,0.0
2020,12,2966,400,28,969,13,8,9,11,0,0,0,0,0,0,False,False,False,0,3,2020-11-30T14:21:51.99,0,,0.0
2020,12,2966,405,28,797,13,4,4,4,0,0,0,0,0,0,False,False,False,0,1,2021-02-22T16:43:50.657,0,,0.0
2020,12,2966,415,28,4912,2,12,10,13,18,5,14,4,14,0,False,False,False,0,3,2020-12-03T21:18:05.85,18,,4.0
2020,12,2966,425,28,797,2,47,5,2,4,2,4,0,4,0,False,False,False,0,1,2020-11-30T14:32:47.75,4,,0.0
2020,12,2966,455,29,4866,13,13,9,0,0,0,0,0,0,0,False,False,False,0,4,2021-03-05T15:31:52.867,0,,0.0
2020,12,2966,470,29,4875,2,50,5,0,8,8,3,5,3,0,False,False,False,1,2,2020-11-30T14:50:28.01,8,,5.0
2020,12,2966,475,29,3398,13,5,5,6,0,0,0,0,0,0,False,False,False,0,3,2020-12-03T21:21:35.067,0,,0.0
2020,12,2966,480,29,4875,13,19,8,47,0,0,0,0,0,0,False,False,False,0,3,2020-11-30T17:59:33.807,0,,0.0
2020,12,2966,490,28,7224,3,2,9,3,0,0,0,0,0,0,False,False,False,0,3,2020-11-30T15:03:58.217,0,,0.0
2020,12,2966,500,28,969,13,21,6,30,0,0,0,0,0,0,False,False,False,0,3,2020-11-30T15:08:49.223,0,,0.0
2020,12,2966,550,28,7224,2,4,9,3,26,23,4,22,4,0,False,False,False,2,3,2020-12-03T21:55:25.287,26,,22.0
2020,12,2966,560,28,6360,13,4,10,12,0,0,0,0,0,0,False,False,False,0,3,2020-11-30T15:37:53.667,0,,
2020,12,2966,580,28,4912,13,26,4,5,0,0,0,0,0,0,False,False,False,0,3,2021-03-15T17:41:50.417,0,,0.0
2020,12,2966,595,29,1958,2,46,3,2,5,3,5,0,5,0,False,False,False,0,3,2020-11-30T15:50:47.857,5,,0.0
2020,12,2966,600,29,4866,2,2,9,6,33,27,22,11,22,0,False,False,False,1,3,2020-11-30T15:53:52.777,33,,11.0
2020,12,2966,605,29,4875,2,4,3,5,14,9,7,7,7,0,False,False,False,1,2,2020-12-03T20:46:17.827,14,,7.0
2020,12,2966,610,29,7378,13,24,6,20,0,0,0,0,0,0,False,False,False,0,3,2020-12-03T21:26:14.53,0,,0.0
2020,12,2966,620,29,1958,13,7,6,19,0,0,0,0,0,0,False,False,False,0,3,2021-02-25T17:28:52.163,0,,0.0
2020,12,2966,650,28,3264,2,45,5,-7,-1,6,-2,1,-2,0,False,False,False,0,1,2020-11-30T16:17:53.363,-1,,1.0
2020,12,2966,695,28,3264,2,50,3,-4,1,5,-1,2,-1,0,False,False,False,0,2,2020-12-03T21:35:55.04,1,,2.0
2020,12,2966,700,28,6360,2,8,1,22,29,7,24,5,24,0,False,False,False,1,3,2020-12-03T20:46:30.44,29,,5.0
2020,12,2966,710,28,6627,13,6,9,13,0,0,0,0,0,0,False,False,False,0,3,2020-11-30T16:32:15.187,0,,0.0
2020,12,2966,730,29,1958,2,30,5,2,12,10,10,2,10,0,True,False,False,0,3,2020-11-30T16:42:12.49,12,,2.0
2020,12,2966,755,28,7224,2,51,10,-4,4,8,1,3,1,0,True,False,False,0,3,2021-03-04T18:53:35.76,4,,3.0
2020,12,2966,760,28,969,2,4,10,5,6,1,5,1,5,0,False,False,False,0,4,2020-11-30T16:51:28.803,6,,1.0
2020,12,2966,765,28,7224,2,34,4,-4,3,7,2,1,2,0,True,False,False,0,3,2020-11-30T16:53:16.8,3,,1.0
2020,12,2966,770,28,4912,2,6,4,11,12,1,11,1,11,0,False,False,False,0,3,2020-12-03T21:37:04.947,12,,1.0
2020,12,2966,780,28,262,2,9,6,18,20,2,20,0,20,0,False,True,False,0,3,2020-12-03T15:54:40.107,20,,0.0
2020,12,2966,795,28,797,13,16,4,4,0,0,0,0,0,0,False,False,False,0,1,2020-12-03T21:37:57.55,0,,0.0
2020,12,2966,810,29,4866,2,4,9,5,8,3,6,2,6,0,False,False,False,0,3,2020-11-30T17:11:46.233,8,,2.0
2020,12,2966,815,29,3398,2,5,5,4,6,2,6,0,6,0,False,False,False,0,3,2020-12-03T21:55:42.73,6,,0.0
2020,12,2966,820,29,1958,2,4,5,5,5,0,5,0,5,0,False,False,False,0,3,2020-11-30T17:14:41.99,5,,0.0
2020,12,2966,825,29,1958,3,5,5,9,0,0,0,0,0,0,False,False,False,0,2,2020-12-03T21:39:26.473,0,,0.0
2020,12,2966,830,29,4866,13,11,6,20,0,0,0,0,0,0,False,False,False,0,3,2020-12-03T21:39:39.773,0,,0.0
2020,12,2966,850,28,797,2,47,10,3,7,4,7,0,7,0,False,False,False,0,1,2020-11-30T17:27:14.837,7,,0.0
2020,12,2966,855,28,7224,2,2,9,5,24,19,17,7,17,0,False,False,False,0,2,2020-11-30T17:29:37.087,24,,7.0
2020,12,2966,860,28,7224,2,51,9,-3,7,10,4,3,4,0,True,False,False,0,3,2020-12-03T21:55:57.797,7,,3.0
2020,12,2966,900,28,4912,3,4,10,4,0,0,0,0,0,0,True,False,False,0,3,2020-12-03T21:56:10.47,0,,0.0
2020,12,2966,905,28,7224,2,2,9,3,4,1,3,1,3,0,False,False,False,0,2,2020-11-30T17:43:02.193,4,,1.0
2020,12,2967,10,16,3938,2,11,3,14,34,20,26,8,26,0,True,False,False,1,4,2020-12-03T22:15:40.28,34,,8.0
2020,12,2967,15,16,121,3,2,10,7,0,0,0,0,0,0,False,False,False,0,2,2020-12-03T22:34:57.113,0,,0.0
2020,12,2967,35,16,3938,2,29,2,19,23,4,20,3,20,0,False,False,False,0,3,2020-12-03T21:08:18.82,23,,3.0
2020,12,2967,40,16,121,2,42,10,6,6,0,6,0,6,0,False,False,False,0,3,2020-12-03T22:35:56.313,6,,0.0
2020,12,2967,45,16,5048,13,12,5,1,0,0,0,0,0,0,False,False,False,0,6,2021-02-22T16:30:40.577,0,,0.0
2020,12,2967,70,30,793,2,4,10,9,12,3,10,2,10,0,False,False,False,0,2,2020-12-01T09:32:08.98,12,,2.0
2020,12,2967,80,30,793,3,19,6,28,0,0,0,0,0,0,False,False,False,0,2,2020-11-30T12:05:44.037,0,,0.0
2020,12,2967,85,30,793,13,4,3,9,0,0,0,0,0,0,False,False,False,0,2,2020-12-03T22:36:40.213,0,,0.0
2020,12,2967,95,16,4143,2,4,3,-1,3,4,2,1,2,0,False,False,False,0,2,2020-12-03T20:55:58.61,3,,1.0
2020,12,2967,105,16,3938,2,55,4,-3,1,4,-4,5,-4,0,False,False,False,1,4,2021-03-04T18:56:09.297,1,,5.0
2020,12,2967,125,30,63,2,39,4,5,6,1,5,1,5,0,False,False,False,0,4,2020-11-30T12:18:06.137,6,,1.0
2020,12,2967,135,30,37,13,11,2,16,0,0,0,0,0,0,True,False,False,0,1,2020-12-03T22:37:15.913,0,,0.0
2020,12,2967,145,16,3938,2,24,2,53,75,22,55,20,55,6,False,False,False,0,2,2020-11-30T12:23:42.133,75,,20.0
2020,12,2967,160,30,63,2,5,10,4,6,2,4,2,4,0,False,False,False,0,4,2020-11-30T12:25:35.547,6,,2.0
2020,12,2967,170,30,2290,3,17,4,5,0,0,0,0,0,0,False,False,False,0,3,2020-12-03T21:44:59.9,0,,0.0
2020,12,2967,185,16,3938,2,2,9,5,19,14,11,8,11,0,False,False,False,1,3,2020-12-03T21:55:19.55,19,,8.0
2020,12,2967,190,16,7176,2,4,5,3,3,0,3,0,3,0,True,False,False,0,2,2020-11-30T12:34:41.697,3,,0.0
2020,12,2967,195,16,374,2,4,6,16,14,-2,11,3,11,0,True,False,False,2,3,2020-12-01T21:43:47.553,14,,3.0
2020,12,2967,200,16,7176,13,7,2,38,0,0,0,0,0,0,False,False,False,0,2,2020-12-03T21:45:29.25,0,,0.0
2020,12,2967,205,16,3938,2,5,5,7,7,0,7,0,7,0,False,False,False,0,3,2020-12-01T21:44:01.783,7,,0.0
2020,12,2967,215,16,3938,2,35,2,24,44,20,36,8,36,6,False,False,False,1,3,2020-12-03T22:37:55.103,44,,8.0
2020,12,2967,230,30,4516,2,49,9,-1,2,3,0,2,0,0,False,False,False,0,3,2020-11-30T12:45:51.62,2,,2.0
2020,12,2967,235,30,2290,2,5,5,4,6,2,4,2,4,0,False,False,False,0,4,2020-12-03T22:56:53.38,6,,2.0
2020,12,2967,240,30,4516,3,2,10,7,0,0,0,0,0,0,True,False,False,0,3,2020-12-03T22:19:37.49,0,,0.0
2020,12,2967,260,16,374,2,4,10,11,20,9,18,2,18,0,False,False,False,0,3,2021-02-22T16:31:36.137,20,,2.0
2020,12,2967,270,16,374,2,5,3,6,12,6,9,3,9,0,False,False,False,0,3,2020-11-30T13:07:15.663,12,,3.0
2020,12,2967,275,16,121,13,44,3,-1,0,0,0,0,0,0,True,False,False,0,3,2020-12-01T21:44:35.23,0,,0.0
2020,12,2967,280,16,121,2,6,9,12,14,2,12,2,12,0,False,False,False,0,2,2020-12-03T22:57:03.18,14,,2.0
2020,12,2967,285,16,3938,13,7,2,28,0,0,0,0,0,0,False,False,False,0,2,2021-02-22T16:32:28.737,0,,0.0
2020,12,2967,290,16,6565,2,30,10,0,2,2,1,1,1,0,True,False,False,0,4,2020-11-30T13:14:48.507,2,,1.0
2020,12,2967,295,16,374,2,6,4,9,9,0,9,0,9,0,False,False,False,0,3,2020-11-30T13:16:54.337,9,,0.0
2020,12,2967,310,16,7176,2,26,10,4,5,1,4,1,4,0,False,False,False,0,3,2020-11-30T13:21:09.073,5,,1.0
2020,12,2967,315,16,4143,2,12,5,10,13,3,13,0,13,0,False,False,False,0,4,2020-11-30T13:23:04.89,13,,0.0
2020,12,2967,330,30,4516,2,5,10,4,9,5,7,2,7,0,False,False,False,0,2,2020-12-03T22:52:41.62,9,,
2020,12,2967,335,30,793,13,4,3,8,0,0,0,0,0,0,False,False,False,0,2,2021-02-22T16:33:26.073,0,,0.0
2020,12,2967,340,30,63,2,13,9,3,9,6,6,3,6,0,False,False,False,0,4,2020-11-30T13:34:11.58,9,,3.0
2020,12,2967,345,30,37,2,5,5,2,2,0,2,0,2,0,False,False,False,0,3,2020-11-30T13:35:51.913,2,,0.0
2020,12,2967,350,30,4516,2,13,10,4,8,4,6,2,6,0,False,False,False,0,3,2020-11-30T13:38:14.867,8,,2.0
2020,12,2967,360,30,63,2,17,7,23,29,6,24,5,24,0,False,False,False,0,4,2020-12-03T22:57:11.06,29,,5.0
2020,12,2967,365,30,6414,2,46,3,4,37,33,12,25,12,6,False,False,False,1,1,2020-12-03T21:55:59.87,37,,25.0
2020,12,2967,380,16,121,2,2,9,6,7,1,7,0,7,0,False,False,False,0,3,2020-11-30T13:47:43.813,7,,0.0
2020,12,2967,390,16,3938,2,49,9,-3,4,7,4,0,4,0,True,False,False,0,3,2021-02-22T16:34:24.527,4,,
2020,12,2967,395,16,3938,2,4,5,7,7,0,7,0,7,0,False,False,False,0,2,2020-12-03T22:21:29.383,7,,0.0
2020,12,2967,400,16,4143,2,5,3,5,8,3,8,0,8,0,False,False,False,0,2,2020-12-01T22:19:11.437,8,,0.0
2020,12,2967,410,16,4143,2,4,10,7,9,2,7,2,7,0,False,False,False,1,2,2020-11-30T13:58:53.763,9,,2.0
2020,12,2967,420,16,374,2,2,10,6,14,8,14,0,14,0,False,False,False,0,3,2020-11-30T14:02:26.977,14,,0.0
2020,12,2967,425,16,374,2,6,4,5,8,3,7,1,7,0,False,False,False,0,3,2020-12-03T20:57:35.613,8,,1.0
2020,12,2967,430,16,34,2,46,3,1,2,1,2,0,2,0,False,False,False,0,1,2020-11-30T14:06:36.567,2,,0.0
2020,12,2967,485,30,63,2,2,4,5,8,3,6,2,6,0,False,False,False,0,3,2020-11-30T14:23:37.567,8,,2.0
2020,12,2967,490,30,63,2,35,2,24,48,24,43,5,43,0,False,False,False,0,4,2020-12-03T22:23:08.493,48,,5.0
2020,12,2967,500,30,4937,2,47,10,-3,-4,-1,-4,0,-4,0,True,False,False,0,1,2020-12-01T09:33:12.52,-4,,0.0
2020,12,2967,520,16,374,2,30,9,-2,2,4,2,0,2,0,False,False,False,0,4,2021-02-22T16:36:44.12,2,,0.0
2020,12,2967,525,16,3938,2,19,6,21,21,0,21,0,21,0,False,False,False,0,2,2020-11-30T14:50:35.487,21,,0.0
2020,12,2967,535,16,5039,13,5,3,10,0,0,0,0,0,0,False,False,False,0,3,2021-03-08T15:06:36.737,0,,
2020,12,2967,540,16,3938,2,4,10,5,4,-1,4,0,4,0,False,False,False,0,3,2020-11-30T14:57:21.097,4,,0.0
2020,12,2967,555,16,3938,2,5,5,6,6,0,6,0,6,0,False,False,False,0,3,2020-11-30T15:01:47.163,6,,0.0
2020,12,2967,560,16,3938,2,9,2,18,20,2,19,1,19,6,False,False,False,0,2,2020-11-30T15:03:45.417,20,,1.0
2020,12,2967,575,30,6414,13,47,5,2,0,0,0,0,0,0,False,False,False,0,1,2020-12-03T22:58:15.96,0,,0.0
2020,12,2967,585,30,63,2,13,9,4,11,7,8,3,8,0,False,False,False,0,3,2020-12-03T22:42:56.403,11,,
2020,12,2967,590,30,4516,2,17,7,40,44,4,44,0,44,0,False,False,False,0,3,2021-02-22T16:38:54.55,44,,0.0
2020,12,2967,595,30,7268,13,9,6,25,0,0,0,0,0,0,False,False,False,0,4,2021-03-05T15:34:47.733,0,,0.0
2020,12,2967,600,16,7176,13,17,7,19,0,0,0,0,0,0,False,False,False,0,3,2020-11-30T15:30:25.027,0,,0.0
2020,12,2967,610,16,121,13,7,3,10,0,0,0,0,0,0,False,False,False,0,3,2020-12-03T22:43:24.073,0,,0.0
2020,12,2967,620,30,37,2,49,9,-2,9,11,9,0,9,0,False,False,False,0,2,2020-12-03T21:19:22.54,9,,0.0
2020,12,2967,635,30,793,13,2,9,11,0,0,0,0,0,0,False,False,False,0,3,2021-03-05T15:35:42.72,0,,0.0
2020,12,2967,645,16,34,2,44,3,-3,8,11,-4,12,-4,0,True,False,False,2,1,2020-12-03T22:43:59.683,8,,12.0
2020,12,2967,675,30,2290,2,5,5,9,14,5,13,1,13,0,False,False,False,0,4,2020-11-30T16:11:48.193,14,,1.0
2020,12,2967,680,30,2290,2,4,4,6,9,3,7,2,7,0,False,False,False,0,3,2020-11-30T16:14:01.903,9,,2.0
2020,12,2967,685,30,4516,2,6,4,5,8,3,6,2,6,0,False,False,False,0,3,2020-12-03T20:59:18.39,8,,2.0
2020,12,2967,690,30,2290,13,4,10,8,0,0,0,0,0,0,False,False,False,0,3,2020-11-30T16:17:54.857,0,,0.0
2020,12,2967,695,30,793,13,9,2,31,0,0,0,0,0,0,False,False,False,0,2,2021-02-22T16:54:41.21,0,,0.0
2020,12,2967,700,30,4516,2,5,5,5,7,2,7,0,7,0,False,False,False,0,3,2020-11-30T16:21:09.337,7,,0.0
2020,12,2967,705,30,793,2,9,2,25,31,6,31,0,31,6,False,False,False,0,3,2020-11-30T17:36:19.08,31,,0.0
2020,12,2967,720,16,121,2,4,9,5,11,6,9,2,9,0,False,False,False,0,3,2020-11-30T16:26:11.997,11,,2.0
2020,12,2967,730,16,374,2,13,9,3,3,0,3,0,3,0,False,False,False,0,3,2020-11-30T16:29:07.827,3,,0.0
2020,12,2967,735,16,7176,2,12,7,15,15,0,15,0,15,0,False,False,False,0,3,2020-12-03T21:49:41.28,15,,0.0
2020,12,2967,750,16,374,2,12,3,14,18,4,11,7,11,0,False,False,False,1,3,2021-03-03T19:33:31.907,18,,
2020,12,2967,755,16,7176,13,11,2,36,0,0,0,0,0,0,False,False,False,0,3,2021-03-05T15:36:45.403,0,,
2020,12,2967,765,16,3938,13,11,3,8,0,0,0,0,0,0,True,False,False,0,4,2020-12-03T22:10:41.493,0,,0.0
2020,12,2967,770,16,374,2,53,9,-2,12,14,3,9,3,0,False,False,False,0,4,2020-12-03T21:56:37.84,12,,
2020,12,2967,775,16,4143,2,32,10,-8,3,11,0,3,0,0,False,False,False,0,3,2020-11-30T16:52:01.633,3,,3.0
2020,12,2967,780,16,4143,13,8,7,24,0,0,0,0,0,0,False,False,False,0,2,2020-12-03T22:44:33.623,0,,0.0
2020,12,2967,790,30,793,13,29,6,18,0,0,0,0,0,0,False,False,False,0,2,2020-11-30T16:56:14.257,0,,0.0
2020,12,2967,795,30,2290,2,5,5,3,5,2,4,1,4,0,False,False,False,0,3,2020-12-03T21:50:44.24,5,,1.0
2020,12,2967,800,30,4516,2,2,10,7,7,0,7,0,7,0,False,False,False,0,3,2020-12-03T21:37:34.853,7,,0.0
2020,12,2967,805,30,37,13,9,2,20,0,0,0,0,0,0,False,False,False,0,3,2020-11-30T17:36:02.797,0,,
2020,12,2967,810,30,4937,2,47,10,2,8,6,7,1,7,0,False,False,False,0,1,2020-12-03T22:27:51.66,8,,1.0
2020,12,2967,815,30,4937,2,46,9,-2,6,8,0,6,0,0,False,False,False,1,1,2020-11-30T17:06:29.893,6,,6.0
2020,12,2967,820,30,4516,2,4,10,3,10,7,10,0,10,0,False,False,False,0,3,2020-11-30T17:08:29.75,10,,0.0
2020,12,2967,835,30,4516,2,5,3,9,11,2,10,1,10,0,False,False,False,0,3,2021-02-22T16:41:56.487,11,,1.0
2020,12,2967,840,30,7893,13,2,4,7,0,0,0,0,0,0,False,False,False,0,3,2020-12-03T22:57:32.35,0,,0.0
2020,12,2967,845,30,793,2,5,3,7,7,0,7,0,7,6,False,False,False,0,3,2020-11-30T17:18:29.083,7,,0.0
2020,12,2967,900,16,7681,2,47,10,1,2,1,0,2,0,0,False,False,False,0,1,2020-11-30T17:28:06.837,2,,2.0
2020,12,2967,905,16,3938,2,3,3,8,8,0,8,0,8,0,False,False,False,0,2,2020-12-03T21:52:02.99,8,,0.0
2020,12,2968,10,12,467,2,53,9,-2,11,13,6,5,6,0,False,False,False,1,4,2020-11-30T11:34:38.42,11,,5.0
2020,12,2968,15,12,4537,13,28,4,0,0,0,0,0,0,0,False,False,False,0,1,2020-12-03T22:59:13.803,0,,0.0
2020,12,2968,30,12,4511,2,30,5,0,2,2,0,2,0,0,False,False,False,0,4,2020-11-30T11:41:43.223,2,,2.0
2020,12,2968,35,12,6691,2,13,10,0,8,8,6,2,6,0,False,False,False,0,3,2020-11-30T11:43:36.843,8,,2.0
2020,12,2968,40,12,6691,2,44,3,-4,5,9,5,0,5,0,True,False,False,0,3,2020-12-03T21:33:32.623,5,,0.0
2020,12,2968,70,12,556,13,2,10,6,0,0,0,0,0,0,False,False,False,0,3,2020-11-30T11:54:01.76,0,,0.0
2020,12,2968,75,12,556,2,12,9,12,12,0,12,0,12,6,True,False,False,0,2,2020-11-30T11:56:28.88,12,,0.0
2020,12,2968,90,6,464,2,30,5,-2,3,5,1,2,1,0,False,False,False,0,4,2021-02-22T17:27:13.017,3,,2.0
2020,12,2968,105,6,7728,13,5,10,6,0,0,0,0,0,0,False,False,False,0,4,2020-11-30T12:06:01.06,0,,0.0
2020,12,2968,110,6,464,13,29,9,9,0,0,0,0,0,0,False,False,False,0,3,2020-11-30T18:01:50.94,0,,0.0
2020,12,2968,125,12,556,2,5,3,4,8,4,3,5,3,0,False,False,False,0,3,2020-12-02T18:00:05.337,8,,5.0
2020,12,2968,135,12,6356,2,12,4,5,15,10,8,7,8,0,False,False,False,1,3,2021-03-03T19:42:59.147,15,,7.0
2020,12,2968,140,12,6356,13,9,2,34,0,0,0,0,0,0,False,False,False,0,3,2020-12-03T21:33:32.623,0,,
2020,12,2968,165,12,556,2,6,9,3,11,8,11,0,11,0,False,False,False,0,3,2020-12-03T23:38:55.273,11,,0.0
2020,12,2968,175,12,467,2,32,3,5,5,0,5,0,5,6,False,False,False,0,4,2020-11-30T12:40:19.267,5,,0.0
2020,12,2968,190,6,7728,2,30,9,-1,8,9,7,1,7,0,False,False,False,0,4,2020-11-30T18:03:03.397,8,,1.0
2020,12,2968,195,6,464,2,8,7,16,20,4,20,0,20,0,False,False,False,0,2,2020-11-30T17:59:36.03,20,,0.0
2020,12,2968,210,6,464,2,2,9,7,16,9,11,5,11,0,False,False,False,0,3,2020-11-30T12:54:52.853,16,,5.0
2020,12,2968,215,6,7725,13,22,8,38,0,0,0,0,0,0,False,False,False,0,3,2020-11-30T12:57:34.967,0,,0.0
2020,12,2968,220,12,556,13,23,1,38,0,0,0,0,0,0,False,False,False,0,2,2021-02-22T17:28:41.537,0,,0.0
2020,12,2968,225,12,6691,2,5,5,4,8,4,6,2,6,0,False,False,False,0,3,2020-11-30T13:07:50.417,8,,2.0
2020,12,2968,230,12,556,2,2,9,5,8,3,8,0,8,0,False,False,False,0,3,2020-11-30T13:09:21.567,8,,0.0
2020,12,2968,240,12,556,3,5,5,13,0,0,0,0,0,0,False,False,False,0,2,2020-12-03T23:09:36.847,0,,
2020,12,2968,250,12,556,2,18,10,0,15,15,15,0,15,0,False,False,False,0,3,2020-12-03T23:24:03.44,15,,0.0
2020,12,2968,255,12,4511,2,30,9,1,4,3,4,0,4,0,False,False,False,0,4,2020-12-03T23:12:11.743,4,,0.0
2020,12,2968,275,12,4511,2,13,9,5,14,9,10,4,10,0,False,False,False,0,3,2020-12-03T23:12:46.64,14,,4.0
2020,12,2968,290,12,6691,2,13,10,2,2,0,2,0,2,6,False,False,False,0,3,2021-03-08T15:09:50.857,2,,0.0
2020,12,2968,310,6,7725,13,4,7,19,0,0,0,0,0,0,False,False,False,0,3,2020-11-30T13:59:29.827,0,,0.0
2020,12,2968,315,6,7725,2,6,10,4,12,8,8,4,8,0,True,False,False,1,2,2020-11-30T17:54:43.793,12,,
2020,12,2968,340,6,6786,2,16,10,4,7,3,6,1,6,0,False,False,False,0,1,2020-12-03T23:13:40.047,7,,1.0
2020,12,2968,345,6,6328,2,5,3,12,12,0,12,0,12,0,False,False,False,0,3,2021-02-22T17:30:54.173,12,,0.0
2020,12,2968,360,6,7725,2,5,3,12,12,0,12,0,12,0,True,False,False,0,2,2020-11-30T14:12:03.723,12,,0.0
2020,12,2968,380,6,7725,2,4,5,3,9,6,3,6,3,0,False,False,False,1,3,2021-03-08T15:11:15.49,9,,6.0
2020,12,2968,385,6,464,13,5,5,6,0,0,0,0,0,0,False,False,False,0,3,2020-11-30T14:18:38.367,0,,0.0
2020,12,2968,390,6,6790,2,4,10,5,6,1,6,0,6,0,False,False,False,0,3,2020-11-30T14:20:16.387,6,,0.0
2020,12,2968,395,6,6786,2,47,5,-2,13,15,-1,14,-1,0,False,False,False,1,1,2020-11-30T14:21:51.257,13,,14.0
2020,12,2968,415,6,464,13,30,10,-2,0,0,0,0,0,0,False,False,False,0,3,2020-12-03T23:39:40.727,0,,0.0
2020,12,2968,420,6,7728,13,4,10,3,0,0,0,0,0,0,False,False,False,0,4,2020-11-30T14:27:17.713,0,,
2020,12,2968,425,6,464,2,4,10,1,1,0,1,0,1,6,False,False,False,0,3,2020-12-03T22:55:19.297,1,,0.0
2020,12,2968,455,6,7725,2,5,2,15,13,-2,13,0,13,0,False,False,False,0,4,2020-12-03T21:33:32.623,13,,0.0
2020,12,2968,480,12,6876,2,32,9,1,5,4,4,1,4,0,True,False,False,1,4,2021-02-22T17:32:52.067,5,,1.0
2020,12,2968,495,12,467,3,46,3,-1,0,0,0,0,0,0,False,False,False,0,4,2020-11-30T14:56:48.74,0,,0.0
2020,12,2968,500,12,6691,13,9,8,35,0,0,0,0,0,0,False,False,False,0,3,2020-11-30T14:59:01.13,0,,0.0
2020,12,2968,505,12,4537,2,50,10,-3,0,3,-2,2,-2,0,False,False,False,0,3,2020-11-30T15:00:35.397,0,,2.0
2020,12,2968,520,6,7725,13,4,3,7,0,0,0,0,0,0,False,False,False,0,2,2020-11-30T15:06:19.3,0,,0.0
2020,12,2968,525,6,6328,13,35,7,28,0,0,0,0,0,0,False,False,False,0,3,2021-03-05T15:29:34.93,0,,0.0
2020,12,2968,545,12,4511,2,23,1,35,39,4,36,3,36,6,False,False,False,0,4,2020-11-30T15:20:26.933,39,,3.0
2020,12,2968,560,6,464,13,4,9,5,0,0,0,0,0,0,False,False,False,0,3,2020-11-30T15:23:12.573,0,,0.0
2020,12,2968,570,6,7725,13,6,8,20,0,0,0,0,0,0,False,False,False,0,2,2020-12-03T21:33:32.623,0,,0.0
2020,12,2968,585,12,6691,13,35,6,15,0,0,0,0,0,0,True,False,False,0,4,2020-11-30T15:31:56.403,0,,0.0
2020,12,2968,590,12,6356,2,6,10,11,24,13,24,0,24,0,False,False,False,0,3,2020-11-30T15:33:50.877,24,,0.0
2020,12,2968,645,6,464,13,2,9,5,0,0,0,0,0,0,False,False,False,0,2,2020-11-30T15:57:09.39,0,,0.0
2020,12,2968,650,6,6337,2,4,10,5,10,5,7,3,7,0,False,False,False,0,3,2020-11-30T15:58:41.053,10,,3.0
2020,12,2968,660,6,464,2,2,10,4,12,8,6,6,6,0,False,False,False,1,3,2020-11-30T16:30:35.137,12,,6.0
2020,12,2968,680,6,7725,13,4,10,11,0,0,0,0,0,0,False,False,False,0,3,2020-11-30T16:37:07.573,0,,0.0
2020,12,2968,685,6,6328,2,5,5,11,12,1,12,0,12,0,True,False,False,0,3,2020-11-30T17:47:10.72,12,,0.0
2020,12,2968,690,6,6328,13,17,9,13,0,0,0,0,0,0,False,False,False,0,3,2020-12-03T23:18:05.133,0,,0.0
2020,12,2968,700,6,666,13,24,2,18,0,0,0,0,0,0,False,False,False,0,2,2020-12-01T16:50:59.18,0,,0.0
2020,12,2968,705,6,666,2,2,9,7,12,5,10,2,10,0,False,False,False,0,2,2020-11-30T16:44:21.167,12,,2.0
2020,12,2968,710,6,464,2,2,9,6,6,0,6,0,6,6,False,False,False,0,3,2020-11-30T16:46:01.383,6,,0.0
2020,12,2968,745,12,556,13,17,1,40,0,0,0,0,0,0,False,False,False,0,3,2020-11-30T16:53:22.06,0,,0.0
2020,12,2968,755,6,666,2,35,9,12,16,4,13,3,13,0,False,False,False,1,3,2020-12-03T21:33:32.623,16,,3.0
2020,12,2968,760,6,6786,2,4,4,2,8,6,2,6,2,0,False,False,False,0,1,2020-11-30T16:58:37.89,8,,6.0
2020,12,2968,770,6,7725,3,3,2,16,0,0,0,0,0,0,False,False,False,0,2,2020-11-30T17:00:21.1,0,,0.0
2020,12,2968,775,6,6328,2,6,10,2,4,2,3,1,3,0,False,False,False,0,3,2020-11-30T17:01:50.34,4,,1.0
2020,12,2968,780,6,464,2,2,10,6,7,1,6,1,6,0,True,False,False,0,2,2020-11-30T17:06:14.69,7,,1.0
2020,12,2968,785,6,7728,13,17,1,21,0,0,0,0,0,0,False,False,False,0,3,2020-12-03T23:39:08.88,0,,0.0
2020,12,2968,790,6,6790,2,4,3,6,10,4,9,1,9,0,False,False,False,0,2,2020-11-30T17:07:47.05,10,,1.0
2020,12,2968,795,6,6786,2,5,4,1,9,8,6,3,6,0,False,False,False,1,1,2020-12-03T20:59:53.39,9,,3.0
2020,12,2968,800,6,666,2,4,10,4,4,0,4,0,4,0,False,False,False,0,3,2020-11-30T17:13:18.787,4,,0.0
2020,12,2968,805,6,6786,3,16,10,2,0,0,0,0,0,0,False,False,False,0,1,2020-11-30T17:15:50.523,0,,0.0
2020,12,2968,815,6,464,2,5,5,9,9,0,9,0,9,0,False,False,False,0,3,2020-11-30T17:25:40.663,9,,0.0
2020,12,2968,825,6,6328,13,7,3,3,0,0,0,0,0,0,False,False,False,0,3,2021-02-22T17:33:35.273,0,,0.0
2020,12,2968,830,6,6786,2,49,5,-3,3,6,2,1,2,6,False,False,False,0,2,2020-12-01T16:51:15.987,3,,1.0
2020,12,2968,845,12,467,3,12,3,14,0,0,0,0,0,0,False,False,False,0,4,2021-03-09T12:46:45.62,0,,0.0
2020,12,2968,860,12,556,2,18,5,0,7,7,4,3,4,0,False,False,False,0,3,2020-12-03T23:22:52.287,7,,3.0
2020,12,2968,870,12,4511,2,46,9,1,8,7,4,4,4,0,True,False,False,0,4,2020-11-30T17:40:35.913,8,,4.0
2020,12,2969,15,24,565,13,4,10,3,0,0,0,0,0,0,False,False,False,0,4,2020-12-01T11:54:01.01,0,,0.0
2020,12,2969,20,24,4382,13,2,4,5,0,0,0,0,0,0,False,False,False,0,3,2020-12-01T11:56:17.98,0,,0.0
2020,12,2969,25,24,264,3,4,5,6,0,0,0,0,0,0,False,False,False,0,2,2020-12-01T11:58:13.137,0,,0.0
2020,12,2969,35,27,5050,2,45,5,-3,7,10,7,0,7,0,False,False,False,0,1,2021-02-22T18:03:22.353,7,,
2020,12,2969,40,27,5050,2,44,3,-1,12,13,12,0,12,0,True,False,False,0,1,2020-12-01T12:05:13.253,12,,0.0
2020,12,2969,45,27,7408,2,2,9,7,13,6,9,4,9,0,False,False,False,2,2,2020-12-05T14:48:50.607,13,,4.0
2020,12,2969,60,27,7408,2,2,10,7,10,3,10,0,10,0,False,False,False,0,2,2020-12-01T12:13:04.353,10,,0.0
2020,12,2969,70,27,7408,2,4,9,5,8,3,7,1,7,0,True,False,False,1,3,2020-12-01T12:17:15.907,8,,1.0
2020,12,2969,95,27,7408,13,2,9,3,0,0,0,0,0,0,False,False,False,0,3,2020-12-01T12:36:50.627,0,,0.0
2020,12,2969,110,27,5069,2,34,4,-4,-5,-1,-5,0,-5,0,True,False,False,0,3,2020-12-01T12:40:01.57,-5,,0.0
2020,12,2969,125,24,7798,13,19,2,23,0,0,0,0,0,0,False,False,False,0,2,2021-03-09T17:02:48.35,0,,0.0
2020,12,2969,135,27,4835,13,12,3,10,0,0,0,0,0,0,False,False,False,0,3,2020-12-01T12:55:44.62,0,,0.0
2020,12,2969,145,27,7408,2,2,9,6,7,1,7,0,7,0,False,False,False,0,3,2020-12-05T15:05:01.22,7,,0.0
2020,12,2969,160,24,7798,2,34,4,-4,3,7,2,1,2,0,True,False,False,0,3,2020-12-01T13:05:05.067,3,,1.0
2020,12,2969,170,24,6373,13,8,2,37,0,0,0,0,0,0,False,False,False,0,3,2020-12-05T14:11:30.86,0,,0.0
2020,12,2969,190,27,153,13,44,3,-5,0,0,0,0,0,0,True,False,False,0,1,2020-12-01T13:14:55.57,0,,0.0
2020,12,2969,200,27,7408,2,49,10,-1,11,12,8,3,8,0,False,False,False,0,2,2021-02-22T18:58:43.17,11,,3.0
2020,12,2969,210,24,7799,2,30,3,-3,1,4,0,1,0,0,True,False,False,0,2,2021-02-22T18:10:29.68,1,,1.0
2020,12,2969,225,24,264,2,5,3,6,6,0,6,0,6,0,False,False,False,0,3,2020-12-01T13:25:39.197,6,,0.0
2020,12,2969,240,27,650,2,35,10,8,18,10,18,0,18,0,False,False,False,0,3,2021-03-09T17:07:18.197,18,,0.0
2020,12,2969,250,27,4835,13,6,10,8,0,0,0,0,0,0,False,False,False,0,3,2020-12-01T13:39:25.55,0,,0.0
2020,12,2969,255,27,7408,2,8,1,45,52,7,46,6,46,0,False,False,False,0,2,2020-12-01T13:43:40.72,52,,6.0
2020,12,2969,265,27,5069,2,9,3,1,1,0,1,0,1,6,False,False,False,0,2,2020-12-05T14:47:15.49,1,,0.0
2020,12,2969,310,27,5050,2,12,4,1,6,5,5,1,5,0,False,False,False,0,1,2020-12-01T14:11:55.883,6,,1.0
2020,12,2969,330,27,650,2,49,3,-1,2,3,1,1,1,0,False,False,False,0,2,2021-02-22T19:17:05.693,2,,1.0
2020,12,2969,335,27,7408,2,13,10,7,17,10,16,1,16,0,False,False,False,0,3,2021-02-25T17:33:18.72,17,,1.0
2020,12,2969,370,24,7798,13,4,5,10,0,0,0,0,0,0,False,False,False,0,2,2020-12-01T14:39:15.513,0,,0.0
2020,12,2969,375,24,6389,2,4,5,8,10,2,10,0,10,0,False,False,False,0,2,2020-12-01T14:40:55.733,10,,0.0
2020,12,2969,380,24,4382,13,5,3,4,0,0,0,0,0,0,False,False,False,0,3,2020-12-01T14:42:10.377,0,,0.0
2020,12,2969,385,24,7798,2,50,9,-4,8,12,1,7,1,0,False,False,False,1,3,2020-12-05T15:08:16.283,8,,7.0
2020,12,2969,390,24,6937,2,50,3,-4,2,6,1,1,1,0,True,False,False,1,2,2020-12-05T14:49:59.753,2,,1.0
2020,12,2969,395,24,6937,3,5,3,3,0,0,0,0,0,0,False,False,False,0,1,2020-12-01T14:51:49.77,0,,
2020,12,2969,435,24,6373,2,51,10,-3,3,6,0,3,0,0,True,False,False,0,3,2020-12-05T15:32:07.697,3,,3.0
2020,12,2969,445,24,6373,2,36,4,3,3,0,3,0,3,6,False,False,False,0,4,2020-12-05T14:55:54.303,3,,0.0
2020,12,2969,475,27,7408,13,19,6,45,0,0,0,0,0,0,False,False,False,0,2,2020-12-01T15:17:56.157,0,,0.0
2020,12,2969,480,27,4835,2,31,9,0,3,3,1,2,1,0,False,False,False,0,4,2020-12-01T15:20:06.843,3,,2.0
2020,12,2969,485,27,153,2,12,5,0,0,0,0,0,0,0,True,False,False,0,4,2020-12-01T15:21:43.737,0,,0.0
2020,12,2969,505,24,264,2,2,9,8,9,1,9,0,9,0,False,False,False,0,2,2020-12-01T15:32:34.21,9,,0.0
2020,12,2969,510,24,6937,3,5,5,4,0,0,0,0,0,0,False,False,False,0,1,2020-12-01T15:34:06.93,0,,0.0
2020,12,2969,515,24,6373,2,4,3,9,9,0,9,0,9,0,False,False,False,0,3,2020-12-02T16:32:25.983,9,,0.0
2020,12,2969,525,24,565,2,35,5,11,17,6,17,0,17,0,False,False,False,0,4,2020-12-01T15:44:09.36,17,,0.0
2020,12,2969,530,24,6373,2,17,10,12,16,4,13,3,13,0,False,False,False,0,4,2020-12-05T14:11:30.86,16,,3.0
2020,12,2969,535,24,7798,2,50,9,-2,0,2,-2,2,-2,0,True,False,False,1,3,2020-12-05T14:11:30.86,0,,2.0
2020,12,2969,540,24,565,13,42,10,5,0,0,0,0,0,0,False,False,False,0,3,2020-12-05T14:11:30.86,0,,0.0
2020,12,2969,570,27,7408,2,5,3,7,9,2,9,0,9,0,False,False,False,0,2,2020-12-01T15:56:32.533,9,,0.0
2020,12,2969,585,27,7408,2,6,7,18,19,1,19,0,19,0,False,False,False,0,2,2021-03-09T17:11:01.727,19,,0.0
2020,12,2969,590,27,4835,2,13,10,6,8,2,7,1,7,0,False,False,False,0,4,2021-02-22T20:15:18.87,8,,1.0
2020,12,2969,595,27,5069,2,49,3,-5,-2,3,-2,0,-2,0,False,False,False,0,2,2021-02-22T20:17:18.79,-2,,0.0
2020,12,2969,600,27,650,2,47,5,3,3,0,3,0,3,0,False,False,False,0,3,2020-12-01T16:08:08.897,3,,0.0
2020,12,2969,615,24,6937,2,5,3,2,5,3,4,1,4,0,False,False,False,0,1,2020-12-01T16:11:28.193,5,,1.0
2020,12,2969,620,24,4382,2,51,10,-4,3,7,2,1,2,0,False,False,False,0,3,2020-12-05T15:00:22.47,3,,1.0
2020,12,2969,625,24,6373,2,4,10,7,7,0,7,0,7,0,False,False,False,0,3,2020-12-01T16:14:06.66,7,,0.0
2020,12,2969,630,24,565,2,38,10,1,3,2,3,0,3,0,False,False,False,0,4,2020-12-05T14:11:30.86,3,,0.0
2020,12,2969,645,24,6808,2,4,3,5,5,0,5,0,5,0,False,False,False,0,3,2020-12-01T16:24:30.453,5,,0.0
2020,12,2969,650,24,565,13,46,3,1,0,0,0,0,0,0,False,False,False,0,4,2020-12-05T15:01:19.757,0,,0.0
2020,12,2969,660,27,7408,2,9,6,31,31,0,31,0,31,0,False,False,False,0,3,2021-01-12T23:49:03.653,31,,0.0
2020,12,2969,665,27,4835,13,32,5,1,0,0,0,0,0,0,False,False,False,0,4,2020-12-01T16:33:10.527,0,,0.0
2020,12,2969,675,27,7408,3,9,6,22,0,0,0,0,0,0,False,False,False,0,2,2020-12-01T16:39:26.003,0,,0.0
2020,12,2969,680,27,153,2,48,9,-7,7,14,3,4,3,0,True,False,False,1,1,2021-02-22T21:24:31.567,7,,4.0
2020,12,2969,700,24,6808,2,2,10,9,11,2,11,0,11,0,False,False,False,0,2,2020-12-01T16:45:25.667,11,,0.0
2020,12,2969,705,24,6373,2,5,5,3,10,7,5,5,5,0,False,False,False,0,4,2020-12-01T16:47:42.2,10,,5.0
2020,12,2969,710,24,6808,13,3,5,9,0,0,0,0,0,0,False,True,True,0,2,2020-12-01T16:49:37.91,0,,
2020,12,2969,715,24,6373,13,17,8,29,0,0,0,0,0,0,False,False,False,0,4,2020-12-01T16:54:11.693,0,,
2020,12,2969,720,24,6373,13,7,2,21,0,0,0,0,0,0,True,False,False,0,3,2020-12-01T16:59:40.773,0,,0.0
2020,12,2969,725,24,7798,13,9,6,21,0,0,0,0,0,0,False,False,False,0,3,2020-12-05T14:43:30.417,0,,0.0
2020,12,2969,730,24,6389,2,45,5,-6,6,12,3,3,3,0,False,False,False,0,1,2020-12-01T17:02:20.923,6,,3.0
2020,12,2969,735,24,6373,13,4,8,15,0,0,0,0,0,0,False,False,False,0,3,2020-12-01T17:04:00.01,0,,0.0
2020,12,2969,755,27,650,13,4,3,13,0,0,0,0,0,0,False,False,False,0,2,2021-03-09T17:17:30.97,0,,0.0
2020,12,2969,760,27,650,13,9,6,18,0,0,0,0,0,0,False,False,False,0,2,2020-12-05T15:02:22.637,0,,
2020,12,2969,790,24,264,13,19,6,21,0,0,0,0,0,0,False,False,False,0,2,2021-03-09T17:19:26.34,0,,0.0
2020,12,2969,795,24,6373,2,5,10,12,27,15,12,15,12,0,True,False,False,1,3,2020-12-01T17:25:45.66,27,,15.0
2020,12,2969,805,24,6937,2,4,4,2,10,8,9,1,9,0,False,False,False,0,1,2020-12-01T17:28:25.803,10,,
2020,12,2969,810,24,6389,13,12,5,8,0,0,0,0,0,0,False,False,False,0,1,2020-12-01T17:30:17.83,0,,0.0
2020,12,2969,815,24,6389,2,48,10,-7,-1,6,-1,0,-1,0,False,False,False,0,1,2020-12-01T17:31:42.617,-1,,0.0
2020,12,2969,820,24,7798,13,6,7,16,0,0,0,0,0,0,False,False,False,0,3,2020-12-05T14:45:57.027,0,,0.0
2020,12,2969,865,24,6389,2,4,10,2,8,6,7,1,7,0,False,False,False,0,1,2020-12-01T17:38:48.523,8,,1.0
2020,12,2969,870,24,6389,2,4,10,3,17,14,15,2,15,0,False,False,False,0,1,2020-12-01T17:39:53.97,17,,2.0
2020,12,2969,880,24,565,2,19,1,33,33,0,33,0,33,6,False,False,False,0,4,2020-12-05T15:08:41.797,33,,0.0
2020,13,2970,20,9,7816,2,46,3,1,4,3,4,0,4,0,True,False,False,0,3,2020-12-11T16:33:17.593,4,,0.0
2020,13,2970,25,9,7816,2,26,10,3,9,6,5,4,5,0,False,False,False,0,3,2020-12-09T16:51:42.243,9,,4.0
2020,13,2970,35,9,7183,2,48,10,-5,11,16,-5,16,-5,0,False,False,False,2,1,2020-12-11T15:23:37.66,11,,
2020,13,2970,40,9,4202,2,45,5,-4,-4,0,-4,0,-4,0,True,False,False,0,1,2020-12-09T16:52:12.113,-4,,0.0
2020,13,2970,45,9,7816,2,50,5,-2,0,2,0,0,0,0,True,False,False,0,2,2020-12-11T14:45:29.25,0,,0.0
2020,13,2970,70,3,902,2,48,3,-6,1,7,-2,3,-2,0,False,False,False,0,1,2020-12-11T14:45:29.25,1,,3.0
2020,13,2970,75,3,6936,2,6,10,3,3,0,3,0,3,0,False,False,False,0,3,2020-12-11T14:45:29.25,3,,0.0
2020,13,2970,80,3,6936,3,13,4,4,0,0,0,0,0,0,False,False,False,0,3,2021-03-05T15:08:24.62,0,,0.0
2020,13,2970,95,9,2568,2,13,5,2,2,0,2,0,2,0,False,False,False,0,4,2020-12-09T16:52:41.583,2,,0.0
2020,13,2970,105,9,6436,13,22,3,13,0,0,0,0,0,0,False,False,False,0,2,2020-12-11T14:30:30.057,0,,0.0
2020,13,2970,140,3,6936,2,18,5,-2,4,6,2,2,2,0,False,False,False,0,2,2020-12-09T12:14:21.02,4,,2.0
2020,13,2970,145,3,670,2,6,4,10,12,2,12,0,12,0,False,False,False,0,3,2020-12-09T12:18:54.27,12,,0.0
2020,13,2970,165,9,7816,2,5,3,13,14,1,14,0,14,0,False,False,False,0,3,2020-12-09T16:53:03.43,14,,0.0
2020,13,2970,180,9,6436,2,7,3,13,13,0,0,13,0,6,False,False,False,0,3,2021-02-25T16:11:18.993,13,,13.0
2020,13,2970,200,3,6936,2,2,4,8,8,0,8,0,8,0,False,False,False,0,3,2020-12-11T14:30:39.067,8,,0.0
2020,13,2970,230,3,6918,2,47,5,0,4,4,4,0,4,0,False,False,False,0,1,2020-12-09T12:52:23.46,4,,0.0
2020,13,2970,245,9,322,2,4,3,7,11,4,8,3,8,0,False,False,False,0,2,2020-12-09T16:53:45.97,11,,3.0
2020,13,2970,250,9,322,13,2,3,1,0,0,0,0,0,0,False,False,False,0,2,2021-03-05T15:10:01.963,0,,0.0
2020,13,2970,255,3,6935,2,35,8,18,38,20,35,3,35,6,False,False,False,1,3,2020-12-09T13:00:48.223,38,,3.0
2020,13,2970,275,9,7816,2,5,9,8,13,5,12,1,12,0,False,False,False,0,3,2020-12-11T14:30:48.953,13,,1.0
2020,13,2970,295,9,4446,2,5,5,10,12,2,12,0,12,0,False,False,False,0,3,2020-12-09T16:54:31.76,12,,0.0
2020,13,2970,305,9,6436,2,13,10,3,13,10,10,3,10,0,False,False,False,0,3,2020-12-11T16:19:05.493,13,,3.0
2020,13,2970,315,9,6436,13,4,3,13,0,0,0,0,0,0,False,False,False,0,2,2020-12-11T14:30:59.9,0,,0.0
2020,13,2970,320,9,7183,2,50,10,-1,6,7,4,2,4,0,True,False,False,0,2,2020-12-11T16:20:15.023,6,,2.0
2020,13,2970,345,3,670,13,17,1,22,0,0,0,0,0,0,False,False,False,0,3,2020-12-11T14:31:42.147,0,,
2020,13,2970,360,3,6936,2,12,3,4,4,0,4,0,4,0,False,False,False,0,2,2020-12-11T14:31:13.02,4,,0.0
2020,13,2970,365,3,6936,13,5,5,8,0,0,0,0,0,0,False,False,False,0,2,2020-12-11T16:31:27.803,0,,0.0
2020,13,2970,385,9,7816,2,5,3,7,6,-1,6,0,6,0,False,False,False,0,3,2020-12-09T16:55:19.52,6,,0.0
2020,13,2970,390,9,6446,2,6,7,15,15,0,15,0,15,0,False,False,False,0,3,2020-12-11T14:31:54.017,15,,0.0
2020,13,2970,400,9,322,2,13,10,3,9,6,5,4,5,0,True,False,False,0,3,2020-12-11T14:32:08.107,9,,4.0
2020,13,2970,410,9,7816,13,5,3,2,0,0,0,0,0,0,False,False,False,0,3,2020-12-09T14:00:18.157,0,,0.0
2020,13,2970,420,9,7816,13,7,6,31,0,0,0,0,0,0,False,False,False,0,3,2020-12-11T14:32:18.713,0,,0.0
2020,13,2970,435,9,7816,3,19,7,55,0,0,0,0,0,0,False,False,False,0,3,2021-03-08T21:13:36.833,0,,0.0
2020,13,2970,450,3,7672,2,51,10,-1,2,3,0,2,0,0,False,False,False,0,3,2020-12-11T15:22:58.2,2,,2.0
2020,13,2970,455,3,6935,13,2,10,11,0,0,0,0,0,0,True,False,False,0,2,2020-12-11T14:45:29.25,0,,0.0
2020,13,2970,475,9,6446,2,12,5,4,4,0,4,0,4,0,False,False,False,0,3,2020-12-11T14:32:29.12,4,,0.0
2020,13,2970,500,9,6436,13,7,6,34,0,0,0,0,0,0,False,False,False,0,3,2020-12-11T14:45:29.25,0,,0.0
2020,13,2970,540,3,6936,13,2,4,11,0,0,0,0,0,0,False,False,False,0,3,2020-12-11T15:23:14.66,0,,0.0
2020,13,2970,555,3,6936,2,12,6,20,20,0,0,20,0,6,False,False,False,0,2,2020-12-11T16:22:44.733,20,,20.0
2020,13,2970,575,9,4202,2,5,5,4,6,2,6,0,6,0,False,False,False,0,3,2020-12-11T16:24:01.023,6,,0.0
2020,13,2970,585,9,6436,2,5,5,5,13,8,8,5,8,0,False,False,False,0,3,2020-12-09T16:56:47.353,13,,5.0
2020,13,2970,595,9,322,2,4,3,10,13,3,11,2,11,0,False,False,False,0,2,2020-12-09T16:57:03.79,13,,2.0
2020,13,2970,610,9,4446,2,26,10,3,9,6,4,5,4,0,False,False,False,1,3,2020-12-09T16:57:16.327,9,,5.0
2020,13,2970,615,9,4202,13,11,5,14,0,0,0,0,0,0,False,False,False,0,1,2020-12-11T14:33:03.26,0,,0.0
2020,13,2970,640,3,5017,2,47,5,-1,9,10,7,2,7,0,True,False,False,0,1,2020-12-10T21:56:51.797,9,,2.0
2020,13,2970,675,3,5017,2,12,3,1,2,1,2,0,2,0,False,False,False,0,1,2021-03-08T21:14:22.507,2,,0.0
2020,13,2970,685,3,6935,13,12,10,4,0,0,0,0,0,0,False,False,False,0,2,2021-02-25T16:12:37.1,0,,0.0
2020,13,2970,700,9,6436,2,5,3,11,11,0,11,0,11,0,False,False,False,0,2,2020-12-09T16:57:35.4,11,,0.0
2020,13,2970,705,9,4202,13,6,4,0,0,0,0,0,0,0,False,False,False,0,1,2020-12-11T14:45:29.25,0,,0.0
2020,13,2970,710,9,6446,2,5,3,5,6,1,6,0,6,0,False,False,False,0,3,2020-12-11T14:33:33.227,6,,0.0
2020,13,2970,715,9,4202,2,28,9,1,4,3,4,0,4,0,False,False,False,0,1,2020-12-09T16:58:00.78,4,,0.0
2020,13,2970,720,9,4446,2,4,3,11,19,8,17,2,17,0,False,False,False,0,2,2020-12-09T16:58:12.823,19,,2.0
2020,13,2970,725,9,6446,2,5,3,5,19,14,5,14,5,0,False,False,False,2,3,2020-12-11T15:24:54.78,19,,14.0
2020,13,2970,730,9,4202,2,48,9,-3,12,15,10,2,10,0,False,False,False,2,1,2020-12-11T15:25:05.21,12,,2.0
2020,13,2970,735,9,322,13,7,3,4,0,0,0,0,0,0,False,False,False,0,4,2020-12-09T15:59:02.627,0,,0.0
2020,13,2970,740,9,6441,13,6,4,4,0,0,0,0,0,0,False,False,False,0,3,2021-02-22T18:57:57.48,0,,
2020,13,2970,760,9,322,2,2,4,2,2,0,0,2,0,6,False,False,False,0,3,2020-12-11T16:27:13.723,2,,2.0
2020,13,2970,840,9,322,2,4,10,5,8,3,8,0,8,0,False,False,False,0,3,2020-12-11T14:34:15.967,8,,0.0
2020,13,2970,845,9,6436,2,4,3,12,12,0,12,0,12,0,False,False,False,0,2,2020-12-11T14:34:24.08,12,,0.0
2020,13,2970,855,9,322,13,2,10,8,0,0,0,0,0,0,False,False,False,0,3,2020-12-11T14:34:32.78,0,,0.0
2020,13,2970,860,9,6436,13,3,5,12,0,0,0,0,0,0,False,False,False,0,2,2020-12-09T16:36:11.69,0,,0.0
2020,13,2970,865,9,6436,2,50,3,-3,-4,-1,-3,-1,-3,0,False,False,False,0,2,2020-12-11T15:25:41.15,-4,,-1.0
2020,13,2970,870,9,6436,2,8,6,20,28,8,28,0,28,0,False,False,False,0,2,2020-12-11T14:45:29.25,28,,0.0
2020,13,2970,875,9,7816,13,19,2,33,0,0,0,0,0,0,False,False,False,0,3,2020-12-09T16:41:27.073,0,,0.0
2020,13,2970,885,9,4446,13,7,6,25,0,0,0,0,0,0,False,False,False,0,3,2020-12-11T14:45:29.25,0,,0.0
2020,13,2971,10,2,990,2,4,4,2,4,2,3,1,3,0,False,False,False,0,1,2021-02-22T18:18:46.89,4,,1.0
2020,13,2971,20,2,661,13,26,10,2,0,0,0,0,0,0,False,False,False,0,2,2020-12-07T11:20:06.15,0,,0.0
2020,13,2971,35,20,7888,2,4,10,5,5,0,5,0,5,0,False,False,False,0,4,2020-12-07T11:24:33.91,5,,0.0
2020,13,2971,40,20,6388,3,13,10,3,0,0,0,0,0,0,False,False,False,0,3,2020-12-11T19:52:51.087,0,,0.0
2020,13,2971,55,2,661,2,30,9,1,2,1,2,0,2,0,False,False,False,0,3,2020-12-07T11:34:18.363,2,,0.0
2020,13,2971,60,2,5223,13,12,2,16,0,0,0,0,0,0,False,False,False,0,2,2020-12-11T19:53:41.46,0,,0.0
2020,13,2971,70,20,6388,13,30,5,1,0,0,0,0,0,0,False,False,False,0,4,2021-01-12T23:50:11.467,0,,0.0
2020,13,2971,80,20,3763,13,8,2,23,0,0,0,0,0,0,False,False,False,0,2,2020-12-08T16:35:19.55,0,,
2020,13,2971,90,20,3763,2,5,10,5,14,9,11,3,11,0,False,False,False,0,3,2020-12-09T13:12:00.033,14,,3.0
2020,13,2971,95,20,958,2,5,9,7,7,0,7,0,7,0,False,False,False,0,3,2020-12-08T02:40:40.057,7,,0.0
2020,13,2971,105,20,6388,2,35,7,15,15,0,15,0,15,6,True,False,False,0,3,2020-12-09T12:30:59.357,15,,0.0
2020,13,2971,120,2,661,2,4,4,5,12,7,9,3,9,0,False,False,False,1,3,2020-12-08T02:41:30.483,12,,3.0
2020,13,2971,130,2,661,2,6,9,13,20,7,13,7,13,0,False,False,False,0,2,2021-02-25T16:24:47.563,20,,7.0
2020,13,2971,140,2,6472,2,48,10,-2,-2,0,-2,0,-2,0,False,False,False,0,1,2020-12-07T12:19:30.383,-2,,0.0
2020,13,2971,145,2,6247,3,2,9,7,0,0,0,0,0,0,True,False,False,0,3,2020-12-07T12:21:45.657,0,,0.0
2020,13,2971,160,20,213,2,5,3,10,7,-3,8,-1,8,0,False,False,False,0,2,2020-12-11T19:55:40.887,7,,-1.0
2020,13,2971,170,20,3763,13,35,6,20,0,0,0,0,0,0,False,False,False,0,3,2020-12-11T19:56:13.517,0,,0.0
2020,13,2971,180,20,3763,2,2,9,5,6,1,6,0,6,0,False,False,False,0,2,2020-12-08T02:41:58.84,6,,0.0
2020,13,2971,185,20,6388,3,5,5,6,0,0,0,0,0,0,False,False,False,0,2,2020-12-11T19:57:29.747,0,,0.0
2020,13,2971,190,20,306,2,45,5,-4,-3,1,-3,0,-3,0,True,False,False,0,1,2020-12-11T19:58:26.017,-3,,0.0
2020,13,2971,195,20,6388,2,5,2,15,21,6,16,5,16,0,False,False,False,0,3,2020-12-11T19:58:11.397,21,,5.0
2020,13,2971,210,20,7888,2,53,10,-4,0,4,-2,2,-2,0,True,False,False,0,4,2020-12-09T12:35:14.277,0,,2.0
2020,13,2971,220,20,3763,2,5,2,18,18,0,18,0,18,0,False,False,False,0,2,2020-12-09T13:12:11.08,18,,0.0
2020,13,2971,235,20,5140,2,45,5,-4,1,5,-2,3,-2,0,False,False,False,0,1,2020-12-07T13:03:50.433,1,,3.0
2020,13,2971,240,20,5140,2,47,5,4,8,4,7,1,7,0,False,False,False,0,1,2020-12-09T12:36:47.71,8,,1.0
2020,13,2971,260,2,5223,13,19,6,33,0,0,0,0,0,0,False,False,False,0,3,2020-12-07T13:13:07.01,0,,0.0
2020,13,2971,265,2,6247,13,5,5,7,0,0,0,0,0,0,False,False,False,0,3,2021-02-22T18:19:59.727,0,,0.0
2020,13,2971,285,20,3763,2,4,5,4,7,3,5,2,5,0,True,False,False,0,2,2020-12-09T12:37:23.493,7,,2.0
2020,13,2971,290,20,3747,13,7,6,24,0,0,0,0,0,0,False,False,False,0,3,2020-12-07T13:24:59.81,0,,0.0
2020,13,2971,300,20,306,2,47,5,1,3,2,2,1,2,0,False,False,False,0,1,2020-12-11T17:45:10.923,3,,1.0
2020,13,2971,305,20,958,3,4,10,7,0,0,0,0,0,0,False,False,False,0,2,2020-12-11T20:00:51.397,0,,0.0
2020,13,2971,310,2,661,2,7,2,21,35,14,25,10,25,0,False,False,False,0,2,2020-12-09T12:20:01.147,35,,10.0
2020,13,2971,315,2,6247,2,32,9,3,3,0,3,0,3,0,False,False,False,0,4,2020-12-08T02:29:18.28,3,,0.0
2020,13,2971,320,2,6247,13,5,3,0,0,0,0,0,0,0,False,False,False,0,3,2020-12-11T19:46:51.127,0,,0.0
2020,13,2971,335,2,5223,13,5,5,12,0,0,0,0,0,0,False,False,False,0,2,2021-02-22T18:21:20.007,0,,0.0
2020,13,2971,340,2,5214,13,26,5,4,0,0,0,0,0,0,False,False,False,0,3,2020-12-11T19:46:51.143,0,,0.0
2020,13,2971,365,20,306,2,4,10,1,5,4,3,2,3,0,False,False,False,0,1,2020-12-09T13:15:46.317,5,,
2020,13,2971,370,20,213,2,5,9,4,7,3,4,3,4,0,False,False,False,1,3,2020-12-11T18:18:41.73,7,,3.0
2020,13,2971,380,20,213,2,8,8,18,18,0,18,0,18,0,False,False,False,0,2,2020-12-09T11:51:07.513,18,,0.0
2020,13,2971,405,20,958,2,6,9,11,11,0,11,0,11,6,False,False,False,0,3,2020-12-07T14:16:35.563,11,,0.0
2020,13,2971,420,2,6472,13,4,5,5,0,0,0,0,0,0,False,False,False,0,2,2020-12-07T14:20:34.63,0,,0.0
2020,13,2971,425,2,6342,2,50,5,0,9,9,7,2,7,0,True,False,False,0,2,2020-12-07T14:22:45.163,9,,2.0
2020,13,2971,435,2,661,2,4,10,5,7,2,7,0,7,0,True,False,False,0,3,2020-12-07T14:27:06.05,7,,0.0
2020,13,2971,440,2,5223,2,19,2,31,31,0,31,0,31,0,False,False,False,0,2,2020-12-09T13:01:05.153,31,,0.0
2020,13,2971,445,2,5223,13,13,4,3,0,0,0,0,0,0,False,False,False,0,2,2020-12-09T12:42:29.173,0,,
2020,13,2971,460,2,5223,2,4,5,12,10,-2,10,0,10,0,False,False,False,0,2,2020-12-09T11:51:54.17,10,,0.0
2020,13,2971,470,2,6247,13,8,10,10,0,0,0,0,0,0,False,False,False,0,3,2020-12-09T13:01:38.813,0,,
2020,13,2971,475,2,6247,13,9,5,10,0,0,0,0,0,0,False,False,False,0,3,2020-12-07T14:42:46.507,0,,0.0
2020,13,2971,480,2,5214,13,6,10,8,0,0,0,0,0,0,False,False,False,0,2,2021-02-22T18:29:40.183,0,,0.0
2020,13,2971,505,20,3763,2,35,7,16,18,2,18,0,18,0,False,False,False,0,3,2020-12-09T13:02:08.267,18,,0.0
2020,13,2971,510,20,3763,2,4,9,10,10,0,10,0,10,0,False,False,False,0,2,2020-12-09T13:02:46.757,10,,0.0
2020,13,2971,515,20,213,2,39,9,5,5,0,5,0,5,0,False,False,False,0,3,2020-12-09T13:03:13.737,5,,0.0
2020,13,2971,540,20,213,13,4,10,3,0,0,0,0,0,0,False,False,False,0,2,2020-12-09T13:03:52.94,0,,0.0
2020,13,2971,545,20,958,2,5,5,10,10,0,10,0,10,0,False,False,False,0,3,2020-12-07T15:29:27.72,10,,0.0
2020,13,2971,580,2,5223,2,6,1,16,18,2,18,0,18,0,True,False,False,0,2,2020-12-07T15:40:51.007,18,,0.0
2020,13,2971,590,2,5223,13,9,6,19,0,0,0,0,0,0,False,False,False,0,2,2020-12-07T15:44:23.037,0,,0.0
2020,13,2971,615,20,3763,2,26,9,6,6,0,6,0,6,0,False,False,False,0,3,2020-12-11T17:45:23.683,6,,0.0
2020,13,2971,625,20,3763,2,6,1,17,17,0,17,0,17,0,False,False,False,0,3,2020-12-11T17:45:33.723,17,,0.0
2020,13,2971,655,2,5214,13,5,3,4,0,0,0,0,0,0,False,False,False,0,3,2020-12-07T16:10:55.873,0,,0.0
2020,13,2971,660,2,661,13,2,4,2,0,0,0,0,0,0,False,False,False,0,2,2020-12-08T02:28:47.303,0,,0.0
2020,13,2971,680,20,958,13,35,9,12,0,0,0,0,0,0,False,False,False,0,3,2020-12-09T12:16:08.05,0,,0.0
2020,13,2971,685,20,3763,13,6,4,12,0,0,0,0,0,0,False,False,False,0,2,2020-12-11T17:45:47.867,0,,0.0
2020,13,2971,700,2,5223,13,6,9,5,0,0,0,0,0,0,True,False,False,0,2,2020-12-11T19:46:51.143,0,,0.0
2020,13,2971,715,20,3763,2,2,4,8,9,1,8,1,8,0,False,False,False,0,3,2020-12-07T16:36:16.55,9,,1.0
2020,13,2971,730,20,213,2,47,5,0,2,2,2,0,2,0,False,False,False,0,3,2020-12-11T20:40:13.593,2,,0.0
2020,13,2971,745,2,5214,13,46,3,6,0,0,0,0,0,0,False,False,False,0,4,2021-02-25T16:26:52.187,0,,
2020,13,2971,750,2,6247,2,8,1,19,24,5,24,0,24,0,False,False,False,0,3,2020-12-07T16:59:54.25,24,,0.0
2020,13,2971,755,2,6247,2,5,3,14,14,0,14,0,14,0,False,False,False,0,3,2020-12-07T17:02:26.143,14,,0.0
2020,13,2971,760,2,5214,2,5,5,9,9,0,9,0,9,0,False,False,False,0,3,2020-12-09T12:52:57.1,9,,0.0
2020,13,2971,775,2,5223,13,21,6,15,0,0,0,0,0,0,False,False,False,0,2,2020-12-07T17:11:32.82,0,,
2020,13,2971,785,2,6247,2,5,3,6,10,4,10,0,10,6,False,False,False,0,3,2020-12-07T17:15:48.313,10,,0.0
2020,13,2971,800,20,7888,2,47,5,1,4,3,4,0,4,0,False,False,False,0,4,2020-12-09T13:08:06.107,4,,0.0
2020,13,2971,810,20,5140,13,35,6,16,0,0,0,0,0,0,False,False,False,0,2,2020-12-11T17:46:03.963,0,,0.0
2020,13,2971,820,20,6388,2,47,5,2,6,4,5,1,5,0,False,False,False,0,4,2020-12-08T16:37:30.873,6,,1.0
2020,13,2971,835,2,6249,13,32,5,3,0,0,0,0,0,0,False,False,False,0,4,2020-12-11T17:46:14.227,0,,0.0
2020,13,2971,840,2,5223,2,7,6,23,27,4,24,3,24,0,False,False,False,0,2,2020-12-09T13:09:02.137,27,,3.0
2020,13,2971,860,2,661,2,6,1,15,18,3,18,0,18,0,False,False,False,0,2,2020-12-11T19:46:51.143,18,,0.0
2020,13,2971,895,2,661,13,7,7,20,0,0,0,0,0,0,False,False,False,0,3,2021-02-25T16:28:46.71,0,,0.0
2020,13,2971,940,2,5223,2,3,6,15,22,7,15,7,15,0,False,False,False,2,2,2020-12-11T20:44:14.453,22,,7.0
2020,13,2971,945,2,661,13,19,1,39,0,0,0,0,0,0,False,False,False,0,3,2020-12-07T18:22:45.897,0,,0.0
2020,13,2972,15,6,464,2,2,9,14,16,2,16,0,16,0,False,False,False,0,2,2020-12-08T03:34:18.897,16,,0.0
2020,13,2972,20,6,7728,13,30,3,-1,0,0,0,0,0,0,False,False,False,0,4,2020-12-10T16:55:50.573,0,,0.0
2020,13,2972,45,11,917,2,2,4,14,21,7,21,0,21,0,False,False,False,0,3,2020-12-07T11:29:31.59,21,,0.0
2020,13,2972,55,11,4487,2,50,9,-2,19,21,16,3,16,0,False,False,False,1,2,2020-12-10T17:34:32.55,19,,3.0
2020,13,2972,60,11,4487,2,46,9,2,5,3,4,1,4,0,False,False,False,0,3,2020-12-08T03:36:08.6,5,,1.0
2020,13,2972,70,11,6810,2,5,5,3,4,1,3,1,3,0,True,False,False,0,3,2020-12-07T11:38:35.79,4,,1.0
2020,13,2972,85,6,464,2,4,8,17,17,0,17,0,17,0,False,False,False,0,3,2020-12-10T18:43:14.817,17,,0.0
2020,13,2972,125,11,7733,13,6,5,9,0,0,0,0,0,0,False,False,False,0,2,2021-02-25T16:33:03.973,0,,0.0
2020,13,2972,135,11,914,2,4,5,14,15,1,14,1,14,0,False,False,False,0,3,2020-12-07T11:56:58.883,15,,1.0
2020,13,2972,145,11,7733,2,3,9,14,14,0,14,0,14,0,False,False,False,0,2,2020-12-07T11:59:39.147,14,,0.0
2020,13,2972,165,11,6810,2,7,3,14,14,0,14,0,14,0,False,False,False,0,4,2020-12-07T12:04:49.09,14,,0.0
2020,13,2972,170,11,100,13,26,9,4,0,0,0,0,0,0,False,False,False,0,2,2020-12-08T03:39:26.5,0,,0.0
2020,13,2972,215,6,464,2,6,7,17,21,4,21,0,21,0,False,False,False,0,2,2020-12-07T17:25:31.233,21,,0.0
2020,13,2972,225,6,7725,2,51,10,-3,10,13,1,9,1,0,False,False,False,1,3,2020-12-08T03:43:35.72,10,,9.0
2020,13,2972,240,6,6331,2,4,3,12,13,1,13,0,13,0,True,False,False,0,2,2020-12-07T12:37:15.29,13,,0.0
2020,13,2972,270,11,914,13,21,2,28,0,0,0,0,0,0,False,False,False,0,3,2020-12-08T03:44:41.47,0,,0.0
2020,13,2972,290,11,914,13,23,1,47,0,0,0,0,0,0,False,False,False,0,3,2020-12-10T18:43:41.787,0,,0.0
2020,13,2972,295,11,7733,13,20,8,30,0,0,0,0,0,0,False,False,False,0,2,2020-12-10T17:12:20.877,0,,0.0
2020,13,2972,310,6,6786,2,31,10,2,10,8,6,4,6,0,False,False,False,1,1,2020-12-07T13:15:14.633,10,,4.0
2020,13,2972,315,6,464,2,4,5,7,7,0,7,0,7,0,False,False,False,0,2,2021-02-22T19:32:05.793,7,,0.0
2020,13,2972,330,6,464,13,12,5,10,0,0,0,0,0,0,False,False,False,0,2,2020-12-07T13:20:20.047,0,,0.0
2020,13,2972,335,6,7728,13,4,10,11,0,0,0,0,0,0,False,False,False,0,3,2020-12-07T13:21:18.613,0,,0.0
2020,13,2972,345,11,6341,13,48,10,-4,0,0,0,0,0,0,False,False,False,0,1,2020-12-07T13:23:01.3,0,,0.0
2020,13,2972,355,11,6341,2,48,9,-5,3,8,2,1,2,0,False,False,False,0,1,2021-02-22T19:32:51.137,3,,1.0
2020,13,2972,365,11,914,2,6,7,19,25,6,22,3,22,0,False,False,False,0,2,2020-12-07T13:27:43.28,25,,3.0
2020,13,2972,370,11,7733,2,19,2,48,49,1,49,0,49,6,False,False,False,0,2,2020-12-10T17:12:20.877,49,,0.0
2020,13,2972,385,6,464,2,6,9,8,10,2,8,2,8,0,False,False,False,1,3,2020-12-10T18:09:02.403,10,,2.0
2020,13,2972,395,6,6328,2,6,7,15,15,0,15,0,15,0,False,False,False,0,3,2020-12-07T13:40:43.443,15,,0.0
2020,13,2972,405,6,6328,2,2,4,8,19,11,19,0,19,0,False,False,False,0,3,2020-12-07T13:42:39.187,19,,0.0
2020,13,2972,415,6,464,13,12,6,18,0,0,0,0,0,0,False,False,False,0,3,2020-12-07T13:44:26.583,0,,
2020,13,2972,420,6,6328,2,4,10,5,9,4,5,4,5,0,False,False,False,1,3,2020-12-07T13:46:01.133,9,,4.0
2020,13,2972,445,11,100,13,4,3,6,0,0,0,0,0,0,False,False,False,0,3,2021-02-22T19:34:03.23,0,,0.0
2020,13,2972,450,11,6341,2,2,9,4,5,1,4,1,4,0,False,False,False,0,2,2020-12-07T14:10:16.567,5,,1.0
2020,13,2972,465,11,914,2,8,7,22,22,0,22,0,22,0,False,False,False,0,3,2020-12-10T17:12:20.877,22,,0.0
2020,13,2972,480,11,914,13,19,1,44,0,0,0,0,0,0,False,False,False,0,3,2020-12-10T17:12:20.877,0,,0.0
2020,13,2972,485,11,917,13,19,8,47,0,0,0,0,0,0,False,False,False,0,2,2020-12-10T17:12:20.877,0,,0.0
2020,13,2972,505,11,917,2,6,4,13,15,2,15,0,15,0,False,False,False,0,2,2020-12-07T14:28:36.977,15,,0.0
2020,13,2972,535,6,7728,2,4,10,5,13,8,9,4,9,0,False,False,False,0,3,2020-12-08T03:48:03.637,13,,4.0
2020,13,2972,540,6,7725,13,9,2,29,0,0,0,0,0,0,False,False,False,0,2,2020-12-07T14:39:36.143,0,,0.0
2020,13,2972,550,6,6786,2,44,9,-3,-1,2,-2,1,-2,0,False,False,False,0,3,2020-12-07T14:40:57.74,-1,,1.0
2020,13,2972,555,6,7725,2,50,10,-1,6,7,5,1,5,0,False,False,False,0,2,2020-12-10T17:34:49.27,6,,1.0
2020,13,2972,565,11,914,2,5,5,13,12,-1,12,0,12,0,False,False,False,0,2,2020-12-10T17:12:20.877,12,,0.0
2020,13,2972,570,11,914,2,4,5,7,7,0,7,0,7,0,False,False,False,0,2,2020-12-07T14:47:34.11,7,,0.0
2020,13,2972,580,11,2714,13,13,9,4,0,0,0,0,0,0,False,False,False,0,4,2020-12-07T14:49:50.463,0,,0.0
2020,13,2972,590,11,6810,2,5,3,9,9,0,9,0,9,0,False,False,False,0,3,2020-12-07T14:52:03.837,9,,0.0
2020,13,2972,600,11,6810,2,24,6,20,24,4,24,0,24,0,False,False,False,0,4,2020-12-07T14:54:38.267,24,,0.0
2020,13,2972,610,11,2714,2,12,3,9,9,0,9,0,9,6,False,False,False,0,4,2021-03-08T21:20:30.56,9,,0.0
2020,13,2972,660,6,6328,2,5,5,4,4,0,4,0,4,0,False,False,False,0,3,2020-12-07T15:39:53.74,4,,0.0
2020,13,2972,665,6,7725,2,13,9,0,21,21,16,5,16,0,False,False,False,0,3,2020-12-07T15:41:44.87,21,,5.0
2020,13,2972,670,6,666,13,17,8,18,0,0,0,0,0,0,True,False,False,0,3,2020-12-07T15:43:07.933,0,,0.0
2020,13,2972,675,6,7725,2,49,10,-2,6,8,0,6,0,0,False,False,False,1,3,2020-12-10T18:09:37.137,6,,6.0
2020,13,2972,680,6,811,2,47,5,2,4,2,4,0,4,0,True,False,False,0,3,2020-12-10T18:36:00.69,4,,0.0
2020,13,2972,690,6,7728,2,30,9,-2,11,13,11,0,11,6,False,False,False,0,4,2020-12-07T15:47:31.893,11,,0.0
2020,13,2972,705,11,792,13,12,10,-7,0,0,0,0,0,0,False,False,False,0,1,2021-02-25T16:36:13.973,0,,0.0
2020,13,2972,715,11,100,2,6,7,18,23,5,23,0,23,0,True,False,False,0,2,2020-12-08T03:51:39.217,23,,0.0
2020,13,2972,720,11,6810,2,18,5,0,6,6,2,4,2,0,False,False,False,1,2,2020-12-07T15:58:34.057,6,,4.0
2020,13,2972,725,11,2714,13,53,10,-4,0,0,0,0,0,0,False,False,False,0,4,2021-03-05T15:12:41.493,0,,0.0
2020,13,2972,740,6,7728,2,47,10,0,7,7,7,0,7,0,False,False,False,1,3,2020-12-10T18:09:58.29,7,,0.0
2020,13,2972,745,6,811,13,47,5,1,0,0,0,0,0,0,True,False,False,0,3,2020-12-10T18:36:49.29,0,,0.0
2020,13,2972,755,11,914,2,4,10,5,5,0,5,0,5,0,False,False,False,0,3,2020-12-08T03:53:18.693,5,,0.0
2020,13,2972,760,11,6810,13,12,5,7,0,0,0,0,0,0,False,False,False,0,3,2020-12-10T17:39:19.003,0,,0.0
2020,13,2972,765,11,914,13,12,8,22,0,0,0,0,0,0,False,False,False,0,2,2020-12-07T17:25:59.833,0,,0.0
2020,13,2972,780,6,6328,2,30,9,1,9,8,9,0,9,0,False,False,False,0,4,2020-12-08T03:53:40.013,9,,0.0
2020,13,2972,800,11,6810,13,5,3,5,0,0,0,0,0,0,False,False,False,0,3,2020-12-10T18:37:22.237,0,,0.0
2020,13,2972,805,11,6810,2,35,10,12,14,2,14,0,14,0,False,False,False,0,4,2020-12-07T16:42:17.943,14,,0.0
2020,13,2972,810,11,100,2,8,7,18,22,4,21,1,21,0,False,False,False,0,3,2020-12-07T16:43:44.343,22,,1.0
2020,13,2972,815,11,100,2,7,6,17,17,0,17,0,17,0,False,False,False,0,3,2020-12-07T16:44:43.37,17,,0.0
2020,13,2972,820,11,914,2,4,3,5,5,0,5,0,5,0,False,False,False,0,2,2020-12-07T16:45:33.177,5,,0.0
2020,13,2972,825,11,6810,2,6,4,12,13,1,13,0,13,0,False,False,False,0,3,2020-12-07T16:47:40.66,13,,0.0
2020,13,2972,830,11,914,2,19,6,25,25,0,25,0,25,6,False,False,False,0,2,2020-12-10T17:12:20.877,25,,0.0
2020,13,2972,895,6,6786,2,16,10,3,16,13,10,6,10,0,False,False,False,0,1,2020-12-07T17:02:38.087,16,,6.0
2020,13,2972,900,6,7728,2,32,5,-4,1,5,-2,3,-2,0,False,False,False,0,4,2020-12-07T17:04:19.673,1,,3.0
2020,13,2972,905,6,6786,2,4,4,3,14,11,8,6,8,0,False,False,False,1,1,2020-12-07T17:05:21.68,14,,6.0
2020,13,2972,910,6,7728,2,26,10,4,5,1,4,1,4,0,False,False,False,0,3,2020-12-07T17:06:37.77,5,,1.0
2020,13,2972,915,6,7725,13,9,2,23,0,0,0,0,0,0,False,False,False,0,2,2020-12-07T17:07:29.783,0,,0.0
2020,13,2972,920,6,464,2,4,5,3,4,1,4,0,4,0,False,False,False,0,2,2020-12-07T17:08:31.287,4,,0.0
2020,13,2973,10,13,404,2,46,9,-1,1,2,1,0,1,0,False,False,False,0,1,2020-12-07T16:54:30.027,1,,0.0
2020,13,2973,30,14,1114,2,4,8,15,18,3,16,2,16,0,False,False,False,0,2,2020-12-10T18:24:53.96,18,,2.0
2020,13,2973,40,14,1119,2,13,9,3,12,9,8,4,8,0,False,False,False,0,4,2020-12-08T02:32:15.007,12,,4.0
2020,13,2973,55,14,7584,2,2,10,10,11,1,11,0,11,0,False,False,False,0,2,2020-12-07T12:54:07.833,11,,0.0
2020,13,2973,60,14,1114,2,13,9,4,21,17,21,0,21,6,False,False,False,0,3,2020-12-07T16:56:18.137,21,,0.0
2020,13,2973,85,13,6529,2,35,2,39,64,25,54,10,54,0,False,False,False,2,3,2020-12-08T02:28:41.037,64,,10.0
2020,13,2973,105,14,6546,2,31,4,-4,-5,-1,-5,0,-5,0,False,False,False,0,1,2020-12-07T13:07:38.193,-5,,0.0
2020,13,2973,110,14,895,3,4,9,7,0,0,0,0,0,0,False,False,False,0,3,2020-12-08T02:33:55.803,0,,0.0
2020,13,2973,115,14,1114,2,50,3,-2,1,3,0,1,0,0,False,False,False,0,2,2021-02-25T17:04:54.527,1,,1.0
2020,13,2973,125,13,876,2,2,10,11,11,0,12,-1,12,0,False,False,False,0,3,2020-12-07T16:57:21.94,11,,-1.0
2020,13,2973,130,13,876,13,19,6,37,0,0,0,0,0,0,False,False,False,0,2,2020-12-07T13:16:07.56,0,,
2020,13,2973,145,13,876,13,12,7,34,0,0,0,0,0,0,False,False,False,0,3,2021-03-08T21:23:11.83,0,,0.0
2020,13,2973,150,13,876,13,8,7,20,0,0,0,0,0,0,False,False,False,0,3,2020-12-07T13:24:28.943,0,,0.0
2020,13,2973,165,14,7495,13,2,10,4,0,0,0,0,0,0,False,False,False,0,2,2020-12-07T13:27:56.023,0,,0.0
2020,13,2973,170,14,5197,2,47,10,1,1,0,1,0,1,0,False,False,False,0,4,2020-12-07T16:58:49.21,1,,0.0
2020,13,2973,175,14,1114,2,7,2,20,21,1,20,1,20,0,False,False,False,0,2,2020-12-10T18:58:55.137,21,,1.0
2020,13,2973,180,14,6543,2,4,5,5,5,0,5,0,5,0,False,False,False,0,2,2020-12-07T13:33:17.963,5,,0.0
2020,13,2973,190,14,4449,2,2,4,6,11,5,9,2,9,0,False,False,False,0,3,2020-12-07T13:37:13.923,11,,2.0
2020,13,2973,200,14,1114,2,35,9,14,13,-1,13,0,13,0,False,False,False,0,3,2020-12-08T02:37:45.07,13,,0.0
2020,13,2973,220,13,4733,2,6,4,12,14,2,13,1,13,0,False,False,False,0,3,2020-12-10T18:39:48.183,14,,1.0
2020,13,2973,235,13,6529,2,35,7,17,19,2,18,1,18,0,False,False,False,0,3,2020-12-07T13:47:28.12,19,,1.0
2020,13,2973,245,13,6529,2,4,10,6,7,1,7,0,7,0,False,False,False,0,3,2020-12-07T13:51:58.69,7,,0.0
2020,13,2973,250,13,4733,13,5,5,9,0,0,0,0,0,0,False,False,False,0,3,2020-12-08T02:38:33.167,0,,0.0
2020,13,2973,265,14,1114,2,4,3,7,10,3,8,2,8,0,False,False,False,0,2,2020-12-08T02:38:55.53,10,,2.0
2020,13,2973,275,14,6543,2,4,3,3,9,6,7,2,7,0,False,False,False,0,2,2020-12-07T13:58:07.02,9,,2.0
2020,13,2973,295,14,7582,2,11,5,7,39,32,39,0,39,6,False,False,False,0,1,2020-12-07T14:01:35.717,39,,0.0
2020,13,2973,315,13,6528,2,32,10,-1,1,2,0,1,0,0,False,False,False,0,4,2020-12-10T19:20:49.46,1,,1.0
2020,13,2973,320,13,4733,2,12,7,20,28,8,27,1,27,0,False,False,False,0,2,2020-12-08T02:29:32.463,28,,1.0
2020,13,2973,325,13,876,2,6,10,12,13,1,13,0,13,0,False,False,False,0,3,2021-02-25T17:04:54.527,13,,0.0
2020,13,2973,335,13,404,2,51,10,-6,-2,4,-4,2,-4,0,True,False,False,0,1,2020-12-07T14:13:19.003,-2,,2.0
2020,13,2973,340,13,2455,13,12,5,12,0,0,0,0,0,0,False,False,False,0,1,2020-12-07T14:14:33.43,0,,0.0
2020,13,2973,370,14,895,2,26,9,3,11,8,8,3,8,0,False,False,False,0,3,2020-12-07T14:20:30.06,11,,3.0
2020,13,2973,380,14,7584,2,2,10,10,13,3,11,2,11,0,False,False,False,0,2,2020-12-07T14:22:24.423,13,,2.0
2020,13,2973,390,14,7584,2,13,9,-1,2,3,1,1,1,0,False,False,False,0,3,2020-12-10T19:00:58.88,2,,1.0
2020,13,2973,395,14,1114,2,21,6,17,16,-1,16,0,16,0,False,False,False,0,2,2021-02-25T17:04:54.527,16,,0.0
2020,13,2973,400,14,1114,3,50,10,-3,0,0,0,0,0,0,False,False,False,0,3,2020-12-07T14:28:33.893,0,,0.0
2020,13,2973,405,14,1114,13,4,9,3,0,0,0,0,0,0,False,False,False,0,2,2020-12-07T14:29:41.56,0,,0.0
2020,13,2973,410,14,7582,2,46,3,-1,0,1,0,0,0,0,True,False,False,0,1,2020-12-08T21:49:30.567,0,,0.0
2020,13,2973,430,13,876,2,4,5,6,7,1,7,0,7,0,False,False,False,0,2,2020-12-08T02:39:36.487,7,,0.0
2020,13,2973,435,13,404,2,44,9,-5,1,6,0,1,0,0,False,False,False,0,1,2020-12-08T02:40:37.797,1,,1.0
2020,13,2973,440,13,4733,2,35,10,12,15,3,14,1,14,0,False,False,False,0,2,2020-12-07T14:37:22.467,15,,1.0
2020,13,2973,445,13,404,2,44,3,3,7,4,7,0,7,0,False,False,False,0,1,2020-12-07T14:39:16.283,7,,0.0
2020,13,2973,450,13,4733,2,12,6,28,28,0,28,0,28,0,False,False,False,0,2,2021-03-08T21:25:08.307,28,,0.0
2020,13,2973,460,13,6529,13,17,8,16,0,0,0,0,0,0,False,False,False,0,3,2020-12-07T14:44:17.163,0,,0.0
2020,13,2973,465,13,6880,13,17,8,16,0,0,0,0,0,0,False,False,False,0,3,2020-12-07T14:45:24.4,0,,0.0
2020,13,2973,495,14,1114,2,4,3,5,10,5,7,3,7,0,False,False,False,0,2,2020-12-07T14:48:42.08,10,,3.0
2020,13,2973,505,14,7584,2,13,9,3,8,5,7,1,7,0,False,False,False,0,3,2020-12-10T19:21:03.707,8,,1.0
2020,13,2973,510,14,5197,2,53,9,-1,17,18,17,0,17,0,True,False,False,0,4,2020-12-10T19:32:50.473,17,,0.0
2020,13,2973,525,14,6543,2,33,9,-1,8,9,7,1,7,0,False,False,False,0,1,2020-12-10T19:21:13.41,8,,1.0
2020,13,2973,535,13,876,2,2,9,9,11,2,11,0,11,0,False,False,False,0,3,2020-12-07T15:00:47.81,11,,0.0
2020,13,2973,545,13,6529,2,50,9,-5,3,8,1,2,1,0,False,False,False,0,2,2020-12-08T02:42:46.127,3,,2.0
2020,13,2973,550,13,6528,13,7,2,21,0,0,0,0,0,0,False,False,False,0,3,2020-12-07T15:05:51.297,0,,0.0
2020,13,2973,560,14,7582,2,47,10,3,5,2,4,1,4,0,False,False,False,0,1,2021-02-25T17:04:54.543,5,,1.0
2020,13,2973,565,14,5197,2,16,10,4,5,1,5,0,5,0,False,False,False,0,4,2021-02-25T17:04:54.543,5,,0.0
2020,13,2973,575,14,1114,13,6,7,17,0,0,0,0,0,0,False,False,False,0,2,2020-12-07T15:15:37.62,0,,0.0
2020,13,2973,600,13,404,2,13,4,5,9,4,8,1,8,0,True,False,False,0,3,2020-12-07T15:22:48.817,9,,1.0
2020,13,2973,610,13,6529,2,4,9,6,9,3,9,0,9,0,False,False,False,0,3,2020-12-08T02:43:14.08,9,,0.0
2020,13,2973,625,13,876,13,6,10,8,0,0,0,0,0,0,False,False,False,0,3,2021-03-05T15:15:06.833,0,,0.0
2020,13,2973,655,13,1430,13,5,10,5,0,0,0,0,0,0,False,False,False,0,4,2020-12-07T15:36:29.833,0,,0.0
2020,13,2973,660,13,4733,2,17,7,16,16,0,16,0,16,0,False,False,False,0,3,2020-12-07T15:39:47.12,16,,0.0
2020,13,2973,675,13,6529,2,44,3,-2,5,7,2,3,2,0,True,False,False,1,3,2020-12-07T15:44:48.213,5,,3.0
2020,13,2973,705,14,5197,13,7,8,16,0,0,0,0,0,0,False,False,False,0,4,2020-12-10T18:59:52.493,0,,0.0
2020,13,2973,725,14,895,13,7,6,15,0,0,0,0,0,0,True,False,False,0,4,2020-12-08T21:50:23.253,0,,0.0
2020,13,2973,730,14,7584,2,50,10,-4,12,16,9,3,9,0,False,False,False,0,3,2021-02-25T17:04:54.557,12,,3.0
2020,13,2973,745,13,2455,13,4,3,5,0,0,0,0,0,0,False,False,False,0,2,2020-12-07T16:08:32.677,0,,0.0
2020,13,2973,815,14,6546,2,48,9,-7,11,18,10,1,10,0,False,False,False,0,1,2020-12-10T19:06:25.55,11,,1.0
2020,13,2973,830,13,4733,13,5,3,13,0,0,0,0,0,0,False,False,False,0,2,2020-12-07T16:40:44.553,0,,0.0
2020,13,2973,835,13,6528,2,4,10,5,9,4,6,3,6,0,False,False,False,0,4,2020-12-08T02:47:36.603,9,,3.0
2020,13,2973,840,13,876,2,4,5,5,23,18,23,0,23,0,False,False,False,0,2,2020-12-08T02:47:57.87,23,,0.0
2020,13,2973,845,13,6529,2,35,8,17,18,1,18,0,18,0,False,False,False,0,3,2020-12-08T02:48:35.967,18,,0.0
2020,13,2973,855,13,404,2,4,10,3,8,5,5,3,5,0,False,False,False,0,1,2020-12-08T02:49:00.497,8,,3.0
2020,13,2973,860,13,6529,2,35,5,14,16,2,16,0,16,0,False,False,False,0,3,2020-12-08T02:49:21.853,16,,0.0
2020,13,2974,25,7,6975,2,51,10,-2,8,10,4,4,4,0,False,False,False,1,4,2020-12-07T12:15:53.757,8,,4.0
2020,13,2974,35,7,7659,13,19,6,27,0,0,0,0,0,0,False,False,False,0,2,2020-12-07T12:18:30.53,0,,0.0
2020,13,2974,55,17,6274,13,29,6,16,0,0,0,0,0,0,False,False,False,0,2,2020-12-07T12:27:03.207,0,,0.0
2020,13,2974,65,7,6975,2,32,5,3,3,0,3,0,3,0,False,False,False,0,4,2020-12-10T14:31:53.1,3,,0.0
2020,13,2974,75,7,7659,2,6,10,6,12,6,7,5,7,0,False,False,False,0,2,2020-12-10T12:47:32.673,12,,5.0
2020,13,2974,80,7,3521,13,8,6,23,0,0,0,0,0,0,False,False,False,0,4,2020-12-10T12:47:32.673,0,,0.0
2020,13,2974,85,7,7659,2,4,5,6,7,1,7,0,7,0,False,False,False,0,2,2020-12-07T12:37:50.257,7,,0.0
2020,13,2974,90,7,7659,2,4,5,4,4,0,4,0,4,0,False,False,False,0,2,2020-12-07T12:39:52.677,4,,0.0
2020,13,2974,95,7,3521,13,11,6,29,0,0,0,0,0,0,False,False,False,0,3,2021-03-05T15:17:13,0,,0.0
2020,13,2974,100,17,2253,2,26,9,4,4,0,4,0,4,0,False,False,False,0,3,2020-12-10T14:32:00.533,4,,0.0
2020,13,2974,105,17,7687,2,2,9,7,8,1,8,0,8,0,True,False,False,0,3,2020-12-07T12:50:00.937,8,,0.0
2020,13,2974,115,17,2253,13,19,3,11,0,0,0,0,0,0,False,False,False,0,2,2021-03-17T19:49:32.557,0,,0.0
2020,13,2974,120,17,4305,13,4,9,13,0,0,0,0,0,0,False,False,False,0,2,2020-12-07T12:57:31.357,0,,0.0
2020,13,2974,130,7,6975,2,51,9,-2,5,7,2,3,2,0,True,False,False,0,4,2020-12-08T19:40:43.96,5,,3.0
2020,13,2974,140,7,3521,2,51,3,0,72,72,72,0,72,6,False,False,False,0,3,2020-12-07T14:29:23.083,72,,0.0
2020,13,2974,155,17,2253,13,4,3,8,0,0,0,0,0,0,False,False,False,0,2,2020-12-07T14:31:36.527,0,,
2020,13,2974,160,17,6274,2,2,9,5,6,1,5,1,5,0,False,False,False,0,3,2020-12-07T14:33:07.873,6,,1.0
2020,13,2974,165,17,7687,2,11,3,5,15,10,14,1,14,0,True,False,False,0,3,2020-12-07T14:36:29.093,15,,1.0
2020,13,2974,175,17,2253,13,9,6,24,0,0,0,0,0,0,False,False,False,0,2,2021-03-05T15:17:47.943,0,,
2020,13,2974,195,17,6274,2,47,5,0,8,8,8,0,8,0,True,False,False,1,4,2020-12-08T21:56:16.113,8,,0.0
2020,13,2974,255,17,4305,3,8,8,44,0,0,0,0,0,0,True,False,False,0,2,2020-12-08T02:34:16.637,0,,0.0
2020,13,2974,260,17,7024,2,48,9,-6,16,22,-6,22,-6,0,False,False,False,1,1,2021-03-03T18:42:57.61,16,,22.0
2020,13,2974,265,17,4305,2,34,4,-3,20,23,8,12,8,0,True,False,False,1,3,2021-03-04T17:25:18.2,20,,12.0
2020,13,2974,270,17,7051,13,12,10,2,0,0,0,0,0,0,False,False,False,0,1,2021-03-08T21:28:42.713,0,,0.0
2020,13,2974,275,17,4383,2,5,3,6,7,1,7,0,7,0,False,False,False,0,3,2020-12-07T15:17:15.563,7,,0.0
2020,13,2974,280,17,6274,13,7,4,7,0,0,0,0,0,0,True,False,False,0,3,2021-04-02T13:53:45.723,0,,0.0
2020,13,2974,300,7,3521,13,7,6,26,0,0,0,0,0,0,False,False,False,0,3,2020-12-07T15:27:57.787,0,,
2020,13,2974,320,7,6975,2,32,5,3,15,12,13,2,13,0,False,False,False,0,4,2020-12-07T15:33:48.807,15,,2.0
2020,13,2974,330,7,7659,2,4,3,6,11,5,10,1,10,0,False,False,False,0,2,2020-12-07T15:36:17.793,11,,1.0
2020,13,2974,345,7,3892,13,11,3,7,0,0,0,0,0,0,False,False,False,0,6,2021-02-22T19:44:03.007,0,,0.0
2020,13,2974,360,7,3521,13,47,5,8,0,0,0,0,0,0,False,False,False,0,3,2020-12-07T15:45:45.887,0,,0.0
2020,13,2974,370,17,7687,2,26,9,3,9,6,4,5,4,0,False,False,False,0,3,2020-12-07T15:51:25.243,9,,5.0
2020,13,2974,380,17,6274,2,47,5,1,2,1,2,0,2,0,False,False,False,0,3,2020-12-07T15:53:10.04,2,,0.0
2020,13,2974,385,17,7051,2,4,10,4,11,7,5,6,5,0,False,False,False,1,2,2020-12-07T18:48:24.253,11,,6.0
2020,13,2974,395,17,7051,2,4,10,5,5,0,5,0,5,0,False,False,False,0,3,2020-12-07T15:55:33.903,5,,0.0
2020,13,2974,415,17,6276,2,47,5,1,5,4,4,1,4,0,False,False,False,0,4,2020-12-07T16:01:56.337,5,,1.0
2020,13,2974,425,17,6274,2,17,10,13,17,4,17,0,17,0,True,False,False,0,4,2020-12-07T16:03:53.447,17,,0.0
2020,13,2974,435,17,2253,2,5,3,13,14,1,14,0,14,0,False,False,False,0,3,2020-12-09T16:49:56.213,14,,0.0
2020,13,2974,445,17,7024,2,12,7,19,35,16,30,5,30,0,False,False,False,0,2,2020-12-07T16:10:50.233,35,,5.0
2020,13,2974,450,17,2253,13,9,3,5,0,0,0,0,0,0,False,False,False,0,2,2020-12-07T16:12:04.377,0,,0.0
2020,13,2974,455,17,6274,2,9,9,5,5,0,5,0,5,6,False,False,False,0,3,2020-12-07T16:19:31.943,5,,0.0
2020,13,2974,475,7,4717,3,4,3,3,0,0,0,0,0,0,False,False,False,0,2,2020-12-07T16:24:51.617,0,,0.0
2020,13,2974,480,7,6975,2,4,4,6,7,1,7,0,7,0,False,False,False,0,4,2020-12-07T16:26:25.403,7,,0.0
2020,13,2974,490,17,4305,2,34,4,-4,22,26,15,7,15,0,True,False,False,0,3,2021-03-04T17:26:27.263,22,,7.0
2020,13,2974,495,17,4305,13,3,6,15,0,0,0,0,0,0,False,False,False,0,2,2021-03-17T19:50:10.253,0,,0.0
2020,13,2974,500,17,6276,2,46,3,4,11,7,9,2,9,0,False,False,False,0,3,2020-12-07T16:32:41.273,11,,2.0
2020,13,2974,510,17,2253,2,4,9,8,8,0,8,0,8,0,False,False,False,0,2,2020-12-07T16:36:07.263,8,,0.0
2020,13,2974,515,17,6274,2,8,1,17,20,3,19,1,19,0,False,False,False,0,3,2021-02-25T17:13:45.897,20,,1.0
2020,13,2974,530,17,2253,13,9,3,5,0,0,0,0,0,0,False,False,False,0,3,2021-02-22T19:45:20.837,0,,0.0
2020,13,2974,550,7,910,13,2,10,7,0,0,0,0,0,0,False,False,False,0,2,2020-12-07T16:52:26.47,0,,0.0
2020,13,2974,565,17,6274,2,47,5,-1,4,5,-1,5,-1,0,True,False,False,1,3,2020-12-10T14:18:34.757,4,,5.0
2020,13,2974,570,17,6274,2,4,10,7,8,1,7,1,7,0,False,False,False,0,4,2020-12-10T14:18:48.813,8,,1.0
2020,13,2974,580,17,2253,2,5,3,9,9,0,9,0,9,0,False,False,False,0,3,2020-12-07T17:52:01.71,9,,0.0
2020,13,2974,595,17,7687,2,44,3,0,9,9,2,7,2,0,True,False,False,1,3,2020-12-07T17:12:43.46,9,,7.0
2020,13,2974,610,17,4484,13,9,3,2,0,0,0,0,0,0,True,False,False,0,2,2020-12-08T21:56:02.4,0,,0.0
2020,13,2974,620,17,2253,13,2,9,1,0,0,0,0,0,0,False,False,False,0,3,2020-12-07T17:22:09.737,0,,0.0
2020,13,2974,635,7,7659,13,35,6,17,0,0,0,0,0,0,False,False,False,0,3,2020-12-07T17:26:22.853,0,,0.0
2020,13,2974,660,17,6274,2,2,9,8,18,10,8,10,8,0,False,False,False,0,3,2020-12-07T17:51:09.683,18,,10.0
2020,13,2974,680,17,4305,3,2,9,9,0,0,0,0,0,0,False,False,False,0,2,2020-12-07T17:56:26.537,0,,0.0
2020,13,2974,690,7,7659,13,4,3,6,0,0,0,0,0,0,False,False,False,0,2,2021-04-02T13:54:50.313,0,,0.0
2020,13,2974,705,7,4341,2,2,4,6,9,3,8,1,8,0,False,False,False,0,3,2020-12-07T18:04:18.487,9,,1.0
2020,13,2974,720,7,4341,2,50,10,-3,8,11,3,5,3,0,False,False,False,0,3,2020-12-07T18:09:20.847,8,,5.0
2020,13,2974,750,7,931,2,12,4,-6,-3,3,-5,2,-5,0,False,False,False,0,1,2021-03-08T21:30:48.33,-3,,2.0
2020,13,2974,755,7,6975,2,4,10,3,5,2,3,2,3,0,False,False,False,0,4,2020-12-07T18:21:14.97,5,,2.0
2020,13,2974,760,7,6975,2,31,9,0,6,6,1,5,1,0,False,False,False,1,4,2020-12-10T14:19:57.123,6,,5.0
2020,13,2974,765,7,7659,2,4,3,5,22,17,5,17,5,0,False,False,False,1,2,2020-12-07T18:25:52.797,22,,17.0
2020,13,2974,775,7,931,2,44,3,-5,2,7,0,2,0,0,False,False,False,0,1,2021-02-22T19:46:15.773,2,,2.0
2020,13,2974,780,7,4341,13,6,4,9,0,0,0,0,0,0,False,False,False,0,3,2021-03-05T15:18:51.517,0,,0.0
2020,13,2975,10,15,2757,2,17,1,20,24,4,22,2,22,0,False,False,False,0,4,2020-12-07T11:28:11.903,24,,2.0
2020,13,2975,15,15,8099,2,45,10,-5,8,13,4,4,4,0,False,False,False,0,1,2020-12-08T19:47:16.207,8,,4.0
2020,13,2975,30,15,7591,2,7,6,22,28,6,28,0,28,6,False,False,False,0,3,2020-12-08T02:28:08.913,28,,0.0
2020,13,2975,45,18,1381,2,3,3,10,8,-2,8,0,8,0,True,False,False,0,3,2020-12-08T02:29:34.073,8,,
2020,13,2975,50,18,1381,13,35,2,21,0,0,0,0,0,0,False,False,False,0,3,2020-12-07T11:51:42.253,0,,0.0
2020,13,2975,60,18,4572,3,47,5,1,0,0,0,0,0,0,True,False,False,0,1,2020-12-07T11:55:53.923,0,,0.0
2020,13,2975,80,15,922,2,54,10,1,6,5,4,2,4,0,True,False,False,1,1,2020-12-10T15:37:43.463,6,,2.0
2020,13,2975,90,15,2757,2,26,4,1,7,6,2,5,2,0,False,False,False,1,4,2020-12-07T12:07:59.047,7,,5.0
2020,13,2975,95,15,7592,2,9,6,31,34,3,34,0,34,0,False,False,False,0,2,2020-12-08T02:32:39.073,34,,0.0
2020,13,2975,100,15,8099,2,50,10,-3,1,4,-1,2,-1,0,False,False,False,0,3,2021-03-04T20:05:30.597,1,,2.0
2020,13,2975,110,15,4997,13,7,3,4,0,0,0,0,0,0,False,False,False,0,3,2021-02-25T17:17:18.283,0,,0.0
2020,13,2975,130,18,7711,2,4,9,5,5,0,5,0,5,0,False,False,False,0,3,2020-12-08T02:42:49.97,5,,0.0
2020,13,2975,165,15,2757,2,30,5,3,4,1,4,0,4,0,False,False,False,0,4,2020-12-07T12:36:51.68,4,,0.0
2020,13,2975,175,15,6501,13,3,5,12,0,0,0,0,0,0,False,False,False,0,2,2020-12-07T12:39:28.783,0,,0.0
2020,13,2975,185,18,7711,2,26,10,1,7,6,4,3,4,0,False,False,False,0,3,2020-12-10T16:25:39.31,7,,3.0
2020,13,2975,200,18,1381,13,5,5,9,0,0,0,0,0,0,False,False,False,0,2,2020-12-08T02:46:20.543,0,,0.0
2020,13,2975,215,15,7591,2,6,9,5,7,2,5,2,5,0,True,False,False,0,3,2020-12-07T13:08:39.623,7,,2.0
2020,13,2975,220,15,6501,13,7,6,23,0,0,0,0,0,0,False,False,False,0,2,2020-12-08T02:47:59.953,0,,0.0
2020,13,2975,225,15,7592,2,4,5,5,6,1,5,1,5,0,False,False,False,1,2,2020-12-07T13:13:29.187,6,,1.0
2020,13,2975,230,15,922,2,13,9,4,6,2,5,1,5,0,False,False,False,0,3,2020-12-07T13:15:25.28,6,,1.0
2020,13,2975,255,15,4886,13,46,3,1,0,0,0,0,0,0,False,False,False,0,1,2020-12-07T13:23:28.173,0,,0.0
2020,13,2975,260,15,922,2,4,10,12,13,1,13,0,13,0,False,False,False,0,3,2020-12-08T02:49:10.903,13,,0.0
2020,13,2975,270,15,4702,13,2,9,4,0,0,0,0,0,0,False,False,False,0,2,2021-03-05T15:30:17.253,0,,0.0
2020,13,2975,280,18,1381,2,4,10,6,14,8,5,9,5,0,False,False,False,1,3,2020-12-07T13:34:35.313,14,,9.0
2020,13,2975,290,18,4572,2,48,10,-3,11,14,8,3,8,0,False,False,False,0,1,2020-12-08T02:51:43.887,11,,3.0
2020,13,2975,300,18,1381,2,3,5,13,12,-1,12,0,12,0,False,False,False,0,2,2020-12-08T02:53:01.02,12,,0.0
2020,13,2975,305,18,813,13,35,3,11,0,0,0,0,0,0,False,False,False,0,4,2020-12-07T13:44:24.36,0,,0.0
2020,13,2975,310,18,4572,2,34,4,-4,20,24,11,9,11,0,True,False,False,1,2,2020-12-08T14:40:00.723,20,,9.0
2020,13,2975,320,18,1381,2,35,3,3,3,0,3,0,3,6,False,False,False,0,3,2020-12-07T13:49:53.473,3,,0.0
2020,13,2975,335,15,4886,13,6,4,5,0,0,0,0,0,0,False,False,False,0,1,2020-12-08T02:53:40.223,0,,0.0
2020,13,2975,340,15,8099,2,5,4,-2,6,8,3,3,3,0,False,False,False,0,1,2020-12-08T02:54:30.537,6,,3.0
2020,13,2975,350,15,7591,2,51,9,-3,3,6,1,2,1,0,False,False,False,1,3,2020-12-10T16:21:31.637,3,,2.0
2020,13,2975,375,18,4572,2,44,3,-2,5,7,-2,7,-2,0,False,False,False,1,1,2020-12-07T14:07:00.45,5,,7.0
2020,13,2975,380,18,4572,2,44,3,-2,1,3,0,1,0,0,False,False,False,0,1,2020-12-07T14:08:39.8,1,,1.0
2020,13,2975,395,18,6706,2,46,3,5,5,0,5,0,5,0,True,False,False,0,3,2020-12-08T14:40:14.723,5,,0.0
2020,13,2975,415,15,922,2,5,5,4,4,0,4,0,4,0,False,False,False,0,3,2020-12-07T14:16:14.317,4,,0.0
2020,13,2975,420,15,8099,2,6,9,0,5,5,0,5,0,0,False,False,False,1,1,2020-12-10T15:37:43.463,5,,5.0
2020,13,2975,425,15,6501,13,6,4,8,0,0,0,0,0,0,False,False,False,0,2,2020-12-07T14:20:50.33,0,,0.0
2020,13,2975,435,18,6706,13,47,5,-5,0,0,0,0,0,0,False,False,False,0,3,2020-12-08T14:40:27.36,0,,0.0
2020,13,2975,465,18,4572,13,5,9,3,0,0,0,0,0,0,False,False,False,0,1,2021-03-17T19:51:47.01,0,,0.0
2020,13,2975,480,18,4572,2,5,10,2,10,8,5,5,5,0,False,False,False,0,1,2020-12-07T14:51:35.057,10,,5.0
2020,13,2975,490,18,4572,13,45,4,-7,0,0,0,0,0,0,False,False,False,0,1,2020-12-07T14:54:28.573,0,,0.0
2020,13,2975,495,18,1381,2,3,5,12,11,-1,11,0,11,0,False,False,False,0,2,2020-12-10T16:29:49.923,11,,0.0
2020,13,2975,505,18,7711,2,6,10,4,11,7,9,2,9,0,False,False,False,0,2,2020-12-07T15:01:52.82,11,,2.0
2020,13,2975,510,18,7711,2,19,2,35,40,5,35,5,35,0,False,False,False,0,2,2020-12-07T18:51:22.887,40,,5.0
2020,13,2975,515,18,4152,2,46,9,-2,12,14,10,2,10,6,False,False,False,0,1,2020-12-10T15:37:43.463,12,,2.0
2020,13,2975,540,15,8099,2,47,5,3,6,3,4,2,4,0,False,False,False,1,1,2020-12-07T15:12:18.837,6,,2.0
2020,13,2975,550,15,2757,2,5,10,3,6,3,5,1,5,0,False,False,False,0,4,2020-12-08T03:06:21.57,6,,1.0
2020,13,2975,560,15,7592,13,9,2,16,0,0,0,0,0,0,False,False,False,0,2,2020-12-08T03:07:45.003,0,,0.0
2020,13,2975,580,18,1381,2,4,3,6,9,3,9,0,9,0,False,False,False,0,3,2020-12-08T03:08:49.723,9,,0.0
2020,13,2975,590,18,7711,13,5,6,18,0,0,0,0,0,0,False,False,False,0,3,2020-12-10T16:31:24.34,0,,
2020,13,2975,600,18,7711,13,4,3,-3,0,0,0,0,0,0,False,False,False,0,3,2021-02-22T19:54:05.697,0,,0.0
2020,13,2975,605,18,1381,2,4,9,12,12,0,12,0,12,0,False,False,False,0,3,2020-12-08T03:11:23.13,12,,0.0
2020,13,2975,615,18,7711,13,19,2,35,0,0,0,0,0,0,False,False,False,0,3,2021-02-22T19:55:44.82,0,,
2020,13,2975,620,18,7711,2,22,2,20,20,0,20,0,20,6,False,False,False,0,2,2020-12-10T15:37:43.463,20,,0.0
2020,13,2975,635,15,7592,13,19,6,20,0,0,0,0,0,0,False,False,False,0,2,2021-03-17T19:52:37.683,0,,0.0
2020,13,2975,640,15,7592,2,5,5,6,5,-1,5,0,5,0,False,False,False,0,2,2020-12-07T15:59:56.627,5,,0.0
2020,13,2975,660,18,1381,2,18,5,-1,5,6,3,2,3,0,False,False,False,0,2,2020-12-07T16:08:41.063,5,,2.0
2020,13,2975,715,18,7711,2,2,9,7,14,7,10,4,10,0,False,False,False,0,2,2020-12-10T16:22:51.853,14,,4.0
2020,13,2975,725,18,7711,2,4,9,4,4,0,4,0,4,0,False,False,False,0,3,2020-12-07T16:33:05.743,4,,0.0
2020,13,2975,730,18,7711,13,9,2,30,0,0,0,0,0,0,False,False,False,0,3,2020-12-10T16:34:37.973,0,,0.0
2020,13,2975,745,15,2757,13,39,4,5,0,0,0,0,0,0,False,False,False,0,3,2020-12-08T03:26:33.077,0,,0.0
2020,13,2975,750,15,922,2,13,9,4,6,2,6,0,6,0,False,False,False,0,3,2020-12-10T16:35:20.23,6,,0.0
2020,13,2975,780,15,6501,2,4,7,17,19,2,17,2,17,0,False,False,False,0,2,2020-12-08T03:30:53.463,19,,2.0
2020,13,2975,790,15,2407,2,4,10,4,4,0,4,0,4,0,False,True,True,0,3,2020-12-07T16:54:55.24,3,,0.0
2020,13,2975,795,18,7711,2,35,10,10,11,1,11,0,11,0,False,False,False,0,3,2020-12-08T03:34:27.04,11,,0.0
2020,13,2975,810,18,7711,13,19,6,25,0,0,0,0,0,0,False,False,False,0,2,2020-12-07T17:04:02.343,0,,0.0
2020,13,2975,825,15,4997,2,6,4,5,7,2,7,0,7,0,False,False,False,0,3,2020-12-10T15:37:43.463,7,,0.0
2020,13,2975,830,15,8099,2,28,9,-6,4,10,-4,8,-4,0,False,False,False,1,1,2020-12-07T17:11:22.123,4,,8.0
2020,13,2975,835,15,922,2,13,10,4,10,6,9,1,9,0,False,False,False,0,3,2020-12-08T03:35:05.907,10,,1.0
2020,13,2975,840,15,6501,13,9,2,25,0,0,0,0,0,0,False,False,False,0,2,2020-12-07T17:15:54.083,0,,0.0
2020,13,2975,845,15,2407,2,26,9,6,9,3,7,2,7,0,False,False,False,0,2,2020-12-08T03:35:50.903,9,,2.0
2020,13,2975,860,15,6501,2,5,6,21,22,1,21,1,21,0,False,False,False,0,3,2021-02-22T19:59:24.467,22,,1.0
2020,13,2975,870,15,7592,2,5,2,19,21,2,20,1,20,0,False,False,False,0,2,2020-12-08T03:37:36.047,21,,1.0
2020,13,2975,905,18,6706,2,5,3,6,5,-1,5,0,5,0,False,False,False,0,3,2020-12-07T17:38:50.703,5,,0.0
2020,13,2975,920,18,566,2,42,4,4,18,14,16,2,16,0,True,False,False,0,3,2020-12-10T15:37:43.463,18,,2.0
2020,13,2975,935,18,7711,2,6,10,6,9,3,7,2,7,0,False,False,False,0,2,2020-12-08T14:41:03.32,9,,2.0
2020,13,2975,945,18,1381,13,19,2,28,0,0,0,0,0,0,False,False,False,0,2,2020-12-07T17:48:50.453,0,,0.0
2020,13,2975,980,18,813,13,36,4,8,0,0,0,0,0,0,False,False,False,0,4,2020-12-07T17:57:37.26,0,,0.0
2020,13,2975,990,18,7711,2,22,7,45,47,2,47,0,47,0,False,False,False,0,3,2020-12-10T16:36:25.12,47,,
2020,13,2975,995,18,4572,2,48,10,-3,12,15,12,0,12,0,False,False,False,0,1,2020-12-08T03:42:24.817,12,,0.0
2020,13,2975,1005,15,2757,13,5,5,13,0,0,0,0,0,0,False,False,False,0,4,2020-12-07T18:10:03.327,0,,0.0
2020,13,2975,1015,15,6501,13,8,7,26,0,0,0,0,0,0,False,False,False,0,3,2020-12-08T03:44:28.083,0,,0.0
2020,13,2975,1020,18,1381,2,4,9,6,9,3,8,1,8,0,False,False,False,0,3,2020-12-07T18:15:01.97,9,,1.0
2020,13,2975,1025,18,6361,13,35,5,14,0,0,0,0,0,0,False,False,False,0,4,2020-12-07T18:16:51.68,0,,
2020,13,2975,1030,18,6361,2,2,4,7,10,3,8,2,8,0,False,False,False,0,4,2020-12-10T15:37:43.463,10,,2.0
2020,13,2976,20,22,256,2,35,9,14,22,8,20,2,20,0,False,False,False,0,3,2021-02-22T20:04:34.53,22,,2.0
2020,13,2976,35,22,3170,2,2,4,8,11,3,11,0,11,0,False,False,False,0,3,2020-12-07T11:38:14.757,11,,0.0
2020,13,2976,40,22,3170,13,30,3,0,0,0,0,0,0,0,True,False,False,0,4,2020-12-08T16:51:35.32,0,,0.0
2020,13,2976,50,22,7610,2,13,9,2,17,15,13,4,13,0,False,False,False,0,3,2020-12-07T11:44:13.797,17,,4.0
2020,13,2976,65,22,3170,2,46,3,3,3,0,3,0,3,6,False,False,False,0,3,2020-12-08T16:52:11.6,3,,0.0
2020,13,2976,80,23,2256,13,19,6,31,0,0,0,0,0,0,False,False,False,0,2,2020-12-07T11:52:29.913,0,,0.0
2020,13,2976,85,23,7240,2,47,5,1,2,1,2,0,2,0,False,False,False,0,1,2020-12-07T11:54:33.79,2,,0.0
2020,13,2976,90,23,2994,2,2,10,3,18,15,16,2,16,0,False,False,False,0,4,2020-12-10T19:14:15.947,18,,2.0
2020,13,2976,100,23,2994,2,6,9,12,12,0,12,0,12,0,False,False,False,0,4,2020-12-10T19:27:00.727,12,,0.0
2020,13,2976,105,23,2994,2,5,3,5,9,4,7,2,7,0,False,False,False,0,3,2020-12-07T12:03:30.63,9,,2.0
2020,13,2976,110,23,7688,13,26,9,7,0,0,0,0,0,0,True,False,False,0,4,2021-03-05T15:34:12.887,0,,0.0
2020,13,2976,125,22,7610,13,7,6,24,0,0,0,0,0,0,False,False,False,0,3,2020-12-08T16:48:48.543,0,,0.0
2020,13,2976,140,23,2994,2,47,5,1,3,2,1,2,1,0,True,False,False,0,4,2020-12-10T19:13:49.933,3,,2.0
2020,13,2976,145,23,2256,13,7,7,22,0,0,0,0,0,0,False,False,False,0,3,2021-02-25T17:22:33.25,0,,
2020,13,2976,150,23,7688,2,11,3,12,28,16,25,3,25,0,True,False,False,0,4,2020-12-07T18:18:15.21,28,,3.0
2020,13,2976,160,23,2994,2,5,6,18,28,10,28,0,28,0,False,False,False,0,4,2020-12-10T16:42:42.557,28,,0.0
2020,13,2976,170,23,2994,2,16,9,9,9,0,9,0,9,6,False,False,False,0,4,2021-02-25T17:23:30.3,9,,0.0
2020,13,2976,195,22,3170,2,2,9,5,16,11,10,6,10,0,False,False,False,0,3,2020-12-08T16:49:03.693,16,,6.0
2020,13,2976,200,22,2391,2,46,3,4,13,9,10,3,10,0,False,False,False,0,1,2020-12-07T12:57:53.213,13,,3.0
2020,13,2976,210,22,3170,13,5,5,3,0,0,0,0,0,0,False,False,False,0,3,2020-12-07T13:07:07.813,0,,0.0
2020,13,2976,220,22,3170,2,4,5,6,6,0,6,0,6,6,False,False,False,0,3,2020-12-07T13:11:47.74,6,,0.0
2020,13,2976,235,23,2994,2,47,5,1,6,5,2,4,2,0,True,False,False,0,4,2020-12-10T19:30:43.987,6,,4.0
2020,13,2976,245,23,2994,13,35,10,14,0,0,0,0,0,0,False,False,False,0,3,2021-02-22T20:06:35.36,0,,0.0
2020,13,2976,250,23,7250,2,5,5,4,4,0,4,0,4,0,False,False,False,0,3,2020-12-07T13:23:06.413,4,,0.0
2020,13,2976,255,23,7250,2,26,9,6,17,11,8,9,8,0,False,False,False,0,3,2020-12-10T19:15:28.563,17,,9.0
2020,13,2976,265,23,2994,13,12,6,20,0,0,0,0,0,0,False,False,False,0,4,2020-12-10T19:18:42.953,0,,0.0
2020,13,2976,270,23,7689,13,26,3,7,0,0,0,0,0,0,False,False,False,0,2,2020-12-07T13:31:43.067,0,,0.0
2020,13,2976,285,22,7610,2,4,7,20,23,3,21,2,21,0,False,False,False,1,2,2020-12-07T13:43:56.42,23,,2.0
2020,13,2976,300,23,2994,13,2,9,7,0,0,0,0,0,0,False,False,False,0,2,2020-12-07T13:49:21.333,0,,0.0
2020,13,2976,345,22,256,13,4,5,5,0,0,0,0,0,0,False,False,False,0,2,2020-12-07T13:59:45.06,0,,0.0
2020,13,2976,355,23,2256,2,13,9,3,13,10,12,1,12,0,False,False,False,0,3,2020-12-07T14:02:33.267,13,,1.0
2020,13,2976,365,23,2256,2,3,3,14,14,0,14,0,14,0,False,False,False,0,2,2020-12-08T17:02:08.08,14,,0.0
2020,13,2976,370,23,2256,2,4,5,3,4,1,3,1,3,0,False,False,False,0,2,2020-12-07T14:44:24.34,4,,1.0
2020,13,2976,375,23,2994,2,4,5,4,38,34,4,34,4,6,False,False,False,2,2,2020-12-10T19:16:41.033,38,,34.0
2020,13,2976,395,22,256,3,4,10,8,0,0,0,0,0,0,False,False,False,0,2,2021-02-22T20:07:31.223,0,,0.0
2020,13,2976,400,22,6270,2,51,10,-1,25,26,17,8,17,0,False,False,False,1,3,2021-03-04T17:33:33.853,25,,8.0
2020,13,2976,405,22,6270,2,46,3,3,8,5,3,5,3,0,False,False,False,0,3,2020-12-10T19:33:22.84,8,,5.0
2020,13,2976,425,23,7250,2,5,2,18,18,0,18,0,18,0,False,False,False,0,4,2020-12-10T19:50:23.567,18,,0.0
2020,13,2976,430,23,2256,13,12,6,16,0,0,0,0,0,0,False,False,False,0,2,2020-12-10T17:19:57.087,0,,0.0
2020,13,2976,470,23,4949,3,13,10,1,0,0,0,0,0,0,False,False,False,0,3,2021-02-22T20:07:55.42,0,,0.0
2020,13,2976,475,23,7250,2,26,9,5,8,3,8,0,8,0,False,False,False,0,3,2020-12-07T15:17:40.277,8,,0.0
2020,13,2976,485,23,2994,2,13,9,3,19,16,17,2,17,0,False,False,False,0,4,2020-12-07T15:20:56.89,19,,2.0
2020,13,2976,515,23,2994,2,2,10,7,9,2,7,2,7,0,False,False,False,0,2,2020-12-07T15:36:18.423,9,,2.0
2020,13,2976,560,22,256,13,17,1,27,0,0,0,0,0,0,False,False,False,0,3,2020-12-07T15:56:51.693,0,,0.0
2020,13,2976,575,23,3957,13,47,5,0,0,0,0,0,0,0,False,False,False,0,1,2020-12-07T16:02:48.967,0,,0.0
2020,13,2976,580,23,567,2,32,5,-5,3,8,-1,4,-1,0,False,False,False,1,1,2020-12-07T16:05:17.703,3,,4.0
2020,13,2976,595,22,6812,2,4,10,1,3,2,2,1,2,0,False,False,False,0,1,2020-12-07T16:10:35.883,3,,1.0
2020,13,2976,600,22,6812,2,48,4,-1,10,11,7,3,7,0,False,False,False,0,1,2020-12-07T16:12:02.647,10,,3.0
2020,13,2976,620,23,2994,13,2,10,0,0,0,0,0,0,0,False,False,False,0,3,2020-12-07T16:17:10.853,0,,0.0
2020,13,2976,645,22,3170,2,26,10,4,11,7,7,4,7,0,False,False,False,0,3,2020-12-10T19:17:24.707,11,,4.0
2020,13,2976,695,23,3957,2,32,9,-3,1,4,1,0,1,0,False,False,False,0,1,2020-12-07T16:49:30.283,1,,0.0
2020,13,2976,705,23,7688,2,6,10,10,12,2,11,1,11,0,False,True,True,0,3,2020-12-07T18:19:00.767,10,,1.0
2020,13,2976,720,22,2391,2,30,5,1,18,17,16,2,16,0,True,False,False,0,4,2020-12-07T17:00:57.077,18,,2.0
2020,13,2976,750,23,3843,2,28,4,1,6,5,5,1,5,0,False,False,False,0,1,2020-12-10T19:41:28.633,6,,1.0
2020,13,2976,755,23,2256,2,13,10,4,7,3,7,0,7,0,False,False,False,0,2,2020-12-07T17:18:45.92,7,,0.0
2020,13,2976,760,23,2256,13,23,1,47,0,0,0,0,0,0,False,False,False,0,3,2020-12-10T16:36:59.837,0,,0.0
2020,13,2976,765,23,7250,13,2,10,4,0,0,0,0,0,0,False,False,False,0,3,2020-12-08T17:02:48.983,0,,0.0
2020,13,2976,770,23,2994,2,6,5,14,29,15,29,0,29,0,False,False,False,0,3,2020-12-07T17:25:01.29,29,,0.0
2020,13,2976,780,23,2994,2,26,10,4,5,1,4,1,4,0,False,False,False,0,3,2020-12-08T17:03:24.357,5,,1.0
2020,13,2976,785,23,7250,13,26,4,4,0,0,0,0,0,0,False,False,False,0,3,2020-12-07T17:31:28.93,0,,
2020,13,2976,795,23,2256,13,7,2,21,0,0,0,0,0,0,False,False,False,0,3,2020-12-10T16:42:42.557,0,,0.0
2020,13,2976,800,23,2256,13,17,8,21,0,0,0,0,0,0,False,False,False,0,3,2020-12-07T17:36:49.833,0,,0.0
2020,13,2976,805,23,2994,13,17,8,15,0,0,0,0,0,0,False,False,False,0,3,2020-12-10T16:42:42.557,0,,
2020,13,2976,830,23,596,13,12,5,3,0,0,0,0,0,0,False,False,False,0,4,2020-12-07T17:43:49.41,0,,0.0
2020,13,2976,835,23,7250,2,12,9,9,9,0,9,0,9,0,True,False,False,0,3,2020-12-08T17:07:15.237,9,,
2020,13,2976,840,23,2256,13,7,3,9,0,0,0,0,0,0,False,False,False,0,3,2020-12-10T17:20:11.007,0,,0.0
2020,13,2976,875,23,2994,2,4,10,14,15,1,13,2,13,0,False,False,False,0,3,2020-12-07T17:54:41.237,15,,2.0
2020,13,2976,885,23,2256,13,23,1,46,0,0,0,0,0,0,False,False,False,0,3,2020-12-10T19:45:33.1,0,,0.0
2020,13,2976,890,23,7688,2,21,7,45,46,1,46,0,46,6,False,False,False,0,2,2020-12-07T18:17:21.673,46,,0.0
2020,13,2976,905,22,3170,13,12,2,48,0,0,0,0,0,0,False,False,False,0,2,2021-03-08T21:36:58.993,0,,0.0
2020,13,2977,10,25,6486,13,21,2,35,0,0,0,0,0,0,False,False,False,0,2,2021-03-15T17:48:27.413,0,,0.0
2020,13,2977,15,25,6259,2,4,3,5,6,1,4,2,4,0,False,False,False,1,2,2020-12-08T15:14:01.553,6,,2.0
2020,13,2977,20,25,609,2,2,10,1,3,2,2,1,2,0,True,False,False,0,2,2020-12-10T19:04:52.253,3,,1.0
2020,13,2977,30,32,7128,2,4,10,5,12,7,9,3,9,0,False,False,False,0,3,2021-02-22T20:13:44.113,12,,3.0
2020,13,2977,40,32,8237,13,26,10,5,0,0,0,0,0,0,False,False,False,0,3,2020-12-08T11:48:00.31,0,,0.0
2020,13,2977,45,32,7494,2,12,5,4,8,4,6,2,6,0,False,False,False,0,3,2021-03-08T21:38:57.147,8,,2.0
2020,13,2977,60,25,4583,2,50,9,-3,0,3,-3,3,-3,0,False,False,False,0,3,2020-12-08T15:13:06.973,0,,3.0
2020,13,2977,70,25,4583,3,12,8,16,0,0,0,0,0,0,False,False,False,0,3,2020-12-08T15:13:16.067,0,,0.0
2020,13,2977,90,32,1427,2,13,10,5,8,3,7,1,7,0,False,False,False,0,3,2020-12-08T12:15:31.693,8,,1.0
2020,13,2977,95,32,1427,2,32,9,1,6,5,6,0,6,0,False,False,False,0,4,2020-12-08T12:17:08.223,6,,0.0
2020,13,2977,110,32,6430,13,4,3,7,0,0,0,0,0,0,False,False,False,0,2,2020-12-08T12:21:21.75,0,,0.0
2020,13,2977,115,32,1427,2,12,5,0,0,0,0,0,0,0,False,False,False,0,4,2021-03-08T21:39:21.533,0,,0.0
2020,13,2977,130,25,6486,2,17,8,24,30,6,30,0,30,0,True,False,False,0,3,2020-12-08T12:29:27.807,30,,0.0
2020,13,2977,145,25,7060,13,29,2,17,0,0,0,0,0,0,False,False,False,0,2,2020-12-08T12:33:27.44,0,,0.0
2020,13,2977,160,32,8237,13,42,4,3,0,0,0,0,0,0,False,False,False,0,3,2021-02-22T20:15:09.383,0,,0.0
2020,13,2977,165,32,7494,3,2,4,4,0,0,0,0,0,0,False,False,False,0,3,2020-12-08T12:37:32.213,0,,0.0
2020,13,2977,175,25,609,2,38,10,2,13,11,10,3,10,0,False,False,False,0,4,2020-12-08T15:14:42.503,13,,3.0
2020,13,2977,180,25,609,2,5,9,4,4,0,4,0,4,0,False,False,False,0,3,2020-12-08T15:11:43.513,4,,0.0
2020,13,2977,185,25,7060,2,6,9,5,5,0,5,0,5,0,False,False,False,0,2,2020-12-08T15:11:51.627,5,,0.0
2020,13,2977,200,25,6259,2,49,3,-3,-2,1,-2,0,-2,0,False,False,False,0,2,2020-12-08T13:13:51.743,-2,,0.0
2020,13,2977,205,25,7060,3,6,10,2,0,0,0,0,0,0,False,False,False,0,2,2020-12-08T15:12:04.377,0,,0.0
2020,13,2977,210,25,7060,2,3,6,15,17,2,14,3,14,0,False,False,False,1,2,2020-12-08T15:14:57.787,17,,3.0
2020,13,2977,215,25,7081,2,46,3,3,4,1,4,0,4,0,False,False,False,0,3,2020-12-08T15:15:07.103,4,,0.0
2020,13,2977,220,25,7666,13,4,10,4,0,0,0,0,0,0,False,False,False,0,3,2020-12-08T15:12:20.543,0,,0.0
2020,13,2977,225,25,609,2,7,3,13,15,2,14,1,14,0,False,False,False,0,3,2020-12-08T13:22:43,15,,1.0
2020,13,2977,230,25,7060,2,49,3,-4,8,12,4,4,4,0,True,False,False,1,3,2020-12-08T13:24:29.637,8,,4.0
2020,13,2977,235,25,7060,2,18,3,1,6,5,3,3,3,6,False,False,False,0,2,2021-03-08T15:18:19.2,6,,
2020,13,2977,240,25,609,13,17,4,11,0,0,0,0,0,0,False,False,False,0,3,2020-12-08T13:27:38.03,0,,0.0
2020,13,2977,245,25,7666,2,4,5,8,8,0,8,0,8,0,False,False,False,0,3,2021-03-08T15:19:45.607,8,,0.0
2020,13,2977,250,25,7060,2,5,3,3,3,0,3,0,3,6,False,False,False,0,2,2020-12-08T13:30:28.543,3,,0.0
2020,13,2977,275,32,1427,2,4,10,4,5,1,4,1,4,0,False,False,False,1,3,2020-12-08T15:15:39.167,5,,1.0
2020,13,2977,280,32,7128,2,50,9,-2,2,4,-1,3,-1,0,False,False,False,1,2,2020-12-08T15:15:47.137,2,,3.0
2020,13,2977,285,32,1427,2,32,5,1,12,11,4,8,4,0,False,False,False,2,3,2020-12-10T19:03:37.35,12,,8.0
2020,13,2977,295,25,6490,2,48,9,-6,-4,2,-5,1,-5,0,False,False,False,0,1,2020-12-08T13:45:50.1,-4,,1.0
2020,13,2977,300,25,7666,2,8,1,29,30,1,30,0,30,0,False,False,False,0,2,2020-12-08T13:48:20.757,30,,0.0
2020,13,2977,310,25,7081,13,47,5,1,0,0,0,0,0,0,False,False,False,0,1,2020-12-08T13:51:11.79,0,,0.0
2020,13,2977,330,25,3422,3,32,5,-1,0,0,0,0,0,0,False,False,False,0,4,2020-12-10T18:53:38.14,0,,0.0
2020,13,2977,345,32,7128,13,4,10,4,0,0,0,0,0,0,False,False,False,0,3,2020-12-10T19:00:17.347,0,,0.0
2020,13,2977,350,32,1427,2,32,5,2,6,4,4,2,4,0,False,False,False,0,4,2020-12-08T14:02:14.353,6,,2.0
2020,13,2977,360,25,6486,2,4,3,7,50,43,7,43,7,6,False,False,False,2,2,2020-12-08T14:04:03.053,50,,43.0
2020,13,2977,375,32,7494,2,26,10,1,2,1,2,0,2,0,False,False,False,0,3,2020-12-08T15:16:25.82,2,,0.0
2020,13,2977,380,32,1427,2,5,2,16,16,0,16,0,16,0,False,False,False,0,3,2020-12-08T14:07:22.603,16,,0.0
2020,13,2977,385,32,7494,13,8,1,24,0,0,0,0,0,0,False,False,False,0,3,2020-12-08T14:08:59.33,0,,0.0
2020,13,2977,390,32,3885,2,16,10,2,3,1,3,0,3,0,False,False,False,0,1,2020-12-08T15:16:40.24,3,,0.0
2020,13,2977,400,32,7128,3,19,2,34,0,0,0,0,0,0,False,False,False,0,3,2020-12-08T14:16:38.617,0,,0.0
2020,13,2977,420,25,7060,2,5,10,2,6,4,6,0,6,0,False,False,False,0,3,2020-12-08T14:21:19.56,6,,0.0
2020,13,2977,430,25,4583,2,51,9,-3,2,5,-3,5,-3,0,True,False,False,0,3,2020-12-08T14:22:37.73,2,,5.0
2020,13,2977,440,32,6430,2,2,10,5,30,25,8,22,8,0,False,False,False,2,2,2020-12-08T14:25:05.78,30,,22.0
2020,13,2977,445,32,3885,2,44,3,1,11,10,11,0,11,0,False,False,False,0,1,2020-12-08T14:26:00.653,11,,0.0
2020,13,2977,450,32,3885,2,44,3,-3,1,4,0,1,0,0,False,False,False,0,1,2020-12-08T14:27:07.003,1,,1.0
2020,13,2977,490,32,7128,13,26,10,2,0,0,0,0,0,0,False,False,False,0,2,2020-12-08T14:42:53.133,0,,
2020,13,2977,500,32,6430,2,6,10,4,4,0,4,0,4,0,False,False,False,0,2,2020-12-08T14:45:07.617,4,,0.0
2020,13,2977,505,32,8237,2,26,9,3,5,2,4,1,4,0,False,False,False,1,3,2020-12-08T14:46:12.097,5,,1.0
2020,13,2977,510,32,6430,2,50,5,-1,31,32,-1,32,-1,0,False,False,False,0,2,2020-12-08T14:47:55.373,31,,32.0
2020,13,2977,530,32,7128,13,6,1,18,0,0,0,0,0,0,False,False,False,0,2,2020-12-08T14:52:18.583,0,,0.0
2020,13,2977,535,32,7494,2,5,10,3,9,6,6,3,6,0,False,False,False,0,3,2020-12-08T14:53:40.98,9,,3.0
2020,13,2977,540,32,7494,2,51,9,-4,-2,2,-3,1,-3,0,False,False,False,0,3,2020-12-08T14:55:37.56,-2,,1.0
2020,13,2977,545,32,1427,2,7,6,22,30,8,27,3,27,0,False,False,False,0,3,2020-12-08T14:57:37.493,30,,3.0
2020,13,2977,555,32,6430,13,9,5,1,0,0,0,0,0,0,False,False,False,0,2,2020-12-10T18:54:09.07,0,,0.0
2020,13,2977,585,25,7081,2,44,9,-6,1,7,-2,3,-2,0,False,False,False,0,1,2020-12-08T15:04:55.633,1,,3.0
2020,13,2977,590,25,609,3,4,4,4,0,0,0,0,0,0,False,False,False,0,3,2020-12-08T15:09:22.68,0,,0.0
2020,13,2977,595,25,4583,2,35,9,8,8,0,8,0,8,0,False,False,False,0,3,2020-12-08T15:20:59.827,8,,
2020,13,2977,600,25,4583,2,26,10,1,1,0,1,0,1,0,False,False,False,0,3,2020-12-08T15:23:15.773,1,,0.0
2020,13,2977,610,25,7060,3,6,4,5,0,0,0,0,0,0,False,False,False,0,2,2020-12-08T15:28:49.973,0,,0.0
2020,13,2977,625,32,3885,2,42,4,4,6,2,4,2,4,0,False,False,False,0,3,2020-12-08T15:33:25.03,6,,2.0
2020,13,2977,645,25,7060,2,2,10,4,14,10,12,2,12,0,False,False,False,0,2,2020-12-08T15:42:09.783,14,,2.0
2020,13,2977,650,25,7060,13,12,2,22,0,0,0,0,0,0,False,False,False,0,2,2020-12-08T15:45:15.417,0,,
2020,13,2977,655,25,609,2,39,4,3,6,3,5,1,5,0,False,False,False,0,3,2020-12-08T15:48:18.463,6,,1.0
2020,13,2977,660,25,609,3,4,9,6,0,0,0,0,0,0,False,False,False,0,3,2020-12-08T15:49:16.563,0,,0.0
2020,13,2977,665,25,7060,2,6,7,15,16,1,16,0,16,0,False,False,False,0,2,2020-12-08T15:51:24.69,16,,0.0
2020,13,2977,670,25,7060,3,13,4,1,0,0,0,0,0,0,False,False,False,0,2,2020-12-08T16:01:46.52,0,,0.0
2020,13,2977,675,25,6490,2,47,10,0,8,8,1,7,1,0,False,False,False,2,1,2020-12-08T16:03:37.297,8,,7.0
2020,13,2977,680,25,7666,13,9,3,13,0,0,0,0,0,0,False,False,False,0,3,2020-12-08T16:04:56.003,0,,
2020,13,2977,690,25,6486,13,13,9,2,0,0,0,0,0,0,False,False,False,0,3,2020-12-08T16:07:22.623,0,,0.0
2020,13,2977,695,25,609,2,12,9,-3,5,8,0,5,0,0,False,False,False,1,4,2021-03-08T21:39:54.08,5,,5.0
2020,13,2977,715,32,3885,2,50,10,-1,6,7,4,2,4,0,False,False,False,0,2,2020-12-08T16:11:43.563,6,,2.0
2020,13,2977,725,32,7128,13,13,10,3,0,0,0,0,0,0,False,False,False,0,3,2020-12-08T16:14:50.843,0,,0.0
2020,13,2977,735,25,6259,13,50,10,-3,0,0,0,0,0,0,False,False,False,0,3,2020-12-08T16:17:51.487,0,,0.0
2020,13,2977,740,25,4583,13,17,1,24,0,0,0,0,0,0,False,False,False,0,3,2020-12-08T16:20:10.733,0,,0.0
2020,13,2977,760,32,3885,2,13,10,2,6,4,4,2,4,0,False,False,False,0,2,2020-12-10T12:54:42.953,6,,2.0
2020,13,2977,770,32,6430,13,19,2,35,0,0,0,0,0,0,False,False,False,0,2,2020-12-08T16:31:36.533,0,,0.0
2020,13,2977,775,32,3885,2,5,5,6,16,10,16,0,16,0,False,False,False,0,3,2020-12-08T16:34:20.953,16,,0.0
2020,13,2977,785,32,3885,2,45,10,-4,8,12,8,0,8,0,False,False,False,0,1,2020-12-08T16:36:48.063,8,,0.0
2020,13,2977,790,32,1427,2,24,3,14,15,1,15,0,15,6,False,False,False,0,3,2020-12-10T17:17:22.633,15,,0.0
2020,13,2977,805,25,4583,2,39,4,4,7,3,7,0,7,0,False,False,False,0,3,2020-12-08T16:43:23.187,7,,0.0
2020,13,2977,810,25,6490,2,18,3,0,7,7,7,0,7,0,False,False,False,0,2,2020-12-10T17:17:22.633,7,,0.0
2020,13,2977,815,25,7060,2,13,9,2,2,0,2,0,2,0,False,False,False,0,3,2020-12-08T16:44:24.197,2,,0.0
2020,13,2977,820,25,4583,2,13,9,5,5,0,5,0,5,0,False,False,False,0,3,2020-12-08T16:45:59.417,5,,0.0
2020,13,2977,825,25,4583,2,26,10,1,4,3,2,2,2,0,False,False,False,0,3,2020-12-08T16:47:16.027,4,,2.0
2020,13,2977,830,25,6490,13,6,9,1,0,0,0,0,0,0,False,False,False,0,1,2020-12-08T16:48:48.177,0,,0.0
2020,13,2977,835,25,4583,2,6,4,4,9,5,8,1,8,0,False,False,False,0,3,2020-12-08T16:49:57.13,9,,1.0
2020,13,2977,840,25,4583,3,47,10,1,0,0,0,0,0,0,False,False,False,0,3,2020-12-08T16:51:46.647,0,,0.0
2020,13,2977,845,25,7665,13,20,2,16,0,0,0,0,0,0,True,False,False,0,2,2020-12-08T16:53:20.787,0,,0.0
2020,13,2977,855,32,3885,2,51,10,-3,7,10,5,2,5,0,False,False,False,0,3,2020-12-08T16:55:51.983,7,,2.0
2020,13,2977,860,32,3885,2,26,9,5,6,1,6,0,6,0,False,False,False,0,3,2020-12-08T16:57:26.593,6,,0.0
2020,13,2977,865,32,8237,13,6,9,5,0,0,0,0,0,0,False,False,False,0,3,2020-12-08T16:59:00.32,0,,0.0
2020,13,2977,870,32,6430,2,9,2,24,29,5,29,0,29,0,False,False,False,0,3,2020-12-08T17:01:04.647,29,,0.0
2020,13,2977,885,32,6430,2,50,3,-2,-2,0,-2,0,-2,0,False,False,False,0,2,2020-12-08T17:20:29.427,-2,,0.0
2020,13,2977,895,32,6430,13,5,5,5,0,0,0,0,0,0,False,False,False,0,2,2021-02-22T20:16:23.21,0,,0.0
2020,13,2977,910,25,609,13,47,5,0,0,0,0,0,0,0,False,False,False,0,4,2020-12-08T17:11:45.84,0,,0.0
2020,13,2977,950,25,7666,13,19,2,29,0,0,0,0,0,0,False,False,False,0,2,2020-12-08T17:22:56.36,0,,0.0
2020,13,2977,955,25,609,2,7,6,18,22,4,21,1,21,0,False,False,False,0,2,2020-12-08T17:23:54.403,22,,1.0
2020,13,2978,10,8,232,2,2,4,4,10,6,7,3,7,0,False,False,False,0,3,2020-12-08T17:40:55.177,10,,3.0
2020,13,2978,20,8,3606,2,4,8,17,35,18,33,2,33,0,False,False,False,0,2,2020-12-08T22:25:35.31,35,,2.0
2020,13,2978,30,8,7651,3,2,4,8,0,0,0,0,0,0,False,False,False,0,3,2020-12-07T11:15:28.65,0,,0.0
2020,13,2978,35,8,7009,2,47,5,0,5,5,5,0,5,0,False,False,False,0,1,2020-12-07T11:16:52.223,5,,0.0
2020,13,2978,45,8,232,2,5,3,4,4,0,4,0,4,0,False,False,False,0,3,2020-12-10T23:18:37.06,4,,0.0
2020,13,2978,65,31,5080,2,6,9,9,18,9,18,0,18,0,False,False,False,0,3,2020-12-07T11:22:07.04,18,,0.0
2020,13,2978,80,31,7917,13,38,9,3,0,0,0,0,0,0,False,False,False,0,5,2020-12-10T23:00:55.74,0,,0.0
2020,13,2978,95,8,6439,2,48,10,-2,26,28,23,3,23,0,False,False,False,0,1,2020-12-07T11:31:38.477,26,,3.0
2020,13,2978,110,8,5217,2,11,3,6,6,0,6,0,6,0,False,False,False,0,6,2021-03-04T17:42:46.997,6,,0.0
2020,13,2978,120,8,232,13,4,9,8,0,0,0,0,0,0,False,False,False,0,3,2020-12-07T11:40:47.07,0,,0.0
2020,13,2978,125,8,3606,2,12,5,7,7,0,7,0,7,0,False,False,False,0,3,2020-12-08T22:26:18.927,7,,0.0
2020,13,2978,135,8,232,2,6,9,2,2,0,2,0,2,6,True,False,False,0,3,2020-12-07T11:46:18.11,2,,0.0
2020,13,2978,160,8,3606,2,4,3,5,8,3,8,0,8,0,False,False,False,0,2,2020-12-07T11:51:37.777,8,,0.0
2020,13,2978,170,8,232,2,5,3,3,7,4,6,1,6,0,False,False,False,0,3,2020-12-10T22:55:19.077,7,,1.0
2020,13,2978,180,8,232,2,4,5,4,6,2,6,0,6,0,False,False,False,0,3,2020-12-07T11:56:47.047,6,,0.0
2020,13,2978,195,8,2932,2,32,9,1,1,0,1,0,1,6,False,False,False,0,4,2020-12-07T12:01:39.26,1,,0.0
2020,13,2978,210,31,6793,2,2,4,6,12,6,7,5,7,0,False,False,False,0,3,2020-12-10T23:14:07.537,12,,5.0
2020,13,2978,220,31,6793,2,8,1,40,40,0,40,0,40,0,False,False,False,0,2,2020-12-07T15:58:36.003,40,,0.0
2020,13,2978,225,31,5080,2,12,8,17,17,0,17,0,17,6,False,False,False,0,3,2020-12-10T23:27:05.927,17,,0.0
2020,13,2978,240,8,7651,2,24,2,33,75,42,75,0,75,6,False,False,False,0,2,2020-12-10T22:56:51.713,75,,0.0
2020,13,2978,255,31,6390,2,34,4,-4,1,5,1,0,1,0,True,False,False,0,3,2020-12-10T22:57:13.78,1,,0.0
2020,13,2978,265,31,2675,13,5,5,9,0,0,0,0,0,0,False,False,False,0,3,2020-12-10T23:27:31.977,0,,0.0
2020,13,2978,280,8,5053,2,48,10,-3,11,14,7,4,7,0,False,False,False,1,1,2020-12-10T23:14:22.12,11,,4.0
2020,13,2978,285,8,3606,13,19,2,21,0,0,0,0,0,0,False,False,False,0,2,2020-12-07T12:20:44.413,0,,0.0
2020,13,2978,290,8,3606,13,12,5,1,0,0,0,0,0,0,False,False,False,0,2,2021-04-02T13:58:33.547,0,,0.0
2020,13,2978,295,8,3606,2,6,8,21,21,0,21,0,21,0,False,False,False,0,2,2020-12-10T23:29:05.093,21,,0.0
2020,13,2978,300,8,4976,2,12,9,-5,5,10,-5,10,-5,0,False,False,False,1,4,2021-03-09T18:33:36.217,5,,10.0
2020,13,2978,315,8,232,2,46,3,5,12,7,12,0,12,0,False,False,False,0,1,2020-12-10T20:41:09.833,12,,0.0
2020,13,2978,325,8,3606,2,19,2,17,17,0,17,0,17,6,False,False,False,0,2,2020-12-07T12:32:57.06,17,,0.0
2020,13,2978,340,31,5080,2,26,10,3,3,0,3,0,3,0,False,False,False,0,3,2020-12-10T20:41:09.833,3,,0.0
2020,13,2978,345,31,6793,13,9,6,42,0,0,0,0,0,0,False,False,False,0,2,2020-12-07T12:37:22.217,0,,0.0
2020,13,2978,360,8,7651,2,35,9,14,17,3,17,0,17,0,False,False,False,0,4,2020-12-10T23:03:14.99,17,,0.0
2020,13,2978,370,8,232,2,49,3,-2,13,15,13,0,13,0,False,False,False,0,2,2020-12-07T12:42:44.593,13,,0.0
2020,13,2978,390,8,232,2,5,3,5,8,3,8,0,8,0,False,False,False,0,3,2020-12-07T12:48:13.627,8,,0.0
2020,13,2978,435,31,5080,2,4,5,13,13,0,13,0,13,0,False,False,False,0,2,2020-12-09T16:48:56.973,13,,0.0
2020,13,2978,440,31,2675,3,12,3,12,0,0,0,0,0,0,False,False,False,0,3,2020-12-10T21:18:36.567,0,,0.0
2020,13,2978,445,31,6724,2,33,4,2,14,12,14,0,14,0,False,False,False,0,4,2020-12-10T23:31:46.663,14,,0.0
2020,13,2978,455,31,6793,2,4,10,4,19,15,19,0,19,0,False,True,True,0,3,2021-02-16T19:15:19.373,19,,0.0
2020,13,2978,475,31,5080,2,35,7,19,43,24,43,0,43,0,False,False,False,0,3,2021-02-22T14:42:07.077,43,,0.0
2020,13,2978,480,31,2901,2,17,7,16,22,6,22,0,22,6,False,False,False,0,4,2020-12-10T23:35:19.35,22,,0.0
2020,13,2978,530,31,5080,2,6,6,17,18,1,18,0,18,0,False,False,False,0,3,2020-12-10T23:04:00.223,18,,0.0
2020,13,2978,540,31,5080,2,4,5,12,22,10,12,10,12,0,False,False,False,1,2,2021-03-03T19:03:18.76,22,,10.0
2020,13,2978,550,31,6793,2,8,9,14,18,4,18,0,18,0,False,True,False,0,2,2021-02-16T19:23:33.06,16,,0.0
2020,13,2978,565,8,3883,2,26,3,2,8,6,8,0,8,0,False,False,False,0,4,2020-12-10T22:58:20.49,8,,0.0
2020,13,2978,575,8,3883,2,4,10,12,16,4,13,3,13,0,False,False,False,0,4,2020-12-07T14:11:21.077,16,,3.0
2020,13,2978,590,8,3606,2,4,3,6,7,1,7,0,7,0,False,False,False,0,2,2020-12-07T14:15:03.183,7,,0.0
2020,13,2978,595,8,232,3,12,9,6,0,0,0,0,0,0,True,False,False,0,3,2021-02-22T14:43:00.78,0,,0.0
2020,13,2978,610,31,2865,13,35,8,25,0,0,0,0,0,0,False,False,False,0,4,2021-03-05T15:35:55.343,0,,
2020,13,2978,625,31,3504,2,44,3,0,9,9,8,1,8,0,False,False,False,0,1,2020-12-10T23:36:57.77,9,,1.0
2020,13,2978,630,31,2901,3,12,10,-2,0,0,0,0,0,0,False,False,False,0,4,2021-03-09T18:34:45.01,0,,0.0
2020,13,2978,655,31,2675,13,5,3,10,0,0,0,0,0,0,False,False,False,0,3,2020-12-07T14:31:26.18,0,,
2020,13,2978,665,31,5080,13,4,5,12,0,0,0,0,0,0,False,False,False,0,2,2020-12-07T14:34:12.597,0,,0.0
2020,13,2978,670,31,5080,2,2,4,6,11,5,8,3,8,0,False,False,False,0,3,2020-12-07T14:35:46.577,11,,3.0
2020,13,2978,680,31,6390,2,5,3,5,5,0,5,0,5,0,False,False,False,0,3,2020-12-07T14:40:52.847,5,,0.0
2020,13,2978,685,31,2675,3,2,10,8,0,0,0,0,0,0,False,False,False,0,2,2021-03-05T15:36:23.783,0,,0.0
2020,13,2978,705,8,3606,13,13,9,7,0,0,0,0,0,0,False,False,False,0,2,2020-12-10T23:01:45.317,0,,0.0
2020,13,2978,720,31,6793,13,6,8,21,0,0,0,0,0,0,False,False,False,0,2,2020-12-10T23:04:55.41,0,,0.0
2020,13,2978,750,8,5053,2,48,9,-5,13,18,-5,18,-5,0,False,False,False,1,1,2020-12-10T23:15:50.57,13,,18.0
2020,13,2978,785,8,5053,2,34,4,-4,0,4,0,0,0,0,True,False,False,0,2,2020-12-07T15:13:32.34,0,,0.0
2020,13,2978,795,31,6793,3,19,2,36,0,0,0,0,0,0,False,False,False,0,2,2020-12-10T23:38:21.62,0,,0.0
2020,13,2978,800,31,5080,2,4,5,5,5,0,5,0,5,0,False,False,False,0,2,2020-12-07T15:16:37.863,5,,0.0
2020,13,2978,805,31,6724,2,33,4,4,6,2,6,0,6,0,False,False,False,0,4,2020-12-10T20:41:09.833,6,,0.0
2020,13,2978,810,31,4545,2,4,10,4,4,0,4,0,4,0,False,False,False,0,1,2020-12-07T15:18:46.913,4,,0.0
2020,13,2978,815,31,6724,2,2,10,7,14,7,14,0,14,0,False,False,False,0,3,2020-12-10T20:41:09.833,14,,0.0
2020,13,2978,820,31,6724,2,38,9,2,6,4,6,0,6,0,False,False,False,0,3,2020-12-07T15:20:41.033,6,,0.0
2020,13,2978,825,31,6724,2,31,9,5,11,6,8,3,8,0,False,False,False,0,4,2020-12-07T15:21:47.01,11,,3.0
2020,13,2978,830,31,4545,2,16,9,2,8,6,5,3,5,0,False,False,False,0,1,2020-12-10T23:16:17.497,8,,3.0
2020,13,2978,835,31,2865,13,7,5,14,0,0,0,0,0,0,False,False,False,0,3,2020-12-10T20:41:09.833,0,,0.0
2020,13,2978,845,31,5080,2,12,5,8,10,2,10,0,10,0,False,False,False,0,2,2020-12-07T15:25:54.4,10,,
2020,13,2978,850,31,5080,2,6,8,18,18,0,18,0,18,0,False,False,False,0,2,2020-12-07T15:27:38.67,18,,0.0
2020,13,2978,855,31,4545,2,16,4,3,3,0,3,0,3,0,False,False,False,0,1,2020-12-07T15:28:26.89,3,,0.0
2020,13,2978,865,31,5080,2,4,10,14,14,0,14,0,14,0,False,False,False,0,2,2020-12-10T23:05:35.89,14,,0.0
2020,13,2978,870,31,2675,2,5,3,9,9,0,9,0,9,0,False,False,False,0,3,2020-12-07T15:31:07.423,9,,0.0
2020,13,2978,875,31,5080,13,16,10,2,0,0,0,0,0,0,False,False,False,0,3,2020-12-10T20:41:09.833,0,,
2020,13,2978,930,31,6724,13,17,9,13,0,0,0,0,0,0,True,False,False,0,3,2020-12-10T23:13:30.76,0,,0.0
2020,13,2978,935,31,6724,13,7,3,13,0,0,0,0,0,0,False,False,False,0,3,2020-12-10T23:40:02.43,0,,0.0
2020,13,2978,940,31,4545,3,32,5,2,0,0,0,0,0,0,False,False,False,0,1,2020-12-10T23:40:27.73,0,,0.0
2020,13,2978,950,31,6390,2,5,3,8,8,0,8,0,8,6,False,False,False,0,3,2020-12-07T15:46:13.65,8,,0.0
2020,13,2979,15,1,245,13,4,9,4,0,0,0,0,0,0,True,False,False,0,3,2021-02-24T20:32:42.947,0,,0.0
2020,13,2979,30,1,5152,2,35,7,29,59,30,59,0,59,6,False,False,False,0,3,2020-12-07T11:20:29.85,59,,0.0
2020,13,2979,55,29,1958,2,30,9,3,11,8,11,0,11,0,False,False,False,1,3,2020-12-07T11:28:52.23,11,,0.0
2020,13,2979,60,29,4850,2,53,10,-2,11,13,9,2,9,0,False,False,False,0,4,2020-12-10T18:06:51.75,11,,2.0
2020,13,2979,70,29,3398,13,7,6,15,0,0,0,0,0,0,False,False,False,0,4,2021-03-09T17:28:58.787,0,,0.0
2020,13,2979,75,29,4850,3,2,9,5,0,0,0,0,0,0,False,False,False,0,2,2020-12-07T11:38:48.41,0,,0.0
2020,13,2979,85,29,1958,13,12,3,12,0,0,0,0,0,0,False,False,False,0,3,2020-12-07T11:40:53.767,0,,0.0
2020,13,2979,100,1,6406,13,12,3,12,0,0,0,0,0,0,False,False,False,0,1,2020-12-07T11:51:08.513,0,,0.0
2020,13,2979,115,29,4850,2,16,10,5,6,1,5,1,5,0,True,False,False,0,3,2020-12-10T17:46:45.503,6,,1.0
2020,13,2979,120,29,4866,2,46,3,2,4,2,2,2,2,0,False,False,False,0,3,2020-12-07T12:00:55.757,4,,2.0
2020,13,2979,130,29,7378,13,48,10,-6,0,0,0,0,0,0,False,False,False,0,1,2020-12-07T12:03:31.72,0,,0.0
2020,13,2979,135,29,4875,13,4,5,9,0,0,0,0,0,0,False,False,False,0,3,2021-03-10T19:59:14.37,0,,
2020,13,2979,150,29,7378,2,28,3,-5,6,11,4,2,4,0,False,False,False,0,1,2021-03-08T15:14:52.197,6,,2.0
2020,13,2979,175,1,7315,13,4,10,4,0,0,0,0,0,0,False,False,False,0,3,2020-12-07T12:21:13.763,0,,0.0
2020,13,2979,190,29,7828,2,30,3,3,5,2,5,0,5,0,False,False,False,0,3,2020-12-10T18:20:13.44,5,,0.0
2020,13,2979,195,29,3398,2,26,10,3,4,1,4,0,4,0,False,False,False,0,2,2020-12-07T12:27:04.447,4,,0.0
2020,13,2979,205,29,3398,2,2,9,7,16,9,8,8,8,0,False,False,False,0,3,2020-12-10T18:07:07.167,16,,8.0
2020,13,2979,215,29,7828,2,4,9,5,5,0,5,0,5,0,False,False,False,0,3,2020-12-10T19:06:14.8,5,,0.0
2020,13,2979,220,29,1958,2,30,5,3,9,6,9,0,9,0,True,False,False,0,3,2020-12-07T12:36:32.973,9,,0.0
2020,13,2979,225,29,7828,13,4,4,8,0,0,0,0,0,0,False,False,False,0,3,2020-12-10T17:46:45.503,0,,0.0
2020,13,2979,230,29,7828,2,39,10,7,8,1,8,0,8,0,False,False,False,0,3,2020-12-07T12:42:55.987,8,,0.0
2020,13,2979,235,29,3398,2,32,5,1,3,2,3,0,3,0,False,False,False,0,4,2020-12-10T02:00:20.153,3,,0.0
2020,13,2979,245,29,4866,2,4,9,5,5,0,5,0,5,0,False,False,False,1,3,2020-12-10T02:02:17.057,5,,0.0
2020,13,2979,250,29,4866,2,13,9,2,12,10,12,0,12,0,False,False,False,1,3,2020-12-07T13:00:37.8,12,,0.0
2020,13,2979,275,1,4307,3,46,3,1,0,0,0,0,0,0,False,False,False,0,1,2020-12-07T13:04:15.257,0,,0.0
2020,13,2979,290,29,4866,2,30,9,-1,15,16,15,0,15,0,False,False,False,0,3,2020-12-07T13:09:11.027,15,,0.0
2020,13,2979,305,29,4875,2,36,7,15,21,6,18,3,18,0,False,False,False,0,3,2020-12-07T13:13:57.293,21,,3.0
2020,13,2979,335,1,6405,13,19,2,43,0,0,0,0,0,0,False,False,False,0,2,2020-12-07T13:25:51.97,0,,0.0
2020,13,2979,345,1,5152,13,4,4,9,0,0,0,0,0,0,False,False,False,0,3,2020-12-10T17:46:45.503,0,,0.0
2020,13,2979,355,29,1958,2,35,2,16,18,2,17,1,17,0,False,False,False,0,3,2020-12-10T17:46:45.503,18,,1.0
2020,13,2979,360,29,1958,2,4,5,3,4,1,4,0,4,0,False,False,False,0,3,2020-12-07T13:35:21.493,4,,0.0
2020,13,2979,370,29,1958,2,50,9,-1,10,11,9,1,9,0,False,False,False,0,2,2020-12-10T18:14:27.62,10,,1.0
2020,13,2979,380,29,1958,2,44,3,-2,6,8,4,2,4,0,True,False,False,0,3,2021-02-22T18:08:11.357,6,,2.0
2020,13,2979,415,29,3398,2,9,5,1,1,0,1,0,1,6,False,False,False,0,3,2020-12-07T17:47:49.783,1,,0.0
2020,13,2979,440,1,7316,2,4,10,4,6,2,6,0,6,0,False,False,False,0,3,2020-12-10T02:04:55.933,6,,0.0
2020,13,2979,445,1,6406,2,4,4,4,8,4,5,3,5,0,False,False,False,0,1,2020-12-07T13:57:02.83,8,,3.0
2020,13,2979,455,1,245,13,19,6,29,0,0,0,0,0,0,False,False,False,0,2,2020-12-07T14:01:09.35,0,,
2020,13,2979,460,1,245,13,5,3,9,0,0,0,0,0,0,False,False,False,0,2,2020-12-07T14:06:39.267,0,,0.0
2020,13,2979,490,29,7378,2,48,3,-5,19,24,15,4,15,0,False,False,False,0,1,2020-12-10T02:14:31.79,19,,4.0
2020,13,2979,495,29,3398,13,17,6,20,0,0,0,0,0,0,False,False,False,0,3,2020-12-07T14:14:20.103,0,,0.0
2020,13,2979,500,29,4850,2,53,10,-3,3,6,-1,4,-1,0,False,False,False,1,4,2020-12-07T14:16:28.677,3,,4.0
2020,13,2979,505,29,3356,2,31,10,3,30,27,29,1,29,0,False,False,False,0,3,2020-12-10T18:12:55.89,30,,1.0
2020,13,2979,510,29,1958,2,30,9,0,5,5,5,0,5,0,False,False,False,0,3,2020-12-10T18:11:31.163,5,,0.0
2020,13,2979,520,29,1958,2,39,4,8,8,0,8,0,8,0,False,False,False,0,3,2020-12-07T14:41:51.193,8,,
2020,13,2979,525,29,4866,2,49,3,-3,9,12,3,6,3,0,False,False,False,1,3,2020-12-07T17:51:08.363,9,,6.0
2020,13,2979,540,1,4307,2,48,9,-8,8,16,7,1,7,0,False,False,False,0,1,2020-12-07T14:49:13.73,8,,1.0
2020,13,2979,545,1,245,2,4,3,5,6,1,6,0,6,0,False,False,False,0,2,2020-12-07T14:50:49.933,6,,0.0
2020,13,2979,550,1,245,2,18,3,-1,10,11,0,10,0,0,False,False,False,1,2,2020-12-07T14:52:23.763,10,,10.0
2020,13,2979,560,1,7316,2,50,10,-3,6,9,3,3,3,0,False,False,False,1,3,2020-12-07T14:57:32.263,6,,3.0
2020,13,2979,575,1,7315,13,35,4,9,0,0,0,0,0,0,False,False,False,0,3,2020-12-07T15:03:34.703,0,,0.0
2020,13,2979,580,1,245,13,5,3,12,0,0,0,0,0,0,False,False,False,0,2,2021-03-09T17:35:35.61,0,,0.0
2020,13,2979,590,1,7316,2,4,9,12,12,0,12,0,12,0,False,False,False,0,3,2020-12-10T17:46:45.503,12,,0.0
2020,13,2979,615,1,245,2,5,3,4,4,0,4,0,4,6,False,False,False,0,2,2020-12-07T15:17:58.32,4,,0.0
2020,13,2979,635,29,1958,2,50,3,0,9,9,7,2,7,0,False,False,False,0,2,2020-12-07T15:25:04.673,9,,2.0
2020,13,2979,645,29,7788,2,48,5,-1,22,23,22,0,22,0,False,False,False,0,1,2020-12-07T15:30:49.727,22,,0.0
2020,13,2979,650,29,4850,2,26,4,3,6,3,5,1,5,0,False,False,False,0,4,2021-02-22T18:14:10.147,6,,1.0
2020,13,2979,655,29,4866,2,35,3,13,13,0,13,0,13,0,False,False,False,0,3,2020-12-10T17:46:45.503,13,,0.0
2020,13,2979,660,29,7828,2,26,10,5,9,4,8,1,8,0,False,False,False,0,3,2020-12-07T15:41:14.783,9,,1.0
2020,13,2979,670,29,4866,2,2,9,6,8,2,7,1,7,0,False,False,False,0,3,2020-12-07T15:46:14.677,8,,1.0
2020,13,2979,680,29,4866,13,26,10,3,0,0,0,0,0,0,False,False,False,0,3,2020-12-07T15:48:50.577,0,,
2020,13,2979,700,1,245,2,4,3,5,5,0,5,0,5,0,False,False,False,0,2,2020-12-07T15:52:14.663,5,,0.0
2020,13,2979,705,1,245,2,4,9,3,5,2,3,2,3,0,False,False,False,0,3,2020-12-07T15:53:47.403,5,,2.0
2020,13,2979,710,1,6405,13,4,2,35,0,0,0,0,0,0,False,False,False,0,2,2020-12-07T16:00:54.423,0,,0.0
2020,13,2979,715,1,6406,13,16,9,2,0,0,0,0,0,0,False,False,False,0,1,2020-12-07T16:02:36.713,0,,0.0
2020,13,2979,720,1,6406,13,12,3,-3,0,0,0,0,0,0,False,False,False,0,1,2021-03-09T18:37:22.87,0,,0.0
2020,13,2979,750,29,4850,2,53,10,-6,-4,2,-4,0,-4,0,False,False,False,0,4,2020-12-07T16:12:05.12,-4,,0.0
2020,13,2979,755,29,1958,2,50,9,-3,3,6,0,3,0,0,False,False,False,1,3,2020-12-10T17:46:45.503,3,,3.0
2020,13,2979,760,29,4850,2,5,5,6,22,16,17,5,17,0,False,False,False,0,3,2020-12-10T18:09:20.877,22,,5.0
2020,13,2979,770,29,1958,2,5,5,6,10,4,8,2,8,0,False,False,False,0,4,2020-12-07T16:19:50.367,10,,2.0
2020,13,2979,775,29,4866,2,31,4,1,7,6,6,1,6,0,False,False,False,0,3,2020-12-07T16:21:35.187,7,,1.0
2020,13,2979,795,1,6405,2,18,10,1,2,1,2,0,2,0,False,False,False,0,2,2020-12-07T16:31:56.983,2,,0.0
2020,13,2979,800,1,7315,2,51,9,1,2,1,2,0,2,0,False,False,False,0,3,2020-12-07T16:34:54.677,2,,0.0
2020,13,2979,805,1,6406,2,4,9,7,7,0,7,0,7,0,False,False,False,0,3,2020-12-07T16:36:06.79,7,,0.0
2020,13,2979,820,1,245,2,4,9,8,8,0,8,0,8,0,False,False,False,0,3,2020-12-08T22:54:56.483,8,,0.0
2020,13,2979,825,1,7316,2,5,3,3,3,0,3,0,3,0,False,False,False,0,3,2020-12-07T16:44:47.23,3,,0.0
2020,13,2979,845,29,4866,13,13,9,1,0,0,0,0,0,0,False,False,False,0,3,2020-12-10T01:57:09.07,0,,0.0
2020,13,2979,860,1,4307,2,48,4,-4,1,5,-2,3,-2,0,False,False,False,0,1,2020-12-07T17:03:41.413,1,,3.0
2020,13,2979,865,1,245,13,4,3,7,0,0,0,0,0,0,False,False,False,0,2,2020-12-07T17:03:27.847,0,,0.0
2020,13,2979,870,1,7315,13,5,5,7,0,0,0,0,0,0,False,False,False,0,3,2021-03-05T15:41:57.297,0,,0.0
2020,13,2979,880,1,245,2,4,3,4,7,3,6,1,6,0,False,False,False,0,2,2020-12-07T17:11:12.26,7,,1.0
2020,13,2979,885,1,7315,2,4,10,6,5,-1,5,0,5,0,False,False,False,0,3,2020-12-07T17:15:55.817,5,,0.0
2020,13,2979,890,1,245,2,4,9,4,7,3,6,1,6,0,False,False,False,0,2,2020-12-07T17:17:37.75,7,,1.0
2020,13,2979,915,1,245,13,2,9,2,0,0,0,0,0,0,False,False,False,0,2,2020-12-08T22:56:34.52,0,,0.0
2020,13,2979,925,1,5152,2,6,9,2,2,0,2,0,2,6,False,False,False,0,4,2020-12-07T17:34:53.06,2,,0.0
2020,13,2980,10,27,5050,2,4,10,3,5,2,5,0,5,0,False,False,False,0,1,2020-12-07T11:28:02.853,5,,0.0
2020,13,2980,15,27,650,2,5,5,6,6,0,6,0,6,0,False,False,False,0,3,2021-02-22T15:04:31.233,6,,0.0
2020,13,2980,25,27,650,2,24,2,23,24,1,24,0,24,0,True,False,False,0,3,2021-02-22T18:04:50.74,24,,0.0
2020,13,2980,35,27,650,13,46,3,3,0,0,0,0,0,0,False,False,False,0,3,2020-12-07T11:43:16.47,0,,0.0
2020,13,2980,40,27,5069,13,8,10,13,0,0,0,0,0,0,False,False,False,0,3,2021-02-22T15:10:33.82,0,,0.0
2020,13,2980,45,27,4835,13,12,3,13,0,0,0,0,0,0,False,False,False,0,3,2021-02-22T15:12:09.087,0,,0.0
2020,13,2980,65,21,4422,13,6,10,12,0,0,0,0,0,0,False,False,False,0,4,2021-02-25T17:35:06.99,0,,0.0
2020,13,2980,75,21,3680,13,4,10,4,0,0,0,0,0,0,False,False,False,0,2,2020-12-07T11:58:16.5,0,,0.0
2020,13,2980,95,27,650,2,4,9,4,6,2,6,0,6,0,False,False,False,0,3,2020-12-07T12:44:15.8,6,,0.0
2020,13,2980,110,21,576,2,4,10,7,9,2,7,2,7,0,False,False,False,0,3,2020-12-08T22:19:06.637,9,,2.0
2020,13,2980,125,21,3680,2,4,8,16,22,6,22,0,22,0,False,False,False,0,3,2020-12-08T22:22:27.333,22,,0.0
2020,13,2980,140,21,576,2,4,9,13,16,3,14,2,14,0,False,False,False,0,3,2020-12-07T12:21:33.537,16,,2.0
2020,13,2980,145,21,576,2,50,10,-1,14,15,9,5,9,0,False,False,False,0,2,2020-12-08T22:23:12.047,2,,5.0
2020,13,2980,150,21,4422,2,4,9,5,11,6,8,3,8,0,False,False,False,0,4,2021-02-22T18:05:57.4,11,,3.0
2020,13,2980,160,21,4422,13,4,9,13,0,0,0,0,0,0,False,False,False,0,2,2021-03-05T15:44:21.423,0,,0.0
2020,13,2980,165,27,5069,2,44,3,-3,6,9,6,0,6,0,True,False,False,0,3,2021-02-22T15:39:38.893,6,,0.0
2020,13,2980,175,27,6397,2,13,3,2,6,4,6,0,6,0,False,False,False,0,4,2020-12-10T16:20:39.34,6,,0.0
2020,13,2980,180,27,4835,2,28,3,2,4,2,3,1,3,0,False,False,False,0,4,2020-12-10T15:02:17.703,4,,1.0
2020,13,2980,195,27,7408,13,8,4,12,0,0,0,0,0,0,False,False,False,0,2,2020-12-07T12:49:08.353,0,,0.0
2020,13,2980,225,21,576,2,42,4,2,3,1,2,1,2,0,False,False,False,0,3,2020-12-08T22:23:28.547,3,,1.0
2020,13,2980,230,21,4422,2,2,10,7,7,0,7,0,7,0,False,False,False,0,3,2020-12-07T12:58:02.697,7,,0.0
2020,13,2980,240,21,3680,13,4,9,6,0,0,0,0,0,0,False,False,False,0,3,2020-12-07T13:01:30.657,0,,0.0
2020,13,2980,260,27,7408,13,4,9,14,0,0,0,0,0,0,False,False,False,0,3,2020-12-07T13:09:08.913,0,,0.0
2020,13,2980,265,27,7408,2,5,3,12,12,0,12,0,12,0,False,False,False,0,2,2020-12-07T13:10:48.603,12,,0.0
2020,13,2980,285,21,3680,3,12,5,10,0,0,0,0,0,0,False,False,False,0,2,2020-12-10T16:23:26.857,0,,0.0
2020,13,2980,295,21,5015,2,49,5,-1,-2,-1,-2,0,-2,0,False,False,False,0,2,2020-12-07T13:25:29.807,-2,,0.0
2020,13,2980,305,27,7408,2,3,6,15,18,3,17,1,17,0,False,False,False,0,2,2020-12-07T13:28:57.633,18,,1.0
2020,13,2980,320,27,4835,2,31,10,5,6,1,6,0,6,0,False,False,False,0,3,2020-12-07T13:34:00.35,6,,0.0
2020,13,2980,335,27,7408,2,5,3,6,21,15,7,14,7,0,False,False,False,1,2,2020-12-07T13:38:20.61,21,,14.0
2020,13,2980,340,27,153,2,12,3,-6,-6,0,-6,0,-6,0,False,False,False,0,1,2020-12-07T13:41:44.727,-6,,0.0
2020,13,2980,345,27,650,3,13,3,2,0,0,0,0,0,0,False,False,False,0,3,2021-02-22T18:07:15.253,0,,0.0
2020,13,2980,350,27,7850,13,44,3,-2,0,0,0,0,0,0,False,False,False,0,1,2020-12-07T13:49:20.553,0,,0.0
2020,13,2980,445,21,3680,13,39,4,6,0,0,0,0,0,0,False,False,False,0,3,2020-12-07T14:11:49.313,0,,0.0
2020,13,2980,470,27,650,2,51,10,-2,5,7,5,0,5,0,False,True,False,0,2,2021-02-22T18:08:41.13,5,False,0.0
2020,13,2980,485,21,7226,2,12,10,1,3,2,2,1,2,0,False,False,False,0,4,2021-03-09T18:47:24.98,3,,1.0
2020,13,2980,515,27,7408,2,3,3,11,14,3,12,2,12,0,False,False,False,0,2,2020-12-07T14:33:10.863,14,,2.0
2020,13,2980,520,27,650,2,30,10,-2,1,3,1,0,1,0,False,False,False,0,3,2020-12-07T14:35:38.27,1,,0.0
2020,13,2980,525,27,153,2,12,3,3,5,2,5,0,5,0,False,False,False,0,1,2021-03-09T18:48:06.71,5,,0.0
2020,13,2980,530,27,6397,2,13,10,1,3,2,3,0,3,0,False,False,False,0,4,2020-12-07T14:39:20.763,3,,0.0
2020,13,2980,535,27,5050,13,12,3,6,0,0,0,0,0,0,False,False,False,0,1,2020-12-07T14:42:02.3,0,,0.0
2020,13,2980,560,21,963,2,47,5,1,6,5,6,0,6,6,False,False,False,0,1,2020-12-07T14:49:57.043,6,,0.0
2020,13,2980,580,27,6397,2,39,4,5,10,5,7,3,7,0,False,False,False,0,4,2020-12-07T14:55:55.48,10,,3.0
2020,13,2980,595,27,7852,2,2,10,4,13,9,12,1,12,0,False,False,False,0,2,2021-02-22T17:05:52.98,13,,
2020,13,2980,605,27,153,2,4,4,3,11,8,9,2,9,0,False,False,False,0,1,2020-12-07T15:03:22.043,11,,2.0
2020,13,2980,640,27,5050,3,4,4,9,0,0,0,0,0,0,False,False,False,0,1,2021-03-05T15:44:53.673,0,,0.0
2020,13,2980,645,21,4422,13,35,2,18,0,0,0,0,0,0,False,False,False,0,4,2020-12-07T15:15:56.817,0,,0.0
2020,13,2980,655,21,4422,2,2,9,7,8,1,7,1,7,0,False,False,False,0,3,2020-12-07T15:19:17.61,8,,1.0
2020,13,2980,675,27,5050,3,31,4,1,0,0,0,0,0,0,False,False,False,0,1,2020-12-07T15:23:32.41,0,,0.0
2020,13,2980,680,27,6397,2,5,3,3,9,6,7,2,7,0,False,False,False,1,3,2021-02-22T17:29:32.837,9,,2.0
2020,13,2980,690,27,6397,13,4,4,11,0,0,0,0,0,0,False,False,False,0,3,2020-12-07T15:28:12.19,0,,0.0
2020,13,2980,695,27,7850,2,44,3,-3,5,8,-3,8,-3,0,False,False,False,2,1,2020-12-07T15:29:54.607,5,,8.0
2020,13,2980,700,27,650,2,12,8,15,21,6,19,2,19,0,False,False,False,0,3,2020-12-07T16:32:06.22,21,,2.0
2020,13,2980,715,27,5050,2,4,4,4,12,8,4,8,4,0,False,False,False,1,1,2020-12-07T15:35:55.257,12,,8.0
2020,13,2980,720,27,7408,3,6,1,18,0,0,0,0,0,0,False,False,False,0,2,2020-12-07T15:39:38.893,0,,0.0
2020,13,2980,730,27,650,13,12,3,11,0,0,0,0,0,0,False,False,False,0,3,2021-02-22T17:44:40.87,0,,
2020,13,2980,735,27,5050,2,20,6,26,28,2,28,0,28,6,False,False,False,0,2,2020-12-07T15:45:48.77,28,,0.0
2020,13,2980,750,21,4422,13,7,2,16,0,0,0,0,0,0,False,False,False,0,4,2020-12-07T15:47:51.057,0,,0.0
2020,13,2980,760,21,4422,2,5,3,4,6,2,5,1,5,0,False,False,False,0,3,2020-12-07T15:52:00.48,6,,1.0
2020,13,2980,770,21,7090,2,6,10,14,14,0,14,0,14,0,False,False,False,0,2,2020-12-07T15:55:22.407,14,,0.0
2020,13,2980,790,21,3680,13,29,6,22,0,0,0,0,0,0,False,False,False,0,2,2020-12-07T15:59:30.837,0,,0.0
2020,13,2980,800,27,7850,2,47,10,-2,6,8,4,2,4,0,False,False,False,0,1,2020-12-07T16:03:10.603,6,,2.0
2020,13,2980,805,27,7408,2,5,6,15,15,0,15,0,15,0,False,False,False,0,2,2021-02-22T17:56:46.627,15,,0.0
2020,13,2980,815,27,4835,2,4,4,10,10,0,10,0,10,0,False,False,False,0,3,2020-12-07T16:06:45.083,10,,0.0
2020,13,2980,825,27,7852,13,19,6,32,0,0,0,0,0,0,False,False,False,0,3,2021-02-22T17:59:56.963,0,,0.0
2020,13,2980,830,27,650,13,39,4,8,0,0,0,0,0,0,False,False,False,0,3,2021-02-22T18:01:15.597,0,,0.0
2020,13,2981,25,24,6373,2,46,3,1,2,1,2,0,2,0,False,False,False,0,4,2020-12-07T11:36:46.01,2,,0.0
2020,13,2981,30,24,6373,13,5,5,10,0,0,0,0,0,0,False,False,False,0,3,2020-12-07T11:38:36.787,0,,0.0
2020,13,2981,35,24,4382,13,35,9,9,0,0,0,0,0,0,False,False,False,0,3,2020-12-10T15:19:05.307,0,,
2020,13,2981,55,24,6373,2,2,9,7,7,0,7,0,7,0,False,False,False,0,2,2020-12-07T11:49:40.74,7,,0.0
2020,13,2981,65,24,894,2,6,9,10,11,1,11,0,11,0,False,False,False,0,3,2021-02-25T17:38:22.277,11,,0.0
2020,13,2981,80,24,6389,13,12,2,15,0,0,0,0,0,0,False,False,False,0,1,2021-03-09T18:52:25.053,0,,0.0
2020,13,2981,105,12,4537,2,48,9,-2,9,11,8,1,8,0,False,False,False,0,1,2020-12-10T16:09:13.747,9,,1.0
2020,13,2981,120,24,4382,2,30,10,0,8,8,8,0,8,0,False,False,False,2,4,2020-12-07T12:19:14.337,8,,0.0
2020,13,2981,155,12,556,2,35,3,12,24,12,24,0,24,0,False,False,False,0,3,2020-12-08T15:29:13.74,24,,0.0
2020,13,2981,170,12,6691,2,5,5,10,10,0,10,0,10,0,True,False,False,0,3,2020-12-07T12:41:06.393,10,,0.0
2020,13,2981,175,12,556,2,2,10,9,12,3,12,0,12,0,False,False,False,0,2,2020-12-07T12:42:42.76,12,,0.0
2020,13,2981,180,12,6691,2,5,5,9,9,0,9,0,9,0,True,False,False,0,3,2021-02-22T19:37:26.717,9,,0.0
2020,13,2981,200,12,4537,2,5,3,2,8,6,6,2,6,0,False,False,False,0,3,2020-12-07T12:50:57.717,8,,2.0
2020,13,2981,205,12,4511,2,54,9,-3,6,9,5,1,5,0,False,False,False,0,4,2020-12-07T12:52:33.85,6,,1.0
2020,13,2981,210,12,556,2,47,5,2,2,0,2,0,2,0,False,False,False,0,3,2020-12-07T12:55:01.31,2,,0.0
2020,13,2981,215,12,556,13,2,10,1,0,0,0,0,0,0,False,False,False,0,2,2020-12-07T12:56:18.077,0,,0.0
2020,13,2981,220,12,556,2,5,3,1,1,0,1,0,1,6,False,False,False,0,3,2020-12-10T16:01:46.217,1,,0.0
2020,13,2981,250,24,6389,13,6,5,3,0,0,0,0,0,0,False,False,False,0,2,2020-12-10T15:19:05.307,0,,0.0
2020,13,2981,275,12,467,2,35,3,14,36,22,33,3,33,0,False,False,False,0,4,2020-12-07T13:15:29.593,36,,3.0
2020,13,2981,285,12,7460,2,52,4,2,14,12,13,1,13,0,True,False,False,1,3,2020-12-10T16:01:59.173,14,,1.0
2020,13,2981,295,12,4561,2,28,10,0,5,5,4,1,4,0,False,False,False,0,1,2020-12-07T13:20:45.937,5,,1.0
2020,13,2981,305,12,4511,2,12,2,25,25,0,25,0,25,6,False,False,False,0,3,2021-03-09T18:53:52.18,25,,0.0
2020,13,2981,320,24,7799,3,2,4,5,0,0,0,0,0,0,False,False,False,0,3,2020-12-10T15:19:05.307,0,,0.0
2020,13,2981,330,24,6373,2,12,9,7,10,3,9,1,9,0,False,False,False,0,3,2020-12-07T13:29:13.473,10,,1.0
2020,13,2981,350,24,6937,13,47,5,0,0,0,0,0,0,0,False,False,False,0,1,2020-12-07T13:32:50.807,0,,0.0
2020,13,2981,370,12,6357,3,23,6,53,0,0,0,0,0,0,False,False,False,0,3,2020-12-09T16:52:18.373,0,,0.0
2020,13,2981,380,12,4511,13,32,3,0,0,0,0,0,0,0,False,False,False,0,4,2021-04-01T19:31:29.713,0,,0.0
2020,13,2981,390,24,6373,2,23,7,31,41,10,39,2,39,0,False,False,False,0,4,2020-12-10T16:11:38.203,41,,2.0
2020,13,2981,400,24,894,13,5,5,4,0,0,0,0,0,0,True,False,False,0,3,2020-12-07T14:34:43.037,0,,0.0
2020,13,2981,405,24,7799,13,3,6,16,0,0,0,0,0,0,False,False,False,0,2,2020-12-10T15:19:05.307,0,,0.0
2020,13,2981,415,12,556,2,8,8,42,42,0,42,0,42,0,False,False,False,0,2,2020-12-09T02:32:49.65,42,,0.0
2020,13,2981,425,12,4537,2,28,10,-4,1,5,-1,2,-1,0,False,False,False,0,1,2020-12-07T14:44:03.387,1,,2.0
2020,13,2981,430,12,6691,2,19,2,27,31,4,27,4,27,0,False,False,False,0,2,2020-12-07T14:46:20.633,31,,4.0
2020,13,2981,445,12,556,2,44,3,0,9,9,5,4,5,6,False,False,False,0,3,2020-12-07T14:51:21.397,9,,4.0
2020,13,2981,470,24,7798,2,19,6,32,34,2,34,0,34,0,False,False,False,0,2,2020-12-07T14:57:55.397,34,,0.0
2020,13,2981,505,12,6691,3,5,5,10,0,0,0,0,0,0,True,False,False,0,3,2020-12-07T15:08:38.88,0,,0.0
2020,13,2981,510,12,556,2,5,3,4,13,9,11,2,11,0,False,False,False,0,3,2020-12-07T15:10:25.13,13,,2.0
2020,13,2981,525,12,4561,2,4,3,3,5,2,4,1,4,0,False,False,False,0,2,2020-12-07T15:14:49.993,5,,1.0
2020,13,2981,530,12,556,2,4,3,8,11,3,10,1,10,0,False,False,False,0,2,2020-12-07T15:16:33.96,11,,1.0
2020,13,2981,535,12,6356,2,51,5,-2,7,9,7,0,7,0,False,False,False,0,3,2021-03-04T17:51:00.737,7,,0.0
2020,13,2981,565,12,556,2,5,5,7,8,1,8,0,8,0,False,False,False,0,3,2020-12-07T15:39:20.74,8,,0.0
2020,13,2981,570,12,556,13,9,2,22,0,0,0,0,0,0,False,False,False,0,3,2020-12-07T15:42:14.01,0,,0.0
2020,13,2981,595,24,6373,13,13,9,3,0,0,0,0,0,0,False,False,False,0,3,2020-12-07T17:18:13.453,0,,0.0
2020,13,2981,600,24,6373,2,5,3,6,6,0,6,0,6,0,False,False,False,0,3,2020-12-07T15:49:19.437,6,,0.0
2020,13,2981,605,24,894,2,5,5,12,20,8,19,1,19,0,False,False,False,0,3,2020-12-07T15:53:34.65,20,,1.0
2020,13,2981,615,24,6808,13,3,5,10,0,0,0,0,0,0,False,False,False,0,2,2020-12-10T15:19:05.307,0,,0.0
2020,13,2981,620,24,4382,13,5,3,12,0,0,0,0,0,0,False,False,False,0,3,2020-12-07T17:18:39.793,0,,0.0
2020,13,2981,625,24,264,2,3,3,13,13,0,13,0,13,0,False,False,False,0,2,2020-12-07T16:00:34.427,13,,
2020,13,2981,630,24,4382,2,8,2,32,32,0,32,0,32,6,False,False,False,0,3,2020-12-10T15:19:05.307,32,,0.0
2020,13,2981,645,12,4511,2,12,5,3,3,0,3,0,3,0,False,False,False,0,4,2021-03-09T18:56:38.7,3,,0.0
2020,13,2981,655,12,6357,13,23,8,41,0,0,0,0,0,0,False,False,False,0,2,2020-12-07T16:12:46.88,0,,0.0
2020,13,2981,660,12,6356,13,12,2,28,0,0,0,0,0,0,False,False,False,0,3,2020-12-07T16:14:58.873,0,,0.0
2020,13,2981,685,12,556,2,51,5,-1,-1,0,-1,0,-1,0,False,False,False,0,3,2021-02-22T19:38:07.72,-1,,0.0
2020,13,2981,710,24,264,13,4,5,10,0,0,0,0,0,0,False,False,False,0,2,2020-12-07T17:19:07.453,0,,0.0
2020,13,2981,720,24,894,13,4,10,11,0,0,0,0,0,0,False,False,False,0,3,2020-12-07T17:19:17.683,0,,0.0
2020,13,2981,755,24,4382,2,22,3,14,17,3,17,0,17,0,False,False,False,0,3,2020-12-10T15:19:05.307,17,,0.0
2020,13,2981,765,24,6808,3,4,6,18,0,0,0,0,0,0,False,False,False,0,2,2020-12-07T17:19:35.29,0,,0.0
2020,13,2981,775,24,4382,13,5,5,3,0,0,0,0,0,0,False,False,False,0,3,2021-03-05T15:46:26.303,0,,0.0
2020,13,2981,800,12,4511,2,30,5,0,5,5,5,0,5,0,False,False,False,0,4,2020-12-07T17:12:01.883,5,,0.0
2020,13,2982,10,19,7172,2,48,9,-2,15,17,10,5,10,0,False,False,False,0,1,2020-12-07T10:59:18.1,15,,5
2020,13,2982,25,19,7175,3,5,6,18,0,0,0,0,0,0,False,False,False,0,3,2020-12-07T11:03:48.533,0,,0
2020,13,2982,50,19,1328,2,44,3,2,3,1,2,1,2,0,False,False,False,0,1,2020-12-07T11:12:29.99,3,,1
2020,13,2982,95,26,7491,2,13,9,6,12,6,7,5,7,0,False,False,False,0,4,2020-12-07T11:25:35.097,12,,5
2020,13,2982,110,26,309,2,13,10,3,3,0,3,0,3,0,False,False,False,0,3,2020-12-07T11:31:04.19,3,,0
2020,13,2982,120,26,7453,2,12,3,4,14,10,12,2,12,0,True,False,False,0,3,2021-03-09T18:39:32.203,14,,2
2020,13,2982,125,26,4616,13,13,10,3,0,0,0,0,0,0,False,False,False,0,3,2020-12-07T11:37:04.217,0,,0
2020,13,2982,130,26,4282,13,12,9,9,0,0,0,0,0,0,False,False,False,0,3,2021-03-09T18:40:04.673,0,,0
2020,13,2982,145,19,1328,2,48,9,-5,-5,0,-5,0,-5,0,False,False,False,0,1,2020-12-07T11:42:15.807,-5,,0
2020,13,2982,155,19,1328,13,50,5,-1,0,0,0,0,0,0,True,False,False,0,2,2020-12-07T11:44:59.843,0,,0
2020,13,2982,175,26,4619,13,8,10,11,0,0,0,0,0,0,False,False,False,0,2,2020-12-07T11:55:25.107,0,,0
2020,13,2982,180,26,7453,13,3,5,9,0,0,0,0,0,0,True,False,False,0,3,2020-12-10T23:51:01.49,0,,0
2020,13,2982,200,26,4616,13,48,9,-4,0,0,0,0,0,0,False,False,False,0,1,2020-12-07T11:59:48.14,0,,0
2020,13,2982,205,26,7514,2,34,4,-4,1,5,-3,4,-3,0,True,False,False,2,2,2020-12-10T23:00:51.34,1,,4
2020,13,2982,210,26,6277,2,28,9,-2,5,7,4,1,4,0,False,False,False,0,1,2020-12-07T12:03:34.87,5,,1
2020,13,2982,245,19,7173,2,4,10,9,10,1,9,1,9,0,False,False,False,0,3,2020-12-07T12:15:05.843,10,,1
2020,13,2982,255,26,4616,2,51,9,-5,11,16,9,2,9,0,True,False,False,0,1,2020-12-10T21:39:06.053,11,,2
2020,13,2982,260,26,309,13,2,10,5,0,0,0,0,0,0,False,False,False,0,3,2020-12-07T12:19:31.96,0,,0
2020,13,2982,265,26,6277,2,47,10,-3,0,3,-1,1,-1,0,False,False,False,0,1,2020-12-10T21:39:06.053,0,,1
2020,13,2982,270,26,4616,13,31,10,-2,0,0,0,0,0,0,False,False,False,0,1,2020-12-10T21:39:06.053,0,,0
2020,13,2982,290,19,3233,2,13,10,6,9,3,7,2,7,0,False,False,False,0,3,2020-12-10T21:39:06.053,9,,2
2020,13,2982,305,19,3233,2,13,10,3,7,4,6,1,6,0,False,False,False,0,3,2020-12-07T12:30:07.85,7,,1
2020,13,2982,315,19,7175,13,4,10,6,0,0,0,0,0,0,True,False,False,0,2,2020-12-07T12:31:37.737,0,,0
2020,13,2982,365,19,1328,2,47,5,0,3,3,3,0,3,0,False,False,False,0,1,2020-12-10T23:18:58.257,3,,0
2020,13,2982,405,26,7453,13,9,6,17,0,0,0,0,0,0,False,False,False,0,2,2020-12-07T12:49:53.877,0,,0
2020,13,2982,410,26,4616,2,4,4,2,15,13,11,4,11,0,False,False,False,0,1,2020-12-07T12:51:25.887,15,,4
2020,13,2982,420,26,4616,13,4,4,0,0,0,0,0,0,0,False,False,False,0,1,2020-12-07T12:53:13.867,0,,0
2020,13,2982,425,26,4616,13,44,9,-9,0,0,0,0,0,0,False,False,False,0,1,2020-12-07T12:54:49.67,0,,0
2020,13,2982,430,26,309,2,6,8,17,24,7,22,2,22,0,True,False,False,0,3,2020-12-07T12:57:15.887,24,,2
2020,13,2982,460,26,4616,2,32,10,1,5,4,2,3,2,0,False,False,False,0,1,2020-12-10T21:39:06.053,5,,3
2020,13,2982,465,26,4282,2,5,5,5,5,0,5,0,5,0,False,False,False,0,3,2020-12-07T13:11:31.66,5,,0
2020,13,2982,475,26,309,2,26,9,4,4,0,4,0,4,0,False,False,False,1,3,2020-12-10T23:01:14.857,4,,0
2020,13,2982,480,26,7453,13,13,4,4,0,0,0,0,0,0,False,False,False,0,3,2021-03-05T15:47:58.367,0,,0
2020,13,2982,490,19,6273,2,4,10,5,6,1,5,1,5,0,True,False,False,0,3,2020-12-07T13:19:31.117,6,,1
2020,13,2982,515,19,7175,13,35,10,5,0,0,0,0,0,0,False,False,False,0,3,2020-12-07T13:27:40.023,0,,0
2020,13,2982,520,19,7173,2,4,10,5,5,0,5,0,5,6,False,False,False,0,3,2020-12-07T13:29:09.383,5,,0
2020,13,2982,535,26,4619,2,50,10,-3,9,12,5,4,5,0,False,False,False,0,2,2020-12-07T13:31:29.817,9,,4
2020,13,2982,540,26,6277,3,16,10,3,0,0,0,0,0,0,False,False,False,0,1,2021-02-22T19:38:16.19,0,,0
2020,13,2982,560,26,7453,2,17,8,17,24,7,22,2,22,0,False,False,False,0,3,2020-12-07T13:39:06.583,24,,2
2020,13,2982,565,26,4619,13,4,4,13,0,0,0,0,0,0,False,False,False,0,4,2021-02-22T19:39:35.85,0,,0
2020,13,2982,570,26,309,2,39,4,4,4,0,4,0,4,0,False,False,False,0,3,2020-12-07T13:42:09.55,4,,0
2020,13,2982,575,26,4619,13,4,5,6,0,0,0,0,0,0,False,False,False,0,2,2020-12-07T13:43:30.293,0,,0
2020,13,2982,580,26,309,13,7,6,18,0,0,0,0,0,0,True,False,False,0,3,2021-03-05T15:48:10.627,0,,0
2020,13,2982,585,19,7456,2,32,3,0,1,1,1,0,1,0,False,False,False,0,4,2020-12-07T13:47:22.74,1,,0
2020,13,2982,600,19,7175,2,5,2,15,15,0,15,0,15,0,False,False,False,0,3,2020-12-07T13:50:26.343,15,,0
2020,13,2982,610,19,7175,2,51,9,-3,0,3,0,0,0,0,False,False,False,0,3,2020-12-07T13:53:13.073,0,,0
2020,13,2982,625,19,7175,13,5,2,18,0,0,0,0,0,0,False,False,False,0,3,2020-12-10T21:39:06.053,0,,0
2020,13,2982,635,19,3233,13,21,2,41,0,0,0,0,0,0,False,False,False,0,2,2020-12-10T21:39:06.053,0,,0
2020,13,2982,650,26,309,13,4,10,5,0,0,0,0,0,0,False,False,False,0,2,2020-12-07T14:01:55.557,0,,0
2020,13,2982,655,26,4619,2,4,5,6,7,1,6,1,6,0,False,False,False,0,2,2020-12-07T14:03:04.637,7,,1
2020,13,2982,665,26,7695,2,32,5,-7,2,9,-1,3,-1,0,False,False,False,0,1,2020-12-10T23:26:48.77,2,,3
2020,13,2982,670,26,7695,2,4,4,1,1,0,1,0,1,0,False,False,False,0,1,2020-12-07T14:06:33.9,1,,0
2020,13,2982,675,26,4619,13,9,2,26,0,0,0,0,0,0,False,False,False,0,2,2020-12-10T22:03:28.957,0,,0
2020,13,2982,715,26,309,13,6,9,14,0,0,0,0,0,0,False,False,False,0,2,2020-12-07T14:18:15.847,0,,0
2020,13,2982,725,26,4050,2,4,10,5,6,1,6,0,6,0,False,False,False,0,3,2020-12-07T14:21:13.67,6,,0
2020,13,2982,730,26,4619,2,35,8,16,20,4,19,1,19,0,False,False,False,0,3,2020-12-07T14:22:55.697,20,,1
2020,13,2982,735,26,7453,13,12,8,36,0,0,0,0,0,0,False,False,False,0,2,2020-12-07T14:24:39.34,0,,0
2020,13,2982,745,26,4616,2,28,9,-6,1,7,0,1,0,0,False,False,False,0,1,2020-12-07T14:27:33.703,1,,1
2020,13,2982,755,19,7173,13,7,7,20,0,0,0,0,0,0,False,False,False,0,3,2020-12-10T23:29:04.3,0,,0
2020,13,2982,760,19,6266,2,5,10,3,23,20,4,19,4,0,False,False,False,1,1,2020-12-07T14:32:37.713,23,,19
2020,13,2982,770,19,7177,2,17,9,13,38,25,18,20,18,6,False,False,False,1,3,2020-12-10T23:00:35.877,38,,20
2020,13,2982,785,26,309,2,2,10,4,13,9,11,2,11,0,False,False,False,1,2,2020-12-10T23:01:44.533,13,,2
2020,13,2982,790,26,7453,13,13,9,1,0,0,0,0,0,0,False,False,False,0,2,2020-12-07T14:47:38.057,0,,0
2020,13,2982,795,26,7697,2,39,4,6,7,1,7,0,7,0,False,False,False,0,3,2020-12-07T14:49:09.347,7,,0
2020,13,2982,800,26,4619,2,4,3,7,7,0,7,0,7,0,False,False,False,0,2,2020-12-07T14:50:34.087,7,,0
2020,13,2982,805,26,7491,2,4,10,6,9,3,7,2,7,0,False,False,False,0,3,2020-12-07T14:52:23.59,9,,2
2020,13,2982,815,26,309,13,4,6,25,0,0,0,0,0,0,False,False,False,0,2,2021-02-22T19:40:29.727,0,,0
2020,13,2982,820,26,4619,13,12,6,30,0,0,0,0,0,0,False,False,False,0,2,2020-12-07T15:20:11.273,0,,0
2020,13,2982,825,26,4050,13,4,9,5,0,0,0,0,0,0,False,False,False,0,3,2020-12-10T22:03:42.167,0,,0
2020,13,2982,830,26,309,13,17,8,25,0,0,0,0,0,0,True,False,False,0,3,2020-12-10T21:39:06.053,0,,0
2020,13,2982,865,26,7491,13,5,10,7,0,0,0,0,0,0,False,False,False,0,3,2020-12-07T15:05:59.333,0,,0
2020,13,2982,870,26,6277,2,28,9,-4,0,4,-1,1,-1,0,False,False,False,0,1,2020-12-07T15:07:29.173,0,,1
2020,13,2982,875,26,7491,13,26,9,5,0,0,0,0,0,0,False,False,False,0,3,2020-12-10T21:39:06.053,0,,0
2020,13,2983,20,10,6840,2,19,6,27,37,10,37,0,37,0,False,False,False,0,2,2020-12-07T11:34:10.537,37,,0.0
2020,13,2983,30,10,6286,13,12,6,24,0,0,0,0,0,0,False,False,False,0,4,2020-12-10T18:37:53.653,0,,0.0
2020,13,2983,40,16,4143,2,47,5,1,19,18,19,0,19,0,False,False,False,1,4,2020-12-07T11:47:18.37,19,,0.0
2020,13,2983,55,16,3938,13,35,7,34,0,0,0,0,0,0,False,False,False,0,3,2020-12-07T11:53:08.503,0,,0.0
2020,13,2983,65,10,3848,2,4,10,6,7,1,6,1,6,0,False,False,False,0,4,2020-12-07T11:56:24.233,7,,1.0
2020,13,2983,75,10,6840,2,5,5,5,5,0,5,0,5,0,True,False,False,0,3,2020-12-08T18:44:18.19,5,,0.0
2020,13,2983,85,10,7701,2,46,3,2,8,6,4,4,4,0,True,False,False,2,3,2020-12-07T12:04:06.807,8,,4.0
2020,13,2983,105,10,6840,13,5,3,14,0,0,0,0,0,0,False,False,False,0,4,2020-12-07T12:12:46.987,0,,0.0
2020,13,2983,110,10,6840,13,46,3,1,0,0,0,0,0,0,True,False,False,0,4,2020-12-07T12:14:49.64,0,,0.0
2020,13,2983,130,16,34,2,44,3,-5,14,19,8,6,8,0,False,False,False,1,1,2020-12-10T19:49:32.063,14,,6.0
2020,13,2983,135,16,374,2,5,9,14,18,4,15,3,15,0,True,False,False,0,4,2020-12-08T19:09:51.373,18,,3.0
2020,13,2983,140,16,4143,2,4,5,11,20,9,17,3,17,0,False,False,False,0,2,2020-12-07T12:25:37.51,20,,3.0
2020,13,2983,150,16,34,2,48,9,-5,1,6,0,1,0,0,False,False,False,0,1,2020-12-07T12:28:52.373,1,,1.0
2020,13,2983,155,16,3938,13,17,7,17,0,0,0,0,0,0,False,False,False,0,3,2021-03-09T20:19:29.547,0,,0.0
2020,13,2983,170,10,282,2,48,4,-5,11,16,10,1,10,0,False,False,False,0,1,2020-12-07T12:34:15.377,11,,1.0
2020,13,2983,180,10,282,13,12,5,2,0,0,0,0,0,0,False,False,False,0,1,2021-03-09T18:42:57.49,0,,0.0
2020,13,2983,190,10,3848,2,32,10,0,0,0,0,0,0,0,False,False,False,0,4,2020-12-07T12:40:05.393,0,,0.0
2020,13,2983,200,16,374,2,35,10,14,19,5,15,4,15,0,False,False,False,2,4,2020-12-10T19:49:43.37,19,,4.0
2020,13,2983,205,16,3938,13,2,4,6,0,0,0,0,0,0,False,False,False,0,3,2020-12-10T19:49:05.777,0,,0.0
2020,13,2983,210,16,3938,2,4,3,6,6,0,6,0,6,0,True,False,False,0,2,2021-02-22T19:28:30.203,6,,0.0
2020,13,2983,215,16,121,2,4,10,4,4,0,4,0,4,0,False,False,False,0,3,2020-12-07T13:07:49.093,4,,0.0
2020,13,2983,220,16,3938,2,44,9,-8,10,18,10,0,10,0,True,False,False,1,2,2020-12-10T19:49:53.627,10,,0.0
2020,13,2983,225,16,7176,13,5,2,17,0,0,0,0,0,0,True,False,False,0,4,2020-12-07T13:12:13.733,0,,0.0
2020,13,2983,230,16,3938,3,51,10,0,0,0,0,0,0,0,False,False,False,0,3,2020-12-07T13:13:32.053,0,,0.0
2020,13,2983,235,16,3938,3,8,1,40,0,0,0,0,0,0,False,False,False,0,3,2020-12-10T19:48:53.513,0,,0.0
2020,13,2983,270,10,6840,2,32,10,2,10,8,9,1,9,0,False,False,False,1,4,2020-12-07T13:24:40.683,10,,1.0
2020,13,2983,285,10,4930,2,30,3,0,5,5,5,0,5,6,True,False,False,0,1,2020-12-08T18:45:57.593,5,,0.0
2020,13,2983,325,16,3938,2,54,9,-3,-5,-2,-7,2,-7,0,False,False,False,2,3,2020-12-10T19:50:23.78,-5,,2.0
2020,13,2983,360,10,6481,13,28,3,-5,0,0,0,0,0,0,False,False,False,0,1,2020-12-10T19:51:06.617,0,,0.0
2020,13,2983,370,10,6840,13,47,5,4,0,0,0,0,0,0,False,False,False,0,4,2021-02-25T17:48:22.02,0,,0.0
2020,13,2983,385,10,4930,3,13,5,4,0,0,0,0,0,0,False,False,False,0,3,2020-12-10T18:41:02.533,0,,
2020,13,2983,390,10,6840,2,53,5,-7,5,12,5,0,5,0,False,False,False,0,4,2020-12-07T14:07:39.937,5,,0.0
2020,13,2983,410,16,7176,2,4,5,14,15,1,15,0,15,0,False,False,False,0,2,2020-12-07T14:10:51.467,15,,0.0
2020,13,2983,415,16,374,2,5,5,11,28,17,11,17,11,0,True,False,False,1,3,2020-12-07T14:13:33.477,28,,17.0
2020,13,2983,420,16,3938,2,42,10,4,5,1,5,0,5,0,False,False,False,0,2,2020-12-10T18:41:02.533,5,,0.0
2020,13,2983,425,16,121,13,2,9,5,0,0,0,0,0,0,True,False,False,0,3,2021-02-25T17:49:20.46,0,,0.0
2020,13,2983,455,16,374,2,2,10,6,20,14,18,2,18,0,False,False,False,0,3,2021-02-22T19:29:27.137,20,,2.0
2020,13,2983,460,16,3938,2,3,3,12,12,0,12,0,12,0,False,False,False,0,2,2021-02-22T19:29:45.83,12,,0.0
2020,13,2983,465,16,374,3,4,10,10,0,0,0,0,0,0,False,False,False,0,4,2021-02-22T19:30:31.257,0,,0.0
2020,13,2983,470,16,7182,2,35,10,10,15,5,15,0,15,0,False,False,False,0,4,2020-12-07T14:33:29.27,15,,0.0
2020,13,2983,475,16,34,3,46,3,-5,0,0,0,0,0,0,False,False,False,0,1,2020-12-10T20:03:35.297,0,,0.0
2020,13,2983,510,10,7701,2,5,5,2,8,6,3,5,3,0,False,False,False,1,3,2021-03-03T19:20:23.163,8,,5.0
2020,13,2983,520,10,4930,2,35,6,20,21,1,20,1,20,0,False,False,False,0,3,2020-12-07T14:51:02.79,21,,1.0
2020,13,2983,525,10,7702,2,13,10,2,11,9,10,1,10,0,False,False,False,0,3,2020-12-07T14:52:38.023,11,,1.0
2020,13,2983,555,10,7700,13,2,3,7,0,0,0,0,0,0,False,False,False,0,2,2020-12-07T15:01:44.28,0,,
2020,13,2983,560,10,4930,2,9,3,10,10,0,10,0,10,6,False,False,False,0,2,2021-03-04T17:53:55.763,10,,0.0
2020,13,2983,575,16,3938,2,6,8,18,30,12,30,0,30,0,False,False,False,0,3,2020-12-10T18:41:02.533,30,,0.0
2020,13,2983,580,16,374,2,26,10,6,14,8,4,10,4,0,False,False,False,1,3,2020-12-10T18:41:02.533,14,,10.0
2020,13,2983,585,16,121,2,4,3,4,5,1,4,1,4,0,False,False,False,0,2,2020-12-07T15:10:08.45,5,,1.0
2020,13,2983,590,16,6499,13,4,4,4,0,0,0,0,0,0,False,False,False,0,1,2020-12-10T19:51:44.077,0,,0.0
2020,13,2983,600,16,7176,13,35,8,20,0,0,0,0,0,0,False,False,False,0,3,2020-12-07T15:15:06.707,0,,0.0
2020,13,2983,605,16,374,2,5,7,15,20,5,19,1,19,6,False,False,False,0,4,2020-12-07T15:17:39.757,20,,1.0
2020,13,2983,620,10,4930,2,4,4,6,8,2,6,2,6,0,False,False,False,0,3,2020-12-10T19:51:55.207,8,,2.0
2020,13,2983,645,10,7701,13,8,8,29,0,0,0,0,0,0,False,False,False,0,3,2020-12-10T18:41:02.533,0,,0.0
2020,13,2983,660,16,374,13,24,2,25,0,0,0,0,0,0,False,False,False,0,3,2020-12-08T18:47:19.867,0,,0.0
2020,13,2983,665,16,374,2,6,4,8,8,0,8,0,8,0,False,False,False,0,3,2020-12-07T15:44:06.783,8,,0.0
2020,13,2983,670,16,6499,2,28,4,5,5,0,5,0,5,0,False,False,False,0,1,2021-02-22T19:32:30.957,5,,0.0
2020,13,2983,680,16,121,3,35,7,15,0,0,0,0,0,0,False,False,False,0,3,2020-12-07T15:50:33.903,0,,0.0
2020,13,2983,685,16,374,13,6,9,12,0,0,0,0,0,0,False,False,False,0,3,2021-02-22T19:33:16.7,0,,0.0
2020,13,2983,690,16,3938,2,7,2,38,48,10,48,0,48,6,False,False,False,0,3,2020-12-08T18:47:57.85,48,,
2020,13,2983,695,16,374,3,12,1,30,0,0,0,0,0,0,False,False,False,0,3,2020-12-07T15:57:54.497,0,,0.0
2020,13,2983,720,10,7700,13,7,6,24,0,0,0,0,0,0,False,False,False,0,3,2020-12-07T16:08:48.087,0,,0.0
2020,13,2983,725,10,4930,13,35,7,20,0,0,0,0,0,0,False,False,False,0,3,2020-12-08T17:12:52.693,0,,
2020,13,2983,740,10,7701,3,35,10,12,0,0,0,0,0,0,False,False,False,0,3,2020-12-07T16:19:52.207,0,,0.0
2020,13,2983,755,16,121,2,12,4,11,17,6,15,2,15,0,False,False,False,0,3,2020-12-07T16:26:47.653,17,,2.0
2020,13,2983,775,16,121,2,5,9,5,9,4,6,3,6,0,False,False,False,0,3,2020-12-07T16:32:25.967,9,,3.0
2020,13,2983,805,16,374,2,12,9,5,9,4,7,2,7,0,False,False,False,0,4,2021-02-22T19:34:12,9,,2.0
2020,13,2983,825,10,7700,13,6,9,8,0,0,0,0,0,0,False,False,False,0,2,2020-12-08T18:48:50.587,0,,0.0
2020,13,2983,830,10,7700,2,5,3,5,5,0,5,0,5,0,False,False,False,0,3,2020-12-07T16:41:44.557,5,,0.0
2020,13,2983,835,10,6840,13,17,1,20,0,0,0,0,0,0,False,False,False,0,4,2020-12-07T16:43:44.293,0,,0.0
2020,13,2983,840,10,7700,13,8,8,19,0,0,0,0,0,0,False,False,False,0,2,2020-12-07T16:45:55.927,0,,0.0
2020,13,2984,10,4,6953,13,17,7,27,0,0,0,0,0,0,False,False,False,0,3,2020-12-08T11:06:26.253,0,,
2020,13,2984,20,4,594,2,49,3,-3,3,6,2,1,2,0,False,False,False,1,2,2020-12-08T11:11:19.357,3,,1.0
2020,13,2984,25,4,594,2,17,6,25,31,6,28,3,28,0,False,False,False,0,3,2020-12-08T11:28:11.14,31,,3.0
2020,13,2984,35,4,2853,2,5,3,4,5,1,5,0,5,0,False,False,False,0,3,2020-12-08T16:45:55.1,5,,0.0
2020,13,2984,40,4,7645,2,44,3,-4,5,9,1,4,1,0,False,False,False,0,1,2021-02-22T14:47:34.643,5,,4.0
2020,13,2984,60,4,2853,2,50,10,-3,6,9,3,3,3,0,False,False,False,1,2,2020-12-08T16:46:11.163,6,,3.0
2020,13,2984,65,4,1377,13,35,9,1,0,0,0,0,0,0,False,False,False,0,4,2021-02-25T17:53:17.097,0,,0.0
2020,13,2984,80,28,7619,13,19,2,30,0,0,0,0,0,0,False,False,False,0,2,2020-12-08T11:39:55.957,0,,
2020,13,2984,100,28,969,2,8,4,12,17,5,15,2,15,0,True,False,False,0,3,2020-12-08T11:47:47.81,17,,2.0
2020,13,2984,110,28,7224,13,4,5,6,0,0,0,0,0,0,False,False,False,0,2,2020-12-10T16:29:20.187,0,,0.0
2020,13,2984,115,28,7619,2,42,4,5,11,6,11,0,11,0,False,False,False,0,3,2020-12-08T16:57:23.707,11,,0.0
2020,13,2984,155,28,7619,2,2,4,2,2,0,2,0,2,6,False,False,False,0,3,2021-02-22T14:50:51.047,2,,0.0
2020,13,2984,170,4,2853,2,12,5,12,12,0,12,0,12,0,False,False,False,0,2,2020-12-08T16:46:26.547,12,,0.0
2020,13,2984,175,4,594,2,12,2,35,35,0,35,0,35,0,False,False,False,0,3,2020-12-08T12:25:38.42,35,,0.0
2020,13,2984,190,4,7646,2,6,7,20,22,2,20,2,20,0,False,False,False,0,2,2020-12-08T12:41:51.717,22,,2.0
2020,13,2984,195,4,1377,2,12,10,1,7,6,5,2,5,0,False,False,False,0,4,2020-12-08T12:44:16.493,7,,
2020,13,2984,200,4,594,2,4,10,5,5,0,5,0,5,6,False,False,False,0,3,2020-12-08T16:56:19.53,5,,0.0
2020,13,2984,215,28,7619,2,2,9,8,13,5,13,0,13,0,False,False,False,0,2,2021-02-22T14:51:04.29,13,,0.0
2020,13,2984,230,28,969,13,35,4,13,0,0,0,0,0,0,True,False,False,0,3,2020-12-08T12:53:52.493,0,,0.0
2020,13,2984,240,4,2853,2,12,5,8,8,0,8,0,8,0,False,False,False,0,3,2021-03-09T18:59:12.743,8,,0.0
2020,13,2984,255,4,2853,13,12,4,7,0,0,0,0,0,0,False,False,False,0,2,2020-12-08T13:01:20.453,0,,
2020,13,2984,260,4,6983,2,4,3,5,9,4,6,3,6,0,False,False,False,0,2,2020-12-08T13:04:33.2,9,,3.0
2020,13,2984,275,4,6953,2,13,10,4,8,4,5,3,5,0,False,False,False,0,3,2020-12-08T13:15:45.363,8,,3.0
2020,13,2984,280,4,5119,2,34,4,-5,8,13,7,1,7,0,True,False,False,0,3,2021-03-04T17:58:56.313,8,,1.0
2020,13,2984,285,4,594,2,2,10,5,12,7,9,3,9,0,False,False,False,0,3,2020-12-09T17:06:06.14,12,,3.0
2020,13,2984,310,4,6953,2,54,10,-3,4,7,4,0,4,6,True,False,False,0,4,2020-12-08T13:30:25.883,4,,0.0
2020,13,2984,330,28,4912,2,12,5,12,13,1,13,0,13,0,False,False,False,0,3,2020-12-10T15:56:10.52,13,,0.0
2020,13,2984,345,28,3264,2,47,5,0,1,1,1,0,1,0,False,False,False,0,1,2020-12-08T13:40:47.573,1,,0.0
2020,13,2984,350,28,7619,3,4,4,5,0,0,0,0,0,0,False,False,False,0,3,2020-12-08T13:44:46.06,0,,0.0
2020,13,2984,365,4,594,2,6,4,3,7,4,5,2,5,0,False,False,False,1,3,2020-12-08T16:54:10.5,7,,2.0
2020,13,2984,380,4,2853,2,35,6,16,18,2,18,0,18,0,False,False,False,0,3,2020-12-08T16:47:01.643,18,,0.0
2020,13,2984,390,4,594,2,12,2,20,20,0,20,0,20,0,False,False,False,0,3,2021-03-09T19:00:12.473,20,,0.0
2020,13,2984,395,4,7646,2,13,9,5,18,13,17,1,17,0,False,False,False,0,2,2020-12-08T13:56:36.687,18,,1.0
2020,13,2984,410,28,7224,13,6,9,9,0,0,0,0,0,0,False,False,False,0,3,2020-12-08T14:11:36.35,0,,0.0
2020,13,2984,415,28,6627,2,7,2,17,17,0,17,0,17,0,False,False,False,0,4,2020-12-08T14:13:35.047,17,,0.0
2020,13,2984,430,28,7619,2,22,3,13,20,7,19,1,19,0,False,False,False,0,2,2020-12-10T15:29:34.453,20,,1.0
2020,13,2984,440,28,6624,2,4,9,7,7,0,7,0,7,0,False,False,False,0,3,2020-12-08T14:20:19.91,7,,0.0
2020,13,2984,445,28,969,13,5,5,10,0,0,0,0,0,0,False,False,False,0,3,2020-12-08T14:21:40.58,0,,0.0
2020,13,2984,460,4,6983,2,44,3,-3,9,12,-2,11,-2,0,False,False,False,1,1,2020-12-08T14:26:22.053,9,,11.0
2020,13,2984,475,4,6953,2,4,9,5,12,7,9,3,9,0,False,False,False,0,3,2020-12-08T14:34:55.127,12,,3.0
2020,13,2984,480,4,6983,2,47,5,0,4,4,2,2,2,0,True,False,False,0,1,2020-12-09T17:00:44.23,4,,2.0
2020,13,2984,485,4,594,2,4,3,5,6,1,6,0,6,0,False,False,False,0,3,2020-12-08T14:37:22.857,6,,0.0
2020,13,2984,490,4,2853,2,4,10,9,11,2,9,2,9,0,False,False,False,0,2,2020-12-09T17:02:15.18,11,,2.0
2020,13,2984,500,4,594,13,4,5,6,0,0,0,0,0,0,True,False,False,0,2,2020-12-08T14:48:16.97,0,,0.0
2020,13,2984,515,4,5119,2,11,6,19,23,4,23,0,23,6,True,False,False,0,3,2020-12-08T14:50:46.833,23,,0.0
2020,13,2984,530,28,7619,13,6,9,14,0,0,0,0,0,0,False,False,False,0,2,2020-12-08T15:04:21.797,0,,0.0
2020,13,2984,535,28,7619,3,6,4,13,0,0,0,0,0,0,False,False,False,0,2,2020-12-10T15:56:41.123,0,,0.0
2020,13,2984,540,4,7646,13,29,3,5,0,0,0,0,0,0,False,False,False,0,3,2020-12-09T17:06:06.14,0,,0.0
2020,13,2984,545,4,6953,2,55,4,-1,3,4,1,2,1,0,True,False,False,0,4,2020-12-09T17:06:06.14,3,,2.0
2020,13,2984,550,4,594,2,5,9,1,1,0,1,0,1,0,False,False,False,0,1,2020-12-09T17:06:06.14,1,,
2020,13,2984,580,28,7224,2,4,9,4,4,0,4,0,4,0,False,False,False,0,3,2020-12-08T15:16:38.427,4,,0.0
2020,13,2984,585,28,7224,2,6,10,3,12,9,6,6,6,0,False,False,False,1,2,2020-12-08T15:18:52.563,12,,6.0
2020,13,2984,595,28,7619,2,19,6,42,49,7,48,1,48,0,False,False,False,0,3,2020-12-08T15:22:28.323,49,,1.0
2020,13,2984,600,28,262,2,47,5,0,6,6,4,2,4,6,False,False,False,0,1,2020-12-08T15:24:04.323,6,,2.0
2020,13,2984,630,4,2853,2,4,9,10,10,0,10,0,10,0,False,False,False,0,2,2020-12-08T15:33:20.73,10,,0.0
2020,13,2984,635,4,2853,2,26,3,5,12,7,10,2,10,0,False,False,False,1,2,2020-12-08T16:48:04.713,12,,2.0
2020,13,2984,645,4,2853,2,5,3,3,3,0,3,0,3,0,False,False,False,0,3,2020-12-08T16:48:32.73,3,,0.0
2020,13,2984,660,4,2853,2,6,9,5,7,2,6,1,6,0,False,False,False,0,2,2021-02-22T14:53:24.98,7,,1.0
2020,13,2984,665,4,6983,13,12,10,6,0,0,0,0,0,0,False,False,False,0,1,2020-12-08T15:43:08.94,0,,0.0
2020,13,2984,670,4,7646,2,19,2,27,28,1,28,0,28,6,False,False,False,0,2,2020-12-09T17:06:06.14,28,,0.0
2020,13,2984,685,28,7224,2,6,7,18,22,4,20,2,20,0,False,False,False,0,3,2020-12-08T15:54:22.477,22,,2.0
2020,13,2984,690,28,7760,2,5,5,4,15,11,12,3,12,0,False,False,False,1,4,2020-12-10T15:57:11.987,15,,3.0
2020,13,2984,695,28,7224,2,5,5,5,9,4,7,2,7,0,False,False,False,0,3,2020-12-08T15:55:49.15,9,,2.0
2020,13,2984,705,28,7760,2,30,3,2,18,16,14,4,14,0,False,False,False,0,4,2020-12-08T15:58:59.51,18,,4.0
2020,13,2984,715,28,4912,2,5,5,2,2,0,2,0,2,0,False,False,False,0,3,2020-12-08T16:02:28.663,2,,0.0
2020,13,2984,725,28,6624,13,12,4,3,0,0,0,0,0,0,True,False,False,0,2,2021-03-09T19:00:57.183,0,,0.0
2020,13,2984,745,4,594,2,5,3,6,11,5,9,2,9,0,False,False,False,0,3,2020-12-08T16:09:00.127,11,,2.0
2020,13,2984,760,4,594,13,12,5,9,0,0,0,0,0,0,False,False,False,0,3,2020-12-09T17:03:41.41,0,,0.0
2020,13,2984,770,28,7224,2,45,5,-5,3,8,1,2,1,0,True,False,False,0,3,2020-12-08T16:15:49.43,3,,2.0
2020,13,2984,775,28,969,2,13,9,6,10,4,8,2,8,0,False,False,False,0,3,2020-12-08T16:17:32.04,10,,2.0
2020,13,2984,780,28,7224,3,4,5,3,0,0,0,0,0,0,False,False,False,0,2,2020-12-08T16:18:45.997,0,,0.0
2020,13,2984,785,28,6627,2,4,10,9,12,3,10,2,10,0,False,False,False,0,4,2020-12-08T16:20:17.45,12,,2.0
2020,13,2984,790,28,6624,13,46,3,3,0,0,0,0,0,0,False,False,False,0,1,2020-12-08T16:21:16.527,0,,0.0
2020,13,2984,795,28,6624,13,6,4,4,0,0,0,0,0,0,False,False,False,0,1,2020-12-08T16:23:24.377,0,,0.0
2020,13,2984,800,28,7224,2,50,9,-4,23,27,0,23,0,0,False,False,False,2,3,2020-12-10T15:57:38.643,23,,23.0
2020,13,2984,810,28,4912,13,12,10,2,0,0,0,0,0,0,False,False,False,0,3,2021-03-09T19:01:43.06,0,,0.0
2020,13,2984,820,28,6624,2,48,3,-6,5,11,2,3,2,0,False,False,False,0,1,2020-12-08T16:29:31.287,5,,3.0
2020,13,2984,825,28,4912,2,12,10,11,11,0,11,0,11,0,False,False,False,0,3,2020-12-08T16:31:11.007,11,,0.0
2020,13,2984,830,28,4912,2,2,4,7,9,2,7,2,7,0,False,False,False,0,3,2020-12-08T16:32:30.243,9,,2.0
2020,13,2984,835,28,7619,13,9,3,5,0,0,0,0,0,0,False,False,False,0,2,2020-12-10T15:29:34.453,0,,0.0
2020,13,2984,840,28,969,2,12,5,5,5,0,5,0,5,6,False,False,False,0,3,2020-12-08T16:34:54.96,5,,0.0
2020,14,2985,10,29,3398,2,35,10,11,25,14,15,10,15,0,False,False,False,1,4,2020-12-11T11:48:34.47,25,,10
2020,14,2985,35,29,4866,2,46,3,3,3,0,3,0,3,0,False,False,False,0,2,2020-12-11T12:05:05.24,3,,0
2020,14,2985,60,19,7172,2,44,9,-5,0,5,-1,1,-1,0,False,False,False,1,1,2020-12-11T12:14:45.07,0,,1
2020,14,2985,65,19,3233,3,6,10,5,0,0,0,0,0,0,False,False,False,0,2,2020-12-11T12:18:09.143,0,,0
2020,14,2985,90,29,4850,13,26,9,2,0,0,0,0,0,0,False,False,False,0,4,2020-12-11T12:27:30.523,0,,0
2020,14,2985,95,29,1958,2,50,9,-3,-2,1,-2,0,-2,0,False,False,False,0,2,2020-12-16T12:10:54.297,-2,,0
2020,14,2985,100,29,1958,2,4,10,11,14,3,14,0,14,0,False,False,False,0,3,2020-12-11T12:31:41.843,14,,0
2020,14,2985,120,29,7788,2,5,9,2,16,14,14,2,14,0,False,False,False,0,1,2021-03-15T18:33:51.62,16,,2
2020,14,2985,135,19,3233,2,4,3,3,5,2,5,0,5,0,False,False,False,0,2,2020-12-11T12:47:03.587,5,,0
2020,14,2985,145,19,7175,13,4,10,3,0,0,0,0,0,0,True,False,False,0,3,2020-12-11T13:24:31.453,0,,0
2020,14,2985,155,29,4875,3,6,4,14,0,0,0,0,0,0,False,False,False,0,3,2020-12-11T12:57:07.517,0,,0
2020,14,2985,160,29,4850,2,4,9,4,9,5,5,4,5,0,False,False,False,0,3,2020-12-16T13:38:06.877,9,,4
2020,14,2985,175,29,1958,2,50,10,-1,7,8,5,2,5,0,False,False,False,0,2,2020-12-11T13:08:21.95,7,,2
2020,14,2985,185,29,1958,13,5,5,5,0,0,0,0,0,0,True,False,False,0,3,2020-12-11T13:20:00.427,0,,0
2020,14,2985,205,19,7172,13,48,10,-2,0,0,0,0,0,0,False,False,False,0,1,2021-03-05T14:57:33.65,0,,0
2020,14,2985,240,19,3233,2,4,7,18,25,7,24,1,24,0,False,False,False,0,2,2020-12-11T13:53:55.023,25,,1
2020,14,2985,290,29,3398,2,47,5,2,9,7,7,2,7,0,False,False,False,0,3,2020-12-11T14:15:24.793,9,,2
2020,14,2985,295,29,7788,13,32,9,-1,0,0,0,0,0,0,False,False,False,0,1,2020-12-11T14:18:06.783,0,,0
2020,14,2985,300,29,4850,13,5,5,3,0,0,0,0,0,0,False,False,False,0,4,2020-12-11T14:20:50.43,0,,0
2020,14,2985,305,29,7788,2,6,10,1,7,6,4,3,4,0,False,False,False,1,1,2021-03-09T12:53:51.71,7,,3
2020,14,2985,315,19,7175,2,6,7,17,31,14,26,5,26,0,False,False,False,0,3,2020-12-11T14:26:55.823,31,,5
2020,14,2985,325,19,3233,2,4,10,5,5,0,4,1,4,0,False,False,False,0,3,2020-12-11T14:30:34.697,5,,1
2020,14,2985,330,19,7173,2,6,10,13,13,0,13,0,13,0,False,False,False,0,3,2020-12-11T14:32:44.89,13,,0
2020,14,2985,355,19,7175,2,13,10,4,6,2,6,0,6,0,False,False,False,0,3,2020-12-11T14:55:51.123,6,,0
2020,14,2985,375,29,4866,2,39,9,4,6,2,4,2,4,0,False,False,False,0,3,2020-12-11T15:00:05.057,6,,2
2020,14,2985,380,29,3356,13,32,3,3,0,0,0,0,0,0,False,False,False,0,1,2020-12-11T15:05:48.837,0,,0
2020,14,2985,385,29,4866,2,13,9,2,2,0,-1,3,-1,0,False,False,False,0,3,2020-12-16T12:10:54.31,2,,3
2020,14,2985,400,19,7175,2,6,10,6,4,-2,4,0,4,0,False,False,False,0,3,2021-03-08T15:24:24.867,4,,0
2020,14,2985,410,19,3233,3,2,9,7,0,0,0,0,0,0,False,False,False,0,2,2021-02-23T13:51:37.143,0,,0
2020,14,2985,440,19,7173,2,21,6,30,30,0,30,0,30,0,False,False,False,0,2,2020-12-11T15:38:20.247,30,,0
2020,14,2985,465,19,7173,13,21,2,27,0,0,0,0,0,0,False,False,False,0,2,2020-12-11T15:45:15.117,0,,0
2020,14,2985,500,29,1958,2,5,3,4,8,4,5,3,5,0,False,False,False,1,3,2020-12-16T12:10:54.31,8,,3
2020,14,2985,515,29,4875,2,50,3,-1,6,7,5,1,5,0,False,False,False,0,2,2020-12-11T16:02:55.857,6,,1
2020,14,2985,535,29,1958,2,26,10,3,5,2,4,1,4,0,False,False,False,0,4,2020-12-11T16:09:54.243,5,,1
2020,14,2985,560,29,4866,2,5,5,2,2,0,2,0,2,6,False,False,False,0,3,2021-02-23T13:52:12.197,2,,0
2020,14,2985,625,19,3233,13,4,9,5,0,0,0,0,0,0,False,False,False,0,2,2020-12-11T16:33:45.503,0,,0
2020,14,2985,630,19,1328,13,32,10,2,0,0,0,0,0,0,False,False,False,0,1,2020-12-11T16:37:56.1,0,,0
2020,14,2985,650,29,1958,13,50,9,-1,0,0,0,0,0,0,False,False,False,0,2,2020-12-11T16:45:00.32,0,,0
2020,14,2985,660,19,1328,2,48,9,-5,2,7,-1,3,-1,0,False,False,False,0,1,2020-12-11T16:48:51.047,2,,3
2020,14,2985,665,19,3233,2,4,9,3,7,4,7,0,7,0,False,False,False,0,3,2020-12-11T16:51:22.573,7,,0
2020,14,2985,680,19,3233,2,50,9,-3,6,9,5,1,5,0,False,False,False,0,3,2021-03-04T18:03:03.4,6,,1
2020,14,2985,685,19,7175,2,4,10,6,6,0,6,0,6,0,True,False,False,0,3,2020-12-11T17:47:24.227,6,,0
2020,14,2985,690,19,7620,13,6,4,7,0,0,0,0,0,0,False,False,False,0,3,2020-12-11T17:00:48.52,0,,0
2020,14,2985,705,29,4866,2,6,7,18,20,2,19,1,19,0,False,False,False,0,3,2020-12-11T17:05:42.227,20,,1
2020,14,2985,715,29,1958,3,7,2,21,0,0,0,0,0,0,False,False,False,0,3,2020-12-11T17:12:41.797,0,,0
2020,14,2985,745,19,7173,2,4,10,6,6,0,6,0,6,0,True,False,False,0,3,2020-12-11T17:52:16.217,6,,0
2020,14,2985,750,19,6266,13,48,9,-6,0,0,0,0,0,0,False,False,False,0,1,2020-12-11T17:28:22.377,0,,0
2020,14,2986,20,10,6481,2,44,3,-5,3,8,0,3,0,0,False,False,False,0,1,2020-12-14T11:28:26.313,3,,3.0
2020,14,2986,35,10,4930,13,2,9,8,0,0,0,0,0,0,False,False,False,0,3,2020-12-14T11:33:15.65,0,,0.0
2020,14,2986,45,5,2554,2,44,3,-2,0,2,0,0,0,0,False,False,False,0,1,2020-12-14T11:39:00.427,0,,0.0
2020,14,2986,55,5,8195,2,28,9,1,5,4,5,0,5,0,True,False,False,0,1,2020-12-15T18:17:45.3,5,,0.0
2020,14,2986,75,5,3477,2,5,3,3,13,10,13,0,13,0,False,False,False,0,3,2020-12-15T18:18:03.837,13,,0.0
2020,14,2986,85,5,2554,2,47,5,2,4,2,2,2,2,0,True,False,False,0,1,2020-12-14T12:12:08.287,4,,2.0
2020,14,2986,105,5,6425,2,46,3,2,8,6,6,2,6,0,False,False,False,0,3,2020-12-14T12:19:05.53,8,,2.0
2020,14,2986,120,10,3848,2,32,5,1,8,7,7,1,7,0,False,False,False,0,4,2020-12-17T15:55:10.297,8,,1.0
2020,14,2986,125,10,6481,2,48,9,-5,4,9,-4,8,-4,0,False,False,False,1,1,2020-12-14T12:24:31.95,4,,8.0
2020,14,2986,155,5,6372,2,4,10,3,3,0,3,0,3,0,False,False,False,0,2,2020-12-14T12:31:50.01,3,,0.0
2020,14,2986,170,5,3477,2,6,9,2,3,1,3,0,3,0,False,False,False,0,2,2020-12-14T12:34:48.033,3,,0.0
2020,14,2986,185,10,7700,13,4,3,3,0,0,0,0,0,0,False,False,False,0,2,2021-02-22T21:55:01.623,0,,0.0
2020,14,2986,195,10,4930,13,21,2,37,0,0,0,0,0,0,False,False,False,0,2,2020-12-17T15:55:10.297,0,,
2020,14,2986,200,10,6285,2,4,10,14,13,-1,13,0,13,0,False,False,False,0,2,2020-12-14T12:56:16.49,13,,0.0
2020,14,2986,205,10,3848,2,32,9,3,7,4,5,2,5,0,False,False,False,0,4,2020-12-14T18:04:03.83,7,,2.0
2020,14,2986,215,10,6286,2,32,10,-3,6,9,5,1,5,0,False,False,False,0,4,2020-12-14T12:59:20.87,6,,1.0
2020,14,2986,225,10,282,2,44,3,-2,2,4,2,0,2,0,False,False,False,0,1,2020-12-17T18:02:02.647,2,,0.0
2020,14,2986,245,5,4803,13,9,3,3,0,0,0,0,0,0,False,False,False,0,2,2020-12-17T15:55:10.297,0,,0.0
2020,14,2986,265,10,3848,2,5,10,3,3,0,3,0,3,0,False,False,False,0,4,2020-12-17T15:55:10.297,3,,0.0
2020,14,2986,275,10,6286,2,5,10,4,4,0,4,0,4,0,False,False,False,0,4,2020-12-14T13:17:08.673,4,,0.0
2020,14,2986,280,10,4930,2,18,3,-2,2,4,2,0,2,0,False,False,False,0,2,2020-12-14T13:19:01.757,2,,0.0
2020,14,2986,285,10,7700,13,49,5,-3,0,0,0,0,0,0,False,False,False,0,2,2020-12-14T13:20:28.13,0,,0.0
2020,14,2986,290,10,7700,13,4,10,4,0,0,0,0,0,0,False,False,False,0,3,2020-12-17T18:03:29.157,0,,
2020,14,2986,295,10,7700,2,20,6,25,31,6,28,3,28,0,False,False,False,0,2,2020-12-14T13:25:48.123,31,,3.0
2020,14,2986,310,10,6286,13,24,5,12,0,0,0,0,0,0,False,False,False,0,4,2020-12-14T13:29:05.073,0,,0.0
2020,14,2986,340,10,3848,2,33,9,2,2,0,2,0,2,6,False,False,False,0,4,2020-12-15T16:45:37.88,2,,0.0
2020,14,2986,355,5,6372,13,19,1,33,0,0,0,0,0,0,False,False,False,0,2,2021-02-22T21:59:35.23,0,,0.0
2020,14,2986,360,5,6425,2,4,9,4,8,4,6,2,6,0,True,False,False,0,3,2020-12-17T18:16:24.633,8,,2.0
2020,14,2986,365,5,2554,2,46,3,-1,18,19,10,8,10,0,False,False,False,2,1,2020-12-14T13:49:21.967,18,,8.0
2020,14,2986,370,5,6372,13,13,10,3,0,0,0,0,0,0,False,False,False,0,2,2020-12-14T13:51:03.803,0,,
2020,14,2986,380,5,6425,3,6,9,12,0,0,0,0,0,0,False,False,False,0,3,2020-12-17T15:55:10.297,0,,0.0
2020,14,2986,400,5,6425,2,46,3,0,4,4,4,0,4,0,True,False,False,0,4,2020-12-14T14:20:26.95,4,,0.0
2020,14,2986,410,5,4803,2,45,5,-6,0,6,0,0,0,0,True,False,False,0,3,2021-02-22T22:00:12.65,0,,0.0
2020,14,2986,415,5,3477,3,4,9,12,0,0,0,0,0,0,False,False,False,0,3,2020-12-17T18:16:58.113,0,,0.0
2020,14,2986,425,10,7700,2,35,5,11,11,0,11,0,11,0,False,False,False,0,3,2021-02-25T16:18:51.73,11,,0.0
2020,14,2986,440,10,7701,2,19,2,30,37,7,37,0,37,6,False,False,False,0,2,2020-12-14T14:47:46.943,37,,0.0
2020,14,2986,460,5,2554,3,16,10,5,0,0,0,0,0,0,True,False,False,0,1,2020-12-15T18:20:43.8,0,,0.0
2020,14,2986,465,5,3477,2,5,3,5,10,5,9,1,9,0,False,False,False,0,3,2020-12-14T14:53:14.303,10,,1.0
2020,14,2986,470,5,3477,13,6,10,14,0,0,0,0,0,0,False,False,False,0,2,2020-12-17T15:55:10.297,0,,0.0
2020,14,2986,480,5,3477,2,5,10,4,21,17,20,1,20,0,False,False,False,1,3,2020-12-17T17:50:15.897,21,,1.0
2020,14,2986,495,5,3477,13,5,2,17,0,0,0,0,0,0,False,False,False,0,2,2021-03-04T18:06:58.653,0,,0.0
2020,14,2986,500,5,3477,13,9,6,17,0,0,0,0,0,0,False,False,False,0,2,2020-12-14T15:07:43.66,0,,0.0
2020,14,2986,520,10,4930,13,12,3,10,0,0,0,0,0,0,False,False,False,0,2,2020-12-17T16:33:46.873,0,,0.0
2020,14,2986,525,10,6286,2,32,10,2,14,12,13,1,13,0,False,False,False,0,4,2020-12-14T15:13:52.54,14,,1.0
2020,14,2986,530,10,4930,2,43,7,17,32,15,30,2,30,0,False,False,False,0,4,2020-12-17T18:07:15.443,32,,2.0
2020,14,2986,540,10,6286,2,53,9,-5,29,34,28,1,28,0,False,False,False,0,4,2020-12-17T16:34:08.457,29,,1.0
2020,14,2986,545,10,4930,2,30,9,-2,2,4,2,0,2,6,False,False,False,0,4,2020-12-17T18:17:43.667,2,,0.0
2020,14,2986,565,5,3389,2,4,3,7,12,5,9,3,9,0,False,False,False,0,2,2020-12-14T15:46:43.767,12,,3.0
2020,14,2986,570,5,2554,2,48,4,-2,0,2,0,0,0,0,False,False,False,0,1,2020-12-14T15:48:57.597,0,,0.0
2020,14,2986,575,5,8195,2,28,9,0,9,9,5,4,5,0,False,False,False,0,1,2020-12-14T16:13:32.42,9,,4.0
2020,14,2986,585,5,4803,2,5,8,16,19,3,18,1,18,0,False,False,False,0,3,2020-12-14T16:17:51.14,19,,1.0
2020,14,2986,590,5,4803,2,17,8,16,17,1,17,0,17,0,False,False,False,0,3,2020-12-14T18:04:27.44,17,,0.0
2020,14,2986,600,5,4803,2,51,9,-4,1,5,0,1,0,0,False,False,False,0,3,2020-12-17T18:17:59.78,1,,1.0
2020,14,2986,625,10,7701,13,35,6,17,0,0,0,0,0,0,False,False,False,0,3,2020-12-14T16:29:28.537,0,,0.0
2020,14,2986,660,5,3477,2,5,5,2,2,0,2,0,2,0,False,False,False,0,3,2020-12-17T15:55:10.297,2,,0.0
2020,14,2986,665,5,4803,2,4,10,11,14,3,14,0,14,0,False,False,False,0,3,2020-12-14T16:49:20.147,14,,0.0
2020,14,2986,670,5,3477,2,51,9,-2,8,10,4,4,4,0,False,False,False,0,3,2020-12-17T17:50:39.21,8,,4.0
2020,14,2986,675,5,3477,2,2,10,7,23,16,19,4,19,0,False,False,False,0,2,2020-12-14T16:53:53.383,23,,4.0
2020,14,2986,680,5,4803,2,4,7,16,16,0,16,0,16,0,False,False,False,0,3,2020-12-14T18:04:45.35,16,,0.0
2020,14,2986,690,5,4719,2,12,5,0,0,0,0,0,0,0,False,False,False,0,1,2021-03-09T12:56:57.437,0,,0.0
2020,14,2986,705,5,3477,2,26,9,4,4,0,4,0,4,0,False,False,False,0,3,2020-12-17T18:09:59.38,4,,0.0
2020,14,2986,725,10,282,2,48,10,-6,20,26,10,10,10,0,False,False,False,1,1,2020-12-14T17:09:30.74,20,,10.0
2020,14,2986,730,10,7701,2,8,1,45,49,4,47,2,47,6,False,False,False,0,3,2020-12-14T17:18:36.607,49,,2.0
2020,14,2986,745,5,2554,2,11,5,5,20,15,5,15,5,0,True,False,False,1,1,2020-12-17T15:55:10.297,20,,15.0
2020,14,2986,750,5,3477,13,5,5,12,0,0,0,0,0,0,False,False,False,0,2,2020-12-14T17:23:06.82,0,,
2020,14,2986,755,5,3389,2,6,7,18,32,14,32,0,32,0,False,False,False,0,2,2020-12-17T17:50:50.467,32,,0.0
2020,14,2986,760,5,4803,13,4,9,4,0,0,0,0,0,0,False,False,False,0,2,2020-12-14T17:28:06.473,0,,0.0
2020,14,2986,800,10,282,2,12,4,-3,1,4,-1,2,-1,0,False,False,False,0,1,2021-02-22T22:04:42.75,1,,2.0
2020,14,2986,820,5,3389,2,13,4,4,8,4,8,0,8,0,False,False,False,0,2,2020-12-14T17:43:06.3,8,,0.0
2020,14,2986,835,5,4803,2,13,9,1,1,0,1,0,1,0,False,False,False,0,3,2020-12-14T17:45:46.597,1,,0.0
2020,14,2987,10,13,6529,2,5,10,5,8,3,8,0,8,0,False,False,False,0,3,2020-12-14T16:43:44.937,8,,0.0
2020,14,2987,30,13,4733,2,6,4,12,13,1,13,0,13,0,False,False,False,0,3,2020-12-14T11:27:29.583,13,,0.0
2020,14,2987,40,13,4733,2,4,9,6,6,0,6,0,6,0,False,False,False,0,3,2020-12-17T20:23:09.14,6,,0.0
2020,14,2987,50,13,6528,13,6,9,11,0,0,0,0,0,0,False,False,False,0,4,2020-12-17T20:23:48.137,0,,0.0
2020,14,2987,85,13,404,2,2,3,5,5,0,5,0,5,0,False,False,False,0,2,2020-12-14T11:49:36.11,5,,0.0
2020,14,2987,115,13,6637,2,5,5,5,11,6,4,7,4,0,False,False,False,1,3,2020-12-14T12:01:56.217,11,,7.0
2020,14,2987,120,13,6637,13,9,6,21,0,0,0,0,0,0,False,False,False,0,2,2020-12-17T20:17:58.853,0,,0.0
2020,14,2987,125,13,4733,2,5,5,4,6,2,6,0,6,0,True,False,False,0,3,2020-12-14T12:05:24.107,6,,0.0
2020,14,2987,140,6,464,2,2,9,9,14,5,14,0,14,0,False,False,False,0,3,2020-12-14T12:10:03.157,14,,0.0
2020,14,2987,145,6,666,2,26,3,-1,12,13,11,1,11,0,False,False,False,0,4,2020-12-14T12:12:17.947,12,,1.0
2020,14,2987,150,6,464,2,4,3,7,7,0,7,0,7,0,False,False,False,0,2,2020-12-14T12:14:29.85,7,,0.0
2020,14,2987,160,6,464,2,5,5,2,9,7,9,0,9,0,False,False,False,0,3,2020-12-14T12:18:31.727,9,,0.0
2020,14,2987,165,6,7728,2,13,10,4,7,3,4,3,4,0,False,False,False,0,4,2020-12-14T12:21:02.443,7,,3.0
2020,14,2987,170,6,7728,2,26,9,-2,7,9,5,2,5,0,False,False,False,0,4,2020-12-14T12:22:52.61,7,,2.0
2020,14,2987,175,6,7725,2,30,10,-2,10,12,6,4,6,0,False,False,False,1,3,2020-12-14T12:25:10.843,10,,4.0
2020,14,2987,210,6,666,2,29,3,5,5,0,5,0,5,6,False,False,False,0,2,2020-12-14T12:54:07.99,5,,0.0
2020,14,2987,230,13,4733,2,26,9,3,3,0,3,0,3,0,False,False,False,0,3,2020-12-14T13:03:08.08,3,,0.0
2020,14,2987,240,13,6528,13,5,5,0,0,0,0,0,0,0,False,False,False,0,4,2020-12-17T20:16:40.457,0,,0.0
2020,14,2987,250,13,404,2,50,9,-5,48,53,40,8,40,0,True,False,False,0,2,2021-03-04T15:47:16.773,48,,8.0
2020,14,2987,260,13,6529,2,12,9,5,5,0,5,0,5,6,False,False,False,0,3,2020-12-17T20:16:55,5,,0.0
2020,14,2987,280,6,666,2,32,9,-4,4,8,2,2,2,0,False,False,False,0,4,2021-02-23T12:41:28.79,4,,2.0
2020,14,2987,285,6,464,13,12,10,2,0,0,0,0,0,0,False,False,False,0,3,2021-03-09T12:59:06.43,0,,0.0
2020,14,2987,315,6,6328,2,30,5,0,6,6,5,1,5,0,False,False,False,0,3,2020-12-14T13:34:43.013,6,,1.0
2020,14,2987,320,6,464,2,2,4,6,9,3,9,0,9,0,False,False,False,0,3,2020-12-14T13:36:15.627,9,,0.0
2020,14,2987,325,6,6786,2,46,3,1,11,10,9,2,9,0,False,False,False,1,1,2020-12-14T13:37:50.48,11,,2.0
2020,14,2987,330,6,7725,2,51,10,-2,12,14,12,0,12,6,False,False,False,0,3,2021-03-04T18:10:12.55,12,,0.0
2020,14,2987,355,13,6528,2,4,9,5,8,3,6,2,6,0,False,False,False,0,4,2020-12-14T13:46:54.137,8,,2.0
2020,14,2987,360,13,3652,2,12,3,1,3,2,3,0,3,0,False,False,False,0,1,2020-12-17T20:27:58.067,3,,
2020,14,2987,370,13,3652,2,32,3,3,10,7,9,1,9,0,False,False,False,0,3,2020-12-14T13:52:40.86,10,,1.0
2020,14,2987,380,6,464,13,5,3,5,0,0,0,0,0,0,False,False,False,0,2,2020-12-17T20:18:26.943,0,,0.0
2020,14,2987,395,6,464,2,2,10,7,8,1,8,0,8,0,False,False,False,0,3,2020-12-17T16:45:04.837,8,,0.0
2020,14,2987,400,6,464,2,9,2,19,22,3,20,2,20,0,False,False,False,0,2,2020-12-14T16:55:35.31,22,,2.0
2020,14,2987,420,6,7728,2,4,10,7,16,9,11,5,11,0,False,False,False,0,3,2020-12-14T14:05:55.903,16,,5.0
2020,14,2987,440,6,464,2,29,5,13,16,3,14,2,14,0,False,False,False,0,3,2020-12-17T20:28:33.773,16,,2.0
2020,14,2987,445,6,7728,13,47,5,0,0,0,0,0,0,0,False,False,False,0,4,2020-12-17T20:17:27.777,0,,0.0
2020,14,2987,455,6,464,2,2,4,3,3,0,3,0,3,6,False,False,False,0,3,2020-12-14T14:15:13.203,3,,0.0
2020,14,2987,485,6,666,2,30,10,1,2,1,2,0,2,0,False,False,False,0,4,2020-12-14T14:20:52.353,2,,0.0
2020,14,2987,490,6,7728,2,30,9,0,11,11,3,8,3,0,False,False,False,1,4,2020-12-17T20:20:21.807,11,,8.0
2020,14,2987,495,6,464,2,2,10,6,35,29,31,4,31,0,False,False,False,1,3,2020-12-14T14:31:38.7,35,,4.0
2020,14,2987,515,6,7728,13,8,1,15,0,0,0,0,0,0,False,False,False,0,3,2020-12-14T14:41:54.39,0,,0.0
2020,14,2987,520,6,6786,2,48,10,-6,18,24,13,5,13,0,True,False,False,1,1,2020-12-17T20:20:35.73,18,,5.0
2020,14,2987,555,13,6528,2,6,4,8,8,0,8,0,8,0,False,False,False,0,3,2020-12-14T14:52:44.05,8,,0.0
2020,14,2987,560,13,6528,2,32,10,0,4,4,0,4,0,0,False,False,False,0,4,2020-12-14T14:54:53.05,4,,4.0
2020,14,2987,575,13,1430,2,47,5,1,15,14,12,3,12,0,False,False,False,0,4,2020-12-14T15:01:03.107,15,,3.0
2020,14,2987,590,13,6637,2,17,4,14,15,1,15,0,15,0,False,False,False,0,3,2020-12-17T16:45:04.837,15,,0.0
2020,14,2987,600,13,6637,2,5,9,11,12,1,12,0,12,0,False,False,False,0,3,2020-12-17T20:32:23,12,,0.0
2020,14,2987,605,13,6528,3,7,5,3,0,0,0,0,0,0,False,False,False,0,3,2020-12-14T15:22:59.917,0,,0.0
2020,14,2987,640,6,811,13,11,6,20,0,0,0,0,0,0,True,False,False,0,2,2020-12-17T20:42:09.653,0,,0.0
2020,14,2987,645,6,6786,13,45,5,0,0,0,0,0,0,0,True,False,False,0,1,2020-12-14T15:41:04.883,0,,0.0
2020,14,2987,680,6,6786,2,47,10,-2,13,15,11,2,11,0,False,False,False,0,1,2020-12-14T15:50:36.267,13,,2.0
2020,14,2987,690,6,6328,2,30,3,1,10,9,7,3,7,0,False,False,False,0,3,2020-12-17T20:42:21.863,10,,3.0
2020,14,2987,705,6,464,13,9,5,14,0,0,0,0,0,0,False,False,False,0,3,2020-12-14T15:58:22.99,0,,0.0
2020,14,2987,725,13,6637,13,2,4,7,0,0,0,0,0,0,False,False,False,0,3,2020-12-14T16:01:53.597,0,,0.0
2020,14,2987,745,6,7728,13,26,10,0,0,0,0,0,0,0,False,False,False,0,4,2020-12-15T18:42:55.937,0,,0.0
2020,14,2987,750,6,464,13,5,3,10,0,0,0,0,0,0,False,False,False,0,2,2020-12-14T16:16:42.423,0,,0.0
2020,14,2987,800,13,4733,2,51,10,3,4,1,4,0,4,0,False,False,False,0,3,2021-03-04T18:10:44.26,4,,0.0
2020,14,2987,805,13,6536,2,45,5,-4,3,7,1,2,1,0,False,False,False,0,1,2020-12-14T16:30:16.823,3,,2.0
2020,14,2987,810,13,4733,2,29,5,12,15,3,13,2,13,0,True,False,False,0,3,2020-12-14T16:32:13.14,15,,2.0
2020,14,2987,835,13,6529,2,50,3,-4,11,15,10,1,10,0,False,False,False,0,3,2021-03-04T15:50:21.477,11,,1.0
2020,14,2987,840,13,6536,13,12,6,20,0,0,0,0,0,0,False,False,False,0,1,2020-12-17T17:09:44.17,0,,0.0
2020,14,2987,850,13,4733,2,2,9,8,9,1,9,0,9,0,False,False,False,0,2,2020-12-14T16:40:41.25,9,,0.0
2020,14,2988,10,7,7659,2,30,9,-1,10,11,10,0,10,0,False,False,False,0,3,2020-12-14T17:55:37.383,10,,0.0
2020,14,2988,20,9,4202,3,44,3,-3,0,0,0,0,0,0,False,False,False,0,1,2020-12-17T23:53:15.163,0,,0.0
2020,14,2988,30,9,6436,2,5,3,11,11,0,11,0,11,0,False,False,False,0,3,2020-12-14T17:55:55.397,11,,0.0
2020,14,2988,40,9,6446,2,5,10,3,5,2,4,1,4,0,False,False,False,0,4,2020-12-17T23:33:58.74,5,,1.0
2020,14,2988,65,7,7659,2,4,5,8,11,3,10,1,10,0,False,False,False,0,2,2020-12-14T17:56:10.97,11,,1.0
2020,14,2988,75,7,910,2,8,4,14,16,2,15,1,15,0,False,False,False,0,2,2020-12-17T22:41:11.84,16,,1.0
2020,14,2988,85,7,6975,2,53,9,-4,6,10,5,1,5,0,False,False,False,0,4,2020-12-17T23:34:57.573,6,,1.0
2020,14,2988,90,7,6985,2,46,3,0,7,7,5,2,5,0,False,False,False,0,1,2020-12-14T11:53:05.68,7,,2.0
2020,14,2988,110,7,7659,13,30,5,0,0,0,0,0,0,0,False,False,False,0,3,2020-12-17T23:52:18.28,0,,0.0
2020,14,2988,120,7,910,13,5,6,18,0,0,0,0,0,0,False,False,False,0,2,2020-12-14T18:16:15,0,,
2020,14,2988,125,7,3521,2,34,4,-5,21,26,16,5,16,0,True,False,False,0,3,2020-12-14T17:57:04.797,21,,5.0
2020,14,2988,135,7,3521,2,4,10,3,11,8,8,3,8,0,False,False,False,0,3,2020-12-14T12:18:00.297,11,,3.0
2020,14,2988,145,7,3445,3,5,3,10,0,0,0,0,0,0,False,False,False,0,2,2020-12-15T17:42:22.363,0,,0.0
2020,14,2988,170,7,3521,2,34,4,-4,5,9,2,3,2,0,True,False,False,0,3,2020-12-14T12:31:24.693,5,,3.0
2020,14,2988,195,9,4202,2,6,10,3,4,1,4,0,4,0,True,False,False,0,2,2020-12-17T22:41:11.84,4,,0.0
2020,14,2988,205,9,7183,2,32,9,0,2,2,2,0,2,0,False,False,False,0,1,2020-12-14T12:58:32.45,2,,0.0
2020,14,2988,220,9,322,2,2,10,5,20,15,11,9,11,0,False,False,False,0,2,2020-12-14T17:57:29.29,20,,9.0
2020,14,2988,235,9,322,2,5,5,13,13,0,13,0,13,0,False,False,False,0,3,2020-12-14T17:57:45.877,13,,0.0
2020,14,2988,240,9,6436,13,26,10,5,0,0,0,0,0,0,False,False,False,0,3,2020-12-17T22:41:11.84,0,,0.0
2020,14,2988,250,9,7816,2,5,5,11,14,3,13,1,13,0,True,False,False,0,3,2020-12-14T17:58:04.29,14,,1.0
2020,14,2988,255,9,6436,2,4,3,12,12,0,12,0,12,0,False,False,False,0,2,2020-12-14T17:58:15.813,12,,0.0
2020,14,2988,265,9,322,2,17,10,11,11,0,11,0,11,6,True,False,False,0,3,2020-12-17T22:41:11.84,11,,0.0
2020,14,2988,295,7,6985,2,47,5,2,7,5,5,2,5,0,False,False,False,0,1,2020-12-14T13:39:36.62,7,,2.0
2020,14,2988,300,7,4341,2,4,5,5,9,4,7,2,7,0,False,False,False,0,2,2020-12-14T17:58:56.83,9,,2.0
2020,14,2988,310,7,3521,13,6,7,15,0,0,0,0,0,0,False,False,False,0,3,2021-03-09T17:43:29.013,0,,0.0
2020,14,2988,315,7,910,2,2,9,10,10,0,10,0,10,0,False,False,False,0,2,2020-12-14T17:59:15.17,10,,0.0
2020,14,2988,335,7,6985,2,48,3,-5,0,5,-6,6,-6,0,False,False,False,2,1,2021-03-03T19:43:38.227,0,,6.0
2020,14,2988,345,7,6975,2,39,4,4,6,2,5,1,5,0,False,False,False,0,4,2020-12-14T13:59:45.31,6,,1.0
2020,14,2988,355,7,910,2,4,3,5,10,5,9,1,9,0,False,False,False,1,2,2020-12-14T17:59:28.457,10,,1.0
2020,14,2988,360,7,910,13,29,3,5,0,0,0,0,0,0,False,False,False,0,2,2021-02-25T16:30:40.09,0,,0.0
2020,14,2988,365,7,3521,13,36,10,5,0,0,0,0,0,0,True,False,False,0,3,2021-02-25T16:33:53.463,0,,0.0
2020,14,2988,375,7,910,2,2,9,5,5,0,5,0,5,6,False,False,False,0,2,2020-12-14T14:09:10.78,5,,0.0
2020,14,2988,405,9,2568,2,5,9,6,11,5,10,1,10,0,False,False,False,0,3,2020-12-14T18:00:10.803,11,,1.0
2020,14,2988,420,9,6446,2,5,3,12,14,2,12,2,12,0,False,False,False,0,4,2020-12-14T18:00:22.707,14,,2.0
2020,14,2988,430,9,6436,13,13,10,2,0,0,0,0,0,0,False,False,False,0,3,2020-12-17T23:52:39.39,0,,0.0
2020,14,2988,435,9,322,13,47,5,2,0,0,0,0,0,0,False,False,False,0,3,2020-12-14T14:43:57.977,0,,0.0
2020,14,2988,465,7,931,2,4,5,3,4,1,3,1,3,0,False,False,False,0,2,2020-12-14T14:53:19.637,4,,1.0
2020,14,2988,470,7,931,2,48,10,-3,9,12,3,6,3,0,False,False,False,0,1,2020-12-14T14:57:19.317,9,,6.0
2020,14,2988,490,9,322,2,30,10,0,7,7,7,0,7,0,True,False,False,0,4,2020-12-17T23:42:15.767,7,,0.0
2020,14,2988,515,7,7659,2,5,5,4,3,-1,3,0,3,0,False,False,False,0,2,2020-12-17T23:42:40.147,3,,0.0
2020,14,2988,520,7,3521,2,34,4,-4,1,5,1,0,1,0,True,False,False,0,3,2020-12-17T23:42:53.93,1,,0.0
2020,14,2988,525,7,7659,2,13,4,2,7,5,4,3,4,0,True,False,False,0,3,2020-12-14T18:00:42.513,7,,3.0
2020,14,2988,535,7,7659,3,2,10,6,0,0,0,0,0,0,False,False,False,0,2,2020-12-17T23:43:24.507,0,,0.0
2020,14,2988,540,7,931,2,47,5,1,2,1,2,0,2,0,False,False,False,0,1,2020-12-14T15:37:43.593,2,,0.0
2020,14,2988,550,9,6446,2,47,10,4,15,11,14,1,14,0,False,False,False,0,4,2020-12-17T23:44:01.41,15,,1.0
2020,14,2988,555,9,4202,2,5,5,2,7,5,7,0,7,0,False,False,False,0,1,2020-12-14T17:39:37.363,7,,0.0
2020,14,2988,565,9,6436,13,8,7,18,0,0,0,0,0,0,False,False,False,0,2,2020-12-14T15:49:54.99,0,,0.0
2020,14,2988,600,7,7659,3,30,10,0,0,0,0,0,0,0,False,False,False,0,3,2020-12-15T17:45:11.3,0,,0.0
2020,14,2988,605,7,910,2,5,10,5,5,0,5,0,5,0,False,False,False,0,2,2020-12-14T16:20:21.153,5,,0.0
2020,14,2988,620,7,7659,2,2,9,4,18,14,12,6,12,0,False,False,False,0,2,2020-12-17T23:52:51.347,18,,6.0
2020,14,2988,625,7,4455,2,47,5,1,4,3,4,0,4,0,False,False,False,0,1,2020-12-14T16:28:12.81,4,,0.0
2020,14,2988,635,7,910,2,5,2,16,16,0,16,0,16,0,False,False,False,0,3,2020-12-14T18:01:34.927,16,,0.0
2020,14,2988,645,7,6975,2,46,3,0,9,9,2,7,2,0,True,False,False,1,4,2020-12-14T18:01:52.423,9,,7.0
2020,14,2988,655,7,4455,2,48,10,-4,5,9,2,3,2,0,False,False,False,1,1,2020-12-14T16:48:30.287,5,,3.0
2020,14,2988,665,7,6975,13,11,3,1,0,0,0,0,0,0,False,False,False,0,4,2021-02-25T16:31:59.387,0,,0.0
2020,14,2988,670,7,3521,13,7,3,10,0,0,0,0,0,0,False,False,False,0,3,2020-12-14T16:54:33.113,0,,0.0
2020,14,2988,685,9,322,13,6,10,-1,0,0,0,0,0,0,False,False,False,0,2,2020-12-14T17:00:58.357,0,,
2020,14,2988,690,9,7816,2,8,8,22,32,10,22,10,22,0,False,False,False,2,3,2020-12-17T22:41:11.84,32,,10.0
2020,14,2988,695,9,6436,13,29,6,26,0,0,0,0,0,0,False,False,False,0,2,2021-03-09T17:44:50.99,0,,0.0
2020,14,2988,735,7,3521,2,4,9,4,5,1,5,0,5,0,False,False,False,0,3,2020-12-17T23:46:03.257,5,,0.0
2020,14,2988,745,7,3521,13,17,1,20,0,0,0,0,0,0,False,False,False,0,3,2020-12-17T22:54:23.673,0,,0.0
2020,14,2988,770,9,7183,2,47,5,0,7,7,7,0,7,6,False,False,False,0,1,2020-12-14T17:31:46.743,7,,0.0
2020,14,2989,15,11,6810,3,4,9,3,0,0,0,0,0,0,True,False,False,0,3,2021-02-22T20:17:31.833,0,,0.0
2020,14,2989,20,11,917,2,6,7,19,21,2,21,0,21,0,False,False,False,0,3,2021-02-23T16:20:11.74,21,,0.0
2020,14,2989,25,11,100,2,39,4,5,5,0,5,0,5,0,False,False,False,0,3,2020-12-14T10:55:04.543,5,,0.0
2020,14,2989,35,11,914,2,4,9,6,8,2,7,1,7,0,False,False,False,0,3,2021-02-22T20:21:49.097,8,,1.0
2020,14,2989,45,11,917,2,2,4,8,16,8,16,0,16,0,False,False,False,0,3,2021-02-22T20:23:25.407,16,,0.0
2020,14,2989,50,11,100,2,46,3,3,15,12,13,2,13,0,False,False,False,0,3,2020-12-14T11:06:58.027,15,,2.0
2020,14,2989,60,11,6810,2,55,4,-2,1,3,1,0,1,6,False,False,False,0,4,2020-12-17T19:22:49.99,1,,0.0
2020,14,2989,75,12,556,2,18,5,0,4,4,2,2,2,0,False,False,False,0,3,2021-02-22T20:28:40.297,4,,2.0
2020,14,2989,80,12,6356,2,12,10,14,15,1,14,1,14,0,False,False,False,0,3,2021-02-23T16:20:51.893,15,,1.0
2020,14,2989,85,12,556,2,29,5,13,56,43,56,0,56,6,False,False,False,2,2,2020-12-17T19:34:29.6,56,,0.0
2020,14,2989,100,11,914,13,35,2,24,0,0,0,0,0,0,False,False,False,0,3,2020-12-14T11:28:10.02,0,,0.0
2020,14,2989,110,11,6810,2,32,5,3,4,1,4,0,4,0,True,False,False,0,4,2020-12-15T17:46:26.557,4,,0.0
2020,14,2989,120,12,6357,2,30,3,-5,10,15,10,0,10,0,True,False,False,0,4,2021-02-23T16:22:24.523,10,,0.0
2020,14,2989,130,12,957,2,45,10,-5,3,8,3,0,3,0,True,False,False,0,2,2021-02-23T16:22:52.967,3,,0.0
2020,14,2989,160,12,957,2,51,9,-4,5,9,5,0,5,0,True,False,False,0,1,2021-02-23T16:24:22.063,5,,0.0
2020,14,2989,165,12,556,2,2,4,6,12,6,8,4,8,0,False,False,False,0,3,2020-12-14T11:52:51.92,12,,4.0
2020,14,2989,180,12,6357,2,29,5,13,14,1,14,0,14,6,False,False,False,0,2,2020-12-15T16:56:31.377,14,,0.0
2020,14,2989,205,11,6810,2,5,3,14,16,2,16,0,16,0,False,False,False,0,4,2020-12-14T12:10:00.463,16,,0.0
2020,14,2989,235,12,6357,2,5,3,7,11,4,11,0,11,0,False,False,False,0,2,2020-12-14T12:18:59.063,11,,0.0
2020,14,2989,255,12,556,2,4,3,5,4,-1,4,0,4,0,False,False,False,0,2,2020-12-14T12:25:49.237,4,,0.0
2020,14,2989,265,12,6691,13,5,3,12,0,0,0,0,0,0,False,False,False,0,2,2020-12-14T12:28:15.827,0,,0.0
2020,14,2989,280,11,7732,2,48,10,-4,17,21,15,2,15,0,False,False,False,0,1,2020-12-17T19:35:30.163,17,,2.0
2020,14,2989,285,11,914,13,23,7,48,0,0,0,0,0,0,False,False,False,0,3,2021-02-22T21:11:07.403,0,,
2020,14,2989,290,11,7733,2,5,3,5,8,3,7,1,7,0,False,False,False,1,3,2020-12-14T12:38:55.1,8,,1.0
2020,14,2989,305,11,792,2,48,3,-9,23,32,17,6,17,0,False,False,False,1,1,2020-12-14T12:43:49.967,23,,6.0
2020,14,2989,310,11,6341,2,48,9,-7,10,17,8,2,8,0,False,False,False,1,1,2020-12-17T19:35:43.76,10,,2.0
2020,14,2989,320,11,6810,2,6,4,10,10,0,10,0,10,0,False,False,False,0,4,2020-12-14T12:49:13.197,10,,0.0
2020,14,2989,335,11,6810,2,5,3,13,13,0,13,0,13,0,False,False,False,0,4,2020-12-17T14:16:16.707,13,,
2020,14,2989,340,11,6810,13,8,1,16,0,0,0,0,0,0,False,False,False,0,4,2020-12-14T12:56:18.477,0,,0.0
2020,14,2989,345,11,100,2,42,4,2,10,8,2,8,2,0,False,False,False,1,3,2020-12-14T12:59:02.763,10,,8.0
2020,14,2989,380,12,4511,2,4,5,7,8,1,8,0,8,0,False,False,False,0,2,2020-12-14T13:05:44.65,8,,0.0
2020,14,2989,390,12,556,13,12,5,9,0,0,0,0,0,0,False,False,False,0,2,2020-12-14T13:08:46.383,0,,0.0
2020,14,2989,395,12,4511,2,5,5,6,7,1,7,0,7,0,False,False,False,0,2,2020-12-17T19:34:12.303,7,,0.0
2020,14,2989,400,12,4537,13,12,5,11,0,0,0,0,0,0,False,False,False,0,1,2020-12-17T14:16:55.62,0,,0.0
2020,14,2989,410,11,100,2,5,3,10,15,5,13,2,13,0,False,False,False,0,3,2020-12-17T14:17:18.53,15,,2.0
2020,14,2989,420,11,7733,2,2,9,6,8,2,8,0,8,0,False,False,False,0,3,2020-12-14T13:17:09.757,8,,0.0
2020,14,2989,430,11,100,2,4,4,12,16,4,14,2,14,0,False,False,False,0,3,2020-12-14T13:19:11.697,16,,2.0
2020,14,2989,450,11,7733,13,17,8,55,0,0,0,0,0,0,False,False,False,0,3,2021-02-25T16:37:37.99,0,,
2020,14,2989,470,12,556,13,6,7,15,0,0,0,0,0,0,False,False,False,0,2,2021-02-23T16:27:38.897,0,,0.0
2020,14,2989,475,12,556,2,13,3,-2,3,5,3,0,3,0,False,False,False,0,3,2021-02-22T21:48:51.437,3,,0.0
2020,14,2989,480,12,6357,13,9,2,36,0,0,0,0,0,0,False,False,False,0,3,2020-12-17T14:09:45.977,0,,
2020,14,2989,490,12,6691,2,13,10,5,14,9,14,0,14,0,True,False,False,0,3,2021-02-23T16:28:19.25,14,,0.0
2020,14,2989,495,12,6357,2,35,5,13,14,1,13,1,13,0,False,False,False,0,3,2021-02-23T16:28:59.267,14,,1.0
2020,14,2989,510,12,4537,2,45,5,-3,-1,2,-2,1,-2,0,False,False,False,0,1,2020-12-14T14:31:08.7,-1,,1.0
2020,14,2989,515,12,4537,2,44,3,-4,7,11,6,1,6,0,True,False,False,0,1,2020-12-14T14:31:16.853,7,,1.0
2020,14,2989,520,12,6357,2,4,1,18,21,3,21,0,21,0,False,False,False,1,3,2021-02-22T21:57:11.533,21,,0.0
2020,14,2989,530,12,467,2,13,9,6,6,0,6,0,6,0,False,False,False,0,4,2020-12-14T14:31:36.967,6,,0.0
2020,14,2989,535,12,6691,2,47,5,5,5,0,5,0,5,0,False,False,False,0,3,2020-12-14T14:31:48.37,5,,0.0
2020,14,2989,565,11,6810,2,30,10,-1,-1,0,-1,0,-1,0,True,False,False,0,4,2020-12-14T14:32:03.35,-1,,0.0
2020,14,2989,570,11,100,2,49,5,-3,5,8,5,0,5,0,False,False,False,0,2,2021-02-22T22:11:37.527,5,,0.0
2020,14,2989,575,11,914,13,26,9,4,0,0,0,0,0,0,False,False,False,0,3,2021-02-22T22:12:33.613,0,,0.0
2020,14,2989,585,12,6357,2,4,5,9,15,6,9,6,9,0,False,False,False,0,2,2020-12-17T19:35:58.983,15,,6.0
2020,14,2989,600,12,4511,2,13,4,8,11,3,8,3,8,0,False,False,False,0,3,2021-02-22T22:17:51.29,11,,3.0
2020,14,2989,645,12,4511,2,38,3,4,4,0,4,0,4,6,False,False,False,0,4,2020-12-17T20:01:00.843,4,,0.0
2020,14,2989,660,11,7732,2,45,5,-5,6,11,4,2,4,0,False,False,False,1,1,2020-12-14T14:44:16.97,6,,2.0
2020,14,2989,670,11,914,13,4,9,12,0,0,0,0,0,0,False,False,False,0,2,2020-12-14T14:48:38.197,0,,0.0
2020,14,2989,675,11,6810,13,54,9,-1,0,0,0,0,0,0,False,False,False,0,4,2021-02-23T16:32:58.13,0,,0.0
2020,14,2989,680,11,914,2,6,9,12,12,0,12,0,12,0,False,False,False,0,2,2020-12-14T14:53:25.617,12,,0.0
2020,14,2989,685,11,7733,3,4,7,15,0,0,0,0,0,0,False,False,False,0,2,2021-02-23T16:35:27.753,0,,
2020,14,2989,695,11,100,13,35,9,13,0,0,0,0,0,0,False,False,False,0,3,2021-02-22T22:45:34.983,0,,0.0
2020,14,2989,700,11,6810,13,12,2,26,0,0,0,0,0,0,False,False,False,0,3,2021-02-22T22:47:37.453,0,,
2020,14,2989,710,11,914,13,21,6,34,0,0,0,0,0,0,False,False,False,0,2,2020-12-14T15:04:25.79,0,,0.0
2020,14,2989,715,11,6810,2,35,10,9,13,4,13,0,13,0,False,False,False,0,4,2021-02-23T16:36:01.09,13,,0.0
2020,14,2989,720,11,100,13,12,5,11,0,0,0,0,0,0,False,False,False,0,3,2021-02-23T16:36:28.037,0,,
2020,14,2989,725,11,7732,2,47,5,2,2,0,2,0,2,0,False,False,False,0,1,2021-02-22T22:51:09.393,2,,0.0
2020,14,2989,730,11,4487,2,5,5,5,4,-1,5,-1,5,0,True,False,False,0,3,2020-12-14T15:13:11.687,4,,-1.0
2020,14,2989,755,12,556,2,5,3,7,7,0,7,0,7,0,False,False,False,0,2,2020-12-14T15:21:13.973,7,,0.0
2020,14,2989,765,12,556,2,18,10,-1,29,30,4,25,4,0,False,False,False,1,3,2020-12-17T19:31:43.04,29,,25.0
2020,14,2989,780,12,556,13,19,6,34,0,0,0,0,0,0,False,False,False,0,2,2021-02-23T16:36:52.903,0,,0.0
2020,14,2989,805,11,7732,2,48,9,-5,1,6,-1,2,-1,0,False,False,False,0,1,2020-12-14T15:36:30.767,1,,2.0
2020,14,2989,810,11,6810,3,5,3,5,0,0,0,0,0,0,False,False,False,0,3,2020-12-14T15:38:15.78,0,,0.0
2020,14,2989,815,11,914,2,35,6,22,23,1,23,0,23,0,False,False,False,0,3,2020-12-14T15:40:44.153,23,,0.0
2020,14,2989,820,11,7732,13,16,9,5,0,0,0,0,0,0,False,False,False,0,1,2020-12-14T15:42:46.393,0,,0.0
2020,14,2989,825,11,914,2,2,10,4,5,1,4,1,4,0,False,False,False,0,2,2021-02-22T23:12:27.957,5,,1.0
2020,14,2989,840,11,6810,13,6,4,11,0,0,0,0,0,0,False,False,False,0,3,2020-12-14T15:48:02.737,0,,0.0
2020,14,2989,875,12,4511,2,30,10,0,6,6,6,0,6,0,False,False,False,1,4,2021-02-23T16:37:17.41,6,,0.0
2020,14,2990,10,15,8099,2,46,3,0,9,9,8,1,8,0,False,False,False,1,1,2020-12-14T11:14:44.483,9,,1.0
2020,14,2990,20,15,4997,2,5,9,7,9,2,9,0,9,0,False,False,False,0,3,2020-12-14T11:24:14.32,9,,0.0
2020,14,2990,30,15,4997,2,50,5,0,4,4,3,1,3,0,False,False,False,0,2,2020-12-17T18:30:14.433,4,,1.0
2020,14,2990,35,15,7591,2,2,4,8,11,3,9,2,9,0,True,False,False,0,3,2020-12-14T11:38:31.747,11,,2.0
2020,14,2990,50,15,922,2,51,10,-1,4,5,3,1,3,0,False,False,False,0,3,2020-12-17T18:31:22.11,4,,1.0
2020,14,2990,70,31,2865,2,30,10,1,13,12,13,0,13,0,False,False,False,0,1,2020-12-17T18:26:03.64,13,,0.0
2020,14,2990,75,31,6793,2,21,2,37,37,0,0,37,0,6,False,False,False,0,3,2020-12-14T12:02:43.953,37,,37.0
2020,14,2990,90,15,7591,2,6,4,13,22,9,20,2,20,0,False,False,False,0,3,2020-12-17T15:27:21.41,22,,2.0
2020,14,2990,100,15,7592,13,5,3,7,0,0,0,0,0,0,False,False,False,0,2,2020-12-14T12:15:19.487,0,,0.0
2020,14,2990,130,31,6793,3,5,5,6,0,0,0,0,0,0,False,False,False,0,2,2020-12-17T18:42:34.1,0,,0.0
2020,14,2990,140,31,5096,2,4,4,6,11,5,8,3,8,0,False,False,False,0,3,2020-12-17T18:35:02.58,11,,3.0
2020,14,2990,155,31,6793,13,5,5,11,0,0,0,0,0,0,False,False,False,0,3,2020-12-14T12:56:00.4,0,,0.0
2020,14,2990,170,15,4702,2,32,3,3,4,1,4,0,4,0,False,False,False,0,4,2020-12-14T13:00:50.7,4,,0.0
2020,14,2990,175,15,7591,13,2,9,4,0,0,0,0,0,0,True,False,False,0,3,2020-12-17T15:55:59.627,0,,0.0
2020,14,2990,185,31,3504,2,48,9,-3,25,28,13,12,13,0,False,False,False,2,1,2021-03-03T20:08:01.67,1,,12.0
2020,14,2990,190,31,6793,2,5,3,4,6,2,5,1,5,0,False,False,False,0,3,2020-12-14T13:16:45.44,6,,1.0
2020,14,2990,195,31,3504,2,45,10,-5,6,11,2,4,2,0,False,False,False,1,1,2021-03-03T20:13:24.48,6,,4.0
2020,14,2990,205,31,6793,2,17,10,13,17,4,15,2,15,0,False,False,False,0,3,2020-12-14T13:24:16.693,17,,2.0
2020,14,2990,225,31,6793,2,3,3,13,13,0,13,0,13,0,False,False,False,0,3,2020-12-17T15:27:21.427,13,,0.0
2020,14,2990,245,31,6724,2,39,4,5,5,0,5,0,5,0,False,False,False,0,3,2020-12-14T13:47:43.927,5,,0.0
2020,14,2990,250,31,5080,2,2,5,6,10,4,9,1,9,0,False,False,False,0,2,2020-12-14T13:50:07.17,10,,1.0
2020,14,2990,265,15,4997,2,39,4,7,9,2,9,0,9,0,False,False,False,0,3,2020-12-14T13:58:41.337,9,,0.0
2020,14,2990,275,15,7591,2,13,9,4,6,2,6,0,6,0,True,False,False,0,3,2020-12-14T14:05:22.37,6,,0.0
2020,14,2990,280,15,7591,2,49,5,-2,2,4,1,1,1,0,False,False,False,0,2,2020-12-14T14:07:38.177,2,,1.0
2020,14,2990,285,15,4997,13,17,1,27,0,0,0,0,0,0,False,False,False,0,3,2020-12-14T14:10:21.94,0,,0.0
2020,14,2990,290,15,6501,2,13,10,5,5,0,5,0,5,0,False,False,False,0,3,2020-12-14T14:14:00.833,5,,0.0
2020,14,2990,295,15,6501,13,6,10,10,0,0,0,0,0,0,False,False,False,0,2,2020-12-14T14:16:31.727,0,,0.0
2020,14,2990,315,31,5080,2,50,9,0,5,5,4,1,4,0,False,True,True,0,3,2020-12-14T14:24:29.507,5,,1.0
2020,14,2990,320,15,4997,2,4,9,5,5,0,5,0,5,0,False,False,False,0,3,2020-12-14T14:27:48.17,5,,0.0
2020,14,2990,325,15,6501,13,9,6,30,0,0,0,0,0,0,False,False,False,0,2,2020-12-17T15:56:12.57,0,,0.0
2020,14,2990,330,15,7591,13,4,5,9,0,0,0,0,0,0,False,False,False,0,2,2021-03-17T19:54:34.823,0,,0.0
2020,14,2990,385,15,4997,3,7,8,19,0,0,0,0,0,0,False,False,False,0,3,2020-12-17T18:36:00.323,0,,0.0
2020,14,2990,390,15,7591,2,50,10,-2,-5,-3,-3,-2,-3,0,False,False,False,2,3,2020-12-17T18:29:01.707,-5,,-2.0
2020,14,2990,410,31,5080,2,5,2,19,19,0,0,19,0,0,False,False,False,0,2,2020-12-17T18:36:37.817,19,,19.0
2020,14,2990,415,31,5096,2,2,10,6,9,3,9,0,9,0,False,False,False,0,3,2020-12-14T15:08:01.577,9,,0.0
2020,14,2990,435,31,6793,2,3,3,13,13,0,13,0,13,0,False,False,False,0,3,2020-12-17T15:56:26.253,13,,0.0
2020,14,2990,445,31,6793,2,4,3,4,9,5,6,3,6,0,False,False,False,0,2,2021-02-23T13:38:33.097,9,,3.0
2020,14,2990,455,31,2865,2,5,3,5,5,0,0,5,0,6,False,False,False,0,3,2020-12-14T15:27:15.71,5,,5.0
2020,14,2990,475,15,6501,13,8,8,31,0,0,0,0,0,0,False,False,False,0,2,2021-03-05T15:02:01.267,0,,0.0
2020,14,2990,490,31,6793,2,2,10,8,17,9,13,4,13,0,False,False,False,0,2,2020-12-14T19:08:47.843,17,,4.0
2020,14,2990,500,31,2865,2,7,5,14,16,2,15,1,15,0,False,False,False,0,4,2020-12-17T18:26:54.067,16,,1.0
2020,14,2990,525,15,8099,2,47,5,-4,2,6,-1,3,-1,0,False,False,False,0,1,2020-12-14T16:17:15.84,2,,3.0
2020,14,2990,530,15,4997,13,2,10,5,0,0,0,0,0,0,False,False,False,0,3,2020-12-17T18:42:59.897,0,,0.0
2020,14,2990,535,15,4997,2,12,5,7,13,6,13,0,13,0,False,False,False,0,3,2021-03-09T13:03:09.157,13,,0.0
2020,14,2990,550,15,2757,2,32,10,1,10,9,10,0,10,0,False,False,False,0,4,2020-12-14T16:29:00.08,10,,0.0
2020,14,2990,570,15,922,2,9,2,16,18,2,16,2,16,0,False,False,False,0,2,2020-12-14T16:46:37.487,18,,2.0
2020,14,2990,575,15,4997,2,26,9,3,5,2,5,0,5,6,False,False,False,0,3,2020-12-14T16:45:49.767,5,,0.0
2020,14,2990,615,31,7913,13,5,3,3,0,0,0,0,0,0,False,False,False,0,3,2020-12-14T17:00:32.42,0,,0.0
2020,14,2990,640,15,8099,2,4,9,-1,1,2,0,1,0,0,False,False,False,0,1,2020-12-17T15:27:21.427,1,,1.0
2020,14,2990,645,15,7591,2,5,3,13,13,0,13,0,13,0,False,False,False,0,3,2020-12-14T17:11:45.357,13,,0.0
2020,14,2990,650,15,6501,13,35,7,17,0,0,0,0,0,0,False,False,False,0,3,2020-12-14T17:14:35.19,0,,0.0
2020,14,2990,665,15,6501,13,9,3,14,0,0,0,0,0,0,False,False,False,0,2,2020-12-17T18:43:23.923,0,,0.0
2020,14,2990,675,15,6501,13,7,5,14,0,0,0,0,0,0,False,False,False,0,3,2020-12-14T17:28:44.38,0,,0.0
2020,14,2990,680,15,7591,13,9,5,14,0,0,0,0,0,0,False,False,False,0,2,2020-12-17T15:57:01.803,0,,0.0
2020,14,2990,690,31,4037,13,22,7,33,0,0,0,0,0,0,False,False,False,0,2,2020-12-14T17:36:21.543,0,,0.0
2020,14,2990,725,31,4545,2,48,10,-6,0,6,0,0,0,0,False,False,False,0,1,2020-12-17T18:45:13.76,0,,0.0
2020,14,2990,740,15,2757,2,4,10,4,4,0,4,0,4,0,False,False,False,0,4,2020-12-14T17:55:20.143,4,,0.0
2020,14,2990,745,15,6501,2,6,9,4,11,7,8,3,8,0,False,False,False,0,2,2020-12-14T17:57:07.193,11,,3.0
2020,14,2990,750,15,4997,2,17,8,20,22,2,22,0,22,0,False,False,False,0,3,2020-12-14T17:58:53.987,22,,0.0
2020,14,2990,755,15,6501,13,5,3,7,0,0,0,0,0,0,False,False,False,0,2,2020-12-14T18:00:49.047,0,,0.0
2020,14,2990,760,15,8099,2,48,10,-3,26,29,22,4,22,0,False,False,False,0,1,2020-12-14T18:03:36.59,4,,4.0
2020,14,2990,765,15,7592,2,35,8,17,27,10,25,2,25,0,False,False,False,0,3,2020-12-14T18:07:20.573,27,,2.0
2020,14,2990,770,15,4886,2,5,10,2,12,10,12,0,12,0,False,False,False,0,1,2020-12-14T18:13:04.433,12,,0.0
2020,14,2990,775,15,4997,13,17,7,19,0,0,0,0,0,0,False,False,False,0,3,2020-12-14T18:12:52.48,0,,0.0
2020,14,2990,780,15,7591,13,5,2,19,0,0,0,0,0,0,False,False,False,0,2,2021-03-17T19:55:29.557,0,,0.0
2020,14,2990,785,15,7591,13,7,6,19,0,0,0,0,0,0,False,False,False,0,3,2021-04-01T19:39:19.917,0,,0.0
2020,14,2990,790,15,4997,13,7,6,19,0,0,0,0,0,0,False,False,False,0,3,2020-12-17T18:46:37.903,0,,0.0
2020,14,2990,845,15,7361,2,45,5,1,12,11,8,4,8,0,False,False,False,0,1,2020-12-17T15:27:21.427,12,,4.0
2020,14,2990,850,15,7361,2,5,5,4,12,8,4,8,4,0,False,False,False,1,1,2020-12-14T18:39:08.7,12,,8.0
2020,14,2990,855,15,7592,2,50,5,-1,6,7,2,4,2,0,False,False,False,0,2,2021-03-04T18:16:01.187,6,,4.0
2020,14,2990,860,15,4997,13,24,3,12,0,0,0,0,0,0,False,False,False,0,3,2020-12-14T19:09:21.687,0,,
2020,14,2990,865,15,7361,2,45,5,-4,-2,2,-3,1,-3,0,False,False,False,1,1,2020-12-14T18:49:30.533,-2,,1.0
2020,14,2990,870,15,7361,2,28,4,5,8,3,8,0,8,0,False,False,False,0,1,2020-12-14T18:51:17.353,8,,0.0
2020,14,2991,10,17,2253,13,3,6,17,0,0,0,0,0,0,False,False,False,0,2,2020-12-14T11:23:47.277,0,,0.0
2020,14,2991,20,17,4305,3,6,1,19,0,0,0,0,0,0,False,False,False,0,3,2021-02-23T14:02:26.55,0,,0.0
2020,14,2991,45,16,7681,2,44,3,-3,1,4,1,0,1,0,True,False,False,2,1,2020-12-17T20:32:13.13,1,,0.0
2020,14,2991,50,16,7681,2,11,3,3,16,13,15,1,15,0,False,False,False,0,1,2020-12-17T20:32:27.627,16,,1.0
2020,14,2991,55,16,374,2,5,2,16,17,1,17,0,17,0,False,False,False,0,4,2020-12-14T11:45:41.62,17,,0.0
2020,14,2991,70,16,374,13,53,5,4,0,0,0,0,0,0,False,False,False,0,4,2021-03-05T15:04:38.513,0,,0.0
2020,14,2991,80,17,4484,2,46,3,0,16,16,14,2,14,0,False,False,False,0,4,2020-12-17T21:07:37.777,16,,2.0
2020,14,2991,85,17,3516,13,12,6,19,0,0,0,0,0,0,False,False,False,0,1,2020-12-14T23:42:07.77,0,,0.0
2020,14,2991,95,17,7687,13,2,4,6,0,0,0,0,0,0,True,False,False,0,3,2020-12-14T12:02:41.72,0,,0.0
2020,14,2991,110,16,374,2,2,10,5,7,2,6,1,6,0,False,False,False,0,3,2020-12-14T12:10:04.18,7,,1.0
2020,14,2991,135,17,6274,2,5,5,12,14,2,12,2,12,0,False,False,False,0,3,2021-02-23T14:05:00.96,14,,2.0
2020,14,2991,150,17,4305,2,2,10,4,18,14,13,5,13,0,False,False,False,1,3,2020-12-17T20:32:46.727,18,,5.0
2020,14,2991,155,17,6274,2,31,9,4,7,3,7,0,7,6,False,False,False,0,4,2020-12-14T12:28:41.3,7,,0.0
2020,14,2991,170,16,121,2,6,1,16,37,21,35,2,35,0,False,False,False,1,2,2020-12-17T19:15:55.827,37,,2.0
2020,14,2991,175,16,7681,13,4,10,7,0,0,0,0,0,0,False,False,False,0,1,2021-03-05T15:05:57.573,0,,0.0
2020,14,2991,190,17,3516,2,4,9,2,7,5,6,1,6,0,False,False,False,0,1,2020-12-14T12:37:46.263,7,,1.0
2020,14,2991,200,17,6274,2,4,9,9,16,7,13,3,13,0,False,False,False,0,3,2020-12-14T12:40:55.727,16,,
2020,14,2991,205,17,3516,13,48,3,-3,0,0,0,0,0,0,False,False,False,0,1,2020-12-14T12:43:55.927,0,,0.0
2020,14,2991,210,17,4383,2,47,5,2,10,8,9,1,9,0,False,False,False,0,4,2020-12-15T21:20:26.177,10,,1.0
2020,14,2991,215,17,7687,2,5,3,4,14,10,11,3,11,0,False,False,False,1,3,2020-12-17T19:16:43.757,14,,3.0
2020,14,2991,225,17,4305,2,6,10,3,2,-1,2,0,2,0,False,False,False,0,2,2020-12-14T13:12:57.607,2,,0.0
2020,14,2991,230,17,2253,3,7,5,13,0,0,0,0,0,0,False,False,False,0,3,2021-02-23T14:06:01.26,0,,0.0
2020,14,2991,245,16,374,2,35,9,12,21,9,19,2,19,0,True,False,False,0,3,2020-12-14T13:06:39.89,21,,2.0
2020,14,2991,250,16,374,2,46,3,0,9,9,6,3,6,0,True,False,False,0,4,2020-12-14T13:03:50.247,9,,3.0
2020,14,2991,255,16,4143,2,5,5,7,13,6,13,0,13,0,False,False,False,0,3,2020-12-17T20:33:15.85,13,,0.0
2020,14,2991,275,17,2253,13,2,9,9,0,0,0,0,0,0,False,False,False,0,2,2020-12-14T13:14:48.743,0,,
2020,14,2991,310,16,3938,3,4,1,15,0,0,0,0,0,0,False,False,False,0,3,2020-12-17T16:55:48.43,0,,0.0
2020,14,2991,320,17,4305,2,34,4,-4,12,16,8,4,8,0,True,False,False,0,3,2020-12-14T13:33:17.21,12,,4.0
2020,14,2991,330,17,6442,13,4,9,10,0,0,0,0,0,0,False,False,False,0,2,2020-12-17T20:53:00.75,0,,0.0
2020,14,2991,335,17,4305,13,17,7,42,0,0,0,0,0,0,False,False,False,1,3,2021-03-05T15:07:08.433,0,,0.0
2020,14,2991,340,16,34,13,5,5,4,0,0,0,0,0,0,False,False,False,0,1,2020-12-14T13:42:51.977,0,,0.0
2020,14,2991,345,16,374,2,31,10,5,16,11,14,2,14,0,True,False,False,0,4,2021-02-23T14:07:03.593,16,,2.0
2020,14,2991,350,16,2035,3,12,10,9,0,0,0,0,0,0,False,False,False,0,1,2021-03-09T13:07:29.71,0,,0.0
2020,14,2991,355,16,34,2,2,4,5,9,4,7,2,7,0,True,False,False,0,3,2020-12-14T13:50:19.197,9,,2.0
2020,14,2991,370,16,34,2,45,5,-1,5,6,2,3,2,0,True,False,False,0,1,2020-12-14T13:54:24.61,5,,3.0
2020,14,2991,380,16,121,2,13,10,7,15,8,14,1,14,0,False,False,False,0,2,2020-12-14T13:56:39.937,15,,1.0
2020,14,2991,390,16,121,3,3,3,6,0,0,0,0,0,0,False,False,False,0,2,2020-12-14T17:43:07.653,0,,0.0
2020,14,2991,395,16,374,2,5,5,6,6,0,6,0,6,6,False,False,False,0,3,2021-03-08T15:28:27.827,6,,0.0
2020,14,2991,410,17,7687,2,5,6,16,16,0,16,0,16,0,False,False,False,0,3,2020-12-14T14:02:18.353,16,,0.0
2020,14,2991,420,17,4383,2,2,9,10,9,-1,9,0,9,0,True,False,False,0,2,2020-12-17T21:07:54.393,9,,0.0
2020,14,2991,445,16,7681,2,46,3,2,26,24,6,20,6,0,False,False,False,2,1,2020-12-17T20:43:32.61,26,,20.0
2020,14,2991,455,16,3938,2,23,1,43,44,1,44,0,44,6,False,False,False,0,3,2021-02-23T14:08:02.673,44,,0.0
2020,14,2991,475,17,6442,13,2,5,5,0,0,0,0,0,0,False,False,False,0,2,2021-02-25T16:43:54.13,0,,0.0
2020,14,2991,480,17,4383,13,13,4,2,0,0,0,0,0,0,True,False,False,0,3,2020-12-17T19:19:22.2,0,,0.0
2020,14,2991,505,17,6276,2,2,3,4,10,6,6,4,6,0,False,False,False,0,2,2020-12-17T20:44:27.933,10,,4.0
2020,14,2991,510,17,6274,13,5,5,11,0,0,0,0,0,0,False,False,False,0,4,2020-12-14T14:40:02.543,0,,0.0
2020,14,2991,515,17,3516,2,2,9,5,10,5,6,4,6,0,False,False,False,0,3,2020-12-14T14:41:55.29,10,,4.0
2020,14,2991,525,17,4484,3,2,9,9,0,0,0,0,0,0,False,False,False,0,4,2021-02-23T14:09:18.47,0,,0.0
2020,14,2991,555,16,374,2,35,10,14,28,14,22,6,22,0,True,False,False,0,3,2020-12-17T20:54:38.683,28,,6.0
2020,14,2991,565,16,7176,2,51,10,-3,26,29,16,10,16,0,False,True,True,1,3,2020-12-17T20:55:50.877,26,,10.0
2020,14,2991,570,17,7687,2,34,4,-4,-1,3,-2,1,-2,0,True,False,False,0,3,2020-12-17T20:31:10.687,-1,,1.0
2020,14,2991,595,16,7176,2,51,10,-2,5,7,3,2,3,0,False,False,False,0,3,2020-12-17T20:31:41.42,5,,2.0
2020,14,2991,600,16,3938,13,7,6,33,0,0,0,0,0,0,False,False,False,0,3,2020-12-14T15:16:11.91,0,,0.0
2020,14,2991,620,17,4383,13,2,10,7,0,0,0,0,0,0,False,False,False,0,2,2020-12-14T15:20:52.05,0,,0.0
2020,14,2991,625,17,7687,2,5,3,6,11,5,9,2,9,0,False,False,False,0,3,2020-12-14T15:23:54.77,11,,2.0
2020,14,2991,630,17,7687,2,4,4,6,11,5,9,2,9,0,False,False,False,0,4,2020-12-17T21:08:10.09,11,,2.0
2020,14,2991,640,17,7687,13,9,6,18,0,0,0,0,0,0,False,False,False,0,3,2020-12-14T15:30:02.307,0,,0.0
2020,14,2991,655,16,3938,3,35,5,13,0,0,0,0,0,0,False,False,False,0,3,2020-12-14T15:34:38.193,0,,0.0
2020,14,2991,665,16,374,2,19,2,27,32,5,27,5,27,0,False,False,False,0,3,2020-12-14T15:38:23.023,32,,5.0
2020,14,2991,675,16,374,13,5,5,10,0,0,0,0,0,0,True,False,False,0,3,2020-12-17T19:21:32.127,0,,0.0
2020,14,2991,680,16,3938,2,17,4,11,13,2,12,1,12,0,False,False,False,0,3,2020-12-17T20:58:36.427,13,,1.0
2020,14,2991,695,16,3938,13,7,2,22,0,0,0,0,0,0,False,False,False,0,3,2020-12-17T16:55:48.43,0,,0.0
2020,14,2991,700,17,4383,13,7,6,15,0,0,0,0,0,0,False,False,False,0,3,2020-12-14T16:00:20.34,0,,0.0
2020,14,2991,705,17,6274,2,2,9,8,13,5,11,2,11,0,False,False,False,0,3,2020-12-14T17:44:01.53,13,,2.0
2020,14,2991,710,17,7634,2,2,10,3,5,2,4,1,4,0,False,False,False,0,2,2020-12-14T16:04:11.243,5,,1.0
2020,14,2991,715,17,4383,2,19,7,20,23,3,20,3,20,0,False,False,False,0,2,2021-02-23T14:10:57.573,23,,3.0
2020,14,2991,720,17,4484,2,47,5,1,10,9,6,4,6,0,False,False,False,0,3,2020-12-17T20:45:05.113,10,,4.0
2020,14,2991,725,17,6274,2,17,1,28,29,1,29,0,29,6,False,False,False,0,3,2020-12-14T16:10:53.543,29,,0.0
2020,14,2991,745,16,7681,2,50,5,-2,5,7,3,2,3,0,False,False,False,0,2,2020-12-14T16:14:50.457,5,,2.0
2020,14,2991,765,17,6274,2,46,3,1,2,1,2,0,2,0,False,False,False,0,3,2020-12-17T16:55:48.43,2,,0.0
2020,14,2991,775,17,4383,2,2,9,3,6,3,3,3,3,0,False,False,False,0,2,2020-12-17T19:23:53.693,6,,3.0
2020,14,2991,780,17,7687,2,2,4,4,9,5,4,5,4,0,False,False,False,0,3,2020-12-14T16:30:01.983,9,,5.0
2020,14,2991,785,17,4383,13,17,7,24,0,0,0,0,0,0,False,False,False,0,3,2020-12-17T19:24:43.13,0,,0.0
2020,14,2991,790,17,6276,2,6,9,9,9,0,9,0,9,0,False,False,False,0,3,2020-12-14T16:35:19.133,9,,0.0
2020,14,2991,800,17,7634,13,19,2,35,0,0,0,0,0,0,False,False,False,0,2,2020-12-14T16:39:22.783,0,,0.0
2020,14,2991,805,17,4383,2,6,10,11,18,7,17,1,17,0,False,False,False,0,2,2020-12-14T16:41:54.593,18,,1.0
2020,14,2991,815,17,7051,2,2,10,2,4,2,3,1,3,0,False,False,False,0,2,2020-12-14T16:44:41.697,4,,1.0
2020,14,2991,825,17,7051,2,2,9,3,4,1,4,0,4,0,False,False,False,0,2,2020-12-14T16:49:29.273,4,,
2020,14,2991,830,17,4484,13,9,3,4,0,0,0,0,0,0,False,False,False,0,3,2020-12-14T16:51:55.767,0,,
2020,14,2991,840,17,4484,13,33,4,1,0,0,0,0,0,0,False,False,False,0,4,2021-02-23T14:14:21.763,0,,
2020,14,2991,865,16,7681,2,18,3,-1,11,12,8,3,8,0,True,False,False,0,2,2020-12-15T18:55:28.91,11,,3.0
2020,14,2991,880,16,7176,2,49,3,-1,9,10,8,1,8,0,False,False,False,1,2,2020-12-14T17:10:04.353,9,,1.0
2020,14,2991,900,16,3938,2,51,5,0,22,22,17,5,17,0,False,False,False,0,3,2020-12-17T16:55:48.447,22,,5.0
2020,14,2991,940,17,6276,13,2,10,14,0,0,0,0,0,0,False,False,False,0,3,2020-12-17T19:26:41.697,0,,0.0
2020,14,2991,945,17,4383,13,19,2,25,0,0,0,0,0,0,False,False,False,0,2,2020-12-14T17:25:26.777,0,,
2020,14,2991,950,17,7687,2,8,1,22,22,0,22,0,22,0,False,False,False,0,3,2020-12-17T19:27:31.373,22,,0.0
2020,14,2992,10,21,7090,2,2,9,7,13,6,9,4,9,0,False,False,False,0,2,2021-02-23T20:42:56.19,13,,4
2020,14,2992,25,21,7090,13,4,9,6,0,0,0,0,0,0,False,False,False,0,2,2020-12-14T11:35:09.883,0,,0
2020,14,2992,40,1,6405,2,55,10,-4,5,9,5,0,5,0,False,False,False,0,3,2020-12-17T17:23:51.98,5,,0
2020,14,2992,50,1,7316,13,12,5,1,0,0,0,0,0,0,False,False,False,0,2,2021-02-23T16:49:39.017,0,,0
2020,14,2992,60,21,7226,2,13,10,4,6,2,5,1,5,0,False,False,False,0,4,2020-12-15T23:04:26.437,6,,1
2020,14,2992,65,21,7090,13,2,10,7,0,0,0,0,0,0,False,False,False,0,2,2020-12-14T12:07:42.983,0,,0
2020,14,2992,75,1,6406,2,50,9,-3,5,8,1,4,1,0,True,False,False,0,3,2021-02-23T16:53:34.117,5,,4
2020,14,2992,80,1,245,2,4,9,8,15,7,15,0,15,0,False,False,False,0,3,2020-12-17T17:42:28.27,15,,0
2020,14,2992,90,1,6405,13,12,3,3,0,0,0,0,0,0,False,False,False,0,3,2021-03-09T13:09:59.9,0,,0
2020,14,2992,115,21,7090,2,4,9,8,7,-1,8,-1,8,0,False,False,False,1,3,2021-03-03T20:23:38.683,7,,-1
2020,14,2992,125,21,7090,13,12,2,16,0,0,0,0,0,0,True,False,False,0,2,2020-12-15T23:11:30.94,0,,0
2020,14,2992,140,1,245,2,4,9,11,17,6,10,7,10,0,False,False,False,3,2,2021-03-03T20:24:57.91,17,,7
2020,14,2992,160,1,6406,2,45,5,-3,1,4,0,1,0,0,True,False,False,0,1,2020-12-14T13:15:57.597,1,,1
2020,14,2992,165,1,245,13,29,6,19,0,0,0,0,0,0,False,False,False,0,2,2020-12-14T19:10:27.213,0,,0
2020,14,2992,190,21,4422,13,38,10,5,0,0,0,0,0,0,False,False,False,0,3,2020-12-14T13:29:05.913,0,,0
2020,14,2992,205,1,5152,13,5,5,10,0,0,0,0,0,0,True,False,False,0,4,2021-02-23T19:43:02.99,0,,0
2020,14,2992,210,1,6406,2,28,10,1,8,7,7,1,7,0,False,False,False,0,1,2020-12-14T13:50:22.523,8,,1
2020,14,2992,230,1,5152,2,6,9,13,20,7,19,1,19,0,False,False,False,0,3,2020-12-14T14:00:49.27,20,,1
2020,14,2992,240,1,6406,13,44,3,-3,0,0,0,0,0,0,False,False,False,0,1,2020-12-14T14:05:45.64,0,,0
2020,14,2992,255,1,245,2,50,9,1,1,0,1,0,1,0,False,False,False,0,2,2021-02-23T17:42:22.167,1,,0
2020,14,2992,290,1,5152,2,8,4,7,7,0,7,0,7,6,False,False,False,0,3,2021-02-23T17:50:05.853,7,,0
2020,14,2992,305,21,576,13,17,8,31,0,0,0,0,0,0,False,False,False,0,3,2021-03-15T18:38:56.95,0,,0
2020,14,2992,315,21,7090,2,4,3,11,11,0,11,0,11,0,False,False,False,0,2,2020-12-17T17:58:59.867,11,,0
2020,14,2992,325,21,4405,2,4,3,3,3,0,3,0,3,0,False,False,False,0,2,2020-12-14T14:51:29.953,3,,0
2020,14,2992,330,21,7090,13,9,6,21,0,0,0,0,0,0,False,False,False,0,3,2020-12-14T14:57:15.59,0,,0
2020,14,2992,340,1,6405,2,44,3,-1,2,3,2,0,2,0,True,False,False,0,2,2020-12-14T15:02:09.093,2,,0
2020,14,2992,345,1,245,2,5,3,12,12,0,12,0,12,0,False,False,False,0,2,2020-12-14T15:04:49.43,12,,0
2020,14,2992,355,1,245,2,12,1,18,24,6,23,1,23,0,False,False,False,0,3,2021-02-23T19:46:51.863,24,,1
2020,14,2992,360,1,2416,2,4,10,5,9,4,6,3,6,0,False,False,False,0,3,2020-12-14T15:14:27.373,9,,3
2020,14,2992,375,1,5152,3,29,2,26,0,0,0,0,0,0,False,False,False,0,3,2021-02-23T18:05:34.957,0,,0
2020,14,2992,385,21,3680,2,2,10,4,4,0,4,0,4,0,False,False,False,0,2,2020-12-14T15:28:59.27,4,,0
2020,14,2992,420,1,7316,2,5,5,9,9,0,9,0,9,0,False,False,False,0,3,2020-12-14T15:42:15.997,9,,0
2020,14,2992,450,1,6405,2,13,10,7,7,0,7,0,7,0,False,False,False,0,3,2021-02-23T19:47:27.143,7,,0
2020,14,2992,460,1,245,2,39,4,3,4,1,4,0,4,0,False,False,False,0,3,2021-02-23T18:21:20.557,4,,0
2020,14,2992,500,1,2416,2,32,10,1,8,7,5,3,5,0,False,False,False,0,4,2020-12-17T15:02:28.177,8,,3
2020,14,2992,525,21,4405,2,11,5,4,10,6,7,3,7,0,False,False,False,0,1,2020-12-15T23:12:07.533,10,,3
2020,14,2992,540,21,4405,2,44,3,-4,3,7,3,0,3,0,False,False,False,0,1,2020-12-14T16:46:19.833,3,,0
2020,14,2992,545,21,576,2,17,8,39,39,0,39,0,39,0,False,False,False,0,3,2020-12-14T16:50:12.753,39,,0
2020,14,2992,570,1,4307,2,28,4,2,10,8,8,2,8,0,False,False,False,0,1,2020-12-14T17:02:02.287,10,,2
2020,14,2992,580,1,525,2,4,10,8,13,5,11,2,11,0,False,False,False,0,3,2020-12-14T17:05:56.44,13,,2
2020,14,2992,590,1,525,2,51,5,-3,-3,0,-3,0,-3,0,False,False,False,0,3,2021-02-23T18:43:17.27,-3,,0
2020,14,2992,595,1,525,13,12,3,2,0,0,0,0,0,0,False,False,False,0,2,2020-12-14T17:16:45.64,0,,0
2020,14,2992,605,21,3680,13,4,9,3,0,0,0,0,0,0,False,False,False,0,3,2020-12-14T17:20:07.597,0,,0
2020,14,2992,615,21,3680,13,9,2,21,0,0,0,0,0,0,False,False,False,0,3,2021-02-23T18:46:47.58,0,,0
2020,14,2992,655,1,245,13,13,10,5,0,0,0,0,0,0,False,False,False,0,2,2021-03-02T13:30:23.95,0,,0
2020,14,2992,660,1,6406,2,31,10,-1,7,8,5,2,5,0,False,False,False,0,1,2020-12-14T17:51:53.85,7,,2
2020,14,2992,680,21,3680,2,3,5,7,7,0,7,0,7,0,False,False,False,0,2,2020-12-14T17:58:44.787,7,,0
2020,14,2992,700,1,245,2,35,6,18,41,23,41,0,41,0,False,False,False,0,3,2020-12-14T18:06:13.377,41,,0
2020,14,2992,735,21,3680,2,6,8,21,24,3,24,0,24,0,False,False,False,0,2,2020-12-15T23:04:48.66,24,,0
2020,14,2992,745,21,4405,13,28,5,4,0,0,0,0,0,0,False,False,False,0,1,2021-02-23T19:50:32.723,0,,0
2020,14,2992,760,21,4422,13,4,4,14,0,0,0,0,0,0,False,False,False,0,3,2021-01-12T23:53:50.883,0,,0
2020,14,2992,780,1,245,2,50,3,-2,11,13,9,2,9,0,False,False,False,1,2,2020-12-14T18:32:07.08,11,,2
2020,14,2992,790,1,245,2,2,4,5,11,6,9,2,9,0,False,False,False,1,3,2020-12-17T17:25:28.88,11,,2
2020,14,2992,840,21,4422,2,46,3,3,4,1,4,0,4,0,False,False,False,0,3,2020-12-15T23:05:10.81,4,,0
2020,14,2992,850,21,7090,13,9,6,25,0,0,0,0,0,0,False,False,False,0,2,2021-04-02T13:23:32.783,0,,0
2020,14,2992,855,21,4422,2,13,4,2,14,12,14,0,14,0,False,False,False,0,3,2020-12-14T18:52:21.503,14,,0
2020,14,2993,40,18,4572,2,45,5,-6,3,9,3,0,3,0,False,False,False,0,1,2020-12-15T17:54:24.34,3,,0.0
2020,14,2993,60,30,4516,2,2,9,5,9,4,6,3,6,0,False,False,False,0,2,2020-12-14T11:44:05.78,9,,3.0
2020,14,2993,75,30,63,13,7,6,25,0,0,0,0,0,0,False,False,False,0,4,2020-12-14T11:50:24.237,0,,0.0
2020,14,2993,85,18,1381,2,8,4,12,15,3,14,1,14,0,False,False,False,0,3,2020-12-14T11:54:26.19,15,,1.0
2020,14,2993,105,18,1381,2,3,6,15,15,0,15,0,15,0,False,False,False,0,2,2020-12-14T12:27:24.86,15,,0.0
2020,14,2993,115,18,6361,2,32,10,0,2,2,2,0,2,0,False,False,False,0,4,2021-02-22T19:28:09.357,2,,0.0
2020,14,2993,120,18,6706,13,5,3,7,0,0,0,0,0,0,True,False,False,0,3,2020-12-14T12:33:51.053,0,,
2020,14,2993,145,18,566,2,44,3,-4,6,10,5,1,5,0,False,False,False,1,1,2020-12-14T12:45:32.223,6,,1.0
2020,14,2993,180,30,793,13,4,9,4,0,0,0,0,0,0,False,False,False,0,3,2020-12-17T21:23:24.43,0,,0.0
2020,14,2993,185,30,4516,13,6,1,18,0,0,0,0,0,0,False,False,False,0,2,2020-12-14T13:08:06.163,0,,0.0
2020,14,2993,195,18,7711,2,4,9,7,17,10,8,9,8,0,False,False,False,1,3,2020-12-17T22:07:22.437,17,,9.0
2020,14,2993,205,18,6358,2,44,3,-3,4,7,3,1,3,0,False,False,False,0,1,2020-12-15T17:54:56.747,4,,1.0
2020,14,2993,210,18,7711,2,50,10,-3,5,8,0,5,0,0,False,False,False,1,3,2020-12-17T21:52:50.433,5,,5.0
2020,14,2993,215,18,1381,13,9,5,14,0,0,0,0,0,0,False,False,False,0,2,2020-12-15T17:55:08.547,0,,0.0
2020,14,2993,235,30,793,2,6,8,16,20,4,18,2,18,0,False,False,False,0,2,2020-12-17T21:23:24.43,20,,2.0
2020,14,2993,250,30,7268,2,8,1,48,48,0,48,0,48,6,True,False,False,0,2,2020-12-15T16:49:28.413,48,,0.0
2020,14,2993,265,18,6361,2,53,10,-4,15,19,12,3,12,0,False,False,False,0,4,2020-12-15T17:55:21.5,15,,3.0
2020,14,2993,275,18,6907,2,32,3,4,15,11,11,4,11,0,False,False,False,0,4,2020-12-17T21:53:36.187,15,,4.0
2020,14,2993,285,18,7711,13,20,6,31,0,0,0,0,0,0,False,False,False,0,2,2020-12-17T21:23:24.43,0,,0.0
2020,14,2993,300,18,7711,13,22,5,14,0,0,0,0,0,0,False,False,False,0,2,2020-12-17T21:23:24.43,0,,0.0
2020,14,2993,315,30,4516,2,35,4,12,16,4,13,3,13,0,False,False,False,0,4,2020-12-17T21:45:56.773,16,,3.0
2020,14,2993,325,30,37,2,50,10,-1,6,7,4,2,4,0,False,False,False,0,2,2020-12-14T14:51:00.503,6,,2.0
2020,14,2993,340,30,6414,13,5,4,2,0,0,0,0,0,0,False,False,False,0,1,2021-03-17T19:57:31.517,0,,0.0
2020,14,2993,345,30,6414,2,47,10,0,4,4,3,1,3,0,False,False,False,0,1,2020-12-14T15:01:03.82,4,,1.0
2020,14,2993,350,30,119,2,51,9,-4,3,7,-3,6,-3,0,False,False,False,1,1,2020-12-17T22:19:42.237,3,,6.0
2020,14,2993,365,30,793,13,29,3,6,0,0,0,0,0,0,False,False,False,0,3,2021-03-05T15:09:16.34,0,,
2020,14,2993,385,18,6706,13,4,10,6,0,0,0,0,0,0,False,False,False,0,3,2021-02-22T19:29:27.427,0,,0.0
2020,14,2993,400,18,7711,13,13,10,3,0,0,0,0,0,0,False,False,False,0,2,2020-12-17T21:23:24.43,0,,0.0
2020,14,2993,410,30,2290,2,4,10,9,9,0,9,0,9,0,False,False,False,0,3,2020-12-17T22:18:53.047,9,,0.0
2020,14,2993,420,30,37,2,13,4,4,16,12,14,2,14,0,False,False,False,0,2,2020-12-14T15:45:27.65,16,,2.0
2020,14,2993,435,30,63,13,19,2,47,0,0,0,0,0,0,False,False,False,0,3,2020-12-17T21:45:24.947,0,,
2020,14,2993,460,30,793,2,2,9,7,7,0,7,0,7,0,False,False,False,0,2,2020-12-14T16:45:34.917,7,,0.0
2020,14,2993,485,30,793,2,24,6,29,29,0,29,0,29,0,False,False,False,0,2,2020-12-14T16:54:24.897,29,,0.0
2020,14,2993,495,30,63,2,47,10,2,2,0,2,0,2,6,False,False,False,0,4,2021-02-22T19:30:23.097,2,,0.0
2020,14,2993,510,18,4572,3,48,10,-4,0,0,0,0,0,0,False,False,False,0,1,2020-12-17T21:45:06.663,0,,0.0
2020,14,2993,520,18,6361,2,12,3,14,14,0,14,0,14,0,True,False,False,0,4,2020-12-15T17:53:56.46,14,,0.0
2020,14,2993,525,18,4152,2,47,5,2,8,6,7,1,7,0,False,False,False,0,1,2020-12-17T22:08:02.72,8,,1.0
2020,14,2993,535,18,4152,2,47,10,2,9,7,5,4,5,0,True,False,False,0,1,2020-12-17T22:08:19.407,9,,4.0
2020,14,2993,540,18,4152,2,32,9,2,5,3,2,3,2,0,False,False,False,1,4,2020-12-17T22:19:15.553,5,,3.0
2020,14,2993,575,18,4572,2,48,9,-4,5,9,0,5,0,0,False,False,False,1,1,2020-12-17T22:00:55.817,5,,5.0
2020,14,2993,585,18,6361,2,6,4,7,7,0,7,0,7,0,False,False,False,0,4,2020-12-14T18:03:38.02,7,,0.0
2020,14,2993,595,18,6907,2,13,10,7,14,7,12,2,12,6,False,False,False,0,4,2020-12-17T22:09:41.403,14,,2.0
2020,14,2993,615,30,793,3,4,3,7,0,0,0,0,0,0,False,False,False,0,2,2021-03-02T15:48:36.913,0,,0.0
2020,14,2993,620,30,37,2,13,9,3,11,8,8,3,8,0,False,False,False,1,3,2020-12-14T18:18:32.233,11,,3.0
2020,14,2993,625,30,7268,13,5,10,4,0,0,0,0,0,0,False,False,False,0,3,2020-12-14T18:20:10.39,0,,0.0
2020,14,2993,635,18,6907,2,17,7,23,25,2,24,1,24,0,False,False,False,0,4,2020-12-14T18:24:21.953,25,,1.0
2020,14,2993,655,18,6907,2,5,3,9,9,0,9,0,9,0,False,False,False,0,4,2020-12-14T18:32:57.423,9,,0.0
2020,14,2993,660,18,6361,2,32,10,-3,2,5,0,2,0,0,False,False,False,0,4,2021-02-22T19:33:29.697,2,,2.0
2020,14,2993,705,30,4498,13,6,4,13,0,0,0,0,0,0,False,False,False,0,3,2021-02-22T19:34:15.457,0,,0.0
2020,14,2993,710,30,37,2,4,3,10,10,0,10,0,10,0,False,False,False,0,2,2021-02-22T19:36:00.073,10,,0.0
2020,14,2993,730,30,37,2,50,10,-2,6,8,2,4,2,0,False,False,False,1,2,2020-12-17T22:11:01.73,6,,4.0
2020,14,2993,745,18,4572,13,48,10,-3,0,0,0,0,0,0,True,False,False,0,1,2020-12-14T19:21:33.92,0,,0.0
2020,14,2993,750,18,7711,13,12,8,23,0,0,0,0,0,0,False,False,False,0,2,2021-03-09T13:11:59.46,0,,0.0
2020,14,2993,755,18,566,2,4,4,4,4,0,4,0,4,0,False,False,False,0,1,2020-12-17T21:44:09.087,4,,0.0
2020,14,2993,760,18,7711,2,6,9,12,12,0,12,0,12,0,False,False,False,0,3,2020-12-14T19:23:00.03,12,,0.0
2020,14,2993,765,18,7711,2,4,5,5,5,0,5,0,5,0,False,False,False,0,2,2021-02-22T19:37:07.49,5,,0.0
2020,14,2993,770,18,6706,3,2,4,6,0,0,0,0,0,0,False,False,False,0,3,2020-12-14T19:25:49.563,0,,0.0
2020,14,2993,775,18,6706,13,13,10,3,0,0,0,0,0,0,False,False,False,0,3,2020-12-17T21:43:54.423,0,,0.0
2020,14,2993,785,18,1381,2,13,9,5,9,4,6,3,6,0,False,False,False,0,3,2020-12-17T22:11:24.437,9,,3.0
2020,14,2993,800,18,3506,13,17,8,48,0,0,0,0,0,0,False,False,False,0,3,2020-12-14T19:34:48.863,0,,0.0
2020,14,2994,10,14,895,13,39,4,4,0,0,0,0,0,0,True,False,False,0,3,2020-12-14T17:05:30.64,0,,
2020,14,2994,35,14,7582,2,46,3,0,20,20,15,5,15,0,False,False,False,0,1,2020-12-15T16:46:14.253,20,,5.0
2020,14,2994,50,14,6543,2,5,5,1,3,2,2,1,2,0,False,False,False,0,1,2020-12-17T14:24:35.46,3,,1.0
2020,14,2994,60,14,6546,2,48,10,-4,4,8,2,2,2,0,False,False,False,0,1,2020-12-14T11:33:49.38,4,,2.0
2020,14,2994,80,23,2256,3,6,1,15,0,0,0,0,0,0,False,False,False,0,3,2021-02-23T13:54:22.383,0,,0.0
2020,14,2994,85,23,7246,13,12,5,4,0,0,0,0,0,0,False,False,False,0,4,2020-12-14T11:56:03.08,0,,0.0
2020,14,2994,100,14,6543,2,5,5,4,4,0,4,0,4,0,False,False,False,0,3,2020-12-15T16:46:42.937,4,,0.0
2020,14,2994,105,14,7584,2,13,9,4,19,15,19,0,19,0,True,False,False,0,3,2020-12-14T12:05:21.337,19,,0.0
2020,14,2994,115,14,7584,13,50,3,0,0,0,0,0,0,0,False,False,False,0,2,2020-12-14T12:11:31.61,0,,0.0
2020,14,2994,125,14,1114,2,5,2,17,17,0,17,0,17,0,False,False,False,0,2,2020-12-17T18:51:43.683,17,,0.0
2020,14,2994,135,14,7584,13,2,9,3,0,0,0,0,0,0,False,False,False,0,2,2020-12-14T12:18:41.777,0,,0.0
2020,14,2994,145,14,1114,2,7,3,7,7,0,7,0,7,6,False,False,False,0,3,2021-02-25T16:53:13.963,7,,0.0
2020,14,2994,165,23,7688,2,45,5,3,6,3,5,1,5,0,True,False,False,0,3,2020-12-17T18:54:30.293,6,,1.0
2020,14,2994,170,23,2994,2,51,5,-3,4,7,2,2,2,0,True,False,False,0,4,2020-12-17T18:23:50.1,4,,2.0
2020,14,2994,180,23,7246,2,17,7,19,47,28,20,27,20,6,False,False,False,1,4,2020-12-14T17:11:16.837,47,,27.0
2020,14,2994,195,14,1119,2,6,9,14,28,14,23,5,23,0,False,False,False,0,4,2020-12-17T18:55:15.65,28,,5.0
2020,14,2994,210,14,1114,13,17,8,37,0,0,0,0,0,0,False,False,False,0,3,2020-12-14T13:01:16.167,0,,0.0
2020,14,2994,215,14,4070,13,6,7,20,0,0,0,0,0,0,False,False,False,0,2,2021-03-17T19:59:57.51,0,,0.0
2020,14,2994,235,23,2994,2,51,5,0,7,7,0,7,0,0,False,False,False,1,4,2020-12-17T14:26:44.14,7,,7.0
2020,14,2994,240,23,7250,3,51,3,0,0,0,0,0,0,0,False,False,False,0,3,2020-12-14T13:11:18.193,0,,0.0
2020,14,2994,245,23,2256,2,24,2,27,36,9,34,2,34,0,False,False,False,0,2,2020-12-14T13:13:26.863,36,,2.0
2020,14,2994,255,23,7241,2,4,4,4,8,4,6,2,6,0,False,False,False,0,1,2021-02-23T13:55:27.28,8,,2.0
2020,14,2994,265,23,2256,2,17,1,18,21,3,21,0,21,6,False,False,False,0,3,2020-12-14T13:19:36.577,21,,0.0
2020,14,2994,285,14,7584,2,6,7,17,23,6,19,4,19,0,False,False,False,0,2,2020-12-17T14:27:08.87,23,,4.0
2020,14,2994,290,14,1114,2,8,7,37,41,4,41,0,41,6,False,False,False,0,3,2021-02-23T13:55:58.39,41,,0.0
2020,14,2994,305,23,7241,2,12,9,3,3,0,3,0,3,0,False,False,False,0,1,2020-12-17T18:19:56.753,3,,0.0
2020,14,2994,320,23,7250,2,6,4,6,7,1,6,1,6,0,True,False,False,0,3,2020-12-14T13:35:58.587,7,,1.0
2020,14,2994,325,23,7688,2,13,9,2,6,4,4,2,4,0,False,False,False,0,3,2020-12-14T13:37:35.5,6,,2.0
2020,14,2994,335,23,2994,2,13,3,5,29,24,21,8,21,0,False,False,False,0,3,2020-12-14T17:09:06.153,29,,8.0
2020,14,2994,350,23,2994,13,7,3,13,0,0,0,0,0,0,False,False,False,0,3,2021-03-05T15:11:08.517,0,,0.0
2020,14,2994,355,14,4449,13,6,6,18,0,0,0,0,0,0,False,False,False,0,3,2020-12-14T14:00:08.59,0,,0.0
2020,14,2994,360,14,7582,2,48,9,-6,-5,1,-5,0,-5,0,False,False,False,0,1,2020-12-14T14:01:48.1,-5,,0.0
2020,14,2994,370,14,5197,2,53,10,-2,9,11,6,3,6,0,False,False,False,0,4,2021-02-23T13:56:33.663,9,,3.0
2020,14,2994,390,14,1119,2,47,5,3,7,4,6,1,6,0,False,False,False,0,4,2020-12-17T18:22:21.777,7,,1.0
2020,14,2994,400,14,4449,2,35,8,19,27,8,19,8,19,0,False,False,False,2,3,2020-12-17T14:01:17.7,27,,8.0
2020,14,2994,410,14,895,13,32,5,2,0,0,0,0,0,0,False,False,False,0,3,2020-12-17T18:24:25.223,0,,0.0
2020,14,2994,415,14,1114,13,6,7,19,0,0,0,0,0,0,False,False,False,0,2,2021-02-23T13:57:06.267,0,,0.0
2020,14,2994,430,14,6543,2,32,10,-5,6,11,4,2,4,0,False,False,False,0,1,2020-12-14T14:19:06.76,6,,2.0
2020,14,2994,435,14,7584,13,6,4,4,0,0,0,0,0,0,False,False,False,0,3,2020-12-14T14:20:42.257,0,,0.0
2020,14,2994,460,23,2256,13,35,2,20,0,0,0,0,0,0,False,False,False,0,3,2020-12-17T18:20:07.533,0,,0.0
2020,14,2994,465,23,7241,13,12,3,9,0,0,0,0,0,0,False,False,False,0,1,2020-12-14T14:30:10.32,0,,0.0
2020,14,2994,470,23,7250,2,32,3,-1,10,11,9,1,9,0,False,False,False,0,3,2021-02-23T13:57:41.197,10,,1.0
2020,14,2994,480,23,2994,2,35,7,15,15,0,15,0,15,0,False,False,False,0,4,2020-12-14T14:44:45.393,15,,0.0
2020,14,2994,495,23,2994,13,29,2,17,0,0,0,0,0,0,False,False,False,0,2,2021-03-09T20:21:39.113,0,,0.0
2020,14,2994,500,23,2256,2,21,2,26,29,3,26,3,26,0,False,False,False,1,2,2020-12-14T14:53:25.423,29,,3.0
2020,14,2994,515,23,2256,13,2,10,7,0,0,0,0,0,0,False,False,False,0,2,2020-12-14T14:56:35.857,0,,0.0
2020,14,2994,530,14,6546,13,11,6,16,0,0,0,0,0,0,False,False,False,0,1,2020-12-14T15:01:55.667,0,,0.0
2020,14,2994,535,14,1119,2,39,4,6,9,3,7,2,7,0,False,False,False,0,4,2020-12-14T15:03:11.803,9,,2.0
2020,14,2994,570,23,7688,2,13,3,4,6,2,6,0,6,0,False,False,False,0,3,2020-12-14T15:13:47.147,6,,0.0
2020,14,2994,585,23,7241,2,28,9,0,14,14,9,5,9,0,False,False,False,1,1,2020-12-17T14:29:23.363,14,,5.0
2020,14,2994,590,23,2994,2,46,3,2,5,3,3,2,3,0,True,False,False,0,4,2021-02-23T13:58:16.5,5,,2.0
2020,14,2994,595,23,7250,2,4,9,5,8,3,5,3,5,0,False,False,False,1,4,2020-12-17T18:58:18.197,8,,3.0
2020,14,2994,600,23,7241,3,4,4,3,0,0,0,0,0,0,False,False,False,0,1,2020-12-17T19:03:59.22,0,,0.0
2020,14,2994,605,23,2256,2,4,5,3,9,6,7,2,7,0,False,False,False,1,2,2020-12-14T15:29:12.71,9,,2.0
2020,14,2994,615,23,7240,2,47,10,-1,0,1,0,0,0,0,False,False,False,0,1,2020-12-17T18:22:34.627,0,,0.0
2020,14,2994,620,23,2256,13,12,3,10,0,0,0,0,0,0,False,False,False,0,2,2020-12-17T18:25:39.5,0,,0.0
2020,14,2994,625,23,2256,2,5,5,5,5,0,5,0,5,0,False,False,False,0,3,2020-12-14T15:35:35.487,5,,0.0
2020,14,2994,650,14,1114,2,4,9,14,14,0,14,0,14,0,False,False,False,0,2,2020-12-14T15:41:13.12,14,,0.0
2020,14,2994,660,14,6543,2,5,3,4,4,0,2,2,2,0,False,False,False,0,3,2020-12-17T19:04:13.01,4,,2.0
2020,14,2994,665,14,1114,2,13,10,3,7,4,4,3,4,0,False,False,False,0,3,2020-12-17T14:02:45.887,7,,3.0
2020,14,2994,710,23,7250,2,49,9,-2,0,2,-1,1,-1,0,False,True,True,0,2,2020-12-14T15:57:19.617,0,,1.0
2020,14,2994,750,23,3843,2,4,10,5,11,6,9,2,9,0,False,False,False,0,1,2020-12-14T16:17:00.663,11,,2.0
2020,14,2994,755,23,3843,2,4,10,5,9,4,8,1,8,0,False,False,False,0,1,2020-12-14T16:17:11.8,9,,1.0
2020,14,2994,760,23,3843,2,45,5,-4,3,7,1,2,1,0,False,False,False,0,1,2020-12-14T16:17:42.737,3,,2.0
2020,14,2994,765,23,3843,3,31,10,2,0,0,0,0,0,0,False,False,False,0,1,2021-03-05T15:13:38.377,0,,0.0
2020,14,2994,785,23,3843,2,16,9,6,8,2,7,1,7,0,False,False,False,0,1,2020-12-17T14:03:50.317,8,,1.0
2020,14,2994,790,23,7250,2,4,4,12,13,1,13,0,13,0,False,False,False,0,3,2020-12-14T16:28:00.57,13,,0.0
2020,14,2994,795,23,3957,2,31,10,0,4,4,3,1,3,0,False,False,False,0,1,2020-12-14T16:29:16.047,4,,1.0
2020,14,2994,800,23,2994,13,17,7,29,0,0,0,0,0,0,False,False,False,0,3,2020-12-14T16:32:29.88,0,,0.0
2020,14,2994,805,23,2994,2,13,10,5,7,2,6,1,6,0,True,False,False,0,4,2020-12-17T14:04:44.18,7,,1.0
2020,14,2994,810,23,3957,2,32,5,2,3,1,2,1,2,0,False,False,False,0,1,2020-12-14T17:08:13.463,3,,1.0
2020,14,2994,825,23,3957,2,4,9,2,4,2,3,1,3,0,False,False,False,0,1,2020-12-14T16:43:58.897,4,,1.0
2020,14,2994,830,23,2994,2,4,3,7,8,1,7,1,7,0,False,False,False,0,4,2020-12-17T19:02:28.747,8,,1.0
2020,14,2994,835,23,7250,13,5,3,5,0,0,0,0,0,0,False,False,False,0,4,2020-12-14T16:47:18.313,0,,0.0
2020,14,2995,20,22,6262,2,5,10,9,9,0,9,0,9,0,False,False,False,0,4,2020-12-15T17:31:43.12,9,,0.0
2020,14,2995,30,22,256,2,4,6,15,17,2,15,2,15,0,False,False,False,0,2,2020-12-14T11:18:41.987,17,,2.0
2020,14,2995,45,22,256,3,6,9,14,0,0,0,0,0,0,False,False,False,0,3,2020-12-14T11:26:55.973,0,,0.0
2020,14,2995,65,27,7408,2,4,10,6,14,8,13,1,13,0,False,False,False,0,3,2020-12-17T18:18:22.59,14,,1.0
2020,14,2995,85,27,7852,2,12,8,19,19,0,19,0,19,6,False,False,False,0,3,2021-03-09T13:14:06.297,19,,0.0
2020,14,2995,100,22,3170,2,5,3,3,3,0,3,0,3,0,False,False,False,0,3,2020-12-14T11:43:26.103,3,,0.0
2020,14,2995,110,22,6270,13,8,7,29,0,0,0,0,0,0,False,False,False,0,2,2020-12-15T17:32:05.75,0,,0.0
2020,14,2995,125,27,6397,2,39,4,1,13,12,8,5,8,0,True,False,False,0,4,2020-12-17T18:08:40.91,13,,5.0
2020,14,2995,130,27,5050,3,48,10,-2,0,0,0,0,0,0,False,False,False,0,1,2020-12-14T11:53:37.393,0,,0.0
2020,14,2995,135,27,7408,13,24,6,37,0,0,0,0,0,0,False,False,False,0,2,2021-02-22T19:56:37.533,0,,0.0
2020,14,2995,140,22,6457,2,35,3,13,16,3,16,0,16,0,False,False,False,0,4,2020-12-17T18:53:51.043,16,,0.0
2020,14,2995,155,22,6270,13,6,4,13,0,0,0,0,0,0,False,False,False,0,2,2020-12-17T17:38:42.87,0,,0.0
2020,14,2995,165,27,650,2,30,9,-1,10,11,9,1,9,0,False,False,False,0,3,2020-12-14T12:15:17.783,10,,1.0
2020,14,2995,175,27,7408,13,4,3,12,0,0,0,0,0,0,False,False,False,0,2,2020-12-17T17:39:01.41,0,,0.0
2020,14,2995,185,27,650,2,4,10,6,15,9,15,0,15,0,False,False,False,0,3,2020-12-14T12:21:38.547,15,,0.0
2020,14,2995,210,27,7408,2,9,5,5,5,0,5,0,5,6,False,False,False,0,2,2020-12-14T12:29:56.237,5,,0.0
2020,14,2995,235,27,5050,2,28,4,3,9,6,7,2,7,0,False,False,False,0,1,2020-12-14T12:40:59.867,9,,2.0
2020,14,2995,265,22,6270,2,5,9,4,6,2,5,1,5,0,False,False,False,0,1,2020-12-14T12:57:42.787,6,,1.0
2020,14,2995,275,22,3170,13,9,2,18,0,0,0,0,0,0,False,False,False,0,3,2020-12-17T17:39:18.887,0,,0.0
2020,14,2995,280,22,256,3,2,9,9,0,0,0,0,0,0,False,False,False,0,3,2020-12-14T13:04:18.15,0,,0.0
2020,14,2995,290,27,5069,2,18,3,-2,3,5,1,2,1,0,False,False,False,0,2,2021-03-04T18:21:19.473,3,,2.0
2020,14,2995,300,27,5069,3,19,2,35,0,0,0,0,0,0,False,False,False,0,2,2020-12-17T18:53:51.043,0,,0.0
2020,14,2995,310,22,3170,13,13,4,-4,0,0,0,0,0,0,False,False,False,0,3,2020-12-17T17:39:38.29,0,,0.0
2020,14,2995,330,22,1113,2,48,9,-5,8,13,3,5,3,0,False,False,False,0,1,2020-12-17T18:21:56.487,8,,5.0
2020,14,2995,350,22,7118,2,12,4,14,14,0,14,0,14,0,False,False,False,0,3,2020-12-14T13:29:45.103,14,,0.0
2020,14,2995,365,22,256,13,9,2,23,0,0,0,0,0,0,True,False,False,0,2,2020-12-15T17:33:57.29,0,,0.0
2020,14,2995,375,27,7408,2,39,4,6,8,2,6,2,6,0,False,False,False,0,3,2020-12-14T13:40:23.603,8,,2.0
2020,14,2995,380,27,7408,2,4,3,5,6,1,5,1,5,0,False,False,False,0,2,2020-12-17T18:23:42.473,6,,1.0
2020,14,2995,390,27,5050,2,48,9,-4,9,13,4,5,4,0,False,False,False,0,1,2020-12-14T13:44:03.757,9,,5.0
2020,14,2995,395,27,5050,2,4,4,3,4,1,3,1,3,0,False,False,False,0,1,2020-12-17T17:40:13.68,4,,1.0
2020,14,2995,400,27,4835,2,12,2,19,20,1,20,0,20,0,False,False,False,0,3,2020-12-17T17:40:27.983,20,,0.0
2020,14,2995,410,27,7852,2,5,5,3,3,0,3,0,3,0,False,False,False,0,2,2020-12-14T13:50:42.033,3,,0.0
2020,14,2995,415,27,7408,2,4,9,4,9,5,6,3,6,0,False,False,False,0,3,2020-12-17T18:24:08.56,9,,3.0
2020,14,2995,440,22,256,2,4,5,6,6,0,6,0,6,0,False,False,False,0,2,2020-12-15T17:32:42.92,6,,0.0
2020,14,2995,450,22,6579,2,47,5,-2,5,7,5,0,5,0,False,False,False,0,1,2020-12-17T18:53:51.043,5,,0.0
2020,14,2995,455,22,6270,2,35,2,16,34,18,34,0,34,0,False,False,False,0,3,2020-12-17T17:41:53.843,34,,0.0
2020,14,2995,465,22,3170,2,5,5,4,4,0,4,0,4,0,False,False,False,0,3,2020-12-14T14:06:42.337,4,,0.0
2020,14,2995,490,27,650,2,4,10,4,7,3,7,0,7,0,False,False,False,0,3,2020-12-14T14:16:20.113,7,,0.0
2020,14,2995,495,27,5069,13,4,3,7,0,0,0,0,0,0,False,False,False,0,2,2020-12-14T14:19:04.747,0,,0.0
2020,14,2995,500,27,650,2,5,5,2,3,1,2,1,2,0,False,False,False,0,3,2020-12-14T14:20:52.867,3,,1.0
2020,14,2995,515,27,7408,13,19,2,25,0,0,0,0,0,0,False,False,False,0,2,2020-12-17T18:53:51.043,0,,
2020,14,2995,550,27,6397,2,30,10,-2,10,12,9,1,9,6,True,False,False,0,4,2020-12-17T18:00:56.88,10,,1.0
2020,14,2995,570,22,3170,13,2,4,6,0,0,0,0,0,0,False,False,False,0,3,2020-12-17T17:42:09.237,0,,0.0
2020,14,2995,585,27,5050,13,48,3,-2,0,0,0,0,0,0,False,False,False,0,1,2020-12-14T14:48:49.39,0,,0.0
2020,14,2995,600,27,650,2,6,4,14,17,3,17,0,17,0,False,False,False,0,3,2020-12-14T14:58:34.693,17,,0.0
2020,14,2995,605,27,7408,2,6,1,17,19,2,18,1,18,0,True,False,False,0,2,2020-12-17T18:54:49.713,19,,1.0
2020,14,2995,620,27,5069,2,6,10,3,3,0,3,0,3,6,False,False,False,0,2,2020-12-17T18:54:49.713,3,,0.0
2020,14,2995,635,22,7118,13,6,8,21,0,0,0,0,0,0,False,False,False,0,2,2020-12-14T15:08:28.197,0,,0.0
2020,14,2995,650,22,256,2,50,10,0,3,3,2,1,2,0,False,False,False,0,2,2020-12-14T15:11:37.31,3,,1.0
2020,14,2995,690,27,7852,13,4,9,10,0,0,0,0,0,0,False,False,False,0,3,2020-12-17T18:54:49.713,0,,0.0
2020,14,2995,705,22,6579,2,47,5,-2,-2,0,-2,0,-2,0,False,False,False,1,1,2020-12-14T15:25:54.44,-2,,0.0
2020,14,2995,730,27,7849,2,5,10,6,10,4,7,3,7,0,False,False,False,1,3,2020-12-17T17:01:19.99,10,,3.0
2020,14,2995,735,27,5069,2,4,5,8,14,6,13,1,13,0,False,False,False,0,2,2020-12-17T18:01:10.263,14,,1.0
2020,14,2995,740,27,7496,2,18,3,-1,3,4,2,1,2,0,False,False,False,0,2,2020-12-14T21:47:07.85,3,,1.0
2020,14,2995,760,27,7849,2,4,4,6,6,0,6,0,6,0,False,False,False,0,3,2020-12-14T15:44:34.47,6,,0.0
2020,14,2995,805,22,6270,2,5,5,9,9,0,9,0,9,0,False,False,False,0,2,2020-12-14T15:54:11.49,9,,0.0
2020,14,2996,15,2,6247,2,47,5,2,4,2,2,2,2,0,False,False,False,0,3,2020-12-14T11:24:11.953,4,,2.0
2020,14,2996,20,2,6247,13,9,6,27,0,0,0,0,0,0,False,False,False,0,3,2020-12-14T11:26:55.303,0,,0.0
2020,14,2996,30,26,4616,2,48,10,-3,9,12,6,3,6,0,False,False,False,1,1,2020-12-14T11:31:39.227,9,,3.0
2020,14,2996,45,26,309,2,4,10,4,6,2,6,0,6,0,False,False,False,0,3,2020-12-18T17:27:18.357,6,,0.0
2020,14,2996,75,26,4282,2,5,9,5,6,1,6,0,6,0,False,False,False,0,4,2020-12-18T17:27:18.357,6,,0.0
2020,14,2996,80,26,7514,2,4,5,5,5,0,5,0,5,0,False,False,False,0,2,2020-12-17T19:13:47.887,5,,0.0
2020,14,2996,95,26,309,2,5,3,6,6,0,6,0,6,0,False,False,False,0,3,2020-12-14T12:02:28.72,6,,0.0
2020,14,2996,105,26,309,2,5,5,10,10,0,10,0,10,6,False,False,False,0,3,2020-12-14T12:06:31.743,10,,0.0
2020,14,2996,120,2,990,2,5,9,3,8,5,6,2,6,0,False,False,False,0,1,2020-12-14T12:12:45.207,8,,2.0
2020,14,2996,130,2,990,2,28,10,2,4,2,2,2,2,0,False,False,False,0,1,2020-12-14T12:16:55.217,4,,2.0
2020,14,2996,145,2,5223,2,4,5,7,5,-2,5,0,5,0,False,False,False,0,2,2020-12-14T12:22:07.633,5,,0.0
2020,14,2996,150,2,5223,2,8,8,37,39,2,39,0,39,6,False,False,False,0,3,2020-12-15T16:10:17.72,39,,0.0
2020,14,2996,165,26,4616,2,31,9,1,16,15,14,2,14,0,False,False,False,0,1,2020-12-18T03:24:53.283,16,,2.0
2020,14,2996,180,26,309,13,2,10,8,0,0,0,0,0,0,False,False,False,0,2,2020-12-18T03:25:04.407,0,,0.0
2020,14,2996,185,26,7514,2,13,9,2,2,0,2,0,2,0,False,False,False,0,3,2020-12-14T12:52:58.823,2,,0.0
2020,14,2996,195,2,6247,2,2,9,7,35,28,12,23,12,0,False,False,False,2,3,2020-12-14T13:04:43.597,35,,23.0
2020,14,2996,200,2,5223,13,21,6,32,0,0,0,0,0,0,False,False,False,0,3,2020-12-18T17:27:18.357,0,,0.0
2020,14,2996,205,2,5214,2,42,9,5,7,2,5,2,5,0,False,False,False,0,3,2020-12-14T13:08:55.757,7,,2.0
2020,14,2996,210,2,6249,2,32,4,2,7,5,5,2,5,0,False,False,False,0,4,2020-12-18T16:09:51.333,7,,2.0
2020,14,2996,215,2,5214,13,5,3,5,0,0,0,0,0,0,True,False,False,0,3,2020-12-14T13:12:27.3,0,,0.0
2020,14,2996,240,26,4616,2,51,10,-5,3,8,1,2,1,0,True,False,False,0,3,2020-12-14T13:23:31.947,3,,2.0
2020,14,2996,250,26,4282,13,46,3,3,0,0,0,0,0,0,True,False,False,0,4,2020-12-14T13:26:21.203,0,,0.0
2020,14,2996,265,2,5223,2,5,2,26,32,6,28,4,28,0,False,False,False,0,2,2020-12-14T13:30:24.09,32,,4.0
2020,14,2996,270,2,2835,13,6,9,7,0,0,0,0,0,0,False,False,False,0,2,2021-02-25T16:57:35.183,0,,0.0
2020,14,2996,280,2,5223,2,35,7,15,19,4,18,1,18,0,False,False,False,0,3,2020-12-14T13:37:59.55,19,,1.0
2020,14,2996,300,2,4179,2,4,9,4,9,5,6,3,6,6,False,False,False,1,3,2021-03-03T20:45:06.067,9,,3.0
2020,14,2996,320,26,4282,2,4,9,3,4,1,3,1,3,0,False,False,False,0,3,2020-12-18T17:27:18.357,4,,1.0
2020,14,2996,330,26,7453,13,19,2,37,0,0,0,0,0,0,False,False,False,0,2,2020-12-14T13:56:26.997,0,,0.0
2020,14,2996,335,26,4616,2,48,3,-9,5,14,2,3,2,0,False,False,False,1,1,2020-12-14T13:58:14.49,5,,3.0
2020,14,2996,340,26,309,2,5,3,4,7,3,7,0,7,0,False,False,False,0,3,2020-12-14T14:00:01.163,7,,0.0
2020,14,2996,350,26,6301,2,47,5,0,9,9,7,2,7,0,False,False,False,0,1,2020-12-14T14:01:31.723,9,,2.0
2020,14,2996,360,26,4282,13,17,8,20,0,0,0,0,0,0,False,False,False,0,3,2020-12-14T14:04:45.67,0,,0.0
2020,14,2996,370,26,309,2,2,5,5,8,3,5,3,5,0,False,False,False,0,2,2020-12-18T03:36:04.817,8,,3.0
2020,14,2996,375,26,309,2,4,5,5,4,-1,4,0,4,0,False,False,False,0,2,2020-12-14T14:11:54.147,4,,0.0
2020,14,2996,380,26,7514,2,13,9,1,1,0,1,0,1,0,False,False,False,0,2,2020-12-14T14:13:26.573,1,,0.0
2020,14,2996,395,26,4282,2,5,5,5,5,0,5,0,5,0,False,False,False,0,3,2020-12-14T14:16:30.277,5,,0.0
2020,14,2996,405,26,4616,2,47,5,2,4,2,3,1,3,0,False,False,False,0,1,2020-12-14T14:17:51.02,4,,1.0
2020,14,2996,440,26,7514,13,12,2,50,0,0,0,0,0,0,False,False,False,0,2,2020-12-14T14:45:17.033,0,,0.0
2020,14,2996,445,26,7453,13,12,5,11,0,0,0,0,0,0,False,False,False,0,2,2020-12-14T14:46:45.457,0,,0.0
2020,14,2996,455,2,2835,2,32,3,-2,-2,0,-2,0,-2,0,False,False,False,0,1,2020-12-18T16:29:57.78,-2,,0.0
2020,14,2996,465,2,6247,2,4,7,18,22,4,22,0,22,0,False,False,False,0,3,2020-12-18T16:40:15.19,22,,0.0
2020,14,2996,480,2,6247,2,4,9,3,4,1,3,1,3,0,True,False,False,0,3,2020-12-14T15:01:24.417,4,,1.0
2020,14,2996,485,2,6342,13,26,9,2,0,0,0,0,0,0,True,False,False,0,3,2021-02-23T13:43:51.46,0,,
2020,14,2996,490,2,5223,2,2,10,2,7,5,7,0,7,0,False,False,False,1,2,2020-12-14T15:12:42.073,7,,0.0
2020,14,2996,500,2,5223,13,23,7,43,0,0,0,0,0,0,False,False,False,0,2,2020-12-18T03:36:53.17,0,,0.0
2020,14,2996,505,26,4616,2,48,10,-5,12,17,6,6,6,0,False,False,False,0,1,2020-12-14T15:19:55.513,12,,6.0
2020,14,2996,515,26,4616,2,47,10,0,5,5,3,2,3,0,False,False,False,0,1,2021-02-23T13:44:20.05,5,,2.0
2020,14,2996,520,26,309,2,2,9,6,8,2,6,2,6,0,True,False,False,0,3,2020-12-18T16:21:27.84,8,,2.0
2020,14,2996,525,26,6277,2,47,5,3,6,3,5,1,5,0,False,False,False,0,1,2020-12-18T17:10:03.977,6,,1.0
2020,14,2996,535,26,4282,2,39,10,5,11,6,9,2,9,0,False,False,False,0,4,2020-12-14T15:37:44.537,11,,2.0
2020,14,2996,555,26,4616,2,48,10,-5,13,18,9,4,9,0,False,False,False,0,1,2020-12-14T15:45:45.297,13,,4.0
2020,14,2996,560,26,309,2,51,9,-5,-4,1,-4,0,-4,0,False,False,False,0,3,2021-02-23T13:44:49.483,-4,,0.0
2020,14,2996,565,26,4616,2,51,10,0,0,0,0,0,0,0,False,False,False,0,1,2020-12-18T17:30:09.677,0,,0.0
2020,14,2996,570,26,7514,2,12,5,12,12,0,12,0,12,6,False,False,False,0,3,2021-02-25T16:58:17.98,12,,0.0
2020,14,2996,605,2,5223,3,6,7,22,0,0,0,0,0,0,False,False,False,0,2,2020-12-18T17:30:09.677,0,,0.0
2020,14,2996,610,2,4670,2,12,10,5,12,7,9,3,9,0,False,False,False,0,1,2020-12-14T16:16:38,12,,3.0
2020,14,2996,640,26,309,2,2,10,5,7,2,5,2,5,0,False,False,False,0,2,2020-12-18T03:45:57.407,7,,2.0
2020,14,2996,645,26,6277,13,51,5,-1,0,0,0,0,0,0,False,False,False,0,1,2020-12-18T17:30:09.677,0,,
2020,14,2996,650,26,6301,2,12,10,-9,0,9,-4,4,-4,0,False,False,False,0,1,2021-03-09T13:17:49.113,0,,4.0
2020,14,2996,655,26,6301,2,47,5,0,1,1,0,1,0,0,False,False,False,0,1,2020-12-14T17:00:45.137,1,,1.0
2020,14,2996,670,2,6247,13,19,6,23,0,0,0,0,0,0,False,False,False,0,2,2020-12-18T03:48:38.823,0,,0.0
2020,14,2996,675,2,6342,2,50,10,0,9,9,6,3,6,0,True,False,False,0,3,2020-12-14T17:06:15.12,9,,3.0
2020,14,2996,690,2,5223,2,51,3,-1,0,1,0,0,0,0,True,False,False,0,3,2020-12-14T17:10:29.04,0,,0.0
2020,14,2996,695,2,5223,2,2,10,8,14,6,12,2,12,0,False,False,False,0,2,2020-12-14T17:11:53.817,14,,2.0
2020,14,2996,710,2,5223,2,5,3,8,8,0,8,0,8,0,False,False,False,0,3,2021-02-23T13:45:24.8,8,,0.0
2020,14,2996,715,2,6472,2,48,10,-5,3,8,0,3,0,0,False,False,False,0,1,2021-02-23T13:45:44.797,3,,3.0
2020,14,2996,720,2,5223,13,9,6,16,0,0,0,0,0,0,False,False,False,0,2,2021-02-23T13:46:08.073,0,,
2020,14,2996,725,2,5214,13,4,10,4,0,0,0,0,0,0,True,False,False,0,3,2020-12-14T17:22:23.93,0,,0.0
2020,14,2996,730,26,4282,2,53,3,-5,0,5,0,0,0,0,False,False,False,0,4,2021-02-23T13:46:35.977,0,,0.0
2020,14,2996,735,26,7514,2,5,5,6,10,4,8,2,8,0,True,False,False,0,3,2020-12-14T17:26:04.753,10,,2.0
2020,14,2996,740,26,7697,2,51,3,0,4,4,3,1,3,0,False,False,False,0,3,2021-02-23T13:47:03.55,4,,1.0
2020,14,2996,765,26,309,13,2,4,7,0,0,0,0,0,0,False,False,False,0,3,2021-03-05T15:17:07.393,0,,0.0
2020,14,2996,770,2,990,3,45,5,-3,0,0,0,0,0,0,False,False,False,0,1,2020-12-14T17:34:45.2,0,,0.0
2020,14,2996,775,2,6247,2,13,4,4,17,13,9,8,9,0,False,False,False,2,2,2020-12-14T17:38:53.383,17,,8.0
2020,14,2996,785,2,5223,13,5,5,12,0,0,0,0,0,0,True,False,False,0,3,2020-12-18T16:08:44.723,0,,0.0
2020,14,2996,790,26,6277,13,16,9,4,0,0,0,0,0,0,False,False,False,0,1,2020-12-18T17:30:09.677,0,,0.0
2020,14,2996,795,26,7453,2,3,3,10,8,-2,8,0,8,0,False,False,False,0,2,2020-12-18T16:24:37.703,8,,0.0
2020,14,2996,805,26,4282,2,39,4,7,15,8,12,3,12,0,False,False,False,0,3,2020-12-18T17:30:09.677,15,,3.0
2020,14,2996,815,26,7514,2,7,6,23,25,2,25,0,25,0,False,False,False,0,2,2020-12-14T17:50:25.367,25,,0.0
2020,14,2997,10,20,306,2,48,3,-8,-6,2,-7,1,-7,0,False,False,False,0,1,2020-12-17T17:57:56.793,-6,,1
2020,14,2997,20,20,5140,2,48,3,-6,2,8,-1,3,-1,0,False,False,False,0,1,2020-12-14T11:51:08.667,2,,3
2020,14,2997,50,24,6937,2,51,3,-5,9,14,9,0,9,0,False,False,False,0,1,2020-12-14T12:07:47.163,9,,0
2020,14,2997,55,24,6937,13,47,5,0,0,0,0,0,0,0,False,False,False,0,1,2020-12-17T18:29:11.397,0,,0
2020,14,2997,60,24,894,2,5,3,2,2,0,2,0,2,0,True,False,False,0,4,2020-12-14T12:11:00.57,2,,0
2020,14,2997,65,24,7798,2,50,10,-3,7,10,-1,8,-1,0,True,False,False,1,3,2020-12-14T12:12:28.95,7,,8
2020,14,2997,75,24,6373,2,13,3,5,5,0,5,0,5,0,False,False,False,0,4,2020-12-14T12:15:08.007,5,,0
2020,14,2997,105,20,3763,2,6,8,18,18,0,18,0,18,0,False,False,False,0,3,2020-12-14T12:32:53.473,18,,0
2020,14,2997,120,20,3763,2,6,9,5,5,0,5,0,5,0,False,False,False,0,2,2020-12-17T18:29:45.287,5,,0
2020,14,2997,125,20,958,13,35,10,11,0,0,0,0,0,0,False,False,False,0,4,2020-12-17T19:17:03.8,0,,0
2020,14,2997,135,20,3763,2,26,3,5,6,1,5,1,5,0,False,False,False,0,3,2020-12-14T12:45:43.847,6,,1
2020,14,2997,145,24,7798,13,23,6,38,0,0,0,0,0,0,False,False,False,0,3,2020-12-17T15:04:38.79,0,,0
2020,14,2997,150,24,7800,2,34,4,-5,3,8,3,0,3,0,True,False,False,0,3,2020-12-14T12:49:37.82,3,,0
2020,14,2997,155,24,7798,2,13,9,3,39,36,39,0,39,0,False,False,False,0,3,2020-12-17T18:31:15.567,39,,0
2020,14,2997,165,24,6373,13,5,3,12,0,0,0,0,0,0,False,False,False,0,3,2020-12-14T12:55:34.29,0,,0
2020,14,2997,180,24,264,2,29,3,14,15,1,15,0,15,6,False,False,False,0,2,2020-12-14T12:59:05.693,15,,0
2020,14,2997,200,20,5140,2,46,3,3,10,7,5,5,5,0,False,False,False,1,1,2020-12-14T13:05:36.087,10,,5
2020,14,2997,205,20,3763,2,4,3,2,2,0,1,1,1,0,False,False,False,0,2,2020-12-14T13:07:38.51,2,,1
2020,14,2997,215,20,6388,3,46,3,4,0,0,0,0,0,0,False,False,False,0,3,2020-12-14T13:13:00.143,0,,0
2020,14,2997,225,24,6373,2,12,3,7,19,12,12,7,12,0,False,False,False,0,3,2021-03-09T13:20:51.383,19,,7
2020,14,2997,235,24,6937,2,46,3,0,0,0,0,0,0,0,False,False,False,0,1,2020-12-14T13:22:34.627,0,,0
2020,14,2997,260,20,5140,3,48,9,0,0,0,0,0,0,0,False,False,False,0,1,2021-03-05T15:19:33.45,0,,0
2020,14,2997,265,24,894,2,2,4,6,6,0,6,0,6,0,False,False,False,0,3,2020-12-14T13:32:28.6,6,,0
2020,14,2997,270,24,7798,13,9,6,21,0,0,0,0,0,0,False,False,False,0,2,2020-12-14T13:34:11.75,0,,0
2020,14,2997,275,24,894,13,12,5,10,0,0,0,0,0,0,False,False,False,0,3,2021-02-25T17:01:59.38,0,,0
2020,14,2997,295,20,5140,2,13,4,2,9,7,6,3,6,0,False,False,False,0,1,2020-12-14T13:40:29.583,9,,3
2020,14,2997,300,20,3763,2,2,9,8,8,0,8,0,8,0,False,False,False,0,2,2020-12-14T18:54:37.007,8,,0
2020,14,2997,310,20,213,2,46,3,-1,2,3,-1,3,-1,0,False,False,False,0,3,2020-12-14T13:47:53.727,2,,3
2020,14,2997,350,24,4382,13,3,5,12,0,0,0,0,0,0,False,False,False,0,3,2020-12-14T14:09:30.033,0,,0
2020,14,2997,370,20,5140,13,47,5,2,0,0,0,0,0,0,False,False,False,0,1,2020-12-14T14:14:28.76,0,,0
2020,14,2997,375,20,213,2,13,4,5,9,4,9,0,9,0,False,False,False,0,3,2020-12-17T18:34:08.373,9,,0
2020,14,2997,405,24,6373,2,13,10,4,13,9,5,8,5,0,False,False,False,2,3,2020-12-14T14:21:26.337,13,,8
2020,14,2997,410,24,4382,13,5,3,10,0,0,0,0,0,0,False,False,False,0,3,2020-12-14T14:22:33.607,0,,0
2020,14,2997,415,24,6389,2,45,5,-5,11,16,7,4,7,0,False,False,False,0,1,2020-12-14T14:24:24.233,11,,4
2020,14,2997,455,24,6937,2,47,5,1,6,5,6,0,6,0,False,False,False,0,1,2021-03-04T18:25:04.707,6,,0
2020,14,2997,480,20,3763,2,4,9,11,13,2,11,2,11,0,False,False,False,0,2,2021-02-22T20:12:55.45,13,,2
2020,14,2997,490,20,8127,2,4,9,6,11,5,9,2,9,0,False,False,False,0,2,2020-12-17T19:17:34.94,11,,2
2020,14,2997,505,20,213,13,5,5,5,0,0,0,0,0,0,False,False,False,0,2,2020-12-17T18:59:04.793,0,,0
2020,14,2997,510,20,958,2,51,10,1,8,7,2,6,2,0,False,False,False,1,3,2020-12-17T18:18:39.113,8,,6
2020,14,2997,525,20,5140,2,11,10,8,11,3,10,1,10,0,False,False,False,0,1,2020-12-17T15:05:37.477,11,,1
2020,14,2997,565,24,4382,2,5,5,4,6,2,5,1,5,0,False,False,False,0,3,2020-12-14T15:37:04.99,6,,1
2020,14,2997,575,24,6373,13,35,5,9,0,0,0,0,0,0,False,False,False,0,4,2020-12-14T15:40:10.463,0,,0
2020,14,2997,580,24,6937,2,50,10,-3,6,9,6,0,6,0,False,False,False,0,2,2020-12-14T15:42:05.567,6,,0
2020,14,2997,595,20,1162,2,30,5,-1,1,2,0,1,0,0,False,False,False,0,4,2020-12-14T16:22:59.707,1,,1
2020,14,2997,605,20,3763,2,6,4,13,22,9,16,6,16,0,False,False,False,0,3,2020-12-14T18:55:18.733,22,,6
2020,14,2997,610,20,213,2,23,7,37,37,0,37,0,37,6,False,False,False,0,3,2020-12-17T18:40:11.55,37,,0
2020,14,2997,630,24,6373,2,4,5,6,6,0,6,0,6,0,False,False,False,0,2,2020-12-17T15:05:59.337,6,,0
2020,14,2997,655,24,4382,13,5,5,6,0,0,0,0,0,0,False,False,False,0,3,2020-12-14T16:36:25.423,0,,0
2020,14,2997,670,20,7888,2,53,10,-6,12,18,10,2,10,0,False,False,False,0,4,2020-12-17T18:42:27.9,12,,2
2020,14,2997,675,20,6388,2,17,7,18,20,2,19,1,19,0,False,False,False,0,3,2020-12-14T16:46:41.78,20,,1
2020,14,2997,680,20,6388,2,12,10,-9,9,18,-8,17,-8,0,False,False,False,1,4,2021-03-09T13:21:42.387,9,,17
2020,14,2997,690,20,6388,13,35,5,10,0,0,0,0,0,0,False,False,False,0,3,2021-03-08T15:16:25.84,0,,0
2020,14,2997,700,20,5140,2,51,5,-3,1,4,-2,3,-2,0,False,False,False,1,1,2020-12-17T18:48:21.963,1,,3
2020,14,2997,720,24,4382,2,4,4,12,14,2,12,2,12,0,False,False,False,0,2,2020-12-17T15:06:15.737,14,,2
2020,14,2997,770,20,5140,13,48,10,-3,0,0,0,0,0,0,False,False,False,0,1,2020-12-14T17:32:52.547,0,,0
2020,14,2997,775,20,3763,2,39,10,5,10,5,7,3,7,0,False,False,False,0,3,2020-12-14T18:55:47.037,10,,3
2020,14,2997,780,20,6388,13,5,3,13,0,0,0,0,0,0,False,False,False,0,2,2020-12-17T18:49:29.377,0,,0
2020,14,2997,785,20,5140,2,4,10,4,9,5,7,2,7,0,False,False,False,0,1,2020-12-14T17:37:09.18,9,,2
2020,14,2997,795,20,5140,2,44,9,-5,2,7,2,0,2,0,False,False,False,0,1,2021-03-04T18:25:51.673,2,,0
2020,14,2997,810,20,958,2,31,10,5,9,4,4,5,4,0,False,False,False,1,3,2020-12-17T18:09:23.683,9,,5
2020,14,2997,845,20,6388,2,9,2,30,31,1,30,1,30,0,False,False,False,0,2,2020-12-14T17:59:43.44,31,,1
2020,14,2997,850,20,213,13,22,6,20,0,0,0,0,0,0,False,False,False,0,3,2020-12-14T18:01:55.397,0,,0
2020,14,2997,855,20,958,2,36,7,20,20,0,20,0,20,6,False,False,False,0,3,2020-12-14T18:53:36.413,20,,0
2020,14,2998,20,28,4912,2,6,7,16,16,0,16,0,16,0,False,False,False,0,3,2020-12-14T18:27:27.213,16,,0.0
2020,14,2998,25,28,7619,13,5,3,6,0,0,0,0,0,0,False,False,False,0,3,2020-12-14T11:41:31.923,0,,0.0
2020,14,2998,30,28,7619,2,30,10,-2,6,8,3,3,3,0,False,False,False,0,3,2020-12-14T11:47:26.66,6,,3.0
2020,14,2998,40,28,7619,13,4,9,5,0,0,0,0,0,0,False,False,False,0,2,2020-12-14T11:48:52.923,0,,0.0
2020,14,2998,50,32,7128,13,35,7,17,0,0,0,0,0,0,False,False,False,0,3,2021-03-15T19:02:36.373,0,,0.0
2020,14,2998,60,32,7128,13,2,10,5,0,0,0,0,0,0,True,False,False,0,3,2020-12-14T11:53:06.437,0,,
2020,14,2998,65,32,1427,2,13,9,1,3,2,2,1,2,0,False,False,False,0,3,2020-12-14T11:56:03.993,3,,1.0
2020,14,2998,75,28,3264,2,5,5,2,6,4,6,0,6,0,False,False,False,0,1,2020-12-17T16:09:30.333,6,,0.0
2020,14,2998,90,28,7619,2,50,9,-1,5,6,3,2,3,0,False,False,False,0,2,2020-12-14T18:14:58.37,5,,2.0
2020,14,2998,135,32,7128,13,4,3,9,0,0,0,0,0,0,False,False,False,0,2,2020-12-14T12:09:39.58,0,,0.0
2020,14,2998,150,28,7619,2,35,6,19,17,-2,19,-2,19,0,False,False,False,1,3,2020-12-15T17:59:09.48,17,,-2.0
2020,14,2998,165,28,969,13,30,3,0,0,0,0,0,0,0,False,False,False,0,4,2020-12-14T18:21:42.45,0,,
2020,14,2998,195,32,1427,13,35,8,25,0,0,0,0,0,0,False,False,False,0,4,2020-12-14T12:20:54.53,0,,0.0
2020,14,2998,200,32,3708,2,45,5,-2,2,4,2,0,2,0,False,False,False,0,1,2020-12-17T20:09:45.247,2,,0.0
2020,14,2998,205,32,3885,13,5,5,5,0,0,0,0,0,0,False,False,False,0,3,2020-12-14T12:22:57.04,0,,0.0
2020,14,2998,220,28,4912,13,17,7,23,0,0,0,0,0,0,False,False,False,0,3,2020-12-14T13:27:03.757,0,,0.0
2020,14,2998,225,28,7619,2,12,1,18,18,0,18,0,18,0,False,False,False,0,2,2021-02-25T17:09:48.48,18,,0.0
2020,14,2998,230,28,4912,13,6,4,14,0,0,0,0,0,0,False,False,False,0,3,2020-12-14T13:29:53.84,0,,0.0
2020,14,2998,245,28,6360,2,50,10,-5,4,9,2,2,2,0,False,False,False,2,3,2020-12-17T20:25:48.017,4,,2.0
2020,14,2998,265,32,6318,13,8,8,45,0,0,0,0,0,0,False,False,False,0,2,2020-12-14T18:15:29.477,0,,0.0
2020,14,2998,285,28,969,13,4,9,4,0,0,0,0,0,0,True,False,False,0,3,2020-12-17T21:02:02.653,0,,0.0
2020,14,2998,300,32,7128,2,5,5,11,11,0,11,0,11,0,False,False,False,0,3,2020-12-17T16:44:37.65,11,,0.0
2020,14,2998,305,32,7494,3,45,5,-8,0,0,0,0,0,0,True,False,False,0,3,2021-02-22T19:46:49.687,0,,0.0
2020,14,2998,310,32,7128,2,2,10,8,13,5,11,2,11,0,False,False,False,0,2,2020-12-14T13:44:03.007,13,,2.0
2020,14,2998,330,32,1427,2,51,10,0,5,5,2,3,2,0,False,False,False,1,3,2020-12-17T20:14:12.037,5,,3.0
2020,14,2998,355,32,1427,2,4,9,5,9,4,5,4,5,0,False,False,False,1,3,2020-12-14T13:50:59.37,9,,4.0
2020,14,2998,360,32,8237,2,51,10,-3,9,12,6,3,6,0,False,False,False,0,3,2020-12-14T13:52:09.773,9,,3.0
2020,14,2998,365,32,6318,13,39,4,4,0,0,0,0,0,0,False,False,False,0,3,2020-12-14T14:02:43.623,0,,0.0
2020,14,2998,400,28,3264,13,48,9,-3,0,0,0,0,0,0,False,False,False,0,1,2020-12-14T14:07:37.603,0,,0.0
2020,14,2998,405,28,969,13,5,3,10,0,0,0,0,0,0,False,False,False,0,3,2020-12-17T16:45:04.67,0,,0.0
2020,14,2998,420,32,1427,2,4,10,5,5,0,5,0,5,0,False,False,False,0,3,2020-12-14T14:26:38.72,5,,0.0
2020,14,2998,430,32,3885,13,48,10,-3,0,0,0,0,0,0,False,False,False,0,1,2021-02-22T19:47:45.477,0,,0.0
2020,14,2998,435,32,6430,13,9,6,20,0,0,0,0,0,0,False,False,False,0,3,2020-12-17T16:13:41.763,0,,0.0
2020,14,2998,440,28,7619,2,50,9,-2,11,13,5,6,5,0,False,False,False,0,2,2020-12-14T18:26:34.387,11,,6.0
2020,14,2998,460,28,969,2,2,9,6,8,2,7,1,7,0,False,False,False,0,3,2020-12-14T14:42:54.2,8,,1.0
2020,14,2998,465,28,7619,2,2,9,8,12,4,11,1,11,0,False,False,False,1,2,2020-12-14T14:44:04.593,12,,1.0
2020,14,2998,475,28,4912,3,6,9,8,0,0,0,0,0,0,False,False,False,0,3,2020-12-14T18:26:06.013,0,,0.0
2020,14,2998,480,28,7619,13,8,9,13,0,0,0,0,0,0,False,False,False,0,3,2020-12-14T18:22:49.553,0,,
2020,14,2998,485,28,969,13,2,9,10,0,0,0,0,0,0,False,False,False,0,3,2020-12-14T14:51:32.527,0,,0.0
2020,14,2998,530,32,3885,2,46,9,0,13,13,13,0,13,0,False,False,False,0,1,2020-12-14T15:04:38.383,13,,0.0
2020,14,2998,535,32,1427,2,5,3,12,12,0,12,0,12,0,True,False,False,0,4,2020-12-14T15:06:10.177,12,,0.0
2020,14,2998,540,32,4467,13,12,10,-1,0,0,0,0,0,0,False,False,False,0,4,2021-03-09T13:24:45.07,0,,0.0
2020,14,2998,560,32,7128,13,13,4,3,0,0,0,0,0,0,False,False,False,0,3,2020-12-17T21:06:31.757,0,,0.0
2020,14,2998,580,28,4912,13,6,10,5,0,0,0,0,0,0,False,False,False,0,2,2020-12-15T17:59:25.707,0,,0.0
2020,14,2998,595,32,6430,2,11,3,6,8,2,8,0,8,0,True,False,False,0,3,2020-12-14T15:23:18.077,8,,0.0
2020,14,2998,610,32,3708,2,47,10,-1,-1,0,-1,0,-1,0,False,False,False,0,1,2020-12-14T15:35:58.543,-1,,0.0
2020,14,2998,615,32,1427,2,38,4,4,9,5,7,2,7,0,False,False,False,0,3,2020-12-17T16:45:44.62,9,,2.0
2020,14,2998,630,32,7494,3,5,5,12,0,0,0,0,0,0,False,False,False,0,3,2020-12-14T15:40:28.127,0,,0.0
2020,14,2998,645,28,7619,2,8,10,12,12,0,12,0,12,0,True,False,False,0,3,2020-12-15T17:59:38.187,12,,0.0
2020,14,2998,650,28,4912,2,5,8,16,16,0,16,0,16,0,False,False,False,0,3,2020-12-17T21:09:35.65,16,,0.0
2020,14,2998,655,28,7619,13,5,3,6,0,0,0,0,0,0,False,False,False,0,3,2020-12-17T20:17:10.523,0,,0.0
2020,14,2998,665,28,6360,2,12,10,4,10,6,10,0,10,0,True,False,False,0,3,2021-03-09T13:25:02.91,10,,0.0
2020,14,2998,670,28,7619,13,17,7,21,0,0,0,0,0,0,False,False,False,0,3,2020-12-14T15:57:40.467,0,,0.0
2020,14,2998,675,28,3264,2,28,10,-7,-1,6,-3,2,-3,0,False,False,False,0,1,2020-12-14T15:59:41.317,-1,,2.0
2020,14,2998,680,28,6624,2,47,5,1,13,12,12,1,12,0,True,False,False,0,1,2020-12-17T22:01:32.483,13,,1.0
2020,14,2998,690,28,262,13,45,5,0,0,0,0,0,0,0,False,False,False,0,1,2021-04-01T19:41:02.833,0,,0.0
2020,14,2998,705,28,3264,13,4,4,5,0,0,0,0,0,0,False,False,False,0,1,2020-12-14T16:10:07.207,0,,0.0
2020,14,2998,710,28,969,2,6,10,5,5,0,5,0,5,0,False,False,False,0,2,2020-12-14T16:12:31.34,5,,0.0
2020,14,2998,715,28,7619,13,12,5,7,0,0,0,0,0,0,False,False,False,0,2,2021-03-09T13:26:05.033,0,,0.0
2020,14,2998,720,28,7619,3,2,4,4,0,0,0,0,0,0,False,False,False,0,3,2021-02-22T19:49:29.15,0,,0.0
2020,14,2998,725,28,6360,2,4,9,13,16,3,16,0,16,0,False,False,False,0,3,2020-12-14T17:07:54.977,16,,0.0
2020,14,2998,730,28,6627,2,32,4,-1,6,7,5,1,5,0,True,False,False,0,4,2020-12-17T16:46:04.19,6,,1.0
2020,14,2998,740,28,262,2,5,3,3,9,6,8,1,8,0,True,False,False,0,4,2020-12-17T21:11:26.55,9,,1.0
2020,14,2998,750,28,262,2,30,9,1,6,5,5,1,5,6,False,False,False,0,1,2020-12-14T18:13:15.663,6,,1.0
2020,14,2998,775,32,7494,2,46,3,1,5,4,5,0,5,0,False,False,False,0,3,2020-12-17T16:46:21.77,5,,0.0
2020,14,2998,785,28,7619,2,2,9,5,12,7,8,4,8,0,False,False,False,0,3,2020-12-14T18:13:46.457,12,,4.0
2020,14,2998,795,28,6627,2,5,10,14,14,0,14,0,14,0,False,False,False,0,4,2020-12-17T16:47:32.33,14,,0.0
2020,14,2998,805,28,6624,13,26,9,3,0,0,0,0,0,0,False,False,False,0,2,2021-02-22T19:50:11.86,0,,0.0
2020,14,2998,820,32,3708,13,28,9,-4,0,0,0,0,0,0,False,False,False,0,1,2020-12-17T16:47:44.693,0,,0.0
2020,14,2998,825,32,7128,13,2,9,6,0,0,0,0,0,0,False,False,False,0,3,2020-12-17T16:50:56.973,0,,0.0
2020,14,2998,845,28,7760,13,47,10,1,0,0,0,0,0,0,False,False,False,0,1,2021-02-22T19:51:54.39,0,,0.0
2020,14,2998,880,32,3885,2,47,10,0,5,5,5,0,5,0,False,False,False,0,1,2020-12-14T18:07:48.407,5,,0.0
2020,14,2998,890,28,7619,2,50,10,-1,7,8,5,2,5,0,False,False,False,0,3,2020-12-14T17:41:36.477,7,,2.0
2020,14,2998,905,28,4912,2,6,10,4,22,18,4,18,4,0,False,False,False,0,3,2020-12-14T17:49:34.8,22,,
2020,14,2998,910,28,6624,3,6,10,4,0,0,0,0,0,0,True,False,False,0,2,2020-12-14T17:51:08.657,0,,0.0
2020,14,2998,915,28,4912,2,6,10,9,10,1,10,0,10,0,False,False,False,0,2,2020-12-17T21:14:36.15,10,,0.0
2020,14,2998,960,28,7619,2,50,9,-3,19,22,19,0,19,0,False,False,False,1,3,2021-12-13T20:15:59.923,19,False,0.0
2020,14,2999,10,25,7060,3,49,3,-1,0,0,0,0,0,0,False,False,False,0,2,2020-12-14T13:04:40.803,0,,0.0
2020,14,2999,15,25,7666,2,34,4,-4,5,9,-5,10,-5,0,True,False,False,1,3,2021-03-04T18:29:03.543,5,,10.0
2020,14,2999,20,25,7060,13,6,10,3,0,0,0,0,0,0,True,False,False,0,2,2020-12-15T20:07:10.507,0,,0.0
2020,14,2999,30,4,594,13,39,4,4,0,0,0,0,0,0,False,False,False,0,3,2020-12-14T13:13:43.703,0,,0.0
2020,14,2999,45,4,2853,13,19,6,55,0,0,0,0,0,0,False,False,False,0,2,2020-12-17T17:23:02.723,0,,0.0
2020,14,2999,55,25,7060,2,50,10,-2,12,14,2,10,2,0,False,False,False,0,3,2020-12-14T13:20:46.677,12,,10.0
2020,14,2999,60,25,4583,2,5,5,4,4,0,4,0,4,0,False,False,False,0,3,2020-12-17T04:11:49.713,4,,0.0
2020,14,2999,70,25,7060,3,13,4,1,0,0,0,0,0,0,False,False,False,0,3,2020-12-14T13:25:25.917,0,,0.0
2020,14,2999,80,4,6983,2,44,3,-5,2,7,-2,4,-2,0,True,False,False,0,1,2020-12-14T13:28:23.177,2,,4.0
2020,14,2999,85,4,594,2,5,10,4,13,9,13,0,13,0,False,False,False,0,3,2020-12-14T13:31:58.013,13,,0.0
2020,14,2999,90,4,2853,13,4,10,7,0,0,0,0,0,0,False,False,False,0,3,2021-02-22T21:50:39.603,0,,0.0
2020,14,2999,95,4,594,13,24,6,27,0,0,0,0,0,0,False,False,False,0,2,2020-12-14T13:43:25.013,0,,0.0
2020,14,2999,110,25,181,13,13,9,3,0,0,0,0,0,0,False,False,False,0,3,2020-12-17T17:23:59.553,0,,0.0
2020,14,2999,130,4,7646,13,13,9,7,0,0,0,0,0,0,False,False,False,0,3,2020-12-14T13:45:40.083,0,,0.0
2020,14,2999,140,25,7666,3,35,6,16,0,0,0,0,0,0,False,False,False,0,2,2020-12-17T17:04:23.92,0,,0.0
2020,14,2999,145,25,7666,2,47,5,2,4,2,3,1,3,0,False,False,False,0,4,2020-12-14T13:49:59.643,4,,1.0
2020,14,2999,150,25,4583,2,35,5,13,13,0,13,0,13,0,False,False,False,0,3,2020-12-14T13:52:34.643,13,,0.0
2020,14,2999,160,25,4583,2,2,10,4,8,4,6,2,6,0,False,False,False,0,2,2020-12-14T13:58:50.033,8,,2.0
2020,14,2999,175,25,6486,13,19,2,25,0,0,0,0,0,0,False,False,False,0,2,2020-12-14T14:05:11.87,0,,0.0
2020,14,2999,185,4,2853,2,2,9,6,8,2,7,1,7,0,False,False,False,0,2,2020-12-14T14:09:21.433,8,,1.0
2020,14,2999,195,4,2853,2,4,3,3,3,0,3,0,3,0,False,False,False,0,2,2020-12-14T14:11:59.323,3,,
2020,14,2999,200,4,6953,13,32,3,2,0,0,0,0,0,0,True,False,False,0,3,2020-12-15T17:27:09.677,0,,0.0
2020,14,2999,205,4,7646,2,51,10,-4,-1,3,-3,2,-3,0,False,False,False,0,3,2020-12-17T17:24:44.857,-1,,2.0
2020,14,2999,215,4,594,13,4,4,11,0,0,0,0,0,0,False,False,False,0,3,2020-12-15T17:26:02.137,0,,0.0
2020,14,2999,225,25,7666,3,19,2,38,0,0,0,0,0,0,False,False,False,0,2,2020-12-14T14:24:28.247,0,,0.0
2020,14,2999,240,25,4583,2,13,9,2,20,18,19,1,19,0,False,False,False,0,4,2020-12-14T14:28:44.24,20,,1.0
2020,14,2999,255,25,609,13,4,4,5,0,0,0,0,0,0,False,False,False,0,4,2020-12-17T17:25:28.993,0,,0.0
2020,14,2999,270,4,594,2,4,9,4,4,0,4,0,4,0,False,False,False,0,3,2020-12-14T14:39:34.667,4,,0.0
2020,14,2999,275,4,7646,2,4,3,7,7,0,7,0,7,0,False,False,False,0,2,2020-12-14T14:40:53.657,7,,0.0
2020,14,2999,280,4,6953,13,12,8,35,0,0,0,0,0,0,False,False,False,0,3,2021-03-09T13:34:12.47,0,,0.0
2020,14,2999,285,4,6953,2,17,10,4,6,2,6,0,6,0,False,True,True,0,1,2020-12-14T14:45:42.127,6,,0.0
2020,14,2999,300,25,6486,2,8,8,19,19,0,19,0,19,6,False,False,False,0,2,2020-12-14T14:50:56.44,19,,0.0
2020,14,2999,320,4,7646,13,21,6,33,0,0,0,0,0,0,False,False,False,0,2,2020-12-17T04:07:30.433,0,,0.0
2020,14,2999,345,25,6486,13,8,9,13,0,0,0,0,0,0,False,False,False,0,2,2020-12-14T15:12:15.647,0,,0.0
2020,14,2999,355,4,594,2,51,3,-1,7,8,5,2,5,0,False,False,False,0,3,2020-12-14T15:14:09.207,7,,2.0
2020,14,2999,360,4,7646,13,4,3,12,0,0,0,0,0,0,False,False,False,0,2,2020-12-14T15:15:17.517,0,,0.0
2020,14,2999,365,4,2853,2,2,9,5,23,18,5,18,5,0,False,False,False,1,2,2020-12-15T17:26:24.317,23,,18.0
2020,14,2999,375,4,2853,2,5,3,7,7,0,7,0,7,0,False,False,False,0,2,2020-12-14T15:19:37.227,7,,0.0
2020,14,2999,380,4,2853,2,4,3,13,18,5,16,2,16,0,False,False,False,0,2,2020-12-14T15:22:58.397,18,,
2020,14,2999,390,4,594,13,5,6,15,0,0,0,0,0,0,False,False,False,0,3,2020-12-17T17:26:09.593,0,,0.0
2020,14,2999,395,4,2853,13,29,3,14,0,0,0,0,0,0,False,False,False,0,3,2020-12-14T15:30:47.733,0,,0.0
2020,14,2999,400,4,6953,13,17,8,16,0,0,0,0,0,0,False,False,False,0,3,2020-12-17T04:08:24.433,0,,0.0
2020,14,2999,415,25,6490,2,48,10,-4,4,8,3,1,3,0,True,False,False,0,1,2020-12-15T20:07:32.74,4,,1.0
2020,14,2999,420,25,609,2,39,4,4,13,9,9,4,9,0,False,False,False,1,4,2020-12-14T15:38:15.677,13,,4.0
2020,14,2999,430,25,7666,13,5,3,14,0,0,0,0,0,0,False,False,False,0,3,2020-12-17T22:53:07.84,0,,0.0
2020,14,2999,440,25,4583,13,5,9,4,0,0,0,0,0,0,False,False,False,0,3,2021-03-05T15:21:30.433,0,,0.0
2020,14,2999,455,25,6486,2,13,4,1,1,0,1,0,1,0,False,False,False,0,2,2020-12-14T15:46:53.677,1,,0.0
2020,14,2999,470,4,2853,2,4,5,2,5,3,4,1,4,0,False,False,False,1,2,2020-12-14T15:52:35.67,5,,1.0
2020,14,2999,480,4,2853,2,2,10,6,6,0,6,0,6,0,False,False,False,0,2,2020-12-17T17:26:46.923,6,,0.0
2020,14,2999,485,4,6953,2,31,5,3,8,5,5,3,5,0,False,False,False,0,1,2020-12-17T17:07:48.477,8,,3.0
2020,14,2999,495,4,2853,2,4,5,2,12,10,10,2,10,0,False,False,False,0,2,2020-12-17T22:36:49.787,12,,2.0
2020,14,2999,505,4,2853,2,2,9,6,19,13,16,3,16,6,False,False,False,0,2,2020-12-14T16:01:39.8,19,,3.0
2020,14,2999,525,25,181,13,31,4,-4,0,0,0,0,0,0,True,False,False,0,4,2020-12-14T16:23:47.157,0,,0.0
2020,14,2999,540,4,2853,2,2,10,11,22,11,22,0,22,0,False,False,False,0,2,2020-12-14T16:27:37.92,22,,0.0
2020,14,2999,545,4,2853,2,4,10,12,19,7,12,7,12,0,False,False,False,1,3,2021-02-25T17:12:05.363,19,,7.0
2020,14,2999,555,4,7646,2,19,3,13,13,0,13,0,13,6,False,False,False,0,2,2020-12-15T17:33:17.317,13,,0.0
2020,14,2999,575,25,7666,2,4,5,6,6,0,6,0,6,0,False,False,False,0,2,2020-12-14T16:34:15.02,6,,0.0
2020,14,2999,580,25,609,13,2,10,6,0,0,0,0,0,0,False,False,False,0,2,2020-12-17T17:27:30.203,0,,0.0
2020,14,2999,595,4,594,2,2,4,4,8,4,5,3,5,0,False,False,False,0,3,2020-12-14T16:38:47.71,8,,3.0
2020,14,2999,610,4,6953,2,31,3,2,4,2,2,2,2,0,False,False,False,0,1,2020-12-14T16:42:17.46,4,,2.0
2020,14,2999,620,25,7060,2,18,5,-2,5,7,3,2,3,0,False,False,False,0,2,2020-12-14T16:44:31.7,5,,2.0
2020,14,2999,630,25,7060,2,18,3,-2,6,8,-2,8,-2,0,False,False,False,1,2,2020-12-14T16:47:27.107,6,,8.0
2020,14,2999,635,25,609,2,17,10,13,17,4,17,0,17,0,False,False,False,0,4,2020-12-14T16:48:41.233,17,,0.0
2020,14,2999,645,25,6490,2,45,5,-5,8,13,3,5,3,0,False,False,False,0,1,2020-12-14T16:51:53.21,8,,5.0
2020,14,2999,650,25,6486,2,4,9,5,9,4,9,0,9,0,False,False,False,0,3,2020-12-17T17:09:12.827,9,,0.0
2020,14,2999,655,25,7060,2,2,9,5,17,12,14,3,14,0,False,False,False,0,2,2020-12-14T16:55:01.557,17,,3.0
2020,14,2999,660,25,4583,2,39,4,1,7,6,5,2,5,0,False,False,False,0,3,2020-12-14T16:56:07.697,7,,2.0
2020,14,2999,670,25,609,13,12,5,3,0,0,0,0,0,0,False,False,False,0,4,2021-02-25T17:13:01.453,0,,0.0
2020,14,2999,675,25,4583,2,45,5,3,3,0,3,0,3,6,False,False,False,0,3,2020-12-14T17:00:34.527,3,,0.0
2020,14,2999,690,4,594,2,5,3,5,9,4,7,2,7,0,False,False,False,0,3,2020-12-14T17:03:04.247,9,,2.0
2020,14,2999,700,4,7646,13,8,1,42,0,0,0,0,0,0,False,False,False,0,3,2020-12-14T17:05:24.407,0,,0.0
2020,14,2999,705,4,7645,13,19,5,14,0,0,0,0,0,0,False,False,False,0,2,2020-12-17T17:12:23.567,0,,0.0
2020,14,2999,710,4,5119,2,13,9,5,12,7,11,1,11,0,False,False,False,0,2,2020-12-14T17:19:38.537,12,,1.0
2020,14,2999,715,4,594,3,6,9,12,0,0,0,0,0,0,False,False,False,0,3,2020-12-14T17:21:38.25,0,,0.0
2020,14,2999,725,4,6953,13,12,8,35,0,0,0,0,0,0,False,False,False,0,3,2021-03-09T13:36:14.297,0,,
2020,14,2999,740,4,7646,13,12,5,5,0,0,0,0,0,0,False,False,False,0,2,2021-03-09T13:36:49.457,0,,0.0
2020,14,2999,755,25,6490,13,18,3,0,0,0,0,0,0,0,False,False,False,0,2,2020-12-14T17:31:55.213,0,,0.0
2020,14,2999,760,25,6490,2,18,3,-1,6,7,4,2,4,0,False,False,False,0,2,2020-12-14T17:34:03.37,6,,2.0
2020,14,2999,765,25,6486,13,19,2,37,0,0,0,0,0,0,False,False,False,0,2,2021-02-22T21:52:44.14,0,,0.0
2020,14,2999,775,4,2853,2,4,3,9,9,0,9,0,9,0,False,False,False,0,2,2020-12-14T17:40:07.68,9,,0.0
2020,14,2999,780,4,2853,13,19,6,42,0,0,0,0,0,0,False,False,False,0,2,2020-12-14T17:41:16.303,0,,0.0
2020,14,2999,790,4,6953,2,47,5,-1,16,17,13,3,13,0,False,False,False,0,1,2020-12-14T17:43:11.403,16,,3.0
2020,14,3000,10,8,232,13,5,5,12,0,0,0,0,0,0,True,False,False,0,3,2021-03-08T15:21:09.477,0,,0.0
2020,14,3000,15,8,4976,2,53,10,-3,20,23,17,3,17,0,False,False,False,0,4,2020-12-15T15:08:57.413,20,,3.0
2020,14,3000,30,8,5053,2,48,9,-4,10,14,1,9,1,0,False,False,False,1,1,2021-03-03T21:07:46.647,10,,9.0
2020,14,3000,35,8,6439,2,48,3,-4,12,16,7,5,7,0,False,False,False,0,1,2020-12-15T15:13:47.917,12,,5.0
2020,14,3000,40,8,7652,2,32,5,3,4,1,4,0,4,0,False,False,False,0,4,2020-12-15T15:16:02.393,4,,0.0
2020,14,3000,45,8,4976,2,6,10,8,11,3,11,0,11,0,False,False,False,0,4,2020-12-15T15:17:18.16,11,,0.0
2020,14,3000,50,8,3606,2,6,9,6,9,3,9,0,9,0,False,True,False,0,2,2020-12-15T15:18:29.057,9,,0.0
2020,14,3000,55,8,3606,2,26,10,3,4,1,4,0,4,0,False,True,False,0,2,2020-12-15T15:20:15.97,2,,0.0
2020,14,3000,100,3,6659,2,32,9,3,4,1,3,1,3,0,True,False,False,0,3,2020-12-17T02:45:45.06,4,,1.0
2020,14,3000,105,3,6936,13,19,6,30,0,0,0,0,0,0,False,False,False,0,2,2020-12-15T15:30:55.86,0,,
2020,14,3000,145,8,7652,13,19,2,18,0,0,0,0,0,0,False,False,False,0,2,2020-12-15T15:38:26.297,0,,
2020,14,3000,155,8,232,2,5,3,3,4,1,4,0,4,0,False,True,False,0,3,2020-12-18T19:53:26.52,4,,0.0
2020,14,3000,165,8,7651,13,19,2,26,0,0,0,0,0,0,False,False,False,0,3,2020-12-18T19:59:48.113,0,,0.0
2020,14,3000,170,8,3606,13,2,9,11,0,0,0,0,0,0,False,False,False,0,2,2020-12-15T15:45:21.3,0,,
2020,14,3000,175,8,4000,3,46,3,1,0,0,0,0,0,0,False,False,False,0,1,2020-12-15T15:47:11.22,0,,0.0
2020,14,3000,185,8,232,13,9,2,17,0,0,0,0,0,0,False,False,False,0,3,2020-12-18T18:00:30.74,0,,0.0
2020,14,3000,205,3,2688,3,47,5,1,0,0,0,0,0,0,True,False,False,0,3,2020-12-15T15:57:14.36,0,,0.0
2020,14,3000,225,8,5053,2,48,9,-4,5,9,2,3,2,0,False,False,False,1,1,2020-12-15T16:01:16.387,5,,
2020,14,3000,235,8,3606,13,8,7,26,0,0,0,0,0,0,False,False,False,0,2,2020-12-15T16:03:40.313,0,,0.0
2020,14,3000,240,8,7652,3,12,5,7,0,0,0,0,0,0,False,False,False,0,3,2021-03-09T13:44:07.703,0,,0.0
2020,14,3000,275,3,2688,2,4,4,5,10,5,8,2,8,0,False,False,False,0,2,2020-12-15T16:13:24.403,10,,2.0
2020,14,3000,310,8,7652,13,12,2,18,0,0,0,0,0,0,False,False,False,0,4,2020-12-15T16:18:30.143,0,,0.0
2020,14,3000,315,8,232,2,4,10,12,11,-1,11,0,11,0,False,False,False,0,3,2020-12-18T20:03:47.687,11,,0.0
2020,14,3000,325,8,7651,2,7,2,34,37,3,35,2,35,0,False,False,False,0,3,2020-12-15T16:22:17.653,37,,2.0
2020,14,3000,380,8,7651,2,2,9,6,7,1,7,0,7,0,False,False,False,0,2,2020-12-15T16:31:04.657,7,,0.0
2020,14,3000,385,8,5053,13,46,3,3,0,0,0,0,0,0,False,False,False,0,1,2020-12-15T16:32:20.873,0,,0.0
2020,14,3000,390,8,3606,2,6,4,11,14,3,13,1,13,0,False,False,False,0,2,2021-02-23T13:29:42.443,14,,
2020,14,3000,405,3,6936,3,3,3,9,0,0,0,0,0,0,False,False,False,0,2,2020-12-15T16:37:51.273,0,,0.0
2020,14,3000,410,3,6936,3,5,5,7,0,0,0,0,0,0,False,False,False,0,2,2020-12-15T16:38:49.37,0,,0.0
2020,14,3000,415,3,6454,2,12,2,24,39,15,27,12,27,0,True,False,False,1,4,2021-03-03T21:09:17.443,39,,12.0
2020,14,3000,440,8,3606,2,6,2,17,18,1,18,0,18,0,False,False,False,0,2,2020-12-18T18:00:30.74,18,,0.0
2020,14,3000,450,8,7652,13,4,9,9,0,0,0,0,0,0,False,False,False,0,4,2020-12-15T16:46:10.437,0,,0.0
2020,14,3000,455,8,5053,2,48,5,-7,1,8,-4,5,-4,0,False,False,False,0,1,2020-12-15T16:47:20.44,1,,5.0
2020,14,3000,465,8,7651,13,19,1,56,0,0,0,0,0,0,False,False,False,0,2,2020-12-15T16:48:51.65,0,,0.0
2020,14,3000,480,3,6454,13,35,5,10,0,0,0,0,0,0,False,False,False,0,4,2020-12-15T16:56:02.42,0,,
2020,14,3000,490,3,6936,2,5,5,4,6,2,5,1,5,0,False,False,False,0,3,2020-12-15T16:59:26.53,6,,1.0
2020,14,3000,515,8,7652,2,32,3,2,9,7,8,1,8,0,True,False,False,0,4,2020-12-17T02:46:13.263,9,,1.0
2020,14,3000,525,8,3606,13,21,6,25,0,0,0,0,0,0,False,False,False,0,2,2020-12-18T18:00:30.74,0,,0.0
2020,14,3000,535,8,232,13,6,9,12,0,0,0,0,0,0,False,False,False,0,3,2021-02-25T17:16:54.713,0,,0.0
2020,14,3000,540,8,4976,2,5,5,14,14,0,14,0,14,0,False,False,False,0,4,2020-12-15T17:12:14.973,14,,0.0
2020,14,3000,545,8,6439,13,48,0,0,0,0,0,0,0,0,False,False,False,0,1,2020-12-15T17:13:44.863,0,,0.0
2020,14,3000,550,8,6439,2,4,5,5,9,4,7,2,7,0,True,False,False,0,2,2020-12-15T17:14:49.21,9,,2.0
2020,14,3000,555,8,5053,2,24,6,24,26,2,26,0,26,0,True,False,False,0,3,2020-12-18T20:33:01.037,26,,0.0
2020,14,3000,585,3,6935,2,8,10,12,15,3,13,2,13,0,False,False,False,0,3,2020-12-15T17:24:32.773,15,,2.0
2020,14,3000,600,3,6454,2,4,4,7,7,0,7,0,7,0,False,False,False,0,4,2020-12-18T18:00:30.74,7,,0.0
2020,14,3000,615,3,2688,13,17,7,28,0,0,0,0,0,0,True,False,False,0,3,2020-12-17T02:46:33.223,0,,0.0
2020,14,3000,620,3,6454,13,35,6,36,0,0,0,0,0,0,False,False,False,0,3,2020-12-15T17:32:25.567,0,,0.0
2020,14,3000,630,8,3606,13,4,3,5,0,0,0,0,0,0,False,False,False,0,2,2020-12-15T17:34:14.927,0,,0.0
2020,14,3000,660,8,232,2,50,10,-2,6,8,-1,7,-1,0,False,False,False,4,2,2021-03-04T15:56:47.37,6,,7.0
2020,14,3000,675,8,7652,2,4,3,4,5,1,5,0,5,0,False,False,False,0,4,2020-12-15T17:42:23.26,5,,0.0
2020,14,3000,685,8,232,2,2,10,3,12,9,6,6,6,0,False,False,False,1,2,2020-12-18T19:56:19.803,12,,6.0
2020,14,3000,690,8,3606,13,19,6,37,0,0,0,0,0,0,False,False,False,0,2,2020-12-15T17:45:52.827,0,,
2020,14,3000,705,8,3606,13,4,3,5,0,0,0,0,0,0,False,False,False,0,2,2020-12-15T17:59:05.57,0,,0.0
2020,14,3000,725,8,3606,2,12,2,21,21,0,21,0,21,6,False,False,False,0,2,2020-12-18T20:11:41.307,21,,0.0
2020,14,3000,745,3,6936,13,2,10,11,0,0,0,0,0,0,False,False,False,0,2,2021-02-23T13:33:06.22,0,,0.0
2020,14,3000,750,3,6936,3,5,3,5,0,0,0,0,0,0,False,False,False,0,3,2020-12-15T18:08:13.9,0,,0.0
2020,14,3000,765,8,232,2,46,3,2,12,10,8,4,8,0,True,False,False,0,3,2020-12-15T18:10:31.293,12,,4.0
2020,14,3000,785,8,3606,2,4,3,4,8,4,6,2,6,0,False,False,False,0,2,2020-12-15T18:13:55.86,8,,2.0
2020,14,3000,795,8,3606,2,5,3,9,10,1,10,0,10,0,False,False,False,0,3,2020-12-15T18:16:18.82,10,,0.0
2020,14,3000,810,8,4976,13,17,10,5,0,0,0,0,0,0,False,False,False,0,3,2021-02-23T13:33:37.623,0,,0.0
2020,14,3000,845,3,2688,2,4,9,13,13,0,13,0,13,0,False,False,False,0,3,2020-12-18T20:15:30.923,13,,0.0
2020,14,3000,880,3,6936,2,19,8,22,44,22,44,0,44,6,False,False,False,0,3,2020-12-18T20:17:01.11,44,,0.0
2020,14,3000,895,8,7651,2,29,6,25,30,5,25,5,25,0,False,False,False,0,2,2020-12-15T18:34:15.56,30,,5.0
2020,14,3000,905,8,232,2,12,5,7,7,0,7,0,7,0,False,False,False,0,3,2020-12-15T18:35:31.583,7,,0.0
2020,14,3000,910,8,5053,2,6,9,1,16,15,13,3,13,0,False,False,False,0,1,2020-12-15T18:36:57.35,16,,3.0
2020,14,3000,915,8,5053,2,4,3,6,22,16,20,2,20,6,False,False,False,1,2,2020-12-15T18:37:56.96,22,,2.0
2020,14,3000,930,3,6454,2,31,10,5,14,9,5,9,5,0,False,False,False,1,4,2020-12-15T18:40:47.897,14,,9.0
2020,14,3000,935,3,6454,2,6,4,8,14,6,11,3,11,0,False,False,False,0,3,2020-12-18T20:17:46.683,14,,3.0
2020,14,3000,950,3,2688,2,13,9,3,6,3,6,0,6,0,False,False,False,0,3,2020-12-18T20:18:26.243,6,,0.0
2020,14,3000,955,3,6454,2,5,10,6,4,-2,4,0,4,0,False,False,False,0,3,2020-12-15T18:45:18.61,4,,0.0
2020,14,3000,975,8,5053,2,16,4,5,2,-3,2,0,2,0,False,True,False,0,1,2020-12-17T04:38:15.047,2,,0.0
2020,15,3001,15,23,2256,2,6,9,4,6,2,4,2,4,0,False,False,False,1,2,2021-03-09T17:48:28.71,6,,2.0
2020,15,3001,20,23,7250,13,24,5,4,0,0,0,0,0,0,False,False,False,0,3,2021-03-09T17:49:14.237,0,,0.0
2020,15,3001,35,26,4616,2,31,4,0,8,8,5,3,5,0,False,False,False,0,1,2020-12-18T13:12:02.467,8,,3.0
2020,15,3001,50,26,4282,2,4,10,11,14,3,11,3,11,0,False,False,False,1,3,2021-03-09T17:50:04.363,14,,3.0
2020,15,3001,60,26,7514,2,4,2,15,18,3,17,1,17,0,False,False,False,0,2,2020-12-18T13:42:35.433,18,,1.0
2020,15,3001,70,26,4619,2,4,5,7,8,1,6,2,6,0,False,False,False,0,2,2020-12-18T13:45:29.883,8,,2.0
2020,15,3001,75,26,309,2,5,5,5,17,12,17,0,17,0,True,False,False,0,3,2020-12-18T13:47:05.403,17,,0.0
2020,15,3001,85,26,4282,2,2,9,6,10,4,10,0,10,6,False,False,False,0,3,2020-12-18T13:52:10.913,10,,0.0
2020,15,3001,100,23,7241,2,4,4,5,17,12,5,12,5,0,False,False,False,1,1,2020-12-18T13:56:05.917,17,,12.0
2020,15,3001,120,23,2256,2,35,7,16,30,14,26,4,26,0,False,False,False,0,3,2020-12-18T14:04:26.913,30,,4.0
2020,15,3001,150,26,7697,2,51,3,-2,5,7,4,1,4,0,True,False,False,0,3,2020-12-18T14:13:02.573,5,,1.0
2020,15,3001,160,26,7514,2,4,7,16,17,1,17,0,17,0,False,False,False,0,2,2021-03-09T17:51:44.38,17,,0.0
2020,15,3001,170,26,4616,2,44,3,-7,3,10,-1,4,-1,0,False,False,False,0,1,2020-12-21T04:13:11.913,3,,4.0
2020,15,3001,180,26,7453,3,13,9,4,0,0,0,0,0,0,False,False,False,0,3,2020-12-18T14:22:23.557,0,,0.0
2020,15,3001,195,23,7246,2,12,6,22,22,0,22,0,22,0,True,False,False,0,2,2020-12-19T17:17:54.79,22,,0.0
2020,15,3001,205,23,2994,2,6,9,12,13,1,12,1,12,0,False,False,False,0,3,2021-03-09T17:52:58.94,13,,1.0
2020,15,3001,220,23,2994,2,19,6,32,35,3,35,0,35,6,False,False,False,0,2,2020-12-18T14:52:24.427,35,,0.0
2020,15,3001,245,26,7453,2,4,10,7,12,5,11,1,11,0,False,False,False,0,3,2021-03-09T17:54:02.637,12,,1.0
2020,15,3001,250,26,4282,2,12,2,15,15,0,15,0,15,0,False,False,False,0,4,2020-12-18T19:33:31.84,15,,0.0
2020,15,3001,255,26,309,13,2,5,3,0,0,0,0,0,0,False,False,False,0,2,2020-12-21T04:12:49.357,0,,0.0
2020,15,3001,265,26,4282,2,12,10,6,7,1,6,1,6,0,False,False,False,0,3,2020-12-18T15:02:52.773,7,,1.0
2020,15,3001,280,26,7453,2,12,3,7,11,4,11,0,11,0,False,False,False,0,3,2021-03-09T13:21:32.29,11,,0.0
2020,15,3001,300,26,309,13,5,3,4,0,0,0,0,0,0,True,False,False,0,3,2021-03-09T17:55:41.493,0,,0.0
2020,15,3001,320,23,2994,2,4,10,5,6,1,5,1,5,0,False,False,False,0,3,2021-03-09T17:56:25.677,6,,1.0
2020,15,3001,330,23,7250,2,26,9,4,4,0,4,0,4,0,True,False,False,0,3,2020-12-21T03:35:09.453,4,,0.0
2020,15,3001,345,26,4616,2,48,10,-4,-2,2,-3,1,-3,0,False,False,False,1,1,2020-12-18T15:25:44.21,-2,,1.0
2020,15,3001,350,26,7514,13,12,2,43,0,0,0,0,0,0,False,False,False,0,2,2021-03-09T13:22:10.123,0,,0.0
2020,15,3001,355,26,7697,2,7,2,18,25,7,25,0,25,0,False,False,False,0,2,2020-12-21T03:35:09.453,25,,0.0
2020,15,3001,360,26,7514,2,7,2,22,26,4,25,1,25,6,False,False,False,0,2,2020-12-21T04:21:38.517,26,,1.0
2020,15,3001,390,26,7453,13,3,5,12,0,0,0,0,0,0,False,False,False,0,2,2021-03-09T17:58:04.523,0,,
2020,15,3001,400,26,7697,2,2,10,5,9,4,8,1,8,0,False,False,False,0,3,2020-12-18T15:42:21.463,9,,1.0
2020,15,3001,420,23,2256,3,50,9,-3,0,0,0,0,0,0,False,False,False,0,3,2020-12-18T15:49:19.04,0,,0.0
2020,15,3001,425,23,2994,13,6,10,14,0,0,0,0,0,0,False,False,False,0,2,2021-03-09T17:59:15.61,0,,0.0
2020,15,3001,430,23,2994,2,13,10,5,25,20,23,2,23,0,False,False,False,0,4,2021-03-09T17:59:59.693,25,,2.0
2020,15,3001,460,23,2256,13,22,3,11,0,0,0,0,0,0,False,False,False,0,2,2020-12-21T03:35:09.453,0,,
2020,15,3001,480,26,7514,13,3,2,20,0,0,0,0,0,0,False,False,False,0,2,2020-12-18T16:58:32.557,0,,0.0
2020,15,3001,485,26,7453,2,5,2,15,15,0,15,0,15,0,False,False,False,0,3,2020-12-18T17:00:24.393,15,,0.0
2020,15,3001,490,26,8177,3,32,5,1,0,0,0,0,0,0,False,False,False,0,1,2020-12-21T03:54:07.29,0,,0.0
2020,15,3001,495,26,4619,2,6,10,14,14,0,14,0,14,0,True,False,False,0,2,2020-12-18T17:09:03.257,14,,0.0
2020,15,3001,510,26,7453,13,17,1,36,0,0,0,0,0,0,False,False,False,0,3,2020-12-18T17:11:53.2,0,,0.0
2020,15,3001,520,26,4616,2,47,5,2,10,8,8,2,8,0,False,False,False,0,1,2020-12-18T17:14:42.807,10,,2.0
2020,15,3001,525,26,4282,2,39,4,6,19,13,9,10,9,0,False,False,False,0,4,2020-12-21T04:23:23.497,19,,10.0
2020,15,3001,530,26,4282,13,17,10,12,0,0,0,0,0,0,False,False,False,0,4,2020-12-18T17:19:54.81,0,,0.0
2020,15,3001,540,26,4619,13,7,5,11,0,0,0,0,0,0,False,False,False,0,3,2020-12-19T19:19:04.587,0,,
2020,15,3001,565,23,2994,2,4,3,6,10,4,8,2,8,0,False,False,False,0,2,2020-12-18T17:30:26.04,10,,2.0
2020,15,3001,570,23,2994,13,11,5,10,0,0,0,0,0,0,False,False,False,0,4,2021-03-09T18:06:30.62,0,,0.0
2020,15,3001,590,23,2256,2,4,9,4,4,0,4,0,4,0,False,False,False,0,3,2020-12-18T17:58:53.923,4,,0.0
2020,15,3001,600,23,2256,13,17,1,19,0,0,0,0,0,0,False,False,False,0,3,2020-12-18T18:01:41.447,0,,0.0
2020,15,3001,615,23,3843,2,50,10,0,7,7,5,2,5,0,False,False,False,1,3,2021-03-09T18:07:50.373,7,,2.0
2020,15,3001,620,23,7241,2,47,10,3,15,12,13,2,13,0,False,False,False,0,1,2020-12-21T04:24:28.857,15,,2.0
2020,15,3001,630,23,2994,2,2,10,12,14,2,13,1,13,0,False,False,False,0,3,2021-02-23T15:47:46.79,14,,1.0
2020,15,3001,650,23,2994,2,13,9,4,7,3,6,1,6,0,False,False,False,0,4,2020-12-18T18:15:59.473,7,,1.0
2020,15,3001,700,26,4282,13,2,9,7,0,0,0,0,0,0,False,False,False,0,3,2020-12-18T18:26:55.55,0,,0.0
2020,15,3001,715,23,2994,2,12,6,15,15,0,15,0,15,0,False,False,False,0,4,2020-12-21T04:26:17.18,15,,0.0
2020,15,3001,720,23,2994,2,11,2,23,25,2,25,0,25,0,False,False,False,0,4,2020-12-18T18:31:42.247,25,,0.0
2020,15,3001,730,23,4949,13,2,10,5,0,0,0,0,0,0,False,False,False,0,3,2021-03-05T15:23:41.553,0,,0.0
2020,15,3001,770,23,2256,13,24,2,29,0,0,0,0,0,0,False,False,False,0,3,2020-12-18T18:45:30.6,0,,0.0
2020,15,3001,775,23,2256,13,35,7,17,0,0,0,0,0,0,False,False,False,0,3,2020-12-19T17:20:36.52,0,,0.0
2020,15,3001,780,23,2256,2,5,5,4,9,5,4,5,4,0,True,False,False,1,3,2021-03-09T18:10:11.787,9,,5.0
2020,15,3001,820,23,4949,2,4,10,9,9,0,9,0,9,0,True,False,False,0,3,2020-12-18T18:57:47.87,9,,0.0
2020,15,3001,830,23,2994,13,21,6,27,0,0,0,0,0,0,True,False,False,0,3,2020-12-18T19:01:39.33,0,,0.0
2020,15,3001,845,23,7241,2,45,10,-5,6,11,5,1,5,0,False,False,False,1,1,2020-12-21T04:14:59.597,6,,1.0
2020,15,3001,875,23,7240,13,47,5,1,0,0,0,0,0,0,False,False,False,0,1,2020-12-18T19:31:54,0,,0.0
2020,15,3001,890,26,7491,13,32,10,1,0,0,0,0,0,0,False,False,False,0,4,2020-12-18T19:16:34.28,0,,0.0
2020,15,3001,895,26,7453,13,7,2,35,0,0,0,0,0,0,False,False,False,0,3,2021-03-09T18:11:27.22,0,,
2020,15,3001,900,26,7453,2,19,6,45,53,8,51,2,51,0,False,False,False,0,2,2020-12-21T04:32:39.963,53,,2.0
2020,15,3002,15,5,5220,2,30,5,-2,2,4,0,2,0,0,False,False,False,0,3,2021-08-12T13:10:21.323,2,,2.0
2020,15,3002,25,5,5220,13,12,4,6,0,0,0,0,0,0,False,False,False,0,3,2021-08-12T14:43:26.663,0,,0.0
2020,15,3002,40,12,4537,2,51,5,-5,9,14,6,3,6,0,True,False,False,0,1,2021-08-02T20:30:48.467,9,,3.0
2020,15,3002,50,12,4561,2,51,10,-5,12,17,5,7,5,0,False,False,False,0,1,2021-08-12T16:25:11.65,12,,7.0
2020,15,3002,60,12,4511,2,12,3,5,7,2,7,0,7,0,False,False,False,0,4,2021-08-12T14:32:00.2,7,,0.0
2020,15,3002,65,12,4511,2,47,5,-1,1,2,1,0,1,6,False,False,False,0,4,2021-08-02T20:36:37.107,1,,0.0
2020,15,3002,85,5,5220,2,19,6,33,37,4,37,0,37,0,False,False,False,0,2,2021-08-03T15:07:47.283,37,,0.0
2020,15,3002,95,5,6425,2,13,3,2,15,13,13,2,13,0,False,False,False,0,4,2021-08-12T14:34:21.417,15,,2.0
2020,15,3002,100,5,4803,3,51,10,-5,0,0,0,0,0,0,False,False,False,0,3,2021-08-03T15:10:14.307,0,,0.0
2020,15,3002,110,5,2554,2,4,4,1,8,7,6,2,6,0,True,False,False,0,1,2021-08-03T15:11:28.497,8,,2.0
2020,15,3002,130,12,556,2,49,9,-1,1,2,1,0,1,0,False,False,False,0,3,2021-08-13T18:06:16.547,1,,0.0
2020,15,3002,135,12,556,2,6,9,14,14,0,14,0,14,0,False,False,False,0,3,2021-08-13T18:06:24.807,14,,0.0
2020,15,3002,140,12,4537,3,45,5,-4,0,0,0,0,0,0,False,False,False,0,1,2021-08-12T14:36:32.433,0,,0.0
2020,15,3002,145,12,4561,2,46,3,2,2,0,2,0,2,0,False,False,False,0,1,2021-08-03T16:24:21.937,2,,0.0
2020,15,3002,150,12,6357,13,17,8,22,0,0,0,0,0,0,False,False,False,0,3,2021-08-13T18:07:03.937,0,,
2020,15,3002,165,12,556,2,51,10,1,14,13,13,1,13,0,False,False,False,0,3,2021-08-12T14:40:03.027,14,,1.0
2020,15,3002,235,5,4803,2,4,9,5,5,0,5,0,5,0,False,True,False,0,3,2021-08-13T18:09:17.327,6,False,0.0
2020,15,3002,245,5,4803,2,2,4,6,16,10,9,7,9,0,False,False,False,0,3,2021-08-04T14:39:42.137,16,,7.0
2020,15,3002,280,12,556,2,18,3,0,6,6,5,1,5,0,False,False,False,0,2,2021-08-04T14:51:13.11,6,,1.0
2020,15,3002,320,5,4803,3,51,9,-5,0,0,0,0,0,0,True,False,False,0,1,2021-08-04T15:14:40.027,0,,0.0
2020,15,3002,325,5,3389,13,2,4,10,0,0,0,0,0,0,True,False,False,0,3,2021-08-04T15:15:40.127,0,,0.0
2020,15,3002,330,5,5220,13,4,10,12,0,0,0,0,0,0,False,False,False,0,3,2021-08-04T15:16:58.667,0,,0.0
2020,15,3002,340,12,556,3,35,2,19,0,0,0,0,0,0,False,False,False,0,3,2021-08-13T18:16:37.82,0,,0.0
2020,15,3002,345,12,6691,2,5,5,6,12,6,12,0,12,0,True,False,False,0,3,2021-08-04T15:19:18.273,12,,0.0
2020,15,3002,350,12,6691,2,51,9,-3,4,7,-3,7,-3,0,False,False,False,1,3,2021-08-04T15:20:37.797,4,,7.0
2020,15,3002,395,5,5220,2,5,3,12,20,8,13,7,13,0,False,False,False,0,3,2021-08-04T15:27:05.96,20,,7.0
2020,15,3002,400,5,6425,13,6,10,14,0,0,0,0,0,0,False,False,False,0,4,2021-08-13T18:19:45.893,0,,0.0
2020,15,3002,405,5,4803,13,5,5,13,0,0,0,0,0,0,False,False,False,0,3,2021-08-04T15:29:30.09,0,,0.0
2020,15,3002,410,5,4803,13,6,4,11,0,0,0,0,0,0,False,False,False,0,4,2021-08-04T15:30:18.22,0,,0.0
2020,15,3002,425,12,556,2,51,9,0,7,7,6,1,6,0,False,False,False,0,3,2021-08-04T15:34:02.247,3,,1.0
2020,15,3002,430,12,6691,2,4,5,8,14,6,13,1,13,0,False,False,False,0,2,2021-08-04T15:42:59.05,14,,1.0
2020,15,3002,435,12,6691,3,12,6,31,0,0,0,0,0,0,False,False,False,0,3,2021-08-04T15:46:48.3,0,,0.0
2020,15,3002,455,12,556,3,2,10,7,0,0,0,0,0,0,False,False,False,0,3,2021-08-04T16:55:23.257,0,,0.0
2020,15,3002,460,12,6357,13,19,2,31,0,0,0,0,0,0,False,False,False,0,2,2021-08-04T16:57:57.793,0,,0.0
2020,15,3002,470,5,4803,2,4,9,5,7,2,6,1,6,0,False,False,False,0,3,2021-08-04T16:59:23.743,7,,1.0
2020,15,3002,485,5,2554,2,48,9,-5,-6,-1,-6,0,-6,0,False,False,False,0,1,2021-08-04T17:05:39.527,-6,,0.0
2020,15,3002,490,5,8195,2,4,3,3,6,3,6,0,6,0,False,False,False,0,1,2021-08-04T17:07:56.263,6,,0.0
2020,15,3002,500,12,4537,2,28,3,1,6,5,1,5,1,0,False,False,False,1,1,2021-08-06T20:25:24.38,6,,5.0
2020,15,3002,530,5,5220,2,30,5,1,18,17,16,2,16,0,True,False,False,0,3,2021-08-04T17:35:39.733,18,,2.0
2020,15,3002,540,5,3477,13,21,2,21,0,0,0,0,0,0,False,False,False,0,2,2021-08-04T17:37:05.987,0,,0.0
2020,15,3002,545,5,3477,2,12,5,4,4,0,4,0,4,0,False,False,False,0,3,2021-08-04T17:37:55.457,4,,
2020,15,3002,580,12,6691,2,51,10,-1,4,5,2,2,2,0,False,False,False,0,3,2021-08-04T18:18:18.57,4,,2.0
2020,15,3002,585,12,4537,2,45,5,-2,-2,0,-2,0,-2,0,False,False,False,0,1,2021-08-04T18:20:53.383,-2,,0.0
2020,15,3002,595,5,8195,2,28,4,5,7,2,6,1,6,0,False,False,False,0,1,2021-08-04T18:22:15.033,7,,1.0
2020,15,3002,605,5,4719,2,47,5,2,9,7,7,2,7,0,False,False,False,0,1,2021-08-04T18:23:57.92,9,,2.0
2020,15,3002,620,5,3477,2,4,5,3,6,3,3,3,3,0,False,False,False,0,2,2021-08-04T19:02:07.643,6,,3.0
2020,15,3002,630,5,6425,2,4,9,5,9,4,7,2,7,0,False,False,False,0,4,2021-08-04T19:03:53.353,9,,2.0
2020,15,3002,640,5,3477,2,2,4,5,15,10,9,6,9,0,True,False,False,0,3,2021-08-04T19:13:13.18,15,,6.0
2020,15,3002,650,5,8195,13,4,4,5,0,0,0,0,0,0,False,False,False,0,1,2021-08-04T19:16:45.983,0,,0.0
2020,15,3002,670,5,3477,13,5,3,7,0,0,0,0,0,0,False,False,False,0,3,2021-08-04T19:19:38.26,0,,0.0
2020,15,3002,680,5,4803,2,2,4,9,13,4,11,2,11,0,False,False,False,0,3,2021-08-04T19:21:12.31,13,,2.0
2020,15,3002,695,12,4511,2,5,5,10,10,0,10,0,10,0,False,False,False,0,4,2021-08-04T19:22:57.107,10,,0.0
2020,15,3002,715,12,556,13,5,3,7,0,0,0,0,0,0,False,False,False,0,2,2021-08-04T19:27:06.567,0,,0.0
2020,15,3002,720,12,6691,2,13,10,5,22,17,20,2,20,0,False,False,False,0,3,2021-08-04T19:28:30.4,22,,2.0
2020,15,3002,725,12,556,2,18,3,0,2,2,2,0,2,0,False,False,False,0,2,2021-08-12T14:01:33.447,2,,0.0
2020,15,3002,730,12,556,2,18,3,0,2,2,2,0,2,0,False,False,False,0,3,2021-08-04T19:29:58.63,2,,0.0
2020,15,3002,755,5,6425,2,31,9,3,5,2,4,1,4,0,True,False,False,0,3,2021-08-04T19:33:35.597,5,,1.0
2020,15,3002,770,5,5220,2,5,8,15,14,-1,14,0,14,0,False,False,False,0,2,2021-08-04T19:45:20.113,14,,0.0
2020,15,3002,775,5,5220,2,2,9,5,40,35,8,32,8,0,False,False,False,3,2,2021-08-04T19:48:43.817,40,,32.0
2020,15,3002,830,5,8195,2,46,3,4,11,7,11,0,11,0,False,False,False,0,1,2021-08-04T19:57:21.673,11,,0.0
2020,15,3002,835,5,4803,13,17,1,35,0,0,0,0,0,0,False,False,False,0,3,2021-08-04T19:58:43.833,0,,0.0
2020,15,3002,840,5,3477,13,19,2,39,0,0,0,0,0,0,False,False,False,0,2,2021-08-04T19:59:54.163,0,,
2020,15,3002,845,5,3477,13,5,5,11,0,0,0,0,0,0,False,False,False,0,2,2021-08-04T20:01:22.89,0,,0.0
2020,15,3003,15,10,6840,2,5,3,4,10,6,8,2,8,0,False,False,False,0,4,2020-12-20T14:01:14.217,10,,2.0
2020,15,3003,30,10,3848,13,4,10,4,0,0,0,0,0,0,False,False,False,0,4,2020-12-21T17:46:08.43,0,,0.0
2020,15,3003,50,10,7700,13,5,5,4,0,0,0,0,0,0,False,False,False,0,2,2020-12-20T14:38:18.207,0,,0.0
2020,15,3003,60,4,2853,2,4,10,7,7,0,7,0,7,0,False,False,False,0,2,2020-12-20T14:40:01.883,7,,0.0
2020,15,3003,70,4,6983,2,44,3,-4,2,6,0,2,0,0,False,False,False,0,1,2020-12-20T14:41:59.017,2,,2.0
2020,15,3003,75,4,6953,13,35,5,12,0,0,0,0,0,0,True,False,False,0,1,2020-12-21T19:10:53.28,0,,0.0
2020,15,3003,80,4,2853,2,3,2,15,15,0,15,0,15,0,False,False,False,0,2,2020-12-20T14:44:33.327,15,,0.0
2020,15,3003,85,4,6983,2,44,3,-3,8,11,6,2,6,0,True,False,False,0,1,2020-12-21T19:08:24.37,8,,2.0
2020,15,3003,95,4,7646,13,19,2,22,0,0,0,0,0,0,False,False,False,0,2,2020-12-22T18:12:03.987,0,,
2020,15,3003,100,4,594,2,4,10,5,5,0,5,0,5,0,False,False,False,0,3,2020-12-20T15:00:27.657,5,,0.0
2020,15,3003,105,4,594,13,51,3,-2,0,0,0,0,0,0,False,False,False,0,3,2020-12-20T15:01:33.937,0,,0.0
2020,15,3003,120,4,2853,2,12,5,2,3,1,3,0,3,0,False,False,False,0,2,2020-12-20T15:03:47.153,3,,0.0
2020,15,3003,130,4,6953,2,5,5,9,9,0,9,0,9,6,False,False,False,0,4,2020-12-20T15:06:02.397,9,,0.0
2020,15,3003,145,10,6840,2,35,10,13,16,3,14,2,14,0,False,False,False,0,4,2020-12-20T15:07:49.94,16,,2.0
2020,15,3003,150,10,6840,2,32,3,1,11,10,5,6,5,0,True,False,False,0,4,2020-12-20T15:09:08.367,11,,6.0
2020,15,3003,160,10,282,2,46,3,-2,-2,0,-2,0,-2,0,False,False,False,0,1,2021-02-23T15:04:23.297,-2,,0.0
2020,15,3003,180,4,2853,13,19,6,40,0,0,0,0,0,0,False,False,False,0,2,2020-12-22T18:09:39,0,,
2020,15,3003,195,4,2853,2,6,9,5,12,7,8,4,8,0,False,False,False,0,2,2020-12-20T15:23:17.637,12,,4.0
2020,15,3003,200,4,2853,13,4,8,16,0,0,0,0,0,0,False,False,False,0,3,2020-12-21T19:11:31.003,0,,0.0
2020,15,3003,210,4,2853,2,4,10,4,4,0,4,0,4,0,False,False,False,0,3,2020-12-21T19:08:36.71,4,,0.0
2020,15,3003,215,4,594,2,2,4,7,17,10,16,1,16,0,False,False,False,0,3,2020-12-20T15:30:12.563,17,,1.0
2020,15,3003,220,4,2853,2,3,2,15,15,0,15,0,15,0,False,False,False,0,2,2020-12-20T15:31:20.03,15,,0.0
2020,15,3003,225,4,594,13,24,6,27,0,0,0,0,0,0,False,False,False,0,3,2020-12-21T19:14:55.037,0,,0.0
2020,15,3003,250,10,4930,13,8,10,13,0,0,0,0,0,0,False,False,False,0,3,2020-12-20T15:51:36.407,0,,0.0
2020,15,3003,260,10,7700,3,5,2,15,0,0,0,0,0,0,False,False,False,0,3,2020-12-20T15:54:14.983,0,,0.0
2020,15,3003,270,10,6481,2,28,5,0,8,8,6,2,6,0,False,False,False,0,1,2020-12-20T15:56:58.603,8,,2.0
2020,15,3003,290,10,7701,13,4,3,5,0,0,0,0,0,0,False,False,False,0,3,2020-12-20T16:01:34.747,0,,0.0
2020,15,3003,315,4,7646,13,4,10,10,0,0,0,0,0,0,False,False,False,0,2,2021-02-23T15:06:01.687,0,,0.0
2020,15,3003,320,4,2853,13,22,6,28,0,0,0,0,0,0,False,False,False,0,2,2020-12-21T19:14:55.037,0,,0.0
2020,15,3003,330,10,6840,13,13,9,3,0,0,0,0,0,0,False,False,False,0,4,2020-12-20T16:15:31.657,0,,0.0
2020,15,3003,340,10,6840,13,9,6,15,0,0,0,0,0,0,False,False,False,0,3,2020-12-20T16:17:50.78,0,,0.0
2020,15,3003,350,4,2853,2,4,5,4,11,7,3,8,3,0,False,False,False,2,2,2020-12-20T16:19:46.14,11,,8.0
2020,15,3003,355,4,7646,2,13,5,5,11,6,12,-1,12,0,False,False,False,0,3,2020-12-20T16:27:23.433,11,,-1.0
2020,15,3003,360,4,6953,2,35,7,17,27,10,25,2,25,0,False,False,False,1,4,2020-12-22T18:10:06.233,27,,2.0
2020,15,3003,370,4,5119,2,13,9,1,13,12,12,1,12,0,False,False,False,1,3,2020-12-20T16:32:24.733,13,,
2020,15,3003,385,4,5119,2,50,5,-1,8,9,7,1,7,0,False,False,False,0,2,2020-12-21T19:12:30.76,8,,1.0
2020,15,3003,390,4,2630,2,17,1,22,22,0,22,0,22,6,True,False,False,0,3,2020-12-21T19:10:43.9,22,,0.0
2020,15,3003,405,10,6840,2,4,10,4,5,1,5,0,5,0,False,False,False,0,4,2020-12-20T16:37:53.783,5,,0.0
2020,15,3003,410,10,6840,2,5,10,4,5,1,4,1,4,0,False,False,False,0,4,2020-12-20T16:38:55.147,5,,1.0
2020,15,3003,420,10,282,2,28,10,1,9,8,6,3,6,0,False,False,False,1,1,2020-12-20T16:40:16.273,9,,3.0
2020,15,3003,425,10,282,2,28,9,0,6,6,3,3,3,0,False,False,False,0,1,2020-12-20T16:41:24.267,6,,3.0
2020,15,3003,440,10,7700,13,9,3,14,0,0,0,0,0,0,False,False,False,0,2,2020-12-20T16:43:27.847,0,,
2020,15,3003,450,10,4930,2,26,3,4,6,2,5,1,5,0,False,False,False,0,2,2021-02-23T15:06:50.8,6,,1.0
2020,15,3003,455,10,7701,13,32,10,1,0,0,0,0,0,0,False,False,False,0,3,2020-12-20T16:46:34.283,0,,0.0
2020,15,3003,460,10,7700,2,22,2,19,19,0,19,0,19,0,False,False,False,0,2,2020-12-22T19:24:46.6,19,,0.0
2020,15,3003,475,10,6840,2,7,3,6,6,0,6,0,6,6,False,False,False,0,4,2021-02-23T15:07:47.7,6,,0.0
2020,15,3003,500,4,594,2,6,6,22,22,0,22,0,22,0,False,False,False,0,3,2021-02-23T15:08:14.287,22,,0.0
2020,15,3003,505,4,7646,13,12,2,21,0,0,0,0,0,0,False,False,False,0,2,2020-12-20T17:07:50.553,0,,0.0
2020,15,3003,510,4,594,2,5,5,6,10,4,9,1,9,0,False,False,False,0,3,2020-12-20T17:08:54.697,10,,1.0
2020,15,3003,520,4,594,2,26,9,1,7,6,5,2,5,0,False,False,False,0,3,2020-12-20T17:11:42.433,7,,2.0
2020,15,3003,525,4,2853,2,6,10,5,6,1,5,1,5,0,False,False,False,0,2,2020-12-20T17:12:43.29,6,,1.0
2020,15,3003,530,4,7646,2,13,10,7,7,0,7,0,7,0,False,False,False,0,3,2020-12-21T19:09:12.59,7,,0.0
2020,15,3003,570,10,6481,2,48,9,-4,-6,-2,-7,1,-7,0,False,False,False,1,1,2020-12-20T17:37:57.273,-6,,1.0
2020,15,3003,575,10,6840,13,53,4,-5,0,0,0,0,0,0,False,False,False,0,4,2020-12-20T17:38:52.46,0,,0.0
2020,15,3003,585,4,2853,2,21,2,49,55,6,52,3,52,0,False,False,False,0,2,2020-12-20T17:41:03.523,55,,3.0
2020,15,3003,595,4,6983,2,30,10,0,6,6,4,2,4,0,False,False,False,0,1,2020-12-21T19:14:55.037,6,,2.0
2020,15,3003,600,4,2853,2,4,4,3,3,0,3,0,3,0,False,False,False,0,3,2020-12-21T19:09:23.76,3,,0.0
2020,15,3003,620,10,7701,3,47,10,0,0,0,0,0,0,0,False,False,False,0,4,2020-12-20T17:47:38.513,0,,0.0
2020,15,3003,635,4,594,2,6,9,13,20,7,12,8,12,0,False,False,False,0,3,2020-12-20T17:51:45.857,20,,8.0
2020,15,3003,640,4,594,2,51,3,-2,4,6,3,1,3,0,False,False,False,0,3,2020-12-20T17:52:51.073,4,,1.0
2020,15,3003,645,4,1377,13,38,10,5,0,0,0,0,0,0,False,False,False,0,4,2020-12-22T19:24:46.6,0,,0.0
2020,15,3003,650,4,2853,2,35,2,15,16,1,16,0,16,0,False,False,False,0,3,2020-12-20T17:54:59.05,16,,0.0
2020,15,3003,660,4,6983,13,12,5,0,0,0,0,0,0,0,False,False,False,0,1,2020-12-22T19:20:52.57,0,,
2020,15,3003,670,4,1377,2,38,4,1,1,0,1,0,1,6,False,False,False,0,4,2020-12-22T19:24:46.6,1,,
2020,15,3003,680,4,5119,2,30,3,-3,7,10,6,1,6,6,True,False,False,1,1,2020-12-21T19:10:33.39,7,,
2020,15,3003,685,4,7646,13,12,4,12,0,0,0,0,0,0,False,False,False,0,3,2020-12-20T18:10:53.457,0,,0.0
2020,15,3003,710,10,6840,2,5,5,5,9,4,8,1,8,0,False,False,False,0,4,2020-12-20T18:13:54.247,9,,1.0
2020,15,3003,725,10,4930,2,18,10,-3,-2,1,-3,1,-3,0,False,False,False,0,2,2020-12-20T18:18:00.483,-2,,1.0
2020,15,3003,735,10,7700,13,4,3,9,0,0,0,0,0,0,False,False,False,0,2,2020-12-22T19:24:46.6,0,,0.0
2020,15,3003,765,4,594,2,2,4,10,27,17,22,5,22,0,False,False,False,0,3,2020-12-20T18:27:57.187,27,,5.0
2020,15,3003,775,4,6953,13,33,2,17,0,0,0,0,0,0,False,False,False,0,4,2020-12-20T18:30:31.307,0,,0.0
2020,15,3003,815,10,6840,2,39,4,5,6,1,5,1,5,0,False,False,False,0,4,2020-12-20T19:06:26.867,6,,1.0
2020,15,3003,820,10,7701,2,39,4,4,4,0,4,0,4,0,False,False,False,0,3,2020-12-20T19:07:16.877,4,,0.0
2020,15,3003,825,10,6481,2,28,3,-2,5,7,4,1,4,0,False,False,False,0,1,2020-12-20T19:08:35.29,5,,1.0
2020,15,3003,840,10,7700,13,4,3,10,0,0,0,0,0,0,False,False,False,0,2,2020-12-20T19:11:36.51,0,,0.0
2020,15,3003,845,10,4930,2,4,10,3,10,7,7,3,7,0,True,False,False,0,3,2020-12-21T17:44:55.58,10,,3.0
2020,15,3003,850,10,282,2,4,4,1,7,6,7,0,7,0,False,False,False,0,1,2020-12-20T19:16:58.97,7,,0.0
2020,15,3004,15,13,876,2,4,9,4,4,0,4,0,4,0,False,False,False,0,3,2020-12-24T18:04:20.23,4,,0.0
2020,15,3004,40,14,7582,13,11,6,18,0,0,0,0,0,0,False,False,False,0,1,2021-02-23T15:22:08.277,0,,0.0
2020,15,3004,45,14,7582,2,47,10,0,7,7,5,2,5,0,False,False,False,0,1,2020-12-21T11:19:00.963,7,,2.0
2020,15,3004,50,14,1119,2,39,4,4,7,3,5,2,5,0,False,False,False,0,3,2020-12-24T16:41:01.487,7,,2.0
2020,15,3004,65,14,4449,2,35,10,11,13,2,12,1,12,0,True,False,False,0,4,2020-12-24T16:33:33.69,13,,1.0
2020,15,3004,80,14,1119,2,46,3,4,7,3,6,1,6,0,False,False,False,0,4,2020-12-24T16:41:01.487,7,,1.0
2020,15,3004,110,13,6529,2,35,9,14,15,1,15,0,15,0,False,False,False,0,3,2020-12-21T14:16:48.037,15,,0.0
2020,15,3004,120,13,4733,13,35,9,9,0,0,0,0,0,0,False,False,False,0,3,2020-12-21T11:38:32.87,0,,0.0
2020,15,3004,130,14,5197,2,12,10,2,4,2,2,2,2,0,False,False,False,1,4,2020-12-21T11:42:57.597,4,,2.0
2020,15,3004,140,14,4449,2,9,6,23,26,3,26,0,26,0,False,False,False,0,3,2020-12-21T11:45:30.63,26,,0.0
2020,15,3004,145,14,4449,2,8,10,11,11,0,11,0,11,6,False,False,False,0,3,2020-12-21T11:46:33.78,11,,0.0
2020,15,3004,170,13,876,2,6,9,6,6,0,6,0,6,0,False,False,False,0,2,2020-12-21T11:50:12.943,6,,0.0
2020,15,3004,180,13,6880,2,5,9,7,9,2,8,1,8,0,False,False,False,0,4,2020-12-21T11:52:35.827,9,,1.0
2020,15,3004,185,13,6529,13,7,2,18,0,0,0,0,0,0,False,False,False,0,2,2020-12-21T11:53:53.403,0,,0.0
2020,15,3004,190,13,4662,2,4,10,5,11,6,5,6,5,0,False,False,False,0,4,2020-12-24T18:05:53.9,11,,6.0
2020,15,3004,205,13,6529,2,50,10,-3,11,14,8,3,8,0,True,False,False,0,3,2020-12-21T11:58:26.757,11,,3.0
2020,15,3004,215,14,1114,2,4,10,6,7,1,6,1,6,0,False,False,False,0,3,2020-12-21T12:01:54.837,7,,1.0
2020,15,3004,235,14,5197,2,32,5,5,10,5,8,2,8,0,False,False,False,1,4,2020-12-24T17:19:48.273,10,,2.0
2020,15,3004,250,13,2455,2,45,5,-4,2,6,0,2,0,0,False,False,False,0,1,2020-12-21T14:05:32.03,2,,2.0
2020,15,3004,255,13,4733,2,6,8,16,17,1,17,0,17,0,False,False,False,0,3,2020-12-24T18:04:35.54,17,,0.0
2020,15,3004,275,13,2455,2,12,8,20,26,6,24,2,24,0,False,False,False,1,1,2021-02-23T15:25:17.233,26,,2.0
2020,15,3004,280,13,4733,2,35,6,23,38,15,38,0,38,6,False,False,False,0,3,2020-12-21T12:17:44.29,38,,0.0
2020,15,3004,295,14,1114,2,3,6,17,15,-2,15,0,15,0,False,False,False,0,3,2020-12-24T16:41:01.487,15,,0.0
2020,15,3004,305,14,6543,2,4,10,2,2,0,2,0,2,0,False,False,False,0,1,2020-12-21T12:21:31.22,2,,0.0
2020,15,3004,315,14,895,13,13,9,6,0,0,0,0,0,0,False,False,False,0,3,2020-12-24T16:41:01.487,0,,0.0
2020,15,3004,330,13,6529,2,5,5,5,5,0,5,0,5,0,False,False,False,0,3,2020-12-21T12:25:57.983,5,,0.0
2020,15,3004,335,13,876,2,4,5,6,12,6,11,1,11,0,False,False,False,0,2,2020-12-21T12:26:49.433,12,,1.0
2020,15,3004,350,13,6528,2,7,2,18,20,2,19,1,19,0,False,False,False,0,4,2020-12-21T12:32:04.923,20,,1.0
2020,15,3004,355,13,876,2,5,5,14,14,0,14,0,14,0,False,False,False,0,2,2020-12-21T12:33:16.247,14,,0.0
2020,15,3004,360,13,876,13,9,2,22,0,0,0,0,0,0,False,False,False,0,2,2020-12-21T12:34:10.337,0,,0.0
2020,15,3004,365,13,6528,2,12,10,7,9,2,9,0,9,0,False,False,False,0,4,2020-12-21T12:35:17.743,9,,0.0
2020,15,3004,415,14,7584,2,4,10,6,13,7,11,2,11,0,False,False,False,0,2,2020-12-21T12:43:42.907,13,,2.0
2020,15,3004,420,14,6543,2,48,9,-7,9,16,5,4,5,0,False,False,False,0,1,2020-12-21T12:44:44.663,9,,4.0
2020,15,3004,425,14,4449,13,2,4,7,0,0,0,0,0,0,False,False,False,0,3,2020-12-21T12:46:01.17,0,,0.0
2020,15,3004,460,14,1114,13,12,8,15,0,0,0,0,0,0,False,False,False,0,3,2020-12-22T17:31:56.42,0,,0.0
2020,15,3004,465,14,7582,2,28,10,-1,0,1,0,0,0,0,False,False,False,0,1,2020-12-21T12:53:03.09,0,,0.0
2020,15,3004,470,14,7582,2,48,9,-7,0,7,-1,1,-1,0,False,False,False,0,1,2020-12-21T12:54:02.18,0,,1.0
2020,15,3004,485,13,2455,2,47,10,4,4,0,4,0,4,0,False,True,False,0,1,2020-12-21T14:06:07.173,4,,0.0
2020,15,3004,495,13,6529,3,2,4,9,0,0,0,0,0,0,False,False,False,0,3,2020-12-21T13:00:47.153,0,,0.0
2020,15,3004,500,13,2455,2,12,7,15,31,16,18,13,18,0,False,False,False,1,1,2020-12-21T14:06:25.34,31,,13.0
2020,15,3004,515,13,876,2,12,5,7,7,0,7,0,7,0,False,False,False,0,2,2020-12-24T17:57:15.397,7,,0.0
2020,15,3004,520,13,2455,2,48,9,-4,2,6,-3,5,-3,0,False,False,False,2,1,2021-02-23T15:25:56.307,2,,5.0
2020,15,3004,535,13,8227,2,46,3,6,7,1,6,1,6,0,False,False,False,0,1,2020-12-24T16:33:19.56,7,,1.0
2020,15,3004,545,13,2455,2,45,5,-4,-2,2,-2,0,-2,0,False,False,False,0,1,2020-12-22T18:05:25.057,-2,,0.0
2020,15,3004,560,14,4449,2,35,6,19,24,5,24,0,24,0,False,False,False,0,3,2020-12-21T13:15:09.243,24,,0.0
2020,15,3004,585,14,6543,3,13,5,3,0,0,0,0,0,0,True,False,False,0,3,2020-12-22T17:34:21.69,0,,0.0
2020,15,3004,600,13,2455,2,46,9,1,14,13,13,1,13,0,False,False,False,1,1,2020-12-21T14:07:05.46,14,,1.0
2020,15,3004,605,13,2455,2,51,10,0,5,5,3,2,3,0,False,False,False,0,3,2020-12-21T14:07:59.923,5,,2.0
2020,15,3004,625,13,6880,2,35,8,18,23,5,19,4,19,0,False,False,False,0,4,2020-12-21T13:28:42.817,23,,4.0
2020,15,3004,635,13,6528,2,5,5,5,6,1,6,0,6,0,False,False,False,0,4,2020-12-21T13:30:39.153,6,,0.0
2020,15,3004,640,13,2455,2,4,10,3,8,5,6,2,6,0,False,False,False,0,1,2020-12-21T14:08:41.69,8,,2.0
2020,15,3004,645,13,6529,2,2,4,9,9,0,9,0,9,6,False,False,False,0,3,2020-12-24T17:58:45.27,9,,0.0
2020,15,3004,660,14,1114,13,6,9,7,0,0,0,0,0,0,False,False,False,0,2,2020-12-21T13:34:16.273,0,,0.0
2020,15,3004,665,14,1114,2,13,9,2,8,6,7,1,7,0,False,False,False,0,3,2020-12-24T18:06:34.16,8,,1.0
2020,15,3004,670,14,895,2,13,4,2,8,6,6,2,6,0,False,False,False,0,4,2020-12-24T17:20:33.837,8,,2.0
2020,15,3004,680,14,7582,2,45,10,-4,5,9,3,2,3,0,False,False,False,0,1,2020-12-21T13:38:49.737,5,,2.0
2020,15,3004,690,14,7584,2,2,9,5,6,1,5,1,5,0,False,False,False,0,2,2020-12-21T13:40:18.46,6,,1.0
2020,15,3004,700,14,1114,13,46,3,3,0,0,0,0,0,0,False,False,False,0,3,2020-12-24T16:41:01.487,0,,
2020,15,3004,705,14,7584,13,5,6,17,0,0,0,0,0,0,False,False,False,0,2,2021-02-23T15:26:57.41,0,,0.0
2020,15,3004,710,14,1114,2,17,1,30,41,11,38,3,38,0,False,False,False,0,3,2020-12-21T13:45:52.697,41,,3.0
2020,15,3004,730,14,4449,2,44,3,-4,5,9,3,2,3,6,True,False,False,0,3,2020-12-21T13:48:09.503,5,,2.0
2020,15,3004,745,13,6528,13,5,10,3,0,0,0,0,0,0,False,False,False,0,4,2020-12-24T16:33:45.513,0,,0.0
2020,15,3004,755,13,6528,2,32,5,2,5,3,5,0,5,0,False,False,False,0,4,2020-12-21T13:52:53.283,5,,0.0
2020,15,3004,760,13,876,2,3,2,16,16,0,16,0,16,0,False,False,False,0,3,2020-12-24T18:04:56.44,16,,0.0
2020,15,3004,765,13,2455,2,28,4,3,10,7,9,1,9,0,False,False,False,0,1,2020-12-24T16:41:01.487,10,,1.0
2020,15,3004,785,13,6528,2,4,4,7,10,3,9,1,9,0,False,False,False,0,4,2020-12-21T13:57:28.893,10,,1.0
2020,15,3004,790,13,2455,2,28,9,1,6,5,4,2,4,0,False,False,False,0,1,2021-03-08T15:34:04.72,6,,2.0
2020,15,3004,800,13,6529,2,2,4,6,13,7,6,7,6,0,False,True,True,2,3,2020-12-24T17:20:45.283,13,,7.0
2020,15,3005,15,29,1958,2,4,9,5,6,1,5,1,5,0,False,False,False,0,3,2020-12-21T11:20:28.803,6,,1.0
2020,15,3005,20,29,4850,13,19,6,17,0,0,0,0,0,0,False,False,False,0,2,2021-01-12T23:58:26.413,0,,0.0
2020,15,3005,30,22,6262,2,5,5,9,12,3,10,2,10,0,False,False,False,0,4,2020-12-21T11:25:08.88,12,,2.0
2020,15,3005,40,22,3170,2,50,5,-1,5,6,2,3,2,0,False,False,False,0,2,2020-12-21T11:27:49.897,5,,3.0
2020,15,3005,45,22,6812,2,44,9,-7,8,15,3,5,3,0,False,False,False,1,1,2021-03-17T20:41:24.073,8,,5.0
2020,15,3005,80,22,6812,2,47,5,1,6,5,6,0,6,0,False,False,False,0,1,2020-12-23T23:18:30.11,6,,0.0
2020,15,3005,90,22,6812,2,45,5,-5,5,10,2,3,2,0,False,False,False,0,1,2020-12-21T11:42:08.857,5,,3.0
2020,15,3005,95,22,6812,2,46,3,0,18,18,15,3,15,6,True,False,False,1,1,2020-12-23T23:29:26.77,18,,3.0
2020,15,3005,135,22,7610,13,35,5,13,0,0,0,0,0,0,False,False,False,0,3,2021-02-23T15:35:28.15,0,,
2020,15,3005,140,22,3170,2,5,3,3,4,1,4,0,4,0,True,False,False,0,3,2020-12-22T16:02:34.87,4,,0.0
2020,15,3005,145,22,3170,2,4,4,4,7,3,6,1,6,0,False,False,False,0,3,2020-12-21T11:58:20.36,7,,1.0
2020,15,3005,160,29,1958,2,4,9,10,11,1,10,1,10,0,False,False,False,0,3,2020-12-23T23:48:51.597,11,,1.0
2020,15,3005,175,29,1958,2,50,5,-2,0,2,-1,1,-1,0,False,False,False,1,2,2020-12-21T12:05:48.58,0,,1.0
2020,15,3005,205,22,6270,3,12,2,21,0,0,0,0,0,0,False,False,False,0,1,2020-12-22T15:59:50.27,0,,0.0
2020,15,3005,230,29,4850,2,31,10,8,15,7,14,1,14,0,False,False,False,0,4,2020-12-23T23:41:22.39,15,,1.0
2020,15,3005,240,29,1958,13,35,5,9,0,0,0,0,0,0,False,False,False,0,3,2021-03-05T15:27:39.64,0,,0.0
2020,15,3005,250,22,6270,2,34,4,-4,5,9,3,2,3,0,True,False,False,0,2,2020-12-23T23:51:42.227,5,,2.0
2020,15,3005,280,29,7378,2,28,5,2,5,3,4,1,4,0,False,False,False,0,1,2020-12-21T12:37:43.983,5,,1.0
2020,15,3005,285,29,7828,13,13,9,4,0,0,0,0,0,0,False,False,False,0,3,2020-12-23T23:43:02.067,0,,0.0
2020,15,3005,300,22,6812,2,46,3,1,2,1,2,0,2,0,False,False,False,0,3,2020-12-21T12:45:47.65,2,,0.0
2020,15,3005,305,22,6812,2,45,10,-8,0,8,-2,2,-2,0,True,False,False,0,1,2020-12-21T12:47:45.73,0,,2.0
2020,15,3005,315,29,4866,2,4,10,11,16,5,15,1,15,0,False,False,False,0,4,2020-12-21T12:50:07.553,16,,1.0
2020,15,3005,320,29,7788,2,44,3,-2,-1,1,-1,0,-1,0,False,False,False,0,1,2020-12-21T12:51:35.427,-1,,0.0
2020,15,3005,330,29,4875,13,7,6,27,0,0,0,0,0,0,False,False,False,0,3,2020-12-23T23:43:19.95,0,,
2020,15,3005,340,29,7788,3,28,4,2,0,0,0,0,0,0,False,False,False,0,1,2020-12-21T12:57:39.963,0,,0.0
2020,15,3005,345,29,4850,3,32,3,3,0,0,0,0,0,0,False,False,False,0,4,2020-12-23T23:06:09.443,0,,0.0
2020,15,3005,365,22,7610,13,6,8,15,0,0,0,0,0,0,False,False,False,0,2,2020-12-21T13:04:06.117,0,,0.0
2020,15,3005,385,29,3398,2,4,10,3,3,0,3,0,3,0,False,False,False,0,4,2020-12-21T13:07:06.48,3,,0.0
2020,15,3005,390,29,3398,2,8,10,14,17,3,16,1,16,0,False,False,False,0,3,2020-12-23T23:06:09.443,17,,1.0
2020,15,3005,400,29,4866,2,4,9,5,6,1,6,0,6,0,False,False,False,0,3,2020-12-21T13:09:58.063,6,,0.0
2020,15,3005,405,29,1958,2,5,5,7,8,1,8,0,8,0,False,False,False,0,2,2020-12-23T23:43:36.14,8,,0.0
2020,15,3005,410,29,3398,3,2,10,9,0,0,0,0,0,0,True,False,False,0,3,2020-12-21T15:29:44.803,0,,0.0
2020,15,3005,435,22,3170,2,13,5,8,10,2,10,0,10,0,False,False,False,0,4,2021-02-25T17:12:42.72,10,,0.0
2020,15,3005,445,22,7610,2,4,9,5,11,6,7,4,7,0,False,False,False,0,3,2021-02-23T15:37:01.23,11,,4.0
2020,15,3005,455,22,256,2,35,7,18,21,3,21,0,21,0,False,False,False,0,3,2021-02-23T15:37:38.203,21,,0.0
2020,15,3005,465,22,6262,2,11,6,18,22,4,22,0,22,0,False,False,False,0,4,2020-12-23T23:45:32.6,22,,0.0
2020,15,3005,475,22,6270,2,16,4,4,4,0,4,0,4,0,False,False,False,0,1,2021-03-03T20:23:50.07,4,,0.0
2020,15,3005,510,29,3398,2,32,10,4,44,40,12,32,12,0,False,False,False,1,4,2020-12-23T23:06:09.443,44,,32.0
2020,15,3005,520,29,4875,2,30,5,4,5,1,4,1,4,0,False,False,False,0,3,2020-12-21T13:47:55.177,5,,1.0
2020,15,3005,530,29,1958,2,5,6,15,15,0,15,0,15,6,False,False,False,0,3,2020-12-21T13:51:17.547,15,,0.0
2020,15,3005,550,22,6262,2,6,10,12,14,2,13,1,13,0,False,False,False,0,4,2021-02-25T17:13:38.147,14,,1.0
2020,15,3005,565,22,7610,2,5,5,4,5,1,5,0,5,0,False,False,False,0,3,2020-12-21T13:58:01.677,5,,0.0
2020,15,3005,570,22,3170,2,46,3,3,16,13,13,3,13,0,True,False,False,0,3,2020-12-23T23:06:09.443,16,,3.0
2020,15,3005,575,22,3170,2,12,10,11,24,13,23,1,23,0,False,False,False,0,2,2020-12-23T23:46:15.85,24,,1.0
2020,15,3005,590,22,6262,13,13,10,2,0,0,0,0,0,0,False,False,False,0,4,2020-12-21T14:05:16.297,0,,0.0
2020,15,3005,605,29,4866,2,54,9,-5,9,14,1,8,1,0,True,False,False,2,4,2020-12-22T18:56:18.837,9,,8.0
2020,15,3005,630,29,7788,13,21,6,17,0,0,0,0,0,0,False,False,False,0,2,2020-12-21T14:16:29.833,0,,
2020,15,3005,640,29,3398,2,38,3,3,3,0,3,0,3,6,False,False,False,0,4,2021-02-23T15:38:09.473,3,,0.0
2020,15,3005,665,22,3170,13,4,10,11,0,0,0,0,0,0,False,False,False,0,3,2020-12-21T14:24:24.77,0,,0.0
2020,15,3005,690,29,1958,2,4,5,8,16,8,13,3,13,0,False,False,False,0,3,2020-12-23T23:31:22.41,16,,3.0
2020,15,3005,695,29,4866,2,38,9,0,2,2,2,0,2,0,False,False,False,0,4,2020-12-21T14:34:06.78,2,,0.0
2020,15,3005,710,29,4850,2,30,5,1,13,12,8,5,8,0,False,False,False,1,4,2020-12-21T14:38:20.853,13,,5.0
2020,15,3005,730,29,3356,2,50,9,-5,6,11,3,3,3,0,False,False,False,0,3,2020-12-23T23:47:09.54,6,,3.0
2020,15,3005,750,22,3170,13,4,4,4,0,0,0,0,0,0,False,False,False,0,2,2020-12-23T23:47:25.357,0,,0.0
2020,15,3005,755,22,7610,2,26,10,5,2,-3,5,-3,5,0,False,False,False,1,2,2020-12-23T23:33:30.273,2,,-3.0
2020,15,3005,765,29,4875,2,30,10,0,4,4,2,2,2,0,False,False,False,0,3,2020-12-23T23:19:03.56,4,,2.0
2020,15,3005,775,29,4866,2,4,9,5,6,1,5,1,5,0,False,False,False,0,3,2020-12-21T15:03:19.777,6,,1.0
2020,15,3005,780,29,7788,13,19,6,21,0,0,0,0,0,0,False,False,False,0,3,2020-12-21T15:05:33.57,0,,0.0
2020,15,3005,785,29,4850,13,19,2,27,0,0,0,0,0,0,False,False,False,0,3,2020-12-21T15:08:38.673,0,,0.0
2020,15,3005,820,22,1113,2,4,4,4,6,2,6,0,6,0,False,False,False,0,1,2020-12-21T15:16:23.193,6,,0.0
2020,15,3006,15,31,3504,2,45,5,-2,6,8,6,0,6,0,False,False,False,0,1,2020-12-21T11:30:25.457,6,,0.0
2020,15,3006,20,31,6793,2,4,5,6,6,0,5,1,5,0,False,False,False,0,2,2020-12-23T17:05:21.737,6,,1.0
2020,15,3006,30,31,5096,2,17,8,17,19,2,18,1,18,0,False,False,False,0,3,2020-12-22T17:15:11.593,19,,1.0
2020,15,3006,40,31,6793,2,6,9,8,10,2,10,0,10,0,False,False,False,0,2,2020-12-21T11:40:49.67,10,,0.0
2020,15,3006,50,31,2901,2,2,4,7,10,3,8,2,8,0,False,False,False,0,3,2021-02-23T15:02:49.74,10,,2.0
2020,15,3006,80,11,7732,2,45,5,-3,0,3,0,0,0,0,False,False,False,0,1,2020-12-21T11:52:31.137,0,,0.0
2020,15,3006,85,11,914,2,5,5,6,6,0,6,0,6,0,False,False,False,0,3,2020-12-21T11:54:09.56,6,,0.0
2020,15,3006,90,11,914,2,6,9,4,4,0,4,0,4,0,False,False,False,0,3,2020-12-21T11:56:53.743,4,,0.0
2020,15,3006,100,11,4487,2,45,5,0,13,13,4,9,4,0,True,False,False,1,2,2020-12-21T12:01:09.053,13,,9.0
2020,15,3006,110,11,914,13,2,4,10,0,0,0,0,0,0,False,False,False,0,3,2021-02-23T15:03:23.227,0,,0.0
2020,15,3006,115,11,6810,2,6,9,11,11,0,11,0,11,0,False,False,False,0,3,2020-12-21T12:07:55.34,11,,0.0
2020,15,3006,120,11,914,2,18,10,2,12,10,11,1,11,0,False,False,False,0,3,2020-12-27T03:40:20.273,12,,1.0
2020,15,3006,145,11,914,2,35,9,2,2,0,2,0,2,6,False,False,False,0,4,2020-12-27T05:05:43.35,2,,0.0
2020,15,3006,160,31,5080,2,22,6,40,75,35,55,20,55,6,False,False,False,1,3,2020-12-21T12:23:31.283,75,,20.0
2020,15,3006,175,11,914,2,13,10,5,6,1,6,0,6,0,True,False,False,0,3,2020-12-27T04:00:26.6,6,,0.0
2020,15,3006,180,11,6810,13,5,6,15,0,0,0,0,0,0,True,False,False,0,3,2020-12-21T12:28:39.947,0,,0.0
2020,15,3006,185,11,917,2,4,5,4,5,1,5,0,5,0,False,False,False,0,2,2020-12-21T12:30:05.873,5,,0.0
2020,15,3006,195,11,7732,2,51,9,-6,8,14,7,1,7,0,False,False,False,0,1,2020-12-21T12:53:12.29,8,,1.0
2020,15,3006,210,11,6810,13,35,5,11,0,0,0,0,0,0,False,False,False,0,4,2020-12-21T12:59:11.733,0,,0.0
2020,15,3006,235,31,6793,13,19,6,23,0,0,0,0,0,0,False,False,False,0,2,2020-12-27T04:00:54.623,0,,
2020,15,3006,245,31,2901,13,43,6,27,0,0,0,0,0,0,False,False,False,0,4,2020-12-21T13:12:48.75,0,,0.0
2020,15,3006,255,31,5080,2,13,9,7,7,0,7,0,7,0,False,False,False,0,3,2021-02-25T17:16:06.777,7,,0.0
2020,15,3006,280,11,7732,2,32,5,0,2,2,2,0,2,0,True,False,False,0,4,2020-12-23T17:05:34.647,2,,0.0
2020,15,3006,290,11,7732,2,26,10,1,5,4,4,1,4,0,True,False,False,0,2,2020-12-27T04:01:07.907,5,,1.0
2020,15,3006,295,11,7906,2,20,1,32,44,12,33,11,33,0,False,False,False,1,3,2020-12-27T03:40:20.273,44,,11.0
2020,15,3006,310,11,7733,13,9,5,5,0,0,0,0,0,0,False,False,False,0,2,2020-12-21T13:35:55.43,0,,0.0
2020,15,3006,340,11,6810,2,49,10,-2,7,9,5,2,5,0,True,False,False,0,2,2020-12-21T13:50:19.563,7,,2.0
2020,15,3006,355,11,914,2,39,4,6,6,0,6,0,6,0,False,False,False,0,3,2020-12-27T04:54:09.567,6,,0.0
2020,15,3006,360,11,914,2,24,8,35,39,4,35,4,35,0,False,False,False,0,3,2020-12-21T13:55:35.59,39,,4.0
2020,15,3006,390,31,6793,2,4,3,8,14,6,13,1,13,0,False,False,False,0,2,2020-12-21T14:02:52.85,14,,1.0
2020,15,3006,400,31,6793,13,4,3,9,0,0,0,0,0,0,False,False,False,0,2,2020-12-27T03:40:20.273,0,,0.0
2020,15,3006,405,31,5080,2,5,10,13,14,1,13,1,13,0,True,False,False,0,3,2020-12-27T04:55:28.16,14,,1.0
2020,15,3006,420,31,5096,2,31,4,3,16,13,15,1,15,0,False,False,False,0,4,2020-12-21T14:10:12.523,16,,1.0
2020,15,3006,425,31,4545,2,5,10,3,5,2,5,0,5,0,False,False,False,0,1,2020-12-27T04:56:10.263,5,,0.0
2020,15,3006,450,11,917,2,2,9,4,12,8,11,1,11,0,False,False,False,0,3,2020-12-21T14:20:02.457,12,,1.0
2020,15,3006,460,11,914,3,35,7,15,0,0,0,0,0,0,False,False,False,0,3,2020-12-21T14:23:22.52,0,,0.0
2020,15,3006,475,11,917,2,4,9,14,14,0,14,0,14,0,False,False,False,0,3,2020-12-21T14:27:48.307,14,,0.0
2020,15,3006,480,11,7733,13,8,7,47,0,0,0,0,0,0,False,False,False,0,3,2020-12-21T14:36:20.343,0,,0.0
2020,15,3006,495,11,917,2,6,9,6,7,1,7,0,7,0,False,False,False,0,2,2021-02-25T17:17:26.227,7,,0.0
2020,15,3006,515,31,5096,2,12,5,0,5,5,3,2,3,0,True,False,False,0,4,2021-03-09T13:58:09.08,5,,2.0
2020,15,3006,530,31,5080,13,5,2,19,0,0,0,0,0,0,False,False,False,0,3,2020-12-27T04:57:15.243,0,,0.0
2020,15,3006,535,31,5096,2,5,3,5,5,0,5,0,5,0,False,False,False,0,3,2020-12-27T04:57:53.87,5,,0.0
2020,15,3006,545,31,3504,2,44,3,-2,-1,1,-1,0,-1,0,False,False,False,0,1,2020-12-21T14:57:16.873,-1,,0.0
2020,15,3006,550,31,6793,13,6,8,25,0,0,0,0,0,0,False,False,False,0,2,2020-12-27T04:58:27.02,0,,0.0
2020,15,3006,565,11,7733,2,21,6,26,36,10,35,1,35,0,False,False,False,0,2,2020-12-21T15:05:49.017,36,,1.0
2020,15,3006,570,11,914,13,4,5,12,0,0,0,0,0,0,False,False,False,0,3,2020-12-21T17:12:23.223,0,,
2020,15,3006,575,11,7906,13,35,8,22,0,0,0,0,0,0,False,False,False,0,3,2020-12-27T04:01:49,0,,0.0
2020,15,3006,580,11,7732,3,48,9,-5,0,0,0,0,0,0,False,False,False,0,1,2020-12-21T15:15:10.157,0,,0.0
2020,15,3006,585,11,917,13,6,9,10,0,0,0,0,0,0,True,False,False,0,2,2020-12-21T15:16:59.807,0,,0.0
2020,15,3006,610,31,6724,2,17,4,14,20,6,18,2,18,0,False,False,False,0,3,2020-12-21T15:24:18.537,20,,2.0
2020,15,3006,620,31,5080,2,6,4,11,14,3,13,1,13,0,False,False,False,0,3,2020-12-27T04:12:37.057,14,,1.0
2020,15,3006,660,11,100,2,51,5,-2,2,4,2,0,2,0,False,False,False,0,3,2020-12-21T15:37:09.473,2,,0.0
2020,15,3006,670,11,100,2,6,9,10,11,1,10,1,10,0,False,False,False,0,3,2020-12-27T04:09:45.247,11,,1.0
2020,15,3006,685,31,5096,2,30,5,-1,7,8,0,7,0,0,True,False,False,1,4,2021-03-03T20:30:50.563,7,,7.0
2020,15,3006,695,31,7603,2,48,10,-4,24,28,15,9,15,0,False,False,False,2,1,2020-12-27T04:49:37.863,24,,9.0
2020,15,3006,710,31,6793,2,13,10,0,2,2,0,2,0,6,True,False,False,0,3,2020-12-27T04:49:52,2,,2.0
2020,15,3006,730,11,100,2,5,5,6,7,1,7,0,7,0,False,False,False,0,3,2020-12-21T16:29:11.397,7,,0.0
2020,15,3006,740,11,914,2,35,2,21,21,0,21,0,21,0,False,False,False,0,3,2020-12-21T16:33:14.26,21,,0.0
2020,15,3006,745,11,2714,2,30,9,0,11,11,10,1,10,0,False,False,False,0,4,2020-12-21T16:33:01.02,11,,1.0
2020,15,3006,775,31,6793,2,26,9,6,12,6,6,6,6,0,False,False,False,1,3,2020-12-27T03:40:20.273,12,,6.0
2020,15,3006,820,31,5080,13,17,10,3,0,0,0,0,0,0,False,False,False,0,3,2020-12-27T04:09:57.55,0,,0.0
2020,15,3006,825,31,7603,2,45,10,2,3,1,3,0,3,6,False,False,False,0,1,2020-12-21T16:52:11.483,3,,0.0
2020,15,3006,840,11,914,2,12,5,5,5,0,5,0,5,0,False,False,False,0,3,2020-12-21T16:54:50.663,5,,0.0
2020,15,3006,850,11,914,2,13,9,6,11,5,9,2,9,0,True,False,False,0,3,2020-12-21T16:56:22.63,11,,2.0
2020,15,3006,855,11,100,13,24,2,19,0,0,0,0,0,0,False,False,False,0,3,2020-12-21T17:05:37.39,0,,0.0
2020,15,3007,15,2,6342,2,47,5,2,2,0,2,0,2,0,False,False,False,0,3,2020-12-21T11:29:40.817,2,,0.0
2020,15,3007,20,2,990,2,4,10,2,10,8,3,7,3,0,False,False,False,2,1,2020-12-21T11:31:51.007,10,,7.0
2020,15,3007,30,2,5214,2,46,3,3,4,1,4,0,4,0,True,False,False,0,4,2020-12-21T11:35:07.693,4,,0.0
2020,15,3007,35,2,5223,2,35,6,15,23,8,21,2,21,0,False,False,False,1,3,2020-12-23T20:24:10.843,23,,2.0
2020,15,3007,40,2,6247,2,8,7,18,27,9,23,4,23,0,False,False,False,0,3,2020-12-21T16:29:52.907,27,,4.0
2020,15,3007,45,2,6247,2,5,3,5,5,0,5,0,5,6,False,False,False,0,3,2020-12-23T19:36:34.273,5,,0.0
2020,15,3007,60,30,37,2,49,3,-1,6,7,4,2,4,0,False,False,False,0,2,2020-12-21T11:47:39.36,6,,2.0
2020,15,3007,65,30,2290,2,5,5,9,14,5,12,2,12,0,True,False,False,0,2,2020-12-21T11:49:40.23,14,,2.0
2020,15,3007,75,30,4937,2,48,10,-5,-8,-3,-4,-4,-4,0,False,False,False,1,1,2020-12-21T11:52:10.807,-8,,-4.0
2020,15,3007,80,30,119,2,48,9,-5,14,19,11,3,11,0,False,False,False,0,1,2020-12-22T18:21:39.087,14,,3.0
2020,15,3007,95,2,6342,2,4,3,3,3,0,3,0,3,0,False,False,False,0,2,2020-12-21T12:00:45.623,3,,0.0
2020,15,3007,105,2,2223,2,32,5,4,25,21,22,3,22,0,False,False,False,0,4,2020-12-21T12:04:22.99,25,,3.0
2020,15,3007,110,2,2223,13,4,10,4,0,0,0,0,0,0,False,False,False,0,4,2020-12-21T12:05:29.27,0,,0.0
2020,15,3007,120,2,990,2,5,10,3,5,2,4,1,4,0,False,False,False,0,1,2020-12-21T12:08:26.1,5,,1.0
2020,15,3007,135,30,2290,2,39,4,6,8,2,7,1,7,0,False,False,False,0,4,2020-12-21T12:12:16.12,8,,1.0
2020,15,3007,150,30,7268,2,46,9,1,2,1,2,0,2,0,False,False,False,0,3,2020-12-21T12:17:14.927,2,,0.0
2020,15,3007,155,30,37,13,13,10,3,0,0,0,0,0,0,False,False,False,0,3,2020-12-23T20:38:05.16,0,,0.0
2020,15,3007,165,2,6247,13,4,3,12,0,0,0,0,0,0,False,False,False,0,2,2020-12-21T12:20:17.037,0,,0.0
2020,15,3007,175,2,6247,13,2,10,9,0,0,0,0,0,0,True,False,False,0,2,2020-12-21T12:26:00.337,0,,0.0
2020,15,3007,180,2,5223,13,7,6,24,0,0,0,0,0,0,False,False,False,0,2,2020-12-23T20:38:30.413,0,,0.0
2020,15,3007,195,30,793,2,2,9,3,7,4,4,3,4,0,False,False,False,0,2,2020-12-21T12:33:12.917,7,,3.0
2020,15,3007,210,2,4670,2,28,10,2,5,3,4,1,4,0,False,False,False,0,1,2020-12-21T12:36:40.207,5,,1.0
2020,15,3007,225,2,6342,13,5,9,4,0,0,0,0,0,0,False,False,False,0,3,2020-12-21T12:41:12.377,0,,0.0
2020,15,3007,235,2,2835,2,46,3,0,8,8,7,1,7,0,False,False,False,0,1,2020-12-23T20:40:33.47,8,,1.0
2020,15,3007,240,2,6247,2,4,10,5,7,2,6,1,6,0,False,False,False,0,2,2020-12-21T12:46:24.167,7,,1.0
2020,15,3007,245,2,2835,2,47,5,4,13,9,13,0,13,0,False,False,False,0,1,2020-12-21T12:50:30.67,13,,0.0
2020,15,3007,250,2,4179,2,2,10,11,14,3,12,2,12,0,False,False,False,0,3,2020-12-23T20:25:06.437,14,,2.0
2020,15,3007,255,2,5223,2,3,3,12,12,0,12,0,12,6,False,False,False,0,2,2020-12-21T12:52:01.773,12,,0.0
2020,15,3007,270,30,7891,3,47,5,1,0,0,0,0,0,0,False,False,False,0,1,2020-12-21T12:54:52.127,0,,0.0
2020,15,3007,275,30,4516,2,2,9,6,10,4,6,4,6,0,False,True,False,0,3,2020-12-23T19:20:54.227,10,,4.0
2020,15,3007,285,30,63,2,46,3,2,7,5,6,1,6,0,False,False,False,0,4,2020-12-21T13:00:28.673,7,,1.0
2020,15,3007,290,30,4516,13,35,6,19,0,0,0,0,0,0,False,False,False,0,3,2020-12-21T13:02:19.063,0,,0.0
2020,15,3007,295,30,793,2,5,5,10,10,0,10,0,10,0,False,False,False,0,2,2020-12-21T13:04:07.183,10,,0.0
2020,15,3007,320,2,5223,2,18,3,1,2,1,2,0,2,0,False,False,False,0,2,2021-03-15T18:15:01.11,2,,0.0
2020,15,3007,330,2,5223,2,5,5,4,7,3,7,0,7,0,False,False,False,0,2,2020-12-21T13:11:29.583,7,,0.0
2020,15,3007,340,2,5223,2,4,5,11,14,3,13,1,13,0,False,False,False,0,2,2020-12-21T13:13:43.023,14,,1.0
2020,15,3007,345,2,5223,2,4,8,19,18,-1,18,0,18,0,False,False,False,0,3,2020-12-23T20:43:24.34,18,,0.0
2020,15,3007,350,2,6472,13,4,4,3,0,0,0,0,0,0,False,False,False,0,1,2020-12-21T13:17:50.66,0,,0.0
2020,15,3007,355,2,6472,2,47,5,-1,5,6,3,2,3,0,False,False,False,0,1,2020-12-23T20:26:07.413,5,,2.0
2020,15,3007,365,2,6247,2,2,10,9,15,6,13,2,13,0,False,False,False,1,2,2020-12-21T13:22:34.05,15,,2.0
2020,15,3007,370,2,5214,2,12,5,12,12,0,12,0,12,0,False,False,False,0,3,2021-03-09T13:59:37.763,12,,0.0
2020,15,3007,380,2,6240,2,18,3,-1,-1,0,-1,0,-1,0,False,False,False,0,2,2020-12-21T13:27:27.087,-1,,0.0
2020,15,3007,395,2,6247,13,24,5,14,0,0,0,0,0,0,False,False,False,0,3,2020-12-21T13:29:47.047,0,,0.0
2020,15,3007,425,30,37,2,35,10,10,20,10,14,6,14,0,False,False,False,0,3,2020-12-21T13:40:05.967,20,,6.0
2020,15,3007,430,30,793,3,6,4,9,0,0,0,0,0,0,False,False,False,0,2,2020-12-21T13:41:43.763,0,,0.0
2020,15,3007,435,30,2290,2,2,10,9,14,5,11,3,11,0,True,False,False,0,3,2020-12-21T13:42:55.293,14,,3.0
2020,15,3007,450,30,793,2,35,1,22,32,10,30,2,30,0,False,False,False,0,2,2020-12-21T16:31:11.953,32,,2.0
2020,15,3007,470,2,5223,2,4,8,15,13,-2,13,0,13,0,True,False,False,0,2,2020-12-21T13:55:02.043,13,,0.0
2020,15,3007,480,2,5223,2,7,2,27,28,1,28,0,28,0,False,False,False,0,2,2020-12-21T13:59:23.827,28,,0.0
2020,15,3007,490,2,6472,2,55,10,-2,4,6,3,1,3,0,False,False,False,0,1,2020-12-21T14:02:06.14,4,,1.0
2020,15,3007,495,2,6247,2,4,10,9,14,5,12,2,12,0,False,False,False,0,3,2020-12-23T20:44:24.32,14,,2.0
2020,15,3007,500,2,5214,2,2,10,7,7,0,7,0,7,6,True,False,False,0,3,2020-12-21T14:06:31.203,7,,0.0
2020,15,3007,515,30,63,13,35,10,14,0,0,0,0,0,0,False,False,False,0,4,2020-12-21T14:27:25.553,0,,0.0
2020,15,3007,520,30,63,2,47,5,1,5,4,3,2,3,0,False,False,False,0,4,2020-12-21T14:28:43.643,5,,2.0
2020,15,3007,525,30,793,2,38,9,5,26,21,24,2,24,0,False,False,False,0,3,2020-12-21T14:30:29.353,26,,2.0
2020,15,3007,530,30,4937,2,5,10,2,16,14,4,12,4,0,False,False,False,1,1,2020-12-21T14:32:16.453,16,,12.0
2020,15,3007,540,30,793,2,12,2,24,24,0,24,0,24,0,False,False,False,0,3,2021-03-09T14:00:55.163,24,,0.0
2020,15,3007,545,30,37,13,5,5,3,0,0,0,0,0,0,False,False,False,0,3,2020-12-21T16:28:46.293,0,,0.0
2020,15,3007,550,30,4516,2,2,9,3,4,1,3,1,3,6,False,False,False,0,2,2020-12-21T14:39:26.787,4,,1.0
2020,15,3007,565,2,4670,2,46,3,2,4,2,4,0,4,0,False,False,False,1,1,2020-12-21T14:41:38.2,4,,0.0
2020,15,3007,570,2,5223,3,6,9,12,0,0,0,0,0,0,False,False,False,0,2,2020-12-21T14:42:49.47,0,,0.0
2020,15,3007,575,2,5223,13,29,3,14,0,0,0,0,0,0,False,False,False,0,2,2020-12-21T14:44:17.08,0,,0.0
2020,15,3007,585,30,4937,13,48,10,-4,0,0,0,0,0,0,False,False,False,0,1,2020-12-21T14:46:37.22,0,,0.0
2020,15,3007,590,30,63,2,29,3,12,17,5,13,4,13,0,False,False,False,0,3,2020-12-21T14:48:05.11,17,,4.0
2020,15,3007,595,30,7893,13,8,1,48,0,0,0,0,0,0,False,False,False,0,3,2020-12-23T19:57:00.23,0,,0.0
2020,15,3007,600,30,7268,2,4,10,10,14,4,13,1,13,0,False,False,False,0,3,2020-12-23T20:28:54.767,14,,1.0
2020,15,3007,605,30,793,3,4,5,13,0,0,0,0,0,0,False,False,False,0,2,2021-03-02T17:06:04.903,0,,
2020,15,3007,610,30,4937,2,44,9,-6,8,14,6,2,6,0,False,False,False,0,1,2020-12-21T14:58:28.573,8,,2.0
2020,15,3007,615,30,37,2,5,5,5,8,3,4,4,4,0,False,False,False,1,2,2020-12-23T20:29:35.677,8,,4.0
2020,15,3007,620,30,63,13,38,4,1,0,0,0,0,0,0,False,False,False,0,4,2020-12-23T20:45:08.547,0,,
2020,15,3007,650,2,6247,3,2,4,3,0,0,0,0,0,0,False,False,False,0,2,2020-12-21T15:08:21.25,0,,0.0
2020,15,3007,655,2,2223,2,32,10,-5,-4,1,-4,0,-4,0,False,False,False,0,4,2020-12-23T20:46:23.81,-4,,0.0
2020,15,3007,670,30,4937,3,12,5,-1,0,0,0,0,0,0,False,False,False,0,1,2021-03-09T14:02:52.787,0,,0.0
2020,15,3007,675,30,119,2,47,5,2,5,3,5,0,5,0,False,False,False,0,1,2020-12-21T15:18:33.937,5,,0.0
2020,15,3007,680,30,793,2,51,9,0,11,11,11,0,11,0,False,False,False,0,3,2020-12-21T15:21:07.097,11,,0.0
2020,15,3007,685,30,4516,2,4,4,9,9,0,9,0,9,0,True,False,False,0,3,2020-12-21T15:22:33.697,9,,0.0
2020,15,3007,690,30,37,2,49,9,-2,13,15,6,7,6,0,False,False,False,1,2,2020-12-23T20:30:12.353,13,,7.0
2020,15,3007,695,30,63,13,7,3,13,0,0,0,0,0,0,False,False,False,0,4,2020-12-21T15:26:04.4,0,,0.0
2020,15,3007,700,30,7268,2,18,5,-2,4,6,2,2,2,0,False,False,False,0,2,2020-12-21T15:27:46.857,4,,2.0
2020,15,3007,705,30,63,13,4,10,9,0,0,0,0,0,0,False,False,False,0,4,2020-12-21T15:29:51.12,0,,0.0
2020,15,3007,715,2,2835,2,46,3,2,11,9,8,3,8,0,False,False,False,0,1,2020-12-21T15:32:20.063,11,,3.0
2020,15,3007,725,2,5223,2,35,7,18,33,15,29,4,29,0,False,False,False,0,3,2020-12-21T15:34:14.423,33,,4.0
2020,15,3007,735,2,5223,13,8,2,27,0,0,0,0,0,0,False,False,False,0,2,2020-12-21T15:37:37.727,0,,0.0
2020,15,3007,755,30,2290,2,17,7,16,18,2,18,0,18,0,False,False,False,0,3,2020-12-21T15:43:42.863,18,,0.0
2020,15,3007,765,30,4516,2,50,5,-2,13,15,4,9,4,0,False,False,False,0,2,2020-12-21T15:46:15.327,13,,9.0
2020,15,3007,770,30,37,2,19,6,40,46,6,43,3,43,6,False,False,False,0,2,2020-12-21T15:48:04.217,46,,3.0
2020,15,3007,785,2,5214,2,53,3,-2,-2,0,-2,0,-2,0,False,False,False,0,4,2021-02-23T14:23:04.837,-2,,0.0
2020,15,3007,790,2,6247,3,21,1,47,0,0,0,0,0,0,False,False,False,0,2,2020-12-23T20:48:51.443,0,,0.0
2020,15,3007,830,30,119,2,54,10,0,13,13,10,3,10,0,False,False,False,0,1,2020-12-21T16:05:59.47,13,,3.0
2020,15,3007,845,2,6342,13,2,9,4,0,0,0,0,0,0,False,False,False,0,2,2020-12-23T20:04:27.023,0,,0.0
2020,15,3007,855,2,5214,13,32,10,0,0,0,0,0,0,0,False,False,False,0,4,2020-12-21T16:10:30.727,0,,0.0
2020,15,3007,860,2,5223,2,35,9,13,13,0,13,0,13,0,False,False,False,0,3,2020-12-21T16:12:40.243,13,,0.0
2020,15,3008,10,3,5017,2,47,5,0,11,11,5,6,5,0,True,False,False,0,1,2021-02-23T14:37:03.997,11,,6.0
2020,15,3008,15,3,6936,2,6,3,10,10,0,10,0,10,0,False,False,False,0,3,2020-12-21T12:02:53.123,10,,0.0
2020,15,3008,35,3,6936,13,17,7,34,0,0,0,0,0,0,True,False,False,0,3,2020-12-23T21:26:47.837,0,,0.0
2020,15,3008,75,3,6454,2,7,8,16,18,2,16,2,16,0,False,False,False,0,3,2020-12-23T14:46:40.57,18,,2.0
2020,15,3008,80,3,6936,2,2,9,10,28,18,28,0,28,0,False,False,False,0,3,2021-02-23T14:38:00.847,28,,0.0
2020,15,3008,85,3,6935,2,13,10,4,4,0,4,0,4,6,False,False,False,0,3,2020-12-23T22:28:39.62,4,,0.0
2020,15,3008,115,15,7592,2,6,9,8,8,0,8,0,8,0,False,False,False,0,3,2020-12-23T22:29:21.517,8,,0.0
2020,15,3008,145,3,6454,2,35,7,24,27,3,24,3,24,0,False,False,False,0,4,2021-02-23T14:38:56.967,27,,3.0
2020,15,3008,150,3,2688,13,12,10,7,0,0,0,0,0,0,False,False,False,0,3,2020-12-21T13:21:03.283,0,,0.0
2020,15,3008,200,15,4886,2,50,9,-1,8,9,4,4,4,0,False,False,False,0,3,2020-12-21T13:38:08.36,8,,4.0
2020,15,3008,210,15,8099,2,46,3,-2,-2,0,-2,0,-2,0,False,False,False,0,1,2020-12-21T13:41:03.09,-2,,0.0
2020,15,3008,215,15,2407,13,5,6,15,0,0,0,0,0,0,False,False,False,0,3,2020-12-21T19:27:41.077,0,,0.0
2020,15,3008,235,3,6454,13,35,7,40,0,0,0,0,0,0,False,False,False,0,3,2020-12-22T22:43:48.48,0,,
2020,15,3008,250,3,590,13,2,9,5,0,0,0,0,0,0,False,False,False,0,2,2020-12-21T13:58:30.503,0,,0.0
2020,15,3008,265,15,922,2,5,3,5,12,7,10,2,10,0,True,False,False,0,3,2020-12-21T14:09:16.373,12,,2.0
2020,15,3008,275,15,6501,2,2,10,6,10,4,10,0,10,0,False,False,False,0,2,2021-02-23T14:40:13.987,10,,0.0
2020,15,3008,285,15,7591,2,13,9,2,2,0,2,0,2,0,False,False,False,0,3,2020-12-21T14:23:01.16,2,,0.0
2020,15,3008,290,15,8099,2,46,3,-3,3,6,2,1,2,0,False,False,False,0,1,2020-12-21T14:25:23.123,3,,1.0
2020,15,3008,300,15,2407,13,19,2,40,0,0,0,0,0,0,False,False,False,0,2,2020-12-21T14:28:58.637,0,,0.0
2020,15,3008,325,3,7671,2,28,10,-6,17,23,17,0,17,0,False,False,False,0,1,2021-03-08T15:38:45.3,17,,0.0
2020,15,3008,330,3,6936,2,45,5,-7,11,18,11,0,11,0,True,False,False,0,3,2020-12-21T14:55:04.29,11,,0.0
2020,15,3008,345,3,6659,2,44,9,-2,2,4,1,1,1,0,False,False,False,0,1,2020-12-21T15:40:34.817,2,,1.0
2020,15,3008,355,3,590,2,12,3,11,11,0,11,0,11,6,False,False,False,0,2,2020-12-21T15:42:30.07,11,,0.0
2020,15,3008,370,15,6501,2,6,4,10,12,2,10,2,10,0,False,False,False,0,2,2020-12-23T22:32:44.347,12,,2.0
2020,15,3008,410,3,6936,2,5,3,3,6,3,2,4,2,0,False,False,False,1,3,2020-12-23T22:17:42.297,6,,4.0
2020,15,3008,415,3,6936,13,19,3,14,0,0,0,0,0,0,False,False,False,0,2,2020-12-21T16:01:11.967,0,,
2020,15,3008,430,15,922,2,2,4,7,11,4,7,4,7,0,False,False,False,0,4,2020-12-23T21:26:47.837,11,,4.0
2020,15,3008,440,15,7591,2,12,10,6,21,15,21,0,21,0,False,False,False,0,3,2020-12-23T22:33:12.437,21,,0.0
2020,15,3008,460,15,7591,2,4,5,6,8,2,6,2,6,0,True,False,False,1,3,2020-12-22T18:12:50.66,8,,2.0
2020,15,3008,465,15,4997,2,5,3,14,14,0,14,0,14,0,False,False,False,0,3,2020-12-21T16:24:41.57,14,,0.0
2020,15,3008,475,15,2757,2,12,10,0,6,6,6,0,6,0,False,False,False,0,4,2020-12-21T16:28:50.24,6,,0.0
2020,15,3008,480,15,8099,2,11,5,13,17,4,12,5,12,6,True,False,False,0,1,2020-12-21T19:27:03.703,17,,5.0
2020,15,3008,495,3,5017,3,30,5,-2,0,0,0,0,0,0,False,False,False,0,1,2020-12-21T16:34:38.427,0,,0.0
2020,15,3008,505,3,6454,2,13,9,5,6,1,5,1,5,0,False,False,False,0,3,2020-12-21T16:39:54.163,6,,1.0
2020,15,3008,530,3,590,13,5,3,4,0,0,0,0,0,0,False,False,False,0,2,2020-12-23T22:11:01.353,0,,0.0
2020,15,3008,535,3,6659,2,12,1,29,34,5,32,2,32,0,True,False,False,0,1,2021-02-23T14:42:41.033,34,,2.0
2020,15,3008,560,15,6501,2,9,2,22,22,0,22,0,22,0,False,False,False,0,3,2020-12-21T17:02:11.13,22,,0.0
2020,15,3008,570,15,7591,2,32,9,0,2,2,2,0,2,0,True,False,False,0,4,2021-02-23T14:43:19.823,2,,0.0
2020,15,3008,575,15,922,2,17,8,23,28,5,25,3,25,0,False,False,False,0,4,2020-12-21T17:09:02.833,28,,3.0
2020,15,3008,590,15,7591,13,2,10,10,0,0,0,0,0,0,False,False,False,0,2,2020-12-23T21:26:47.837,0,,0.0
2020,15,3008,610,3,6936,2,34,4,-4,-1,3,-1,0,-1,0,True,False,False,0,3,2020-12-23T22:46:37.65,-1,,0.0
2020,15,3008,620,3,6936,2,19,6,41,44,3,44,0,44,0,False,False,False,0,2,2020-12-21T17:27:53.58,44,,0.0
2020,15,3008,630,3,6454,2,13,10,7,12,5,10,2,10,0,False,False,False,0,3,2020-12-21T17:33:35.627,12,,2.0
2020,15,3008,650,3,6454,2,4,10,3,3,0,3,0,3,6,False,False,False,0,4,2020-12-21T17:38:58.983,3,,0.0
2020,15,3008,670,15,922,13,2,4,4,0,0,0,0,0,0,False,False,False,0,3,2020-12-23T21:26:47.837,0,,0.0
2020,15,3008,675,15,7591,2,4,9,10,24,14,17,7,17,0,False,False,False,0,3,2020-12-21T17:47:44.16,24,,
2020,15,3008,680,15,7591,2,51,9,-7,10,17,8,2,8,0,True,False,False,0,1,2020-12-22T18:08:47.843,10,,2.0
2020,15,3008,690,3,5017,2,30,10,-2,-1,1,-1,0,-1,0,True,False,False,0,1,2020-12-23T22:35:55.713,-1,,0.0
2020,15,3008,715,3,6935,13,29,6,22,0,0,0,0,0,0,False,False,False,0,2,2020-12-23T22:36:30.703,0,,0.0
2020,15,3008,725,3,6918,2,31,10,1,8,7,5,3,5,0,False,False,False,1,1,2020-12-23T22:37:17.033,8,,3.0
2020,15,3008,735,3,4368,13,8,8,34,0,0,0,0,0,0,False,False,False,0,3,2020-12-23T21:26:47.837,0,,0.0
2020,15,3008,740,15,4997,2,49,10,-1,8,9,5,3,5,0,False,False,False,0,3,2020-12-21T18:25:13.617,8,,3.0
2020,15,3008,745,15,7591,13,12,5,2,0,0,0,0,0,0,False,False,False,0,3,2021-03-05T15:29:56.267,0,,
2020,15,3008,755,15,6501,2,2,10,9,9,0,9,0,9,0,False,False,False,0,2,2020-12-21T18:31:07.48,9,,0.0
2020,15,3008,765,15,6501,13,7,6,17,0,0,0,0,0,0,False,False,False,0,3,2020-12-21T18:33:11.603,0,,0.0
2020,15,3008,770,15,7361,2,44,9,-4,4,8,1,3,1,0,True,False,False,0,1,2020-12-21T18:35:18.763,4,,3.0
2020,15,3008,775,15,2407,2,29,5,13,13,0,13,0,13,6,False,False,False,0,3,2021-02-25T17:22:14.85,13,,0.0
2020,15,3009,10,19,7456,13,32,3,0,0,0,0,0,0,0,False,False,False,0,4,2020-12-21T18:09:52.297,0,,0.0
2020,15,3009,20,19,3233,2,50,10,-3,-2,1,-2,0,-2,0,False,False,False,1,2,2020-12-21T11:28:10.987,-2,,0.0
2020,15,3009,40,17,7051,2,47,5,1,3,2,3,0,3,0,True,False,False,0,1,2020-12-24T16:02:37.757,3,,0.0
2020,15,3009,50,19,7175,2,2,9,4,11,7,8,3,8,0,True,False,False,0,3,2020-12-21T11:47:46.74,11,,3.0
2020,15,3009,65,19,7620,3,38,9,0,0,0,0,0,0,0,False,False,False,0,4,2020-12-21T11:56:18.673,0,,0.0
2020,15,3009,90,17,7687,2,30,4,2,7,5,6,1,6,0,True,False,False,0,3,2020-12-21T12:11:20.873,7,,1.0
2020,15,3009,100,17,4383,2,6,9,6,8,2,7,1,7,0,False,False,False,0,2,2020-12-24T16:03:24.063,8,,1.0
2020,15,3009,105,17,4484,2,30,3,0,15,15,3,12,3,0,False,False,False,3,4,2020-12-24T16:07:59.823,15,,12.0
2020,15,3009,110,17,7687,2,34,4,-3,3,6,2,1,2,0,True,False,False,0,3,2020-12-21T12:25:00.92,3,,1.0
2020,15,3009,115,17,6276,2,26,10,10,15,5,13,2,13,0,False,False,False,0,3,2020-12-21T12:29:31.417,15,,2.0
2020,15,3009,145,17,4752,2,30,3,1,3,2,3,0,3,0,True,False,False,0,4,2020-12-21T12:49:47.327,3,,0.0
2020,15,3009,155,17,7687,13,5,5,3,0,0,0,0,0,0,False,False,False,0,1,2020-12-24T15:22:48.197,0,,0.0
2020,15,3009,175,19,3233,2,13,10,1,3,2,3,0,3,0,False,False,False,0,3,2020-12-21T13:05:28.473,3,,0.0
2020,15,3009,185,19,7175,2,13,10,3,8,5,8,0,8,0,True,False,False,0,3,2020-12-24T16:04:56.523,8,,0.0
2020,15,3009,190,19,7175,2,13,10,1,5,4,4,1,4,0,False,False,False,0,3,2020-12-21T13:13:09.463,5,,1.0
2020,15,3009,195,19,6266,2,4,4,4,8,4,8,0,8,0,False,False,False,0,1,2020-12-21T13:16:17.417,8,,0.0
2020,15,3009,205,19,7175,13,8,10,10,0,0,0,0,0,0,False,False,False,0,3,2020-12-21T13:24:23.893,0,,0.0
2020,15,3009,210,19,7173,2,13,10,3,6,3,4,2,4,0,True,False,False,0,2,2020-12-21T13:27:17.927,6,,
2020,15,3009,225,19,7173,13,4,3,14,0,0,0,0,0,0,False,False,False,0,2,2020-12-21T13:37:00.54,0,,0.0
2020,15,3009,255,17,4484,13,12,5,10,0,0,0,0,0,0,False,False,False,0,4,2021-03-09T14:08:16.75,0,,0.0
2020,15,3009,270,19,7175,13,5,6,15,0,0,0,0,0,0,False,False,False,0,3,2020-12-21T13:51:05.223,0,,0.0
2020,15,3009,280,19,1328,2,12,4,12,21,9,19,2,19,0,False,False,False,0,1,2020-12-21T13:56:24.64,21,,2.0
2020,15,3009,285,19,7173,2,13,9,8,12,4,10,2,10,0,False,False,False,0,3,2020-12-21T13:58:53.693,12,,2.0
2020,15,3009,295,19,7175,13,7,6,21,0,0,0,0,0,0,False,False,False,0,3,2020-12-21T14:03:52.13,0,,0.0
2020,15,3009,320,17,7618,13,13,4,2,0,0,0,0,0,0,False,False,False,0,2,2020-12-21T14:16:46.113,0,,0.0
2020,15,3009,325,17,7687,2,2,4,7,14,7,7,7,7,0,True,False,False,1,3,2020-12-24T16:11:30.467,14,,7.0
2020,15,3009,350,17,4383,3,6,9,14,0,0,0,0,0,0,False,False,False,0,2,2020-12-21T14:33:04.24,0,,0.0
2020,15,3009,355,17,7618,2,5,5,4,5,1,5,0,5,0,False,False,False,0,3,2020-12-21T14:35:27.133,5,,0.0
2020,15,3009,370,17,7051,2,28,3,6,9,3,8,1,8,0,False,False,False,0,1,2020-12-21T14:42:00.757,9,,1.0
2020,15,3009,400,17,4383,2,4,9,10,10,0,10,0,10,0,False,False,False,0,2,2020-12-21T14:59:20.767,10,,0.0
2020,15,3009,455,19,7175,2,35,7,20,20,0,20,0,20,0,False,True,True,0,3,2020-12-21T18:42:02.833,18,,0.0
2020,15,3009,460,17,7687,2,47,5,0,5,5,3,2,3,0,False,False,False,0,3,2020-12-21T15:28:27.27,5,,2.0
2020,15,3009,475,17,4752,2,4,9,8,8,0,8,0,8,0,False,False,False,0,2,2020-12-21T15:38:28.39,8,,0.0
2020,15,3009,480,17,3564,2,7,5,14,14,0,14,0,14,0,False,False,False,0,4,2020-12-24T15:05:52.427,14,,
2020,15,3009,495,19,8001,13,19,2,33,0,0,0,0,0,0,False,False,False,0,2,2020-12-21T16:12:17.807,0,,
2020,15,3009,505,19,7175,2,2,9,8,35,27,31,4,31,0,False,False,False,1,3,2020-12-21T16:16:24.967,35,,4.0
2020,15,3009,520,19,3233,13,2,4,7,0,0,0,0,0,0,False,False,False,0,2,2020-12-21T16:23:40.02,0,,0.0
2020,15,3009,530,19,7175,2,5,5,4,8,4,7,1,7,0,True,False,False,0,3,2020-12-21T16:27:10.623,8,,1.0
2020,15,3009,545,17,7687,2,30,3,1,4,3,0,4,0,0,True,False,False,0,4,2020-12-24T16:06:09.177,4,,4.0
2020,15,3009,550,17,6276,2,46,3,2,8,6,5,3,5,0,False,False,False,0,4,2020-12-21T16:34:11.053,8,,3.0
2020,15,3009,555,17,7618,13,28,9,2,0,0,0,0,0,0,False,False,False,0,1,2020-12-21T16:37:14.827,0,,0.0
2020,15,3009,605,17,6276,2,46,3,3,6,3,4,2,4,0,False,False,False,0,4,2020-12-21T16:59:05.93,6,,2.0
2020,15,3009,615,17,6276,2,55,9,0,1,1,0,1,0,0,False,False,False,0,4,2020-12-21T17:02:03.517,1,,1.0
2020,15,3009,650,19,3233,2,6,1,19,23,4,22,1,22,0,False,False,False,1,2,2020-12-21T17:12:53.77,23,,1.0
2020,15,3009,655,19,7622,13,12,5,2,0,0,0,0,0,0,False,False,False,0,4,2021-03-09T14:08:54.027,0,,
2020,15,3009,675,19,7622,13,17,7,22,0,0,0,0,0,0,False,False,False,0,3,2020-12-21T17:23:16.757,0,,0.0
2020,15,3009,695,17,6276,2,47,5,1,10,9,4,6,4,0,False,False,False,0,4,2020-12-21T17:29:09.097,10,,6.0
2020,15,3009,700,17,7687,2,30,9,-1,4,5,3,1,3,0,True,False,False,0,4,2020-12-21T17:31:28.2,4,,1.0
2020,15,3009,725,17,4752,2,30,3,5,7,2,7,0,7,0,True,False,False,0,4,2020-12-21T17:41:18.02,7,,0.0
2020,15,3009,760,19,7175,2,35,2,26,26,0,26,0,26,0,False,False,False,0,3,2020-12-21T17:52:05.567,26,,0.0
2020,15,3009,765,19,1328,2,5,9,5,8,3,7,1,7,0,False,False,False,0,1,2020-12-24T16:07:12.537,8,,1.0
2020,15,3009,770,19,1328,2,31,9,3,11,8,10,1,10,0,False,False,False,0,1,2020-12-24T15:22:48.197,11,,1.0
2020,15,3009,785,19,7622,2,38,9,1,4,3,4,0,4,0,False,True,False,0,4,2020-12-21T18:19:29.613,2,,0.0
2020,15,3009,790,19,1328,2,47,10,-1,12,13,9,3,9,0,False,False,False,0,1,2020-12-24T16:07:28.71,12,,3.0
2020,15,3010,10,6,7728,2,30,9,-2,7,9,4,3,4,0,True,False,False,0,4,2021-02-23T14:33:59.06,7,,3.0
2020,15,3010,60,6,811,2,44,3,-5,4,9,2,2,2,0,False,False,False,0,1,2021-02-23T14:34:31.457,4,,2.0
2020,15,3010,65,6,464,2,9,2,22,24,2,23,1,23,0,False,False,False,0,2,2020-12-21T11:47:27.78,24,,1.0
2020,15,3010,70,6,7725,2,30,9,1,8,7,6,2,6,6,False,False,False,0,4,2020-12-26T20:18:47.193,8,,2.0
2020,15,3010,85,18,1381,2,4,9,9,8,-1,8,0,8,0,False,False,False,0,2,2020-12-26T20:23:08.733,8,,0.0
2020,15,3010,95,18,6907,2,26,4,7,21,14,13,8,13,0,False,False,False,0,4,2020-12-21T12:04:59.46,21,,8.0
2020,15,3010,105,18,7711,2,35,7,17,23,6,21,2,21,0,False,False,False,0,3,2020-12-26T20:13:29.887,23,,2.0
2020,15,3010,120,18,1381,2,7,9,3,3,0,3,0,3,6,False,False,False,0,3,2020-12-21T12:12:15.11,3,,0.0
2020,15,3010,135,6,464,2,35,10,11,14,3,14,0,14,0,False,False,False,0,3,2020-12-21T12:15:34.643,14,,0.0
2020,15,3010,140,6,7725,2,45,5,-1,12,13,2,10,2,0,True,False,False,1,3,2020-12-21T12:18:42.1,12,,10.0
2020,15,3010,150,6,464,2,12,5,10,10,0,10,0,10,0,False,False,False,0,2,2020-12-21T12:23:46.46,10,,0.0
2020,15,3010,160,6,7728,2,4,9,4,5,1,4,1,4,0,False,False,False,0,3,2020-12-21T12:25:15.027,5,,1.0
2020,15,3010,165,6,6331,13,4,4,7,0,0,0,0,0,0,False,False,False,0,3,2020-12-21T12:27:13.01,0,,0.0
2020,15,3010,180,18,7711,2,4,9,5,9,4,6,3,6,0,False,False,False,0,3,2020-12-26T20:24:15.65,9,,3.0
2020,15,3010,220,6,666,2,35,9,11,16,5,14,2,14,0,False,False,False,0,4,2020-12-21T12:59:55.353,16,,2.0
2020,15,3010,250,6,464,13,7,6,16,0,0,0,0,0,0,False,False,False,0,3,2020-12-21T13:09:55.937,0,,0.0
2020,15,3010,315,18,7711,13,6,10,0,0,0,0,0,0,0,False,False,False,0,3,2020-12-21T13:38:36.8,0,,0.0
2020,15,3010,335,6,666,2,32,10,2,9,7,7,2,7,0,False,False,False,0,4,2020-12-26T20:29:45.69,9,,2.0
2020,15,3010,350,6,7725,13,7,2,17,0,0,0,0,0,0,False,False,False,0,3,2020-12-21T13:50:18.38,0,,0.0
2020,15,3010,355,6,6786,13,5,3,3,0,0,0,0,0,0,False,False,False,0,1,2020-12-21T13:52:27.93,0,,0.0
2020,15,3010,370,18,6907,2,32,3,4,5,1,5,0,5,0,False,False,False,0,4,2020-12-21T13:55:32.387,5,,0.0
2020,15,3010,380,18,7711,2,4,4,6,9,3,7,2,7,0,False,False,False,0,3,2020-12-21T13:58:31.233,9,,2.0
2020,15,3010,395,18,4572,2,48,9,-3,2,5,1,1,1,0,False,False,False,0,1,2021-02-23T14:38:01.247,2,,1.0
2020,15,3010,405,18,4572,2,28,10,2,2,0,2,0,2,0,False,False,False,0,1,2020-12-21T14:05:28.46,2,,
2020,15,3010,410,18,6361,13,26,4,0,0,0,0,0,0,0,True,False,False,0,4,2020-12-22T17:07:57.56,0,,0.0
2020,15,3010,420,18,4572,2,4,10,3,3,0,3,0,3,0,False,False,False,0,1,2020-12-22T17:08:06.813,3,,0.0
2020,15,3010,430,18,7711,13,12,3,6,0,0,0,0,0,0,False,False,False,0,3,2020-12-21T14:13:51.663,0,,0.0
2020,15,3010,435,18,6907,3,12,5,6,0,0,0,0,0,0,False,False,False,0,4,2020-12-26T20:30:43.773,0,,0.0
2020,15,3010,485,18,7711,2,5,6,16,16,0,16,0,16,0,False,False,False,0,3,2020-12-26T20:33:22.337,16,,0.0
2020,15,3010,530,6,6786,2,45,5,-1,16,17,14,2,14,0,False,False,False,0,1,2020-12-21T15:26:09.953,16,,2.0
2020,15,3010,545,6,666,13,35,5,14,0,0,0,0,0,0,False,False,False,0,4,2021-02-23T14:39:26.517,0,,0.0
2020,15,3010,555,6,6328,2,4,10,12,13,1,12,1,12,0,False,False,False,0,3,2020-12-21T15:44:21.57,13,,1.0
2020,15,3010,585,18,7711,2,5,6,20,26,6,24,2,24,0,False,False,False,0,2,2021-03-03T20:51:31.367,26,,2.0
2020,15,3010,590,18,6361,2,32,5,1,30,29,22,8,22,0,False,False,False,1,3,2021-03-03T20:51:39.993,30,,8.0
2020,15,3010,595,18,4572,2,45,5,-5,13,18,13,0,13,0,False,False,False,0,1,2020-12-21T16:01:34.133,13,,0.0
2020,15,3010,610,18,7711,13,7,9,4,0,0,0,0,0,0,False,False,False,0,3,2020-12-21T16:05:54.173,0,,0.0
2020,15,3010,640,6,7725,2,35,6,19,22,3,22,0,22,0,False,False,False,0,3,2020-12-21T16:14:06.783,22,,0.0
2020,15,3010,680,18,4572,2,47,5,2,3,1,3,0,3,0,False,False,False,0,1,2020-12-21T16:26:58.89,3,,0.0
2020,15,3010,685,18,6706,2,47,5,5,9,4,8,1,8,0,True,False,False,0,4,2020-12-22T17:08:38.703,9,,1.0
2020,15,3010,695,18,6900,2,32,9,2,14,12,13,1,13,0,False,False,False,0,1,2020-12-21T16:33:17.427,14,,1.0
2020,15,3010,700,18,1381,13,3,3,9,0,0,0,0,0,0,False,False,False,0,2,2020-12-21T16:35:16.307,0,,
2020,15,3010,715,18,1381,13,26,10,5,0,0,0,0,0,0,False,False,False,0,3,2020-12-21T16:42:28.483,0,,0.0
2020,15,3010,720,18,7711,2,50,9,0,5,5,4,1,4,0,False,False,False,0,2,2021-02-23T14:40:24.603,5,,1.0
2020,15,3010,725,18,7711,2,6,4,10,9,-1,9,0,9,0,False,False,False,0,3,2020-12-26T19:25:12.757,9,,0.0
2020,15,3010,730,18,6361,2,32,10,0,20,20,15,5,15,6,False,False,False,3,4,2020-12-26T20:20:01.793,20,,5.0
2020,15,3010,745,6,7725,2,26,9,-1,7,8,2,5,2,0,False,False,False,0,3,2020-12-21T16:50:42.18,7,,5.0
2020,15,3010,760,6,464,2,35,2,19,35,16,24,11,24,0,False,False,False,1,3,2020-12-21T16:57:43.583,35,,11.0
2020,15,3010,785,6,3607,13,9,9,6,0,0,0,0,0,0,False,False,False,0,2,2021-02-25T17:27:54.847,0,,0.0
2020,15,3010,795,18,4572,2,16,10,1,6,5,3,3,3,0,False,False,False,0,1,2020-12-21T17:07:32.073,6,,3.0
2020,15,3010,810,18,6361,13,30,5,11,0,0,0,0,0,0,True,False,False,0,1,2021-02-23T14:41:01.35,0,,0.0
2020,15,3010,855,18,6706,2,5,3,8,12,4,12,0,12,0,False,False,False,0,3,2020-12-26T20:38:42.167,12,,0.0
2020,15,3010,860,18,6361,2,31,4,4,7,3,6,1,6,0,False,False,False,0,4,2020-12-21T17:18:42.617,7,,1.0
2020,15,3010,865,18,6907,2,31,3,7,11,4,9,2,9,0,False,False,False,0,4,2020-12-26T20:18:23.12,11,,2.0
2020,15,3010,875,18,7711,2,5,3,7,7,0,7,0,7,0,False,False,False,0,2,2020-12-21T17:23:06.007,7,,0.0
2020,15,3010,880,18,6897,13,19,8,33,0,0,0,0,0,0,False,False,False,0,2,2020-12-21T17:25:16.463,0,,0.0
2020,15,3011,15,21,7090,13,5,3,4,0,0,0,0,0,0,False,False,False,0,3,2020-12-21T18:41:08.673,0,,0
2020,15,3011,30,21,3680,2,29,6,16,22,6,19,3,19,0,False,False,False,0,2,2020-12-21T18:41:42.883,22,,3
2020,15,3011,35,21,3680,13,29,3,13,0,0,0,0,0,0,False,False,False,0,3,2020-12-24T17:16:30.55,0,,0
2020,15,3011,45,21,4422,13,36,10,8,0,0,0,0,0,0,False,False,False,0,3,2020-12-21T11:48:01.817,0,,0
2020,15,3011,50,21,6582,13,33,9,8,0,0,0,0,0,0,False,False,False,0,5,2020-12-21T18:29:06.013,0,,0
2020,15,3011,60,8,232,2,4,9,4,3,-1,3,0,3,0,False,False,False,0,3,2020-12-21T12:10:04.383,3,,0
2020,15,3011,65,8,5053,2,16,9,3,5,2,4,1,4,0,True,False,False,0,1,2020-12-21T12:09:52.967,5,,1
2020,15,3011,75,8,232,2,5,5,7,8,1,8,0,8,0,False,False,False,0,2,2020-12-21T12:23:20.423,8,,0
2020,15,3011,80,8,3606,2,5,2,17,17,0,17,0,17,0,False,False,False,0,3,2020-12-21T12:26:52.11,17,,0
2020,15,3011,90,8,3883,2,53,9,-6,4,10,-3,7,-3,0,False,False,False,1,4,2021-02-23T14:58:58.533,4,,7
2020,15,3011,100,8,3883,13,4,9,5,0,0,0,0,0,0,False,False,False,0,3,2020-12-21T12:39:06.257,0,,0
2020,15,3011,115,21,7090,2,9,6,23,35,12,35,0,35,0,False,False,False,0,2,2020-12-21T18:43:40.263,35,,0
2020,15,3011,120,21,576,2,30,5,-1,-1,0,-1,0,-1,0,False,False,False,0,4,2020-12-21T12:49:48.933,-1,,0
2020,15,3011,125,21,4422,13,43,6,19,0,0,0,0,0,0,False,False,False,0,4,2020-12-21T12:53:16.93,0,,0
2020,15,3011,130,21,7090,13,9,2,19,0,0,0,0,0,0,False,False,False,0,2,2020-12-21T12:57:48.39,0,,0
2020,15,3011,145,8,232,2,44,3,-4,6,10,4,2,4,0,True,False,False,0,3,2020-12-21T13:02:13.06,6,,2
2020,15,3011,160,8,3883,2,4,3,10,17,7,17,0,17,0,False,False,False,0,3,2020-12-21T13:09:29.697,17,,0
2020,15,3011,165,8,7652,2,53,9,-2,10,12,8,2,8,0,True,False,False,0,4,2020-12-22T18:43:41.813,10,,2
2020,15,3011,175,8,3606,2,4,6,17,22,5,19,3,19,0,False,False,False,0,2,2020-12-21T13:15:36.9,22,,3
2020,15,3011,185,8,3606,13,9,2,16,0,0,0,0,0,0,False,False,False,0,2,2020-12-21T13:21:57.767,0,,0
2020,15,3011,190,8,7652,2,5,5,5,9,4,9,0,9,0,False,False,False,0,3,2020-12-22T18:40:43.713,9,,0
2020,15,3011,215,8,3883,2,33,9,2,2,0,2,0,2,6,False,False,False,0,4,2020-12-24T16:35:46.1,2,,0
2020,15,3011,245,21,3680,2,34,4,-4,12,16,10,2,10,0,True,False,False,0,3,2020-12-21T13:47:19.893,12,,2
2020,15,3011,260,21,4180,2,32,10,1,9,8,9,0,9,0,False,False,False,0,1,2020-12-21T13:54:52.72,9,,0
2020,15,3011,265,21,720,2,32,5,3,14,11,8,6,8,0,False,False,False,1,4,2020-12-21T13:57:55.593,14,,6
2020,15,3011,275,21,7090,13,35,5,10,0,0,0,0,0,0,False,False,False,0,3,2020-12-21T14:05:05.083,0,,0
2020,15,3011,295,8,5053,2,28,4,2,7,5,7,0,7,0,False,False,False,0,1,2020-12-21T14:16:05.663,7,,0
2020,15,3011,300,8,7651,2,8,10,14,18,4,18,0,18,0,False,False,False,0,3,2020-12-21T14:19:07.64,18,,0
2020,15,3011,305,8,232,2,30,10,-2,15,17,10,5,10,0,False,False,False,0,3,2021-03-10T20:31:35.56,15,,5
2020,15,3011,310,8,4976,2,35,2,21,22,1,22,0,22,0,False,False,False,0,4,2020-12-21T14:27:06.783,22,,0
2020,15,3011,320,8,232,2,4,9,5,5,0,5,0,5,0,False,False,False,0,3,2020-12-21T14:29:17.703,5,,0
2020,15,3011,355,8,232,2,35,10,2,2,0,2,0,2,6,False,False,False,0,3,2020-12-24T16:36:19.673,2,,0
2020,15,3011,385,8,3883,2,2,4,10,12,2,12,0,12,0,False,False,False,0,3,2020-12-21T15:01:18.617,12,,0
2020,15,3011,400,8,7651,2,4,8,18,18,0,18,0,18,0,False,False,False,0,2,2020-12-24T17:17:00.623,18,,0
2020,15,3011,410,21,7226,2,47,10,-1,0,1,0,0,0,0,False,False,False,0,4,2020-12-21T18:17:06.973,0,,0
2020,15,3011,420,21,3680,2,4,9,5,7,2,6,1,6,0,False,False,False,0,3,2020-12-21T15:21:04.24,7,,1
2020,15,3011,425,21,4422,2,46,3,0,1,1,0,1,0,0,False,False,False,0,4,2021-02-23T14:59:32.503,1,,1
2020,15,3011,435,21,7090,2,8,7,15,21,6,18,3,18,0,False,False,False,0,2,2020-12-21T18:37:23.073,21,,3
2020,15,3011,450,21,4422,2,31,10,4,8,4,8,0,8,0,False,False,False,0,4,2020-12-21T18:46:07.65,8,,0
2020,15,3011,480,8,232,13,6,8,19,0,0,0,0,0,0,False,False,False,0,2,2020-12-24T16:45:35.267,0,,0
2020,15,3011,485,8,3606,2,6,1,20,20,0,20,0,20,0,False,False,False,0,2,2020-12-24T16:40:02.74,20,,0
2020,15,3011,490,8,6439,2,45,5,-7,8,15,5,3,5,0,False,False,False,1,1,2020-12-21T16:17:22.617,8,,3
2020,15,3011,500,8,232,2,8,8,21,22,1,21,1,21,0,True,False,False,0,3,2020-12-24T16:40:12.903,22,,1
2020,15,3011,515,8,3883,2,4,10,6,6,0,6,0,6,0,True,False,False,0,3,2020-12-21T16:27:44.553,6,,0
2020,15,3011,525,8,3606,2,17,8,16,17,1,17,0,17,0,False,False,False,0,3,2021-02-25T17:30:45.387,17,,0
2020,15,3011,535,8,6439,2,6,10,5,8,3,5,3,5,0,True,False,False,1,2,2020-12-24T17:17:50.097,8,,3
2020,15,3011,570,21,3680,2,4,3,7,10,3,7,3,7,0,False,False,False,0,2,2020-12-21T16:56:14.067,10,,3
2020,15,3011,575,21,7090,13,5,2,16,0,0,0,0,0,0,False,False,False,0,3,2020-12-21T16:59:01.007,0,,0
2020,15,3011,580,21,7090,3,6,3,8,0,0,0,0,0,0,False,False,False,0,2,2020-12-21T18:49:03.137,0,,0
2020,15,3011,600,8,7651,2,13,9,6,19,13,17,2,17,0,False,False,False,0,3,2020-12-21T17:19:09.743,19,,2
2020,15,3011,610,8,5053,2,48,10,-5,-5,0,-5,0,-5,0,False,False,False,0,1,2020-12-24T17:18:06.283,-5,,0
2020,15,3011,630,21,3680,13,4,5,10,0,0,0,0,0,0,False,False,False,0,2,2021-02-23T15:00:36.267,0,,0
2020,15,3011,635,21,4422,13,4,4,8,0,0,0,0,0,0,False,False,False,0,3,2020-12-21T17:33:52.883,0,,0
2020,15,3011,640,21,576,2,4,10,14,14,0,14,0,14,0,False,False,False,0,3,2020-12-21T17:36:22.54,14,,0
2020,15,3011,645,21,4422,2,47,5,4,13,9,8,5,8,0,False,False,False,0,3,2020-12-21T18:50:17.583,13,,5
2020,15,3011,650,21,4422,2,17,8,17,24,7,19,5,19,0,False,False,False,0,3,2020-12-22T23:21:26.96,24,,5
2020,15,3011,655,21,2288,2,6,10,5,5,0,5,0,5,0,False,False,False,0,1,2020-12-22T23:21:39.833,5,,0
2020,15,3011,660,21,3680,13,7,2,16,0,0,0,0,0,0,False,False,False,0,2,2020-12-22T23:21:50.497,0,,0
2020,15,3011,665,21,576,13,9,6,21,0,0,0,0,0,0,False,False,False,0,3,2021-02-25T17:31:43.423,0,,0
2020,15,3011,685,8,4976,13,30,9,-1,0,0,0,0,0,0,False,False,False,0,4,2020-12-21T17:56:42.373,0,,0
2020,15,3011,735,21,2288,2,31,9,3,9,6,6,3,6,0,False,False,False,1,1,2020-12-21T18:31:16.2,9,,3
2020,15,3011,740,21,7090,2,4,3,12,12,0,12,0,12,0,False,False,False,0,2,2020-12-22T23:22:01.76,12,,0
2020,15,3011,750,21,7090,2,4,3,6,6,0,6,0,6,0,False,False,False,0,2,2020-12-21T18:14:10.103,6,,0
2020,15,3012,15,32,7128,2,50,9,-5,-2,3,-5,3,-5,0,False,False,False,0,2,2020-12-21T10:49:17.783,-2,,3.0
2020,15,3012,20,32,6430,2,13,4,1,0,-1,0,0,0,0,False,False,False,0,3,2020-12-25T00:37:39.36,0,,0.0
2020,15,3012,35,27,650,2,18,10,-1,6,7,6,0,6,0,False,False,False,0,3,2020-12-22T21:46:57.443,6,,0.0
2020,15,3012,55,27,5050,2,45,5,-3,3,6,3,0,3,0,False,False,False,0,1,2020-12-21T11:02:45.947,3,,0.0
2020,15,3012,70,27,153,2,6,9,0,5,5,5,0,5,0,False,False,False,0,1,2020-12-21T11:06:29.27,5,,0.0
2020,15,3012,90,32,7128,2,51,10,-4,0,4,-1,1,-1,0,False,False,False,0,3,2020-12-21T11:09:48.163,0,,1.0
2020,15,3012,125,27,5069,2,47,5,1,1,0,1,0,1,0,True,False,False,0,3,2020-12-21T11:17:32.317,1,,0.0
2020,15,3012,135,27,650,13,12,3,6,0,0,0,0,0,0,False,False,False,0,3,2020-12-25T00:09:48.807,0,,0.0
2020,15,3012,145,32,7128,13,3,2,16,0,0,0,0,0,0,False,False,False,0,2,2020-12-21T11:23:24.3,0,,0.0
2020,15,3012,150,32,1427,2,47,5,1,9,8,6,3,6,0,False,False,False,0,3,2020-12-25T00:28:03.903,9,,3.0
2020,15,3012,160,32,6430,2,30,5,1,1,0,1,0,1,0,True,False,False,0,4,2020-12-21T11:27:52.503,1,,0.0
2020,15,3012,175,32,3885,13,12,6,22,0,0,0,0,0,0,False,False,False,0,2,2020-12-21T11:32:42.373,0,,0.0
2020,15,3012,180,32,6318,3,2,9,9,0,0,0,0,0,0,False,False,False,0,2,2020-12-21T11:34:19.333,0,,0.0
2020,15,3012,190,27,650,2,4,1,15,15,0,15,0,15,0,False,False,False,0,3,2020-12-21T11:36:01.663,15,,0.0
2020,15,3012,200,27,650,2,4,5,7,7,0,7,0,7,0,False,False,False,0,2,2020-12-22T21:42:50.193,7,,0.0
2020,15,3012,215,27,650,2,39,10,6,6,0,6,0,6,0,False,False,False,0,3,2020-12-25T00:28:27.97,6,,0.0
2020,15,3012,220,27,7852,13,19,6,39,0,0,0,0,0,0,False,False,False,0,2,2020-12-21T11:50:29.267,0,,
2020,15,3012,230,27,650,3,12,9,8,0,0,0,0,0,0,False,False,False,0,3,2020-12-21T11:54:48.103,0,,0.0
2020,15,3012,240,27,7408,13,9,2,27,0,0,0,0,0,0,False,False,False,0,2,2021-02-23T18:58:41.743,0,,
2020,15,3012,245,27,5069,13,2,9,3,0,0,0,0,0,0,False,False,False,0,2,2020-12-21T12:02:02.193,0,,0.0
2020,15,3012,260,32,1427,2,4,10,4,11,7,8,3,8,0,False,False,False,0,3,2021-02-23T15:07:03.103,11,,3.0
2020,15,3012,265,32,1427,2,32,10,2,2,0,2,0,2,0,True,False,False,0,1,2020-12-21T12:06:26.787,2,,0.0
2020,15,3012,275,32,1427,2,5,5,8,11,3,9,2,9,0,False,False,False,0,3,2020-12-21T12:09:15.54,11,,2.0
2020,15,3012,280,32,3708,3,13,10,3,0,0,0,0,0,0,False,False,False,0,2,2020-12-21T12:10:18.18,0,,0.0
2020,15,3012,285,32,1427,2,4,10,5,20,15,18,2,18,0,False,False,False,0,3,2020-12-21T12:11:40.887,20,,2.0
2020,15,3012,295,32,6430,13,12,8,24,0,0,0,0,0,0,False,False,False,0,3,2020-12-25T00:03:11.767,0,,0.0
2020,15,3012,300,27,7408,2,4,10,4,6,2,4,2,4,0,False,False,False,0,3,2020-12-25T00:24:35.213,6,,2.0
2020,15,3012,320,27,5069,2,49,5,-3,9,12,6,3,6,0,False,False,False,0,2,2020-12-21T12:22:15.553,9,,3.0
2020,15,3012,325,27,7852,2,49,3,-2,3,5,1,2,1,0,False,False,False,0,2,2020-12-21T12:24:01.13,3,,2.0
2020,15,3012,335,27,7408,13,35,6,19,0,0,0,0,0,0,False,False,False,0,3,2020-12-21T12:27:24.243,0,,
2020,15,3012,345,27,5069,13,21,5,13,0,0,0,0,0,0,False,False,False,0,2,2020-12-21T12:29:25.673,0,,0.0
2020,15,3012,360,27,4835,2,4,4,10,10,0,10,0,10,6,False,False,False,0,3,2020-12-22T21:43:05.48,10,,0.0
2020,15,3012,375,32,3885,2,4,9,9,13,4,13,0,13,0,False,False,False,0,3,2020-12-21T12:49:33.037,13,,0.0
2020,15,3012,380,32,1427,2,5,10,3,3,0,3,0,3,0,False,False,False,0,3,2020-12-21T12:50:34.587,3,,0.0
2020,15,3012,385,32,7128,3,29,6,26,0,0,0,0,0,0,False,False,False,0,2,2020-12-21T12:52:42.74,0,,0.0
2020,15,3012,390,32,1427,2,47,5,1,10,9,10,0,10,0,False,False,False,0,3,2020-12-21T12:53:38.413,10,,0.0
2020,15,3012,395,32,6430,3,2,10,4,0,0,0,0,0,0,False,False,False,0,2,2020-12-21T12:55:13.78,0,,0.0
2020,15,3012,405,32,3885,2,12,5,4,4,0,4,0,4,0,False,False,False,0,3,2020-12-21T12:57:15.493,4,,0.0
2020,15,3012,410,32,7128,2,2,10,9,18,9,18,0,18,0,False,False,False,0,2,2020-12-21T12:58:47.68,18,,0.0
2020,15,3012,420,32,1427,2,32,5,-3,-2,1,-2,0,-2,0,False,False,False,0,1,2020-12-21T13:00:02.02,-2,,0.0
2020,15,3012,430,32,7494,13,5,3,6,0,0,0,0,0,0,False,False,False,0,3,2020-12-21T13:01:13.243,0,,0.0
2020,15,3012,435,32,1427,13,47,5,2,0,0,0,0,0,0,False,False,False,0,3,2021-01-13T19:48:25.793,0,,0.0
2020,15,3012,465,27,5050,2,44,3,-3,3,6,2,1,2,0,False,False,False,0,1,2021-02-23T18:59:47.763,3,,1.0
2020,15,3012,505,32,1427,2,5,9,5,5,0,5,0,5,0,False,False,False,0,3,2020-12-21T13:13:04.833,5,,0.0
2020,15,3012,510,32,7128,2,9,2,26,30,4,26,4,26,0,False,False,False,0,3,2020-12-21T13:14:34.08,30,,4.0
2020,15,3012,515,32,6430,13,35,7,22,0,0,0,0,0,0,False,False,False,0,3,2020-12-21T13:17:26.803,0,,0.0
2020,15,3012,530,27,153,2,32,9,0,3,3,2,1,2,0,True,False,False,0,3,2020-12-21T13:20:29.363,3,,1.0
2020,15,3012,545,32,8237,2,26,9,3,5,2,4,1,4,0,False,False,False,0,3,2020-12-25T00:31:28.963,5,,1.0
2020,15,3012,550,32,3885,2,46,3,0,1,1,1,0,1,0,False,False,False,0,1,2020-12-21T13:29:09.217,1,,0.0
2020,15,3012,570,27,650,13,39,4,5,0,0,0,0,0,0,False,False,False,0,3,2021-02-23T19:01:02.43,0,,0.0
2020,15,3012,575,27,7408,2,50,3,-2,4,6,2,2,2,0,False,False,False,0,2,2020-12-21T13:34:12.533,4,,2.0
2020,15,3012,590,32,3885,2,46,3,0,0,0,0,0,0,0,False,False,False,0,1,2020-12-21T13:39:43.26,0,,0.0
2020,15,3012,595,32,6318,2,13,10,2,9,7,6,3,6,0,False,False,False,0,2,2020-12-21T13:41:54.933,9,,3.0
2020,15,3012,600,32,1427,2,13,9,2,7,5,3,4,3,0,False,False,False,0,3,2021-02-23T15:12:25.55,7,,4.0
2020,15,3012,605,32,1427,2,51,5,3,17,14,16,1,16,0,False,False,False,0,3,2021-02-23T15:13:17.33,17,,1.0
2020,15,3012,620,32,7128,13,12,3,9,0,0,0,0,0,0,False,False,False,0,3,2020-12-21T13:49:59.48,0,,0.0
2020,15,3012,625,32,7128,2,6,10,14,17,3,17,0,17,0,False,False,False,0,2,2020-12-21T13:51:32.69,17,,0.0
2020,15,3012,630,32,1427,2,13,9,3,3,0,3,0,3,0,False,False,False,0,4,2020-12-21T13:52:42.393,3,,0.0
2020,15,3012,640,32,3885,2,46,3,4,12,8,8,4,8,0,True,False,False,0,1,2020-12-21T13:56:48.83,12,,4.0
2020,15,3012,650,32,7128,13,29,3,1,0,0,0,0,0,0,False,False,False,0,2,2020-12-25T00:17:30.367,0,,0.0
2020,15,3012,670,27,7408,2,2,10,9,15,6,14,1,14,0,False,False,False,0,2,2020-12-21T14:09:27.8,15,,1.0
2020,15,3012,675,27,7408,2,35,10,9,11,2,11,0,11,0,False,False,False,0,3,2021-02-23T15:13:58.293,11,,0.0
2020,15,3012,685,27,7408,13,2,9,8,0,0,0,0,0,0,False,False,False,0,2,2020-12-21T14:11:21.983,0,,0.0
2020,15,3012,690,27,7408,2,2,10,8,7,-1,7,0,7,0,False,False,False,0,3,2020-12-21T14:12:21.773,7,,0.0
2020,15,3012,695,27,5050,13,12,5,3,0,0,0,0,0,0,False,False,False,0,1,2020-12-21T14:15:25.46,0,,0.0
2020,15,3012,700,32,7128,13,5,3,4,0,0,0,0,0,0,False,False,False,0,3,2020-12-21T14:20:05.15,0,,0.0
2020,15,3012,705,32,3885,2,5,3,5,13,8,13,0,13,0,False,False,False,0,3,2020-12-21T14:21:03.04,13,,0.0
2020,15,3012,710,32,3885,2,13,9,4,5,1,5,0,5,0,True,False,False,0,2,2020-12-21T14:22:23.403,5,,0.0
2020,15,3012,715,32,1427,13,51,3,2,0,0,0,0,0,0,False,False,False,0,3,2020-12-21T14:24:01.533,0,,0.0
2020,15,3012,720,32,6430,2,2,9,9,10,1,10,0,10,0,False,False,False,0,2,2020-12-21T14:25:10.77,10,,0.0
2020,15,3012,735,32,6430,2,4,10,9,9,0,9,0,9,0,False,False,False,0,2,2020-12-21T14:27:39.917,9,,0.0
2020,15,3012,745,32,6430,2,13,9,2,6,4,6,0,6,0,False,False,False,0,3,2020-12-25T00:24:46.013,6,,0.0
2020,15,3012,750,32,3885,2,47,5,0,6,6,6,0,6,6,False,False,False,0,1,2020-12-21T14:31:54.27,6,,0.0
2020,15,3012,770,27,4835,2,4,4,5,7,2,7,0,7,0,False,False,False,0,3,2020-12-21T14:34:56.773,7,,0.0
2020,15,3012,775,27,153,3,12,3,9,0,0,0,0,0,0,True,False,False,0,2,2021-02-23T19:00:00.157,0,,0.0
2020,15,3012,800,32,1427,2,5,10,5,5,0,5,0,5,0,False,False,False,0,3,2020-12-21T14:41:46.947,5,,0.0
2020,15,3012,805,32,3885,2,28,10,-1,2,3,2,0,2,0,False,False,False,0,1,2020-12-25T00:35:13.737,2,,0.0
2020,15,3012,815,32,8237,2,4,4,5,10,5,9,1,9,0,False,False,False,1,3,2020-12-21T14:47:05.083,10,,1.0
2020,15,3012,820,32,7128,2,2,9,6,9,3,9,0,9,0,False,False,False,0,2,2020-12-21T14:49:21.613,9,,0.0
2020,15,3012,825,32,7128,2,5,3,4,5,1,5,0,5,0,False,False,False,0,3,2020-12-21T14:58:23.357,5,,0.0
2020,15,3012,835,32,7494,2,6,9,5,11,6,9,2,9,0,False,False,False,0,3,2020-12-21T15:01:33.563,11,,2.0
2020,15,3012,840,32,1427,13,17,7,23,0,0,0,0,0,0,False,False,False,0,4,2020-12-21T15:03:17.047,0,,0.0
2020,15,3012,865,32,1427,13,12,8,37,0,0,0,0,0,0,False,False,False,0,3,2020-12-25T00:09:36.357,0,,0.0
2020,15,3013,10,1,525,2,35,7,15,15,0,15,0,15,0,False,False,False,0,3,2020-12-21T10:48:46.157,15,,0.0
2020,15,3013,20,1,6405,2,4,10,11,16,5,16,0,16,0,False,False,False,0,2,2020-12-21T10:52:09.503,16,,0.0
2020,15,3013,30,1,4307,2,48,10,-5,6,11,3,3,3,0,False,False,False,0,1,2020-12-27T17:34:08.473,6,,3.0
2020,15,3013,40,1,6406,2,5,3,2,8,6,8,0,8,0,False,False,False,0,3,2020-12-21T11:00:47.98,8,,
2020,15,3013,45,1,5152,2,32,10,3,10,7,9,1,9,0,False,False,False,0,3,2020-12-27T17:48:43.317,10,,1.0
2020,15,3013,60,1,245,2,4,9,4,4,0,4,0,4,0,False,True,True,0,3,2020-12-21T11:09:30.467,1,,0.0
2020,15,3013,70,24,4382,13,12,3,13,0,0,0,0,0,0,False,False,False,0,3,2020-12-27T17:35:15.127,0,,0.0
2020,15,3013,90,1,245,13,12,6,17,0,0,0,0,0,0,False,False,False,0,2,2020-12-27T17:45:33.933,0,,0.0
2020,15,3013,95,1,6406,13,4,4,4,0,0,0,0,0,0,False,False,False,0,1,2020-12-21T11:26:46.903,0,,0.0
2020,15,3013,130,1,2416,2,38,5,5,42,37,9,33,9,0,True,False,False,1,4,2020-12-22T17:34:19.083,42,,33.0
2020,15,3013,150,24,6373,2,30,5,3,5,2,3,2,3,0,False,False,False,1,4,2020-12-27T17:31:03.567,5,,2.0
2020,15,3013,155,24,6937,2,48,9,-8,26,34,24,2,24,0,False,False,False,0,1,2020-12-21T11:51:51.897,26,,2.0
2020,15,3013,165,24,7798,2,50,3,-3,-6,-3,-6,0,-6,0,False,False,False,0,2,2020-12-27T17:29:04.56,-6,,0.0
2020,15,3013,180,1,245,13,2,9,5,0,0,0,0,0,0,False,False,False,0,3,2020-12-27T17:29:31.09,0,,0.0
2020,15,3013,185,1,6406,2,46,9,1,6,5,6,0,6,6,True,False,False,0,1,2021-02-23T14:10:49.703,6,,0.0
2020,15,3013,200,24,7798,2,5,5,10,10,0,10,0,10,0,False,False,False,0,2,2020-12-21T12:07:11.5,10,,0.0
2020,15,3013,210,24,264,2,19,2,23,24,1,24,0,24,0,False,False,False,0,2,2020-12-27T17:48:43.317,24,,0.0
2020,15,3013,215,24,6373,2,5,3,9,16,7,14,2,14,0,False,False,False,1,3,2020-12-21T12:13:46.413,16,,2.0
2020,15,3013,230,24,7798,13,8,1,32,0,0,0,0,0,0,False,False,False,0,2,2020-12-21T12:17:36.923,0,,0.0
2020,15,3013,235,24,7800,2,50,3,-3,32,35,32,0,32,6,False,False,False,0,2,2020-12-22T20:21:46.52,32,,0.0
2020,15,3013,250,1,245,2,23,7,40,45,5,40,5,40,0,False,False,False,0,3,2020-12-21T12:25:23.45,45,,5.0
2020,15,3013,265,1,6405,2,44,3,-5,2,7,0,2,0,0,True,False,False,0,3,2021-02-23T14:11:59.38,2,,2.0
2020,15,3013,290,24,894,13,5,5,9,0,0,0,0,0,0,False,False,False,0,3,2020-12-21T12:38:29.53,0,,0.0
2020,15,3013,300,24,6389,2,48,9,-4,7,11,4,3,4,0,False,False,False,0,1,2020-12-21T12:41:37.327,7,,3.0
2020,15,3013,305,24,7798,13,19,2,28,0,0,0,0,0,0,False,False,False,0,2,2020-12-21T12:44:16.27,0,,0.0
2020,15,3013,320,1,245,2,4,8,15,15,0,15,0,15,0,False,False,False,0,3,2020-12-27T17:38:16.213,15,,0.0
2020,15,3013,355,24,4382,2,5,3,4,4,0,4,0,4,6,False,False,False,0,3,2021-03-08T15:43:59.827,4,,0.0
2020,15,3013,385,1,5152,2,22,7,18,21,3,21,0,21,0,False,False,False,0,4,2020-12-21T13:09:16.983,21,,0.0
2020,15,3013,395,1,525,2,4,9,4,6,2,4,2,4,0,False,False,False,0,3,2020-12-21T13:12:43.99,6,,2.0
2020,15,3013,400,1,5152,2,17,8,21,23,2,22,1,22,0,False,False,False,0,4,2020-12-21T13:14:23.813,23,,1.0
2020,15,3013,410,1,525,2,7,3,14,14,0,14,0,14,6,False,False,False,0,3,2020-12-21T13:26:34.843,14,,0.0
2020,15,3013,435,24,7798,2,3,3,10,12,2,12,0,12,0,False,False,False,0,2,2020-12-21T13:32:21.613,12,,0.0
2020,15,3013,440,24,894,2,22,2,30,42,12,37,5,37,0,False,False,False,0,3,2020-12-27T17:48:43.317,42,,5.0
2020,15,3013,445,24,7798,13,19,2,15,0,0,0,0,0,0,False,False,False,0,2,2020-12-27T17:48:43.317,0,,0.0
2020,15,3013,450,24,7798,13,21,6,16,0,0,0,0,0,0,False,False,False,0,2,2020-12-21T13:40:10.683,0,,
2020,15,3013,475,24,4382,2,7,3,5,5,0,5,0,5,6,False,False,False,0,2,2020-12-27T17:53:08.183,5,,0.0
2020,15,3013,530,1,245,2,4,3,9,9,0,9,0,9,0,False,False,False,0,2,2020-12-21T13:59:34.817,9,,0.0
2020,15,3013,535,1,6406,2,44,3,-5,1,6,-3,4,-3,0,False,False,False,0,1,2020-12-21T14:01:27.157,1,,4.0
2020,15,3013,540,1,7316,2,12,2,30,32,2,30,2,30,0,False,False,False,0,2,2020-12-21T14:04:00.78,32,,2.0
2020,15,3013,555,24,894,2,5,2,16,27,11,27,0,27,0,False,False,False,0,4,2020-12-21T14:25:09.507,27,,0.0
2020,15,3013,565,24,7798,2,3,5,11,10,-1,10,0,10,0,False,False,False,0,2,2020-12-21T14:27:51.897,10,,0.0
2020,15,3013,575,24,894,13,3,9,7,0,0,0,0,0,0,False,False,False,0,3,2020-12-27T17:48:43.317,0,,0.0
2020,15,3013,580,24,6373,13,50,9,-3,0,0,0,0,0,0,True,False,False,0,3,2020-12-27T17:48:43.317,0,,0.0
2020,15,3013,590,1,245,2,3,6,16,16,0,16,0,16,0,False,False,False,0,2,2020-12-21T14:36:17.043,16,,0.0
2020,15,3013,600,1,245,2,2,9,7,11,4,9,2,9,0,False,False,False,0,2,2020-12-21T14:40:59.113,11,,2.0
2020,15,3013,615,1,6406,13,4,9,2,0,0,0,0,0,0,False,False,False,0,3,2020-12-21T14:46:54.93,0,,0.0
2020,15,3013,620,1,5152,13,4,1,18,0,0,0,0,0,0,False,False,False,0,3,2020-12-21T14:48:49.063,0,,0.0
2020,15,3013,655,1,6405,2,5,5,7,15,8,13,2,13,0,False,False,False,0,2,2020-12-21T15:02:28.25,15,,2.0
2020,15,3013,670,1,6405,13,2,10,7,0,0,0,0,0,0,False,False,False,0,2,2020-12-21T15:12:59.2,0,,0.0
2020,15,3013,680,24,6937,13,47,5,1,0,0,0,0,0,0,False,False,False,0,1,2020-12-27T17:40:39.623,0,,0.0
2020,15,3013,685,24,6373,2,47,5,3,4,1,4,0,4,0,True,False,False,0,4,2021-03-03T21:01:22.837,4,,0.0
2020,15,3013,690,24,264,13,19,2,28,0,0,0,0,0,0,False,False,False,0,2,2020-12-21T15:20:19.25,0,,
2020,15,3013,705,24,6373,13,12,2,16,0,0,0,0,0,0,False,False,False,0,4,2020-12-21T15:26:20.607,0,,0.0
2020,15,3013,710,24,7798,2,50,3,-2,23,25,21,2,21,0,False,False,False,0,2,2021-02-23T14:13:52.357,23,,2.0
2020,15,3013,725,24,264,13,19,2,28,0,0,0,0,0,0,False,False,False,0,2,2020-12-22T21:42:04.337,0,,
2020,15,3013,750,1,245,2,50,3,-1,8,9,6,2,6,0,False,False,False,1,2,2020-12-27T17:31:58.177,8,,2.0
2020,15,3013,765,1,525,13,9,6,22,0,0,0,0,0,0,False,False,False,0,3,2020-12-21T15:53:24.717,0,,0.0
2020,15,3013,770,1,6411,2,19,10,14,26,12,22,4,22,0,False,False,False,0,1,2020-12-21T15:56:13.947,26,,4.0
2020,15,3013,775,1,4307,2,48,9,-4,8,12,6,2,6,0,False,False,False,0,1,2020-12-21T15:57:54.97,8,,2.0
2020,15,3013,790,1,7316,13,3,3,11,0,0,0,0,0,0,False,False,False,0,3,2020-12-27T17:48:43.317,0,,0.0
2020,15,3013,805,24,894,13,5,5,2,0,0,0,0,0,0,False,False,False,0,4,2020-12-21T16:09:52.527,0,,0.0
2020,15,3013,815,1,5152,13,17,1,23,0,0,0,0,0,0,False,False,False,0,4,2020-12-21T16:14:07.477,0,,0.0
2020,15,3013,835,1,245,2,4,3,10,44,34,10,34,10,0,False,False,False,0,2,2020-12-27T17:41:37.713,44,,34.0
2020,15,3013,840,1,6406,2,50,3,-2,12,14,12,0,12,0,False,False,False,0,2,2020-12-27T17:48:43.317,12,,0.0
2020,15,3013,845,1,5032,2,53,9,-5,2,7,1,1,1,0,False,False,False,0,4,2020-12-27T17:42:07.777,2,,1.0
2020,15,3013,850,1,7316,2,4,4,5,6,1,6,0,6,0,False,False,False,0,3,2020-12-27T17:48:43.317,6,,0.0
2020,15,3013,855,1,245,2,29,6,17,20,3,17,3,17,6,False,False,False,0,2,2020-12-21T16:28:24.993,20,,3.0
2020,15,3013,870,24,894,13,35,9,9,0,0,0,0,0,0,False,False,False,0,4,2020-12-21T16:34:54.2,0,,0.0
2020,15,3013,875,24,7800,2,51,9,-5,3,8,-5,8,-5,0,False,False,False,1,3,2020-12-27T17:32:22.143,3,,8.0
2020,15,3013,880,24,4382,2,35,9,10,12,2,11,1,11,0,False,False,False,0,3,2020-12-21T16:36:38.697,12,,1.0
2020,15,3013,885,24,4382,2,45,5,-6,-6,0,-6,0,-6,0,True,False,False,0,3,2020-12-21T16:38:43.07,-6,,0.0
2020,15,3013,895,24,264,2,5,6,15,39,24,36,3,36,0,False,False,False,0,2,2020-12-27T17:55:23.11,39,,3.0
2020,15,3013,910,24,7800,2,51,10,0,5,5,3,2,3,0,False,False,False,0,3,2020-12-27T17:42:38.51,5,,2.0
2020,15,3013,930,24,6373,13,8,7,22,0,0,0,0,0,0,False,False,False,0,3,2020-12-21T16:53:59.317,0,,0.0
2020,15,3013,935,24,6373,13,17,7,21,0,0,0,0,0,0,False,False,False,0,3,2020-12-21T16:56:06.717,0,,0.0
2020,15,3013,975,24,894,13,13,4,4,0,0,0,0,0,0,False,False,False,0,3,2020-12-21T17:06:01.7,0,,0.0
2020,15,3013,980,24,264,13,9,2,18,0,0,0,0,0,0,False,False,False,0,2,2020-12-27T17:53:22.753,0,,0.0
2020,15,3013,995,24,6808,2,4,3,12,12,0,12,0,12,0,False,False,False,0,2,2020-12-21T17:12:21.187,12,,0.0
2020,15,3013,1000,24,6373,2,12,5,14,14,0,14,0,14,0,False,False,False,0,3,2020-12-21T17:20:53.65,14,,0.0
2020,15,3013,1005,24,7800,13,7,7,18,0,0,0,0,0,0,False,False,False,0,2,2020-12-27T17:55:31.597,0,,0.0
2020,15,3013,1010,24,6808,2,5,2,18,18,0,18,0,18,0,False,False,False,0,2,2020-12-27T17:48:43.317,18,,0.0
2020,15,3013,1020,24,894,13,19,8,31,0,0,0,0,0,0,False,False,False,0,3,2020-12-21T17:30:57.913,0,,0.0
2020,15,3013,1025,24,6808,13,19,7,31,0,0,0,0,0,0,False,False,False,0,2,2020-12-21T17:32:44.223,0,,0.0
2020,15,3014,10,16,374,2,2,4,6,8,2,7,1,7,0,False,False,False,0,3,2020-12-21T11:21:40.9,8,,1.0
2020,15,3014,25,16,7681,2,45,5,-6,4,10,2,2,2,0,False,False,False,0,1,2020-12-21T11:28:56.21,4,,2.0
2020,15,3014,30,16,3938,13,5,9,11,0,0,0,0,0,0,False,False,False,0,3,2020-12-27T19:37:12.317,0,,0.0
2020,15,3014,45,20,4535,13,7,6,21,0,0,0,0,0,0,True,False,False,0,1,2020-12-22T21:38:14.853,0,,0.0
2020,15,3014,50,20,6388,13,6,9,8,0,0,0,0,0,0,False,False,False,0,3,2020-12-23T06:23:44.757,0,,0.0
2020,15,3014,60,16,7176,3,12,4,11,0,0,0,0,0,0,False,False,False,0,3,2021-03-09T14:16:54.84,0,,0.0
2020,15,3014,65,16,7176,13,8,1,57,0,0,0,0,0,0,False,False,False,0,2,2021-03-05T15:34:40.15,0,,
2020,15,3014,70,16,3938,2,30,5,-4,-5,-1,-5,0,-5,0,True,False,False,0,3,2020-12-21T11:49:14.363,-5,,0.0
2020,15,3014,75,16,121,13,12,7,15,0,0,0,0,0,0,False,False,False,0,3,2020-12-23T06:22:48.443,0,,0.0
2020,15,3014,80,16,7176,13,7,6,38,0,0,0,0,0,0,False,False,False,0,3,2020-12-21T11:54:14.08,0,,0.0
2020,15,3014,90,20,5140,13,51,5,-3,0,0,0,0,0,0,True,False,False,0,1,2020-12-22T21:36:35.823,0,,0.0
2020,15,3014,100,20,7356,13,7,5,12,0,0,0,0,0,0,False,False,False,0,2,2020-12-23T06:25:08.997,0,,0.0
2020,15,3014,110,16,7176,2,12,5,2,4,2,0,4,0,0,False,False,False,0,3,2020-12-27T19:38:39.877,4,,
2020,15,3014,120,16,3938,3,13,10,3,0,0,0,0,0,0,False,False,False,0,3,2020-12-21T12:10:54.827,0,,0.0
2020,15,3014,125,16,374,2,5,10,9,11,2,10,1,10,0,False,False,False,0,4,2020-12-27T19:38:53.867,11,,1.0
2020,15,3014,140,16,6565,2,30,10,-2,6,8,3,3,3,0,False,False,False,0,4,2020-12-23T06:50:03.613,6,,3.0
2020,15,3014,145,16,3938,2,47,5,5,5,0,5,0,5,6,True,False,False,0,3,2020-12-23T06:49:49.463,5,,0.0
2020,15,3014,170,20,213,13,19,2,22,0,0,0,0,0,0,False,False,False,0,3,2020-12-21T12:34:18.46,0,,0.0
2020,15,3014,180,16,34,2,47,10,3,14,11,11,3,11,0,False,False,False,0,1,2020-12-27T19:42:13.9,14,,3.0
2020,15,3014,190,16,121,2,6,4,10,10,0,10,0,10,0,False,False,False,0,2,2020-12-23T06:26:58.46,10,,0.0
2020,15,3014,195,16,121,2,12,8,16,23,7,23,0,23,0,False,False,False,0,2,2020-12-21T12:43:49.15,23,,0.0
2020,15,3014,200,16,7176,13,35,8,24,0,0,0,0,0,0,False,False,False,0,3,2020-12-27T19:46:14.473,0,,0.0
2020,15,3014,205,16,4143,2,5,3,8,23,15,17,6,17,0,False,False,False,0,2,2020-12-23T06:28:49.057,23,,6.0
2020,15,3014,220,16,3938,2,5,3,14,19,5,19,0,19,0,False,False,False,0,3,2020-12-21T12:54:22.307,19,,0.0
2020,15,3014,235,16,374,2,49,10,-2,1,3,1,0,1,6,False,False,False,0,3,2020-12-21T15:18:01.043,1,,0.0
2020,15,3014,250,20,8127,3,5,3,4,0,0,0,0,0,0,False,False,False,0,3,2020-12-21T13:00:04.063,0,,0.0
2020,15,3014,270,16,7681,13,12,3,6,0,0,0,0,0,0,False,False,False,0,1,2020-12-27T19:37:37.197,0,,0.0
2020,15,3014,275,16,374,13,19,6,37,0,0,0,0,0,0,False,False,False,0,3,2020-12-21T13:24:40.72,0,,0.0
2020,15,3014,280,16,3938,13,4,10,10,0,0,0,0,0,0,False,False,False,0,3,2020-12-21T13:27:05.517,0,,0.0
2020,15,3014,295,20,5140,2,32,5,-1,5,6,3,2,3,0,False,False,False,0,1,2020-12-22T21:41:18.827,5,,2.0
2020,15,3014,300,20,4535,13,30,10,0,0,0,0,0,0,0,True,False,False,0,4,2020-12-27T19:38:06.357,0,,0.0
2020,15,3014,305,20,306,3,28,9,-7,0,0,0,0,0,0,False,False,False,0,1,2020-12-21T13:33:45.173,0,,0.0
2020,15,3014,310,20,213,2,19,2,38,51,13,45,6,45,0,False,False,False,0,3,2020-12-23T06:29:49.617,51,,6.0
2020,15,3014,370,16,374,13,12,10,6,0,0,0,0,0,0,True,False,False,0,3,2020-12-21T13:59:07.083,0,,0.0
2020,15,3014,380,16,2507,2,12,10,-2,7,9,3,4,3,0,False,False,False,0,5,2021-03-24T19:43:12.863,7,,
2020,15,3014,400,20,306,2,48,10,-5,7,12,3,4,3,0,False,False,False,0,1,2020-12-21T18:18:13.987,2,,4.0
2020,15,3014,410,20,5140,3,45,5,-5,0,0,0,0,0,0,False,False,False,0,1,2020-12-21T14:14:01.863,0,,0.0
2020,15,3014,430,16,3938,2,51,10,-3,2,5,0,2,0,0,False,False,False,1,3,2020-12-21T14:21:00.36,2,,2.0
2020,15,3014,455,16,374,13,4,9,8,0,0,0,0,0,0,False,False,False,0,3,2020-12-21T14:24:56.447,0,,0.0
2020,15,3014,460,16,7176,13,35,8,30,0,0,0,0,0,0,False,False,False,0,3,2020-12-21T14:27:11.3,0,,0.0
2020,15,3014,470,20,5140,2,48,10,-4,21,25,11,10,11,0,False,False,False,0,1,2020-12-21T14:30:39.643,21,,10.0
2020,15,3014,475,20,958,2,5,5,6,8,2,6,2,6,0,False,False,False,0,3,2020-12-21T14:32:34.523,8,,2.0
2020,15,3014,480,20,958,13,6,8,15,0,0,0,0,0,0,False,False,False,0,3,2020-12-21T14:33:46.257,0,,0.0
2020,15,3014,485,20,8127,13,2,9,4,0,0,0,0,0,0,False,False,False,0,2,2020-12-21T14:35:48.283,0,,0.0
2020,15,3014,510,20,6388,2,6,8,17,25,8,20,5,20,0,False,False,False,0,3,2020-12-22T21:46:14.673,25,,5.0
2020,15,3014,520,20,4535,13,7,6,18,0,0,0,0,0,0,True,False,False,0,4,2020-12-27T19:43:22.797,0,,
2020,15,3014,525,20,958,13,17,7,20,0,0,0,0,0,0,False,False,False,0,3,2020-12-21T14:53:21.47,0,,
2020,15,3014,535,20,306,2,12,9,-1,24,25,18,6,18,6,False,False,False,0,1,2021-03-09T14:18:15.373,24,,6.0
2020,15,3014,555,16,374,2,2,9,6,13,7,10,3,10,0,True,False,False,0,3,2020-12-21T15:02:35.567,13,,3.0
2020,15,3014,565,16,4143,2,4,5,4,4,0,4,0,4,0,False,False,False,0,2,2020-12-21T15:05:40.047,4,,0.0
2020,15,3014,570,16,121,2,13,9,6,20,14,18,2,18,0,False,False,False,0,2,2020-12-23T06:31:42.673,20,,2.0
2020,15,3014,575,16,7176,2,13,9,5,9,4,8,1,8,0,False,False,False,0,3,2020-12-21T15:10:37.557,9,,1.0
2020,15,3014,590,16,7176,2,12,3,5,5,0,5,0,5,6,False,False,False,0,2,2020-12-27T19:43:41.53,5,,0.0
2020,15,3014,610,20,3747,3,45,5,-3,0,0,0,0,0,0,True,False,False,0,3,2020-12-27T19:43:57.237,0,,0.0
2020,15,3014,615,20,8127,13,6,4,7,0,0,0,0,0,0,False,False,False,0,3,2020-12-22T21:44:30.78,0,,0.0
2020,15,3014,630,16,121,13,9,6,15,0,0,0,0,0,0,False,False,False,0,2,2020-12-27T18:28:51.347,0,,
2020,15,3014,645,16,121,13,12,8,36,0,0,0,0,0,0,False,False,False,0,2,2020-12-21T15:35:59.317,0,,0.0
2020,15,3014,650,16,7176,13,2,4,5,0,0,0,0,0,0,False,False,False,0,3,2020-12-23T06:48:29.013,0,,0.0
2020,15,3014,655,16,3938,2,4,4,13,16,3,15,1,15,0,False,False,False,0,3,2020-12-21T15:48:41.173,16,,1.0
2020,15,3014,665,16,3938,3,4,5,7,0,0,0,0,0,0,False,False,False,0,2,2020-12-21T15:51:54.253,0,,0.0
2020,15,3014,670,16,7176,13,35,8,25,0,0,0,0,0,0,True,False,False,0,3,2020-12-21T15:52:59.74,0,,0.0
2020,15,3014,680,20,958,13,9,2,22,0,0,0,0,0,0,False,False,False,0,2,2020-12-27T18:28:51.347,0,,0.0
2020,15,3014,700,16,374,2,31,9,0,9,9,7,2,7,0,True,False,False,1,4,2020-12-23T06:32:40.22,9,,2.0
2020,15,3014,710,16,374,2,4,10,5,9,4,7,2,7,0,False,False,False,0,3,2020-12-21T16:21:57.147,9,,2.0
2020,15,3014,745,16,4143,13,5,3,10,0,0,0,0,0,0,False,False,False,0,3,2021-03-24T19:49:24.497,0,,0.0
2020,15,3014,765,20,958,13,2,10,8,0,0,0,0,0,0,False,False,False,0,3,2020-12-21T16:36:41.967,0,,0.0
2020,15,3014,775,20,7356,13,13,10,5,0,0,0,0,0,0,False,False,False,0,3,2020-12-21T16:40:13.727,0,,0.0
2020,15,3014,790,16,7176,2,5,5,5,8,3,7,1,7,0,True,False,False,0,2,2020-12-23T06:44:29.137,8,,1.0
2020,15,3014,800,16,374,13,6,10,4,0,0,0,0,0,0,True,False,False,0,3,2020-12-21T16:49:26.88,0,,0.0
2020,15,3014,810,20,568,2,6,4,3,9,6,7,2,7,0,False,False,False,0,1,2020-12-21T16:55:08.473,9,,2.0
2020,15,3014,820,20,5140,2,34,4,-4,14,18,9,5,9,6,True,False,False,0,2,2020-12-27T19:46:24.897,14,,5.0
2020,15,3014,835,16,3938,2,7,2,15,16,1,16,0,16,0,False,False,False,0,3,2020-12-21T17:04:56.94,16,,0.0
2020,15,3014,845,16,121,2,5,5,6,7,1,8,-1,8,0,False,False,False,0,3,2020-12-21T17:07:41.787,7,,-1.0
2020,15,3014,860,16,374,2,5,5,3,7,4,3,4,3,0,False,False,False,1,3,2020-12-21T17:12:42.387,7,,4.0
2020,15,3014,890,20,5140,13,47,10,3,0,0,0,0,0,0,False,False,False,0,1,2020-12-27T18:28:51.347,0,,0.0
2020,15,3014,895,20,213,2,2,10,3,8,5,7,1,7,0,False,False,False,0,2,2020-12-21T17:36:23.773,8,,1.0
2020,15,3014,900,20,8127,13,19,6,23,0,0,0,0,0,0,False,False,False,0,2,2020-12-21T17:37:43.02,0,,0.0
2020,15,3014,905,20,958,2,8,1,18,21,3,20,1,20,0,False,False,False,0,3,2020-12-21T17:39:20.093,21,,1.0
2020,15,3014,910,20,7356,2,38,4,4,12,8,11,1,11,0,False,False,False,0,3,2020-12-23T06:37:20.057,12,,1.0
2020,15,3014,915,20,213,2,4,5,2,5,3,4,1,4,0,False,False,False,0,2,2020-12-21T17:42:15.283,5,,1.0
2020,15,3014,925,20,213,2,13,10,4,12,8,10,2,10,0,False,False,False,0,3,2020-12-21T17:48:24.94,12,,2.0
2020,15,3014,930,20,7356,2,17,7,17,17,0,17,0,17,6,False,False,False,0,3,2020-12-21T17:49:36.697,17,,0.0
2020,15,3014,955,16,374,2,46,9,1,10,9,7,3,7,0,False,False,False,0,4,2021-02-23T14:57:03.73,10,,3.0
2020,15,3015,25,28,969,3,6,10,12,0,0,0,0,0,0,False,False,False,0,3,2020-12-21T11:35:41.497,0,,0.0
2020,15,3015,35,9,322,2,5,5,4,5,1,5,0,5,0,False,False,False,0,3,2020-12-21T11:38:15.87,5,,0.0
2020,15,3015,45,9,7183,13,11,5,5,0,0,0,0,0,0,False,False,False,0,1,2020-12-23T20:18:30.597,0,,0.0
2020,15,3015,65,9,7183,2,18,5,-3,12,15,1,11,1,0,True,False,False,1,2,2020-12-21T11:46:43.317,12,,11.0
2020,15,3015,70,9,7183,2,49,10,-2,4,6,1,3,1,0,False,False,False,0,3,2020-12-23T20:14:47.213,4,,3.0
2020,15,3015,100,28,6624,13,44,3,2,0,0,0,0,0,0,False,False,False,0,1,2020-12-23T20:19:08.003,0,,0.0
2020,15,3015,110,9,2568,2,32,3,1,10,9,5,5,5,0,False,False,False,0,4,2020-12-21T12:04:21.437,10,,5.0
2020,15,3015,130,9,6436,2,2,4,3,3,0,3,0,3,6,False,False,False,0,3,2020-12-23T19:09:16.47,3,,0.0
2020,15,3015,155,28,4912,2,4,3,5,14,9,9,5,9,0,False,False,False,0,3,2020-12-21T12:17:09.697,14,,5.0
2020,15,3015,165,28,6360,13,5,5,6,0,0,0,0,0,0,False,False,False,0,3,2020-12-21T12:21:55.957,0,,0.0
2020,15,3015,175,28,4912,2,2,9,5,12,7,8,4,8,0,False,False,False,0,2,2020-12-21T12:24:23.877,12,,4.0
2020,15,3015,185,28,7619,2,35,10,8,13,5,10,3,10,0,False,False,False,0,3,2020-12-23T20:14:11.993,13,,3.0
2020,15,3015,190,28,6360,13,6,3,9,0,0,0,0,0,0,False,False,False,0,3,2020-12-23T20:22:07.883,0,,0.0
2020,15,3015,215,28,969,2,35,3,5,5,0,5,0,5,6,False,False,False,0,4,2020-12-23T20:22:39.827,5,,0.0
2020,15,3015,230,9,7183,2,45,10,-3,30,33,21,9,21,0,False,False,False,0,1,2020-12-21T12:46:27.393,30,,9.0
2020,15,3015,240,9,7183,2,47,10,0,1,1,1,0,1,0,False,False,False,0,1,2020-12-21T12:54:04.097,1,,0.0
2020,15,3015,245,9,322,13,19,6,26,0,0,0,0,0,0,False,False,False,0,2,2021-03-09T17:40:11.77,0,,0.0
2020,15,3015,250,9,6436,2,4,5,10,11,1,10,1,10,0,False,False,False,0,2,2020-12-21T12:56:39.397,11,,1.0
2020,15,3015,260,9,7183,2,45,5,-3,4,7,2,2,2,0,True,False,False,0,1,2020-12-21T12:59:09.033,4,,2.0
2020,15,3015,285,28,6360,2,12,2,19,22,3,22,0,22,0,False,False,False,0,3,2020-12-21T13:04:22.987,22,,0.0
2020,15,3015,300,28,6627,2,12,4,7,19,12,17,2,17,0,False,False,False,0,4,2020-12-21T13:08:55.49,19,,2.0
2020,15,3015,305,28,6627,2,46,3,1,9,8,7,2,7,0,False,False,False,0,4,2020-12-21T13:10:28.963,9,,2.0
2020,15,3015,330,28,262,13,26,10,0,0,0,0,0,0,0,True,False,False,0,4,2020-12-23T19:09:16.47,0,,0.0
2020,15,3015,350,28,7619,2,34,4,-4,2,6,2,0,2,6,True,False,False,0,2,2021-03-04T18:21:16.207,2,,0.0
2020,15,3015,365,9,4446,2,4,9,8,13,5,9,4,9,0,False,False,False,0,3,2020-12-21T13:26:08.193,13,,4.0
2020,15,3015,375,9,7816,2,50,10,-3,8,11,4,4,4,0,False,False,False,0,3,2020-12-23T20:24:20.757,8,,4.0
2020,15,3015,385,9,4446,13,9,3,13,0,0,0,0,0,0,True,False,False,0,3,2020-12-23T20:14:32.01,0,,0.0
2020,15,3015,390,9,4446,13,8,8,30,0,0,0,0,0,0,False,False,False,0,2,2021-03-17T20:02:10.333,0,,0.0
2020,15,3015,410,28,7619,2,50,9,-3,-3,0,-3,0,-3,0,False,False,False,0,3,2020-12-21T13:41:23.483,-3,,0.0
2020,15,3015,445,9,7816,2,17,1,18,22,4,21,1,21,0,False,False,False,0,3,2020-12-21T13:47:55.667,22,,1.0
2020,15,3015,450,9,7816,13,2,10,7,0,0,0,0,0,0,False,False,False,0,3,2020-12-21T13:50:42.003,0,,0.0
2020,15,3015,455,9,7183,13,48,10,-2,0,0,0,0,0,0,False,False,False,0,1,2020-12-21T13:52:20.107,0,,0.0
2020,15,3015,460,9,7816,3,2,4,5,0,0,0,0,0,0,False,False,False,0,3,2020-12-21T13:57:13.757,0,,0.0
2020,15,3015,470,28,3264,2,12,3,-6,8,14,7,1,7,0,False,False,False,0,1,2021-03-09T14:20:49.543,8,,
2020,15,3015,475,28,6360,2,5,5,4,4,0,4,0,4,0,False,False,False,0,2,2020-12-23T20:25:16.553,4,,0.0
2020,15,3015,515,28,6360,2,12,1,20,23,3,23,0,23,0,False,False,False,0,3,2020-12-22T17:49:05.697,23,,0.0
2020,15,3015,520,28,7619,13,7,2,30,0,0,0,0,0,0,False,False,False,0,3,2020-12-21T14:29:35.637,0,,0.0
2020,15,3015,545,9,7816,2,34,4,-4,1,5,0,1,0,0,True,False,False,0,2,2020-12-21T14:37:25.16,1,,1.0
2020,15,3015,550,9,6436,2,2,9,7,12,5,9,3,9,0,False,False,False,1,2,2020-12-21T14:40:24.133,12,,3.0
2020,15,3015,560,9,6446,2,47,10,1,2,1,2,0,2,0,False,False,False,0,4,2020-12-22T17:48:47.227,2,,0.0
2020,15,3015,565,9,7816,2,35,2,31,45,14,45,0,45,0,False,False,False,0,3,2021-03-09T17:42:48.083,45,,0.0
2020,15,3015,570,9,6446,2,47,5,4,12,8,6,6,6,6,False,False,False,1,4,2020-12-23T20:26:49.79,12,,6.0
2020,15,3015,600,28,262,2,11,6,17,25,8,25,0,25,0,False,False,False,0,1,2020-12-21T15:00:18.57,25,,0.0
2020,15,3015,610,28,7619,2,50,9,-1,3,4,-1,4,-1,0,False,False,False,2,2,2020-12-21T15:04:29.257,3,,4.0
2020,15,3015,625,28,969,13,39,9,8,0,0,0,0,0,0,False,False,False,0,4,2020-12-21T15:08:14.97,0,,0.0
2020,15,3015,630,28,969,2,6,4,4,13,9,2,11,2,0,False,False,False,1,2,2021-03-03T21:21:38.447,13,,11.0
2020,15,3015,660,9,6436,13,5,3,6,0,0,0,0,0,0,False,False,False,0,2,2020-12-23T20:27:54.37,0,,0.0
2020,15,3015,685,28,7619,2,2,10,4,3,-1,3,0,3,0,False,False,False,0,2,2020-12-21T15:29:39.537,3,,0.0
2020,15,3015,705,9,4446,13,6,9,6,0,0,0,0,0,0,False,False,False,0,3,2020-12-21T15:37:00.673,0,,0.0
2020,15,3015,720,28,7619,2,2,9,8,9,1,8,1,8,0,False,False,False,0,2,2020-12-21T15:47:32.993,9,,1.0
2020,15,3015,735,28,969,13,5,9,12,0,0,0,0,0,0,False,False,False,0,3,2020-12-21T15:51:42.643,0,,0.0
2020,15,3015,740,9,4446,13,4,3,10,0,0,0,0,0,0,False,False,False,0,2,2020-12-21T15:52:49.13,0,,0.0
2020,15,3015,750,9,4446,13,2,9,5,0,0,0,0,0,0,False,False,False,0,2,2020-12-21T15:54:57.403,0,,0.0
2020,15,3015,770,28,7619,2,8,4,13,15,2,13,2,13,0,False,False,False,1,3,2021-02-23T14:57:33.333,15,,2.0
2020,15,3015,780,28,6360,13,5,6,16,0,0,0,0,0,0,False,False,False,0,2,2020-12-21T16:04:22.74,0,,0.0
2020,15,3015,785,28,7619,13,19,2,26,0,0,0,0,0,0,False,False,False,0,2,2020-12-21T16:07:53.417,0,,0.0
2020,15,3015,800,9,7183,13,44,3,-4,0,0,0,0,0,0,False,False,False,0,1,2020-12-21T16:16:45.457,0,,0.0
2020,15,3015,805,9,7816,2,5,3,10,9,-1,10,-1,10,0,False,False,False,0,3,2020-12-21T16:23:23.907,9,,-1.0
2020,15,3015,815,9,322,2,50,10,-3,5,8,0,5,0,0,False,False,False,0,2,2020-12-21T16:30:11.09,5,,5.0
2020,15,3015,820,9,7183,2,48,5,-8,12,20,8,4,8,0,False,False,False,1,1,2021-02-23T14:58:04.447,12,,4.0
2020,15,3015,830,28,7619,2,30,9,-1,5,6,1,4,1,0,True,False,False,0,3,2020-12-21T16:37:12.73,5,,4.0
2020,15,3015,835,28,4912,2,13,4,4,11,7,8,3,8,0,True,False,False,0,2,2020-12-23T19:09:16.47,11,,3.0
2020,15,3015,840,28,7619,13,7,2,26,0,0,0,0,0,0,False,False,False,0,3,2020-12-21T16:45:56.577,0,,
2020,15,3015,850,28,7619,13,6,4,11,0,0,0,0,0,0,False,False,False,0,2,2021-03-05T16:11:58.92,0,,0.0
2020,15,3015,885,28,6360,2,6,5,4,7,3,6,1,6,0,False,False,False,0,2,2020-12-21T17:11:19.797,7,,1.0
2020,15,3015,895,28,6624,13,5,5,2,0,0,0,0,0,0,False,False,False,0,1,2020-12-21T17:17:31.14,0,,0.0
2020,15,3015,900,28,6624,13,28,5,-4,0,0,0,0,0,0,False,False,False,0,1,2020-12-21T17:21:03.667,0,,0.0
2020,15,3015,905,28,5199,2,26,10,4,8,4,4,4,4,0,False,False,False,1,3,2021-03-03T21:22:23.367,8,,4.0
2020,15,3015,910,28,7619,13,2,9,4,0,0,0,0,0,0,False,False,False,0,2,2020-12-21T17:53:20.02,0,,0.0
2020,15,3015,915,28,797,2,44,9,-6,-1,5,-3,2,-3,0,False,False,False,0,1,2020-12-21T17:34:37.367,-1,,2.0
2020,15,3015,920,28,797,2,16,9,3,23,20,19,4,19,0,False,False,False,0,1,2020-12-21T17:33:56.117,23,,4.0
2020,15,3015,925,28,5199,2,13,10,3,3,0,3,0,3,0,False,False,False,0,2,2020-12-23T19:09:16.47,3,,0.0
2020,15,3015,955,28,7619,2,8,1,19,26,7,21,5,21,0,False,False,False,0,3,2020-12-21T17:38:57.35,26,,5.0
2020,15,3015,960,28,6624,13,5,3,2,0,0,0,0,0,0,False,False,False,0,1,2021-02-23T15:00:18.69,0,,0.0
2020,15,3015,965,28,4912,2,19,2,49,49,0,49,0,49,6,False,False,False,0,2,2021-03-09T17:45:06.72,49,,0.0
2020,15,3016,10,25,6486,13,19,2,39,0,0,0,0,0,0,False,False,False,0,2,2020-12-27T16:13:38.033,0,,0.0
2020,15,3016,20,25,7060,13,13,9,1,0,0,0,0,0,0,False,False,False,0,2,2020-12-22T11:12:59.93,0,,0.0
2020,15,3016,50,25,4583,2,2,10,4,4,0,4,0,4,0,False,False,False,0,3,2020-12-22T11:23:00.32,4,,0.0
2020,15,3016,55,25,7060,13,35,2,17,0,0,0,0,0,0,False,False,False,0,2,2020-12-27T16:35:16.933,0,,0.0
2020,15,3016,60,25,6486,13,29,6,24,0,0,0,0,0,0,False,False,False,0,2,2020-12-22T11:28:10.14,0,,0.0
2020,15,3016,80,7,7659,13,6,9,4,0,0,0,0,0,0,False,False,False,0,2,2020-12-22T11:40:54.903,0,,0.0
2020,15,3016,100,7,7659,2,4,5,7,9,2,8,1,8,0,False,False,False,0,2,2020-12-22T11:40:40.273,9,,1.0
2020,15,3016,135,25,6259,2,50,9,-3,-2,1,-2,0,-2,0,False,False,False,0,3,2020-12-27T16:25:43.947,-2,,0.0
2020,15,3016,150,25,7060,13,4,5,11,0,0,0,0,0,0,False,False,False,0,2,2020-12-27T16:16:06.593,0,,0.0
2020,15,3016,160,7,910,2,19,2,26,30,4,30,0,30,0,False,False,False,0,2,2020-12-27T16:16:48.22,30,,0.0
2020,15,3016,165,7,3521,13,21,2,36,0,0,0,0,0,0,False,False,False,0,2,2020-12-27T16:17:15.287,0,,0.0
2020,15,3016,185,25,7666,13,2,10,11,0,0,0,0,0,0,True,False,False,0,3,2020-12-27T16:17:38.923,0,,0.0
2020,15,3016,190,25,7081,2,45,5,-6,3,9,-2,5,-2,0,True,False,False,0,1,2020-12-22T12:06:36.263,3,,5.0
2020,15,3016,195,25,4583,2,13,10,0,0,0,0,0,0,0,False,True,True,0,3,2020-12-22T12:09:39.98,-10,,0.0
2020,15,3016,215,7,7659,2,4,3,9,14,5,13,1,13,0,False,False,False,1,3,2020-12-23T17:42:29.28,14,,1.0
2020,15,3016,230,7,7659,2,4,10,5,8,3,6,2,6,0,False,False,False,0,3,2020-12-22T12:19:57.02,8,,2.0
2020,15,3016,270,25,609,13,7,6,20,0,0,0,0,0,0,False,False,False,0,4,2020-12-22T12:31:32.657,0,,0.0
2020,15,3016,285,25,7060,2,46,3,2,3,1,2,1,2,0,False,False,False,0,3,2020-12-22T12:36:50.997,3,,1.0
2020,15,3016,300,25,4583,13,6,10,10,0,0,0,0,0,0,False,False,False,0,2,2021-03-05T15:47:45.34,0,,0.0
2020,15,3016,315,7,931,2,16,9,4,14,10,7,7,7,6,False,False,False,2,1,2020-12-27T16:37:10.807,14,,7.0
2020,15,3016,330,25,7060,2,6,10,6,6,0,6,0,6,0,False,False,False,0,2,2020-12-27T16:09:25.243,6,,
2020,15,3016,335,25,7060,2,2,10,9,9,0,9,0,9,0,False,False,False,0,2,2020-12-22T12:53:48.643,9,,0.0
2020,15,3016,345,25,4583,13,5,3,9,0,0,0,0,0,0,False,False,False,0,3,2020-12-22T12:56:40.577,0,,
2020,15,3016,350,25,4583,13,6,9,3,0,0,0,0,0,0,False,False,False,0,3,2020-12-22T12:59:30.73,0,,0.0
2020,15,3016,375,7,7659,13,6,9,4,0,0,0,0,0,0,False,False,False,0,2,2020-12-27T16:18:08.63,0,,0.0
2020,15,3016,400,25,6490,2,5,4,3,12,9,12,0,12,0,False,False,False,0,1,2020-12-27T16:09:25.243,12,,0.0
2020,15,3016,435,7,4341,13,12,6,30,0,0,0,0,0,0,False,False,False,0,3,2020-12-27T16:18:49.64,0,,0.0
2020,15,3016,445,25,7081,13,28,10,1,0,0,0,0,0,0,True,False,False,0,1,2020-12-27T16:19:11.897,0,,0.0
2020,15,3016,455,25,7666,2,49,3,-3,37,40,7,30,7,0,False,False,False,0,2,2020-12-27T16:27:00.113,37,,30.0
2020,15,3016,460,25,7060,2,9,2,23,23,0,23,0,23,6,False,False,False,0,2,2020-12-22T13:24:43.203,23,,0.0
2020,15,3016,480,7,6975,2,2,9,4,4,0,4,0,4,0,False,False,False,0,2,2020-12-22T13:28:27.753,4,,0.0
2020,15,3016,485,7,7659,13,20,2,26,0,0,0,0,0,0,False,False,False,0,3,2020-12-27T16:19:48.273,0,,0.0
2020,15,3016,495,25,7060,2,26,10,3,8,5,8,0,8,0,False,False,False,1,3,2020-12-27T16:37:35.8,8,,0.0
2020,15,3016,505,25,7060,2,2,9,8,8,0,8,0,8,0,False,False,False,0,2,2020-12-22T13:37:12.94,8,,0.0
2020,15,3016,515,25,7060,2,4,9,4,4,0,4,0,4,0,False,False,False,0,3,2020-12-22T13:39:44.473,4,,0.0
2020,15,3016,525,25,7666,13,12,5,10,0,0,0,0,0,0,False,False,False,0,2,2020-12-22T13:43:19.477,0,,0.0
2020,15,3016,535,25,7060,2,12,10,2,0,-2,0,0,0,0,False,False,False,0,2,2020-12-22T13:46:15.62,0,,0.0
2020,15,3016,560,7,910,13,8,10,14,0,0,0,0,0,0,False,False,False,0,3,2020-12-27T16:20:25.357,0,,0.0
2020,15,3016,570,25,7665,2,48,10,-2,9,11,7,2,7,0,False,False,False,0,1,2020-12-22T13:55:01.4,9,,2.0
2020,15,3016,575,25,7060,13,5,5,4,0,0,0,0,0,0,False,False,False,0,2,2020-12-27T16:20:42.99,0,,0.0
2020,15,3016,600,7,910,2,12,4,8,10,2,10,0,10,0,False,False,False,0,2,2020-12-22T14:07:13.013,10,,0.0
2020,15,3016,665,25,4583,2,26,9,1,21,20,21,0,21,0,False,False,False,0,3,2020-12-22T14:20:44.773,21,,0.0
2020,15,3016,670,25,7060,2,2,9,4,4,0,4,0,4,0,False,False,False,0,2,2020-12-22T14:22:05.573,4,,0.0
2020,15,3016,675,25,7081,2,5,10,1,14,13,11,3,11,0,False,False,False,1,1,2021-03-03T21:27:32.653,14,,3.0
2020,15,3016,680,25,7666,13,4,3,14,0,0,0,0,0,0,False,False,False,0,2,2020-12-22T14:26:41.243,0,,0.0
2020,15,3016,685,25,7081,2,28,4,-2,6,8,4,2,4,0,False,False,False,0,1,2020-12-27T16:21:04.303,6,,2.0
2020,15,3016,690,25,7666,2,4,5,4,8,4,5,3,5,0,False,False,False,0,2,2020-12-22T14:32:44.457,8,,3.0
2020,15,3016,695,25,7666,2,4,5,6,9,3,7,2,7,0,False,False,False,0,2,2020-12-22T14:32:29.753,9,,2.0
2020,15,3016,700,25,7666,13,2,10,4,0,0,0,0,0,0,False,False,False,0,3,2020-12-22T14:35:52.173,0,,0.0
2020,15,3016,710,25,7060,13,5,3,12,0,0,0,0,0,0,False,False,False,0,3,2020-12-27T16:36:15.59,0,,
2020,15,3016,775,25,4583,13,12,5,6,0,0,0,0,0,0,False,False,False,0,3,2020-12-27T16:21:44.37,0,,0.0
2020,15,3016,780,25,7060,13,9,3,10,0,0,0,0,0,0,False,False,False,0,2,2021-01-13T20:00:01.503,0,,0.0
2020,15,3016,785,25,7666,13,35,6,45,0,0,0,0,0,0,False,False,False,0,3,2020-12-27T16:22:04.433,0,,0.0
2020,15,3016,800,25,6486,13,8,10,13,0,0,0,0,0,0,True,False,False,0,3,2020-12-22T14:59:31.95,0,,0.0
2020,16,3017,15,20,8131,2,5,3,9,9,0,9,0,9,0,False,False,False,0,2,2020-12-26T12:24:12.683,9,,0.0
2020,16,3017,25,20,5140,3,4,9,6,0,0,0,0,0,0,True,False,False,0,3,2020-12-27T18:37:11.367,0,,0.0
2020,16,3017,50,18,1381,2,13,10,2,16,14,16,0,16,0,False,False,False,0,3,2020-12-26T12:34:08.14,16,,0.0
2020,16,3017,55,18,7711,2,2,10,3,11,8,8,3,8,0,False,False,False,0,2,2020-12-26T12:35:12.397,11,,3.0
2020,16,3017,70,18,6361,3,53,10,-3,0,0,0,0,0,0,False,False,False,0,4,2020-12-26T12:41:10.557,0,,0.0
2020,16,3017,75,18,6361,2,6,10,4,9,5,4,5,4,0,False,False,False,0,4,2020-12-26T12:49:30.167,9,,5.0
2020,16,3017,80,18,1381,2,47,5,1,7,6,4,3,4,0,True,False,False,0,4,2020-12-26T12:49:17.657,7,,3.0
2020,16,3017,105,20,5140,2,46,3,6,9,3,9,0,9,0,False,False,False,0,1,2020-12-26T12:54:12.85,9,,0.0
2020,16,3017,115,20,958,2,17,8,19,19,0,19,0,19,0,False,False,False,0,3,2020-12-26T12:57:50.267,19,,0.0
2020,16,3017,125,20,306,2,5,5,2,8,6,6,2,6,0,False,False,False,0,1,2020-12-26T13:01:42.66,8,,2.0
2020,16,3017,135,20,213,13,22,5,6,0,0,0,0,0,0,False,False,False,0,2,2021-02-25T17:20:44.027,0,,
2020,16,3017,155,18,7711,13,13,9,5,0,0,0,0,0,0,False,False,False,0,3,2020-12-26T13:09:04.65,0,,0.0
2020,16,3017,175,18,7711,13,9,6,15,0,0,0,0,0,0,False,False,False,0,3,2021-02-23T19:47:00.61,0,,0.0
2020,16,3017,185,20,4535,2,12,2,19,19,0,19,0,19,0,False,False,False,0,4,2020-12-28T17:05:37.153,19,,0.0
2020,16,3017,200,20,8127,2,35,5,10,19,9,17,2,17,0,False,False,False,0,3,2020-12-27T18:32:43.063,19,,2.0
2020,16,3017,220,20,4828,13,21,2,16,0,0,0,0,0,0,False,False,False,0,3,2020-12-28T17:17:02.443,0,,0.0
2020,16,3017,230,20,5140,13,11,5,12,0,0,0,0,0,0,False,False,False,0,1,2021-03-09T20:23:24.32,0,,0.0
2020,16,3017,250,18,1381,2,35,2,19,19,0,19,0,19,0,False,False,False,0,3,2020-12-26T13:40:17.013,19,,0.0
2020,16,3017,255,18,6897,2,30,9,1,13,12,10,3,10,0,False,False,False,1,3,2020-12-26T13:42:19.927,13,,3.0
2020,16,3017,280,18,7711,2,8,8,15,25,10,23,2,23,0,False,False,False,0,3,2020-12-26T13:56:41.26,25,,2.0
2020,16,3017,325,20,213,2,6,8,19,31,12,29,2,29,0,False,False,False,0,2,2020-12-26T18:47:25.333,31,,2.0
2020,16,3017,340,20,958,13,5,5,12,0,0,0,0,0,0,False,False,False,0,3,2020-12-28T17:17:17.07,0,,0.0
2020,16,3017,345,18,4572,2,45,5,-5,8,13,8,0,8,0,False,False,False,0,1,2020-12-26T14:39:12.29,8,,0.0
2020,16,3017,365,20,306,2,48,3,-6,7,13,5,2,5,0,False,False,False,0,1,2020-12-26T14:51:56.957,7,,2.0
2020,16,3017,375,20,8131,13,17,7,31,0,0,0,0,0,0,False,False,False,0,3,2020-12-26T14:56:05.463,0,,0.0
2020,16,3017,385,20,8131,2,5,5,11,11,0,11,0,11,0,False,False,False,0,3,2020-12-26T14:59:32.913,11,,0.0
2020,16,3017,390,20,958,2,4,10,12,19,7,12,7,12,0,False,False,False,1,4,2021-02-25T17:21:53.133,19,,7.0
2020,16,3017,395,20,5140,2,49,3,-4,1,5,0,1,0,0,False,False,False,0,2,2020-12-26T15:11:40.777,1,,1.0
2020,16,3017,420,18,6907,13,4,10,12,0,0,0,0,0,0,False,False,False,0,2,2020-12-26T15:20:52.06,0,,0.0
2020,16,3017,425,18,6907,2,2,10,8,13,5,13,0,13,0,False,False,False,0,3,2020-12-26T15:22:50.31,13,,0.0
2020,16,3017,435,18,6361,2,38,10,5,8,3,8,0,8,0,False,False,False,0,4,2020-12-26T15:24:35.503,8,,0.0
2020,16,3017,455,18,6907,2,7,3,14,14,0,14,0,14,0,False,False,False,0,3,2020-12-26T15:29:57.86,14,,0.0
2020,16,3017,460,18,6361,2,32,10,1,5,4,3,2,3,0,False,False,False,0,4,2021-03-08T20:45:59.257,5,,2.0
2020,16,3017,465,18,1381,2,47,5,1,1,0,1,0,1,0,False,False,False,0,3,2021-03-08T20:45:48.58,1,,0.0
2020,16,3017,470,18,1381,13,2,10,6,0,0,0,0,0,0,False,False,False,0,3,2020-12-26T15:44:53.283,0,,0.0
2020,16,3017,490,20,213,3,30,10,0,0,0,0,0,0,0,True,False,False,0,4,2021-03-04T20:25:31.827,0,,0.0
2020,16,3017,505,18,6907,2,30,9,2,2,0,2,0,2,6,False,False,False,0,4,2020-12-26T15:55:42.337,2,,0.0
2020,16,3017,530,20,306,2,28,10,1,9,8,5,4,5,0,False,False,False,0,1,2020-12-26T16:05:00.63,9,,4.0
2020,16,3017,535,20,213,2,6,7,17,26,9,24,2,24,0,False,False,False,0,2,2020-12-26T18:47:53.883,26,,2.0
2020,16,3017,545,20,213,2,5,5,3,3,0,3,0,3,0,False,False,False,0,2,2020-12-26T16:13:09.81,3,,0.0
2020,16,3017,580,18,6907,13,35,8,15,0,0,0,0,0,0,False,False,False,0,4,2020-12-26T16:33:50.813,0,,0.0
2020,16,3017,585,18,4572,2,48,10,-3,4,7,3,1,3,0,False,False,False,0,1,2020-12-28T17:12:33.423,4,,1.0
2020,16,3017,590,18,6907,2,47,5,3,6,3,5,1,5,0,False,False,False,0,4,2020-12-26T16:38:01.597,6,,1.0
2020,16,3017,600,18,1381,2,35,9,14,24,10,24,0,24,0,False,False,False,0,3,2020-12-26T16:48:31.793,24,,0.0
2020,16,3017,605,18,6897,3,12,2,34,0,0,0,0,0,0,True,False,False,0,4,2020-12-27T16:54:51.703,0,,
2020,16,3017,615,18,6361,2,42,9,4,9,5,7,2,7,0,False,False,False,0,4,2020-12-26T16:55:20.227,9,,2.0
2020,16,3017,620,18,6907,3,2,9,7,0,0,0,0,0,0,False,False,False,0,2,2020-12-27T18:34:20.963,0,,
2020,16,3017,625,18,1381,13,11,6,18,0,0,0,0,0,0,True,False,False,0,2,2020-12-26T17:12:00.95,0,,
2020,16,3017,635,18,6907,2,7,3,4,4,0,4,0,4,6,False,False,False,0,3,2020-12-26T17:16:59.487,4,,0.0
2020,16,3017,660,20,2408,13,35,5,14,0,0,0,0,0,0,False,False,False,0,3,2020-12-26T18:51:20.503,0,,0.0
2020,16,3017,665,20,958,2,5,3,11,44,33,13,31,13,0,False,False,False,1,3,2020-12-28T17:06:18.643,44,,31.0
2020,16,3017,700,18,7711,2,44,3,-6,5,11,3,2,3,0,True,False,False,0,3,2020-12-28T17:06:41.147,5,,2.0
2020,16,3017,705,18,6361,13,32,3,0,0,0,0,0,0,0,False,False,False,0,4,2020-12-26T17:42:06.16,0,,0.0
2020,16,3017,725,20,213,2,17,8,21,23,2,23,0,23,0,False,False,False,0,3,2020-12-26T17:47:50.79,23,,0.0
2020,16,3017,735,20,5140,2,47,5,1,7,6,2,5,2,0,False,False,False,2,1,2020-12-27T18:33:02.217,7,,5.0
2020,16,3017,740,20,8131,2,5,3,4,6,2,6,0,6,0,False,False,False,0,2,2020-12-26T17:53:21.23,6,,0.0
2020,16,3017,750,20,7888,2,28,9,-1,4,5,2,2,2,0,False,False,False,2,1,2020-12-28T17:06:55.703,4,,2.0
2020,16,3017,760,20,568,2,47,5,1,4,3,4,0,4,0,True,False,False,0,1,2020-12-26T17:58:54.543,4,,0.0
2020,16,3017,790,18,7711,2,6,9,13,14,1,14,0,14,0,False,False,False,0,2,2020-12-26T18:05:04.87,14,,0.0
2020,16,3017,795,18,1381,2,9,2,17,21,4,18,3,18,0,False,False,False,0,2,2020-12-26T18:12:42.22,21,,3.0
2020,16,3017,800,18,7711,2,50,3,0,11,11,8,3,8,0,False,False,False,0,2,2020-12-26T18:15:36.253,11,,3.0
2020,16,3017,805,18,7711,2,2,9,9,19,10,12,7,12,0,False,False,False,1,2,2020-12-26T18:17:02.573,19,,7.0
2020,16,3017,810,18,6907,2,2,9,5,14,9,5,9,5,0,False,False,False,1,3,2020-12-28T17:17:27.7,14,,9.0
2020,16,3017,815,18,7711,13,2,9,1,0,0,0,0,0,0,False,False,False,0,2,2020-12-26T18:19:01.44,0,,0.0
2020,16,3017,825,18,6907,13,2,9,1,0,0,0,0,0,0,False,False,False,0,2,2020-12-26T18:20:10.623,0,,0.0
2020,16,3017,830,18,566,13,16,9,1,0,0,0,0,0,0,True,False,False,0,3,2020-12-26T18:22:18.45,0,,0.0
2020,16,3017,840,18,1381,2,47,5,1,1,0,1,0,1,6,False,False,False,0,3,2020-12-26T18:24:15.64,1,,0.0
2020,16,3017,865,20,7888,2,7,2,15,41,26,36,5,36,0,True,False,False,0,4,2020-12-26T18:33:04.067,41,,5.0
2020,16,3017,895,18,7711,3,13,10,5,0,0,0,0,0,0,False,False,False,0,2,2020-12-26T18:36:59.69,0,,0.0
2020,16,3017,910,18,1381,2,50,10,-2,8,10,5,3,5,0,False,False,False,0,2,2020-12-28T17:14:37.31,8,,3.0
2020,16,3018,10,30,4516,13,5,3,14,0,0,0,0,0,0,False,False,False,0,4,2020-12-30T06:22:01.773,0,,0.0
2020,16,3018,25,30,4516,2,42,9,7,8,1,8,0,8,0,False,False,False,0,3,2020-12-27T14:35:03.367,8,,0.0
2020,16,3018,30,30,793,2,19,6,29,33,4,31,2,31,0,False,False,False,0,3,2020-12-30T06:37:27.38,33,,2.0
2020,16,3018,40,30,63,2,9,2,25,33,8,25,8,25,6,False,False,False,0,3,2020-12-27T14:23:48.98,33,,8.0
2020,16,3018,55,11,100,2,46,3,2,15,13,15,0,15,0,False,False,False,0,3,2020-12-27T14:26:18.773,15,,0.0
2020,16,3018,65,11,6810,13,47,5,2,0,0,0,0,0,0,False,False,False,0,4,2020-12-27T14:29:21.02,0,,0.0
2020,16,3018,70,11,100,2,26,10,1,2,1,2,0,2,0,True,False,False,0,2,2020-12-28T22:36:15.33,2,,0.0
2020,16,3018,90,30,4516,2,8,1,42,47,5,47,0,47,0,True,False,False,0,3,2021-02-23T17:03:19.823,47,,0.0
2020,16,3018,95,30,37,2,49,3,-2,-2,0,-2,0,-2,0,False,False,False,0,2,2020-12-30T06:19:26.283,-2,,0.0
2020,16,3018,100,30,793,2,9,2,27,27,0,27,0,27,6,False,False,False,0,3,2021-02-25T17:26:14.36,27,,0.0
2020,16,3018,115,11,6810,2,51,5,2,7,5,3,4,3,0,False,False,False,0,4,2020-12-30T06:19:39.92,7,,4.0
2020,16,3018,130,11,7733,13,4,5,5,0,0,0,0,0,0,False,False,False,0,2,2020-12-27T14:46:17.517,0,,0.0
2020,16,3018,145,30,4937,2,47,10,-1,7,8,7,0,7,0,False,False,False,0,1,2020-12-27T14:50:22.847,7,,0.0
2020,16,3018,155,30,793,2,17,9,13,16,3,16,0,16,0,False,False,False,0,3,2020-12-29T00:09:23.49,16,,0.0
2020,16,3018,165,30,4516,2,39,4,6,10,4,8,2,8,0,True,False,False,0,3,2020-12-27T14:55:59.323,10,,2.0
2020,16,3018,195,11,917,2,5,5,4,2,-2,2,0,2,0,False,False,False,0,3,2020-12-27T15:03:19.777,2,,0.0
2020,16,3018,205,11,914,2,50,5,-3,2,5,-1,3,-1,0,False,False,False,0,3,2021-03-04T16:04:33.83,2,,3.0
2020,16,3018,210,11,917,3,5,5,6,0,0,0,0,0,0,False,False,False,0,3,2020-12-27T15:28:05.48,0,,0.0
2020,16,3018,225,30,4516,2,2,4,6,12,6,12,0,12,0,False,False,False,0,3,2020-12-27T15:31:09.383,12,,0.0
2020,16,3018,230,30,4937,2,4,9,2,12,10,5,7,5,0,False,False,False,1,1,2020-12-27T15:31:22.163,12,,7.0
2020,16,3018,240,30,4937,2,4,9,4,13,9,10,3,10,0,False,False,False,1,1,2020-12-30T06:20:03.15,13,,3.0
2020,16,3018,290,30,793,2,18,3,0,7,7,4,3,4,0,False,False,False,0,2,2020-12-27T15:45:11.047,7,,3.0
2020,16,3018,295,30,6570,2,6,1,15,20,5,18,2,18,0,False,False,False,0,4,2020-12-27T15:47:26.44,20,,2.0
2020,16,3018,300,30,793,2,3,6,21,22,1,22,0,22,0,False,False,False,0,2,2020-12-30T05:15:16.403,22,,0.0
2020,16,3018,320,30,4516,2,13,3,7,7,0,7,0,7,6,True,False,False,0,3,2020-12-27T15:55:36.26,7,,0.0
2020,16,3018,345,11,100,13,5,10,13,0,0,0,0,0,0,False,False,False,0,3,2020-12-27T18:58:16.517,0,,0.0
2020,16,3018,355,30,793,13,19,6,41,0,0,0,0,0,0,False,False,False,0,2,2020-12-27T16:05:44.403,0,,0.0
2020,16,3018,360,30,7891,2,47,5,1,7,6,5,2,5,0,False,False,False,0,1,2020-12-27T16:26:53.433,7,,2.0
2020,16,3018,365,30,793,2,6,9,10,15,5,13,2,13,0,False,False,False,0,2,2020-12-27T16:27:57.447,15,,2.0
2020,16,3018,370,30,4516,13,7,2,15,0,0,0,0,0,0,False,False,False,0,4,2020-12-27T16:29:12.147,0,,
2020,16,3018,380,30,4516,13,17,1,34,0,0,0,0,0,0,True,False,False,0,3,2020-12-29T00:12:36.827,0,,0.0
2020,16,3018,385,30,2290,2,5,3,10,11,1,11,0,11,0,False,False,False,0,3,2020-12-30T05:27:53.89,11,,0.0
2020,16,3018,390,30,37,13,50,5,0,0,0,0,0,0,0,False,False,False,0,2,2020-12-27T16:37:33.773,0,,0.0
2020,16,3018,395,30,37,2,12,5,13,15,2,15,0,15,0,False,False,False,0,3,2020-12-27T16:41:02.62,15,,0.0
2020,16,3018,400,30,4516,2,35,2,22,23,1,23,0,23,6,False,False,False,0,4,2020-12-27T16:42:24.26,23,,
2020,16,3018,405,30,2290,2,17,10,11,16,5,15,1,15,0,False,False,False,0,4,2020-12-27T16:43:37.947,16,,1.0
2020,16,3018,415,30,37,2,17,4,12,12,0,12,0,12,6,False,False,False,0,3,2020-12-30T06:28:01.573,12,,0.0
2020,16,3018,430,11,6810,2,5,5,7,7,0,7,0,7,0,False,False,False,0,3,2020-12-27T16:55:38.803,7,,0.0
2020,16,3018,435,11,6810,2,38,4,3,4,1,4,0,4,0,False,False,False,0,3,2020-12-30T05:27:53.89,4,,0.0
2020,16,3018,455,11,100,2,4,10,14,19,5,18,1,18,0,False,False,False,0,3,2020-12-27T17:03:00.66,19,,1.0
2020,16,3018,460,11,914,2,7,5,11,11,0,11,0,11,0,False,False,False,0,2,2020-12-30T05:27:53.89,11,,0.0
2020,16,3018,480,30,63,2,17,7,19,25,6,22,3,22,6,False,False,False,0,4,2020-12-29T00:11:10.297,25,,3.0
2020,16,3018,495,11,7732,2,44,9,0,2,2,1,1,1,0,False,False,False,0,1,2020-12-27T17:28:01.16,2,,1.0
2020,16,3018,500,11,100,2,49,10,-3,-2,1,-2,0,-2,0,False,False,False,0,3,2020-12-28T22:33:27.873,-2,,0.0
2020,16,3018,505,11,7733,2,13,9,7,8,1,7,1,7,0,False,False,False,0,2,2020-12-27T17:29:52.747,8,,
2020,16,3018,515,11,914,2,4,9,4,6,2,4,2,4,0,False,False,False,0,3,2020-12-27T17:31:32.587,6,,2.0
2020,16,3018,530,30,793,2,18,3,0,5,5,3,2,3,0,False,False,False,0,2,2020-12-27T17:36:29.27,5,,2.0
2020,16,3018,545,30,793,13,4,9,3,0,0,0,0,0,0,False,False,False,0,3,2020-12-27T17:38:41.517,0,,0.0
2020,16,3018,570,30,4516,13,17,7,16,0,0,0,0,0,0,True,False,False,0,3,2020-12-29T00:12:25.953,0,,0.0
2020,16,3018,580,30,7893,2,50,3,-2,35,37,31,4,31,0,False,False,False,0,2,2020-12-30T05:10:35,35,,4.0
2020,16,3018,585,30,793,2,22,6,21,22,1,22,0,22,6,False,False,False,0,2,2020-12-27T17:49:09.387,22,,0.0
2020,16,3018,605,11,7732,2,4,10,3,15,12,10,5,10,0,False,False,False,1,1,2021-03-03T18:49:38.13,15,,5.0
2020,16,3018,620,11,917,13,4,5,9,0,0,0,0,0,0,False,False,False,0,2,2020-12-27T17:56:23.983,0,,0.0
2020,16,3018,625,11,100,2,50,9,-4,3,7,3,0,3,0,False,False,False,0,3,2021-02-23T17:19:48.733,3,,0.0
2020,16,3018,630,11,6341,2,28,4,4,10,6,7,3,7,0,False,False,False,0,1,2020-12-27T17:58:05.98,10,,3.0
2020,16,3018,645,30,793,2,3,2,19,30,11,21,9,21,0,False,False,False,1,2,2020-12-27T18:03:57.447,30,,9.0
2020,16,3018,655,30,7268,3,5,3,11,0,0,0,0,0,0,False,False,False,0,2,2020-12-30T06:29:36.637,0,,0.0
2020,16,3018,660,30,793,13,7,2,34,0,0,0,0,0,0,False,False,False,0,3,2020-12-27T18:52:31.713,0,,
2020,16,3018,670,30,7891,13,28,9,2,0,0,0,0,0,0,False,False,False,0,1,2020-12-27T18:09:26.867,0,,0.0
2020,16,3018,680,30,7268,2,46,3,6,7,1,6,1,6,0,False,False,False,0,3,2020-12-27T18:14:01.477,7,,1.0
2020,16,3018,695,30,4516,13,5,5,10,0,0,0,0,0,0,False,False,False,0,3,2020-12-27T18:13:51.24,0,,0.0
2020,16,3018,700,11,7732,2,28,5,-1,6,7,4,2,4,0,False,False,False,0,1,2020-12-27T18:14:46.25,6,,2.0
2020,16,3018,705,11,914,13,2,5,8,0,0,0,0,0,0,False,False,False,0,2,2020-12-27T18:15:26.453,0,,
2020,16,3018,710,11,6810,2,5,5,5,5,0,5,0,5,0,False,False,False,0,3,2020-12-27T18:16:29.963,5,,0.0
2020,16,3018,720,11,100,13,17,7,30,0,0,0,0,0,0,False,False,False,0,3,2020-12-27T18:18:08.243,0,,0.0
2020,16,3018,755,30,37,13,5,5,5,0,0,0,0,0,0,False,False,False,0,3,2020-12-27T18:23:16.177,0,,0.0
2020,16,3018,765,30,793,13,19,6,37,0,0,0,0,0,0,False,False,False,0,2,2020-12-27T18:54:32.45,0,,
2020,16,3018,770,30,793,2,18,3,-2,4,6,1,3,1,0,False,False,False,1,2,2020-12-27T18:25:41.683,4,,3.0
2020,16,3018,780,30,119,2,6,9,2,5,3,3,2,3,0,False,False,False,0,1,2020-12-30T05:27:53.89,5,,2.0
2020,16,3018,790,11,917,2,6,1,17,20,3,18,2,18,0,False,False,False,0,3,2020-12-30T05:27:53.89,20,,2.0
2020,16,3018,800,11,7732,2,28,10,1,2,1,1,1,1,0,False,False,False,0,1,2020-12-27T18:31:43.117,2,,1.0
2020,16,3018,810,11,7732,2,48,10,-6,7,13,-3,10,-3,0,False,False,False,0,1,2020-12-27T18:34:08.793,7,,
2020,16,3018,815,11,7733,2,2,10,5,9,4,9,0,9,0,False,False,False,0,3,2020-12-27T18:35:25.857,9,,0.0
2020,16,3018,820,11,7732,13,28,4,0,0,0,0,0,0,0,False,False,False,0,1,2020-12-27T18:36:24.987,0,,0.0
2020,16,3018,825,11,6341,2,48,9,-5,7,12,7,0,7,0,False,False,False,0,1,2020-12-27T18:37:34.94,7,,0.0
2020,16,3018,830,11,6810,13,12,3,13,0,0,0,0,0,0,False,False,False,0,3,2020-12-27T18:38:27.367,0,,0.0
2020,16,3018,855,11,2714,13,12,2,17,0,0,0,0,0,0,False,False,False,0,4,2021-03-04T21:56:40.313,0,,0.0
2020,16,3018,875,30,37,2,50,5,-1,10,11,7,3,7,0,False,False,False,0,2,2020-12-27T18:55:54.043,10,,3.0
2020,16,3019,10,1,5032,13,39,4,5,0,0,0,0,0,0,False,False,False,0,4,2020-12-27T12:25:38.187,0,,0.0
2020,16,3019,15,1,4307,2,47,10,-1,6,7,4,2,4,0,False,False,False,0,1,2020-12-27T12:27:07.27,6,,2.0
2020,16,3019,20,1,6405,2,21,2,23,38,15,36,2,36,0,False,False,False,0,2,2020-12-27T12:29:34.847,38,,2.0
2020,16,3019,25,1,6406,2,34,4,-4,5,9,4,1,4,0,True,False,False,0,3,2020-12-29T13:42:59.267,5,,1.0
2020,16,3019,45,1,6405,2,49,10,-3,-1,2,-1,0,-1,0,True,False,False,0,2,2020-12-27T12:38:05.99,-1,,0.0
2020,16,3019,50,1,6406,2,6,4,3,3,0,3,0,3,0,False,False,False,0,1,2020-12-27T12:39:24.647,3,,0.0
2020,16,3019,55,1,6405,3,6,9,9,0,0,0,0,0,0,False,False,False,0,3,2020-12-27T12:41:59.03,0,,0.0
2020,16,3019,80,28,7619,3,6,4,12,0,0,0,0,0,0,False,False,False,0,3,2020-12-27T12:49:19.837,0,,0.0
2020,16,3019,100,1,3601,13,12,6,31,0,0,0,0,0,0,False,False,False,0,4,2020-12-27T12:57:21.95,0,,0.0
2020,16,3019,105,1,5152,13,17,1,25,0,0,0,0,0,0,False,False,False,0,3,2020-12-27T16:36:28.25,0,,0.0
2020,16,3019,110,1,6406,13,12,5,-4,0,0,0,0,0,0,False,False,False,0,1,2021-03-08T21:27:09.367,0,,0.0
2020,16,3019,120,28,7619,2,5,6,15,15,0,15,0,15,0,False,False,False,0,2,2020-12-29T18:30:25.567,15,,0.0
2020,16,3019,125,28,4922,2,13,10,2,24,22,22,2,22,0,False,False,False,2,4,2021-02-23T16:23:19.413,24,,2.0
2020,16,3019,155,28,6624,2,16,9,7,21,14,21,0,21,6,False,False,False,2,1,2020-12-29T18:26:51.497,21,,0.0
2020,16,3019,180,1,245,2,5,3,7,7,0,7,0,7,0,True,False,False,0,3,2020-12-27T13:23:40.377,7,,0.0
2020,16,3019,185,1,245,2,30,5,3,5,2,5,0,5,0,True,False,False,0,3,2020-12-29T17:58:58.317,5,,0.0
2020,16,3019,190,1,5152,2,5,5,4,7,3,7,0,7,0,False,False,False,0,4,2020-12-27T13:26:55.557,7,,0.0
2020,16,3019,205,1,5152,2,44,3,0,7,7,4,3,4,0,True,False,False,0,4,2020-12-27T13:29:56.827,7,,3.0
2020,16,3019,225,1,4307,2,28,10,-2,-1,1,-1,0,-1,0,False,False,False,0,1,2020-12-27T13:36:03.61,-1,,0.0
2020,16,3019,260,28,262,13,13,4,4,0,0,0,0,0,0,True,False,False,0,2,2020-12-27T13:42:56.59,0,,0.0
2020,16,3019,265,28,6360,3,4,4,4,0,0,0,0,0,0,False,False,False,0,3,2020-12-27T13:44:32,0,,0.0
2020,16,3019,285,1,245,2,2,4,7,8,1,7,1,7,0,False,False,False,0,3,2020-12-27T13:54:37.157,8,,1.0
2020,16,3019,290,1,525,2,4,9,3,3,0,2,1,2,0,False,False,False,0,2,2020-12-27T13:55:53.333,3,,1.0
2020,16,3019,310,1,245,13,5,6,17,0,0,0,0,0,0,False,False,False,0,2,2020-12-29T18:43:15.977,0,,0.0
2020,16,3019,345,1,5152,3,21,8,41,0,0,0,0,0,0,False,False,False,0,4,2020-12-29T13:40:52.52,0,,0.0
2020,16,3019,355,1,6405,2,13,4,3,5,2,5,0,5,0,False,False,False,0,3,2020-12-27T14:15:10.237,5,,0.0
2020,16,3019,375,1,6405,2,6,4,14,16,2,16,0,16,0,False,False,False,0,3,2020-12-27T14:18:34.047,16,,0.0
2020,16,3019,380,1,525,2,50,10,0,5,5,1,4,1,0,True,False,False,0,3,2020-12-28T17:46:13.33,5,,4.0
2020,16,3019,395,1,245,13,19,6,25,0,0,0,0,0,0,False,False,False,0,2,2020-12-27T14:24:32.41,0,,0.0
2020,16,3019,415,28,4912,2,2,9,11,16,5,16,0,16,0,False,False,False,0,2,2020-12-27T14:27:24.69,16,,0.0
2020,16,3019,425,28,797,2,5,9,1,11,10,11,0,11,0,False,False,False,1,1,2020-12-27T14:29:06.073,11,,0.0
2020,16,3019,435,28,797,13,5,10,3,0,0,0,0,0,0,True,False,False,0,3,2020-12-27T14:30:49.303,0,,0.0
2020,16,3019,445,1,525,13,7,2,27,0,0,0,0,0,0,False,False,False,0,3,2020-12-27T14:37:17.627,0,,0.0
2020,16,3019,450,1,6405,2,12,5,2,5,3,5,0,5,0,False,False,False,0,2,2020-12-28T17:43:27.843,5,,0.0
2020,16,3019,480,28,4922,2,13,10,4,18,14,12,6,12,0,False,False,False,0,4,2020-12-27T14:48:00.337,18,,6.0
2020,16,3019,495,28,969,13,2,4,3,0,0,0,0,0,0,False,False,False,0,3,2020-12-29T13:42:05.783,0,,0.0
2020,16,3019,515,1,245,2,50,9,-2,-3,-1,-3,0,-3,0,False,False,False,0,3,2020-12-27T15:03:59.85,-3,,0.0
2020,16,3019,535,28,4922,2,17,8,23,27,4,25,2,25,0,False,False,False,0,3,2020-12-27T15:10:37.913,27,,2.0
2020,16,3019,545,28,743,2,51,10,-7,0,7,-1,1,-1,0,False,False,False,0,1,2021-02-23T16:26:47.027,0,,1.0
2020,16,3019,550,28,797,2,47,5,2,10,8,4,6,4,0,False,False,False,1,1,2020-12-27T15:15:41.56,10,,6.0
2020,16,3019,555,28,262,2,46,3,1,9,8,5,4,5,6,False,False,False,0,1,2020-12-27T15:16:39.52,9,,4.0
2020,16,3019,570,1,5152,2,13,9,5,11,6,10,1,10,0,False,True,True,0,4,2020-12-27T15:20:07.943,11,,1.0
2020,16,3019,580,28,6624,3,47,5,1,0,0,0,0,0,0,False,False,False,0,1,2020-12-27T15:22:11.893,0,,0.0
2020,16,3019,585,28,969,13,12,2,29,0,0,0,0,0,0,True,False,False,0,3,2020-12-29T01:11:15.01,0,,0.0
2020,16,3019,595,1,245,2,4,9,6,9,3,7,2,7,0,False,False,False,1,2,2020-12-29T18:27:19.8,9,,2.0
2020,16,3019,610,1,7316,13,17,1,16,0,0,0,0,0,0,False,False,False,0,3,2020-12-27T15:30:09.01,0,,0.0
2020,16,3019,630,1,7316,2,35,7,39,45,6,42,3,42,0,False,False,False,0,3,2020-12-29T17:58:58.317,45,,3.0
2020,16,3019,635,1,525,2,47,5,1,2,1,1,1,1,0,False,False,False,0,3,2020-12-29T17:58:58.317,2,,1.0
2020,16,3019,640,1,525,2,4,9,4,5,1,4,1,4,0,False,False,False,0,3,2020-12-27T15:36:32.24,5,,1.0
2020,16,3019,650,1,245,2,2,9,5,5,0,5,0,5,0,False,False,False,0,2,2020-12-27T15:37:48.52,5,,0.0
2020,16,3019,660,1,245,13,5,5,3,0,0,0,0,0,0,False,False,False,0,2,2020-12-27T15:40:38.623,0,,
2020,16,3019,695,28,4922,3,13,9,2,0,0,0,0,0,0,False,False,False,0,3,2020-12-27T15:46:51.323,0,,0.0
2020,16,3019,705,28,797,2,48,10,-6,7,13,4,3,4,0,False,False,False,1,1,2020-12-29T18:25:49.847,7,,3.0
2020,16,3019,720,1,7316,2,18,9,1,5,4,4,1,4,0,False,False,False,0,3,2020-12-27T15:52:14.327,5,,1.0
2020,16,3019,730,1,245,2,13,10,2,8,6,3,5,3,0,False,False,False,0,3,2020-12-27T15:53:53.347,8,,5.0
2020,16,3019,735,1,245,13,2,9,4,0,0,0,0,0,0,False,False,False,0,2,2020-12-27T15:55:05.13,0,,0.0
2020,16,3019,745,28,262,2,47,5,1,1,0,1,0,1,6,False,False,False,0,1,2020-12-27T15:57:27.857,1,,0.0
2020,16,3019,760,1,5032,2,31,9,4,7,3,5,2,5,0,False,False,False,0,1,2021-02-23T16:30:36.48,7,,2.0
2020,16,3019,775,1,6405,2,4,5,8,9,1,8,1,8,0,False,False,False,0,2,2020-12-27T16:08:33.61,9,,1.0
2020,16,3019,780,1,525,13,4,9,2,0,0,0,0,0,0,False,False,False,0,3,2020-12-27T16:09:45.363,0,,0.0
2020,16,3019,785,1,245,2,4,3,4,9,5,4,5,4,0,False,True,False,1,2,2020-12-27T16:11:44.22,9,,5.0
2020,16,3019,805,1,6405,13,29,5,14,0,0,0,0,0,0,False,False,False,0,2,2020-12-27T16:16:11.61,0,,0.0
2020,16,3019,825,28,4922,2,29,7,15,23,8,15,8,15,0,False,False,False,0,4,2021-02-25T17:28:21.86,23,,8.0
2020,16,3019,875,1,525,2,39,4,3,4,1,4,0,4,0,False,False,False,0,3,2020-12-27T16:24:51.007,4,,0.0
2020,16,3019,885,1,525,2,4,10,5,9,4,8,1,8,0,False,False,False,0,3,2020-12-27T16:26:23.417,9,,1.0
2020,16,3019,895,1,6405,2,13,4,3,4,1,4,0,4,0,False,False,False,0,3,2020-12-27T16:29:21.23,4,,0.0
2020,16,3019,900,1,6405,13,19,2,37,0,0,0,0,0,0,False,False,False,0,2,2020-12-29T18:22:28.31,0,,0.0
2020,16,3019,905,1,245,13,3,3,7,0,0,0,0,0,0,False,False,False,0,2,2020-12-27T16:32:20.163,0,,0.0
2020,16,3020,10,26,4050,2,4,9,8,14,6,11,3,11,0,False,False,False,0,4,2020-12-28T11:15:43.757,14,,3.0
2020,16,3020,20,26,6277,2,45,5,-5,3,8,1,2,1,0,False,False,False,0,1,2020-12-31T17:25:16.51,3,,2.0
2020,16,3020,30,26,4619,13,2,9,6,0,0,0,0,0,0,False,False,False,0,3,2021-02-23T20:57:04.12,0,,0.0
2020,16,3020,45,10,7700,2,4,3,6,6,0,7,-1,7,0,False,False,False,1,2,2021-03-03T18:56:10.57,6,,-1.0
2020,16,3020,60,10,4930,2,4,3,5,5,0,5,0,5,0,False,False,False,0,2,2020-12-28T11:45:46.9,5,,0.0
2020,16,3020,75,10,4930,2,2,9,4,7,3,6,1,6,0,False,False,False,0,2,2020-12-31T16:17:16.2,7,,1.0
2020,16,3020,105,10,6840,13,11,2,16,0,0,0,0,0,0,False,False,False,0,4,2020-12-28T12:20:06.973,0,,0.0
2020,16,3020,110,10,6285,13,12,3,10,0,0,0,0,0,0,False,False,False,0,3,2021-03-08T21:48:31.02,0,,0.0
2020,16,3020,115,26,4616,2,47,5,2,3,1,3,0,3,0,False,False,False,0,1,2020-12-28T12:26:43.497,3,,0.0
2020,16,3020,125,26,7453,13,39,10,5,0,0,0,0,0,0,True,False,False,0,3,2020-12-28T12:33:45.56,0,,
2020,16,3020,135,26,4050,13,5,9,6,0,0,0,0,0,0,False,False,False,0,4,2020-12-29T16:59:28.327,0,,0.0
2020,16,3020,140,26,7453,13,26,4,2,0,0,0,0,0,0,False,False,False,0,2,2020-12-28T12:44:34.453,0,,0.0
2020,16,3020,160,10,6840,2,4,10,5,5,0,5,0,5,0,True,False,False,0,2,2020-12-28T12:53:22.623,5,,0.0
2020,16,3020,165,10,6840,3,36,8,17,0,0,0,0,0,0,False,False,False,0,4,2020-12-31T16:16:58.913,0,,0.0
2020,16,3020,180,10,7700,2,6,10,14,17,3,17,0,17,0,False,False,False,0,2,2020-12-31T15:55:38.283,17,,0.0
2020,16,3020,195,10,7700,13,4,5,7,0,0,0,0,0,0,False,False,False,0,2,2020-12-31T16:18:12.32,0,,0.0
2020,16,3020,220,26,4619,2,2,10,6,25,19,23,2,23,0,False,False,False,0,2,2020-12-31T17:27:51.16,25,,2.0
2020,16,3020,225,26,4619,2,6,10,10,10,0,10,0,10,0,False,False,False,0,3,2020-12-28T13:26:35.41,10,,0.0
2020,16,3020,235,26,7514,2,2,9,8,10,2,9,1,9,0,False,False,False,0,3,2020-12-31T16:19:18.113,10,,1.0
2020,16,3020,240,26,7453,3,18,10,-2,0,0,0,0,0,0,True,False,False,0,3,2020-12-31T16:19:44.393,0,,0.0
2020,16,3020,250,26,4616,2,46,3,2,9,7,7,2,7,6,True,False,False,0,3,2020-12-28T13:50:30.013,9,,2.0
2020,16,3020,265,10,7700,2,49,3,-2,2,4,1,1,1,0,False,False,False,0,2,2020-12-28T13:53:56.257,2,,1.0
2020,16,3020,270,10,7926,2,48,9,0,9,9,4,5,4,0,False,False,False,0,1,2020-12-29T17:58:37.947,5,,5.0
2020,16,3020,275,10,7700,13,4,10,14,0,0,0,0,0,0,False,False,False,0,2,2020-12-31T16:20:22.457,0,,0.0
2020,16,3020,280,10,7700,2,50,10,-1,10,11,7,3,7,0,False,False,False,0,2,2020-12-28T14:04:14.597,10,,3.0
2020,16,3020,295,26,4050,2,46,3,0,5,5,4,1,4,0,False,False,False,0,4,2020-12-28T14:09:55.45,5,,1.0
2020,16,3020,300,26,7514,2,18,5,-2,2,4,0,2,0,0,False,False,False,0,2,2020-12-28T14:11:59.313,2,,2.0
2020,16,3020,305,26,4050,13,12,9,10,0,0,0,0,0,0,False,False,False,0,4,2021-02-25T17:30:57.62,0,,0.0
2020,16,3020,310,26,7453,2,7,6,20,29,9,26,3,26,0,False,False,False,1,3,2020-12-28T14:19:09.7,29,,3.0
2020,16,3020,320,26,7514,2,3,5,14,14,0,14,0,14,0,False,False,False,0,2,2020-12-28T14:24:40.023,14,,0.0
2020,16,3020,330,26,4619,3,9,2,18,0,0,0,0,0,0,False,False,False,0,2,2020-12-28T14:31:03.357,0,,0.0
2020,16,3020,345,10,6840,2,6,9,10,10,0,10,0,10,0,False,False,False,0,3,2020-12-28T14:35:14.027,10,,0.0
2020,16,3020,360,10,7700,3,5,3,6,0,0,0,0,0,0,True,False,False,0,2,2020-12-28T14:41:02.223,0,,0.0
2020,16,3020,365,10,7700,3,2,9,8,0,0,0,0,0,0,False,False,False,0,2,2020-12-28T14:42:57.277,0,,0.0
2020,16,3020,370,10,6285,13,9,3,13,0,0,0,0,0,0,False,False,False,0,3,2020-12-28T18:16:57.577,0,,0.0
2020,16,3020,385,26,4619,2,4,3,12,12,0,12,0,12,0,False,False,False,0,2,2020-12-31T16:21:06.893,12,,0.0
2020,16,3020,390,26,7491,2,5,8,15,21,6,19,2,19,0,False,False,False,0,3,2020-12-31T16:04:49.983,21,,2.0
2020,16,3020,415,10,7700,3,2,3,5,0,0,0,0,0,0,False,False,False,0,2,2020-12-28T15:07:33.357,0,,0.0
2020,16,3020,420,10,4930,13,3,3,13,0,0,0,0,0,0,False,False,False,0,2,2020-12-28T15:10:12.213,0,,0.0
2020,16,3020,425,10,7700,2,6,10,12,16,4,16,0,16,0,False,False,False,0,2,2020-12-28T15:15:25.58,16,,0.0
2020,16,3020,435,10,7082,2,45,5,-1,10,11,9,1,9,0,True,False,False,0,3,2020-12-31T16:23:04.103,10,,1.0
2020,16,3020,450,10,6840,2,31,10,5,11,6,11,0,11,0,False,False,False,0,4,2020-12-28T15:27:48.74,11,,0.0
2020,16,3020,475,26,4050,2,32,3,0,6,6,5,1,5,0,False,False,False,0,4,2020-12-28T15:34:51.117,6,,1.0
2020,16,3020,490,10,6285,2,35,7,18,18,0,18,0,18,0,False,False,False,0,3,2020-12-28T15:40:38.07,18,,0.0
2020,16,3020,495,10,6285,2,47,5,3,7,4,5,2,5,0,False,False,False,0,3,2021-02-23T21:01:38.357,7,,2.0
2020,16,3020,515,10,7700,3,7,5,12,0,0,0,0,0,0,False,False,False,0,2,2020-12-31T16:23:36.113,0,,0.0
2020,16,3020,530,26,4619,2,4,5,7,7,0,7,0,7,0,False,False,False,0,2,2020-12-28T15:55:19.203,7,,0.0
2020,16,3020,535,26,7491,2,35,7,15,26,11,26,0,26,0,False,False,False,0,4,2020-12-28T15:57:50.567,26,,0.0
2020,16,3020,545,26,7453,2,45,5,-9,-9,0,-9,0,-9,0,True,False,False,0,2,2020-12-28T16:03:24.797,-9,,0.0
2020,16,3020,550,26,4616,2,52,4,2,11,9,11,0,11,0,False,False,False,1,2,2020-12-31T17:11:56.703,11,,0.0
2020,16,3020,560,26,4050,2,32,5,2,23,21,10,13,10,0,False,False,False,2,4,2020-12-31T16:26:02.437,23,,13.0
2020,16,3020,565,26,4619,3,2,4,7,0,0,0,0,0,0,True,False,False,0,3,2021-02-25T17:32:01.983,0,,0.0
2020,16,3020,580,26,4619,3,35,9,2,0,0,0,0,0,0,True,False,False,0,3,2020-12-31T16:32:49.833,0,,0.0
2020,16,3020,600,10,6285,2,4,10,4,12,8,9,3,9,0,False,False,False,0,3,2020-12-28T16:24:43.117,12,,3.0
2020,16,3020,620,10,6840,2,39,4,4,15,11,6,9,6,0,False,False,False,1,4,2020-12-28T16:32:01.923,15,,9.0
2020,16,3020,630,10,6286,13,17,8,19,0,0,0,0,0,0,False,False,False,0,4,2020-12-31T17:10:03.14,0,,0.0
2020,16,3020,635,10,6285,13,9,6,24,0,0,0,0,0,0,False,False,False,0,2,2020-12-28T16:40:10.997,0,,0.0
2020,16,3020,650,26,6277,13,46,3,0,0,0,0,0,0,0,False,False,False,0,1,2020-12-28T16:45:22.007,0,,0.0
2020,16,3020,655,26,6277,2,5,3,1,9,8,7,2,7,0,False,False,False,0,1,2020-12-28T16:48:06.617,9,,2.0
2020,16,3020,660,26,4619,13,4,3,5,0,0,0,0,0,0,False,False,False,0,2,2020-12-28T16:50:20.143,0,,0.0
2020,16,3020,670,10,7700,13,8,1,43,0,0,0,0,0,0,False,False,False,0,2,2020-12-31T16:33:42.347,0,,0.0
2020,16,3020,680,10,7700,2,13,10,6,10,4,7,3,7,0,False,False,False,1,3,2020-12-31T17:12:06.997,10,,3.0
2020,16,3020,685,10,6840,13,39,10,6,0,0,0,0,0,0,False,False,False,0,4,2020-12-28T17:01:05.613,0,,0.0
2020,16,3020,690,10,6282,2,16,4,1,3,2,3,0,3,0,False,False,False,0,1,2020-12-28T17:03:07.457,3,,0.0
2020,16,3020,695,10,7700,3,6,9,10,0,0,0,0,0,0,False,False,False,0,2,2020-12-28T17:06:05.48,0,,0.0
2020,16,3020,700,10,4930,2,6,4,12,27,15,25,2,25,0,False,False,False,0,3,2020-12-31T17:29:38.877,27,,2.0
2020,16,3020,705,10,6840,2,39,4,5,5,0,5,0,5,0,False,False,False,0,4,2020-12-28T17:10:22.613,5,,0.0
2020,16,3020,715,10,6285,2,29,2,15,15,0,15,0,15,0,False,False,False,0,2,2020-12-28T17:14:40.307,15,,0.0
2020,16,3020,745,26,4619,13,4,9,13,0,0,0,0,0,0,False,False,False,0,2,2020-12-31T16:06:18.003,0,,0.0
2020,16,3020,750,26,7491,13,4,10,14,0,0,0,0,0,0,False,False,False,0,3,2020-12-28T17:29:44.08,0,,0.0
2020,16,3020,765,10,6840,2,35,8,17,19,2,19,0,19,0,False,False,False,0,4,2020-12-28T17:35:11.983,19,,0.0
2020,16,3020,785,10,6282,2,46,3,0,4,4,4,0,4,0,False,False,False,0,1,2020-12-28T17:40:31.97,4,,0.0
2020,16,3020,805,26,7453,2,7,2,16,23,7,19,4,19,0,True,False,False,0,3,2020-12-28T17:47:08.13,23,,4.0
2020,16,3020,870,10,6285,13,35,8,22,0,0,0,0,0,0,True,False,False,0,3,2020-12-28T17:58:33.667,0,,0.0
2020,16,3020,875,10,7700,3,23,7,45,0,0,0,0,0,0,False,False,False,0,3,2020-12-31T16:37:39.737,0,,0.0
2020,16,3020,880,10,7082,13,35,7,20,0,0,0,0,0,0,False,False,False,0,3,2020-12-28T18:05:22.157,0,,0.0
2020,16,3020,885,10,6285,2,8,1,26,25,-1,25,0,25,0,True,False,False,0,3,2021-03-08T21:44:09.687,25,,0.0
2020,16,3020,900,10,7082,13,8,1,49,0,0,0,0,0,0,False,False,False,0,2,2021-03-04T20:43:17.8,0,,0.0
2020,16,3021,15,23,7250,2,49,10,-5,-1,4,-3,2,-3,0,False,False,False,1,3,2020-12-27T15:51:15.673,-1,,2.0
2020,16,3021,20,23,2256,13,22,7,21,0,0,0,0,0,0,False,False,False,0,3,2021-02-25T17:35:29.593,0,,0.0
2020,16,3021,30,17,6276,2,12,10,0,1,1,1,0,1,0,False,False,False,0,4,2020-12-27T12:30:53.383,1,,0.0
2020,16,3021,50,23,2256,2,35,7,15,16,1,16,0,16,0,False,False,False,0,3,2020-12-27T12:35:16.443,16,,0.0
2020,16,3021,55,23,2994,13,35,5,9,0,0,0,0,0,0,False,False,False,0,3,2020-12-27T12:36:34.377,0,,0.0
2020,16,3021,60,23,7250,2,51,10,-3,11,14,8,3,8,0,False,False,False,0,3,2020-12-28T18:27:24.16,11,,3.0
2020,16,3021,65,23,596,13,9,5,12,0,0,0,0,0,0,False,False,False,0,4,2020-12-27T12:40:04.577,0,,0.0
2020,16,3021,100,17,7618,2,48,9,-4,1,5,-1,2,-1,0,False,False,False,1,1,2020-12-27T12:50:25.593,1,,2.0
2020,16,3021,105,17,4305,2,4,10,11,13,2,11,2,11,0,False,False,False,1,2,2020-12-29T22:21:12.43,13,,2.0
2020,16,3021,125,17,6274,2,2,10,4,5,1,5,0,5,0,False,False,False,0,3,2020-12-27T12:56:37.907,5,,0.0
2020,16,3021,130,17,4305,2,13,4,3,5,2,5,0,5,0,True,False,False,0,3,2020-12-27T12:57:44.427,5,,0.0
2020,16,3021,140,17,7687,2,30,9,-1,6,7,0,6,0,0,False,False,False,1,3,2020-12-27T13:00:03.667,6,,6.0
2020,16,3021,170,23,3957,2,44,3,-2,4,6,3,1,3,0,False,False,False,0,1,2020-12-27T13:06:30.323,4,,1.0
2020,16,3021,175,23,2994,2,9,2,20,29,9,25,4,25,0,False,False,False,0,2,2020-12-27T13:07:28.75,29,,4.0
2020,16,3021,190,23,596,2,26,9,1,2,1,1,1,1,0,False,False,False,0,4,2020-12-27T13:11:06.177,2,,1.0
2020,16,3021,205,17,7687,2,47,5,1,2,1,1,1,1,0,False,False,False,0,3,2020-12-27T13:16:09.023,2,,1.0
2020,16,3021,210,17,4484,2,46,3,0,3,3,2,1,2,0,False,False,False,1,4,2020-12-29T22:21:35.997,3,,1.0
2020,16,3021,215,17,7687,13,12,10,8,0,0,0,0,0,0,False,False,False,0,3,2020-12-27T13:19:09.97,0,,0.0
2020,16,3021,225,23,7241,13,4,3,-1,0,0,0,0,0,0,True,False,False,0,2,2021-03-08T15:46:18.29,0,,0.0
2020,16,3021,235,23,2256,2,8,1,15,19,4,15,4,15,0,False,False,False,0,3,2020-12-27T13:22:57.867,19,,4.0
2020,16,3021,245,23,7241,13,46,3,2,0,0,0,0,0,0,True,False,False,0,3,2020-12-28T15:51:01.477,0,,0.0
2020,16,3021,295,17,6274,13,35,10,14,0,0,0,0,0,0,False,False,False,0,4,2020-12-27T13:33:36.633,0,,0.0
2020,16,3021,310,17,4305,13,47,5,1,0,0,0,0,0,0,True,False,False,0,3,2020-12-27T13:36:21.14,0,,0.0
2020,16,3021,315,17,6276,2,47,5,3,5,2,5,0,5,0,False,False,False,0,4,2020-12-27T13:37:22.86,5,,0.0
2020,16,3021,320,17,7024,2,4,10,4,4,0,4,0,4,0,False,False,False,0,2,2020-12-27T13:38:12.68,4,,0.0
2020,16,3021,365,23,7250,2,4,10,4,12,8,5,7,5,0,False,False,False,1,3,2021-03-03T19:22:19.373,12,,7.0
2020,16,3021,370,23,2994,13,12,2,18,0,0,0,0,0,0,False,False,False,0,4,2020-12-27T13:49:18.18,0,,
2020,16,3021,375,23,2994,2,35,9,13,19,6,19,0,19,0,False,False,False,0,3,2020-12-27T13:50:52.127,19,,0.0
2020,16,3021,385,23,7250,2,4,9,6,9,3,7,2,7,0,True,False,False,0,3,2020-12-27T15:51:57.863,9,,2.0
2020,16,3021,390,23,2994,2,6,9,5,9,4,7,2,7,0,False,False,False,0,4,2020-12-27T13:53:39.287,9,,2.0
2020,16,3021,410,23,596,13,32,5,4,0,0,0,0,0,0,False,False,False,0,4,2020-12-27T13:56:08.32,0,,0.0
2020,16,3021,440,17,7024,2,46,3,2,5,3,4,1,4,0,False,False,False,0,1,2020-12-27T14:12:27.577,5,,1.0
2020,16,3021,450,17,4305,2,13,4,2,6,4,2,4,2,0,False,False,False,1,3,2020-12-27T14:14:34.553,6,,4.0
2020,16,3021,455,17,4305,2,2,9,10,14,4,12,2,12,0,False,False,False,0,3,2021-03-17T20:47:32.95,14,,2.0
2020,16,3021,465,17,4305,2,34,4,-4,5,9,2,3,2,0,True,False,False,2,3,2021-03-04T18:35:30.997,5,,3.0
2020,16,3021,470,17,4752,2,12,4,7,8,1,8,0,8,0,False,False,False,0,2,2020-12-27T14:19:11.823,8,,0.0
2020,16,3021,480,17,7024,2,48,4,-3,10,13,2,8,2,6,False,False,False,2,1,2021-03-03T19:23:40.873,10,,8.0
2020,16,3021,495,23,2256,2,35,9,14,13,-1,13,0,13,0,False,False,False,0,3,2020-12-27T14:27:34.773,13,,0.0
2020,16,3021,510,23,596,13,43,3,14,0,0,0,0,0,0,True,False,False,0,4,2020-12-28T15:51:29.927,0,,0.0
2020,16,3021,520,17,4383,3,4,8,16,0,0,0,0,0,0,False,False,False,0,3,2021-02-23T19:33:48.847,0,,0.0
2020,16,3021,540,23,2256,2,4,9,14,22,8,16,6,16,0,False,False,False,1,2,2020-12-27T14:39:53.987,22,,6.0
2020,16,3021,545,23,7689,2,45,5,-7,11,18,1,10,1,0,True,False,False,2,1,2021-03-03T19:25:20.73,11,,10.0
2020,16,3021,550,23,2994,2,9,2,28,33,5,30,3,30,0,False,False,False,0,3,2020-12-27T14:41:19.76,33,,3.0
2020,16,3021,555,23,596,2,32,10,-1,10,11,6,4,6,0,False,False,False,0,4,2020-12-29T22:29:59.293,10,,4.0
2020,16,3021,570,23,7250,2,5,3,3,3,0,3,0,3,0,False,False,False,0,3,2020-12-27T15:52:18.153,3,,0.0
2020,16,3021,595,17,4752,13,12,7,15,0,0,0,0,0,0,False,False,False,0,3,2020-12-27T14:50:23.287,0,,0.0
2020,16,3021,610,23,2994,2,9,2,19,22,3,21,1,21,0,False,False,False,0,4,2020-12-27T14:54:02.7,22,,1.0
2020,16,3021,620,23,3957,2,44,3,-5,4,9,1,3,1,0,False,False,False,0,1,2020-12-28T15:54:13.203,4,,3.0
2020,16,3021,630,23,7688,13,6,4,14,0,0,0,0,0,0,False,False,False,0,2,2020-12-27T15:01:25.253,0,,0.0
2020,16,3021,640,17,6274,2,47,5,1,1,0,1,0,1,0,False,False,False,0,3,2020-12-27T15:02:52.043,1,,0.0
2020,16,3021,665,23,7688,13,8,1,43,0,0,0,0,0,0,False,False,False,0,3,2020-12-27T15:07:55.897,0,,0.0
2020,16,3021,680,17,7024,2,46,3,0,4,4,3,1,3,0,False,False,False,1,1,2020-12-27T15:56:45.15,4,,1.0
2020,16,3021,690,17,4752,2,7,3,12,13,1,12,1,12,0,False,False,False,0,3,2021-02-25T17:36:52.31,13,,1.0
2020,16,3021,695,17,4383,2,6,9,4,8,4,7,1,7,0,False,False,False,0,2,2020-12-27T15:15:58.293,8,,1.0
2020,16,3021,705,17,6274,13,17,1,25,0,0,0,0,0,0,False,False,False,0,3,2020-12-27T15:17:56.223,0,,0.0
2020,16,3021,715,17,6274,2,2,4,7,17,10,15,2,15,0,True,False,False,0,3,2020-12-27T15:21:08.23,17,,2.0
2020,16,3021,720,17,6274,2,17,1,21,31,10,28,3,28,0,False,False,False,0,3,2020-12-27T15:20:56.7,31,,3.0
2020,16,3021,735,17,4383,3,2,10,3,0,0,0,0,0,0,False,False,False,0,2,2020-12-28T19:34:13.927,0,,0.0
2020,16,3021,740,17,6274,13,2,4,4,0,0,0,0,0,0,False,False,False,0,3,2020-12-27T15:24:10.603,0,,0.0
2020,16,3021,760,23,2256,2,12,2,35,85,50,36,49,36,6,False,False,False,1,3,2020-12-29T22:36:37.37,85,,49.0
2020,16,3021,775,17,4752,2,4,9,5,7,2,6,1,6,0,False,False,False,0,3,2020-12-27T15:29:35.057,7,,1.0
2020,16,3021,780,17,4752,2,4,5,5,9,4,8,1,8,0,False,False,False,0,2,2020-12-27T15:31:21.26,9,,1.0
2020,16,3021,785,17,7024,2,2,10,6,59,53,6,53,6,6,False,False,False,2,2,2021-03-03T19:27:43.33,59,,53.0
2020,16,3021,800,23,3843,2,5,9,4,4,0,4,0,4,0,False,False,False,0,1,2020-12-27T15:34:43.977,4,,0.0
2020,16,3021,805,23,2256,13,8,1,51,0,0,0,0,0,0,False,False,False,0,4,2020-12-27T15:36:57.533,0,,
2020,16,3021,875,17,4383,2,19,6,34,34,0,34,0,34,0,False,False,False,0,2,2020-12-27T15:45:47.95,34,,0.0
2020,16,3022,10,8,3883,2,39,4,5,5,0,5,0,5,0,False,False,False,0,4,2020-12-28T11:32:02.44,5,,0.0
2020,16,3022,15,8,4000,13,4,4,4,0,0,0,0,0,0,False,False,False,0,1,2020-12-28T11:33:38.417,0,,0.0
2020,16,3022,20,8,5053,13,31,10,0,0,0,0,0,0,0,False,False,False,0,1,2020-12-28T11:35:16.37,0,,0.0
2020,16,3022,30,22,7610,13,4,5,10,0,0,0,0,0,0,False,False,False,0,3,2020-12-28T11:38:23.82,0,,0.0
2020,16,3022,35,22,256,13,9,6,28,0,0,0,0,0,0,False,False,False,0,2,2020-12-31T16:12:02.147,0,,0.0
2020,16,3022,55,8,3883,2,17,7,24,28,4,28,0,28,0,False,False,False,0,3,2020-12-28T11:51:01.987,28,,0.0
2020,16,3022,60,8,7652,13,5,6,20,0,0,0,0,0,0,True,False,False,0,3,2020-12-29T19:45:36.057,0,,0.0
2020,16,3022,65,8,3883,2,5,3,6,7,1,6,1,6,0,False,False,False,0,4,2020-12-28T11:55:31.367,7,,1.0
2020,16,3022,70,8,3883,2,12,3,5,5,0,5,0,5,0,False,False,False,0,4,2020-12-28T17:59:38.76,5,,0.0
2020,16,3022,80,8,3883,13,17,4,6,0,0,0,0,0,0,False,False,False,0,4,2020-12-31T15:31:41.303,0,,0.0
2020,16,3022,90,8,7652,13,4,10,14,0,0,0,0,0,0,False,False,False,0,3,2020-12-28T12:03:29.647,0,,0.0
2020,16,3022,115,22,3320,2,47,5,0,13,13,1,12,1,0,False,False,False,1,1,2020-12-31T16:36:26.723,13,,12.0
2020,16,3022,120,22,6270,2,50,9,-1,17,18,14,3,14,0,False,False,False,0,3,2020-12-28T12:20:48.747,17,,3.0
2020,16,3022,125,22,3170,13,35,8,17,0,0,0,0,0,0,False,False,False,0,3,2020-12-31T15:31:41.303,0,,0.0
2020,16,3022,155,8,8054,2,13,9,4,6,2,5,1,5,0,False,False,False,0,3,2020-12-28T12:33:39.77,6,,1.0
2020,16,3022,165,22,3170,2,5,3,6,9,3,8,1,8,0,False,False,False,0,3,2020-12-28T17:56:45.497,9,,1.0
2020,16,3022,175,22,3170,2,5,3,5,9,4,6,3,6,0,False,False,False,0,3,2020-12-28T12:44:27.393,9,,3.0
2020,16,3022,185,22,6270,2,11,2,26,43,17,41,2,41,6,False,False,False,0,1,2021-02-23T19:52:04.78,43,,2.0
2020,16,3022,200,8,7652,2,4,10,5,13,8,8,5,8,0,False,False,False,0,4,2020-12-28T12:52:29.747,13,,5.0
2020,16,3022,225,22,256,13,5,3,11,0,0,0,0,0,0,False,False,False,0,3,2020-12-28T13:00:36.157,0,,0.0
2020,16,3022,230,22,6262,2,17,10,11,11,0,11,0,11,6,False,False,False,0,3,2020-12-28T17:55:36.257,11,,0.0
2020,16,3022,250,8,7652,2,4,9,8,14,6,9,5,9,0,False,False,False,0,3,2020-12-28T13:11:35.82,14,,5.0
2020,16,3022,260,8,6439,2,28,9,-1,8,9,0,8,0,0,False,False,False,2,1,2020-12-28T17:57:37.777,8,,8.0
2020,16,3022,285,8,3883,3,6,9,12,0,0,0,0,0,0,False,False,False,0,2,2020-12-28T13:23:41.333,0,,0.0
2020,16,3022,300,22,256,13,8,8,20,0,0,0,0,0,0,False,False,False,0,2,2021-03-08T15:51:49.52,0,,0.0
2020,16,3022,305,22,3170,2,5,5,4,5,1,5,0,5,0,True,False,False,0,3,2020-12-28T13:36:41.437,5,,0.0
2020,16,3022,310,22,3170,2,51,3,-2,12,14,10,2,10,0,False,False,False,0,3,2020-12-28T13:38:54.07,12,,2.0
2020,16,3022,335,8,4976,2,39,10,5,7,2,7,0,7,0,False,False,False,0,4,2020-12-28T13:50:56.337,7,,0.0
2020,16,3022,340,8,4976,2,4,10,4,4,0,4,0,4,0,False,False,False,0,4,2020-12-28T13:52:03.98,4,,0.0
2020,16,3022,355,8,5053,3,6,9,3,0,0,0,0,0,0,False,False,False,0,1,2020-12-31T15:31:41.303,0,,0.0
2020,16,3022,410,8,5053,2,16,10,3,8,5,7,1,7,0,True,False,False,0,1,2020-12-28T14:13:52.093,8,,1.0
2020,16,3022,420,8,3820,13,8,8,19,0,0,0,0,0,0,False,False,False,0,2,2020-12-29T19:46:23.16,0,,0.0
2020,16,3022,425,8,3883,2,6,10,7,9,2,7,2,7,0,False,False,False,0,4,2020-12-28T14:17:25.847,9,,2.0
2020,16,3022,435,8,7652,2,5,3,10,10,0,10,0,10,0,False,False,False,0,3,2020-12-28T14:19:26.23,10,,0.0
2020,16,3022,445,8,3883,13,46,3,3,0,0,0,0,0,0,False,False,False,0,4,2021-02-23T19:53:26.537,0,,0.0
2020,16,3022,465,22,6262,2,31,9,6,7,1,6,1,6,0,True,False,False,0,4,2020-12-29T20:48:57.093,7,,1.0
2020,16,3022,480,22,3170,2,13,4,3,25,22,7,18,7,0,False,False,False,1,2,2020-12-28T14:49:56.99,25,,18.0
2020,16,3022,495,22,3170,2,9,2,24,30,6,30,0,30,6,False,False,False,0,3,2020-12-31T15:31:41.303,30,,0.0
2020,16,3022,515,8,6439,2,28,4,4,4,0,4,0,4,0,False,False,False,0,1,2020-12-28T15:00:58.31,4,,0.0
2020,16,3022,520,8,3820,2,5,5,12,12,0,12,0,12,0,False,False,False,0,3,2020-12-28T15:02:30.247,12,,0.0
2020,16,3022,525,8,3883,13,38,9,5,0,0,0,0,0,0,False,False,False,0,3,2020-12-28T15:04:27.703,0,,0.0
2020,16,3022,540,22,7609,2,48,9,-3,14,17,11,3,11,0,False,False,False,0,1,2020-12-31T16:38:14.803,14,,3.0
2020,16,3022,545,22,256,13,19,7,45,0,0,0,0,0,0,False,False,False,0,2,2021-02-23T19:54:08.207,0,,0.0
2020,16,3022,565,22,7609,13,11,6,23,0,0,0,0,0,0,False,False,False,0,1,2020-12-28T15:23:13.763,0,,0.0
2020,16,3022,575,22,3170,13,4,4,10,0,0,0,0,0,0,False,False,False,0,3,2020-12-28T15:25:55.38,0,,0.0
2020,16,3022,585,8,8054,2,6,9,5,7,2,5,2,5,0,False,False,False,0,2,2020-12-28T15:35:22.087,7,,2.0
2020,16,3022,590,8,6439,2,48,10,-2,15,17,-2,17,-2,0,False,False,False,1,1,2021-03-03T19:37:09.443,15,,17.0
2020,16,3022,595,8,7652,13,8,7,23,0,0,0,0,0,0,False,False,False,0,3,2020-12-28T18:00:28.873,0,,0.0
2020,16,3022,600,8,8054,2,9,2,20,22,2,22,0,22,0,False,False,False,0,2,2020-12-28T15:40:41.607,22,,0.0
2020,16,3022,610,8,5053,2,48,9,-3,9,12,6,3,6,0,False,False,False,1,1,2020-12-28T15:42:49.39,9,,3.0
2020,16,3022,620,8,3883,13,9,3,3,0,0,0,0,0,0,True,False,False,0,2,2020-12-29T19:46:00.86,0,,0.0
2020,16,3022,625,8,3820,13,7,3,3,0,0,0,0,0,0,False,False,False,0,3,2020-12-31T16:25:35.443,0,,
2020,16,3022,645,22,6262,2,6,9,5,5,0,5,0,5,0,False,False,False,0,4,2020-12-28T15:51:59.89,5,,0.0
2020,16,3022,655,22,256,13,6,9,12,0,0,0,0,0,0,False,False,False,0,3,2020-12-28T15:54:14.23,0,,0.0
2020,16,3022,665,8,4976,2,5,9,4,11,7,8,3,8,0,False,False,False,0,4,2020-12-28T15:56:37.063,11,,3.0
2020,16,3022,670,8,8054,2,5,3,8,8,0,8,0,8,0,False,False,False,0,2,2020-12-28T15:57:43.847,8,,0.0
2020,16,3022,680,8,8054,13,13,5,5,0,0,0,0,0,0,False,False,False,0,3,2020-12-28T16:01:59.703,0,,0.0
2020,16,3022,685,8,8054,2,12,10,14,17,3,17,0,17,0,False,False,False,0,2,2020-12-28T16:04:05.797,17,,0.0
2020,16,3022,705,8,8054,13,9,2,18,0,0,0,0,0,0,False,False,False,0,2,2020-12-28T16:10:10.967,0,,0.0
2020,16,3022,710,8,3820,13,8,9,13,0,0,0,0,0,0,False,False,False,0,2,2020-12-28T16:11:51.95,0,,
2020,16,3022,715,8,6439,2,4,4,3,3,0,3,0,3,0,False,False,False,1,1,2020-12-28T16:13:53.15,3,,0.0
2020,16,3022,745,22,3170,2,45,5,-3,2,5,2,0,2,0,True,False,False,0,3,2020-12-28T16:26:25.453,2,,0.0
2020,16,3022,755,22,1113,2,4,4,3,5,2,4,1,4,0,False,False,False,0,1,2020-12-28T16:28:44.127,5,,1.0
2020,16,3022,785,22,6270,2,47,5,0,0,0,0,0,0,0,True,False,False,0,1,2020-12-29T20:49:06.04,0,,0.0
2020,16,3022,795,8,6439,2,47,5,0,8,8,5,3,5,0,False,False,False,1,1,2020-12-28T16:39:49.233,8,,3.0
2020,16,3022,800,8,3820,13,6,1,15,0,0,0,0,0,0,False,False,False,0,2,2020-12-28T16:55:27.053,0,,
2020,16,3022,805,8,8054,13,20,6,28,0,0,0,0,0,0,False,False,False,0,2,2020-12-28T17:00:01.203,0,,0.0
2020,16,3022,810,8,6439,2,48,10,-4,6,10,-2,8,-2,0,False,False,False,2,1,2020-12-28T17:01:55.117,6,,
2020,16,3022,815,8,8054,13,3,3,5,0,0,0,0,0,0,False,False,False,0,2,2020-12-31T15:31:41.303,0,,0.0
2020,16,3022,820,8,3883,13,4,4,13,0,0,0,0,0,0,False,False,False,0,3,2020-12-31T15:47:07.467,0,,0.0
2020,16,3022,835,22,256,13,2,9,9,0,0,0,0,0,0,False,False,False,0,2,2020-12-28T17:08:48.333,0,,0.0
2020,16,3022,840,22,6262,2,28,10,8,11,3,9,2,9,0,False,False,False,0,1,2020-12-28T17:14:32.917,11,,2.0
2020,16,3022,855,22,7610,13,21,2,26,0,0,0,0,0,0,False,False,False,0,2,2021-02-23T19:54:46.99,0,,0.0
2020,16,3022,865,8,8054,13,4,9,5,0,0,0,0,0,0,False,False,False,0,2,2020-12-28T17:19:59.733,0,,0.0
2020,16,3022,870,8,4976,2,4,9,4,4,0,4,0,4,0,False,False,False,0,3,2020-12-28T17:21:05.35,4,,0.0
2020,16,3022,925,8,5053,2,48,9,-2,24,26,18,6,18,0,False,False,False,0,1,2020-12-28T17:31:41.5,24,,6.0
2020,16,3022,930,8,3883,2,12,9,8,8,0,8,0,8,0,False,False,False,0,4,2021-03-09T14:12:52.863,8,,0.0
2020,16,3022,935,8,3883,13,12,7,19,0,0,0,0,0,0,False,False,False,0,3,2020-12-31T15:32:00.69,0,,0.0
2020,16,3022,950,8,7652,3,4,10,6,0,0,0,0,0,0,False,False,False,0,3,2020-12-28T17:37:07.89,0,,0.0
2020,16,3022,955,8,8054,13,19,6,20,0,0,0,0,0,0,False,False,False,0,2,2020-12-28T17:38:29.803,0,,0.0
2020,16,3022,960,8,3883,2,5,3,9,9,0,9,0,9,0,False,False,False,0,3,2020-12-28T17:40:02.55,9,,0.0
2020,16,3023,15,3,2688,2,4,9,6,13,7,9,4,9,0,False,False,False,0,3,2020-12-28T11:01:58.29,13,,4.0
2020,16,3023,25,3,6935,2,35,10,10,13,3,12,1,12,0,False,False,False,0,3,2020-12-31T12:18:56.637,13,,1.0
2020,16,3023,35,3,6936,2,4,9,6,9,3,9,0,9,0,False,False,False,0,3,2020-12-28T11:11:29.493,9,,0.0
2020,16,3023,70,3,6936,2,35,3,6,6,0,6,0,6,6,False,False,False,0,3,2020-12-28T11:25:56.197,6,,0.0
2020,16,3023,90,21,7090,13,2,9,5,0,0,0,0,0,0,False,False,False,0,2,2020-12-28T11:30:25.517,0,,0.0
2020,16,3023,105,21,4422,2,50,10,2,10,8,9,1,9,0,False,False,False,0,3,2020-12-28T11:34:01.14,10,,1.0
2020,16,3023,135,3,6454,13,17,8,15,0,0,0,0,0,0,False,False,False,0,4,2020-12-31T12:19:37.66,0,,0.0
2020,16,3023,145,3,2688,2,2,4,10,11,1,10,1,10,0,False,False,False,0,3,2020-12-28T11:49:11.547,11,,1.0
2020,16,3023,155,3,7671,3,44,3,-5,0,0,0,0,0,0,False,False,False,0,1,2020-12-28T11:53:10.663,0,,0.0
2020,16,3023,175,21,3680,13,24,2,24,0,0,0,0,0,0,False,False,False,0,3,2020-12-28T12:00:21.213,0,,
2020,16,3023,190,21,4405,2,5,10,4,7,3,5,2,5,0,False,False,False,0,1,2020-12-28T12:05:02.037,7,,2.0
2020,16,3023,195,21,3680,13,4,8,35,0,0,0,0,0,0,False,False,False,0,3,2021-03-17T20:04:01.247,0,,0.0
2020,16,3023,205,21,8259,3,13,10,6,0,0,0,0,0,0,False,False,False,0,3,2020-12-31T11:49:54.053,0,,0.0
2020,16,3023,230,3,6454,2,4,4,5,6,1,6,0,6,0,False,False,False,0,3,2020-12-28T12:29:27.697,6,,0.0
2020,16,3023,245,3,6454,2,39,4,7,11,4,8,3,8,0,False,False,False,0,3,2020-12-28T12:35:20.023,11,,3.0
2020,16,3023,265,3,6454,2,35,2,18,20,2,18,2,18,0,False,False,False,0,3,2020-12-29T23:15:11.437,20,,2.0
2020,16,3023,270,3,7672,2,34,4,-4,0,4,-3,3,-3,0,True,False,False,0,3,2020-12-28T12:46:15.63,0,,3.0
2020,16,3023,280,3,6454,13,12,5,2,0,0,0,0,0,0,False,False,False,0,3,2020-12-31T12:01:16.733,0,,0.0
2020,16,3023,295,21,3680,2,35,5,11,14,3,14,0,14,0,False,False,False,0,3,2020-12-28T12:53:16.973,14,,0.0
2020,16,3023,305,21,4422,2,13,9,5,13,8,6,7,6,0,False,False,False,1,3,2020-12-28T12:56:39.047,13,,7.0
2020,16,3023,315,21,963,2,28,9,2,9,7,4,5,4,0,False,False,False,1,1,2020-12-31T12:16:31.923,9,,5.0
2020,16,3023,325,21,3680,2,4,5,6,11,5,10,1,10,0,False,False,False,0,2,2020-12-28T13:01:56.973,11,,1.0
2020,16,3023,330,21,4422,2,13,9,3,11,8,10,1,10,0,False,False,False,0,4,2020-12-28T13:03:31.223,11,,1.0
2020,16,3023,335,21,3680,2,4,5,4,4,0,4,0,4,0,False,False,False,0,2,2020-12-28T13:04:40.973,4,,0.0
2020,16,3023,345,21,8259,13,8,10,13,0,0,0,0,0,0,False,False,False,0,3,2020-12-31T12:22:43.97,0,,0.0
2020,16,3023,350,21,8259,13,8,10,13,0,0,0,0,0,0,False,False,False,0,3,2020-12-28T13:08:44.493,0,,0.0
2020,16,3023,365,3,6454,2,39,4,5,7,2,6,1,6,0,False,False,False,0,3,2020-12-28T13:11:22.557,7,,1.0
2020,16,3023,370,3,6454,2,6,9,12,25,13,12,13,12,0,False,False,False,1,3,2020-12-28T13:12:37.393,25,,13.0
2020,16,3023,380,3,6936,2,4,5,6,6,0,6,0,6,0,False,False,False,0,2,2020-12-29T23:16:44.22,6,,0.0
2020,16,3023,385,3,6454,13,12,2,17,0,0,0,0,0,0,False,False,False,0,3,2020-12-29T23:17:18.547,0,,0.0
2020,16,3023,420,3,6454,3,2,4,10,0,0,0,0,0,0,False,False,False,0,3,2020-12-28T13:25:23.733,0,,0.0
2020,16,3023,440,21,7090,2,2,9,9,15,6,15,0,15,0,False,False,False,0,2,2020-12-28T13:38:06.22,15,,0.0
2020,16,3023,445,21,4422,13,9,6,21,0,0,0,0,0,0,False,False,False,0,3,2020-12-31T11:49:54.053,0,,0.0
2020,16,3023,460,3,6935,13,6,9,10,0,0,0,0,0,0,False,False,False,0,3,2020-12-28T13:44:13.503,0,,0.0
2020,16,3023,495,21,5015,13,6,10,11,0,0,0,0,0,0,False,False,False,0,2,2020-12-28T14:00:04.1,0,,0.0
2020,16,3023,500,21,5015,2,2,9,6,16,10,6,10,6,0,False,False,False,0,2,2020-12-31T12:16:42.203,16,,10.0
2020,16,3023,505,21,4405,2,17,7,15,19,4,19,0,19,0,False,False,False,0,1,2020-12-28T16:17:29.63,19,,0.0
2020,16,3023,515,21,7226,13,11,6,17,0,0,0,0,0,0,True,False,False,0,4,2020-12-31T12:25:54.443,0,,
2020,16,3023,520,21,6365,2,17,8,18,20,2,18,2,18,0,False,False,False,0,3,2020-12-28T14:09:23.9,20,,2.0
2020,16,3023,525,21,3680,2,26,9,3,8,5,4,4,4,0,False,False,False,0,3,2020-12-28T14:11:28.477,8,,4.0
2020,16,3023,540,21,3680,2,51,3,-6,-5,1,-5,0,-5,0,True,False,False,0,3,2020-12-31T12:26:45.52,-5,,0.0
2020,16,3023,550,21,4422,2,4,10,3,7,4,3,4,3,0,False,False,False,1,3,2020-12-28T14:20:50.15,7,,4.0
2020,16,3023,570,3,6659,2,47,5,1,10,9,8,2,8,0,False,False,False,0,1,2020-12-28T14:26:48.893,10,,2.0
2020,16,3023,585,3,6936,2,12,10,2,4,2,4,0,4,0,False,False,False,0,3,2020-12-28T14:33:38.62,4,,0.0
2020,16,3023,600,3,590,2,8,4,8,8,0,8,0,8,6,False,False,False,0,2,2020-12-31T11:49:54.053,8,,0.0
2020,16,3023,615,21,7090,13,19,2,37,0,0,0,0,0,0,False,False,False,0,2,2020-12-28T14:45:05.267,0,,0.0
2020,16,3023,620,21,4422,2,47,5,0,0,0,0,0,0,0,True,False,False,0,3,2020-12-28T14:46:43.507,0,,0.0
2020,16,3023,625,21,4422,2,5,9,5,9,4,7,2,7,0,False,False,False,0,3,2020-12-29T23:19:27.94,9,,2.0
2020,16,3023,655,21,4422,13,2,9,14,0,0,0,0,0,0,False,False,False,0,3,2020-12-31T12:27:30.14,0,,0.0
2020,16,3023,660,21,3680,13,2,10,7,0,0,0,0,0,0,False,False,False,0,2,2020-12-28T15:05:49.567,0,,0.0
2020,16,3023,670,21,3680,2,6,4,6,16,10,10,6,10,0,False,False,False,1,3,2020-12-31T12:16:53.637,16,,6.0
2020,16,3023,675,21,6365,2,12,3,13,13,0,13,0,13,0,False,False,False,0,3,2020-12-28T15:10:28.55,13,,0.0
2020,16,3023,680,21,7090,13,2,9,4,0,0,0,0,0,0,False,False,False,0,2,2020-12-31T12:35:41.67,0,,0.0
2020,16,3023,685,21,7090,2,4,3,11,11,0,11,0,11,0,False,False,False,0,2,2020-12-28T15:14:30.67,11,,0.0
2020,16,3023,690,21,3680,13,35,7,17,0,0,0,0,0,0,False,False,False,0,3,2020-12-28T15:16:03.437,0,,
2020,16,3023,695,21,3680,2,4,10,3,6,3,6,0,6,0,False,False,False,0,3,2020-12-28T15:18:05.403,6,,
2020,16,3023,705,21,3680,2,26,3,3,3,0,3,0,3,6,False,False,False,0,2,2020-12-28T15:21:00.35,3,,0.0
2020,16,3023,740,21,3680,2,13,10,3,12,9,10,2,10,0,False,False,False,0,2,2020-12-28T15:28:57.863,12,,2.0
2020,16,3023,745,21,7090,3,9,6,23,0,0,0,0,0,0,False,False,False,0,3,2020-12-28T15:32:10.943,0,,0.0
2020,16,3023,750,21,3680,13,2,10,6,0,0,0,0,0,0,False,False,False,0,2,2020-12-31T12:59:53.253,0,,0.0
2020,16,3023,760,21,4422,13,35,7,19,0,0,0,0,0,0,False,False,False,0,3,2020-12-28T15:36:16.757,0,,0.0
2020,16,3023,780,3,6659,2,12,5,7,27,20,7,20,7,0,False,False,False,2,1,2021-03-03T19:45:51.79,27,,20.0
2020,16,3023,800,3,6454,2,13,5,7,7,0,7,0,7,0,False,False,False,0,3,2020-12-31T11:49:54.053,7,,0.0
2020,16,3023,825,21,4422,13,9,6,15,0,0,0,0,0,0,False,False,False,0,3,2020-12-31T11:49:54.053,0,,
2020,16,3023,830,21,3680,2,26,10,3,14,11,14,0,14,0,False,False,False,0,3,2020-12-31T12:28:39.417,14,,0.0
2020,16,3023,835,21,4422,2,2,10,12,15,3,14,1,14,0,False,False,False,0,3,2020-12-29T23:20:18.643,15,,1.0
2020,16,3023,840,21,7090,13,2,10,5,0,0,0,0,0,0,False,False,False,0,2,2020-12-28T16:00:11.423,0,,0.0
2020,16,3023,845,21,7090,13,20,2,20,0,0,0,0,0,0,False,False,False,0,2,2020-12-28T16:01:34.103,0,,0.0
2020,16,3023,855,21,6365,13,5,3,7,0,0,0,0,0,0,False,False,False,0,3,2020-12-28T16:03:46.24,0,,0.0
2020,16,3024,10,13,876,13,6,4,9,0,0,0,0,0,0,False,False,False,0,3,2020-12-28T12:26:49.807,0,,0.0
2020,16,3024,20,13,6880,2,5,5,2,3,1,3,0,3,0,True,False,False,0,2,2020-12-28T12:31:30.123,3,,0.0
2020,16,3024,30,7,931,2,48,9,-3,28,31,25,3,25,0,False,False,False,0,1,2020-12-28T13:29:42.917,28,,3.0
2020,16,3024,40,7,4341,2,4,4,7,8,1,7,1,7,0,False,False,False,0,3,2020-12-28T13:30:28.67,8,,1.0
2020,16,3024,50,7,4455,2,48,9,-3,15,18,11,4,11,0,False,False,False,0,1,2020-12-28T13:30:40.563,15,,4.0
2020,16,3024,60,7,931,2,47,5,1,6,5,4,2,4,0,False,False,False,0,1,2020-12-28T13:30:53.797,6,,2.0
2020,16,3024,65,7,6975,2,46,3,0,8,8,8,0,8,6,False,False,False,0,3,2020-12-28T13:31:05.313,8,,0.0
2020,16,3024,80,13,876,2,5,5,7,7,0,7,0,7,0,False,False,False,0,3,2020-12-28T12:57:06.633,7,,0.0
2020,16,3024,90,13,4733,3,4,9,5,0,0,0,0,0,0,False,False,False,0,3,2020-12-31T14:26:02.793,0,,0.0
2020,16,3024,105,7,931,2,47,5,0,17,17,17,0,17,0,True,False,False,0,1,2020-12-28T13:31:26.3,17,,0.0
2020,16,3024,120,7,4455,2,48,10,-7,8,15,4,4,4,0,False,False,False,0,1,2020-12-31T14:20:42.063,8,,4.0
2020,16,3024,125,7,910,13,19,2,26,0,0,0,0,0,0,False,False,False,0,2,2020-12-28T13:31:53.347,0,,0.0
2020,16,3024,130,7,910,13,9,2,20,0,0,0,0,0,0,False,False,False,0,3,2020-12-28T13:32:06.23,0,,0.0
2020,16,3024,135,13,876,2,21,2,47,50,3,47,3,47,0,False,False,False,0,2,2020-12-31T14:27:16.393,50,,3.0
2020,16,3024,140,13,6637,2,39,4,2,2,0,2,0,2,0,False,False,False,0,3,2020-12-28T13:21:29.173,2,,0.0
2020,16,3024,150,13,6880,13,7,5,3,0,0,0,0,0,0,False,False,False,0,4,2020-12-28T13:25:18.973,0,,0.0
2020,16,3024,165,7,910,2,5,3,5,5,0,5,0,5,0,False,False,False,0,2,2020-12-28T13:29:17.447,5,,0.0
2020,16,3024,175,7,910,13,4,3,7,0,0,0,0,0,0,False,False,False,0,2,2020-12-28T13:35:03.403,0,,
2020,16,3024,185,7,7659,3,50,9,-1,0,0,0,0,0,0,False,False,False,0,3,2020-12-29T17:54:42.37,0,,
2020,16,3024,190,7,931,2,28,9,-2,6,8,6,0,6,0,False,False,False,0,1,2020-12-28T13:40:39.42,6,,0.0
2020,16,3024,200,7,7659,2,13,9,4,9,5,5,4,5,0,False,False,False,1,3,2021-03-03T19:54:21.677,9,,4.0
2020,16,3024,215,7,4341,2,4,10,7,7,0,7,0,7,0,False,False,False,0,3,2020-12-28T13:50:36.907,7,,0.0
2020,16,3024,220,7,7046,2,5,5,5,5,0,5,0,5,0,False,False,False,0,3,2020-12-28T13:53:25.323,5,,0.0
2020,16,3024,225,7,7659,3,2,10,11,0,0,0,0,0,0,False,False,False,0,3,2020-12-28T14:01:19.01,0,,0.0
2020,16,3024,230,7,910,13,2,10,10,0,0,0,0,0,0,False,False,False,0,2,2020-12-28T13:57:29.827,0,,0.0
2020,16,3024,255,13,6880,13,2,9,5,0,0,0,0,0,0,False,False,False,0,2,2020-12-31T15:11:10.193,0,,0.0
2020,16,3024,260,13,2455,2,50,10,-5,12,17,12,0,12,0,False,False,False,0,3,2020-12-28T14:11:15.647,12,,0.0
2020,16,3024,265,13,876,13,2,4,10,0,0,0,0,0,0,False,False,False,0,3,2020-12-31T15:11:44.537,0,,0.0
2020,16,3024,280,7,910,2,21,2,26,33,7,28,5,28,0,False,False,False,0,2,2020-12-28T14:20:27.43,33,,5.0
2020,16,3024,285,7,931,13,11,2,22,0,0,0,0,0,0,False,False,False,0,1,2021-02-23T20:01:22.82,0,,0.0
2020,16,3024,295,7,7659,2,21,6,27,30,3,29,1,29,0,False,False,False,0,2,2020-12-28T14:27:37.953,30,,1.0
2020,16,3024,310,7,7046,13,2,9,6,0,0,0,0,0,0,False,False,False,0,3,2020-12-28T14:31:45.46,0,,0.0
2020,16,3024,325,13,6529,2,4,10,6,17,11,15,2,15,0,False,False,False,0,3,2020-12-28T14:35:43.75,17,,2.0
2020,16,3024,330,13,4733,13,19,2,25,0,0,0,0,0,0,False,False,False,0,2,2020-12-28T14:38:24.07,0,,0.0
2020,16,3024,335,13,876,2,50,9,-4,7,11,2,5,2,0,True,False,False,1,3,2020-12-31T14:23:23.753,7,,5.0
2020,16,3024,340,13,876,2,6,10,14,26,12,26,0,26,0,False,False,False,0,3,2020-12-31T14:40:18.923,26,,0.0
2020,16,3024,350,13,876,2,7,6,25,25,0,25,0,25,6,False,False,False,0,2,2021-02-23T20:01:44.757,25,,0.0
2020,16,3024,365,7,931,2,48,9,-6,-6,0,-6,0,-6,0,False,False,False,0,1,2020-12-28T14:53:01.867,-6,,0.0
2020,16,3024,370,7,7659,13,2,10,5,0,0,0,0,0,0,False,False,False,0,3,2020-12-28T14:54:45.537,0,,0.0
2020,16,3024,375,7,931,2,4,9,5,9,4,9,0,9,0,False,False,False,0,1,2020-12-28T17:47:17.657,9,,0.0
2020,16,3024,390,13,6529,2,4,5,9,11,2,10,1,10,0,False,False,False,0,3,2020-12-31T13:32:15.91,11,,1.0
2020,16,3024,395,13,6528,2,4,10,5,6,1,6,0,6,0,False,False,False,0,4,2020-12-28T15:01:54.063,6,,0.0
2020,16,3024,405,13,876,13,8,2,51,0,0,0,0,0,0,False,False,False,0,2,2020-12-28T17:47:32.55,0,,0.0
2020,16,3024,410,13,6637,13,7,6,24,0,0,0,0,0,0,False,False,False,0,3,2020-12-28T15:06:51.01,0,,0.0
2020,16,3024,435,7,931,2,45,5,-2,6,8,5,1,5,0,False,False,False,0,1,2020-12-28T15:12:19.11,6,,1.0
2020,16,3024,445,7,910,2,2,4,9,12,3,11,1,11,0,False,False,False,0,2,2020-12-28T15:15:27.217,12,,1.0
2020,16,3024,470,13,876,2,5,3,6,7,1,7,0,7,0,False,False,False,0,2,2020-12-28T15:21:58.003,7,,0.0
2020,16,3024,490,13,6528,2,53,9,-2,14,16,9,5,9,0,True,False,False,1,4,2020-12-31T14:23:37.307,14,,5.0
2020,16,3024,510,7,4341,2,50,9,0,7,7,6,1,6,0,False,False,False,0,2,2020-12-28T15:34:51.38,7,,1.0
2020,16,3024,520,7,7659,2,11,6,21,31,10,26,5,26,0,False,False,False,0,3,2020-12-28T15:39:26.503,31,,
2020,16,3024,525,7,910,2,4,5,14,14,0,14,0,14,0,False,False,False,0,2,2020-12-28T15:41:24.1,14,,0.0
2020,16,3024,530,7,4341,2,8,1,24,42,18,37,5,37,0,False,False,False,0,3,2020-12-28T15:43:50.56,42,,5.0
2020,16,3024,535,7,7659,2,9,6,20,20,0,20,0,20,6,True,False,False,0,3,2020-12-31T14:28:53.997,20,,0.0
2020,16,3024,550,13,6529,2,5,3,7,13,6,9,4,9,0,False,False,False,0,3,2020-12-31T14:40:35.517,13,,4.0
2020,16,3024,560,13,1430,13,7,9,14,0,0,0,0,0,0,False,False,False,0,4,2020-12-31T14:30:12.283,0,,0.0
2020,16,3024,565,13,2455,2,48,9,-5,-3,2,-3,0,-3,0,False,False,False,0,1,2021-02-23T20:02:27.21,-3,,0.0
2020,16,3024,580,13,6528,2,5,5,3,4,1,3,1,3,0,False,False,False,0,1,2020-12-28T16:00:28.493,4,,1.0
2020,16,3024,590,13,2455,2,2,9,2,2,0,2,0,2,6,False,False,False,0,2,2020-12-31T14:30:36.057,2,,0.0
2020,16,3024,605,7,4455,2,48,9,-4,14,18,11,3,11,0,False,False,False,0,1,2020-12-28T16:07:47.837,14,,3.0
2020,16,3024,620,7,7659,2,5,2,22,22,0,22,0,22,0,False,False,False,0,3,2020-12-28T16:16:13.917,22,,0.0
2020,16,3024,625,7,7659,13,9,2,30,0,0,0,0,0,0,False,False,False,0,2,2020-12-28T16:18:08.213,0,,0.0
2020,16,3024,635,7,3445,13,6,5,5,0,0,0,0,0,0,False,False,False,0,2,2021-02-25T17:47:17.343,0,,0.0
2020,16,3024,645,7,4341,2,5,3,2,4,2,4,0,4,0,False,False,False,0,3,2020-12-28T16:25:28.903,4,,0.0
2020,16,3024,650,7,7659,2,5,3,7,7,0,7,0,7,0,False,False,False,0,3,2020-12-28T16:27:09.073,7,,0.0
2020,16,3024,680,13,4733,13,5,5,6,0,0,0,0,0,0,False,False,False,0,3,2020-12-28T16:34:19.497,0,,
2020,16,3024,695,13,4662,2,4,9,8,29,21,9,20,9,0,False,False,False,3,3,2020-12-28T16:41:17.49,29,,20.0
2020,16,3024,705,13,6529,2,4,9,13,13,0,13,0,13,0,False,False,False,0,3,2020-12-28T16:46:08.18,13,,0.0
2020,16,3024,710,13,6529,2,44,3,-3,0,3,0,0,0,0,True,True,False,0,3,2020-12-31T14:35:05.933,0,,0.0
2020,16,3024,715,13,1430,2,12,10,10,22,12,15,7,15,6,False,False,False,2,4,2020-12-31T15:11:59.73,22,,7.0
2020,16,3024,735,7,7659,2,5,5,11,11,0,11,0,11,0,False,False,False,0,3,2020-12-28T16:54:52.63,11,,0.0
2020,16,3024,755,7,4341,2,35,9,14,20,6,18,2,18,0,False,False,False,0,3,2020-12-31T14:40:47.987,20,,2.0
2020,16,3024,765,7,4455,2,48,9,-3,4,7,-1,5,-1,0,False,False,False,1,1,2020-12-29T17:54:58.703,4,,5.0
2020,16,3024,795,13,6528,2,12,10,11,15,4,12,3,12,0,False,False,False,0,4,2020-12-28T17:10:55.747,15,,3.0
2020,16,3024,860,13,876,2,5,3,8,12,4,10,2,10,0,False,False,False,0,2,2021-02-23T20:03:46.123,12,,2.0
2020,16,3024,865,13,4733,2,4,3,11,8,-3,11,-3,11,0,False,False,False,0,2,2020-12-31T13:22:00.197,8,,-3.0
2020,16,3025,20,15,922,2,5,3,5,9,4,7,2,7,0,True,False,False,0,3,2020-12-28T11:47:20.397,9,,2.0
2020,16,3025,25,15,4886,2,45,10,-6,0,6,-1,1,-1,0,False,False,False,0,1,2020-12-28T11:50:58.377,0,,1.0
2020,16,3025,35,15,6501,2,4,8,18,18,0,18,0,18,0,False,False,False,0,2,2020-12-28T11:54:34.803,18,,0.0
2020,16,3025,55,15,4997,2,5,5,5,5,0,5,0,5,0,False,False,False,0,3,2020-12-28T12:00:57.567,5,,0.0
2020,16,3025,60,15,922,13,26,10,3,0,0,0,0,0,0,False,False,False,0,3,2020-12-28T12:02:16.557,0,,0.0
2020,16,3025,85,6,666,13,35,2,23,0,0,0,0,0,0,False,False,False,0,3,2020-12-28T12:08:26.273,0,,0.0
2020,16,3025,90,6,464,2,46,3,3,3,0,3,0,3,0,False,False,False,0,3,2020-12-28T12:11:01.76,3,,0.0
2020,16,3025,100,6,464,2,5,5,5,21,16,5,16,5,0,False,False,False,1,3,2020-12-28T12:13:17.167,21,,16.0
2020,16,3025,115,6,666,2,12,5,10,12,2,12,0,12,0,False,False,False,0,4,2021-02-25T17:50:24.61,12,,0.0
2020,16,3025,125,6,666,2,16,10,5,5,0,5,0,5,6,False,False,False,0,4,2020-12-28T12:21:16.4,5,,0.0
2020,16,3025,140,15,7591,2,44,3,-5,2,7,-4,6,-4,0,True,False,False,1,2,2020-12-28T12:23:54.437,2,,6.0
2020,16,3025,145,15,2757,2,46,3,0,4,4,1,3,1,0,False,False,False,0,4,2020-12-28T12:25:09.053,4,,3.0
2020,16,3025,150,15,6501,13,7,6,23,0,0,0,0,0,0,False,False,False,0,3,2021-01-01T00:00:34.117,0,,0.0
2020,16,3025,160,6,666,2,11,5,10,30,20,25,5,25,0,False,False,False,0,4,2021-01-01T00:03:04.51,30,,5.0
2020,16,3025,170,6,7725,3,51,9,-4,0,0,0,0,0,0,False,False,False,0,4,2020-12-28T12:38:02.24,0,,0.0
2020,16,3025,175,6,7725,2,5,5,5,12,7,10,2,10,0,False,False,False,0,3,2020-12-28T12:39:37.883,12,,2.0
2020,16,3025,185,6,7725,13,22,2,22,0,0,0,0,0,0,False,False,False,0,2,2020-12-31T22:11:53.61,0,,
2020,16,3025,210,6,464,13,9,3,2,0,0,0,0,0,0,True,False,False,0,2,2020-12-29T17:39:38.37,0,,0.0
2020,16,3025,230,15,6501,2,4,9,7,5,-2,5,0,5,0,False,False,False,0,2,2020-12-28T12:58:35.91,5,,0.0
2020,16,3025,240,15,4997,2,2,4,10,14,4,12,2,12,0,False,False,False,0,3,2020-12-28T13:02:08.423,14,,2.0
2020,16,3025,250,15,2407,2,5,3,7,10,3,10,0,10,0,False,False,False,0,3,2021-01-01T00:10:33.98,10,,0.0
2020,16,3025,260,15,4997,2,5,3,6,7,1,7,0,7,0,False,False,False,0,3,2021-01-01T00:22:15.003,7,,0.0
2020,16,3025,265,15,922,13,17,1,16,0,0,0,0,0,0,False,False,False,0,3,2020-12-28T13:09:53.66,0,,0.0
2020,16,3025,270,15,6501,2,9,6,20,20,0,20,0,20,6,False,False,False,0,2,2020-12-28T13:11:03.96,20,,0.0
2020,16,3025,295,6,464,13,4,9,10,0,0,0,0,0,0,False,False,False,0,3,2020-12-28T13:26:07.477,0,,0.0
2020,16,3025,315,15,7361,2,45,10,-1,3,4,2,1,2,0,False,False,False,0,1,2020-12-28T13:32:06.857,3,,1.0
2020,16,3025,320,15,7493,2,47,5,0,3,3,2,1,2,0,False,False,False,0,1,2020-12-28T16:12:55.103,3,,1.0
2020,16,3025,335,6,7725,13,11,6,26,0,0,0,0,0,0,True,False,False,0,3,2021-01-01T00:52:11.657,0,,0.0
2020,16,3025,340,6,7725,2,51,9,-3,13,16,11,2,11,0,False,False,False,0,3,2021-01-01T00:47:07.363,13,,2.0
2020,16,3025,355,6,7725,2,5,3,3,6,3,3,3,3,0,False,False,False,1,3,2020-12-31T23:51:37.557,6,,3.0
2020,16,3025,365,6,464,2,4,9,6,12,6,12,0,12,0,False,False,False,0,3,2020-12-28T13:47:24.527,12,,0.0
2020,16,3025,375,6,7725,13,2,4,10,0,0,0,0,0,0,False,False,False,0,3,2020-12-28T13:47:08.027,0,,0.0
2020,16,3025,380,6,464,2,5,3,9,9,0,9,0,9,0,False,False,False,0,3,2020-12-28T13:48:41.53,9,,0.0
2020,16,3025,385,6,464,2,2,9,10,12,2,11,1,11,0,False,False,False,0,3,2021-02-23T20:11:12.903,12,,1.0
2020,16,3025,395,6,7728,13,4,10,13,0,0,0,0,0,0,False,False,False,0,2,2020-12-28T13:51:52.127,0,,0.0
2020,16,3025,400,6,464,13,7,6,23,0,0,0,0,0,0,False,False,False,0,3,2020-12-28T13:54:29.037,0,,
2020,16,3025,405,6,464,13,12,5,13,0,0,0,0,0,0,False,False,False,0,3,2021-01-01T00:24:50.89,0,,0.0
2020,16,3025,410,15,7591,2,50,10,-2,6,8,4,2,4,0,False,False,False,0,2,2020-12-28T13:59:10.097,6,,2.0
2020,16,3025,415,15,6501,13,6,8,17,0,0,0,0,0,0,False,False,False,0,2,2021-03-04T20:46:03.743,0,,0.0
2020,16,3025,420,6,7728,2,17,4,5,10,5,10,0,10,0,False,False,False,0,3,2020-12-28T14:02:43.907,10,,0.0
2020,16,3025,440,6,464,2,2,4,8,12,4,9,3,9,0,False,False,False,0,3,2020-12-28T14:06:44.427,12,,3.0
2020,16,3025,445,6,6786,2,46,9,1,24,23,19,5,19,0,False,False,False,1,1,2020-12-28T14:08:22.447,24,,5.0
2020,16,3025,455,6,6786,2,44,3,-3,2,5,-2,4,-2,0,False,False,False,0,1,2020-12-28T14:10:35.387,2,,4.0
2020,16,3025,460,6,6328,13,9,2,19,0,0,0,0,0,0,False,False,False,0,3,2020-12-28T14:12:05.857,0,,0.0
2020,16,3025,465,6,464,2,2,9,4,8,4,5,3,5,0,False,False,False,0,2,2020-12-28T14:14:05.547,8,,3.0
2020,16,3025,470,6,6328,2,30,3,2,8,6,7,1,7,0,False,False,False,0,4,2021-01-01T00:26:00.013,8,,1.0
2020,16,3025,480,6,464,2,4,5,6,7,1,7,0,7,0,False,False,False,0,2,2020-12-28T14:18:01.447,7,,0.0
2020,16,3025,505,15,4886,2,46,9,-2,8,10,2,6,2,0,False,False,False,1,1,2021-01-01T00:31:01.403,8,,
2020,16,3025,515,15,4886,13,51,9,-2,0,0,0,0,0,0,False,False,False,0,3,2020-12-31T22:11:53.61,0,,0.0
2020,16,3025,520,15,4886,2,48,10,-3,6,9,5,1,5,0,False,False,False,1,1,2020-12-28T14:35:08.793,6,,1.0
2020,16,3025,530,6,7728,13,35,8,16,0,0,0,0,0,0,False,False,False,0,4,2020-12-28T16:18:17.397,0,,0.0
2020,16,3025,545,6,7728,2,4,9,6,8,2,6,2,6,0,False,False,False,0,3,2020-12-28T14:42:15.4,8,,2.0
2020,16,3025,555,6,464,2,2,9,7,13,6,9,4,9,0,False,False,False,0,2,2020-12-28T14:43:40.89,13,,4.0
2020,16,3025,585,15,7591,3,54,10,-4,0,0,0,0,0,0,True,False,False,0,4,2021-01-01T00:31:56.767,0,,0.0
2020,16,3025,590,15,4886,13,16,10,5,0,0,0,0,0,0,False,False,False,0,1,2020-12-28T14:55:42.69,0,,0.0
2020,16,3025,600,6,666,2,24,6,22,22,0,22,0,22,6,False,False,False,0,4,2020-12-28T14:59:13.553,22,,0.0
2020,16,3025,615,15,7591,13,5,3,10,0,0,0,0,0,0,False,False,False,0,3,2020-12-28T15:01:29.477,0,,0.0
2020,16,3025,620,15,922,2,39,4,5,8,3,6,2,6,0,False,False,False,0,4,2020-12-28T15:02:43.12,8,,2.0
2020,16,3025,635,6,6328,2,30,5,1,2,1,2,0,2,0,False,False,False,0,3,2020-12-28T15:06:17.457,2,,0.0
2020,16,3025,640,6,7725,2,51,9,-6,8,14,3,5,3,0,True,False,False,1,3,2020-12-28T15:07:46.203,8,,5.0
2020,16,3025,650,6,7728,13,11,6,30,0,0,0,0,0,0,False,False,False,0,4,2020-12-28T15:09:55.377,0,,0.0
2020,16,3025,660,6,464,2,2,9,5,6,1,6,0,6,0,False,False,False,0,2,2020-12-28T15:12:00.117,6,,0.0
2020,16,3025,700,15,4886,2,45,10,-3,1,4,0,1,0,0,False,False,False,0,1,2020-12-28T15:32:40.87,1,,1.0
2020,16,3025,705,15,2757,2,5,3,9,14,5,11,3,11,0,False,False,False,0,3,2020-12-28T15:34:21.923,14,,3.0
2020,16,3025,710,15,2757,13,5,10,4,0,0,0,0,0,0,False,False,False,0,4,2020-12-28T16:18:54.953,0,,0.0
2020,16,3025,715,15,7591,2,13,10,2,3,1,2,1,2,0,False,False,False,1,3,2021-03-03T19:08:05.143,3,,1.0
2020,16,3025,720,15,4997,13,26,3,4,0,0,0,0,0,0,False,False,False,0,3,2021-01-01T00:48:28.463,0,,0.0
2020,16,3025,755,15,4997,13,7,6,16,0,0,0,0,0,0,False,False,False,0,2,2020-12-31T21:43:35.223,0,,0.0
2020,16,3025,760,15,6501,2,9,2,18,19,1,19,0,19,0,False,False,False,0,2,2020-12-28T15:46:53.657,19,,0.0
2020,16,3025,765,15,922,13,39,4,7,0,0,0,0,0,0,False,False,False,0,4,2020-12-28T15:49:12.91,0,,0.0
2020,16,3025,770,15,2407,2,2,5,5,8,3,7,1,7,0,False,False,False,0,2,2020-12-28T15:50:23.85,8,,1.0
2020,16,3025,775,15,7591,2,8,8,34,34,0,34,0,34,6,False,False,False,0,2,2020-12-28T15:52:10.817,34,,0.0
2020,16,3025,800,6,7728,13,5,10,6,0,0,0,0,0,0,False,False,False,0,3,2020-12-28T15:59:47.013,0,,0.0
2020,16,3025,810,15,2407,2,2,5,6,9,3,8,1,8,0,False,False,False,0,2,2020-12-28T16:03:52.1,9,,1.0
2020,16,3025,835,15,7591,2,50,5,-2,3,5,1,2,1,0,False,False,False,0,2,2020-12-28T16:09:26.077,3,,2.0
2020,16,3026,10,2,990,2,12,2,20,26,6,26,0,26,0,False,False,False,0,1,2020-12-28T11:21:15.63,26,,0.0
2020,16,3026,20,2,6247,2,50,9,-2,-1,1,-2,1,-2,0,True,False,False,0,2,2020-12-28T11:29:17.28,-1,,1.0
2020,16,3026,25,2,6342,13,13,9,4,0,0,0,0,0,0,True,False,False,0,3,2020-12-28T11:40:33.47,0,,0.0
2020,16,3026,40,16,3938,2,55,4,-4,15,19,15,0,15,0,False,False,False,0,4,2021-01-01T03:22:33.267,15,,0.0
2020,16,3026,55,16,3938,2,30,3,-2,6,8,6,0,6,0,False,False,False,0,4,2020-12-28T11:56:59.727,6,,0.0
2020,16,3026,60,16,374,2,50,3,1,10,9,6,4,6,0,False,False,False,0,2,2020-12-28T11:58:22.037,10,,4.0
2020,16,3026,65,16,3938,13,22,2,40,0,0,0,0,0,0,False,False,False,0,3,2020-12-28T12:01:41.07,0,,0.0
2020,16,3026,70,16,34,13,12,6,16,0,0,0,0,0,0,True,False,False,0,1,2020-12-29T19:12:52.587,0,,0.0
2020,16,3026,75,16,374,13,4,9,11,0,0,0,0,0,0,False,False,False,0,3,2020-12-28T12:03:29.743,0,,0.0
2020,16,3026,105,2,6247,2,47,5,3,3,0,3,0,3,0,True,False,False,0,3,2020-12-28T12:12:06.71,3,,0.0
2020,16,3026,110,2,5214,2,5,5,5,8,3,6,2,6,0,False,False,False,0,4,2020-12-28T12:14:30.357,8,,
2020,16,3026,115,2,5214,2,36,8,15,15,0,15,0,15,0,False,False,False,0,3,2021-01-01T01:43:12.193,15,,0.0
2020,16,3026,145,16,3938,2,5,5,4,31,27,7,24,7,0,False,False,False,1,3,2020-12-28T12:38:07.14,31,,24.0
2020,16,3026,160,16,374,13,4,3,8,0,0,0,0,0,0,False,False,False,0,3,2020-12-28T12:44:04,0,,0.0
2020,16,3026,180,2,2835,2,47,5,4,7,3,5,2,5,0,True,False,False,0,4,2020-12-28T12:48:31.793,7,,2.0
2020,16,3026,190,2,5223,13,19,6,28,0,0,0,0,0,0,False,False,False,0,2,2020-12-28T12:51:04.743,0,,0.0
2020,16,3026,205,16,6499,2,28,5,-4,5,9,5,0,5,0,False,False,False,0,1,2020-12-28T12:53:44.133,5,,0.0
2020,16,3026,210,16,7176,13,35,2,16,0,0,0,0,0,0,False,False,False,0,3,2020-12-30T17:56:24.547,0,,0.0
2020,16,3026,215,16,7176,2,26,9,2,4,2,4,0,4,0,True,False,False,0,3,2020-12-29T19:13:08.85,4,,0.0
2020,16,3026,230,16,374,13,12,10,7,0,0,0,0,0,0,False,False,False,0,4,2021-01-01T03:23:49.353,0,,0.0
2020,16,3026,235,16,6499,2,48,4,-5,13,18,9,4,9,0,False,False,False,0,1,2020-12-28T13:05:59.81,13,,4.0
2020,16,3026,245,16,5048,13,11,6,24,0,0,0,0,0,0,False,False,False,0,1,2021-03-04T20:49:11.617,0,,0.0
2020,16,3026,255,2,2835,2,47,5,3,7,4,3,4,3,0,True,False,False,1,4,2020-12-28T13:13:10.927,7,,4.0
2020,16,3026,260,2,6472,2,46,9,-2,5,7,2,3,2,0,False,True,False,0,1,2020-12-28T13:14:23.893,5,,3.0
2020,16,3026,270,2,990,2,47,5,5,8,3,3,5,3,0,False,False,False,0,1,2020-12-28T13:17:55.077,8,,5.0
2020,16,3026,280,2,5223,2,2,9,12,54,42,13,41,13,0,False,False,False,1,3,2020-12-28T16:02:01.457,54,,41.0
2020,16,3026,290,2,5214,2,55,9,-3,5,8,4,1,4,6,False,False,False,0,4,2021-01-01T03:16:20.417,5,,1.0
2020,16,3026,305,16,34,2,48,10,-5,9,14,4,5,4,0,False,False,False,0,1,2021-01-01T03:24:48.747,9,,5.0
2020,16,3026,310,16,121,2,4,10,5,9,4,5,4,5,0,False,False,False,0,3,2020-12-28T13:32:17.173,9,,4.0
2020,16,3026,315,16,121,2,5,3,5,5,0,5,0,5,0,True,False,False,0,2,2020-12-30T17:57:32.64,5,,0.0
2020,16,3026,325,16,374,2,4,9,6,11,5,8,3,8,0,False,False,False,0,3,2020-12-28T13:34:50.687,11,,3.0
2020,16,3026,335,16,7176,13,5,5,13,0,0,0,0,0,0,False,False,False,0,3,2020-12-28T13:37:10.18,0,,0.0
2020,16,3026,350,16,374,2,26,10,0,2,2,2,0,2,0,False,False,False,1,3,2020-12-28T13:39:36.253,2,,0.0
2020,16,3026,365,16,6499,2,47,5,0,9,9,6,3,6,0,False,False,False,0,1,2020-12-28T13:42:20.257,9,,3.0
2020,16,3026,380,16,374,2,4,10,4,4,0,4,0,4,6,False,False,False,0,3,2020-12-28T13:46:00.903,4,,0.0
2020,16,3026,425,16,374,13,12,1,16,0,0,0,0,0,0,False,False,False,0,3,2020-12-28T13:51:30.877,0,,0.0
2020,16,3026,430,16,7176,2,5,3,7,11,4,10,1,10,0,False,False,False,0,2,2020-12-28T13:52:50.99,11,,1.0
2020,16,3026,435,16,6565,2,4,9,4,12,8,8,4,8,0,False,False,False,1,3,2020-12-30T17:50:14.857,12,,4.0
2020,16,3026,450,16,374,13,20,3,7,0,0,0,0,0,0,False,False,False,0,2,2020-12-30T17:55:28.293,0,,0.0
2020,16,3026,455,16,34,13,48,3,-7,0,0,0,0,0,0,False,False,False,0,1,2021-04-01T19:43:17.087,0,,0.0
2020,16,3026,460,16,374,13,8,9,6,0,0,0,0,0,0,False,False,False,0,3,2021-03-04T20:51:19.85,0,,0.0
2020,16,3026,475,2,5214,2,5,5,5,7,2,6,1,6,0,False,False,False,0,3,2020-12-28T14:11:07.053,7,,1.0
2020,16,3026,485,16,3938,2,4,10,10,13,3,13,0,13,0,False,False,False,0,2,2020-12-28T14:13:26.733,13,,0.0
2020,16,3026,490,16,6499,3,12,5,5,0,0,0,0,0,0,False,False,False,0,1,2020-12-28T14:14:24.063,0,,0.0
2020,16,3026,500,16,6499,13,28,4,5,0,0,0,0,0,0,False,False,False,0,1,2021-03-09T14:36:36.717,0,,0.0
2020,16,3026,540,2,5214,13,5,3,11,0,0,0,0,0,0,False,False,False,0,3,2020-12-28T14:24:55.687,0,,
2020,16,3026,545,2,5214,2,32,3,2,3,1,2,1,2,0,True,False,False,0,4,2020-12-29T17:29:04.387,3,,1.0
2020,16,3026,555,2,5214,13,13,9,5,0,0,0,0,0,0,False,False,False,0,3,2021-03-08T15:50:23.377,0,,0.0
2020,16,3026,560,2,990,2,6,4,2,0,-2,0,0,0,0,False,False,False,0,1,2020-12-28T14:33:54.363,0,,0.0
2020,16,3026,575,16,121,13,4,10,5,0,0,0,0,0,0,False,False,False,0,3,2021-02-23T20:41:24.3,0,,0.0
2020,16,3026,585,16,374,2,12,1,28,26,-2,26,0,26,0,True,False,False,0,3,2020-12-28T14:42:31.807,26,,0.0
2020,16,3026,600,16,121,13,4,10,4,0,0,0,0,0,0,False,False,False,0,3,2020-12-28T14:45:48.357,0,,0.0
2020,16,3026,605,16,6499,2,48,9,-6,0,6,-3,3,-3,0,False,False,False,0,1,2021-01-01T03:17:03.273,0,,3.0
2020,16,3026,620,2,5223,2,30,5,5,15,10,15,0,15,0,True,False,False,0,4,2020-12-28T14:49:00.917,15,,0.0
2020,16,3026,625,2,5214,2,6,8,18,17,-1,17,0,17,0,False,False,False,0,4,2020-12-28T14:51:11.637,17,,0.0
2020,16,3026,635,2,4179,2,4,10,5,6,1,6,0,6,0,False,False,False,0,3,2020-12-28T14:53:56.237,6,,0.0
2020,16,3026,640,2,2223,2,31,10,2,9,7,8,1,8,0,False,False,False,0,4,2021-03-04T18:42:03.847,9,,1.0
2020,16,3026,645,2,4670,2,4,4,4,6,2,4,2,4,0,False,False,False,0,1,2020-12-28T14:57:31.067,6,,2.0
2020,16,3026,650,2,6342,2,44,3,1,2,1,2,0,2,0,True,True,True,0,3,2020-12-29T17:29:42.94,2,,0.0
2020,16,3026,665,16,4143,2,4,3,4,4,0,4,0,4,0,False,False,False,0,2,2020-12-28T15:05:27.143,4,,0.0
2020,16,3026,685,2,5223,2,6,7,19,31,12,31,0,31,0,False,False,False,0,3,2020-12-28T15:13:17.637,31,,0.0
2020,16,3026,700,2,4670,2,45,5,-5,2,7,-1,3,-1,0,False,False,False,0,1,2020-12-28T15:15:27.473,2,,3.0
2020,16,3026,705,2,6247,2,5,3,4,9,5,7,2,7,0,True,False,False,0,3,2020-12-28T15:17:27.17,9,,2.0
2020,16,3026,710,2,4670,2,47,10,3,17,14,17,0,17,0,False,False,False,0,1,2020-12-28T15:18:37.247,17,,0.0
2020,16,3026,715,2,5223,13,9,3,5,0,0,0,0,0,0,False,False,False,0,2,2021-02-23T20:42:36.177,0,,0.0
2020,16,3026,720,2,4179,2,4,9,5,5,0,5,0,5,6,False,False,False,0,3,2020-12-28T15:21:28.95,5,,0.0
2020,16,3026,740,16,7176,3,12,3,4,0,0,0,0,0,0,True,False,False,0,2,2021-03-09T14:41:41.09,0,,0.0
2020,16,3026,745,16,374,2,4,9,12,36,24,15,21,15,0,False,False,False,1,3,2021-01-01T03:17:32.283,29,,21.0
2020,16,3026,755,16,374,2,2,9,6,16,10,7,9,7,0,False,False,False,0,2,2020-12-28T15:35:03.87,16,,9.0
2020,16,3026,760,16,7176,2,4,3,7,9,2,8,1,8,0,False,False,False,0,2,2020-12-28T15:36:37.093,9,,1.0
2020,16,3026,770,16,3938,13,19,2,25,0,0,0,0,0,0,False,False,False,0,2,2020-12-28T15:39:01.957,0,,0.0
2020,16,3026,775,16,4143,2,23,7,25,25,0,25,0,25,6,False,False,False,0,2,2020-12-28T15:41:20.163,25,,0.0
2020,16,3026,790,2,5214,13,6,10,12,0,0,0,0,0,0,False,False,False,0,4,2020-12-28T15:43:22.977,0,,
2020,16,3026,795,2,6247,2,13,10,3,12,9,8,4,8,0,True,False,False,0,3,2021-01-01T03:17:14.79,12,,4.0
2020,16,3026,800,2,5223,2,7,2,20,21,1,21,0,21,0,False,False,False,0,3,2021-01-01T01:43:12.193,21,,0.0
2020,16,3026,805,2,5223,2,2,9,7,9,2,9,0,9,0,False,False,False,0,2,2020-12-28T15:47:40.317,9,,0.0
2020,16,3026,810,2,5223,13,7,6,28,0,0,0,0,0,0,False,False,False,0,3,2020-12-28T15:49:36.25,0,,0.0
2020,16,3026,820,2,5223,13,9,2,26,0,0,0,0,0,0,False,False,False,0,2,2020-12-28T15:52:26.147,0,,
2020,16,3026,825,2,6247,13,13,10,4,0,0,0,0,0,0,True,False,False,0,3,2020-12-28T15:53:55.61,0,,0.0
2020,16,3026,830,2,5223,13,20,2,21,0,0,0,0,0,0,False,False,False,0,2,2021-01-01T01:43:12.193,0,,0.0
2020,16,3026,835,2,5223,13,35,6,17,0,0,0,0,0,0,False,False,False,0,3,2020-12-28T15:57:53.6,0,,0.0
2020,16,3027,10,25,7060,13,2,10,7,0,0,0,0,0,0,False,False,False,0,2,2020-12-28T11:32:55.267,0,,0.0
2020,16,3027,15,25,4583,13,2,4,8,0,0,0,0,0,0,False,False,False,0,2,2020-12-28T11:34:36.69,0,,0.0
2020,16,3027,20,25,7060,3,13,10,3,0,0,0,0,0,0,False,False,False,0,2,2020-12-28T11:36:51.113,0,,0.0
2020,16,3027,40,14,7584,2,13,9,4,26,22,16,10,16,0,False,False,False,1,3,2020-12-28T11:43:38.68,26,,10.0
2020,16,3027,50,14,4449,2,13,9,4,16,12,15,1,15,0,False,False,False,0,3,2020-12-29T19:03:48.097,16,,1.0
2020,16,3027,65,14,1119,13,7,5,6,0,0,0,0,0,0,False,False,False,0,4,2021-02-25T17:56:50.81,0,,0.0
2020,16,3027,90,25,7060,2,4,5,6,7,1,7,0,7,0,False,False,False,0,2,2021-01-01T04:43:24.067,7,,0.0
2020,16,3027,95,25,7060,2,52,9,1,9,8,6,3,6,0,False,False,False,0,3,2021-01-01T05:32:35.93,9,,3.0
2020,16,3027,100,25,7060,2,5,5,8,7,-1,7,0,7,0,False,False,False,0,3,2021-01-01T05:41:56.973,7,,0.0
2020,16,3027,135,14,895,2,13,4,2,5,3,4,1,4,0,False,False,False,0,4,2020-12-28T12:09:41.49,5,,1.0
2020,16,3027,145,14,1114,13,7,2,23,0,0,0,0,0,0,False,False,False,0,3,2020-12-28T12:12:05,0,,0.0
2020,16,3027,165,25,609,2,39,4,6,11,5,9,2,9,0,False,False,False,0,4,2020-12-28T12:16:36.12,11,,2.0
2020,16,3027,190,25,7060,13,2,9,2,0,0,0,0,0,0,False,False,False,0,2,2020-12-28T12:22:39.913,0,,0.0
2020,16,3027,195,25,4583,3,17,9,2,0,0,0,0,0,0,False,False,False,0,3,2020-12-28T12:25:06.157,0,,
2020,16,3027,220,14,1119,2,7,2,16,17,1,16,1,16,0,True,False,False,0,4,2020-12-29T19:04:09.847,17,,1.0
2020,16,3027,225,14,1114,2,5,6,17,25,8,25,0,25,0,False,False,False,0,2,2020-12-28T12:32:37.353,25,,0.0
2020,16,3027,230,14,7584,13,8,1,41,0,0,0,0,0,0,False,False,False,0,3,2020-12-28T12:34:20.887,0,,0.0
2020,16,3027,235,14,1114,2,2,9,8,14,6,11,3,11,0,False,False,False,0,2,2020-12-28T12:35:29.057,14,,3.0
2020,16,3027,255,14,1119,2,4,9,8,8,0,8,0,8,0,False,False,False,0,4,2020-12-28T12:39:34.783,8,,0.0
2020,16,3027,285,25,609,13,35,7,15,0,0,0,0,0,0,False,False,False,0,4,2020-12-28T12:45:52.04,0,,0.0
2020,16,3027,295,25,7060,2,52,9,-1,-1,0,-1,0,-1,0,False,False,False,0,2,2020-12-28T12:48:02.673,-1,,0.0
2020,16,3027,310,14,4449,2,23,1,42,42,0,42,0,42,6,False,False,False,0,3,2020-12-28T12:52:10.503,42,,0.0
2020,16,3027,325,25,7060,2,4,10,6,5,-1,5,0,5,0,False,False,False,0,3,2020-12-28T12:56:14.323,5,,0.0
2020,16,3027,330,25,4583,2,46,3,2,5,3,3,2,3,0,False,False,False,0,3,2021-01-01T05:35:16.81,5,,2.0
2020,16,3027,335,25,4583,2,2,10,5,8,3,5,3,5,0,False,False,False,0,3,2020-12-28T12:59:08.327,8,,3.0
2020,16,3027,340,25,4587,2,28,10,-2,10,12,7,3,7,0,False,False,False,1,1,2020-12-28T13:00:41.847,10,,3.0
2020,16,3027,345,25,4583,13,4,9,5,0,0,0,0,0,0,False,False,False,0,3,2020-12-28T13:01:51.597,0,,0.0
2020,16,3027,350,25,4583,13,4,4,7,0,0,0,0,0,0,False,False,False,0,3,2020-12-28T13:02:59.677,0,,0.0
2020,16,3027,360,25,7060,13,29,2,25,0,0,0,0,0,0,False,False,False,0,2,2020-12-28T13:04:19.693,0,,0.0
2020,16,3027,375,14,6543,2,48,9,-5,68,73,61,7,61,0,False,False,False,2,1,2021-01-01T04:11:46.007,68,,
2020,16,3027,405,25,7060,13,8,2,39,0,0,0,0,0,0,False,False,False,0,2,2020-12-30T22:13:52.01,0,,0.0
2020,16,3027,410,25,4583,2,35,8,17,17,0,17,0,17,0,False,False,False,0,3,2020-12-30T22:14:03.147,17,,0.0
2020,16,3027,420,25,4583,2,17,7,18,22,4,22,0,22,0,False,True,False,0,3,2021-01-01T04:16:12.397,20,,0.0
2020,16,3027,440,14,5197,2,32,10,3,20,17,17,3,17,0,False,False,False,0,4,2020-12-28T13:30:22.05,20,,3.0
2020,16,3027,455,14,7584,2,6,9,5,8,3,5,3,5,0,False,False,False,1,2,2020-12-28T13:34:14.14,8,,3.0
2020,16,3027,465,14,4449,13,47,10,3,0,0,0,0,0,0,False,False,False,0,4,2020-12-28T13:37:01.257,0,,0.0
2020,16,3027,495,25,7666,2,4,5,5,8,3,7,1,7,0,False,False,False,0,2,2020-12-28T13:48:03.473,8,,1.0
2020,16,3027,505,25,609,2,35,5,11,11,0,11,0,11,0,False,False,False,0,4,2020-12-28T13:50:18.493,11,,0.0
2020,16,3027,510,25,7666,2,4,5,10,11,1,11,0,11,0,False,False,False,0,2,2020-12-28T13:51:32.343,11,,0.0
2020,16,3027,515,25,7666,2,8,8,23,34,11,29,5,29,0,False,False,False,0,2,2020-12-28T13:52:53.167,34,,5.0
2020,16,3027,520,25,609,2,4,4,5,10,5,7,3,7,0,False,False,False,0,4,2020-12-28T13:53:52.86,10,,3.0
2020,16,3027,525,25,6486,13,6,9,4,0,0,0,0,0,0,False,False,False,0,2,2020-12-28T13:55:16.37,0,,
2020,16,3027,535,25,609,13,2,10,2,0,0,0,0,0,0,False,False,False,0,3,2020-12-28T13:57:56.17,0,,0.0
2020,16,3027,540,25,7666,13,49,9,0,0,0,0,0,0,0,True,False,False,0,2,2021-03-04T16:10:29.75,0,,0.0
2020,16,3027,545,25,6486,13,5,5,2,0,0,0,0,0,0,True,False,False,0,3,2020-12-28T14:01:37.433,0,,0.0
2020,16,3027,560,14,1114,13,19,6,28,0,0,0,0,0,0,False,False,False,0,2,2020-12-28T14:03:42.27,0,,0.0
2020,16,3027,565,14,4449,2,50,9,-1,6,7,5,1,5,0,False,False,False,0,3,2021-03-04T16:11:33.057,6,,1.0
2020,16,3027,575,25,7060,2,19,2,38,39,1,39,0,39,6,False,False,False,0,2,2020-12-28T14:08:41.967,39,,0.0
2020,16,3027,595,14,4449,13,5,3,5,0,0,0,0,0,0,False,False,False,0,3,2020-12-28T14:12:27.093,0,,0.0
2020,16,3027,600,14,895,2,32,5,4,11,7,11,0,11,0,True,False,False,0,4,2020-12-29T19:04:23.403,11,,0.0
2020,16,3027,610,25,4583,13,5,5,9,0,0,0,0,0,0,False,False,False,0,2,2020-12-28T14:15:41.793,0,,0.0
2020,16,3027,615,25,7060,13,7,2,24,0,0,0,0,0,0,False,False,False,0,3,2020-12-28T22:52:59.663,0,,
2020,16,3027,620,25,6486,2,3,3,13,13,0,13,0,13,0,False,False,False,0,2,2020-12-28T14:19:20.583,13,,0.0
2020,16,3027,625,25,4587,2,48,9,-3,10,13,6,4,6,0,False,False,False,0,1,2021-01-01T05:33:34.133,10,,4.0
2020,16,3027,630,25,7666,2,6,10,3,1,-2,0,1,0,0,False,False,False,0,2,2020-12-28T14:22:21.69,1,,1.0
2020,16,3027,640,25,7060,13,19,8,24,0,0,0,0,0,0,False,False,False,0,2,2021-01-01T04:43:24.067,0,,
2020,16,3027,645,25,609,2,51,9,0,5,5,3,2,3,6,True,False,False,0,4,2020-12-28T14:28:35.91,5,,2.0
2020,16,3027,660,14,7584,13,4,10,4,0,0,0,0,0,0,False,False,False,0,3,2020-12-28T14:30:52.333,0,,0.0
2020,16,3027,665,14,1119,2,5,2,15,18,3,17,1,17,0,False,False,False,0,4,2020-12-28T14:32:10.3,18,,1.0
2020,16,3027,675,14,7584,2,4,9,3,4,1,4,0,4,0,False,False,False,0,2,2020-12-28T14:34:54.02,4,,0.0
2020,16,3027,690,25,7060,2,6,9,3,7,4,7,0,7,0,False,False,False,0,2,2021-01-01T04:23:37.283,7,,0.0
2020,16,3027,700,25,609,2,13,9,3,10,7,7,3,7,0,False,False,False,0,4,2020-12-28T14:39:38.817,10,,3.0
2020,16,3027,705,25,6486,2,4,5,7,7,0,7,0,7,0,False,False,False,0,2,2020-12-28T14:40:41.697,7,,0.0
2020,16,3027,715,25,7060,13,29,2,19,0,0,0,0,0,0,False,False,False,0,2,2020-12-28T14:42:49.92,0,,0.0
2020,16,3027,725,25,4587,2,48,9,0,10,10,9,1,9,0,False,False,False,0,1,2020-12-28T14:44:49.207,10,,1.0
2020,16,3027,730,25,4587,2,44,3,-4,9,13,6,3,6,0,False,False,False,0,1,2020-12-28T14:46:04.257,9,,3.0
2020,16,3027,735,25,7666,13,5,5,12,0,0,0,0,0,0,False,False,False,0,3,2021-01-01T04:43:24.067,0,,0.0
2020,16,3027,740,25,7666,13,29,2,23,0,0,0,0,0,0,False,False,False,0,2,2020-12-28T14:50:10.25,0,,
2020,16,3027,745,25,4583,2,35,7,25,25,0,25,0,25,6,False,False,False,0,3,2020-12-28T14:51:50.847,25,,0.0
2020,16,3027,760,14,1119,2,4,9,6,7,1,7,0,7,0,False,False,False,0,3,2020-12-28T14:53:48.55,7,,0.0
2020,16,3027,770,14,7584,13,8,7,41,0,0,0,0,0,0,False,False,False,0,3,2021-03-04T20:59:39.76,0,,0.0
2020,16,3027,775,25,181,2,39,4,5,5,0,5,0,5,0,False,False,False,0,3,2020-12-28T14:58:20.447,5,,0.0
2020,16,3027,780,25,4583,2,13,10,4,8,4,7,1,7,0,False,False,False,0,3,2020-12-28T15:00:01.557,8,,1.0
2020,16,3027,785,25,4583,2,49,9,-2,6,8,5,1,5,0,False,False,False,0,3,2020-12-28T15:01:08.827,6,,1.0
2020,16,3027,790,25,4583,2,49,3,-2,3,5,3,0,3,0,False,False,False,0,2,2020-12-28T15:02:06.78,3,,0.0
2020,16,3027,795,25,4583,2,49,10,1,4,3,4,0,4,0,False,False,False,0,2,2021-01-01T05:33:10.09,4,,0.0
2020,16,3027,810,25,4587,2,50,10,-2,6,8,5,1,5,0,False,False,False,0,3,2021-01-01T05:38:03.013,6,,1.0
2020,16,3027,820,25,7060,2,51,5,0,1,1,1,0,1,0,True,False,False,0,3,2021-01-01T05:43:53.523,1,,0.0
2020,16,3027,830,14,6543,2,32,9,-2,11,13,9,2,9,0,False,False,False,0,1,2020-12-28T15:26:59.39,11,,2.0
2020,16,3027,835,14,6543,2,28,9,-1,5,6,-1,6,-1,0,False,False,False,1,1,2020-12-28T15:27:09.527,5,,6.0
2020,16,3027,840,14,6543,2,32,9,-6,0,6,-2,2,-2,0,False,False,False,0,1,2020-12-28T15:26:34.397,0,,2.0
2020,16,3027,850,14,895,3,7,6,15,0,0,0,0,0,0,False,False,False,0,3,2020-12-28T15:12:57.317,0,,0.0
2020,16,3027,855,14,1114,13,7,3,13,0,0,0,0,0,0,False,False,False,0,2,2021-03-04T21:55:13.313,0,,
2020,16,3027,860,14,6543,2,32,9,-2,4,6,4,0,4,0,False,False,False,0,1,2020-12-28T15:27:23.477,4,,0.0
2020,16,3027,865,14,1119,13,4,9,12,0,0,0,0,0,0,False,False,False,0,3,2020-12-28T15:17:13.913,0,,0.0
2020,16,3027,870,14,1114,2,5,3,11,21,10,21,0,21,0,False,False,False,0,2,2020-12-28T15:18:11.52,21,,0.0
2020,16,3027,875,14,895,2,46,3,2,2,0,2,0,2,0,False,False,False,0,3,2020-12-28T15:19:14.953,2,,0.0
2020,16,3027,880,14,1114,13,4,6,15,0,0,0,0,0,0,False,False,False,0,2,2021-01-01T04:43:24.067,0,,0.0
2020,16,3027,885,14,1114,13,17,7,33,0,0,0,0,0,0,False,False,False,0,3,2020-12-28T15:22:04.03,0,,0.0
2020,16,3027,890,14,4449,13,4,8,18,0,0,0,0,0,0,False,False,False,0,3,2021-01-01T05:44:16.443,0,,0.0
2020,16,3028,15,32,6430,13,7,2,43,0,0,0,0,0,0,False,False,False,0,3,2020-12-28T12:14:53.313,0,,0.0
2020,16,3028,20,32,1427,3,5,3,14,0,0,0,0,0,0,False,False,False,0,3,2020-12-31T20:29:25.32,0,,0.0
2020,16,3028,30,5,5220,2,4,3,9,9,0,9,0,9,0,False,False,False,0,2,2020-12-28T12:23:49.843,9,,0.0
2020,16,3028,45,5,3477,2,2,4,6,8,2,6,2,6,0,False,False,False,0,3,2020-12-28T12:29:39.417,8,,2.0
2020,16,3028,55,5,3477,13,5,3,6,0,0,0,0,0,0,False,False,False,0,3,2020-12-28T12:32:46.67,0,,0.0
2020,16,3028,60,5,3477,2,51,9,-2,1,3,1,0,1,0,False,False,False,0,3,2020-12-31T18:15:41.87,1,,0.0
2020,16,3028,100,5,5220,13,12,5,9,0,0,0,0,0,0,False,False,False,0,3,2021-02-25T18:44:00.54,0,,0.0
2020,16,3028,105,5,3477,13,4,10,14,0,0,0,0,0,0,False,False,False,0,2,2020-12-31T19:09:56.713,0,,0.0
2020,16,3028,130,32,6318,13,19,6,23,0,0,0,0,0,0,False,False,False,0,2,2020-12-28T13:08:55.833,0,,0.0
2020,16,3028,135,32,6430,13,6,1,17,0,0,0,0,0,0,False,False,False,0,2,2020-12-28T13:12:19.833,0,,0.0
2020,16,3028,150,5,4803,2,5,9,7,16,9,14,2,14,0,False,False,False,0,3,2020-12-31T18:17:23.11,16,,2.0
2020,16,3028,160,5,3477,2,51,9,-2,-1,1,-1,0,-1,0,False,False,False,0,3,2021-02-23T16:57:58.923,-1,,0.0
2020,16,3028,165,5,3477,13,6,1,18,0,0,0,0,0,0,False,False,False,0,2,2020-12-31T18:19:16.523,0,,0.0
2020,16,3028,180,32,1427,2,32,5,1,5,4,3,2,3,0,False,False,False,0,4,2020-12-28T13:39:21.247,5,,2.0
2020,16,3028,270,32,7807,2,51,10,-6,-2,4,-3,1,-3,0,False,False,False,0,1,2020-12-28T14:13:44.573,-2,,1.0
2020,16,3028,275,32,3885,2,32,10,1,4,3,2,2,2,0,False,False,False,0,3,2020-12-31T20:58:30.233,4,,2.0
2020,16,3028,280,32,7494,2,12,6,17,17,0,17,0,17,0,False,False,False,0,3,2021-02-25T18:45:11.067,17,,0.0
2020,16,3028,285,32,1427,13,5,10,11,0,0,0,0,0,0,True,False,False,0,4,2021-03-04T21:53:42.62,0,,0.0
2020,16,3028,290,5,3477,2,49,10,0,1,1,0,1,0,0,False,False,False,0,3,2021-02-23T16:58:59.833,1,,1.0
2020,16,3028,300,5,4803,2,8,7,40,44,4,41,3,41,0,False,False,False,0,3,2020-12-28T14:26:32.897,44,,3.0
2020,16,3028,310,5,5220,2,50,3,0,0,0,-1,1,-1,0,False,False,False,0,2,2020-12-28T14:28:46.483,0,,1.0
2020,16,3028,320,5,3477,2,13,4,5,14,9,14,0,14,6,False,False,False,1,3,2020-12-28T14:32:28.54,14,,0.0
2020,16,3028,340,32,7807,13,16,10,2,0,0,0,0,0,0,False,False,False,0,6,2020-12-28T14:38:36.853,0,,0.0
2020,16,3028,355,32,3885,2,28,9,0,12,12,12,0,12,0,False,False,False,1,1,2020-12-31T22:19:36.183,12,,0.0
2020,16,3028,370,32,3885,2,44,3,-1,0,1,0,0,0,0,False,False,False,0,1,2020-12-28T14:46:30.213,0,,0.0
2020,16,3028,380,32,6430,3,12,6,17,0,0,0,0,0,0,False,False,False,0,2,2021-03-09T14:53:28.337,0,,0.0
2020,16,3028,395,5,3477,2,6,9,14,13,-1,13,0,13,0,False,False,False,0,2,2021-03-15T19:52:31.133,13,,0.0
2020,16,3028,400,5,5220,2,4,9,10,10,0,10,0,10,0,False,False,False,0,2,2020-12-28T14:55:16.52,10,,0.0
2020,16,3028,405,5,5220,13,19,7,35,0,0,0,0,0,0,False,False,False,0,2,2020-12-28T18:35:51.4,0,,0.0
2020,16,3028,410,5,3389,13,6,8,17,0,0,0,0,0,0,False,False,False,0,2,2020-12-28T15:01:54.09,0,,0.0
2020,16,3028,415,5,8195,2,5,5,2,12,10,4,8,4,0,False,False,False,1,1,2020-12-31T18:22:37.983,12,,8.0
2020,16,3028,425,32,7808,13,3,5,13,0,0,0,0,0,0,False,False,False,0,2,2020-12-31T19:36:20.147,0,,0.0
2020,16,3028,430,32,7494,13,5,2,23,0,0,0,0,0,0,False,False,False,0,3,2021-03-04T21:11:59.97,0,,0.0
2020,16,3028,470,5,4803,2,5,10,6,14,8,12,2,12,0,False,False,False,0,3,2020-12-31T21:15:56.037,14,,2.0
2020,16,3028,495,5,5220,13,29,2,19,0,0,0,0,0,0,False,False,False,0,2,2021-03-15T19:52:44.143,0,,0.0
2020,16,3028,500,5,5220,2,6,10,14,14,0,14,0,14,0,False,False,False,0,3,2020-12-28T15:40:25.453,14,,0.0
2020,16,3028,515,32,6430,13,4,9,12,0,0,0,0,0,0,False,False,False,0,2,2020-12-28T15:45:43.267,0,,0.0
2020,16,3028,520,32,3885,2,4,9,3,8,5,5,3,5,0,True,False,False,0,2,2020-12-28T15:47:50.38,8,,3.0
2020,16,3028,525,32,6430,2,12,5,11,50,39,46,4,46,0,False,False,False,1,3,2021-02-25T18:46:07.6,50,,4.0
2020,16,3028,535,32,3885,2,6,10,2,14,12,14,0,14,0,False,False,False,0,1,2020-12-31T18:54:25.46,14,,0.0
2020,16,3028,540,32,3885,13,47,5,0,0,0,0,0,0,0,False,False,False,0,1,2020-12-28T15:57:01.623,0,,0.0
2020,16,3028,560,5,4803,2,5,10,6,10,4,8,2,8,0,False,False,False,0,3,2020-12-31T19:18:03.22,10,,2.0
2020,16,3028,565,5,5220,2,39,4,2,4,2,4,0,4,0,False,False,False,0,3,2020-12-28T16:03:09.9,4,,0.0
2020,16,3028,570,5,4803,2,17,9,12,22,10,19,3,19,0,False,False,False,0,1,2021-02-23T17:01:43.853,22,,3.0
2020,16,3028,580,5,8195,2,44,3,-6,3,9,3,0,3,0,True,False,False,0,1,2020-12-31T19:18:42.29,3,,0.0
2020,16,3028,600,32,6430,13,20,2,23,0,0,0,0,0,0,False,False,False,0,2,2020-12-31T18:55:03.613,0,,0.0
2020,16,3028,605,32,7807,2,45,5,-2,3,5,2,1,2,0,False,False,False,0,1,2020-12-28T16:24:04.657,3,,1.0
2020,16,3028,610,32,6318,2,13,9,3,28,25,7,21,7,0,False,False,False,1,3,2020-12-28T16:31:39.683,28,,21.0
2020,16,3028,615,32,3885,13,4,4,3,0,0,0,0,0,0,False,False,False,0,1,2020-12-28T16:39:05.387,0,,0.0
2020,16,3028,620,32,1427,2,32,5,-1,7,8,3,4,3,0,False,False,False,0,4,2020-12-28T16:44:48.083,7,,4.0
2020,16,3028,625,32,7808,3,12,5,7,0,0,0,0,0,0,False,False,False,0,2,2021-03-09T14:54:04.423,0,,
2020,16,3028,630,32,1427,3,13,9,5,0,0,0,0,0,0,False,False,False,0,3,2020-12-31T18:56:24.36,0,,0.0
2020,16,3028,635,32,3885,2,6,4,3,5,2,4,1,4,0,False,False,False,0,1,2020-12-31T19:01:36.06,5,,1.0
2020,16,3028,640,32,1427,2,51,10,1,3,2,3,0,3,0,False,False,False,0,3,2020-12-28T16:55:00.72,3,,0.0
2020,16,3028,655,5,3477,2,5,5,4,3,-1,3,0,3,0,False,False,False,0,3,2020-12-28T17:01:15.57,3,,0.0
2020,16,3028,660,5,5220,13,9,6,26,0,0,0,0,0,0,False,False,False,0,3,2020-12-28T17:03:23.43,0,,0.0
2020,16,3028,670,32,7494,2,4,9,5,8,3,8,0,8,0,False,False,False,0,3,2020-12-28T17:06:13.967,8,,0.0
2020,16,3028,675,32,7808,13,6,8,17,0,0,0,0,0,0,False,False,False,0,2,2020-12-28T17:07:56.47,0,,0.0
2020,16,3028,685,32,7494,2,5,3,1,4,3,2,2,2,0,False,False,False,0,3,2020-12-31T18:58:02.577,4,,2.0
2020,16,3028,690,32,1427,2,17,8,16,19,3,17,2,17,0,False,False,False,0,3,2021-02-24T16:38:28.063,19,,2.0
2020,16,3028,695,32,6430,3,8,7,37,0,0,0,0,0,0,False,False,False,0,2,2020-12-28T17:15:22.9,0,,0.0
2020,16,3028,700,32,7494,13,17,7,17,0,0,0,0,0,0,False,False,False,0,3,2020-12-31T19:24:54.737,0,,0.0
2020,16,3028,705,32,7807,2,45,5,0,7,7,5,2,5,0,False,False,False,0,1,2020-12-31T19:25:33.633,7,,2.0
2020,16,3028,710,32,6430,2,2,9,7,9,2,8,1,8,0,False,False,False,0,2,2020-12-31T18:58:42.633,9,,1.0
2020,16,3028,715,32,6430,2,13,4,2,4,2,4,0,4,0,False,False,False,0,3,2020-12-31T18:59:35.287,4,,0.0
2020,16,3028,720,32,3885,2,4,4,0,5,5,3,2,3,0,False,False,False,0,1,2020-12-28T17:23:08.61,5,,2.0
2020,16,3028,730,32,1427,2,4,5,4,9,5,6,3,6,0,False,False,False,0,3,2020-12-28T17:29:46.38,9,,3.0
2020,16,3028,740,32,1427,13,4,10,12,0,0,0,0,0,0,False,False,False,0,3,2020-12-28T17:32:28.373,0,,0.0
2020,16,3028,745,32,1427,2,12,0,9,12,3,11,1,11,0,False,False,False,0,3,2021-03-09T14:54:21.84,12,,
2020,16,3028,755,32,7808,13,9,6,22,0,0,0,0,0,0,False,False,False,0,2,2020-12-31T19:00:22.663,0,,0.0
2020,16,3028,795,32,7494,2,4,10,12,23,11,11,12,11,0,False,False,False,1,3,2020-12-28T17:49:12.77,23,,12.0
2020,16,3028,805,32,1427,2,39,4,7,7,0,7,0,7,0,False,False,False,0,3,2020-12-28T17:52:50.82,7,,0.0
2020,16,3028,810,32,1427,13,19,8,34,0,0,0,0,0,0,False,False,False,0,3,2020-12-28T17:54:48.85,0,,0.0
2020,16,3028,815,32,8237,13,7,2,25,0,0,0,0,0,0,False,False,False,0,3,2020-12-28T17:56:27.74,0,,0.0
2020,16,3028,825,32,1427,2,32,9,-1,13,14,10,3,10,0,False,False,False,0,4,2021-02-24T16:38:15.993,13,,3.0
2020,16,3028,835,32,3885,2,12,6,29,29,0,29,0,29,6,False,False,False,0,1,2021-02-25T18:47:15.913,29,,0.0
2020,16,3029,15,29,4875,2,30,3,2,5,3,5,0,5,0,True,False,False,0,3,2021-01-02T22:44:18.753,5,,0.0
2020,16,3029,20,29,4875,13,4,3,6,0,0,0,0,0,0,False,False,False,0,2,2021-01-02T23:36:36.86,0,,0.0
2020,16,3029,40,27,650,13,4,9,6,0,0,0,0,0,0,True,False,False,0,3,2021-02-23T17:05:28.84,0,,0.0
2020,16,3029,55,29,4875,13,30,5,2,0,0,0,0,0,0,True,False,False,0,3,2020-12-28T12:40:41.877,0,,0.0
2020,16,3029,60,29,4866,2,3,3,9,9,0,9,0,9,0,False,False,False,0,3,2020-12-28T12:42:45.327,9,,0.0
2020,16,3029,80,29,4866,2,4,10,12,12,0,12,0,12,0,False,False,False,0,3,2020-12-28T12:48:30.877,12,,0.0
2020,16,3029,85,29,1958,2,5,2,18,19,1,19,0,19,0,False,False,False,0,3,2020-12-28T12:52:52.893,19,,0.0
2020,16,3029,100,29,1958,2,4,10,9,11,2,9,2,9,0,False,False,False,0,3,2021-01-02T23:56:38.58,11,,2.0
2020,16,3029,105,29,3398,13,4,5,5,0,0,0,0,0,0,False,False,False,0,2,2020-12-28T12:59:05.517,0,,0.0
2020,16,3029,115,29,7828,3,6,4,5,0,0,0,0,0,0,False,False,False,0,3,2021-01-02T23:37:02.393,0,,0.0
2020,16,3029,130,27,6397,2,4,10,5,6,1,5,1,5,0,False,False,False,0,3,2020-12-28T13:07:01.89,6,,1.0
2020,16,3029,135,27,650,2,30,3,4,9,5,9,0,9,0,True,False,False,0,2,2020-12-28T13:08:36.443,9,,0.0
2020,16,3029,140,27,4835,2,28,3,1,4,3,3,1,3,0,True,False,False,0,4,2020-12-28T13:10:17.427,4,,1.0
2020,16,3029,170,29,4866,2,47,5,2,8,6,6,2,6,0,False,False,False,0,3,2020-12-28T13:18:57.703,8,,2.0
2020,16,3029,180,27,7408,13,3,3,13,0,0,0,0,0,0,False,False,False,0,2,2020-12-28T13:22:06.43,0,,
2020,16,3029,185,27,7408,2,35,3,12,12,0,12,0,12,0,True,False,False,0,2,2020-12-28T13:26:05.48,12,,0.0
2020,16,3029,200,27,7408,2,49,5,-2,4,6,2,2,2,0,True,False,False,0,2,2020-12-28T13:29:21.873,4,,2.0
2020,16,3029,210,27,505,2,6,9,12,15,3,13,2,13,0,False,False,False,0,3,2021-01-02T23:38:25.507,15,,2.0
2020,16,3029,220,27,4835,13,11,3,13,0,0,0,0,0,0,False,False,False,0,3,2020-12-28T13:36:56.343,0,,0.0
2020,16,3029,245,29,4875,2,4,3,5,6,1,5,1,5,0,False,False,False,0,2,2020-12-28T13:44:11.287,6,,1.0
2020,16,3029,250,29,4866,2,42,9,5,6,1,5,1,5,0,False,False,False,0,3,2020-12-28T13:45:56.8,6,,1.0
2020,16,3029,255,29,4875,2,3,3,12,13,1,13,0,13,0,False,False,False,0,2,2020-12-28T13:48:41.09,13,,0.0
2020,16,3029,270,29,4866,2,4,10,5,11,6,9,2,9,0,False,False,False,0,3,2021-01-02T23:21:53.86,11,,2.0
2020,16,3029,275,29,3398,13,17,8,27,0,0,0,0,0,0,False,False,False,0,3,2020-12-28T13:56:10.707,0,,0.0
2020,16,3029,285,29,1958,13,5,5,11,0,0,0,0,0,0,True,False,False,0,3,2020-12-28T13:58:06.91,0,,0.0
2020,16,3029,290,29,1958,3,39,4,6,0,0,0,0,0,0,False,False,False,0,3,2020-12-28T14:00:05.527,0,,0.0
2020,16,3029,310,27,7408,13,19,2,50,0,0,0,0,0,0,False,False,False,0,2,2020-12-28T14:04:33.36,0,,0.0
2020,16,3029,315,27,505,13,39,4,5,0,0,0,0,0,0,False,False,False,0,3,2020-12-28T14:05:56.617,0,,0.0
2020,16,3029,340,29,4875,2,13,9,2,2,0,2,0,2,0,False,False,False,0,2,2021-02-23T19:25:54.57,2,,0.0
2020,16,3029,355,29,1958,2,47,5,2,5,3,5,0,5,0,True,False,False,0,3,2020-12-28T14:20:20.453,5,,0.0
2020,16,3029,360,29,4866,2,34,4,-4,3,7,2,1,2,0,True,False,False,0,2,2021-01-02T23:40:40.383,3,,1.0
2020,16,3029,365,29,1958,2,5,9,13,13,0,13,0,13,0,False,False,False,0,3,2021-01-02T23:41:11.937,13,,0.0
2020,16,3029,370,29,3398,3,35,3,10,0,0,0,0,0,0,False,False,False,0,4,2020-12-28T14:30:26.723,0,,0.0
2020,16,3029,380,29,1958,13,12,2,19,0,0,0,0,0,0,False,False,False,0,3,2021-03-09T20:25:24.353,0,,0.0
2020,16,3029,385,27,5050,2,4,4,2,6,4,4,2,4,0,False,False,False,0,1,2020-12-28T14:34:51.293,6,,2.0
2020,16,3029,395,27,4835,3,30,9,2,0,0,0,0,0,0,False,False,False,0,4,2021-02-23T17:10:57.717,0,,0.0
2020,16,3029,400,27,6397,2,47,5,1,4,3,3,1,3,0,False,False,False,0,4,2020-12-28T14:39:20.31,4,,1.0
2020,16,3029,410,27,7408,2,2,9,9,17,8,14,3,14,0,True,False,False,0,3,2021-01-02T23:57:28.89,17,,3.0
2020,16,3029,425,27,7408,13,2,9,6,0,0,0,0,0,0,False,False,False,0,2,2020-12-28T14:44:32.31,0,,0.0
2020,16,3029,450,29,3398,2,46,3,2,2,0,2,0,2,0,False,False,False,0,3,2020-12-28T14:48:49.683,2,,0.0
2020,16,3029,455,29,3356,3,28,4,1,0,0,0,0,0,0,False,False,False,0,1,2020-12-28T14:50:19.493,0,,0.0
2020,16,3029,475,27,7408,2,4,4,6,7,1,6,1,6,0,False,False,False,0,3,2020-12-28T14:53:15.59,7,,1.0
2020,16,3029,485,27,650,13,23,7,57,0,0,0,0,0,0,False,False,False,0,2,2021-01-02T23:01:39.813,0,,0.0
2020,16,3029,530,27,5050,2,44,3,-5,1,6,0,1,0,0,True,False,False,0,3,2021-01-02T23:57:54.067,1,,1.0
2020,16,3029,535,27,5069,2,21,2,42,45,3,43,2,43,0,False,False,False,0,2,2020-12-28T15:19:02.36,45,,2.0
2020,16,3029,550,27,153,2,12,10,5,18,13,16,2,16,0,False,False,False,0,1,2020-12-28T15:25:37.703,18,,2.0
2020,16,3029,585,29,4850,2,4,9,4,4,0,4,0,4,0,False,False,False,0,3,2020-12-28T15:35:21.863,4,,0.0
2020,16,3029,595,29,3398,2,4,9,5,22,17,7,15,7,0,False,False,False,2,3,2021-03-03T20:12:38.597,22,,15.0
2020,16,3029,630,27,4835,13,4,9,4,0,0,0,0,0,0,False,False,False,0,3,2020-12-28T17:48:09.153,0,,0.0
2020,16,3029,635,27,6397,2,13,4,4,7,3,4,3,4,0,False,False,False,0,4,2021-01-02T23:01:39.813,7,,3.0
2020,16,3029,665,29,4850,2,6,4,8,9,1,8,1,8,0,False,False,False,0,2,2020-12-28T16:22:16.967,9,,1.0
2020,16,3029,670,29,4866,2,39,4,6,6,0,6,0,6,0,False,False,False,0,3,2020-12-28T16:03:14.243,6,,0.0
2020,16,3029,680,29,4875,13,2,10,11,0,0,0,0,0,0,False,False,False,0,2,2020-12-28T16:05:49.843,0,,0.0
2020,16,3029,685,29,4866,2,6,4,11,11,0,11,0,11,0,False,False,False,0,2,2020-12-28T16:11:13.94,11,,0.0
2020,16,3029,695,29,4875,13,39,4,5,0,0,0,0,0,0,False,False,False,0,3,2021-01-02T23:46:13.877,0,,0.0
2020,16,3029,715,27,4835,13,32,4,-1,0,0,0,0,0,0,False,False,False,0,4,2020-12-28T16:25:03.07,0,,0.0
2020,16,3029,725,27,7408,2,38,4,4,11,7,8,3,8,0,False,False,False,0,3,2020-12-28T16:28:02.143,11,,3.0
2020,16,3029,760,29,4850,13,12,5,8,0,0,0,0,0,0,False,False,False,0,3,2020-12-28T16:43:46.707,0,,0.0
2020,16,3029,765,29,4875,2,4,5,4,26,22,8,18,8,0,False,False,False,2,2,2020-12-28T16:45:27.573,26,,18.0
2020,16,3029,780,29,1958,13,4,8,17,0,0,0,0,0,0,False,False,False,0,2,2021-01-02T23:48:16.533,0,,0.0
2020,16,3029,790,27,650,2,4,10,8,11,3,11,0,11,0,False,False,False,0,2,2020-12-28T16:52:58.633,11,,0.0
2020,16,3029,800,27,650,2,7,6,21,24,3,22,2,22,0,True,False,False,0,2,2020-12-28T16:56:57.133,24,,2.0
2020,16,3029,810,27,5050,2,48,9,-6,3,9,3,0,3,0,False,False,False,0,1,2020-12-28T17:00:09.83,3,,0.0
2020,16,3029,815,27,7408,2,2,4,5,8,3,6,2,6,0,False,False,False,0,2,2020-12-28T17:01:50.91,8,,2.0
2020,16,3029,840,27,4835,2,9,3,13,13,0,13,0,13,6,True,False,False,0,3,2021-01-02T23:50:47.957,13,,0.0
2020,16,3029,855,29,3356,2,4,4,2,8,6,6,2,6,0,False,False,False,0,1,2020-12-28T17:17:02.353,8,,2.0
2020,16,3029,860,29,4866,13,4,10,5,0,0,0,0,0,0,False,False,False,0,3,2021-01-02T23:58:23.94,0,,0.0
2020,16,3029,865,29,4875,2,6,4,13,13,0,13,0,13,0,False,False,False,0,3,2021-01-02T23:52:32.953,13,,0.0
2020,16,3029,870,29,1958,13,50,3,-1,0,0,0,0,0,0,False,False,False,0,2,2020-12-28T17:27:41.907,0,,0.0
2020,16,3029,875,29,3356,3,31,4,3,0,0,0,0,0,0,False,False,False,0,1,2020-12-28T17:29:43.753,0,,0.0
2020,16,3029,890,29,3398,2,12,3,7,10,3,8,2,8,0,False,False,False,0,4,2021-02-25T18:49:57.01,10,,2.0
2020,16,3030,10,24,7798,13,6,1,18,0,0,0,0,0,0,False,False,False,0,2,2020-12-28T15:09:24.46,0,,
2020,16,3030,25,24,6937,2,48,9,-6,3,9,-6,9,-6,0,False,False,False,1,1,2021-03-03T20:18:13.077,3,,9.0
2020,16,3030,45,24,7798,2,5,3,5,5,0,5,0,5,0,False,False,False,0,3,2020-12-28T15:21:28.377,5,,0.0
2020,16,3030,80,9,322,2,8,6,31,35,4,33,2,33,0,False,False,False,0,3,2021-01-02T23:11:44.933,35,,2.0
2020,16,3030,90,9,6436,13,19,6,31,0,0,0,0,0,0,False,False,False,0,3,2021-01-02T23:11:44.933,0,,
2020,16,3030,105,9,7183,13,12,6,17,0,0,0,0,0,0,True,False,False,0,2,2020-12-28T15:37:39.653,0,,0.0
2020,16,3030,120,24,967,2,23,2,42,81,39,81,0,81,6,False,False,False,0,2,2020-12-28T15:41:37.773,81,,0.0
2020,16,3030,140,9,6436,13,2,10,8,0,0,0,0,0,0,False,False,False,0,2,2020-12-28T15:45:23.823,0,,0.0
2020,16,3030,175,9,6436,13,19,6,33,0,0,0,0,0,0,False,False,False,0,2,2020-12-28T17:33:47.177,0,,0.0
2020,16,3030,185,9,6436,2,8,9,14,14,0,14,0,14,0,False,False,False,0,2,2021-01-02T23:11:44.933,14,,0.0
2020,16,3030,190,9,2568,2,53,9,-3,7,10,5,2,5,0,False,False,False,0,4,2020-12-28T15:59:00.52,7,,2.0
2020,16,3030,210,9,4202,2,28,9,-1,9,10,3,6,3,0,False,False,False,1,1,2021-01-03T00:09:07.67,9,,6.0
2020,16,3030,220,9,4202,2,30,5,-1,7,8,5,2,5,0,False,False,False,0,1,2021-01-03T00:00:37.59,7,,2.0
2020,16,3030,225,9,6436,2,2,5,10,21,11,13,8,13,6,False,False,False,1,2,2021-01-03T00:09:21.623,21,,8.0
2020,16,3030,255,24,6808,2,6,1,17,19,2,19,0,19,0,False,False,False,0,2,2020-12-28T16:17:55.867,19,,0.0
2020,16,3030,285,9,6446,2,4,9,4,4,0,4,0,4,0,False,False,False,0,3,2020-12-28T16:23:32.643,4,,0.0
2020,16,3030,295,9,6436,2,50,3,-3,55,58,52,3,52,0,False,False,False,0,2,2021-01-02T23:11:44.933,55,,3.0
2020,16,3030,330,24,6373,2,4,9,4,5,1,4,1,4,0,False,False,False,0,3,2020-12-28T16:38:22.547,5,,1.0
2020,16,3030,340,24,4382,2,5,2,17,17,0,17,0,17,0,False,False,False,0,2,2020-12-28T16:40:08.577,17,,0.0
2020,16,3030,350,24,6937,13,47,5,3,0,0,0,0,0,0,False,False,False,0,1,2020-12-28T16:42:48.253,0,,0.0
2020,16,3030,355,24,6373,2,11,5,14,23,9,20,3,20,0,True,False,False,0,4,2020-12-28T16:44:25.197,23,,3.0
2020,16,3030,360,24,894,3,6,10,8,0,0,0,0,0,0,False,False,False,0,3,2020-12-28T16:47:44.79,0,,0.0
2020,16,3030,370,24,7798,13,8,8,20,0,0,0,0,0,0,False,False,False,0,3,2021-01-03T00:01:08.92,0,,0.0
2020,16,3030,385,9,7816,2,2,10,6,6,0,6,0,6,0,True,False,False,0,2,2020-12-28T16:56:39.613,6,,0.0
2020,16,3030,400,9,6436,2,6,10,5,5,0,5,0,5,0,False,False,False,0,2,2021-02-25T18:52:12.45,5,,0.0
2020,16,3030,405,9,7183,2,4,4,4,8,4,6,2,6,0,False,False,False,0,1,2020-12-28T17:01:25.483,8,,2.0
2020,16,3030,410,9,6446,13,4,4,9,0,0,0,0,0,0,False,False,False,0,3,2020-12-28T17:02:32.627,0,,0.0
2020,16,3030,415,9,6446,2,6,1,16,16,0,16,0,16,0,False,False,False,0,3,2020-12-28T17:04:58.033,16,,0.0
2020,16,3030,425,9,4202,2,4,10,1,4,3,3,1,3,0,False,False,False,0,1,2020-12-28T17:06:25.733,4,,1.0
2020,16,3030,440,9,7816,2,4,10,4,7,3,5,2,5,0,False,False,False,0,3,2020-12-28T17:10:47.533,7,,2.0
2020,16,3030,450,9,6436,2,12,6,19,19,0,19,0,19,0,False,False,False,0,2,2020-12-28T17:16:26.537,19,,0.0
2020,16,3030,455,9,6436,2,9,3,7,7,0,7,0,7,6,False,False,False,0,2,2020-12-28T17:17:26.997,7,,0.0
2020,16,3030,480,24,4382,2,5,5,7,10,3,10,0,10,0,False,False,False,0,3,2020-12-28T17:22:42.89,10,,0.0
2020,16,3030,490,24,7798,2,52,4,4,15,11,15,0,15,0,False,False,False,0,2,2020-12-28T17:24:44.007,15,,0.0
2020,16,3030,510,9,322,2,2,10,9,11,2,10,1,10,0,False,False,False,0,2,2020-12-28T17:37:23.837,11,,1.0
2020,16,3030,525,9,7816,2,11,2,18,52,34,52,0,52,6,True,False,False,0,3,2021-01-02T23:11:44.933,52,,0.0
2020,16,3030,565,9,322,2,2,5,4,69,65,16,53,16,0,False,False,False,2,2,2021-03-03T20:19:44.667,69,,53.0
2020,16,3030,580,9,322,3,9,3,3,0,0,0,0,0,0,False,False,False,0,2,2021-01-03T00:01:45.927,0,,0.0
2020,16,3030,595,9,322,13,3,3,3,0,0,0,0,0,0,False,False,False,0,2,2020-12-28T18:07:31.743,0,,0.0
2020,16,3030,610,24,7800,2,12,6,40,43,3,40,3,40,0,False,False,False,0,3,2020-12-28T18:09:55.857,43,,3.0
2020,16,3030,625,24,6937,3,47,5,3,0,0,0,0,0,0,False,False,False,0,1,2020-12-28T18:13:13.553,0,,0.0
2020,16,3030,645,9,6446,2,47,5,0,1,1,0,1,0,0,True,False,False,0,4,2020-12-28T18:19:40.863,1,,1.0
2020,16,3030,655,24,6373,2,47,5,3,10,7,8,2,8,0,False,False,False,0,4,2020-12-28T18:21:24.72,10,,2.0
2020,16,3030,685,9,4202,2,47,5,0,14,14,3,11,3,0,False,False,False,1,1,2020-12-28T18:25:46.483,14,,11.0
2020,16,3030,695,9,7816,13,17,8,26,0,0,0,0,0,0,False,False,False,0,3,2021-03-04T21:19:28.54,0,,0.0
2020,16,3030,700,24,7798,13,2,4,5,0,0,0,0,0,0,False,False,False,0,3,2020-12-28T18:29:24.233,0,,0.0
2020,16,3030,720,24,7798,13,6,9,13,0,0,0,0,0,0,False,False,False,0,2,2020-12-28T18:33:31.36,0,,0.0
2020,16,3030,730,24,894,2,32,3,4,8,4,7,1,7,0,False,False,False,0,3,2020-12-29T19:57:51.33,8,,1.0
2020,16,3030,735,24,894,2,32,10,3,8,5,8,0,8,0,False,False,False,0,3,2020-12-28T18:36:29.177,8,,0.0
2020,16,3030,760,9,322,2,4,3,6,6,0,6,0,6,0,False,False,False,0,2,2020-12-28T18:45:56.903,6,,0.0
2020,16,3030,765,9,7816,13,6,4,2,0,0,0,0,0,0,True,False,False,0,3,2020-12-28T18:47:38.787,0,,0.0
2020,16,3030,775,24,6937,2,5,5,4,9,5,6,3,6,0,False,False,False,0,1,2020-12-28T18:49:12.677,9,,3.0
2020,16,3030,780,24,4382,3,6,9,5,0,0,0,0,0,0,False,False,False,0,3,2020-12-28T18:50:11.583,0,,0.0
2020,16,3030,790,24,264,2,19,2,17,22,5,22,0,22,0,False,False,False,0,2,2021-02-23T16:58:30.22,22,,0.0
2020,16,3030,800,24,894,13,32,5,0,0,0,0,0,0,0,False,False,False,0,3,2021-01-03T00:15:14.157,0,,0.0
2020,16,3030,805,24,894,2,6,4,11,17,6,17,0,17,0,False,False,False,0,3,2020-12-28T18:57:45.26,17,,0.0
2020,16,3030,810,24,6937,2,4,9,4,6,2,4,2,4,0,False,False,False,0,1,2020-12-28T18:59:56.02,6,,2.0
2020,16,3030,825,24,7798,2,50,5,-2,10,12,8,2,8,0,False,False,False,0,2,2020-12-28T19:03:09.477,10,,2.0
2020,16,3030,840,24,6808,13,12,6,17,0,0,0,0,0,0,False,False,False,0,3,2020-12-29T19:58:50.273,0,,0.0
2020,16,3030,865,24,264,13,19,2,43,0,0,0,0,0,0,False,False,False,0,2,2020-12-28T19:11:36.367,0,,
2020,16,3030,910,9,7816,13,8,1,35,0,0,0,0,0,0,False,False,False,0,3,2020-12-28T19:18:09.923,0,,
2020,16,3030,945,24,7800,2,6,10,14,14,0,14,0,14,0,False,False,False,0,2,2020-12-28T19:23:01.07,14,,0.0
2020,16,3030,950,24,894,3,5,5,2,0,0,0,0,0,0,False,False,False,0,4,2020-12-28T19:24:00.367,0,,0.0
2020,16,3030,955,24,6937,2,5,9,1,9,8,9,0,9,0,False,False,False,0,1,2021-01-02T23:11:44.933,9,,0.0
2020,16,3030,960,24,7800,13,12,2,26,0,0,0,0,0,0,False,False,False,0,2,2020-12-28T19:26:25.44,0,,0.0
2020,16,3030,975,24,6808,2,3,5,8,8,0,8,0,8,0,False,False,False,0,2,2020-12-28T19:28:38.387,8,,0.0
2020,16,3030,985,24,7798,13,12,2,20,0,0,0,0,0,0,False,False,False,0,2,2020-12-28T19:30:56.633,0,,0.0
2020,16,3031,15,12,556,2,5,10,5,7,2,5,2,5,0,False,False,False,0,3,2020-12-28T11:49:15.07,7,,2.0
2020,16,3031,20,12,556,2,2,10,7,8,1,8,0,8,0,False,False,False,0,2,2020-12-28T11:50:48.833,8,,0.0
2020,16,3031,30,12,8279,2,30,3,2,13,11,9,4,9,0,False,False,False,0,4,2020-12-28T11:55:53.09,13,,4.0
2020,16,3031,40,12,6691,2,5,3,5,7,2,5,2,5,0,False,False,False,0,3,2020-12-28T12:00:31.593,7,,2.0
2020,16,3031,45,12,556,2,18,5,-3,5,8,-1,6,-1,6,False,False,False,1,2,2021-02-23T19:32:09.003,5,,6.0
2020,16,3031,70,31,6390,2,4,10,6,12,6,6,6,6,0,True,False,False,0,3,2021-01-02T22:40:01.18,12,,6.0
2020,16,3031,90,31,5096,13,5,3,13,0,0,0,0,0,0,False,False,False,0,3,2020-12-28T12:17:17.107,0,,0.0
2020,16,3031,120,12,957,2,44,9,-8,-1,7,-2,1,-2,0,True,False,False,0,3,2020-12-28T12:27:51.953,-1,,1.0
2020,16,3031,125,12,7742,2,48,9,-7,0,7,-2,2,-2,0,False,False,False,0,1,2020-12-28T12:31:16.31,0,,
2020,16,3031,135,12,6691,2,5,10,5,7,2,6,1,6,0,False,False,False,0,3,2020-12-28T12:38:01.797,7,,1.0
2020,16,3031,140,12,4511,2,30,10,1,17,16,16,1,16,0,False,False,False,0,4,2020-12-28T12:39:36.757,17,,1.0
2020,16,3031,160,12,6356,2,35,8,21,21,0,21,0,21,6,False,False,False,0,3,2020-12-28T12:46:36.22,21,,0.0
2020,16,3031,185,31,6793,13,35,10,12,0,0,0,0,0,0,False,False,False,0,3,2021-03-04T21:23:02.183,0,,0.0
2020,16,3031,190,12,4537,13,12,3,3,0,0,0,0,0,0,False,False,False,0,2,2021-03-09T16:25:47.29,0,,0.0
2020,16,3031,200,12,957,2,51,9,-4,6,10,5,1,5,0,True,False,False,0,3,2020-12-28T13:00:15.24,6,,1.0
2020,16,3031,215,12,556,2,9,5,7,7,0,7,0,7,6,False,False,False,0,2,2021-02-23T19:33:59.167,7,,0.0
2020,16,3031,235,31,7603,13,45,10,-4,0,0,0,0,0,0,False,False,False,0,1,2020-12-28T13:13:54.093,0,,0.0
2020,16,3031,250,12,556,2,35,7,18,23,5,20,3,20,0,False,False,False,0,3,2020-12-28T13:42:17.937,23,,3.0
2020,16,3031,270,12,7742,2,6,9,3,5,2,4,1,4,0,False,False,False,0,1,2021-01-02T21:49:10.367,5,,1.0
2020,16,3031,285,12,4511,13,7,6,17,0,0,0,0,0,0,False,False,False,0,3,2020-12-28T13:52:25.35,0,,0.0
2020,16,3031,310,31,6793,2,6,10,5,10,5,5,5,5,0,False,False,False,0,2,2020-12-28T14:01:29.197,10,,5.0
2020,16,3031,325,31,6793,2,4,3,12,12,0,12,0,12,0,False,False,False,0,2,2020-12-28T14:04:59.947,12,,0.0
2020,16,3031,345,31,6793,2,4,3,7,12,5,7,5,7,0,False,False,False,1,2,2020-12-28T14:12:44.107,12,,5.0
2020,16,3031,350,31,5096,2,5,5,4,8,4,6,2,6,0,False,False,False,0,3,2020-12-28T14:14:25.093,8,,2.0
2020,16,3031,355,31,5096,2,7,3,12,12,0,12,0,12,6,False,False,False,0,3,2020-12-28T14:16:51.963,12,,0.0
2020,16,3031,375,12,4537,2,4,9,0,9,9,7,2,7,0,False,False,False,0,1,2020-12-28T14:19:55.597,9,,2.0
2020,16,3031,390,12,556,2,5,5,6,6,0,6,0,6,0,False,False,False,0,2,2020-12-28T14:24:01.14,6,,0.0
2020,16,3031,410,31,6793,2,2,4,6,9,3,8,1,8,0,False,False,False,0,3,2021-02-23T19:34:51.923,9,,1.0
2020,16,3031,450,12,556,2,12,9,8,8,0,8,0,8,6,False,False,False,0,2,2020-12-28T14:45:32.867,8,,0.0
2020,16,3031,465,31,6793,13,19,6,27,0,0,0,0,0,0,False,False,False,0,2,2020-12-28T17:39:05.913,0,,0.0
2020,16,3031,475,31,6793,13,12,2,18,0,0,0,0,0,0,False,False,False,0,2,2020-12-29T16:30:19.803,0,,0.0
2020,16,3031,485,12,556,2,2,4,10,11,1,11,0,11,0,False,False,False,0,3,2020-12-28T15:01:22.937,11,,0.0
2020,16,3031,500,12,7742,2,45,5,-3,7,10,7,0,7,0,False,False,False,0,1,2020-12-28T15:08:07.067,7,,
2020,16,3031,510,12,556,2,26,5,3,8,5,8,0,8,0,False,False,False,0,3,2020-12-28T15:16:45.727,8,,0.0
2020,16,3031,560,31,6724,2,4,10,3,11,8,8,3,8,0,True,False,False,0,3,2020-12-28T15:29:53.647,11,,3.0
2020,16,3031,565,31,5080,13,2,10,5,0,0,0,0,0,0,False,False,False,0,2,2020-12-28T15:34:01.017,0,,0.0
2020,16,3031,575,31,6793,13,35,2,15,0,0,0,0,0,0,False,False,False,0,2,2020-12-28T15:38:33.41,0,,0.0
2020,16,3031,585,31,5096,2,33,4,4,10,6,8,2,8,0,False,False,False,0,4,2020-12-28T15:42:11.34,10,,2.0
2020,16,3031,595,31,5096,13,5,5,6,0,0,0,0,0,0,False,False,False,0,3,2020-12-28T15:44:24.377,0,,0.0
2020,16,3031,600,31,5096,13,12,5,2,0,0,0,0,0,0,True,False,False,0,3,2021-03-04T21:25:39.39,0,,0.0
2020,16,3031,615,12,4537,2,46,3,2,5,3,3,2,3,0,False,False,False,0,1,2021-02-23T19:39:56.543,5,,2.0
2020,16,3031,620,12,556,13,6,4,14,0,0,0,0,0,0,False,False,False,0,2,2021-03-04T21:51:41.873,0,,0.0
2020,16,3031,640,31,7913,2,7,6,19,19,0,19,0,19,0,False,False,False,0,3,2020-12-28T16:09:33.473,19,,0.0
2020,16,3031,660,31,5080,13,8,8,15,0,0,0,0,0,0,False,False,False,0,2,2020-12-28T16:11:36.003,0,,0.0
2020,16,3031,665,31,4545,2,4,10,3,6,3,5,1,5,0,False,False,False,0,1,2020-12-28T16:13:19.023,6,,1.0
2020,16,3031,670,31,5096,13,31,10,3,0,0,0,0,0,0,False,False,False,0,4,2020-12-28T16:18:55.63,0,,0.0
2020,16,3031,690,12,556,2,49,3,0,27,27,5,22,5,0,False,False,False,1,2,2021-02-23T19:39:04.073,27,,22.0
2020,16,3031,705,12,556,2,19,6,26,32,6,27,5,27,0,False,False,False,0,2,2020-12-28T16:32:44.327,32,,5.0
2020,16,3031,740,31,4037,13,5,5,9,0,0,0,0,0,0,False,False,False,0,3,2021-01-02T22:38:59.637,0,,0.0
2020,16,3031,745,31,7603,13,4,4,4,0,0,0,0,0,0,False,False,False,0,1,2020-12-28T16:42:17.587,0,,0.0
2020,16,3032,25,19,3233,3,33,6,28,0,0,0,0,0,0,False,False,False,0,3,2021-02-25T19:05:34.573,0,,0.0
2020,16,3032,30,19,7175,2,4,10,7,9,2,8,1,8,0,False,False,False,0,3,2020-12-29T11:27:55.53,9,,1.0
2020,16,3032,50,4,7646,2,4,9,5,6,1,6,0,6,0,False,False,False,0,3,2020-12-29T11:31:38.673,6,,0.0
2020,16,3032,60,4,7646,2,4,8,17,17,0,17,0,17,0,False,True,False,0,3,2020-12-30T17:27:33.427,17,,0.0
2020,16,3032,70,4,6983,2,6,5,6,10,4,8,2,8,0,False,False,False,1,2,2021-01-04T01:22:48.977,10,,2.0
2020,16,3032,75,4,6983,2,55,10,-2,6,8,6,0,6,0,True,False,False,1,1,2021-01-04T01:23:05.26,6,,0.0
2020,16,3032,80,4,1028,2,34,4,-4,2,6,1,1,1,0,True,False,False,1,3,2021-01-04T01:23:14.467,2,,1.0
2020,16,3032,105,19,7620,3,38,9,1,0,0,0,0,0,0,True,False,False,0,4,2021-01-04T01:35:33.607,0,,0.0
2020,16,3032,120,4,7645,2,46,9,-1,0,1,0,0,0,0,True,False,False,0,1,2020-12-30T17:24:48.367,0,,0.0
2020,16,3032,130,4,2853,13,12,4,10,0,0,0,0,0,0,False,False,False,0,2,2021-01-04T01:13:30.58,0,,0.0
2020,16,3032,135,4,6257,2,9,5,8,13,5,10,3,10,0,False,False,False,0,2,2020-12-29T11:52:45.733,13,,3.0
2020,16,3032,145,4,2853,2,30,3,0,2,2,2,0,2,0,True,False,False,0,3,2020-12-29T11:54:19.497,2,,0.0
2020,16,3032,155,4,594,2,47,5,2,4,2,4,0,4,0,True,False,False,0,3,2020-12-29T11:56:23.983,4,,0.0
2020,16,3032,165,4,2497,3,12,2,21,0,0,0,0,0,0,False,False,False,0,2,2020-12-29T11:59:45.997,0,,0.0
2020,16,3032,175,4,2853,13,29,3,10,0,0,0,0,0,0,False,False,False,0,2,2021-02-25T19:07:11.71,0,,
2020,16,3032,185,4,6953,3,35,9,5,0,0,0,0,0,0,False,False,False,0,4,2020-12-29T12:03:34.477,0,,0.0
2020,16,3032,210,19,3233,13,6,9,4,0,0,0,0,0,0,False,False,False,0,2,2020-12-29T12:11:01.927,0,,
2020,16,3032,225,19,3233,2,49,3,-2,7,9,1,6,1,0,False,False,False,1,2,2021-01-04T01:25:37.46,7,,6.0
2020,16,3032,265,4,6953,2,17,8,20,24,4,22,2,22,0,False,False,False,0,4,2020-12-29T12:26:56.577,24,,2.0
2020,16,3032,280,4,594,2,5,9,4,6,2,4,2,4,0,False,False,False,0,3,2021-01-04T01:13:40.337,6,,2.0
2020,16,3032,290,4,6953,2,6,9,12,12,0,12,0,12,0,False,False,False,0,3,2020-12-30T00:54:39.377,12,,0.0
2020,16,3032,295,4,2853,13,19,6,31,0,0,0,0,0,0,False,False,False,0,2,2020-12-29T12:35:17.297,0,,0.0
2020,16,3032,310,4,5119,2,44,3,-5,13,18,11,2,11,0,True,False,False,1,2,2021-01-04T01:26:03.167,13,,2.0
2020,16,3032,315,4,1377,2,38,9,4,4,0,4,0,4,6,False,False,False,0,4,2020-12-29T12:40:45.983,4,,0.0
2020,16,3032,330,19,7173,2,26,10,3,3,0,3,0,3,0,False,False,False,0,3,2020-12-29T12:43:10.507,3,,0.0
2020,16,3032,335,19,7173,13,6,4,12,0,0,0,0,0,0,False,False,False,0,3,2020-12-29T12:45:18.973,0,,0.0
2020,16,3032,340,19,7620,13,2,10,9,0,0,0,0,0,0,False,False,False,0,2,2020-12-29T12:47:41.953,0,,0.0
2020,16,3032,355,4,2853,2,35,3,14,17,3,17,0,17,0,False,False,False,0,3,2021-02-25T19:09:31.383,17,,0.0
2020,16,3032,360,4,2853,2,2,10,12,50,38,50,0,50,6,False,False,False,0,3,2020-12-29T12:54:27.453,50,,0.0
2020,16,3032,405,19,1328,2,26,3,5,7,2,7,0,7,0,False,False,False,0,2,2021-02-23T19:42:16.013,7,,0.0
2020,16,3032,415,19,7175,2,4,10,7,8,1,8,0,8,0,False,False,False,0,3,2020-12-29T13:06:10.98,8,,0.0
2020,16,3032,420,19,7173,13,12,1,19,0,0,0,0,0,0,False,False,False,1,2,2021-01-04T01:26:40.693,0,,0.0
2020,16,3032,450,4,6953,2,5,2,15,15,0,15,0,15,0,False,False,False,0,4,2020-12-29T13:18:29.62,15,,0.0
2020,16,3032,455,4,2853,2,50,9,-2,11,13,8,3,8,0,True,False,False,0,3,2020-12-30T17:27:33.427,11,,3.0
2020,16,3032,465,4,594,2,5,5,6,7,1,7,0,7,0,False,False,False,0,3,2020-12-29T13:22:00.613,7,,0.0
2020,16,3032,475,4,7646,2,4,9,6,10,4,8,2,8,0,False,False,False,0,3,2020-12-29T13:24:19.867,10,,2.0
2020,16,3032,480,4,2853,2,49,5,-3,10,13,3,7,3,0,False,False,False,1,2,2021-01-04T01:26:48.74,10,,7.0
2020,16,3032,485,4,2853,2,2,10,12,18,6,13,5,13,6,False,False,False,2,3,2020-12-29T13:27:17.267,18,,5.0
2020,16,3032,520,4,7646,13,19,8,55,0,0,0,0,0,0,False,False,False,0,3,2021-01-04T01:14:36.423,0,,0.0
2020,16,3032,530,4,7646,13,19,6,34,0,0,0,0,0,0,False,False,False,0,2,2020-12-29T13:37:59.737,0,,0.0
2020,16,3032,545,19,3233,13,4,10,6,0,0,0,0,0,0,False,False,False,0,3,2020-12-29T13:43:37.61,0,,0.0
2020,16,3032,550,19,7173,13,5,5,9,0,0,0,0,0,0,False,False,False,0,3,2020-12-29T13:44:46.69,0,,
2020,16,3032,560,19,7175,2,4,10,6,22,16,13,9,13,0,False,False,False,1,3,2020-12-29T13:47:31.147,22,,9.0
2020,16,3032,565,19,7175,13,6,4,11,0,0,0,0,0,0,False,False,False,0,3,2021-01-04T01:00:14.337,0,,0.0
2020,16,3032,570,19,7173,13,21,2,28,0,0,0,0,0,0,False,False,False,0,2,2021-02-23T19:43:29.937,0,,0.0
2020,16,3032,575,19,1328,2,31,9,1,6,5,4,2,4,0,False,False,False,0,1,2020-12-29T13:51:03.807,6,,2.0
2020,16,3032,605,4,5119,2,13,9,3,3,0,3,0,3,0,False,False,False,0,3,2020-12-29T13:56:33.197,3,,0.0
2020,16,3032,610,4,2853,2,4,3,9,9,0,9,0,9,0,False,False,False,0,2,2020-12-29T13:58:08.15,9,,0.0
2020,16,3032,615,4,5119,2,46,3,5,9,4,9,0,9,0,False,False,False,0,3,2020-12-29T13:59:15.767,9,,0.0
2020,16,3032,625,4,7645,2,12,5,4,4,0,4,0,4,0,True,False,False,0,1,2020-12-29T14:02:40.89,4,,
2020,16,3032,635,4,2853,2,12,1,21,20,-1,19,1,19,0,False,False,False,0,3,2020-12-29T14:04:49.96,20,,1.0
2020,16,3032,640,4,1377,2,33,5,8,27,19,25,2,25,0,False,False,False,0,4,2020-12-29T14:06:02.073,27,,2.0
2020,16,3032,645,4,2853,2,12,3,8,8,0,8,0,8,6,False,False,False,0,3,2021-01-04T01:14:45.363,8,,0.0
2020,16,3032,660,19,7175,2,26,5,3,6,3,6,0,6,0,False,False,False,0,2,2020-12-29T14:10:50.193,6,,0.0
2020,16,3032,685,4,1028,2,3,5,12,10,-2,10,0,10,0,False,False,False,0,2,2020-12-30T17:27:33.427,10,,0.0
2020,16,3032,690,4,594,13,5,7,19,0,0,0,0,0,0,False,False,False,0,3,2021-02-23T19:44:10.66,0,,0.0
2020,16,3032,700,4,5119,2,50,3,-1,1,2,-1,2,-1,0,False,False,False,0,2,2021-01-04T01:28:15.253,1,,2.0
2020,16,3032,735,19,1328,2,31,9,1,10,9,8,2,8,0,False,False,False,1,1,2021-01-04T01:28:24.463,10,,2.0
2020,16,3032,750,19,7175,13,6,1,18,0,0,0,0,0,0,False,False,False,0,3,2020-12-29T14:37:19.63,0,,0.0
2020,17,3033,15,4,1412,2,39,4,4,7,3,7,0,7,0,False,False,False,0,3,2021-02-23T20:32:56.157,7,,0.0
2020,17,3033,20,4,5119,2,4,9,4,7,3,5,2,5,0,False,False,False,0,3,2021-01-05T17:06:59.117,7,,2.0
2020,17,3033,30,4,2853,2,4,10,3,5,2,3,2,3,0,False,False,False,0,3,2021-01-04T11:38:34.433,5,,2.0
2020,17,3033,40,4,7646,13,4,3,4,0,0,0,0,0,0,False,False,False,0,2,2021-01-05T17:07:21.727,0,,0.0
2020,17,3033,50,17,6276,2,30,9,1,11,10,8,3,8,0,False,False,False,0,4,2021-01-07T15:11:12.29,11,,3.0
2020,17,3033,60,17,7687,13,18,5,0,0,0,0,0,0,0,False,False,False,0,2,2021-02-23T20:34:38.983,0,,0.0
2020,17,3033,85,4,7645,2,47,5,1,13,12,6,7,6,0,False,False,False,2,1,2021-03-03T15:44:00.377,13,,7.0
2020,17,3033,95,4,6953,13,39,4,5,0,0,0,0,0,0,False,False,False,0,4,2021-01-04T12:08:22.273,0,,0.0
2020,17,3033,105,4,6953,13,35,7,30,0,0,0,0,0,0,True,False,False,0,3,2021-01-04T12:10:25.377,0,,0.0
2020,17,3033,120,17,2253,13,4,10,3,0,0,0,0,0,0,True,False,False,0,3,2021-01-04T12:12:57.143,0,,0.0
2020,17,3033,125,17,7024,2,48,10,-5,6,11,3,3,3,0,True,False,False,0,1,2021-01-04T12:14:29.143,6,,3.0
2020,17,3033,130,17,2253,2,3,5,8,8,0,8,0,8,0,False,False,False,0,2,2021-01-04T12:17:12.123,8,,0.0
2020,17,3033,150,4,2853,13,12,2,31,0,0,0,0,0,0,False,False,False,0,3,2021-01-04T12:21:48.123,0,,0.0
2020,17,3033,170,17,7687,2,13,3,4,7,3,7,0,7,0,False,False,False,0,3,2021-01-04T12:27:24.87,7,,0.0
2020,17,3033,180,4,2853,2,12,5,5,5,0,5,0,5,0,False,False,False,0,3,2021-01-04T12:29:39.73,5,,0.0
2020,17,3033,190,4,6983,2,4,3,6,6,0,6,0,6,0,False,False,False,0,2,2021-01-04T12:31:06.637,6,,0.0
2020,17,3033,195,4,2853,2,4,3,5,8,3,7,1,7,0,False,False,False,0,2,2021-01-04T12:33:02.933,8,,1.0
2020,17,3033,200,4,2853,2,2,9,7,18,11,17,1,17,0,False,False,False,0,2,2021-01-04T12:34:27.327,18,,1.0
2020,17,3033,215,4,5119,2,5,5,7,7,0,7,0,7,6,False,False,False,0,3,2021-01-04T12:41:54.983,7,,0.0
2020,17,3033,235,17,4484,2,46,3,1,22,21,20,2,20,0,False,False,False,0,4,2021-01-04T12:46:03.193,22,,2.0
2020,17,3033,245,17,6274,13,13,9,3,0,0,0,0,0,0,False,False,False,0,4,2021-01-04T12:48:34.973,0,,0.0
2020,17,3033,250,17,7687,2,49,10,-4,3,7,-1,4,-1,0,True,False,False,1,3,2021-01-04T12:50:55.903,3,,4.0
2020,17,3033,260,4,2853,2,4,10,5,8,3,6,2,6,0,False,False,False,0,2,2021-01-04T12:57:22.99,8,,2.0
2020,17,3033,265,4,6953,2,46,3,1,10,9,8,2,8,0,False,False,False,0,4,2021-01-04T12:59:09.94,10,,2.0
2020,17,3033,270,4,2853,2,4,9,4,16,12,7,9,7,0,False,False,False,3,3,2021-01-04T13:09:29.987,16,,9.0
2020,17,3033,280,4,5119,2,12,7,17,19,2,19,0,19,0,False,False,False,0,3,2021-01-07T14:52:07.047,19,,0.0
2020,17,3033,290,4,1412,2,2,10,5,6,1,5,1,5,0,False,False,False,0,2,2021-01-07T14:52:24.873,6,,1.0
2020,17,3033,295,4,5119,2,12,10,14,14,0,14,0,14,6,False,False,False,0,3,2021-01-04T13:24:36.957,14,,0.0
2020,17,3033,310,17,7687,2,2,10,3,3,0,3,0,3,0,False,False,False,0,2,2021-01-04T13:28:23.763,3,,0.0
2020,17,3033,315,17,7687,2,49,9,-3,1,4,0,1,0,0,False,False,False,1,2,2021-01-04T13:31:06.983,1,,1.0
2020,17,3033,320,17,6274,13,19,6,27,0,0,0,0,0,0,False,False,False,0,3,2021-01-04T13:32:57.077,0,,0.0
2020,17,3033,340,17,7687,2,4,3,5,10,5,8,2,8,0,False,False,False,1,2,2021-01-04T14:11:36.56,10,,2.0
2020,17,3033,350,17,7024,2,48,9,-6,8,14,7,1,7,0,False,False,False,0,1,2021-01-07T15:33:15.397,8,,1.0
2020,17,3033,355,17,6274,13,2,4,6,0,0,0,0,0,0,False,False,False,0,3,2021-01-07T15:33:41.727,0,,
2020,17,3033,360,17,6276,2,46,3,3,5,2,5,0,5,0,False,False,False,0,4,2021-01-04T14:18:16.37,5,,0.0
2020,17,3033,365,17,7024,2,51,3,-3,32,35,30,2,30,0,False,False,False,0,1,2021-01-04T14:20:33.653,32,,2.0
2020,17,3033,390,17,2253,13,9,5,14,0,0,0,0,0,0,False,False,False,0,2,2021-01-04T14:24:01.53,0,,0.0
2020,17,3033,405,4,2853,2,2,10,11,16,5,16,0,16,0,False,False,False,0,2,2021-02-23T20:36:45.29,16,,0.0
2020,17,3033,410,4,1412,2,7,6,27,27,0,27,0,27,0,False,False,False,0,3,2021-01-05T21:44:43.66,27,,0.0
2020,17,3033,415,4,6953,13,32,5,-2,0,0,0,0,0,0,False,False,False,0,1,2021-01-07T14:52:54.76,0,,0.0
2020,17,3033,420,4,1412,2,20,2,32,32,0,32,0,32,6,False,False,False,0,2,2021-01-07T15:03:44.337,32,,0.0
2020,17,3033,435,17,4752,13,6,1,16,0,0,0,0,0,0,False,False,False,0,2,2021-01-04T14:38:47.11,0,,0.0
2020,17,3033,440,17,7687,2,26,10,3,5,2,5,0,5,0,False,False,False,0,3,2021-01-04T14:40:37.08,5,,0.0
2020,17,3033,450,17,7024,13,12,4,10,0,0,0,0,0,0,False,False,False,0,2,2021-01-07T15:47:28.657,0,,0.0
2020,17,3033,475,17,2253,2,4,3,9,17,8,14,3,14,0,False,False,False,0,2,2021-01-04T14:55:02.65,17,,3.0
2020,17,3033,480,17,2253,2,6,9,4,13,9,11,2,11,0,False,False,False,0,2,2021-01-04T14:55:11.063,13,,2.0
2020,17,3033,485,17,2253,2,29,6,22,25,3,23,2,23,0,False,False,False,0,2,2021-01-07T14:44:30.33,25,,2.0
2020,17,3033,490,17,6274,2,39,4,5,5,0,5,0,5,0,False,False,False,0,3,2021-01-04T14:54:12.65,5,,0.0
2020,17,3033,495,17,2253,2,2,10,4,6,2,5,1,5,0,False,False,False,0,2,2021-01-04T14:56:22.347,6,,1.0
2020,17,3033,505,17,6274,13,2,4,4,0,0,0,0,0,0,True,False,False,0,3,2021-02-23T20:37:25.193,0,,0.0
2020,17,3033,510,17,2253,13,17,10,4,0,0,0,0,0,0,True,False,False,0,3,2021-01-07T15:33:50.853,0,,0.0
2020,17,3033,515,17,2253,13,2,9,4,0,0,0,0,0,0,False,False,False,0,2,2021-01-04T15:01:13.913,0,,
2020,17,3033,535,4,6953,13,30,10,-1,0,0,0,0,0,0,False,False,False,0,4,2021-01-04T15:10:28.827,0,,0.0
2020,17,3033,550,4,5119,2,6,9,6,15,9,14,1,14,0,False,False,False,1,2,2021-01-04T15:15:48.59,15,,1.0
2020,17,3033,560,4,6953,13,35,7,22,0,0,0,0,0,0,False,False,False,0,3,2021-01-07T15:03:56.457,0,,0.0
2020,17,3033,565,4,5119,3,51,5,0,0,0,0,0,0,0,False,False,False,0,3,2021-01-04T15:19:29.397,0,,0.0
2020,17,3033,575,17,2253,13,6,9,5,0,0,0,0,0,0,False,False,False,0,2,2021-01-04T15:21:51.11,0,,0.0
2020,17,3033,595,17,6274,2,5,3,2,2,0,2,0,2,0,False,False,False,0,3,2021-01-04T15:34:55.243,2,,0.0
2020,17,3033,600,17,4484,13,39,4,6,0,0,0,0,0,0,False,False,False,0,4,2021-02-23T20:38:17.57,0,,0.0
2020,17,3033,610,17,4484,13,46,3,5,0,0,0,0,0,0,False,False,False,0,4,2021-02-23T20:40:01.24,0,,0.0
2020,17,3033,625,17,6274,13,39,4,8,0,0,0,0,0,0,False,False,False,0,3,2021-01-07T15:04:04.817,0,,0.0
2020,17,3033,630,17,4752,13,8,1,17,0,0,0,0,0,0,False,False,False,0,2,2021-01-07T15:36:15.573,0,,0.0
2020,17,3033,635,17,2253,13,4,3,10,0,0,0,0,0,0,False,False,False,0,2,2021-01-04T15:45:45.727,0,,0.0
2020,17,3033,645,4,6953,2,11,2,17,19,2,19,0,19,0,False,False,False,0,3,2021-01-04T15:47:50.257,19,,0.0
2020,17,3033,650,4,6953,13,13,9,5,0,0,0,0,0,0,False,False,False,0,4,2021-01-04T15:49:15.15,0,,0.0
2020,17,3033,655,4,7646,13,2,9,3,0,0,0,0,0,0,False,False,False,0,2,2021-01-04T15:50:14.94,0,,0.0
2020,17,3033,660,4,7435,13,35,8,19,0,0,0,0,0,0,False,False,False,0,3,2021-01-06T00:17:36.693,0,,0.0
2020,17,3033,665,17,4752,13,21,2,34,0,0,0,0,0,0,False,False,False,0,2,2021-01-04T16:15:19.657,0,,0.0
2020,17,3033,670,17,2253,2,2,10,6,16,10,14,2,14,0,False,False,False,0,2,2021-01-04T16:16:10.457,16,,2.0
2020,17,3033,675,17,7687,13,4,10,3,0,0,0,0,0,0,False,False,False,0,3,2021-01-04T16:25:29.933,0,,0.0
2020,17,3033,680,17,7024,2,48,9,-8,11,19,8,3,8,0,False,False,False,0,1,2021-01-04T16:26:38.33,11,,3.0
2020,17,3033,685,17,2253,2,29,6,30,31,1,31,0,31,0,False,False,False,0,2,2021-01-04T16:27:46.447,31,,0.0
2020,17,3033,695,17,2253,13,2,9,6,0,0,0,0,0,0,False,False,False,0,2,2021-01-04T16:30:02.777,0,,0.0
2020,17,3033,700,17,7687,13,2,8,15,0,0,0,0,0,0,False,False,False,0,3,2021-01-04T16:32:28.287,0,,0.0
2020,17,3033,720,4,5119,2,6,9,3,3,0,3,0,3,0,False,False,False,0,2,2021-01-04T16:38:51.827,3,,0.0
2020,17,3033,725,4,7646,2,19,2,43,51,8,43,8,43,0,False,False,False,0,2,2021-01-05T15:32:16.147,51,,8.0
2020,17,3033,745,17,6274,13,17,1,23,0,0,0,0,0,0,False,False,False,0,3,2021-01-04T16:44:01.563,0,,0.0
2020,17,3033,750,4,7947,2,28,10,4,20,16,13,7,13,0,False,False,False,1,1,2021-01-04T16:47:21.833,20,,7.0
2020,17,3033,780,17,6274,2,6,10,7,7,0,7,0,7,0,False,False,False,0,3,2021-02-23T20:41:21.85,7,,0.0
2020,17,3033,790,17,4752,2,4,9,5,12,7,6,6,6,0,False,False,False,1,2,2021-01-07T15:36:31.767,12,,6.0
2020,17,3033,795,17,7618,2,48,9,-5,13,18,11,2,11,0,False,False,False,0,1,2021-01-04T17:00:52.36,13,,2.0
2020,17,3033,800,17,4752,3,6,8,17,0,0,0,0,0,0,False,False,False,0,2,2021-01-04T17:04:02.337,0,,0.0
2020,17,3033,805,17,2253,3,6,9,4,0,0,0,0,0,0,False,False,False,0,2,2021-01-07T15:04:19.73,0,,0.0
2020,17,3033,810,17,6274,2,8,7,23,23,0,23,0,23,0,False,False,False,0,3,2021-01-07T15:05:23.043,23,,0.0
2020,17,3033,850,4,5119,13,19,2,37,0,0,0,0,0,0,False,False,False,0,2,2021-01-06T00:20:38.51,0,,0.0
2020,17,3033,865,17,4752,2,4,10,6,7,1,7,0,7,0,False,False,False,0,2,2021-01-04T17:19:13.66,7,,0.0
2020,17,3033,870,17,7687,2,13,10,6,6,0,6,0,6,0,False,False,False,0,3,2021-02-23T20:43:32.217,6,,0.0
2020,17,3033,880,17,4383,2,2,9,4,5,1,5,0,5,0,False,True,True,0,2,2021-01-04T17:24:13.067,3,,0.0
2020,17,3033,885,4,7646,2,8,8,36,56,20,48,8,48,6,False,False,False,1,2,2021-01-04T17:28:54.52,56,,8.0
2020,17,3033,900,17,7618,2,48,10,-4,-1,3,-2,1,-2,0,False,False,False,0,1,2021-01-04T17:30:19.653,-1,,1.0
2020,17,3033,905,17,6276,2,39,4,6,7,1,6,1,6,0,False,False,False,0,3,2021-01-04T17:31:21.373,7,,1.0
2020,17,3033,910,17,6274,2,13,4,4,10,6,9,1,9,0,False,False,False,0,3,2021-01-04T17:32:18.5,10,,1.0
2020,17,3033,915,17,7618,2,48,9,-5,7,12,2,5,2,0,False,False,False,1,1,2021-01-04T17:33:22.4,7,,5.0
2020,17,3033,920,17,7687,2,2,4,4,9,5,5,4,5,0,False,False,False,1,3,2021-01-04T17:34:31.917,9,,4.0
2020,17,3033,925,17,7687,13,12,2,21,0,0,0,0,0,0,False,False,False,0,3,2021-01-04T17:36:47.85,0,,0.0
2020,17,3033,930,17,4752,2,8,7,17,18,1,17,1,17,0,False,False,False,0,2,2021-01-04T17:38:49.357,18,,1.0
2020,17,3033,935,17,7634,2,19,2,24,25,1,25,0,25,6,False,False,False,0,2,2021-01-05T21:44:43.66,25,,0.0
2020,17,3034,10,5,5220,13,5,5,4,0,0,0,0,0,0,False,False,False,0,3,2021-01-04T11:22:45.05,0,,0.0
2020,17,3034,30,20,213,2,4,5,5,8,3,7,1,7,0,False,False,False,0,2,2021-01-04T11:30:21.56,8,,1.0
2020,17,3034,55,20,7888,2,53,10,-4,5,9,5,0,5,0,False,False,False,0,4,2021-01-04T11:38:40.21,5,,0.0
2020,17,3034,60,20,4535,2,38,10,3,5,2,5,0,5,0,False,False,False,0,4,2021-01-05T21:56:26.64,5,,0.0
2020,17,3034,70,20,958,2,17,8,18,18,0,18,0,18,6,False,False,False,0,4,2021-01-05T16:33:04.763,18,,0.0
2020,17,3034,100,5,8195,2,5,5,3,4,1,4,0,4,0,False,False,False,0,1,2021-01-04T11:51:45.79,4,,0.0
2020,17,3034,105,5,4803,13,16,10,5,0,0,0,0,0,0,False,False,False,0,1,2021-01-04T11:54:38.897,0,,0.0
2020,17,3034,120,20,958,2,39,4,7,7,0,7,0,7,0,False,False,False,0,4,2021-01-07T19:40:03.493,7,,0.0
2020,17,3034,135,5,6425,2,30,9,-2,-1,1,-1,0,-1,0,False,False,False,0,4,2021-01-04T12:06:22.38,-1,,0.0
2020,17,3034,140,5,4803,2,4,4,7,8,1,8,0,8,0,False,False,False,0,3,2021-01-04T12:08:01.9,8,,0.0
2020,17,3034,145,5,4803,13,11,3,5,0,0,0,0,0,0,False,False,False,0,1,2021-01-04T12:10:00.663,0,,
2020,17,3034,150,5,5220,2,6,1,18,14,-4,18,-4,18,0,False,False,False,0,3,2021-01-04T12:13:29.937,14,,-4.0
2020,17,3034,160,5,4803,2,35,2,25,25,0,25,0,25,0,False,False,False,0,3,2021-01-04T12:17:52.563,25,,0.0
2020,17,3034,185,20,213,13,6,1,17,0,0,0,0,0,0,False,False,False,0,2,2021-01-04T12:27:42.693,0,,0.0
2020,17,3034,210,5,3389,2,46,3,2,9,7,7,2,7,0,False,False,False,0,3,2021-01-05T21:55:50.363,9,,2.0
2020,17,3034,220,5,4719,3,47,10,0,0,0,0,0,0,0,False,False,False,0,1,2021-01-04T12:40:54.657,0,,0.0
2020,17,3034,230,5,4803,2,2,9,6,8,2,8,0,8,0,True,False,False,0,3,2021-01-04T12:44:05.807,8,,0.0
2020,17,3034,235,5,4803,13,5,5,4,0,0,0,0,0,0,True,False,False,0,3,2021-01-04T12:47:22.057,0,,0.0
2020,17,3034,245,5,5220,13,7,6,30,0,0,0,0,0,0,False,False,False,0,3,2021-01-04T12:54:18.373,0,,0.0
2020,17,3034,250,5,4803,2,6,4,12,12,0,12,0,12,0,False,False,False,0,3,2021-01-04T12:59:37.06,12,,0.0
2020,17,3034,255,5,5220,13,8,8,18,0,0,0,0,0,0,False,False,False,0,3,2021-01-07T19:40:16.893,0,,0.0
2020,17,3034,280,20,213,2,2,4,8,8,0,8,0,8,6,False,False,False,0,3,2021-01-04T13:18:56.41,8,,0.0
2020,17,3034,300,5,4803,2,17,8,19,33,14,27,6,27,0,False,False,False,1,3,2021-01-04T13:26:45.07,33,,6.0
2020,17,3034,310,5,4803,2,2,9,11,13,2,11,2,11,0,True,False,False,0,3,2021-01-04T17:00:32.977,13,,
2020,17,3034,315,5,3389,13,12,2,19,0,0,0,0,0,0,False,False,False,0,2,2021-01-04T13:34:32.397,0,,0.0
2020,17,3034,320,5,4803,2,2,4,6,9,3,9,0,9,0,False,False,False,0,3,2021-01-05T16:34:59.47,9,,0.0
2020,17,3034,340,5,5220,13,2,10,8,0,0,0,0,0,0,False,False,False,0,3,2021-01-04T13:41:59.827,0,,0.0
2020,17,3034,345,5,5220,2,50,9,-3,3,6,2,1,2,0,False,False,False,0,3,2021-01-04T13:44:08.473,3,,1.0
2020,17,3034,360,20,213,2,49,10,-2,5,7,3,2,3,0,False,False,False,0,3,2021-01-04T13:49:07.073,5,,2.0
2020,17,3034,365,20,213,2,5,5,5,5,0,5,0,5,0,False,False,False,0,3,2021-01-05T21:56:40.623,5,,0.0
2020,17,3034,375,20,213,2,4,9,3,9,6,8,1,8,0,False,False,False,0,3,2021-01-04T13:56:39.447,9,,1.0
2020,17,3034,380,20,958,2,39,4,5,8,3,7,1,7,0,False,False,False,0,4,2021-01-07T19:40:30.22,8,,1.0
2020,17,3034,385,20,958,2,39,4,7,10,3,9,1,9,0,False,False,False,0,3,2021-01-04T14:05:48.55,10,,1.0
2020,17,3034,390,20,7356,2,17,8,15,17,2,15,2,15,0,False,False,False,1,3,2021-01-04T14:08:31.503,17,,2.0
2020,17,3034,400,20,213,2,39,4,4,9,5,7,2,7,0,False,False,False,0,3,2021-01-04T14:10:48.99,9,,2.0
2020,17,3034,405,20,2408,13,4,4,2,0,0,0,0,0,0,False,False,False,0,1,2021-01-05T21:56:54.663,0,,0.0
2020,17,3034,410,20,958,13,6,9,14,0,0,0,0,0,0,False,False,False,0,2,2021-01-04T14:14:59.157,0,,0.0
2020,17,3034,430,20,213,13,4,10,14,0,0,0,0,0,0,False,False,False,0,3,2021-01-04T14:25:09.637,0,,0.0
2020,17,3034,435,20,8131,2,9,2,21,27,6,22,5,22,0,False,False,False,0,2,2021-01-04T14:26:48.967,27,,5.0
2020,17,3034,460,20,8131,13,26,9,5,0,0,0,0,0,0,False,False,False,0,3,2021-01-04T14:39:43.907,0,,0.0
2020,17,3034,475,5,3477,2,6,9,4,8,4,7,1,7,0,False,False,False,0,2,2021-01-04T14:43:05.587,8,,1.0
2020,17,3034,490,5,5220,2,8,7,43,44,1,44,0,44,0,False,False,False,0,3,2021-01-07T19:29:58.94,44,,0.0
2020,17,3034,495,5,6425,13,7,2,19,0,0,0,0,0,0,True,False,False,0,3,2021-01-05T21:56:01.877,0,,0.0
2020,17,3034,505,20,213,13,2,10,9,0,0,0,0,0,0,False,False,False,0,2,2021-01-04T14:56:50.32,0,,0.0
2020,17,3034,510,20,8131,2,2,9,6,18,12,16,2,16,0,False,False,False,0,2,2021-01-04T15:01:02.607,18,,2.0
2020,17,3034,520,20,2408,2,45,5,-5,2,7,0,2,0,0,False,False,False,0,1,2021-01-04T15:05:00.293,2,,2.0
2020,17,3034,525,20,213,3,29,6,15,0,0,0,0,0,0,False,False,False,0,3,2021-01-04T15:06:44.047,0,,0.0
2020,17,3034,540,5,4803,13,2,4,4,0,0,0,0,0,0,False,False,False,0,3,2021-01-04T15:11:42.15,0,,0.0
2020,17,3034,545,5,4803,3,2,4,9,0,0,0,0,0,0,False,False,False,0,3,2021-03-04T21:35:43.493,0,,0.0
2020,17,3034,580,5,5220,13,5,5,13,0,0,0,0,0,0,False,False,False,0,3,2021-01-04T15:32:12.467,0,,0.0
2020,17,3034,585,5,3477,3,5,5,13,0,0,0,0,0,0,False,False,False,0,3,2021-02-23T20:09:16.513,0,,0.0
2020,17,3034,590,5,3477,13,8,6,27,0,0,0,0,0,0,False,False,False,0,2,2021-01-04T15:33:51.577,0,,0.0
2020,17,3034,605,20,213,2,4,3,4,4,0,4,0,4,0,False,False,False,0,2,2021-01-04T15:40:08.703,4,,0.0
2020,17,3034,615,20,213,2,4,10,9,9,0,9,0,9,0,False,False,False,0,3,2021-01-04T15:42:54.447,9,,0.0
2020,17,3034,625,20,8131,2,4,9,8,6,-2,6,0,6,0,False,False,False,0,2,2021-01-05T21:57:09.407,6,,0.0
2020,17,3034,640,20,4828,2,17,4,11,11,0,11,0,11,6,False,False,False,0,4,2021-01-05T16:36:43.5,11,,0.0
2020,17,3034,675,5,4803,2,35,8,21,23,2,23,0,23,0,True,False,False,0,4,2021-01-04T16:02:29.657,23,,0.0
2020,17,3034,685,5,3477,13,24,3,12,0,0,0,0,0,0,False,False,False,0,3,2021-01-04T16:08:11.57,0,,0.0
2020,17,3034,690,5,6425,13,12,9,10,0,0,0,0,0,0,False,False,False,0,3,2021-01-04T16:08:28.067,0,,0.0
2020,17,3034,695,5,3477,2,13,4,2,1,-1,1,0,1,0,False,False,False,0,3,2021-01-04T16:09:57.857,1,,0.0
2020,17,3034,705,20,8127,2,18,5,-2,4,6,2,2,2,0,False,False,False,0,2,2021-01-04T16:14:20.867,4,,2.0
2020,17,3034,715,20,213,2,49,9,-3,6,9,6,0,6,0,False,False,False,0,2,2021-01-04T16:17:11.803,6,,0.0
2020,17,3034,730,5,3477,2,9,2,27,31,4,28,3,28,0,False,False,False,0,2,2021-01-04T16:24:54.433,31,,3.0
2020,17,3034,740,5,5220,2,6,8,17,22,5,22,0,22,0,False,False,False,0,2,2021-01-04T16:27:56.377,22,,0.0
2020,17,3034,745,5,5220,2,4,9,14,18,4,16,2,16,0,False,False,False,0,3,2021-01-04T16:29:33.6,18,,2.0
2020,17,3034,755,5,3477,13,17,1,30,0,0,0,0,0,0,False,False,False,0,3,2021-01-04T16:34:56.13,0,,0.0
2020,17,3034,780,5,5220,13,19,8,58,0,0,0,0,0,0,False,False,False,0,2,2021-01-04T16:48:17.017,0,,0.0
2020,17,3035,15,6,7725,2,34,4,-4,6,10,6,0,6,0,True,False,False,0,3,2021-03-04T19:09:25.98,6,,0.0
2020,17,3035,25,6,7728,2,32,3,2,7,5,5,2,5,0,False,False,False,0,4,2021-01-04T17:12:17.91,7,,2.0
2020,17,3035,30,6,7725,13,5,6,20,0,0,0,0,0,0,False,False,False,0,3,2021-01-04T13:21:21.437,0,,0.0
2020,17,3035,55,6,6328,2,2,9,4,7,3,7,0,7,0,False,False,False,0,3,2021-01-04T13:30:39.9,7,,0.0
2020,17,3035,70,6,7728,2,55,4,-2,8,10,3,5,3,0,False,False,False,0,4,2021-01-04T13:35:15.85,8,,5.0
2020,17,3035,95,12,6357,2,12,10,12,15,3,14,1,14,0,False,False,False,0,3,2021-01-05T22:43:49.08,15,,1.0
2020,17,3035,100,12,556,2,2,10,6,9,3,8,1,8,0,False,False,False,0,3,2021-01-04T13:45:24.267,9,,1.0
2020,17,3035,115,12,4537,2,28,5,-5,3,8,0,3,0,0,False,False,False,0,1,2021-01-04T13:48:26.693,3,,3.0
2020,17,3035,120,12,4537,2,28,10,0,15,15,3,12,3,0,False,False,False,3,1,2021-01-07T13:14:21.49,15,,12.0
2020,17,3035,140,12,556,13,9,2,23,0,0,0,0,0,0,False,False,False,0,3,2021-01-04T14:17:55.027,0,,
2020,17,3035,155,12,4511,2,35,9,3,3,0,3,0,3,6,False,False,False,0,4,2021-01-04T14:20:15.707,3,,0.0
2020,17,3035,170,6,7728,2,30,10,-1,7,8,4,3,4,0,False,False,False,0,4,2021-01-04T14:24:48.917,7,,3.0
2020,17,3035,185,6,7725,13,6,3,4,0,0,0,0,0,0,False,False,False,0,2,2021-01-04T14:29:14.527,0,,0.0
2020,17,3035,190,6,6786,2,48,9,-6,5,11,1,4,1,0,False,False,False,1,1,2021-01-04T17:12:52.51,5,,4.0
2020,17,3035,205,6,7725,2,30,10,-1,5,6,4,1,4,0,False,False,False,0,3,2021-01-05T16:05:51.473,5,,1.0
2020,17,3035,230,12,957,2,45,5,-6,7,13,1,6,1,0,True,False,False,1,3,2021-01-07T13:14:33.843,7,,6.0
2020,17,3035,240,12,6357,2,19,8,28,72,44,72,0,72,6,False,False,False,0,3,2021-01-07T12:28:52.613,72,,0.0
2020,17,3035,260,6,7728,2,30,5,-1,1,2,1,0,1,0,False,True,True,0,4,2021-01-04T17:09:04.593,-2,False,0.0
2020,17,3035,265,12,467,2,32,10,1,11,10,10,1,10,0,False,False,False,0,4,2021-01-04T17:15:58.927,9,,1.0
2020,17,3035,280,12,556,2,2,10,7,9,2,8,1,8,0,False,False,False,0,3,2021-01-04T14:54:39.613,9,,1.0
2020,17,3035,290,12,467,13,36,9,7,0,0,0,0,0,0,False,False,False,0,3,2021-01-07T13:13:51.817,0,,
2020,17,3035,300,12,8279,2,35,9,13,13,0,13,0,13,6,False,False,False,0,3,2021-01-07T12:28:52.613,13,,0.0
2020,17,3035,320,6,6328,2,4,9,5,6,1,5,1,5,0,False,False,False,1,3,2021-01-04T15:02:32.777,6,,1.0
2020,17,3035,325,6,7728,2,39,4,5,6,1,6,0,6,0,False,False,False,0,3,2021-01-04T15:03:42.14,6,,0.0
2020,17,3035,345,6,7725,2,46,3,1,1,0,1,0,1,0,False,False,False,0,3,2021-01-04T15:06:42.263,1,,0.0
2020,17,3035,355,6,6786,2,46,3,0,0,0,0,0,0,0,False,True,True,0,6,2021-01-04T17:10:04.253,0,,
2020,17,3035,360,6,7725,2,4,9,4,5,1,5,0,5,0,False,False,False,0,2,2021-01-04T15:10:22.407,5,,0.0
2020,17,3035,380,6,6786,2,4,10,1,14,13,5,9,5,0,False,False,False,2,1,2021-01-04T17:13:07.61,14,,9.0
2020,17,3035,385,6,6786,2,16,9,2,10,8,8,2,8,0,False,False,False,0,1,2021-01-04T17:13:19.74,10,,2.0
2020,17,3035,400,6,464,13,5,9,9,0,0,0,0,0,0,False,False,False,0,3,2021-01-04T15:16:43.517,0,,0.0
2020,17,3035,430,12,4511,2,32,3,3,15,12,12,3,12,0,False,False,False,0,4,2021-01-04T15:33:31.88,15,,3.0
2020,17,3035,435,12,6357,3,8,8,40,0,0,0,0,0,0,False,False,False,0,2,2021-02-23T20:24:12.75,0,,0.0
2020,17,3035,445,12,6356,13,3,2,20,0,0,0,0,0,0,False,False,False,0,3,2021-01-05T00:00:18.077,0,,0.0
2020,17,3035,460,6,7725,2,4,3,1,5,4,4,1,4,0,False,False,False,0,2,2021-01-04T15:44:56.273,5,,1.0
2020,17,3035,470,6,666,2,32,10,-1,2,3,-1,3,-1,0,True,False,False,0,3,2021-01-05T16:06:07.473,2,,3.0
2020,17,3035,475,6,7728,2,46,3,1,11,10,8,3,8,0,False,False,False,1,3,2021-01-04T15:48:39.32,11,,3.0
2020,17,3035,480,6,7725,2,51,10,-2,2,4,-1,3,-1,0,False,False,False,0,3,2021-01-04T15:52:03.81,2,,3.0
2020,17,3035,485,6,7725,2,23,7,50,53,3,53,0,53,0,False,False,False,0,2,2021-01-04T15:53:36.497,53,,0.0
2020,17,3035,495,6,7725,2,51,9,-2,3,5,2,1,2,0,False,False,False,0,3,2021-01-04T15:57:36.35,3,,1.0
2020,17,3035,500,6,6786,2,5,10,2,5,3,3,2,3,0,False,False,False,0,1,2021-01-04T17:13:34.603,5,,2.0
2020,17,3035,520,12,6691,13,12,10,11,0,0,0,0,0,0,False,False,False,0,3,2021-01-04T16:04:57.987,0,,0.0
2020,17,3035,525,12,4537,13,51,3,-3,0,0,0,0,0,0,False,False,False,0,1,2021-01-04T16:06:17.38,0,,0.0
2020,17,3035,535,6,7725,2,6,9,5,5,0,5,0,5,0,False,False,False,0,2,2021-01-04T16:09:56.843,5,,0.0
2020,17,3035,545,6,464,2,4,3,6,14,8,11,3,11,0,False,False,False,1,2,2021-01-04T16:12:27.163,14,,3.0
2020,17,3035,550,6,6786,2,46,3,1,2,1,2,0,2,0,False,False,False,0,1,2021-01-04T17:13:50.017,2,,0.0
2020,17,3035,565,6,7725,2,47,5,1,2,1,2,0,2,0,True,False,False,0,3,2021-01-04T16:23:10.983,2,,0.0
2020,17,3035,575,6,6331,13,43,8,18,0,0,0,0,0,0,False,False,False,0,3,2021-01-07T13:14:05.283,0,,0.0
2020,17,3035,605,6,7725,2,30,3,0,6,6,0,6,0,0,False,False,False,3,4,2021-03-03T15:48:41.75,6,,6.0
2020,17,3035,615,6,464,13,5,5,4,0,0,0,0,0,0,False,False,False,0,3,2021-01-04T16:33:28.967,0,,0.0
2020,17,3035,620,12,556,2,2,9,6,6,0,6,0,6,0,False,False,False,0,3,2021-01-04T16:34:46.083,6,,0.0
2020,17,3035,625,12,556,2,13,10,2,7,5,7,0,7,0,False,False,False,0,3,2021-01-05T00:03:28.27,7,,0.0
2020,17,3035,635,12,6691,13,12,6,18,0,0,0,0,0,0,False,False,False,0,3,2021-01-04T16:39:17.647,0,,0.0
2020,17,3035,640,12,556,2,2,10,5,9,4,8,1,8,0,True,False,False,0,3,2021-01-04T16:40:49.873,9,,1.0
2020,17,3035,645,12,4537,2,51,3,-4,8,12,5,3,5,0,True,False,False,0,1,2021-01-04T16:45:22.4,8,,3.0
2020,17,3035,650,12,6691,2,30,5,-1,3,4,2,1,2,0,True,False,False,0,3,2021-01-04T16:43:16.25,3,,1.0
2020,17,3035,660,12,4537,2,51,3,-4,17,21,13,4,13,0,True,False,False,0,1,2021-01-04T16:45:12.88,17,,4.0
2020,17,3035,670,12,6691,2,13,10,3,14,11,12,2,12,0,False,False,False,0,3,2021-01-04T16:47:33.003,14,,2.0
2020,17,3035,690,6,6786,2,4,4,2,4,2,4,0,4,0,False,False,False,0,1,2021-01-04T16:50:57.923,4,,0.0
2020,17,3035,695,6,7728,13,17,1,21,0,0,0,0,0,0,False,False,False,0,3,2021-01-04T16:52:04.923,0,,0.0
2020,17,3035,720,12,556,2,2,10,6,6,0,6,0,6,6,False,False,False,0,2,2021-01-04T16:55:53.117,6,,0.0
2020,17,3035,735,6,464,13,4,9,5,0,0,0,0,0,0,False,False,False,0,3,2021-01-04T16:57:19.867,0,,0.0
2020,17,3035,745,6,6786,2,16,10,5,12,7,5,7,5,0,False,False,False,1,1,2021-01-04T16:58:47.987,12,,7.0
2020,17,3035,750,6,6331,13,19,2,40,0,0,0,0,0,0,False,False,False,0,2,2021-01-04T16:59:44.66,0,,0.0
2020,17,3035,765,6,7728,2,32,3,1,4,3,4,0,4,0,False,False,False,0,4,2021-01-04T17:01:19.333,4,,0.0
2020,17,3035,770,6,464,2,19,6,18,23,5,20,3,20,0,False,False,False,0,2,2021-01-04T17:02:23.453,23,,3.0
2020,17,3035,775,6,6786,2,4,4,2,6,4,3,3,3,0,False,False,False,0,1,2021-01-04T17:03:21.487,6,,3.0
2020,17,3035,780,6,6786,2,16,10,2,5,3,3,2,3,0,False,False,False,0,1,2021-01-04T17:03:59.813,5,,2.0
2020,17,3035,790,6,666,2,4,5,3,3,0,3,0,3,0,False,False,False,0,2,2021-02-23T20:25:53.57,3,,0.0
2020,17,3036,15,3,6454,2,46,3,0,5,5,5,0,5,0,False,False,False,0,4,2021-01-05T06:03:08.827,5,,0.0
2020,17,3036,55,3,6659,2,30,10,-1,10,11,7,3,7,0,False,False,False,0,1,2021-01-04T11:25:08.433,10,,3.0
2020,17,3036,60,3,6935,13,8,1,18,0,0,0,0,0,0,False,False,False,0,3,2021-01-04T11:27:07.8,0,,0.0
2020,17,3036,85,7,910,13,2,9,4,0,0,0,0,0,0,False,False,False,0,2,2021-01-07T17:11:59.53,0,,0.0
2020,17,3036,90,7,7659,2,2,9,2,41,39,38,3,38,0,False,False,False,0,2,2021-01-07T17:01:25.927,41,,
2020,17,3036,95,7,6975,13,2,4,9,0,0,0,0,0,0,False,False,False,0,3,2021-01-04T21:37:15.387,0,,0.0
2020,17,3036,105,3,6936,3,8,2,47,0,0,0,0,0,0,False,False,False,0,3,2021-01-07T17:01:41.223,0,,0.0
2020,17,3036,130,3,6935,2,8,1,36,43,7,43,0,43,6,False,False,False,0,2,2021-01-04T11:47:39.28,43,,0.0
2020,17,3036,150,7,3521,2,51,9,-1,1,2,0,1,0,0,True,False,False,0,3,2021-01-04T11:50:59.807,1,,1.0
2020,17,3036,155,7,4341,13,6,3,4,0,0,0,0,0,0,False,False,False,0,2,2021-01-04T11:52:09.167,0,,0.0
2020,17,3036,190,3,6454,13,4,4,12,0,0,0,0,0,0,False,False,False,0,3,2021-01-07T17:44:58.323,0,,0.0
2020,17,3036,195,3,7672,13,6,9,6,0,0,0,0,0,0,False,False,False,0,3,2021-03-04T21:50:09.97,0,,0.0
2020,17,3036,205,7,4716,13,12,10,10,0,0,0,0,0,0,False,False,False,0,4,2021-01-04T12:07:48.193,0,,0.0
2020,17,3036,210,7,931,13,21,6,30,0,0,0,0,0,0,False,False,False,0,2,2021-01-04T12:09:08.03,0,,0.0
2020,17,3036,220,3,6936,2,18,3,-1,5,6,3,2,3,0,False,False,False,0,2,2021-01-05T06:02:51.67,5,,2.0
2020,17,3036,240,3,6454,13,5,6,16,0,0,0,0,0,0,False,False,False,0,3,2021-01-07T17:15:12.827,0,,0.0
2020,17,3036,270,3,6936,13,18,9,-1,0,0,0,0,0,0,False,False,False,0,2,2021-01-07T17:15:37.743,0,,0.0
2020,17,3036,280,3,6936,2,5,5,4,7,3,5,2,5,0,False,False,False,0,3,2021-01-07T17:47:05.28,7,,2.0
2020,17,3036,285,3,6454,2,47,5,0,9,9,8,1,8,0,False,False,False,0,4,2021-01-04T12:31:09.627,9,,1.0
2020,17,3036,300,3,6454,13,12,2,18,0,0,0,0,0,0,False,False,False,0,4,2021-01-04T12:35:53.777,0,,0.0
2020,17,3036,305,3,6936,2,8,1,18,18,0,18,0,18,6,False,False,False,0,3,2021-01-07T17:12:18.947,18,,0.0
2020,17,3036,320,7,6975,2,32,5,0,8,8,2,6,2,0,False,False,False,0,4,2021-01-04T12:40:34.613,8,,6.0
2020,17,3036,330,7,4716,2,5,8,17,21,4,18,3,18,0,True,False,False,0,4,2021-01-04T14:22:42.54,21,,3.0
2020,17,3036,350,7,4341,2,2,9,3,8,5,4,4,4,0,False,False,False,0,2,2021-01-30T00:29:52.983,8,,4.0
2020,17,3036,385,7,6975,2,30,10,-2,7,9,5,2,5,0,True,False,False,1,4,2021-01-04T12:56:31.74,7,,2.0
2020,17,3036,405,7,910,13,5,3,6,0,0,0,0,0,0,False,False,False,0,3,2021-01-04T13:01:00.253,0,,0.0
2020,17,3036,410,7,910,13,19,2,23,0,0,0,0,0,0,False,False,False,0,2,2021-01-04T13:03:08.073,0,,0.0
2020,17,3036,465,7,910,13,12,2,19,0,0,0,0,0,0,False,False,False,0,2,2021-01-04T13:14:53.623,0,,0.0
2020,17,3036,480,3,6936,13,2,4,10,0,0,0,0,0,0,False,False,False,0,3,2021-01-04T13:20:07.84,0,,0.0
2020,17,3036,515,3,6454,2,30,3,0,5,5,5,0,5,0,False,False,False,0,1,2021-01-07T17:12:27.46,5,,0.0
2020,17,3036,520,3,6936,2,18,3,-2,2,4,0,2,0,0,False,False,False,0,2,2021-01-07T17:16:46.24,2,,2.0
2020,17,3036,525,3,6936,2,35,5,9,9,0,9,0,9,6,False,False,False,0,3,2021-01-07T17:12:34.36,9,,0.0
2020,17,3036,545,7,910,13,29,6,17,0,0,0,0,0,0,False,False,False,0,2,2021-01-04T13:35:52.187,0,,
2020,17,3036,550,7,910,13,2,4,4,0,0,0,0,0,0,False,False,False,0,3,2021-01-04T13:37:54.513,0,,
2020,17,3036,555,7,910,13,13,9,1,0,0,0,0,0,0,False,False,False,0,3,2021-01-04T13:39:14.173,0,,0.0
2020,17,3036,590,7,6985,2,48,9,-7,3,10,-1,4,-1,0,False,False,False,0,1,2021-01-04T13:45:41.623,3,,4.0
2020,17,3036,605,3,6454,2,5,5,5,8,3,7,1,7,0,False,False,False,0,3,2021-01-04T13:47:34.783,8,,1.0
2020,17,3036,655,7,910,13,4,5,7,0,0,0,0,0,0,False,False,False,0,2,2021-01-07T17:53:24.55,0,,0.0
2020,17,3036,660,7,3521,3,5,6,15,0,0,0,0,0,0,False,False,False,0,2,2021-01-04T14:01:11.74,0,,0.0
2020,17,3036,700,7,4341,13,4,10,6,0,0,0,0,0,0,False,False,False,0,3,2021-01-04T14:10:32.217,0,,0.0
2020,17,3036,715,7,910,13,20,2,22,0,0,0,0,0,0,False,False,False,0,2,2021-01-04T14:13:56.023,0,,0.0
2020,17,3037,20,25,7666,2,2,9,6,13,7,10,3,10,0,False,False,False,0,2,2021-01-07T15:13:48.637,13,,3.0
2020,17,3037,25,25,4583,2,51,5,0,5,5,2,3,2,0,False,False,False,0,3,2021-01-04T11:21:07.62,5,,3.0
2020,17,3037,30,25,4587,13,12,4,3,0,0,0,0,0,0,False,False,False,0,1,2021-03-08T17:07:34.943,0,,0.0
2020,17,3037,35,25,4583,13,13,10,3,0,0,0,0,0,0,False,False,False,0,3,2021-01-07T15:06:32.863,0,,0.0
2020,17,3037,55,8,232,2,6,4,6,14,8,10,4,10,0,False,False,False,0,3,2021-01-05T18:20:57.423,14,,4.0
2020,17,3037,60,8,3883,3,6,9,5,0,0,0,0,0,0,False,False,False,0,3,2021-01-05T18:21:06.71,0,,0.0
2020,17,3037,65,8,3883,2,5,5,5,10,5,8,2,8,0,False,False,False,0,3,2021-01-04T11:36:55.577,10,,2.0
2020,17,3037,90,25,6259,2,34,4,-4,-3,1,-2,-1,-2,0,True,False,False,0,2,2021-01-04T11:43:01.76,-3,,-1.0
2020,17,3037,95,25,181,2,4,10,5,9,4,7,2,7,0,False,False,False,0,4,2021-01-07T15:06:43.053,9,,2.0
2020,17,3037,110,8,4976,13,6,9,13,0,0,0,0,0,0,False,False,False,0,4,2021-01-04T11:48:33.82,0,,0.0
2020,17,3037,115,8,7651,2,46,3,5,11,6,11,0,11,0,False,False,False,0,3,2021-01-07T15:06:51.78,11,,0.0
2020,17,3037,125,8,3883,2,2,9,12,12,0,12,0,12,0,False,False,False,0,3,2021-01-04T11:54:11.683,12,,0.0
2020,17,3037,140,8,7651,13,5,3,9,0,0,0,0,0,0,False,False,False,0,2,2021-01-04T11:59:03.25,0,,0.0
2020,17,3037,145,8,5053,2,5,9,3,4,1,3,1,3,0,False,False,False,0,1,2021-01-04T12:01:17.193,4,,1.0
2020,17,3037,165,25,6486,3,5,5,9,0,0,0,0,0,0,False,False,False,0,3,2021-01-04T12:26:18.78,0,,0.0
2020,17,3037,170,25,4587,2,48,9,-4,2,6,-6,8,-6,0,False,False,False,1,1,2021-01-07T15:08:25.357,2,,8.0
2020,17,3037,175,25,7666,2,5,3,9,9,0,9,0,9,0,True,False,False,0,3,2021-01-05T18:21:53.147,9,,0.0
2020,17,3037,190,25,7666,13,19,8,32,0,0,0,0,0,0,False,False,False,0,2,2021-01-06T00:34:22.52,0,,0.0
2020,17,3037,215,8,3606,2,21,2,22,42,20,40,2,40,0,False,False,False,0,2,2021-03-09T18:40:25.517,42,,2.0
2020,17,3037,220,8,232,13,8,7,15,0,0,0,0,0,0,False,False,False,0,3,2021-03-09T18:40:17.82,0,,0.0
2020,17,3037,225,8,232,2,2,4,8,11,3,9,2,9,0,False,False,False,0,3,2021-01-04T12:42:18.797,11,,2.0
2020,17,3037,240,8,4976,13,5,5,4,0,0,0,0,0,0,False,False,False,0,4,2021-02-25T17:31:44.387,0,,0.0
2020,17,3037,250,8,4976,13,36,10,4,0,0,0,0,0,0,False,False,False,0,3,2021-01-06T00:30:38.12,0,,0.0
2020,17,3037,280,25,7666,13,29,3,14,0,0,0,0,0,0,False,False,False,0,2,2021-03-09T18:41:22.357,0,,0.0
2020,17,3037,290,25,7060,2,19,2,33,41,8,38,3,38,0,False,False,False,0,2,2021-01-05T18:23:03.797,41,,3.0
2020,17,3037,300,25,6259,2,34,4,-4,0,4,-5,5,-5,0,True,False,False,0,2,2021-01-04T13:14:21.77,0,,5.0
2020,17,3037,305,25,4587,2,48,4,0,1,1,1,0,1,0,False,False,False,0,1,2021-01-07T15:07:49.473,1,,0.0
2020,17,3037,310,25,4587,13,28,10,3,0,0,0,0,0,0,False,False,False,0,1,2021-01-04T13:17:51.09,0,,0.0
2020,17,3037,360,25,4583,2,4,9,11,12,1,11,1,11,0,False,False,False,0,3,2021-01-04T13:33:09.117,12,,1.0
2020,17,3037,370,25,4583,2,12,10,3,3,0,3,0,3,0,False,False,False,0,2,2021-01-04T13:35:13.737,3,,
2020,17,3037,375,25,4587,3,5,9,-2,0,0,0,0,0,0,False,False,False,0,1,2021-01-07T15:18:55.06,0,,0.0
2020,17,3037,380,25,4587,2,46,3,1,11,10,7,4,7,0,False,False,False,0,1,2021-01-04T13:38:51.827,11,,4.0
2020,17,3037,385,25,4583,2,2,9,9,26,17,11,15,11,0,True,False,False,0,3,2021-01-05T20:16:55.99,26,,15.0
2020,17,3037,390,25,181,2,46,3,2,5,3,4,1,4,0,False,False,False,0,4,2021-01-04T13:43:34.11,5,,1.0
2020,17,3037,425,8,7651,13,8,4,12,0,0,0,0,0,0,False,False,False,0,3,2021-01-04T13:51:43.867,0,,0.0
2020,17,3037,470,8,6439,13,9,2,21,0,0,0,0,0,0,False,False,False,0,2,2021-01-05T18:23:17.44,0,,0.0
2020,17,3037,475,8,232,2,5,10,5,5,0,5,0,5,0,False,False,False,0,3,2021-01-04T14:11:01.43,5,,0.0
2020,17,3037,485,8,232,2,6,4,5,14,9,12,2,12,0,False,False,False,1,3,2021-01-04T14:14:33.043,14,,2.0
2020,17,3037,505,25,4587,2,47,5,0,3,3,2,1,2,0,False,False,False,0,1,2021-01-06T00:44:16.317,3,,1.0
2020,17,3037,515,25,7666,2,19,6,35,41,6,37,4,37,0,False,False,False,0,2,2021-01-04T16:25:18.143,41,,4.0
2020,17,3037,525,25,7060,13,29,6,19,0,0,0,0,0,0,False,False,False,0,2,2021-01-04T14:38:54.223,0,,0.0
2020,17,3037,530,25,4587,2,4,4,1,8,7,2,6,2,0,False,False,False,1,1,2021-01-06T00:44:48.717,8,,6.0
2020,17,3037,545,8,3606,2,4,10,12,13,1,13,0,13,0,False,False,False,0,2,2021-01-04T16:25:51.95,13,,0.0
2020,17,3037,560,8,4976,2,4,9,8,14,6,9,5,9,0,False,False,False,0,3,2021-01-04T14:48:20.89,14,,5.0
2020,17,3037,575,8,6633,2,12,3,10,10,0,10,0,10,0,True,False,False,0,3,2021-03-09T18:44:21.063,10,,0.0
2020,17,3037,580,8,3883,2,13,9,2,2,0,2,0,2,6,False,False,False,0,4,2021-01-04T14:54:56.473,2,,0.0
2020,17,3037,595,25,4583,2,4,9,3,7,4,5,2,5,0,False,False,False,0,3,2021-01-04T14:58:22.097,7,,2.0
2020,17,3037,615,25,4583,13,4,9,8,0,0,0,0,0,0,False,False,False,0,3,2021-03-04T21:40:59.04,0,,0.0
2020,17,3037,625,8,4976,2,12,5,0,-1,-1,-1,0,-1,0,False,False,False,0,3,2021-01-07T15:07:06.14,-1,,0.0
2020,17,3037,630,8,6633,2,8,4,14,15,1,15,0,15,0,False,False,False,0,3,2021-03-09T18:44:57.933,15,,0.0
2020,17,3037,655,25,181,2,47,5,2,14,12,7,7,7,0,True,False,False,0,4,2021-01-07T15:08:48.84,14,,7.0
2020,17,3037,670,25,7666,13,2,9,9,0,0,0,0,0,0,False,False,False,0,2,2021-01-06T00:37:55.093,0,,0.0
2020,17,3037,675,25,7666,2,39,9,5,10,5,7,3,7,0,False,False,False,1,3,2021-03-03T15:53:59.377,10,,3.0
2020,17,3037,685,25,181,2,55,4,-2,3,5,1,2,1,0,False,False,False,0,4,2021-01-04T15:26:54.303,3,,2.0
2020,17,3037,690,25,7073,13,5,9,3,0,0,0,0,0,0,True,False,False,0,4,2021-01-07T15:07:23.573,0,,0.0
2020,17,3037,695,25,7060,2,4,3,8,8,0,8,0,8,0,False,False,False,0,2,2021-01-04T15:30:02.783,8,,0.0
2020,17,3037,700,25,7666,13,17,8,28,0,0,0,0,0,0,True,False,False,0,3,2021-01-06T00:38:51.413,0,,0.0
2020,17,3037,705,25,6486,13,12,6,28,0,0,0,0,0,0,False,False,False,0,2,2021-01-07T15:07:30.96,0,,0.0
2020,17,3037,715,25,7666,13,5,5,14,0,0,0,0,0,0,True,False,False,0,3,2021-01-04T15:36:47.533,0,,0.0
2020,17,3037,720,25,7666,2,9,2,28,28,0,28,0,28,6,False,False,False,0,2,2021-01-06T00:40:19.567,28,,0.0
2020,17,3037,735,8,3883,2,2,9,12,13,1,13,0,13,0,False,False,False,0,3,2021-01-05T18:24:36.333,13,,0.0
2020,17,3037,745,8,232,2,4,4,4,7,3,6,1,6,0,False,False,False,0,3,2021-01-04T15:44:19.873,7,,1.0
2020,17,3037,780,8,3606,13,5,10,10,0,0,0,0,0,0,False,False,False,0,3,2021-01-04T15:56:17.867,0,,0.0
2020,17,3037,785,25,181,3,47,10,1,0,0,0,0,0,0,False,False,False,0,4,2021-01-04T15:57:45.66,0,,0.0
2020,17,3037,790,25,7666,13,9,2,26,0,0,0,0,0,0,False,False,False,0,2,2021-01-04T15:59:08.45,0,,0.0
2020,17,3037,795,25,4583,2,12,3,12,13,1,13,0,13,0,False,False,False,0,3,2021-03-09T18:47:05.633,13,,0.0
2020,17,3037,805,25,7060,2,19,7,45,47,2,47,0,47,0,False,False,False,0,3,2021-01-04T16:05:11.98,47,,0.0
2020,17,3037,820,25,181,2,55,4,-4,2,6,0,2,0,0,False,False,False,0,4,2021-01-04T16:07:52.76,2,,2.0
2020,17,3037,825,25,4583,2,2,4,2,2,0,2,0,2,6,False,False,False,0,3,2021-01-04T16:08:51.44,2,,0.0
2020,17,3038,10,18,4152,2,31,4,5,14,9,10,4,10,0,False,False,False,0,4,2021-01-04T10:52:38.033,14,,4.0
2020,17,3038,15,18,1381,2,39,10,5,5,0,4,1,4,0,False,False,False,0,3,2021-01-07T18:05:07.68,5,,
2020,17,3038,25,18,6706,13,2,10,6,0,0,0,0,0,0,False,False,False,0,3,2021-01-04T11:02:14.057,0,,0.0
2020,17,3038,30,18,6361,13,13,9,5,0,0,0,0,0,0,False,False,False,0,4,2021-01-07T16:42:39.12,0,,0.0
2020,17,3038,45,11,7732,2,45,5,-4,-1,3,-2,1,-2,0,False,False,False,0,1,2021-01-04T11:21:04.143,-1,,1.0
2020,17,3038,50,11,100,13,8,1,19,0,0,0,0,0,0,True,False,False,0,3,2021-01-04T11:24:41.863,0,,0.0
2020,17,3038,70,18,566,2,18,3,-2,6,8,3,3,3,0,True,False,False,0,2,2021-01-07T18:07:07.927,6,,3.0
2020,17,3038,80,18,6361,13,13,5,5,0,0,0,0,0,0,False,False,False,0,4,2021-01-07T18:07:35.52,0,,0.0
2020,17,3038,90,18,7711,13,4,4,13,0,0,0,0,0,0,False,False,False,0,3,2021-01-04T11:53:54.063,0,,0.0
2020,17,3038,100,11,6810,2,26,9,5,9,4,9,0,9,0,False,False,False,0,3,2021-01-06T03:01:19.3,9,,0.0
2020,17,3038,110,11,914,2,8,7,22,23,1,23,0,23,0,False,False,False,0,3,2021-01-04T12:02:29.53,23,,0.0
2020,17,3038,130,11,914,2,7,2,41,43,2,42,1,42,6,False,False,False,0,3,2021-01-04T12:10:53.473,43,,1.0
2020,17,3038,150,18,7711,13,26,5,3,0,0,0,0,0,0,False,False,False,0,3,2021-02-23T19:09:37.54,0,,0.0
2020,17,3038,155,18,7711,2,2,10,10,13,3,11,2,11,0,False,False,False,0,3,2021-01-04T12:19:57.467,13,,2.0
2020,17,3038,160,18,6900,2,28,4,3,15,12,12,3,12,0,False,False,False,0,1,2021-01-04T12:22:04.427,15,,3.0
2020,17,3038,175,18,7711,2,26,9,3,9,6,7,2,7,0,False,True,False,1,3,2021-01-07T17:55:40.657,9,,2.0
2020,17,3038,180,18,6900,2,47,10,2,28,26,14,14,14,6,False,False,False,1,1,2021-01-04T12:30:04.233,28,,14.0
2020,17,3038,195,11,914,2,4,10,3,3,0,3,0,3,0,False,False,False,0,3,2021-01-04T12:32:53.667,3,,0.0
2020,17,3038,215,11,6810,2,8,9,12,15,3,14,1,14,0,False,False,False,0,4,2021-01-04T12:44:53.157,15,,1.0
2020,17,3038,225,11,7733,2,17,7,19,20,1,20,0,20,6,False,False,False,0,3,2021-01-04T12:48:05.497,20,,0.0
2020,17,3038,240,18,6907,2,17,1,18,25,7,23,2,23,0,False,False,False,0,4,2021-01-04T12:51:06.95,25,,2.0
2020,17,3038,245,18,6361,2,32,10,0,11,11,9,2,9,0,False,False,False,0,3,2021-01-07T18:03:54.913,11,,2.0
2020,17,3038,255,18,6361,2,2,9,12,19,7,16,3,16,0,False,False,False,0,4,2021-01-07T16:42:39.12,19,,3.0
2020,17,3038,260,18,1381,2,6,10,14,14,0,14,0,14,0,False,False,False,0,3,2021-01-04T13:00:51.043,14,,0.0
2020,17,3038,270,18,1381,13,16,4,4,0,0,0,0,0,0,True,False,False,0,3,2021-01-04T13:03:46.013,0,,0.0
2020,17,3038,275,18,566,2,13,10,2,4,2,4,0,4,6,False,False,False,0,3,2021-01-07T18:08:58.467,4,,0.0
2020,17,3038,290,11,914,2,35,8,19,38,19,34,4,34,0,False,False,False,1,2,2021-01-04T13:15:12.197,38,,4.0
2020,17,3038,295,11,917,13,9,2,27,0,0,0,0,0,0,False,False,False,0,3,2021-02-23T19:10:05.99,0,,0.0
2020,17,3038,305,11,917,13,2,9,7,0,0,0,0,0,0,True,False,False,0,3,2021-01-04T16:43:47.347,0,,0.0
2020,17,3038,320,18,1381,2,4,8,16,20,4,19,1,19,0,False,False,False,0,2,2021-01-05T09:38:37.45,20,,1.0
2020,17,3038,325,18,1381,2,5,3,6,9,3,9,0,9,0,False,False,False,0,2,2021-01-04T13:25:30.797,9,,0.0
2020,17,3038,340,18,4152,3,30,10,0,0,0,0,0,0,0,True,False,False,0,4,2021-01-07T17:49:09.627,0,,0.0
2020,17,3038,370,11,2714,2,53,10,-2,2,4,1,1,1,0,False,False,False,0,4,2021-01-04T13:37:10.37,2,,1.0
2020,17,3038,385,11,6341,13,32,9,-4,0,0,0,0,0,0,False,False,False,0,1,2021-02-23T19:10:52.287,0,,0.0
2020,17,3038,390,11,917,13,8,7,45,0,0,0,0,0,0,False,False,False,0,2,2021-02-23T19:11:42.943,0,,0.0
2020,17,3038,410,18,7711,2,4,5,7,8,1,7,1,7,0,False,False,False,0,2,2021-01-04T13:51:27.963,8,,1.0
2020,17,3038,420,18,6706,2,46,3,4,4,0,4,0,4,0,False,False,False,0,3,2021-01-04T16:44:42.453,4,,0.0
2020,17,3038,425,18,566,2,48,10,-3,-3,0,-3,0,-3,0,False,False,False,0,1,2021-01-04T13:55:46.333,-3,,0.0
2020,17,3038,435,18,1381,2,50,3,-1,14,15,5,9,5,0,False,False,False,0,2,2021-01-07T17:56:34.247,14,,9.0
2020,17,3038,445,18,6361,2,42,9,7,10,3,10,0,10,0,False,True,False,0,4,2021-01-05T00:11:47.447,10,,0.0
2020,17,3038,460,18,6706,2,7,6,19,40,21,19,21,19,6,False,False,False,2,3,2021-01-07T17:57:06.557,40,,21.0
2020,17,3038,485,11,917,2,2,10,6,7,1,7,0,7,0,False,False,False,0,3,2021-01-04T14:15:24.85,7,,0.0
2020,17,3038,490,11,914,2,24,10,13,26,13,26,0,26,6,True,False,False,0,3,2021-01-04T14:17:25.6,26,,0.0
2020,17,3038,505,18,7711,2,4,2,15,15,0,15,0,15,0,False,False,False,0,2,2021-01-04T14:21:31.683,15,,0.0
2020,17,3038,515,18,7711,2,6,4,14,38,24,13,25,13,0,False,False,False,2,3,2021-03-03T16:30:52.017,38,,25.0
2020,17,3038,560,11,914,13,6,4,12,0,0,0,0,0,0,False,False,False,0,2,2021-01-07T18:10:43.343,0,,0.0
2020,17,3038,565,18,6907,13,17,8,22,0,0,0,0,0,0,False,False,False,0,3,2021-01-04T14:40:58.117,0,,0.0
2020,17,3038,570,18,7711,2,5,3,9,15,6,11,4,11,0,False,False,False,1,2,2021-01-07T17:57:37.86,15,,4.0
2020,17,3038,575,18,7711,13,6,10,5,0,0,0,0,0,0,False,False,False,0,3,2021-01-04T14:45:25.03,0,,0.0
2020,17,3038,605,11,7733,13,19,6,41,0,0,0,0,0,0,False,False,False,0,2,2021-01-04T14:52:46.303,0,,0.0
2020,17,3038,610,11,100,2,39,4,5,6,1,5,1,5,0,True,False,False,0,3,2021-01-04T14:54:49.567,6,,1.0
2020,17,3038,615,11,917,3,9,6,30,0,0,0,0,0,0,False,False,False,0,2,2021-01-04T14:57:48.043,0,,0.0
2020,17,3038,625,11,7733,2,19,2,31,31,0,31,0,31,0,False,False,False,0,2,2021-01-04T15:02:39.233,31,,0.0
2020,17,3038,635,11,7732,2,48,9,-5,18,23,17,1,17,0,False,False,False,0,1,2021-01-04T15:05:42.213,18,,1.0
2020,17,3038,665,18,6900,2,44,3,-4,7,11,-3,10,-3,0,False,False,False,2,1,2021-01-04T15:16:12.427,7,,10.0
2020,17,3038,675,18,7711,13,4,8,16,0,0,0,0,0,0,False,False,False,0,3,2021-02-23T19:13:19.58,0,,
2020,17,3038,685,18,7711,2,5,3,14,14,0,14,0,14,0,False,False,False,0,3,2021-01-04T15:26:58.283,14,,0.0
2020,17,3038,765,11,7732,13,12,6,25,0,0,0,0,0,0,False,False,False,0,1,2021-01-05T23:26:39.557,0,,
2020,17,3038,770,11,914,2,8,8,15,21,6,21,0,21,0,False,False,False,0,2,2021-01-04T16:45:12.64,21,,0.0
2020,17,3038,785,11,6810,2,32,10,1,1,0,1,0,1,0,False,False,False,0,4,2021-01-07T18:12:23.787,1,,0.0
2020,17,3038,790,11,914,13,5,10,4,0,0,0,0,0,0,False,False,False,0,3,2021-01-07T18:14:33.717,0,,0.0
2020,17,3038,800,11,914,3,8,10,38,0,0,0,0,0,0,False,False,False,0,2,2021-01-04T16:04:01.507,0,,0.0
2020,17,3038,805,11,7732,2,48,10,-7,-1,6,-2,1,-2,0,False,False,False,1,1,2021-01-07T17:58:21.353,-1,,1.0
2020,17,3038,810,11,914,2,5,6,16,16,0,16,0,16,0,False,False,False,0,2,2021-01-07T18:15:14.19,16,,0.0
2020,17,3038,815,11,917,2,5,5,6,6,0,6,0,6,0,False,False,False,0,2,2021-01-07T18:16:04.96,6,,0.0
2020,17,3038,825,11,7906,13,17,4,12,0,0,0,0,0,0,False,False,False,0,4,2021-01-04T16:13:40.75,0,,0.0
2020,17,3038,830,11,914,2,2,10,8,10,2,8,2,8,0,False,False,False,0,3,2021-01-04T16:15:41.81,10,,2.0
2020,17,3038,850,18,4152,2,47,5,5,30,25,30,0,30,0,False,False,False,0,1,2021-01-07T18:17:26.487,30,,0.0
2020,17,3038,860,18,7711,2,4,3,6,13,7,6,7,6,0,False,False,False,1,2,2021-01-07T17:58:35.06,13,,7.0
2020,17,3038,865,18,7711,2,5,3,8,8,0,8,0,8,0,False,False,False,0,2,2021-01-04T16:26:21.423,8,,0.0
2020,17,3038,885,18,6907,2,5,3,5,5,0,5,0,5,0,False,False,False,0,3,2021-01-04T16:31:00.083,5,,0.0
2020,17,3039,10,13,876,2,6,1,20,20,0,20,0,20,0,False,False,False,0,2,2021-01-04T12:13:33.97,20,,0.0
2020,17,3039,15,13,4733,13,12,2,17,0,0,0,0,0,0,False,False,False,0,3,2021-03-08T17:26:05.333,0,,0.0
2020,17,3039,20,13,4733,2,4,10,4,4,0,4,0,4,0,False,False,False,0,2,2021-01-04T12:16:53.86,4,,0.0
2020,17,3039,40,31,6793,2,6,8,18,21,3,19,2,19,0,False,False,False,0,2,2021-01-04T12:28:06.557,21,,2.0
2020,17,3039,55,31,5080,3,2,9,11,0,0,0,0,0,0,False,False,False,0,3,2021-02-23T19:18:00.293,0,,0.0
2020,17,3039,70,31,6724,2,13,10,3,6,3,3,3,3,0,False,False,False,1,3,2021-01-04T12:36:28.643,6,,3.0
2020,17,3039,90,13,876,13,5,3,13,0,0,0,0,0,0,False,False,False,0,2,2021-03-04T21:48:37.403,0,,0.0
2020,17,3039,100,31,5080,13,21,2,26,0,0,0,0,0,0,False,False,False,0,2,2021-01-07T15:20:09.58,0,,0.0
2020,17,3039,105,31,5080,3,3,5,13,0,0,0,0,0,0,False,False,False,0,2,2021-01-05T16:25:42.82,0,,0.0
2020,17,3039,120,13,876,2,2,9,6,8,2,8,0,8,0,False,False,False,0,2,2021-01-04T12:51:03.673,8,,0.0
2020,17,3039,135,13,6529,2,11,6,16,42,26,42,0,42,0,True,False,False,0,3,2021-01-04T12:56:12.29,42,,0.0
2020,17,3039,140,13,4662,2,12,5,7,7,0,7,0,7,0,False,False,False,0,3,2021-01-04T12:58:15.423,7,,
2020,17,3039,145,13,2455,13,48,4,-3,0,0,0,0,0,0,False,False,False,0,1,2021-01-04T13:00:53.56,0,,0.0
2020,17,3039,155,13,876,2,3,5,10,9,-1,9,0,9,0,False,False,False,0,2,2021-01-04T13:13:48.78,9,,0.0
2020,17,3039,160,13,2455,3,2,10,5,0,0,0,0,0,0,False,False,False,0,3,2021-01-04T13:14:58.427,0,,0.0
2020,17,3039,165,13,6529,2,46,3,2,2,0,2,0,2,0,True,False,False,0,3,2021-01-04T13:18:49.527,2,,0.0
2020,17,3039,170,13,6528,13,2,4,6,0,0,0,0,0,0,False,False,False,0,3,2021-02-25T17:36:10.603,0,,0.0
2020,17,3039,200,31,6793,2,2,10,7,8,1,7,1,7,0,False,False,False,0,2,2021-01-04T13:23:42.99,8,,1.0
2020,17,3039,225,13,4662,2,8,10,14,14,0,14,0,14,0,False,False,False,0,3,2021-01-04T13:29:09.02,14,,0.0
2020,17,3039,230,13,6529,2,5,9,4,7,3,6,1,6,0,False,False,False,0,3,2021-01-04T13:30:40.213,7,,1.0
2020,17,3039,240,13,876,13,12,2,16,0,0,0,0,0,0,False,False,False,0,3,2021-03-08T17:26:32.79,0,,0.0
2020,17,3039,245,13,6637,2,17,8,16,20,4,20,0,20,0,False,False,False,0,3,2021-01-04T13:35:56.527,20,,0.0
2020,17,3039,265,13,876,2,50,9,-3,7,10,7,0,7,0,False,False,False,0,3,2021-01-04T13:47:30.777,7,,0.0
2020,17,3039,285,31,5080,2,50,3,-1,1,2,1,0,1,0,False,False,False,0,2,2021-01-05T16:26:01.91,1,,0.0
2020,17,3039,300,31,5080,2,35,10,12,19,7,13,6,13,0,False,False,False,0,3,2021-01-04T13:53:56.243,19,,6.0
2020,17,3039,315,31,6793,2,42,10,3,4,1,4,0,4,6,False,False,False,0,2,2021-01-04T13:58:25.89,4,,0.0
2020,17,3039,330,13,4733,2,35,10,9,12,3,11,1,11,0,False,False,False,0,3,2021-02-25T17:37:19.147,12,,1.0
2020,17,3039,340,13,6529,2,5,3,7,8,1,8,0,8,0,False,False,False,0,3,2021-01-04T14:03:16.963,8,,0.0
2020,17,3039,350,13,876,2,12,9,12,14,2,13,1,13,0,False,False,False,0,2,2021-01-04T14:05:58.12,14,,1.0
2020,17,3039,360,13,4662,2,30,9,0,6,6,5,1,5,0,True,False,False,0,1,2021-01-06T02:02:36.093,6,,1.0
2020,17,3039,380,13,4662,2,46,3,2,7,5,3,4,3,0,False,False,False,1,4,2021-01-04T14:10:46.743,7,,4.0
2020,17,3039,385,13,6529,13,17,10,12,0,0,0,0,0,0,False,False,False,0,3,2021-01-04T14:12:15.39,0,,0.0
2020,17,3039,395,13,6529,2,50,10,-3,2,5,0,2,0,0,False,False,False,0,3,2021-01-04T14:15:57.107,2,,2.0
2020,17,3039,405,13,876,13,9,3,10,0,0,0,0,0,0,False,False,False,0,2,2021-01-04T14:15:27.487,0,,0.0
2020,17,3039,450,31,5080,2,4,9,4,4,0,4,0,4,0,True,False,False,0,3,2021-01-04T14:35:39.98,4,,0.0
2020,17,3039,455,31,6793,2,5,10,12,29,17,19,10,19,0,True,False,False,0,3,2021-01-05T16:25:00.29,29,,10.0
2020,17,3039,465,31,5080,3,2,9,5,0,0,0,0,0,0,False,False,False,0,3,2021-01-04T14:40:20.467,0,,0.0
2020,17,3039,470,31,6724,2,4,10,10,12,2,11,1,11,0,False,False,False,1,3,2021-01-04T14:41:53.873,12,,1.0
2020,17,3039,475,31,5096,2,2,9,4,8,4,5,3,5,0,False,False,False,1,2,2021-01-04T14:43:48.09,8,,3.0
2020,17,3039,495,13,876,2,3,5,11,11,0,11,0,11,0,False,False,False,0,2,2021-01-04T14:47:15.333,11,,0.0
2020,17,3039,505,13,4662,2,5,10,9,14,5,11,3,11,0,False,False,False,0,4,2021-01-04T14:49:30.33,14,,3.0
2020,17,3039,510,13,876,13,2,10,11,0,0,0,0,0,0,False,False,False,0,2,2021-01-04T14:51:05.743,0,,
2020,17,3039,515,13,876,2,8,7,37,38,1,38,0,38,6,False,False,False,0,3,2021-02-23T19:19:38.613,38,,0.0
2020,17,3039,530,31,5080,2,13,4,7,6,-1,6,0,6,0,True,False,False,1,4,2021-01-04T14:59:01.577,6,,0.0
2020,17,3039,550,31,5080,13,7,2,27,0,0,0,0,0,0,False,False,False,0,3,2021-01-04T15:10:23.053,0,,0.0
2020,17,3039,590,13,876,2,35,2,20,20,0,20,0,20,6,False,False,False,0,3,2021-01-04T15:19:01.843,20,,0.0
2020,17,3039,610,13,876,2,35,6,26,27,1,26,1,26,0,False,False,False,0,3,2021-01-04T15:24:04.07,27,,1.0
2020,17,3039,615,13,2455,2,55,4,-2,0,2,-1,1,-1,0,True,False,False,0,1,2021-01-04T15:25:17.71,0,,1.0
2020,17,3039,645,31,6793,2,5,10,8,11,3,9,2,9,0,True,False,False,0,3,2021-01-07T16:21:40.813,11,,2.0
2020,17,3039,670,31,5080,13,7,6,37,0,0,0,0,0,0,False,False,False,0,3,2021-01-04T15:46:41.88,0,,0.0
2020,17,3039,675,31,7913,13,6,9,11,0,0,0,0,0,0,False,False,False,0,3,2021-01-04T15:48:32.133,0,,0.0
2020,17,3039,690,13,2455,2,48,9,-4,4,8,1,3,1,0,False,False,False,0,1,2021-01-04T15:52:14.807,4,,3.0
2020,17,3039,700,13,6528,2,5,3,8,9,1,8,1,8,0,False,False,False,0,4,2021-01-04T15:54:09.993,9,,1.0
2020,17,3039,705,13,876,2,5,10,7,7,0,7,0,7,0,False,False,False,0,2,2021-01-04T15:55:27.46,7,,0.0
2020,17,3039,710,13,4662,2,30,5,7,7,0,7,0,7,6,True,False,False,0,1,2021-02-25T17:38:26.743,7,,0.0
2020,17,3039,735,31,6793,2,5,5,10,11,1,10,1,10,0,False,False,False,0,2,2021-01-07T16:21:52.58,11,,1.0
2020,17,3039,755,31,6793,2,6,9,5,5,0,5,0,5,0,False,False,False,0,2,2021-01-04T16:19:14.86,5,,0.0
2020,17,3039,760,31,6793,2,4,3,4,5,1,4,1,4,0,False,False,False,0,2,2021-01-04T16:22:46.943,5,,1.0
2020,17,3039,780,31,6793,13,2,10,10,0,0,0,0,0,0,False,False,False,0,2,2021-04-02T14:02:32.15,0,,0.0
2020,17,3039,785,31,6793,2,50,10,-2,5,7,2,3,2,0,False,False,False,0,3,2021-01-04T16:30:59.15,5,,3.0
2020,17,3039,790,31,5080,2,2,9,2,9,7,7,2,7,0,False,False,False,0,2,2021-01-04T16:32:17.75,9,,2.0
2020,17,3039,825,31,5096,13,2,9,5,0,0,0,0,0,0,True,False,False,0,3,2021-01-04T16:38:58.9,0,,0.0
2020,17,3039,845,13,2455,2,12,3,11,32,21,15,17,15,0,False,False,False,1,1,2021-01-04T16:43:32.62,32,,17.0
2020,17,3039,850,13,876,2,4,10,5,5,0,5,0,5,0,False,False,False,0,2,2021-01-04T16:44:39.113,5,,0.0
2020,17,3039,865,13,6529,2,7,6,27,29,2,29,0,29,0,False,False,False,0,3,2021-01-04T16:46:47.943,29,,0.0
2020,17,3039,870,13,876,3,13,4,7,0,0,0,0,0,0,False,False,False,0,2,2021-01-04T16:48:01.03,0,,0.0
2020,17,3039,875,13,876,13,8,1,33,0,0,0,0,0,0,False,False,False,0,2,2021-01-04T16:49:36.5,0,,0.0
2020,17,3039,880,13,4733,13,3,3,13,0,0,0,0,0,0,False,False,False,0,2,2021-01-04T16:50:54.293,0,,0.0
2020,17,3039,895,31,6793,2,8,8,45,52,7,46,6,46,0,False,False,False,0,2,2021-01-04T16:53:09.727,52,,6.0
2020,17,3040,10,19,7175,13,5,2,27,0,0,0,0,0,0,False,False,False,0,3,2021-01-07T20:04:41.513,0,,
2020,17,3040,15,19,6266,2,48,10,-3,17,20,14,3,14,0,False,False,False,0,1,2021-01-04T12:02:21.673,17,,3.0
2020,17,3040,50,19,1328,2,16,10,5,7,2,7,0,7,6,False,False,False,0,1,2021-01-04T12:29:03.347,7,,0.0
2020,17,3040,70,22,6812,2,46,3,-1,8,9,4,4,4,0,False,False,False,0,1,2021-01-04T12:46:20.347,8,,4.0
2020,17,3040,75,22,6270,2,5,5,5,10,5,8,2,8,0,False,False,False,0,3,2021-01-04T12:52:13.247,10,,2.0
2020,17,3040,90,22,3170,2,50,5,-2,0,2,0,0,0,0,True,False,False,0,3,2021-01-07T19:54:45.41,0,,0.0
2020,17,3040,95,22,6579,3,45,5,-4,0,0,0,0,0,0,False,False,False,0,1,2021-01-04T13:06:23.453,0,,0.0
2020,17,3040,100,22,7610,13,6,7,17,0,0,0,0,0,0,False,False,False,0,2,2021-01-04T13:08:28.103,0,,0.0
2020,17,3040,115,19,7620,2,6,9,13,13,0,13,0,13,0,False,False,False,0,4,2021-01-04T13:13:01.957,13,,0.0
2020,17,3040,120,19,7175,2,4,3,5,6,1,6,0,6,0,False,False,False,0,3,2021-01-07T18:53:17.533,6,,0.0
2020,17,3040,150,22,256,2,35,8,20,20,0,20,0,20,0,False,False,False,0,3,2021-01-04T13:26:00.867,20,,0.0
2020,17,3040,165,22,6262,2,47,5,1,6,5,2,4,2,0,False,False,False,0,4,2021-01-04T13:31:33.88,6,,4.0
2020,17,3040,175,22,6270,2,50,9,-3,4,7,-3,7,-3,0,True,False,False,1,2,2021-03-03T16:35:58.327,4,,7.0
2020,17,3040,195,19,7175,2,39,4,5,13,8,8,5,8,0,False,False,False,1,3,2021-01-04T14:01:03.183,13,,5.0
2020,17,3040,210,19,3233,13,12,10,13,0,0,0,0,0,0,False,False,False,0,3,2021-01-04T14:04:05.527,0,,0.0
2020,17,3040,220,22,7610,2,35,3,13,15,2,13,2,13,0,False,False,False,0,2,2021-01-04T14:10:54.863,15,,2.0
2020,17,3040,225,22,6262,13,35,6,22,0,0,0,0,0,0,True,False,False,0,4,2021-01-04T14:14:13.747,0,,0.0
2020,17,3040,245,19,7622,13,39,4,10,0,0,0,0,0,0,False,False,False,0,4,2021-01-07T20:08:40.05,0,,0.0
2020,17,3040,255,19,7175,2,6,1,18,18,0,18,0,18,0,False,False,False,0,2,2021-01-07T19:55:30.383,18,,0.0
2020,17,3040,260,19,3233,2,2,9,6,7,1,7,0,7,0,False,False,False,0,2,2021-01-07T20:09:11.187,7,,0.0
2020,17,3040,265,19,6266,2,28,10,3,3,0,3,0,3,0,False,False,False,0,1,2021-01-04T14:39:47.41,3,,
2020,17,3040,270,19,1328,2,44,3,-3,10,13,8,2,8,0,False,False,False,0,1,2021-01-04T14:43:59.897,10,,2.0
2020,17,3040,280,19,1328,2,44,3,-2,12,14,6,6,6,0,False,False,False,0,1,2021-01-07T20:10:49.167,12,,6.0
2020,17,3040,285,19,1328,13,32,5,2,0,0,0,0,0,0,False,False,False,0,1,2021-01-07T18:53:17.533,0,,0.0
2020,17,3040,290,19,3233,13,8,8,26,0,0,0,0,0,0,False,False,False,0,2,2021-01-07T18:53:17.533,0,,0.0
2020,17,3040,305,22,6270,2,34,4,-5,6,11,4,2,4,0,True,False,False,0,3,2021-01-07T20:11:31.833,6,,2.0
2020,17,3040,320,22,256,13,35,3,10,0,0,0,0,0,0,False,False,False,0,2,2021-01-07T19:57:36.643,0,,0.0
2020,17,3040,325,22,3170,2,5,3,3,4,1,3,1,3,0,False,False,False,0,3,2021-01-07T20:12:07.887,4,,
2020,17,3040,330,22,256,2,5,5,11,11,0,11,0,11,0,False,False,False,0,2,2021-01-04T15:24:44.607,11,,0.0
2020,17,3040,335,22,3320,2,2,4,10,18,8,13,5,13,0,False,False,False,0,3,2021-01-04T15:26:42.707,18,,5.0
2020,17,3040,350,22,6812,2,45,5,-2,15,17,-1,16,-1,0,False,False,False,1,1,2021-01-04T18:18:04.497,15,,16.0
2020,17,3040,355,22,3170,2,12,5,12,12,0,12,0,12,0,False,False,False,0,3,2021-01-04T15:35:00.363,12,,0.0
2020,17,3040,360,22,6262,2,8,1,21,21,0,21,0,21,6,False,False,False,0,3,2021-01-04T15:37:06.06,21,,0.0
2020,17,3040,375,19,7175,2,5,3,5,10,5,9,1,9,0,False,False,False,0,3,2021-01-04T15:42:19.473,10,,1.0
2020,17,3040,380,19,7622,2,5,10,5,6,1,5,1,5,0,False,False,False,0,4,2021-01-04T15:43:28.23,6,,1.0
2020,17,3040,385,19,7175,2,5,5,6,10,4,10,0,10,0,False,False,False,0,3,2021-01-04T15:47:24.75,10,,0.0
2020,17,3040,395,19,1328,3,44,9,-3,0,0,0,0,0,0,False,False,False,0,1,2021-01-04T15:50:36.85,0,,0.0
2020,17,3040,400,19,1328,13,6,10,1,0,0,0,0,0,0,False,False,False,0,1,2021-01-04T15:50:26.647,0,,0.0
2020,17,3040,405,19,7175,13,4,3,7,0,0,0,0,0,0,False,False,False,0,2,2021-01-07T19:38:55.133,0,,0.0
2020,17,3040,435,22,256,2,6,1,18,53,35,48,5,48,0,False,False,False,0,3,2021-01-07T19:59:09.46,53,,5.0
2020,17,3040,445,22,3170,2,26,5,3,10,7,8,2,8,0,False,False,False,0,2,2021-01-07T20:13:18.493,10,,2.0
2020,17,3040,480,19,6266,2,47,5,-2,12,14,9,3,9,0,True,False,False,0,1,2021-01-07T20:14:48.787,12,,3.0
2020,17,3040,485,19,1328,2,12,9,2,2,0,2,0,2,0,False,False,False,0,1,2021-01-04T16:19:54.15,2,,0.0
2020,17,3040,495,19,7620,3,8,9,13,0,0,0,0,0,0,False,False,False,0,3,2021-01-04T16:26:40.81,0,,0.0
2020,17,3040,525,19,7173,2,4,10,5,7,2,5,2,5,0,False,False,False,0,3,2021-01-04T16:38:55.593,7,,2.0
2020,17,3040,545,19,7173,2,3,5,10,10,0,10,0,10,0,False,False,False,0,2,2021-01-04T16:42:24.933,10,,0.0
2020,17,3040,550,19,7177,2,6,10,10,12,2,11,1,11,0,False,False,False,0,2,2021-01-04T18:13:24.553,12,,1.0
2020,17,3040,560,19,7177,2,49,3,-3,2,5,1,1,1,0,False,False,False,1,2,2021-01-07T18:53:17.533,2,,1.0
2020,17,3040,570,19,506,2,11,5,12,19,7,17,2,17,6,False,False,False,0,6,2021-02-23T19:47:31.823,19,,2.0
2020,17,3040,590,22,6262,2,51,5,-2,9,11,7,2,7,0,True,False,False,0,4,2021-01-07T18:53:17.533,9,,2.0
2020,17,3040,600,22,256,13,4,8,22,0,0,0,0,0,0,False,False,False,0,3,2021-03-04T20:28:42.233,0,,0.0
2020,17,3040,625,19,7620,2,7,2,20,26,6,21,5,21,6,False,False,False,0,4,2021-01-04T17:04:01.88,26,,5.0
2020,17,3040,640,22,6262,2,30,10,0,2,2,1,1,1,0,True,False,False,0,4,2021-01-04T17:08:41.377,2,,1.0
2020,17,3040,650,22,6538,13,12,3,10,0,0,0,0,0,0,False,False,False,0,3,2021-01-07T19:40:43.857,0,,0.0
2020,17,3040,660,19,7175,2,39,4,8,11,3,8,3,8,0,False,False,False,1,3,2021-01-04T18:11:30.483,11,,3.0
2020,17,3040,665,19,6266,2,45,5,-1,31,32,31,0,31,6,False,False,False,0,1,2021-01-07T20:20:14.787,31,,0.0
2020,17,3040,680,22,6262,2,49,10,-2,5,7,4,1,4,0,False,False,False,0,3,2021-01-07T18:53:17.533,5,,1.0
2020,17,3040,695,22,6579,2,28,10,3,11,8,7,4,7,0,False,False,False,1,1,2021-01-07T18:53:17.533,11,,4.0
2020,17,3040,715,22,6579,2,4,4,1,1,0,1,0,1,0,False,False,False,0,1,2021-01-04T18:13:40.343,1,,0.0
2020,17,3040,720,22,6579,13,12,5,2,0,0,0,0,0,0,False,False,False,0,1,2021-03-15T19:04:29.673,0,,0.0
2020,17,3040,725,22,6262,2,51,9,-1,12,13,8,4,8,0,True,False,False,0,4,2021-01-07T18:53:17.533,12,,4.0
2020,17,3040,730,22,6262,13,11,6,19,0,0,0,0,0,0,True,False,False,0,4,2021-01-07T20:23:47.303,0,,0.0
2020,17,3040,735,22,3170,2,39,4,4,9,5,8,1,8,0,False,False,False,0,3,2021-01-04T17:47:21.113,9,,1.0
2020,17,3040,745,22,6538,13,12,2,17,0,0,0,0,0,0,False,False,False,0,3,2021-01-04T17:49:32.673,0,,0.0
2020,17,3040,755,22,256,13,7,6,15,0,0,0,0,0,0,False,False,False,0,3,2021-01-04T17:53:42,0,,0.0
2020,17,3040,830,22,6262,2,51,3,0,8,8,6,2,6,0,False,False,False,0,4,2021-01-07T20:25:26.97,8,,2.0
2020,17,3041,10,21,4422,2,5,5,6,14,8,10,4,10,0,False,False,False,0,4,2021-01-04T11:35:22.483,14,,4.0
2020,17,3041,25,21,7226,2,46,3,1,16,15,7,9,7,0,False,False,False,1,4,2021-01-07T22:58:22.75,16,,9.0
2020,17,3041,55,9,6446,13,4,9,5,0,0,0,0,0,0,False,False,False,0,4,2021-01-04T11:52:10.473,0,,0.0
2020,17,3041,60,9,7816,13,5,3,14,0,0,0,0,0,0,False,False,False,0,3,2021-01-04T11:54:05.01,0,,
2020,17,3041,70,9,322,2,30,10,0,4,4,2,2,2,0,False,False,False,0,4,2021-02-23T19:50:41.737,4,,2.0
2020,17,3041,95,21,8259,2,32,9,1,9,8,4,5,4,0,True,False,False,0,3,2021-01-04T12:18:16.673,9,,5.0
2020,17,3041,110,9,4202,2,45,5,-1,9,10,9,0,9,0,False,False,False,0,1,2021-01-04T12:24:06.17,9,,0.0
2020,17,3041,120,9,7183,13,48,10,-2,0,0,0,0,0,0,False,False,False,0,1,2021-01-04T12:27:41.03,0,,0.0
2020,17,3041,140,21,963,13,47,5,2,0,0,0,0,0,0,False,False,False,0,1,2021-01-04T12:32:49.047,0,,0.0
2020,17,3041,150,21,7090,2,3,5,9,15,6,15,0,15,0,False,False,False,0,3,2021-01-04T12:37:07.117,15,,0.0
2020,17,3041,170,21,2288,13,32,9,-3,0,0,0,0,0,0,True,False,False,0,1,2021-01-04T12:41:58.85,0,,0.0
2020,17,3041,185,9,7183,2,44,3,-5,3,8,0,3,0,0,False,False,False,0,1,2021-01-04T12:46:08.997,3,,3.0
2020,17,3041,190,9,322,13,5,5,7,0,0,0,0,0,0,False,False,False,0,3,2021-01-07T23:02:42.177,0,,0.0
2020,17,3041,220,21,3680,13,5,5,13,0,0,0,0,0,0,False,False,False,0,3,2021-01-04T12:59:29.147,0,,0.0
2020,17,3041,230,9,322,3,2,10,6,0,0,0,0,0,0,False,False,False,0,3,2021-01-04T13:02:38.507,0,,0.0
2020,17,3041,250,21,7090,13,19,6,38,0,0,0,0,0,0,False,False,False,0,2,2021-01-04T13:17:05.33,0,,0.0
2020,17,3041,260,21,3680,13,2,10,10,0,0,0,0,0,0,True,False,False,0,3,2021-01-04T13:20:30.55,0,,0.0
2020,17,3041,275,9,6436,13,4,9,14,0,0,0,0,0,0,False,False,False,0,2,2021-01-07T22:30:52.78,0,,0.0
2020,17,3041,280,9,6436,13,2,10,6,0,0,0,0,0,0,False,False,False,0,2,2021-01-04T13:29:06.763,0,,0.0
2020,17,3041,295,21,3680,2,5,3,9,21,12,18,3,18,0,False,False,False,1,3,2021-01-07T23:04:03.277,21,,3.0
2020,17,3041,305,21,720,2,39,4,6,10,4,8,2,8,0,False,False,False,0,3,2021-01-07T21:27:10.72,10,,2.0
2020,17,3041,315,21,3680,2,26,3,4,10,6,9,1,9,6,False,False,False,0,2,2021-01-04T13:37:38.77,10,,1.0
2020,17,3041,330,9,322,2,4,4,12,13,1,11,2,11,0,False,False,False,1,3,2021-01-04T13:45:51.97,13,,2.0
2020,17,3041,335,9,7183,13,18,5,-3,0,0,0,0,0,0,False,False,False,0,2,2021-01-06T00:18:36.96,0,,0.0
2020,17,3041,340,9,6436,2,4,5,8,16,8,13,3,13,0,False,False,False,0,2,2021-01-04T13:49:29.787,16,,3.0
2020,17,3041,345,9,6446,2,4,9,4,9,5,5,4,5,0,False,False,False,1,4,2021-03-03T16:42:58.77,9,,4.0
2020,17,3041,365,9,7183,2,50,10,-3,6,9,3,3,3,0,True,False,False,0,2,2021-03-04T16:18:48.9,6,,3.0
2020,17,3041,390,21,3680,2,5,3,4,4,0,4,0,4,0,False,False,False,0,3,2021-02-23T19:51:43.27,4,,0.0
2020,17,3041,400,21,3680,2,5,5,2,2,0,2,0,2,0,False,False,False,0,3,2021-01-04T14:44:12.027,2,,
2020,17,3041,410,21,3680,2,6,8,19,18,-1,18,0,18,0,False,False,False,0,2,2021-01-04T14:46:52.38,18,,0.0
2020,17,3041,415,21,4422,13,4,9,8,0,0,0,0,0,0,False,False,False,0,3,2021-01-04T14:54:06.047,0,,
2020,17,3041,420,21,6365,2,17,8,25,33,8,33,0,33,6,False,False,False,0,3,2021-01-04T14:56:35.523,33,,0.0
2020,17,3041,435,9,7816,2,5,5,14,14,0,14,0,14,0,False,False,False,0,3,2021-01-07T23:05:12.187,14,,0.0
2020,17,3041,440,9,6446,2,4,9,7,9,2,9,0,9,0,False,False,False,0,3,2021-01-04T17:33:31.723,9,,0.0
2020,17,3041,450,9,7816,2,50,10,-4,6,10,5,1,5,0,False,False,False,0,3,2021-01-07T21:27:10.72,6,,1.0
2020,17,3041,460,9,6446,2,13,10,7,11,4,8,3,8,0,False,False,False,0,4,2021-01-07T22:32:03.747,11,,3.0
2020,17,3041,505,9,4202,3,47,5,-1,0,0,0,0,0,0,False,False,False,0,1,2021-01-07T23:06:04.817,0,,0.0
2020,17,3041,510,9,6436,13,4,2,15,0,0,0,0,0,0,False,False,False,0,2,2021-01-04T15:21:14.137,0,,0.0
2020,17,3041,525,21,4422,3,6,1,15,0,0,0,0,0,0,False,False,False,0,3,2021-03-04T21:59:46.183,0,,0.0
2020,17,3041,535,9,322,2,49,5,-2,7,9,5,2,5,0,False,False,False,0,2,2021-02-23T19:52:24.93,7,,2.0
2020,17,3041,545,9,7816,2,29,2,17,21,4,20,1,20,0,True,False,False,0,3,2021-01-04T15:47:57.45,21,,1.0
2020,17,3041,550,9,4202,2,28,4,0,7,7,6,1,6,0,False,False,False,0,1,2021-01-04T15:49:08.89,7,,1.0
2020,17,3041,555,9,6446,2,32,5,2,10,8,3,7,3,0,False,False,False,2,4,2021-01-04T15:50:28.97,10,,7.0
2020,17,3041,560,9,7816,2,51,9,-3,-3,0,-3,0,-3,0,False,False,False,0,3,2021-02-23T19:53:00.11,-3,,0.0
2020,17,3041,565,9,6436,3,12,6,16,0,0,0,0,0,0,False,False,False,0,2,2021-01-04T15:52:50.543,0,,
2020,17,3041,575,9,322,2,30,10,3,5,2,4,1,4,0,True,False,False,0,4,2021-01-04T15:57:30.24,5,,1.0
2020,17,3041,600,21,7090,2,4,5,9,7,-2,7,0,7,0,False,False,False,0,2,2021-01-04T16:11:24.92,7,,0.0
2020,17,3041,605,21,3680,2,35,7,16,16,0,16,0,16,0,False,False,False,0,3,2021-01-05T19:24:10.947,16,,0.0
2020,17,3041,615,21,4422,3,8,7,17,0,0,0,0,0,0,False,False,False,0,3,2021-01-07T22:33:29.053,0,,0.0
2020,17,3041,620,21,4422,2,13,10,3,3,0,3,0,3,0,False,False,False,0,3,2021-01-04T16:18:01.627,3,,0.0
2020,17,3041,635,9,6436,2,4,7,17,20,3,17,3,17,0,False,False,False,0,2,2021-01-04T16:21:30.737,20,,3.0
2020,17,3041,640,9,322,2,6,9,5,7,2,7,0,7,0,False,False,False,0,2,2021-01-07T21:27:10.72,7,,0.0
2020,17,3041,650,9,6436,2,4,5,9,10,1,9,1,9,0,False,False,False,0,2,2021-01-04T16:24:28.217,10,,1.0
2020,17,3041,660,9,7816,13,12,10,5,0,0,0,0,0,0,False,False,False,0,3,2021-01-04T16:26:38.883,0,,0.0
2020,17,3041,665,9,6446,2,6,10,7,8,1,7,1,7,0,False,False,False,0,4,2021-01-07T22:34:01.21,8,,1.0
2020,17,3041,670,9,322,13,9,6,24,0,0,0,0,0,0,False,False,False,0,2,2021-01-04T16:30:31.17,0,,0.0
2020,17,3041,685,9,6436,2,13,10,2,3,1,2,1,2,0,False,False,False,0,3,2021-01-04T16:34:03.85,3,,1.0
2020,17,3041,715,21,7090,13,21,2,31,0,0,0,0,0,0,False,False,False,0,2,2021-01-04T16:40:55.627,0,,0.0
2020,17,3041,730,9,6446,2,4,9,5,16,11,5,11,5,0,False,False,False,1,3,2021-01-07T22:34:36.83,16,,11.0
2020,17,3041,735,9,6436,13,4,5,8,0,0,0,0,0,0,False,False,False,0,2,2021-01-04T16:47:01.67,0,,0.0
2020,17,3041,755,21,3680,2,12,10,6,9,3,9,0,9,0,True,False,False,0,2,2021-01-04T16:52:50.783,9,,0.0
2020,17,3041,765,21,3680,2,29,2,20,21,1,21,0,21,0,False,False,False,0,3,2021-01-07T22:35:10.537,21,,0.0
2020,17,3041,770,21,3680,2,4,5,9,13,4,11,2,11,0,False,False,False,1,2,2021-01-04T16:56:08.543,13,,2.0
2020,17,3041,785,21,6365,2,4,9,10,10,0,10,0,10,0,False,False,False,0,3,2021-01-04T16:59:41.993,10,,0.0
2020,17,3041,810,9,4202,2,44,3,-3,3,6,1,2,1,0,False,False,False,0,1,2021-01-07T23:07:58.287,3,,2.0
2020,17,3041,815,9,7183,2,28,10,1,10,9,7,3,7,0,False,False,False,0,1,2021-01-07T23:08:23.33,10,,3.0
2020,17,3041,820,9,7816,2,26,9,1,5,4,4,1,4,0,True,False,False,0,4,2021-01-07T23:09:25.547,5,,1.0
2020,17,3041,840,9,6441,2,51,10,2,3,1,2,1,2,0,False,False,False,0,3,2021-01-04T17:10:11.34,3,,1.0
2020,17,3041,845,9,322,2,13,4,4,5,1,4,1,4,0,False,False,False,0,3,2021-01-04T17:12:04.3,5,,1.0
2020,17,3041,860,9,6446,3,5,3,5,0,0,0,0,0,0,False,False,False,0,3,2021-01-04T17:14:37.547,0,,0.0
2020,17,3041,875,9,6446,2,51,9,0,7,7,2,5,2,0,False,False,False,0,3,2021-02-23T19:54:55.6,7,,5.0
2020,17,3041,890,9,7816,3,2,4,4,0,0,0,0,0,0,False,False,False,0,3,2021-01-07T21:27:10.72,0,,0.0
2020,17,3041,900,9,6446,13,12,7,17,0,0,0,0,0,0,False,False,False,0,3,2021-01-04T17:21:53.513,0,,0.0
2020,17,3042,10,30,793,2,3,5,9,12,3,10,2,10,0,False,False,False,0,2,2021-01-04T14:26:17.607,12,,2.0
2020,17,3042,30,30,63,2,53,10,-6,11,17,5,6,5,0,False,False,False,0,4,2021-01-04T14:30:11.787,11,,6.0
2020,17,3042,40,30,4516,2,11,6,28,29,1,29,0,29,6,True,False,False,0,4,2021-01-04T14:31:56.077,29,,0.0
2020,17,3042,60,2,5223,2,2,5,5,7,2,6,1,6,0,False,False,False,0,2,2021-01-04T14:34:43.017,7,,1.0
2020,17,3042,65,2,6247,2,50,9,0,6,6,3,3,3,0,False,False,False,0,3,2021-01-04T14:35:50.103,6,,3.0
2020,17,3042,75,2,5223,2,39,10,5,12,7,12,0,12,0,False,False,False,1,2,2021-01-04T14:38:09.567,12,,0.0
2020,17,3042,80,2,6472,2,46,9,2,7,5,5,2,5,0,False,False,False,2,1,2021-01-04T14:39:46.18,7,,2.0
2020,17,3042,95,2,4670,2,4,9,3,26,23,25,1,25,0,False,False,False,1,1,2021-01-04T14:42:35.407,26,,1.0
2020,17,3042,110,2,6472,13,46,3,1,0,0,0,0,0,0,False,False,False,0,1,2021-01-04T14:46:34.497,0,,0.0
2020,17,3042,125,30,37,2,51,9,-1,5,6,3,2,3,0,False,False,False,1,3,2021-01-07T18:04:35.46,5,,2.0
2020,17,3042,130,30,793,2,4,3,11,14,3,12,2,12,0,False,False,False,0,2,2021-01-04T14:50:25.113,14,,2.0
2020,17,3042,135,30,37,2,3,2,18,23,5,20,3,20,0,False,False,False,0,2,2021-01-04T14:51:43.897,23,,3.0
2020,17,3042,140,30,37,13,19,2,31,0,0,0,0,0,0,True,False,False,0,2,2021-01-04T14:52:56.48,0,,0.0
2020,17,3042,145,30,793,2,6,10,14,20,6,17,3,17,0,False,False,False,0,3,2021-02-23T23:07:05.033,20,,3.0
2020,17,3042,150,30,793,3,2,10,11,0,0,0,0,0,0,False,False,False,0,2,2021-01-04T14:57:00.443,0,,0.0
2020,17,3042,155,30,63,13,53,9,-2,0,0,0,0,0,0,False,False,False,0,4,2021-02-23T23:07:41.25,0,,0.0
2020,17,3042,215,30,4516,13,8,10,14,0,0,0,0,0,0,True,False,False,0,3,2021-01-04T15:14:42.647,0,,0.0
2020,17,3042,220,30,4516,13,29,6,25,0,0,0,0,0,0,False,False,False,0,3,2021-01-04T15:16:40.297,0,,0.0
2020,17,3042,230,30,37,2,12,2,25,25,0,25,0,25,6,False,False,False,0,3,2021-01-04T15:17:54.4,25,,0.0
2020,17,3042,245,2,4179,2,4,9,4,4,0,4,0,4,0,False,False,False,0,3,2021-01-04T15:19:47.163,4,,0.0
2020,17,3042,250,2,5223,3,6,7,15,0,0,0,0,0,0,False,False,False,0,3,2021-01-04T15:21:10.303,0,,0.0
2020,17,3042,255,2,6247,2,5,5,11,13,2,13,0,13,0,True,False,False,0,2,2021-01-04T15:22:16.44,13,,0.0
2020,17,3042,270,30,7268,2,2,4,4,12,8,11,1,11,0,False,False,False,0,3,2021-01-04T15:26:35.273,12,,1.0
2020,17,3042,275,30,7893,13,8,1,16,0,0,0,0,0,0,True,False,False,0,3,2021-02-23T23:08:47.85,0,,0.0
2020,17,3042,285,30,4937,2,32,3,2,8,6,7,1,7,0,False,False,False,0,3,2021-02-25T17:44:19.643,8,,1.0
2020,17,3042,300,2,2223,2,28,5,3,13,10,6,7,6,0,True,False,False,1,4,2021-03-03T17:02:06.53,13,,7.0
2020,17,3042,310,2,6472,13,46,3,-1,0,0,0,0,0,0,False,False,False,0,1,2021-01-04T15:36:21.63,0,,0.0
2020,17,3042,330,2,6247,2,4,5,4,7,3,5,2,5,0,False,False,False,0,2,2021-01-04T15:39:45.37,7,,2.0
2020,17,3042,335,2,5214,2,53,10,-3,4,7,3,1,3,0,True,False,False,0,4,2021-01-04T15:41:26.023,4,,1.0
2020,17,3042,340,2,5223,2,4,5,6,8,2,8,0,8,0,False,False,False,0,2,2021-01-04T15:42:17.667,8,,0.0
2020,17,3042,350,2,5223,2,13,4,2,2,0,2,0,2,0,False,False,False,0,3,2021-01-04T15:44:44.287,2,,0.0
2020,17,3042,355,2,5214,13,6,10,5,0,0,0,0,0,0,False,False,False,0,3,2021-01-04T15:45:47.063,0,,0.0
2020,17,3042,360,2,5214,2,2,10,4,9,5,5,4,5,0,False,False,False,0,3,2021-01-04T15:48:14.267,9,,4.0
2020,17,3042,390,30,37,13,4,5,10,0,0,0,0,0,0,False,False,False,0,2,2021-01-04T15:52:13.173,0,,
2020,17,3042,395,30,4516,13,2,10,13,0,0,0,0,0,0,False,False,False,0,3,2021-01-04T15:53:34.88,0,,
2020,17,3042,405,30,2290,2,4,10,7,11,4,10,1,10,0,False,False,False,0,3,2021-01-04T15:55:14.167,11,,1.0
2020,17,3042,415,30,37,2,2,4,6,10,4,10,0,10,0,True,False,False,0,2,2021-01-04T15:56:35.577,10,,0.0
2020,17,3042,420,30,7268,13,19,6,29,0,0,0,0,0,0,False,False,False,0,2,2021-01-04T15:57:47.28,0,,0.0
2020,17,3042,425,30,7893,2,35,4,14,16,2,15,1,15,0,False,False,False,0,3,2021-01-04T15:58:50.047,16,,1.0
2020,17,3042,435,30,4937,2,47,5,-2,6,8,4,2,4,0,False,False,False,0,1,2021-01-04T16:01:13.12,6,,2.0
2020,17,3042,440,30,2290,13,5,5,7,0,0,0,0,0,0,False,False,False,0,3,2021-01-04T16:01:25.733,0,,0.0
2020,17,3042,460,2,6247,2,5,3,7,7,0,7,0,7,0,False,False,False,0,3,2021-01-04T16:08:13.197,7,,0.0
2020,17,3042,465,2,6247,2,18,3,0,5,5,2,3,2,0,False,False,False,0,2,2021-01-04T16:08:57.78,5,,3.0
2020,17,3042,470,2,6247,2,36,10,13,15,2,15,0,15,0,False,False,False,0,3,2021-01-04T16:10:13.797,15,,0.0
2020,17,3042,480,2,5223,2,2,10,4,6,2,6,0,6,0,False,False,False,1,2,2021-01-07T18:07:28.823,6,,0.0
2020,17,3042,485,2,990,2,5,9,3,17,14,17,0,17,0,False,False,False,0,1,2021-01-04T16:13:15.607,17,,0.0
2020,17,3042,490,2,5214,13,2,10,13,0,0,0,0,0,0,True,False,False,0,3,2021-01-05T20:01:46.247,0,,0.0
2020,17,3042,495,2,4179,2,5,3,6,11,5,9,2,9,0,False,False,False,0,3,2021-01-04T16:16:01.127,11,,2.0
2020,17,3042,510,2,6247,2,35,6,17,19,2,17,2,17,6,False,False,False,0,3,2021-01-04T16:18:35.863,19,,2.0
2020,17,3042,525,30,4516,2,8,7,17,46,29,19,27,19,0,True,False,False,1,4,2021-01-04T16:21:39.84,46,,27.0
2020,17,3042,530,30,63,13,17,8,22,0,0,0,0,0,0,False,False,False,0,4,2021-01-04T16:22:36.07,0,,0.0
2020,17,3042,540,30,7268,3,8,7,21,0,0,0,0,0,0,False,False,False,0,3,2021-03-04T20:31:49.32,0,,0.0
2020,17,3042,545,2,5214,2,4,9,6,14,8,11,3,11,0,False,False,False,1,4,2021-01-07T18:06:48.693,14,,3.0
2020,17,3042,550,2,4670,2,12,4,1,13,12,9,4,9,0,False,False,False,1,1,2021-03-08T18:17:36.003,13,,4.0
2020,17,3042,565,2,5223,2,13,5,0,0,0,0,0,0,0,False,False,False,0,2,2021-01-04T16:31:23.003,0,,0.0
2020,17,3042,575,2,6247,2,50,9,-2,8,10,3,5,3,0,False,False,False,0,2,2021-01-04T16:37:46.45,8,,5.0
2020,17,3042,585,2,5223,13,13,4,3,0,0,0,0,0,0,False,False,False,0,3,2021-01-07T16:46:48.803,0,,
2020,17,3042,590,2,4670,2,4,4,3,3,0,3,0,3,0,False,True,False,1,1,2021-01-07T18:28:06.713,3,False,0.0
2020,17,3042,595,2,5223,3,5,5,10,0,0,0,0,0,0,False,False,False,0,3,2021-01-04T16:41:58.523,0,,0.0
2020,17,3042,600,2,6247,2,5,5,8,11,3,10,1,10,0,False,False,False,0,3,2021-01-04T16:45:02.743,11,,1.0
2020,17,3042,620,2,4179,13,13,9,3,0,0,0,0,0,0,False,False,False,0,3,2021-01-04T16:48:29.113,0,,0.0
2020,17,3042,645,30,4516,2,5,3,2,7,5,6,1,6,0,False,False,False,0,3,2021-01-04T16:57:24.07,7,,1.0
2020,17,3042,660,30,37,2,50,3,0,8,8,8,0,8,0,False,False,False,0,2,2021-03-04T16:21:47.6,8,,0.0
2020,17,3042,665,30,37,2,49,3,-1,12,13,9,3,9,0,False,False,False,0,2,2021-01-04T17:02:32.167,12,,3.0
2020,17,3042,670,30,37,13,19,2,27,0,0,0,0,0,0,False,False,False,0,2,2021-01-04T17:03:31.137,0,,0.0
2020,17,3042,675,30,63,13,5,3,10,0,0,0,0,0,0,False,False,False,0,4,2021-01-04T17:04:29.363,0,,
2020,17,3042,680,30,37,2,51,10,-3,14,17,4,10,4,0,False,False,False,1,3,2021-01-04T17:05:40.917,14,,10.0
2020,17,3042,710,2,5223,13,9,3,4,0,0,0,0,0,0,False,False,False,0,2,2021-01-07T18:04:45.353,0,,0.0
2020,17,3042,725,2,5214,2,17,4,1,1,0,1,0,1,6,False,False,False,0,4,2021-01-04T17:12:41.323,1,,0.0
2020,17,3042,745,30,63,2,6,9,14,18,4,15,3,15,0,False,False,False,0,4,2021-01-04T17:15:58.373,18,,3.0
2020,17,3042,760,30,4516,2,7,2,42,47,5,44,3,44,0,False,False,False,0,3,2021-02-23T23:10:03.577,47,,3.0
2020,17,3042,775,30,4516,2,13,9,3,4,1,4,0,4,6,False,False,False,0,3,2021-01-04T17:26:39.883,4,,0.0
2020,17,3042,795,2,5223,2,7,2,18,18,0,18,0,18,0,False,False,False,0,3,2021-01-04T17:41:48.24,18,,0.0
2020,17,3042,800,2,5223,2,13,9,1,-1,-2,1,-2,1,0,True,True,True,0,3,2021-01-04T17:42:58.767,-1,False,-2.0
2020,17,3042,805,30,37,13,2,10,4,0,0,0,0,0,0,False,False,False,0,2,2021-01-07T18:05:16.543,0,,0.0
2020,17,3042,820,30,37,2,12,5,11,30,19,23,7,23,6,False,False,False,0,3,2021-03-08T18:17:51.607,30,,7.0
2020,17,3042,840,2,5223,13,6,10,5,0,0,0,0,0,0,False,False,False,0,2,2021-01-04T17:49:13.547,0,,0.0
2020,17,3042,845,2,6247,13,16,9,7,0,0,0,0,0,0,False,False,False,0,3,2021-01-07T16:46:48.803,0,,0.0
2020,17,3042,850,2,990,13,17,4,14,0,0,0,0,0,0,False,False,False,0,1,2021-01-07T19:04:35.713,0,,0.0
2020,17,3042,855,30,37,2,49,5,-1,3,4,1,2,1,0,False,False,False,0,2,2021-01-04T17:53:12.773,3,,2.0
2020,17,3042,865,30,37,2,34,4,-4,6,10,6,0,6,0,True,False,False,0,2,2021-01-04T17:54:36.747,6,,0.0
2020,17,3042,870,30,37,2,34,4,-4,2,6,1,1,1,0,True,False,False,0,3,2021-01-04T17:55:40.157,2,,1.0
2020,17,3043,15,15,2407,2,2,9,9,15,6,10,5,10,0,False,False,False,1,2,2021-01-04T13:13:08.79,15,,5.0
2020,17,3043,25,15,4886,13,4,4,3,0,0,0,0,0,0,False,False,False,0,1,2021-01-04T13:16:04.487,0,,0.0
2020,17,3043,30,15,4886,2,47,5,3,6,3,5,1,5,0,False,False,False,0,1,2021-01-04T13:17:56.643,6,,1.0
2020,17,3043,45,14,7495,13,6,3,5,0,0,0,0,0,0,False,False,False,0,2,2021-02-25T17:46:54.09,0,,0.0
2020,17,3043,65,14,1114,2,4,10,6,6,0,6,0,6,6,False,False,False,0,3,2021-01-04T13:29:42.397,6,,0.0
2020,17,3043,90,15,7591,3,19,5,13,0,0,0,0,0,0,False,False,False,0,2,2021-01-07T13:36:13.807,0,,0.0
2020,17,3043,100,14,4449,3,35,9,12,0,0,0,0,0,0,True,False,False,0,3,2021-01-04T13:42:40.07,0,,0.0
2020,17,3043,105,14,6543,2,51,10,-6,11,17,7,4,7,0,False,False,False,0,1,2021-01-07T13:29:34.543,11,,4.0
2020,17,3043,130,14,1114,2,4,9,12,15,3,15,0,15,0,False,False,False,0,2,2021-01-04T13:51:01.237,15,,0.0
2020,17,3043,135,14,6543,2,51,10,-4,1,5,1,0,1,0,True,False,False,0,1,2021-01-04T13:52:20.31,1,,0.0
2020,17,3043,155,14,6543,2,48,4,-6,13,19,11,2,11,0,False,False,False,1,1,2021-01-04T14:09:03.003,13,,2.0
2020,17,3043,160,14,6543,13,5,5,3,0,0,0,0,0,0,False,False,False,0,1,2021-01-04T14:10:08.613,0,,0.0
2020,17,3043,190,15,922,2,4,4,10,10,0,10,0,10,0,False,False,False,0,4,2021-01-04T14:16:19.683,10,,0.0
2020,17,3043,235,15,7591,13,3,2,16,0,0,0,0,0,0,False,False,False,0,2,2021-01-04T14:26:23.227,0,,0.0
2020,17,3043,255,14,1119,2,46,3,4,7,3,5,2,5,0,False,False,False,0,4,2021-01-05T20:23:15.547,7,,2.0
2020,17,3043,265,14,6543,2,12,3,2,2,0,2,0,2,0,False,False,False,0,2,2021-01-04T14:35:32.38,2,,0.0
2020,17,3043,275,15,7591,2,35,6,15,18,3,15,3,15,0,False,False,False,0,3,2021-01-04T14:39:01.37,18,,3.0
2020,17,3043,285,15,4886,13,4,9,2,0,0,0,0,0,0,False,False,False,0,1,2021-01-07T13:29:34.543,0,,0.0
2020,17,3043,295,15,7591,13,5,5,6,0,0,0,0,0,0,True,False,False,0,3,2021-01-07T13:44:29.57,0,,0.0
2020,17,3043,300,14,1114,13,6,9,4,0,0,0,0,0,0,False,False,False,0,2,2021-01-04T14:50:40.29,0,,0.0
2020,17,3043,305,14,1114,13,21,8,37,0,0,0,0,0,0,False,False,False,0,3,2021-01-04T14:52:18.843,0,,
2020,17,3043,315,14,7584,2,2,10,7,15,8,11,4,11,0,False,False,False,0,2,2021-01-04T14:55:54.943,15,,4.0
2020,17,3043,345,15,2407,2,8,9,14,17,3,14,3,14,0,False,False,False,0,2,2021-01-07T13:29:34.543,17,,3.0
2020,17,3043,350,15,2407,2,4,5,5,9,4,7,2,7,0,False,False,False,0,2,2021-01-04T15:01:49.12,9,,2.0
2020,17,3043,360,15,4997,2,2,4,5,8,3,7,1,7,0,False,False,False,0,3,2021-01-04T15:04:19.273,8,,1.0
2020,17,3043,365,15,7335,2,5,5,5,5,0,5,0,5,0,False,False,False,0,3,2021-01-04T15:05:21.153,5,,0.0
2020,17,3043,370,15,7335,2,6,9,5,6,1,5,1,5,0,False,False,False,0,3,2021-01-04T15:06:20.933,6,,1.0
2020,17,3043,375,15,7335,2,8,7,18,21,3,20,1,20,0,False,False,False,0,3,2021-01-04T15:07:28.44,21,,1.0
2020,17,3043,380,15,7591,2,2,9,7,9,2,9,0,9,6,False,False,False,0,2,2021-01-04T15:08:17.753,9,,0.0
2020,17,3043,405,14,6543,2,48,9,-6,14,20,10,4,10,0,False,False,False,0,1,2021-01-04T15:12:52.3,14,,4.0
2020,17,3043,415,14,6543,2,12,10,3,9,6,7,2,7,0,False,False,False,0,1,2021-03-08T18:29:18.153,9,,2.0
2020,17,3043,480,15,4886,2,45,5,-5,2,7,1,1,1,0,False,False,False,0,1,2021-01-04T15:27:16.387,2,,1.0
2020,17,3043,485,15,2407,2,52,4,6,15,9,8,7,8,0,False,False,False,0,2,2021-01-07T15:17:01.98,15,,7.0
2020,17,3043,500,15,4997,2,47,5,3,3,0,3,0,3,0,False,False,False,0,3,2021-01-04T15:32:15.343,3,,0.0
2020,17,3043,505,15,4997,2,2,4,9,12,3,12,0,12,0,False,False,False,1,3,2021-01-04T15:35:19.793,12,,0.0
2020,17,3043,510,15,4702,2,13,10,4,9,5,6,3,6,0,False,False,False,0,4,2021-01-04T15:36:52.873,9,,3.0
2020,17,3043,520,15,7591,2,7,5,8,8,0,8,0,8,6,True,False,False,0,3,2021-02-25T17:47:49.127,8,,0.0
2020,17,3043,555,15,2407,13,2,4,10,0,0,0,0,0,0,False,False,False,0,2,2021-01-07T15:07:59.763,0,,0.0
2020,17,3043,560,15,4997,13,12,4,7,0,0,0,0,0,0,False,False,False,0,3,2021-03-08T18:29:35.177,0,,0.0
2020,17,3043,565,15,4997,3,6,10,14,0,0,0,0,0,0,False,False,False,0,3,2021-01-04T15:49:08.757,0,,0.0
2020,17,3043,575,14,4449,2,35,6,22,25,3,22,3,22,0,False,False,False,0,3,2021-01-04T15:51:56.723,25,,3.0
2020,17,3043,580,14,4449,2,55,4,-4,16,20,13,3,13,0,False,False,False,0,3,2021-01-04T15:53:09.88,16,,3.0
2020,17,3043,590,14,1114,13,8,1,36,0,0,0,0,0,0,False,False,False,0,2,2021-01-04T16:00:09.92,0,,0.0
2020,17,3043,600,15,7591,2,39,4,4,6,2,5,1,5,0,False,False,False,0,3,2021-01-04T16:03:17.913,6,,1.0
2020,17,3043,605,15,2407,2,47,5,3,12,9,11,1,11,0,False,False,False,0,3,2021-01-04T16:06:11.103,12,,1.0
2020,17,3043,620,15,2407,3,4,10,12,0,0,0,0,0,0,False,False,False,0,3,2021-01-04T16:09:49.417,0,,0.0
2020,17,3043,625,15,4997,13,4,1,18,0,0,0,0,0,0,False,False,False,0,3,2021-01-04T16:12:11.47,0,,0.0
2020,17,3043,635,14,1119,2,39,9,4,8,4,5,3,5,0,False,False,False,0,4,2021-01-04T16:26:58.823,8,,3.0
2020,17,3043,640,14,1114,2,13,10,6,6,0,6,0,6,0,False,False,False,0,3,2021-01-04T16:28:46.763,6,,0.0
2020,17,3043,655,14,4449,3,6,7,19,0,0,0,0,0,0,False,False,False,0,2,2021-01-04T16:34:33.587,0,,0.0
2020,17,3043,660,14,1119,2,53,4,-2,2,4,1,1,1,0,False,False,False,0,4,2021-01-04T16:39:16.51,2,,1.0
2020,17,3043,665,14,1114,13,6,8,18,0,0,0,0,0,0,False,False,False,0,2,2021-01-04T16:40:26.643,0,,0.0
2020,17,3043,675,15,7591,2,35,3,11,21,10,17,4,17,0,False,False,False,0,3,2021-01-05T17:55:15.987,21,,4.0
2020,17,3043,700,15,922,13,47,5,2,0,0,0,0,0,0,False,False,False,0,4,2021-01-04T16:49:16.083,0,,0.0
2020,17,3043,715,14,1114,13,6,7,17,0,0,0,0,0,0,False,False,False,0,2,2021-01-04T16:54:32.96,0,,0.0
2020,17,3043,720,14,7584,2,2,10,8,13,5,10,3,10,0,False,False,False,0,2,2021-01-04T16:56:26.097,13,,3.0
2020,17,3043,730,14,7582,2,46,9,0,1,1,1,0,1,0,False,False,False,0,1,2021-01-04T17:00:07.073,1,,0.0
2020,17,3043,735,14,7582,3,28,3,0,0,0,0,0,0,0,False,False,False,0,1,2021-01-04T17:02:35.563,0,,0.0
2020,17,3043,750,15,2407,2,39,4,6,6,0,6,0,6,0,False,False,False,0,3,2021-01-04T17:08:01.37,6,,0.0
2020,17,3043,755,15,7335,3,6,9,12,0,0,0,0,0,0,False,False,False,0,2,2021-01-04T22:40:43.313,0,,0.0
2020,17,3043,785,15,4997,13,13,4,6,0,0,0,0,0,0,False,False,False,0,3,2021-01-04T17:17:10.203,0,,0.0
2020,17,3043,790,15,2407,2,5,3,10,13,3,11,2,11,0,False,False,False,0,3,2021-01-04T17:18:14.26,13,,2.0
2020,17,3043,795,15,4886,2,4,9,3,11,8,8,3,8,0,False,False,False,0,1,2021-01-04T17:19:30.54,11,,3.0
2020,17,3043,800,15,4886,13,4,4,0,0,0,0,0,0,0,False,False,False,0,1,2021-01-04T17:20:56.883,0,,0.0
2020,17,3043,805,15,2757,2,31,10,6,10,4,9,1,9,0,False,False,False,1,4,2021-01-04T17:22:41.533,10,,1.0
2020,17,3043,810,15,4886,2,12,5,1,3,2,2,1,2,0,False,False,False,0,1,2021-01-07T15:11:41.147,3,,1.0
2020,17,3043,815,15,7591,2,6,9,4,6,2,5,1,5,0,False,False,False,0,2,2021-01-04T17:26:48.143,6,,1.0
2020,17,3044,10,16,6565,2,30,10,-3,-2,1,-2,0,-2,0,False,False,False,0,4,2021-01-04T11:14:21.453,-2,,0.0
2020,17,3044,20,16,7210,2,48,10,-5,37,42,35,2,35,0,True,False,False,0,1,2021-01-05T22:15:22.603,37,,2.0
2020,17,3044,25,16,7210,2,44,3,-4,3,7,3,0,3,0,False,False,False,0,1,2021-01-04T11:19:42.37,3,,0.0
2020,17,3044,30,16,7176,2,51,3,-2,7,9,5,2,5,0,False,False,False,0,3,2021-01-07T16:17:06.257,7,,2.0
2020,17,3044,35,16,6499,2,48,9,-5,2,7,-5,7,-5,0,False,False,False,1,1,2021-01-07T16:35:58.89,2,,7.0
2020,17,3044,40,16,6500,2,2,4,3,3,0,3,0,3,6,False,False,False,0,4,2021-01-04T18:58:23.827,3,,0.0
2020,17,3044,55,26,4616,2,47,10,2,3,1,2,1,2,0,False,False,False,0,1,2021-01-07T16:00:58.367,3,,1.0
2020,17,3044,60,26,4616,2,51,3,-4,7,11,2,5,2,0,True,False,False,1,1,2021-01-04T11:32:24.417,7,,5.0
2020,17,3044,65,26,7491,2,30,10,1,7,6,5,2,5,0,False,False,False,3,4,2021-01-07T16:36:51.21,7,,2.0
2020,17,3044,80,26,4050,2,2,4,12,17,5,15,2,15,0,False,False,False,0,4,2021-03-09T18:18:54.503,17,,2.0
2020,17,3044,90,26,4619,2,5,5,13,11,-2,11,0,11,0,False,False,False,0,3,2021-01-04T11:41:38.93,11,,0.0
2020,17,3044,110,26,7491,2,12,3,2,8,6,2,6,2,6,True,False,False,1,4,2021-01-07T16:37:02.74,8,,6.0
2020,17,3044,125,16,4143,2,5,3,10,11,1,11,0,11,0,False,False,False,0,3,2021-01-04T11:49:31.71,11,,0.0
2020,17,3044,130,16,7210,2,44,3,-4,2,6,0,2,0,0,False,False,False,0,1,2021-01-04T11:51:18.463,2,,
2020,17,3044,135,16,6565,13,12,3,5,0,0,0,0,0,0,True,False,False,0,4,2021-01-04T11:53:41.11,0,,0.0
2020,17,3044,140,16,6565,2,4,9,4,8,4,4,4,4,0,False,False,False,0,4,2021-01-04T11:54:50.423,8,,4.0
2020,17,3044,150,16,4143,2,3,5,7,8,1,8,0,8,0,False,False,False,0,2,2021-02-23T19:28:21.16,8,,0.0
2020,17,3044,155,16,6565,13,19,8,24,0,0,0,0,0,0,False,False,False,0,3,2021-03-09T18:20:46.62,0,,0.0
2020,17,3044,160,16,7176,2,51,9,-3,18,21,16,2,16,0,True,False,False,0,4,2021-01-05T22:14:40.503,18,,2.0
2020,17,3044,165,16,5033,13,6,9,11,0,0,0,0,0,0,False,False,False,0,3,2021-03-09T18:21:54.56,0,,0.0
2020,17,3044,180,16,6500,2,12,10,6,12,6,10,2,10,0,False,False,False,0,3,2021-01-04T12:04:58.503,12,,2.0
2020,17,3044,215,26,7491,2,35,10,13,22,9,19,3,19,0,False,False,False,1,4,2021-01-07T16:37:32.433,22,,3.0
2020,17,3044,220,26,7453,3,8,8,40,0,0,0,0,0,0,False,False,False,0,2,2021-01-04T12:14:21.203,0,,0.0
2020,17,3044,225,26,4619,13,2,9,5,0,0,0,0,0,0,False,False,False,0,2,2021-01-04T12:15:37.417,0,,0.0
2020,17,3044,230,26,4616,3,5,5,4,0,0,0,0,0,0,False,False,False,0,3,2021-01-04T12:17:25.057,0,,0.0
2020,17,3044,240,26,4616,2,5,5,2,9,7,6,3,6,0,False,False,False,1,1,2021-01-04T12:20:31.183,9,,3.0
2020,17,3044,255,26,4616,2,50,3,-1,4,5,2,2,2,6,False,False,False,1,2,2021-01-07T16:37:56.73,4,,2.0
2020,17,3044,270,16,6565,13,11,2,19,0,0,0,0,0,0,True,False,False,0,3,2021-01-07T16:02:38.75,0,,0.0
2020,17,3044,275,16,7210,2,48,9,-4,3,7,0,3,0,0,False,False,False,1,1,2021-01-07T16:42:17.977,3,,3.0
2020,17,3044,285,16,6500,13,5,3,7,0,0,0,0,0,0,False,False,False,0,3,2021-01-04T12:31:37.55,0,,0.0
2020,17,3044,305,26,4619,2,7,6,19,20,1,20,0,20,0,False,False,False,0,3,2021-01-07T16:17:47.35,20,,0.0
2020,17,3044,315,26,6301,13,44,3,-3,0,0,0,0,0,0,False,False,False,0,1,2021-01-07T16:31:27.27,0,,0.0
2020,17,3044,320,26,4619,2,2,9,5,11,6,9,2,9,0,False,False,False,0,2,2021-01-07T16:42:53.87,11,,2.0
2020,17,3044,330,26,6301,2,48,3,-7,32,39,4,28,4,0,False,False,False,2,1,2021-01-04T12:44:53.327,32,,28.0
2020,17,3044,340,26,7453,13,9,3,10,0,0,0,0,0,0,False,False,False,0,3,2021-01-07T16:43:09.49,0,,0.0
2020,17,3044,345,26,4616,2,47,5,2,6,4,4,2,4,0,False,False,False,0,1,2021-01-07T16:43:20.143,6,,2.0
2020,17,3044,355,26,7491,13,7,5,2,0,0,0,0,0,0,False,False,False,0,4,2021-01-07T16:17:58.91,0,,0.0
2020,17,3044,360,26,7453,13,5,5,2,0,0,0,0,0,0,False,False,False,0,3,2021-01-07T16:10:29.623,0,,0.0
2020,17,3044,395,26,4619,2,4,5,7,6,-1,6,0,6,0,False,False,False,0,2,2021-01-04T12:58:47.11,6,,0.0
2020,17,3044,400,26,4619,2,4,5,9,12,3,9,3,9,0,False,False,False,0,2,2021-01-04T18:54:48.097,12,,3.0
2020,17,3044,405,26,4616,2,28,10,0,4,4,3,1,3,0,False,False,False,0,1,2021-01-04T13:01:44.163,4,,1.0
2020,17,3044,410,26,4616,3,16,10,3,0,0,0,0,0,0,False,False,False,0,1,2021-01-07T16:11:08.95,0,,
2020,17,3044,415,26,4619,13,9,2,22,0,0,0,0,0,0,False,False,False,0,2,2021-01-04T13:05:33.593,0,,
2020,17,3044,440,16,7210,2,28,9,-4,-2,2,-2,0,-2,0,False,True,False,0,1,2021-01-04T13:11:18.213,-1,,0.0
2020,17,3044,465,26,4050,2,32,3,0,17,17,5,12,5,0,False,False,False,2,4,2021-01-07T16:38:21.703,17,,12.0
2020,17,3044,470,26,7453,13,19,2,38,0,0,0,0,0,0,False,False,False,0,2,2021-01-07T16:12:39.413,0,,0.0
2020,17,3044,505,16,6500,2,39,4,6,6,0,6,0,6,0,False,False,False,0,3,2021-01-04T13:31:34.527,6,,0.0
2020,17,3044,515,16,4143,2,4,3,4,9,5,6,3,6,0,False,False,False,0,2,2021-01-04T13:33:46.123,9,,3.0
2020,17,3044,520,16,4143,13,9,2,18,0,0,0,0,0,0,False,False,False,0,2,2021-01-07T16:18:13.507,0,,0.0
2020,17,3044,535,16,4143,2,4,9,14,12,-2,12,0,12,0,False,False,False,0,2,2021-01-04T13:39:13.9,12,,0.0
2020,17,3044,545,16,4143,2,4,10,4,10,6,6,4,6,0,False,False,False,1,3,2021-01-04T13:42:17.02,10,,4.0
2020,17,3044,560,26,8177,2,47,5,2,5,3,5,0,5,0,False,False,False,0,1,2021-01-04T13:46:55.13,5,,0.0
2020,17,3044,575,26,7514,2,3,3,9,8,-1,7,1,7,0,False,False,False,0,2,2021-01-04T18:55:59.783,8,,1.0
2020,17,3044,585,26,4619,2,24,6,43,48,5,48,0,48,6,False,False,False,0,2,2021-01-04T13:53:51.04,48,,0.0
2020,17,3044,600,16,4143,2,51,9,-4,8,12,8,0,8,0,False,False,False,0,2,2021-02-23T19:30:24.463,8,,0.0
2020,17,3044,610,16,5033,2,2,4,5,10,5,6,4,6,0,False,False,False,0,3,2021-01-04T13:57:19.153,10,,4.0
2020,17,3044,615,16,7210,2,44,3,-3,12,15,11,1,11,0,False,False,False,1,1,2021-01-07T16:13:18.11,12,,1.0
2020,17,3044,625,16,6500,13,4,3,12,0,0,0,0,0,0,False,False,False,0,2,2021-01-04T14:00:43.463,0,,0.0
2020,17,3044,630,16,6500,2,39,4,8,31,23,8,23,8,0,False,False,False,4,3,2021-01-04T14:02:54.573,31,,23.0
2020,17,3044,640,16,6565,13,5,3,8,0,0,0,0,0,0,True,False,False,0,3,2021-01-07T16:14:26.07,0,,0.0
2020,17,3044,645,16,7210,2,46,3,2,8,6,8,0,8,6,False,False,False,0,1,2021-01-04T14:09:22.173,8,,0.0
2020,17,3044,675,26,7514,2,4,5,8,27,19,9,18,9,0,False,False,False,1,2,2021-01-04T14:16:12.903,27,,18.0
2020,17,3044,705,16,5033,2,4,3,9,8,-1,8,0,8,0,False,False,False,0,2,2021-03-09T18:28:48.493,8,,
2020,17,3044,715,16,7210,2,48,9,-5,3,8,-6,9,-6,0,False,False,False,1,1,2021-01-07T16:43:36.183,3,,9.0
2020,17,3044,740,26,4050,2,53,4,-5,18,23,17,1,17,0,False,False,False,0,4,2021-01-04T14:34:33.887,18,,1.0
2020,17,3045,10,24,6389,13,19,2,28,0,0,0,0,0,0,False,False,False,0,2,2021-01-04T12:59:12.057,0,,0.0
2020,17,3045,40,32,7807,2,45,5,-2,6,8,6,0,6,0,False,False,False,0,1,2021-02-23T22:38:58.137,6,,0.0
2020,17,3045,55,32,6430,2,44,3,-5,1,6,-2,3,-2,0,True,False,False,0,3,2021-01-04T13:11:40.347,1,,3.0
2020,17,3045,65,32,3885,2,28,10,-2,10,12,8,2,8,0,False,False,False,0,1,2021-01-04T13:16:27.647,10,,2.0
2020,17,3045,80,32,1427,2,53,10,-4,18,22,16,2,16,0,False,False,False,0,4,2021-01-04T13:21:11.88,18,,2.0
2020,17,3045,90,32,7128,13,13,5,4,0,0,0,0,0,0,False,False,False,0,3,2021-02-23T22:40:23.277,0,,0.0
2020,17,3045,95,32,6430,2,2,9,3,16,13,15,1,15,0,False,False,False,0,2,2021-01-04T13:25:09.697,16,,1.0
2020,17,3045,110,32,6430,2,5,5,5,5,0,5,0,5,0,False,False,False,0,3,2021-01-04T13:28:09.873,5,,0.0
2020,17,3045,115,32,7128,2,7,3,5,5,0,5,0,5,6,False,False,False,0,3,2021-01-04T13:29:45.127,5,,0.0
2020,17,3045,130,24,4382,13,5,5,5,0,0,0,0,0,0,False,False,False,0,3,2021-01-04T13:36:36.303,0,,0.0
2020,17,3045,135,24,894,13,2,9,7,0,0,0,0,0,0,False,False,False,0,2,2021-03-05T14:21:28.71,0,,0.0
2020,17,3045,145,32,7128,2,5,10,4,6,2,6,0,6,0,False,False,False,0,3,2021-01-07T23:37:49.99,6,,0.0
2020,17,3045,150,32,7128,2,2,9,5,5,0,5,0,5,0,False,False,False,0,3,2021-01-05T23:48:56.953,5,,0.0
2020,17,3045,165,24,7798,13,8,6,36,0,0,0,0,0,0,False,False,False,0,3,2021-01-04T13:48:51.757,0,,
2020,17,3045,180,24,7003,13,29,6,21,0,0,0,0,0,0,False,False,False,0,2,2021-01-04T13:53:03.753,0,,
2020,17,3045,185,24,6808,2,12,2,15,15,0,15,0,15,0,False,False,False,0,2,2021-01-04T13:54:47.95,15,,0.0
2020,17,3045,205,24,6389,2,4,3,2,9,7,9,0,9,0,False,False,False,0,2,2021-01-04T14:03:24.977,9,,0.0
2020,17,3045,255,32,3885,2,47,5,2,4,2,4,0,4,0,True,False,False,0,4,2021-01-04T14:20:09.077,4,,0.0
2020,17,3045,270,24,894,2,32,5,3,7,4,4,3,4,0,True,False,False,0,4,2021-01-08T00:29:30.82,7,,3.0
2020,17,3045,275,24,894,2,5,5,4,4,0,4,0,4,0,False,False,False,0,3,2021-01-04T14:31:04.147,4,,0.0
2020,17,3045,280,24,7798,2,3,2,15,15,0,15,0,15,0,False,False,False,0,2,2021-01-04T14:32:48.17,15,,0.0
2020,17,3045,295,24,7003,2,17,1,27,30,3,27,3,27,0,False,False,False,0,3,2021-01-08T00:41:34.967,30,,3.0
2020,17,3045,315,32,7128,2,13,10,5,5,0,5,0,5,0,False,False,False,0,2,2021-02-23T22:45:48.973,5,,0.0
2020,17,3045,335,24,7800,3,51,3,-5,0,0,0,0,0,0,True,False,False,0,2,2021-01-04T14:50:53.58,0,,0.0
2020,17,3045,340,24,7003,13,4,3,9,0,0,0,0,0,0,False,False,False,0,2,2021-01-04T14:52:02.713,0,,0.0
2020,17,3045,345,24,894,13,5,3,9,0,0,0,0,0,0,False,False,False,0,3,2021-01-05T23:49:11.43,0,,0.0
2020,17,3045,355,32,3885,2,47,5,1,4,3,2,2,2,0,False,False,False,0,1,2021-01-04T14:56:16.82,4,,2.0
2020,17,3045,360,32,3885,13,45,5,-3,0,0,0,0,0,0,False,False,False,0,1,2021-01-04T14:57:24.627,0,,0.0
2020,17,3045,365,32,6430,2,6,9,13,15,2,15,0,15,0,False,False,False,0,2,2021-01-04T14:58:39.9,15,,0.0
2020,17,3045,375,32,6430,2,50,5,-1,6,7,6,0,6,0,False,False,False,0,2,2021-01-04T15:00:13.563,6,,0.0
2020,17,3045,380,32,1427,13,5,5,0,0,0,0,0,0,0,False,False,False,0,3,2021-01-04T15:01:13.597,0,,0.0
2020,17,3045,390,32,7494,2,39,4,6,6,0,6,0,6,0,False,False,False,0,3,2021-01-04T15:03:01.953,6,,0.0
2020,17,3045,400,32,3885,2,5,5,4,6,2,6,0,6,0,False,False,False,0,1,2021-01-04T15:04:17.043,6,,0.0
2020,17,3045,410,32,1427,2,35,10,13,13,0,13,0,13,6,False,False,False,0,3,2021-01-04T15:07:10.253,13,,0.0
2020,17,3045,475,24,6389,13,12,5,5,0,0,0,0,0,0,False,False,False,0,1,2021-01-04T15:37:08.897,0,,0.0
2020,17,3045,485,32,7128,2,4,10,5,5,0,5,0,5,0,False,False,False,0,3,2021-02-23T22:46:40.43,5,,0.0
2020,17,3045,505,24,4382,13,47,5,5,0,0,0,0,0,0,True,False,False,0,2,2021-02-23T22:47:26.34,0,,0.0
2020,17,3045,515,24,4385,2,51,3,-3,7,10,4,3,4,0,False,False,False,0,3,2021-01-04T15:51:51.007,7,,3.0
2020,17,3045,530,24,7734,2,44,3,-3,0,3,0,0,0,0,False,False,False,0,1,2021-01-04T15:55:47.06,0,,0.0
2020,17,3045,540,24,7800,3,12,5,13,0,0,0,0,0,0,False,False,False,0,2,2021-01-04T15:58:48.5,0,,0.0
2020,17,3045,555,32,3885,13,45,5,-5,0,0,0,0,0,0,True,False,False,0,3,2021-03-05T14:23:07.633,0,,0.0
2020,17,3045,585,24,894,13,12,5,4,0,0,0,0,0,0,False,False,False,0,3,2021-01-05T23:49:22.413,0,,0.0
2020,17,3045,590,24,7800,13,12,3,4,0,0,0,0,0,0,False,False,False,0,2,2021-01-04T16:13:03.23,0,,0.0
2020,17,3045,595,32,7128,2,4,5,9,11,2,11,0,11,0,False,False,False,0,2,2021-01-04T16:14:37.877,11,,0.0
2020,17,3045,605,32,1427,2,54,10,-6,6,12,4,2,4,0,False,False,False,0,4,2021-01-08T00:32:59.89,6,,2.0
2020,17,3045,625,32,7128,2,5,9,3,3,0,3,0,3,0,False,False,False,0,3,2021-01-07T23:37:49.99,3,,0.0
2020,17,3045,630,32,3885,3,2,9,4,0,0,0,0,0,0,True,False,False,0,3,2021-01-04T16:23:52.43,0,,0.0
2020,17,3045,655,24,7799,13,19,2,39,0,0,0,0,0,0,False,False,False,0,2,2021-03-05T14:24:19.477,0,,0.0
2020,17,3045,670,32,1427,13,5,3,13,0,0,0,0,0,0,False,False,False,0,4,2021-01-05T23:50:52.93,0,,0.0
2020,17,3045,675,24,894,2,39,9,4,5,1,5,0,5,0,True,False,False,0,3,2021-01-07T23:37:49.99,5,,0.0
2020,17,3045,695,32,1427,13,4,10,3,0,0,0,0,0,0,False,False,False,0,3,2021-01-04T16:56:05.743,0,,0.0
2020,17,3045,700,32,3885,2,50,3,-5,6,11,4,2,4,0,True,False,False,0,2,2021-01-04T16:57:38.29,6,,2.0
2020,17,3045,720,24,7800,3,5,6,15,0,0,0,0,0,0,False,False,False,0,2,2021-02-23T22:52:36.903,0,,0.0
2020,17,3045,725,24,7003,2,3,3,10,10,0,10,0,10,0,False,False,False,0,2,2021-01-08T00:33:57.123,10,,0.0
2020,17,3045,735,24,6389,2,50,5,-1,5,6,4,1,4,0,False,False,False,1,2,2021-01-04T17:43:43.693,5,,1.0
2020,17,3045,825,24,4382,2,32,10,-4,6,10,6,0,6,0,False,False,False,0,4,2021-01-04T17:43:03.437,6,,0.0
2020,17,3045,835,24,6389,13,12,3,0,0,0,0,0,0,0,False,False,False,0,1,2021-03-08T18:42:18.073,0,,0.0
2020,17,3045,845,24,7799,13,9,2,23,0,0,0,0,0,0,False,False,False,0,2,2021-01-04T17:30:15.747,0,,0.0
2020,17,3045,855,24,7800,2,52,9,4,6,2,6,0,6,0,False,False,False,0,3,2021-01-04T17:42:37.947,6,,0.0
2020,17,3046,20,23,2256,13,4,5,8,0,0,0,0,0,0,False,False,False,0,2,2021-01-04T11:07:50.487,0,,0.0
2020,17,3046,35,10,7700,2,2,10,7,7,0,7,0,7,0,False,False,False,0,2,2021-02-24T14:08:02.923,7,,0.0
2020,17,3046,60,10,4930,2,13,10,1,17,16,8,9,8,0,False,False,False,0,3,2021-01-04T11:27:55.197,17,,9.0
2020,17,3046,65,10,6286,2,35,10,11,14,3,14,0,14,0,False,False,False,0,4,2021-01-04T11:29:40.37,14,,0.0
2020,17,3046,70,10,6286,3,6,10,9,0,0,0,0,0,0,False,False,False,0,4,2021-02-24T20:35:07.043,0,,0.0
2020,17,3046,80,10,4930,13,13,3,3,0,0,0,0,0,0,False,False,False,0,3,2021-01-04T11:36:19.437,0,,0.0
2020,17,3046,95,23,7250,13,2,4,6,0,0,0,0,0,0,False,False,False,0,3,2021-01-04T11:42:12.337,0,,0.0
2020,17,3046,100,23,2994,2,2,10,6,9,3,6,3,6,0,False,False,False,0,3,2021-02-24T14:12:13.107,9,,3.0
2020,17,3046,115,23,2256,2,19,7,50,57,7,57,0,57,0,False,False,False,0,2,2021-02-24T14:14:01.46,57,,0.0
2020,17,3046,125,23,2256,2,35,10,7,7,0,7,0,7,6,False,False,False,0,3,2021-01-04T11:54:24.07,7,,
2020,17,3046,140,23,2994,2,51,10,1,5,4,5,0,5,0,False,False,False,0,3,2021-01-04T12:01:07.797,5,,0.0
2020,17,3046,165,10,4930,13,19,6,34,0,0,0,0,0,0,False,False,False,0,2,2021-01-04T12:06:52.47,0,,0.0
2020,17,3046,170,10,7702,2,5,6,17,17,0,17,0,17,0,False,False,False,0,2,2021-01-04T12:08:37.283,17,,0.0
2020,17,3046,185,10,4930,2,2,10,7,29,22,17,12,17,0,False,False,False,1,2,2021-01-07T22:35:08.057,29,,12.0
2020,17,3046,200,10,7702,13,7,3,3,0,0,0,0,0,0,False,False,False,0,2,2021-01-07T21:37:15.52,0,,
2020,17,3046,205,10,6286,2,35,9,1,1,0,1,0,1,6,True,False,False,0,4,2021-02-24T14:15:03.05,1,,0.0
2020,17,3046,230,23,2994,2,5,3,6,9,3,9,0,9,0,False,True,True,0,3,2021-01-04T12:28:32.123,9,,0.0
2020,17,3046,240,10,6840,13,5,10,8,0,0,0,0,0,0,False,False,False,0,4,2021-01-04T12:33:23.067,0,,0.0
2020,17,3046,255,23,7250,2,26,10,-1,8,9,6,2,6,0,False,False,False,0,3,2021-01-06T02:37:32.107,8,,2.0
2020,17,3046,265,23,7241,13,12,5,5,0,0,0,0,0,0,False,False,False,0,1,2021-03-08T18:47:15.023,0,,
2020,17,3046,280,23,2994,2,19,2,28,28,0,28,0,28,6,False,False,False,0,3,2021-02-24T14:16:47.683,28,,0.0
2020,17,3046,305,10,7702,2,6,7,16,16,0,16,0,16,0,False,False,False,0,2,2021-01-04T12:54:36.333,16,,0.0
2020,17,3046,310,10,7700,13,4,9,10,0,0,0,0,0,0,False,False,False,0,2,2021-02-24T14:25:29.293,0,,0.0
2020,17,3046,315,10,282,13,44,3,-2,0,0,0,0,0,0,False,False,False,0,1,2021-01-04T12:59:12.467,0,,0.0
2020,17,3046,325,10,7702,2,26,10,8,8,0,8,0,8,0,False,False,False,0,3,2021-01-04T13:02:13.85,8,,0.0
2020,17,3046,345,10,7702,2,26,10,2,4,2,4,0,4,0,True,False,False,0,3,2021-01-04T13:08:27.727,4,,0.0
2020,17,3046,350,10,7702,13,26,9,2,0,0,0,0,0,0,False,False,False,0,3,2021-01-04T13:10:05.643,0,,0.0
2020,17,3046,355,23,7688,2,4,1,18,18,0,18,0,18,0,False,False,False,0,3,2021-02-24T20:35:07.043,18,,0.0
2020,17,3046,365,23,567,2,16,10,6,12,6,8,4,8,0,False,False,False,0,1,2021-01-07T22:40:59.413,12,,4.0
2020,17,3046,370,23,567,13,28,10,0,0,0,0,0,0,0,False,False,False,0,1,2021-02-24T14:28:16.853,0,,0.0
2020,17,3046,375,23,2256,13,21,8,42,0,0,0,0,0,0,False,False,False,0,3,2021-01-04T13:26:22.757,0,,0.0
2020,17,3046,395,10,7702,13,6,10,9,0,0,0,0,0,0,False,False,False,0,2,2021-01-04T13:32:38.627,0,,
2020,17,3046,400,10,282,2,47,5,-1,1,2,1,0,1,0,False,False,False,0,1,2021-01-04T13:34:58.907,1,,0.0
2020,17,3046,420,10,6840,2,53,10,-6,9,15,6,3,6,0,False,False,False,0,4,2021-01-04T13:41:30.937,9,,3.0
2020,17,3046,435,23,567,2,5,3,1,5,4,5,0,5,0,False,False,False,2,1,2021-01-07T22:35:20.17,5,,0.0
2020,17,3046,440,23,567,2,5,3,2,15,13,15,0,15,0,False,False,False,0,1,2021-01-04T13:46:18.32,15,,0.0
2020,17,3046,445,23,7688,2,6,8,15,15,0,15,0,15,0,False,False,False,0,3,2021-01-07T22:43:43.077,15,,0.0
2020,17,3046,455,23,7250,13,6,4,4,0,0,0,0,0,0,True,False,False,0,3,2021-02-24T14:29:18.423,0,,0.0
2020,17,3046,470,23,7689,2,29,2,26,26,0,26,0,26,6,False,False,False,0,2,2021-01-04T13:56:01.477,26,,0.0
2020,17,3046,485,10,7082,2,39,4,6,9,3,9,0,9,0,False,False,False,0,3,2021-01-04T14:02:51.58,9,,0.0
2020,17,3046,495,10,6840,2,32,3,2,9,7,8,1,8,0,False,False,False,0,4,2021-01-04T14:04:32.933,9,,1.0
2020,17,3046,500,10,6282,2,46,3,0,1,1,1,0,1,0,False,False,False,0,1,2021-01-04T14:06:04.843,1,,0.0
2020,17,3046,505,10,6285,13,6,7,16,0,0,0,0,0,0,False,False,False,0,2,2021-01-07T22:44:20.027,0,,0.0
2020,17,3046,510,10,6285,13,2,4,3,0,0,0,0,0,0,False,False,False,0,3,2021-01-04T14:09:49.003,0,,
2020,17,3046,525,10,282,2,45,10,-6,2,8,-1,3,-1,0,False,False,False,0,1,2021-01-04T14:20:24.713,2,,3.0
2020,17,3046,535,10,6285,2,12,3,11,11,0,11,0,11,0,False,False,False,0,3,2021-01-04T14:23:50.433,11,,0.0
2020,17,3046,540,10,7700,2,35,10,12,12,0,12,0,12,0,False,False,False,1,3,2021-01-07T22:35:47.303,12,,0.0
2020,17,3046,545,10,6285,3,35,5,7,0,0,0,0,0,0,False,False,False,0,3,2021-01-04T14:27:19.287,0,,0.0
2020,17,3046,550,10,6285,13,19,6,29,0,0,0,0,0,0,False,False,False,0,2,2021-01-04T14:29:18.423,0,,
2020,17,3046,560,10,6840,13,35,10,9,0,0,0,0,0,0,False,False,False,0,4,2021-01-04T14:33:18.183,0,,0.0
2020,17,3046,565,10,6285,13,7,2,17,0,0,0,0,0,0,False,False,False,0,2,2021-02-25T17:58:01.66,0,,0.0
2020,17,3046,585,23,7250,13,4,5,3,0,0,0,0,0,0,False,False,False,0,3,2021-01-04T14:39:21.127,0,,0.0
2020,17,3046,605,10,6285,13,19,2,30,0,0,0,0,0,0,False,False,False,0,2,2021-01-04T14:45:19.367,0,,0.0
2020,17,3046,610,10,7700,2,13,10,3,4,1,4,0,4,0,False,False,False,0,3,2021-01-04T14:48:55.107,4,,0.0
2020,17,3046,630,23,7688,2,5,5,4,5,1,5,0,5,0,False,False,False,0,3,2021-01-04T14:54:24.013,5,,0.0
2020,17,3046,635,23,2994,3,6,10,14,0,0,0,0,0,0,False,False,False,0,4,2021-03-05T14:27:01.467,0,,0.0
2020,17,3046,645,10,6840,2,29,6,17,20,3,17,3,17,0,False,False,False,0,3,2021-01-04T15:01:11.86,20,,3.0
2020,17,3046,655,10,282,13,11,5,1,0,0,0,0,0,0,True,False,False,0,1,2021-01-04T15:08:20.357,0,,0.0
2020,17,3046,660,10,6285,2,13,10,0,7,7,1,6,1,0,False,False,False,0,3,2021-01-07T22:36:41.79,7,,6.0
2020,17,3046,675,23,2994,2,4,10,5,14,9,10,4,10,0,False,False,False,0,4,2021-01-04T15:16:25.38,14,,4.0
2020,17,3046,685,10,282,2,44,3,-1,13,14,7,6,7,0,False,False,False,1,1,2021-01-07T22:37:03.47,13,,6.0
2020,17,3046,695,10,6840,2,32,10,1,10,9,9,1,9,0,False,False,False,0,4,2021-01-04T15:25:53.433,10,,1.0
2020,17,3046,730,23,2994,13,9,6,19,0,0,0,0,0,0,False,False,False,0,2,2021-01-07T22:45:37.313,0,,
2020,17,3046,735,23,2256,13,6,9,13,0,0,0,0,0,0,False,False,False,0,3,2021-03-05T14:27:46.723,0,,0.0
2020,17,3046,745,10,282,2,44,9,-4,1,5,-1,2,-1,0,False,False,False,0,1,2021-01-04T15:48:35.49,1,,2.0
2020,17,3046,765,23,7246,2,44,3,-1,7,8,6,1,6,0,True,False,False,0,4,2021-01-07T22:46:09.883,7,,1.0
2020,17,3046,780,23,7689,2,8,4,14,25,11,16,9,16,0,False,False,False,0,3,2021-02-24T20:35:07.043,25,,9.0
2020,17,3046,785,23,2994,2,51,9,-1,6,7,2,4,2,0,False,False,False,0,3,2021-02-24T19:04:18.133,6,,4.0
2020,17,3046,790,23,7250,13,6,6,16,0,0,0,0,0,0,False,False,False,0,3,2021-01-07T22:53:29.807,0,,0.0
2020,17,3046,795,23,2994,2,38,9,3,15,12,15,0,15,0,False,False,False,0,4,2021-01-07T22:47:15.547,15,,0.0
2020,17,3046,820,10,7700,13,2,10,8,0,0,0,0,0,0,False,False,False,0,2,2021-02-24T20:36:34.543,0,,0.0
2020,17,3046,830,10,7700,2,8,1,21,92,71,92,0,92,6,False,False,False,0,2,2021-01-04T16:15:10.603,92,,0.0
2020,17,3046,850,23,7250,2,5,3,2,2,0,2,0,2,0,False,False,False,0,3,2021-01-04T16:21:29.43,2,,0.0
2020,17,3046,865,23,7250,2,5,5,5,14,9,5,9,5,0,False,False,False,1,3,2021-01-04T16:25:52.49,14,,9.0
2020,17,3046,875,23,7241,13,4,4,3,0,0,0,0,0,0,False,False,False,0,1,2021-02-24T14:35:04.493,0,,0.0
2020,17,3046,945,23,4949,2,19,2,34,37,3,37,0,37,0,False,False,False,0,2,2021-01-04T16:50:16.96,37,,0.0
2020,17,3046,950,23,2994,2,5,5,4,10,6,9,1,9,0,False,False,False,0,4,2021-01-04T16:52:23.047,10,,1.0
2020,17,3046,955,23,2994,2,6,4,14,21,7,18,3,18,0,False,False,False,0,3,2021-01-15T21:55:18.277,21,,3.0
2020,17,3046,965,23,4949,13,6,4,9,0,0,0,0,0,0,False,False,False,0,3,2021-01-15T21:57:06.857,0,,0.0
2020,17,3046,970,23,567,2,2,9,6,8,2,6,2,6,0,True,False,False,0,3,2021-01-07T22:37:52.037,8,,2.0
2020,17,3046,995,10,7700,2,8,8,24,25,1,25,0,25,0,False,False,False,0,2,2021-01-04T17:07:54.51,25,,0.0
2020,17,3046,1000,10,7082,13,5,3,2,0,0,0,0,0,0,False,False,False,0,3,2021-01-04T17:12:02.78,0,,0.0
2020,17,3047,25,1,7316,2,46,3,2,7,5,3,4,3,0,True,False,False,0,4,2021-01-04T13:12:59.667,7,,4.0
2020,17,3047,30,1,245,13,4,3,6,0,0,0,0,0,0,False,False,False,0,2,2021-01-07T14:40:16.72,0,,0.0
2020,17,3047,55,29,4875,13,2,9,5,0,0,0,0,0,0,False,False,False,0,3,2021-03-05T14:30:05.623,0,,0.0
2020,17,3047,60,1,6410,2,50,9,-2,3,5,2,1,2,0,False,False,False,0,3,2021-02-23T19:32:11.817,3,,1.0
2020,17,3047,65,1,7782,2,34,4,-4,11,15,8,3,8,6,True,False,False,0,3,2021-01-04T14:06:24.987,11,,3.0
2020,17,3047,85,29,7788,2,30,5,-1,3,4,2,1,2,0,False,False,False,0,1,2021-01-04T14:09:16.373,3,,1.0
2020,17,3047,90,29,4850,13,7,2,20,0,0,0,0,0,0,False,False,False,0,3,2021-01-04T14:10:16.463,0,,0.0
2020,17,3047,105,1,245,13,19,6,33,0,0,0,0,0,0,False,False,False,0,2,2021-01-07T13:43:39.063,0,,0.0
2020,17,3047,110,1,245,2,49,10,1,3,2,3,0,3,0,True,False,False,0,2,2021-01-04T14:14:33.99,3,,0.0
2020,17,3047,120,29,7828,13,8,7,43,0,0,0,0,0,0,False,False,False,0,3,2021-01-05T20:39:16.723,0,,0.0
2020,17,3047,125,29,7828,13,2,9,11,0,0,0,0,0,0,False,False,False,0,2,2021-02-23T19:32:47.563,0,,0.0
2020,17,3047,140,29,7828,2,4,5,5,15,10,8,7,8,0,False,False,False,0,2,2021-01-04T14:21:19.263,15,,7.0
2020,17,3047,160,29,1958,13,47,5,4,0,0,0,0,0,0,True,False,False,0,3,2021-02-23T19:33:30.877,0,,0.0
2020,17,3047,170,29,1958,2,9,2,24,27,3,24,3,24,0,False,False,False,0,3,2021-01-04T14:26:32.413,27,,3.0
2020,17,3047,185,29,7788,2,47,5,1,2,1,2,0,2,0,False,False,False,0,1,2021-01-04T14:28:38.283,2,,0.0
2020,17,3047,190,29,1958,13,5,9,2,0,0,0,0,0,0,False,False,False,0,4,2021-01-04T14:29:52.84,0,,
2020,17,3047,220,29,4850,13,9,5,10,0,0,0,0,0,0,False,False,False,0,2,2021-01-04T14:34:42.787,0,,0.0
2020,17,3047,235,1,245,13,3,3,12,0,0,0,0,0,0,True,False,False,0,2,2021-01-05T18:59:44.24,0,,0.0
2020,17,3047,245,1,6410,2,26,9,3,3,0,3,0,3,0,False,False,False,0,3,2021-01-04T14:38:26.567,3,,0.0
2020,17,3047,255,29,4850,2,4,10,13,13,0,13,0,13,0,False,False,False,0,4,2021-01-04T14:40:58.42,13,,0.0
2020,17,3047,260,29,4850,2,2,10,5,12,7,9,3,9,0,True,False,False,1,3,2021-01-04T14:41:57.88,12,,3.0
2020,17,3047,265,29,7788,2,28,9,1,9,8,3,6,3,0,False,False,False,0,1,2021-01-04T14:42:56.777,9,,6.0
2020,17,3047,280,29,4875,13,13,9,3,0,0,0,0,0,0,False,False,False,0,3,2021-01-04T14:47:23.017,0,,0.0
2020,17,3047,285,29,4875,2,2,10,7,12,5,9,3,9,0,False,False,False,0,3,2021-01-04T14:48:29,12,,3.0
2020,17,3047,295,29,1958,13,31,9,4,0,0,0,0,0,0,False,False,False,0,4,2021-01-04T14:51:02.31,0,,0.0
2020,17,3047,300,29,4875,2,5,3,10,10,0,10,0,10,0,False,False,False,0,3,2021-01-04T14:51:54.453,10,,0.0
2020,17,3047,310,29,3398,2,13,10,6,10,4,9,1,9,0,False,False,False,0,4,2021-01-04T14:54:23.203,10,,1.0
2020,17,3047,340,29,1958,2,50,9,-3,1,4,1,0,1,0,False,False,False,0,3,2021-01-07T13:43:39.063,1,,0.0
2020,17,3047,345,29,4875,2,4,10,7,7,0,7,0,7,0,False,False,False,0,3,2021-01-04T15:03:54.47,7,,0.0
2020,17,3047,355,1,245,2,4,9,4,4,0,4,0,4,0,False,False,False,0,2,2021-02-23T19:35:52.973,4,,0.0
2020,17,3047,385,29,1958,2,50,9,-3,4,7,1,3,1,0,False,False,False,0,3,2021-01-04T15:12:49.743,4,,3.0
2020,17,3047,390,29,1958,3,4,9,5,0,0,0,0,0,0,False,False,False,0,3,2021-01-07T14:44:27.84,0,,0.0
2020,17,3047,395,29,7828,13,29,6,18,0,0,0,0,0,0,False,False,False,0,2,2021-01-04T15:16:47.993,0,,0.0
2020,17,3047,410,1,245,13,5,3,3,0,0,0,0,0,0,False,False,False,0,2,2021-01-04T15:20:37.343,0,,0.0
2020,17,3047,415,1,245,13,21,6,28,0,0,0,0,0,0,False,False,False,0,2,2021-01-04T15:21:45.053,0,,
2020,17,3047,430,1,6410,13,17,8,16,0,0,0,0,0,0,False,False,False,0,3,2021-03-05T14:31:35.693,0,,0.0
2020,17,3047,460,29,4875,2,31,10,-1,0,1,0,0,0,0,False,False,False,0,4,2021-01-04T15:38:48.933,0,,0.0
2020,17,3047,465,29,7828,2,6,10,12,13,1,12,1,12,0,False,False,False,0,3,2021-02-23T19:36:49.39,13,,1.0
2020,17,3047,475,29,1958,13,12,6,17,0,0,0,0,0,0,False,False,False,0,3,2021-01-04T15:42:17.653,0,,
2020,17,3047,485,29,3398,2,19,2,23,26,3,25,1,25,0,False,False,False,0,2,2021-01-07T13:43:39.063,26,,1.0
2020,17,3047,520,29,1958,2,50,10,-4,4,8,1,3,1,0,False,False,False,0,3,2021-01-04T15:55:20.26,4,,3.0
2020,17,3047,540,1,5152,2,30,10,3,13,10,11,2,11,0,False,False,False,0,4,2021-01-04T15:59:41.417,13,,2.0
2020,17,3047,545,1,6410,2,51,3,-5,12,17,9,3,9,0,False,False,False,0,2,2021-01-04T16:00:58.28,12,,3.0
2020,17,3047,550,1,245,2,12,1,40,40,0,40,0,40,0,False,False,False,0,3,2021-01-04T16:04:10.893,40,,
2020,17,3047,560,1,6406,2,18,3,-1,9,10,6,3,6,0,False,False,False,0,2,2021-01-04T16:07:28.2,9,,3.0
2020,17,3047,565,1,6406,2,28,10,0,19,19,17,2,17,0,False,False,False,0,1,2021-01-07T13:43:39.063,19,,2.0
2020,17,3047,575,29,4850,13,7,2,22,0,0,0,0,0,0,False,False,False,0,4,2021-01-04T16:10:31.497,0,,0.0
2020,17,3047,580,29,7788,2,19,6,25,38,13,36,2,36,0,False,False,False,0,2,2021-01-04T16:11:33.66,38,,2.0
2020,17,3047,585,29,4850,13,9,6,25,0,0,0,0,0,0,False,False,False,0,3,2021-01-04T16:12:24.15,0,,0.0
2020,17,3047,595,29,7828,2,51,9,-3,3,6,0,3,0,0,False,False,False,1,3,2021-01-07T14:41:18.59,3,,3.0
2020,17,3047,600,29,3398,2,5,3,5,5,0,5,0,5,0,False,False,False,0,3,2021-02-23T19:38:25.543,5,,0.0
2020,17,3047,605,29,7828,2,35,5,12,19,7,16,3,16,0,False,False,False,0,3,2021-01-05T20:40:00.05,19,,3.0
2020,17,3047,620,29,4850,3,9,3,9,0,0,0,0,0,0,False,False,False,0,2,2021-02-23T19:39:58.63,0,,0.0
2020,17,3047,630,29,7828,13,6,10,9,0,0,0,0,0,0,False,False,False,0,2,2021-01-04T16:20:57.89,0,,0.0
2020,17,3047,645,1,4307,2,4,4,4,10,6,8,2,8,0,False,False,False,0,1,2021-01-04T16:23:04.17,10,,2.0
2020,17,3047,655,1,4307,2,51,10,-5,-1,4,-1,0,-1,0,False,False,False,0,1,2021-01-04T16:24:39.247,-1,,0.0
2020,17,3047,660,1,6410,2,17,7,20,26,6,24,2,24,0,False,False,False,0,2,2021-01-04T16:25:49.317,26,,2.0
2020,17,3047,670,1,5152,2,8,7,21,25,4,24,1,24,0,False,False,False,0,4,2021-02-23T19:40:33.557,25,,1.0
2020,17,3047,680,1,5152,2,4,9,5,8,3,6,2,6,0,False,False,False,0,3,2021-01-04T16:34:03.95,8,,2.0
2020,17,3047,695,1,245,13,8,1,19,0,0,0,0,0,0,False,False,False,0,2,2021-01-07T14:55:05.713,0,,0.0
2020,17,3047,710,29,3398,13,7,7,21,0,0,0,0,0,0,False,False,False,0,4,2021-01-04T16:39:30.453,0,,0.0
2020,17,3047,720,29,3356,2,48,10,-5,-2,3,-3,1,-3,0,False,False,False,0,1,2021-01-04T16:42:38.043,-2,,1.0
2020,17,3047,730,1,4307,2,44,3,-5,6,11,4,2,4,0,False,False,False,0,1,2021-02-23T19:41:01.503,6,,2.0
2020,17,3047,740,1,7316,2,30,10,-1,6,7,5,1,5,0,False,False,False,0,3,2021-01-04T16:47:15.667,6,,1.0
2020,17,3047,750,1,245,13,7,6,34,0,0,0,0,0,0,False,False,False,0,2,2021-01-04T16:49:16.433,0,,
2020,17,3047,760,1,6410,13,19,8,40,0,0,0,0,0,0,False,False,False,0,3,2021-01-04T16:51:28.473,0,,0.0
2020,17,3047,830,1,245,2,4,3,6,16,10,16,0,16,0,False,False,False,0,2,2021-01-04T17:00:55.71,16,,0.0
2020,17,3047,835,1,245,13,19,6,33,0,0,0,0,0,0,False,False,False,0,2,2021-01-04T17:01:57.783,0,,0.0
2020,17,3047,840,1,245,2,18,3,0,12,12,12,0,12,0,False,False,False,0,2,2021-01-04T17:03:28.767,12,,0.0
2020,17,3048,10,27,650,2,12,3,1,5,4,4,1,4,0,True,False,False,0,3,2021-03-08T18:57:03.23,5,,1.0
2020,17,3048,15,27,650,2,26,9,3,5,2,4,1,4,0,False,False,False,0,3,2021-01-04T13:15:34.19,5,,1.0
2020,17,3048,30,27,4835,13,4,10,5,0,0,0,0,0,0,False,False,False,0,3,2021-01-07T17:50:49.977,0,,0.0
2020,17,3048,45,28,4922,2,26,9,0,3,3,0,3,0,0,True,False,False,0,3,2021-01-04T13:23:03.447,3,,3.0
2020,17,3048,65,27,7408,13,35,2,23,0,0,0,0,0,0,False,False,False,0,3,2021-01-04T13:27:35.693,0,,0.0
2020,17,3048,70,27,4835,2,5,10,6,6,0,6,0,6,0,False,False,False,0,3,2021-01-04T13:30:23.123,6,,0.0
2020,17,3048,90,28,4912,2,4,3,3,3,0,2,1,2,0,False,False,False,1,2,2021-01-04T13:34:42.587,3,,1.0
2020,17,3048,105,28,6360,13,4,3,4,0,0,0,0,0,0,False,False,False,0,2,2021-01-04T13:45:50.58,0,,0.0
2020,17,3048,120,27,650,2,4,9,5,8,3,7,1,7,0,False,False,False,0,2,2021-01-04T13:50:30.377,8,,1.0
2020,17,3048,130,27,650,2,49,9,-3,2,5,0,2,0,0,True,False,False,0,2,2021-02-23T22:58:36.43,2,,2.0
2020,17,3048,140,27,5050,2,31,3,1,29,28,28,1,28,0,False,False,False,0,1,2021-01-04T14:04:05.357,29,,1.0
2020,17,3048,155,27,7408,3,2,10,7,0,0,0,0,0,0,False,False,False,0,2,2021-01-07T16:57:40.78,0,,0.0
2020,17,3048,200,27,650,2,12,5,10,26,16,26,0,26,0,True,False,False,0,3,2021-01-04T14:15:39.207,26,,0.0
2020,17,3048,210,27,7408,2,4,9,5,5,0,5,0,5,0,False,False,False,0,2,2021-01-07T17:53:23.107,5,,0.0
2020,17,3048,215,27,7408,2,13,10,1,4,3,1,3,1,0,False,False,False,0,3,2021-01-04T14:21:59.827,4,,3.0
2020,17,3048,225,27,650,2,51,5,0,4,4,4,0,4,0,True,False,False,0,3,2021-02-23T22:59:43.397,4,,0.0
2020,17,3048,235,27,7408,13,9,2,19,0,0,0,0,0,0,False,False,False,0,2,2021-01-04T14:27:32.067,0,,0.0
2020,17,3048,240,27,650,2,5,5,4,7,3,6,1,6,0,False,False,False,0,3,2021-02-23T23:00:12.273,7,,1.0
2020,17,3048,245,27,650,13,7,3,12,0,0,0,0,0,0,False,False,False,0,3,2021-01-04T14:29:56.21,0,,0.0
2020,17,3048,260,28,262,13,17,8,25,0,0,0,0,0,0,False,False,False,0,3,2021-01-04T18:45:07.207,0,,0.0
2020,17,3048,300,28,4922,2,13,10,0,1,1,1,0,1,0,True,False,False,0,4,2021-01-05T21:33:09.167,1,,0.0
2020,17,3048,305,28,4922,2,54,3,-5,-5,0,-5,0,-5,0,True,False,False,0,4,2021-01-04T18:40:08.573,-5,,0.0
2020,17,3048,310,28,6360,2,19,8,42,45,3,43,2,43,0,False,False,False,0,3,2021-01-04T14:57:11.217,45,,2.0
2020,17,3048,325,28,262,2,13,9,4,4,0,4,0,4,0,False,False,False,0,4,2021-01-05T21:38:39.227,4,,0.0
2020,17,3048,330,28,4922,2,2,3,7,14,7,12,2,12,0,False,False,False,0,2,2021-02-25T18:01:24.43,14,,2.0
2020,17,3048,345,28,6360,2,45,5,-5,2,7,-1,3,-1,0,True,False,False,0,1,2021-02-25T18:02:35.55,2,,3.0
2020,17,3048,350,28,6624,13,16,10,4,0,0,0,0,0,0,False,False,False,0,6,2021-01-05T21:32:39.937,0,,0.0
2020,17,3048,390,28,6624,2,44,3,2,4,2,2,2,2,0,False,False,False,0,1,2021-01-07T16:57:40.78,4,,2.0
2020,17,3048,400,28,4922,2,2,9,6,9,3,9,0,9,0,False,False,False,0,4,2021-01-07T17:51:18.363,9,,0.0
2020,17,3048,405,28,7760,2,6,4,3,3,0,3,0,3,0,False,False,False,0,2,2021-01-07T17:51:28.933,3,,0.0
2020,17,3048,415,28,4922,3,17,8,23,0,0,0,0,0,0,False,False,False,0,4,2021-01-05T21:29:42.377,0,,0.0
2020,17,3048,425,28,797,2,4,9,5,6,1,6,0,6,0,True,False,False,0,3,2021-01-07T17:51:39.997,6,,0.0
2020,17,3048,445,27,6397,3,6,10,10,0,0,0,0,0,0,False,False,False,0,4,2021-01-04T15:59:46.267,0,,0.0
2020,17,3048,450,27,7408,13,4,10,9,0,0,0,0,0,0,False,False,False,0,2,2021-01-04T16:00:58.397,0,,0.0
2020,17,3048,460,28,4922,2,22,2,25,41,16,37,4,37,0,False,False,False,0,3,2021-02-23T23:01:45.803,41,,4.0
2020,17,3048,470,28,4912,13,26,5,4,0,0,0,0,0,0,False,False,False,0,2,2021-01-05T21:38:39.227,0,,0.0
2020,17,3048,495,27,7852,13,12,6,44,0,0,0,0,0,0,False,False,False,0,2,2021-01-04T16:11:42.647,0,,0.0
2020,17,3048,505,27,7408,13,12,6,30,0,0,0,0,0,0,True,False,False,0,3,2021-01-04T16:13:36.723,0,,0.0
2020,17,3048,525,28,4912,2,5,10,10,27,17,24,3,24,0,False,False,False,0,3,2021-01-04T16:17:38.947,27,,3.0
2020,17,3048,535,28,6624,3,44,3,-4,0,0,0,0,0,0,True,False,False,0,3,2021-01-04T16:20:09.103,0,,0.0
2020,17,3048,540,28,4922,2,2,10,5,5,0,5,0,5,0,False,False,False,0,2,2021-01-05T21:38:39.227,5,,0.0
2020,17,3048,545,28,4912,2,12,9,11,11,0,11,0,11,0,False,False,False,0,3,2021-01-05T21:30:21.837,11,,0.0
2020,17,3048,555,28,6627,2,5,3,13,13,0,13,0,13,0,False,False,False,0,4,2021-01-05T21:38:39.227,13,,0.0
2020,17,3048,585,27,5050,2,4,4,3,10,7,6,4,6,0,False,False,False,0,1,2021-01-04T16:30:45.777,10,,4.0
2020,17,3048,590,27,650,2,26,5,4,9,5,8,1,8,0,False,False,False,0,3,2021-01-04T16:32:34.837,9,,1.0
2020,17,3048,600,27,650,2,30,3,5,5,0,5,0,5,0,True,False,False,0,2,2021-01-07T17:51:55.047,5,,0.0
2020,17,3048,605,27,6397,2,38,10,4,20,16,10,10,10,0,False,False,False,1,4,2021-01-04T17:12:40.02,20,,10.0
2020,17,3048,620,27,650,2,12,10,6,6,0,6,0,6,6,False,False,False,0,3,2021-01-04T17:16:52.147,6,,0.0
2020,17,3048,635,28,6360,13,4,8,16,0,0,0,0,0,0,False,False,False,0,2,2021-01-04T17:19:41.797,0,,0.0
2020,17,3048,645,28,5199,2,2,10,10,12,2,11,1,11,0,False,False,False,0,3,2021-01-04T17:23:36.857,12,,1.0
2020,17,3048,660,28,4922,3,6,9,14,0,0,0,0,0,0,False,False,False,0,3,2021-01-04T17:28:20.873,0,,0.0
2020,17,3048,670,27,7408,2,2,9,8,12,4,9,3,9,0,False,False,False,0,2,2021-01-07T17:53:59.507,12,,3.0
2020,17,3048,690,27,650,2,51,3,2,9,7,2,7,2,0,True,False,False,0,3,2021-01-04T17:38:21.617,9,,7.0
2020,17,3048,700,27,650,13,7,2,36,0,0,0,0,0,0,False,False,False,0,3,2021-01-07T16:57:40.78,0,,0.0
2020,17,3048,725,27,4835,3,12,10,4,0,0,0,0,0,0,True,False,False,0,1,2021-01-04T17:54:20.147,0,,0.0
2020,17,3048,735,27,7408,13,9,3,4,0,0,0,0,0,0,False,False,False,0,2,2021-01-07T17:54:10.893,0,,0.0
2020,17,3048,740,27,650,2,13,3,4,4,0,4,0,4,6,False,False,False,0,3,2021-02-23T23:03:12.36,4,,0.0
2020,17,3048,755,28,6624,13,46,3,3,0,0,0,0,0,0,False,False,False,0,1,2021-01-05T21:38:39.227,0,,0.0
2020,17,3048,805,28,5199,2,32,3,1,5,4,4,1,4,0,True,False,False,1,3,2021-01-07T16:57:40.78,5,,1.0
2020,17,3048,810,28,6624,2,6,9,5,5,0,5,0,5,0,False,False,False,0,2,2021-01-07T17:52:08.173,5,,0.0
2020,17,3048,815,28,6360,2,2,3,9,19,10,17,2,17,0,False,False,False,0,2,2021-02-23T23:03:58.107,19,,2.0
2020,17,3048,820,28,4912,2,2,4,8,21,13,17,4,17,0,False,False,False,0,2,2021-01-04T18:16:44.33,21,,4.0
2020,17,3048,825,28,6627,2,39,4,4,8,4,5,3,5,0,False,False,False,0,3,2021-01-05T21:38:39.227,8,,3.0
2020,17,3048,835,28,6624,3,5,5,3,0,0,0,0,0,0,False,False,False,0,6,2021-02-23T23:04:28.137,0,,0.0
2020,17,3048,840,28,4912,2,2,5,7,12,5,7,5,7,0,False,False,False,0,2,2021-01-04T18:22:29.603,12,,
2020,17,3048,845,28,4912,2,2,5,5,14,9,12,2,12,0,False,False,False,0,2,2021-01-04T18:25:34.507,14,,2.0
2020,17,3048,855,28,6624,2,5,10,3,3,0,3,0,3,6,True,False,False,0,3,2021-01-05T21:38:39.227,3,,0.0
2020,17,3048,870,27,5069,2,34,4,-3,5,8,2,3,2,0,True,False,False,0,3,2021-01-04T18:30:50.643,5,,3.0
2020,18,3049,10,14,1114,2,4,9,5,9,4,7,2,7,0,False,False,False,0,3,2021-01-10T11:21:53.507,9,,
2020,18,3049,25,14,7584,2,2,10,4,6,2,4,2,4,0,False,False,False,0,2,2021-01-10T11:28:12.707,6,,
2020,18,3049,45,14,7584,3,4,9,5,0,0,0,0,0,0,False,False,False,0,3,2021-01-10T11:38:19.563,0,,
2020,18,3049,50,14,1114,13,7,6,17,0,0,0,0,0,0,False,False,False,0,2,2021-01-10T11:42:18.287,0,,
2020,18,3049,65,4,594,2,4,9,4,4,0,4,0,4,0,False,False,False,0,3,2021-01-10T11:49:56.773,4,,
2020,18,3049,70,4,1412,13,12,2,19,0,0,0,0,0,0,False,False,False,0,3,2021-03-08T19:03:12.193,0,,
2020,18,3049,85,14,6543,13,46,3,1,0,0,0,0,0,0,False,False,False,0,1,2021-01-10T11:57:29.503,0,,
2020,18,3049,90,14,1114,2,4,8,16,23,7,21,2,21,0,False,False,False,0,3,2021-01-10T12:03:55.467,23,,
2020,18,3049,95,14,7584,2,35,6,19,22,3,20,2,20,0,False,False,False,0,3,2021-01-12T19:43:45.807,22,,
2020,18,3049,110,14,7582,2,48,10,-5,0,5,-1,1,-1,0,False,False,False,0,1,2021-01-10T12:11:09.833,0,,
2020,18,3049,125,4,2853,13,4,5,5,0,0,0,0,0,0,False,False,False,0,2,2021-01-10T12:14:57.287,0,,
2020,18,3049,135,4,2853,2,8,8,33,36,3,33,3,33,0,False,False,False,0,3,2021-01-12T19:45:56.84,36,,
2020,18,3049,140,4,7646,2,12,2,16,16,0,16,0,16,0,False,False,False,0,3,2021-01-12T19:46:50.303,16,,
2020,18,3049,145,4,6983,2,45,5,-3,5,8,4,1,4,0,False,False,False,0,1,2021-01-10T16:52:54.073,5,,
2020,18,3049,155,4,7645,2,47,5,5,7,2,7,0,7,0,False,False,False,0,1,2021-01-11T17:37:02.057,7,,
2020,18,3049,160,4,6953,2,12,5,3,3,0,3,0,3,6,False,False,False,0,4,2021-02-25T17:38:46.107,3,,
2020,18,3049,185,14,7582,3,4,4,2,0,0,0,0,0,0,False,False,False,0,1,2021-01-10T12:48:00.563,0,,
2020,18,3049,190,14,1114,13,7,2,30,0,0,0,0,0,0,False,False,False,0,3,2021-01-12T19:47:28.427,0,,
2020,18,3049,205,4,7645,2,47,5,1,2,1,1,1,1,0,False,False,False,0,1,2021-01-10T12:53:29.267,2,,
2020,18,3049,245,14,7582,2,28,10,-2,6,8,3,3,3,0,True,False,False,0,1,2021-01-13T17:30:27.403,6,,
2020,18,3049,250,14,7584,2,35,7,18,32,14,26,6,26,0,False,False,False,1,4,2021-01-10T13:09:58.13,32,,
2020,18,3049,255,14,1119,2,46,3,1,2,1,1,1,1,0,False,False,False,0,4,2021-01-10T13:11:37.29,2,,
2020,18,3049,260,14,6543,2,16,10,4,8,4,4,4,4,0,False,False,False,1,3,2021-01-10T17:01:27.757,8,,
2020,18,3049,305,14,7584,2,50,3,-1,31,32,7,24,7,0,False,False,False,1,2,2021-01-10T13:26:28.653,31,,
2020,18,3049,315,14,1119,2,35,9,10,10,0,10,0,10,0,False,False,False,0,4,2021-01-13T16:10:35.367,10,,
2020,18,3049,320,14,5197,2,8,9,14,16,2,15,1,15,0,False,False,False,0,3,2021-01-10T13:32:52.953,16,,
2020,18,3049,325,14,895,2,55,4,-2,2,4,2,0,2,0,False,False,False,0,4,2021-01-13T17:21:08.313,2,,
2020,18,3049,350,14,7584,13,13,3,4,0,0,0,0,0,0,False,False,False,0,3,2021-01-13T17:31:10.01,0,,
2020,18,3049,355,4,2853,3,8,1,17,0,0,0,0,0,0,False,False,False,0,2,2021-01-12T19:50:04.833,0,,
2020,18,3049,360,4,7646,2,12,2,36,37,1,37,0,37,0,False,False,False,0,3,2021-01-10T13:53:22.99,37,,
2020,18,3049,365,4,594,2,4,9,5,7,2,4,3,4,0,False,False,False,1,3,2021-03-02T21:06:32.08,7,,
2020,18,3049,370,4,7646,2,12,6,19,19,0,19,0,19,0,False,False,False,0,3,2021-01-10T13:57:48.373,19,,
2020,18,3049,385,4,6953,2,28,5,-1,2,3,0,2,0,0,False,False,False,0,1,2021-01-10T14:01:44.093,2,,
2020,18,3049,390,4,1412,13,19,2,21,0,0,0,0,0,0,False,False,False,0,2,2021-01-10T14:03:33.953,0,,
2020,18,3049,395,4,1412,13,19,2,21,0,0,0,0,0,0,False,False,False,0,2,2021-01-13T16:38:54.13,0,,
2020,18,3049,445,4,1412,3,6,8,16,0,0,0,0,0,0,False,False,False,0,2,2021-01-12T19:51:24.963,0,,
2020,18,3049,450,4,594,2,5,5,6,10,4,7,3,7,0,False,False,False,1,3,2021-01-10T14:22:34.143,10,,
2020,18,3049,455,4,594,2,2,9,9,13,4,13,0,13,0,False,False,False,0,2,2021-01-11T17:37:54.137,13,,
2020,18,3049,460,4,2853,2,6,8,16,16,0,16,0,16,0,False,False,False,0,2,2021-01-10T14:28:12.273,16,,
2020,18,3049,495,14,4449,13,5,5,3,0,0,0,0,0,0,True,False,False,0,3,2021-01-10T14:37:52.947,0,,
2020,18,3049,500,14,1119,2,4,9,7,7,0,7,0,7,0,False,False,False,0,3,2021-01-10T14:40:40.22,7,,
2020,18,3049,510,14,1119,2,13,4,4,12,8,12,0,12,0,False,False,False,0,4,2021-01-13T17:25:06.313,12,,
2020,18,3049,525,14,5197,2,13,10,2,6,4,4,2,4,0,False,False,False,0,3,2021-01-10T14:47:59.387,6,,
2020,18,3049,535,14,1119,2,46,3,-1,1,2,0,1,0,0,False,False,False,0,4,2021-01-10T14:51:13.933,1,,
2020,18,3049,540,14,895,2,7,2,18,19,1,19,0,19,0,False,False,False,0,3,2021-01-10T14:53:45.577,19,,
2020,18,3049,550,14,7582,3,51,9,-5,0,0,0,0,0,0,False,False,False,0,1,2021-01-10T14:56:28.463,0,,
2020,18,3049,555,14,7584,13,2,10,6,0,0,0,0,0,0,False,False,False,0,2,2021-01-10T14:58:26.037,0,,
2020,18,3049,575,4,2853,2,4,10,4,4,0,4,0,4,0,False,False,False,0,3,2021-01-11T17:37:23.183,4,,
2020,18,3049,585,4,7645,2,28,9,1,10,9,8,2,8,0,False,False,False,0,1,2021-01-10T15:06:53.817,10,,
2020,18,3049,590,4,594,2,26,10,2,4,2,4,0,4,0,False,False,False,0,3,2021-01-10T15:08:34.013,4,,
2020,18,3049,600,4,7645,2,47,5,-1,7,8,2,5,2,0,False,False,False,2,1,2021-01-13T17:25:44.343,7,,
2020,18,3049,610,4,2853,2,19,2,35,35,0,35,0,35,6,False,False,False,0,2,2021-01-10T15:21:25.94,35,,
2020,18,3049,640,14,4449,2,13,9,4,11,7,9,2,9,0,True,False,False,0,3,2021-01-13T16:10:35.383,11,,
2020,18,3049,645,14,7584,13,13,10,3,0,0,0,0,0,0,False,False,False,0,3,2021-01-13T17:34:26.687,0,,
2020,18,3049,650,14,5197,2,39,9,3,6,3,4,2,4,0,False,False,False,0,4,2021-01-10T15:33:51.437,6,,
2020,18,3049,655,14,4449,2,13,9,4,9,5,9,0,9,6,False,False,False,0,3,2021-01-10T15:36:04.957,9,,
2020,18,3049,675,4,594,2,5,3,1,3,2,2,1,2,0,False,False,False,0,3,2021-01-10T15:41:05.637,3,,
2020,18,3049,680,4,2853,2,51,10,-1,16,17,15,1,15,0,False,False,False,0,3,2021-01-13T17:25:17.877,16,,
2020,18,3049,685,4,594,2,2,4,13,16,3,16,0,16,0,False,False,False,0,3,2021-01-10T17:02:47.397,16,,
2020,18,3049,695,4,6983,2,47,5,-1,4,5,2,2,2,0,False,False,False,0,1,2021-01-10T16:53:32.393,4,,
2020,18,3049,700,4,1412,13,6,10,12,0,0,0,0,0,0,False,False,False,0,2,2021-01-10T15:49:17.53,0,,
2020,18,3049,725,14,1119,13,39,10,5,0,0,0,0,0,0,False,False,False,0,4,2021-01-10T15:54:48.293,0,,
2020,18,3049,730,14,895,2,5,9,12,13,1,13,0,13,0,False,False,False,0,3,2021-01-10T15:57:47.927,13,,
2020,18,3049,740,14,1119,2,24,6,27,27,0,27,0,27,6,False,False,False,0,4,2021-01-10T16:01:27.063,27,,
2020,18,3049,755,4,7646,2,6,4,13,13,0,13,0,13,0,False,False,False,0,3,2021-01-12T19:52:05.627,13,,
2020,18,3049,765,4,2853,2,12,6,21,21,0,21,0,21,0,False,False,False,0,3,2021-01-12T19:52:48.407,21,,
2020,18,3049,770,4,6953,13,32,3,0,0,0,0,0,0,0,False,False,False,0,4,2021-01-10T16:09:29.7,0,,
2020,18,3049,790,4,2853,13,5,2,18,0,0,0,0,0,0,False,False,False,0,2,2021-01-12T19:53:28.77,0,,
2020,18,3049,795,4,6983,2,12,5,13,14,1,14,0,14,0,False,False,False,0,1,2021-01-10T16:53:59.38,14,,
2020,18,3049,810,14,1119,2,6,4,11,11,0,11,0,11,0,False,False,False,0,3,2021-01-10T16:22:04.21,11,,
2020,18,3049,815,14,4449,13,4,4,9,0,0,0,0,0,0,False,False,False,0,3,2021-01-12T19:54:08.327,0,,
2020,18,3049,830,14,5197,2,13,10,3,4,1,3,1,3,0,False,False,False,0,3,2021-01-10T16:27:47.217,4,,
2020,18,3049,840,14,1119,13,47,5,6,0,0,0,0,0,0,False,False,False,0,3,2021-01-10T16:31:11.85,0,,
2020,18,3049,845,14,6543,3,28,10,-2,0,0,0,0,0,0,False,False,False,0,1,2021-01-10T16:32:53.39,0,,
2020,18,3049,850,14,1114,13,5,5,11,0,0,0,0,0,0,False,False,False,0,2,2021-01-13T17:35:05.683,0,,
2020,18,3049,855,14,4449,2,35,8,17,17,0,17,0,17,0,False,False,False,0,3,2021-01-13T16:10:35.383,17,,
2020,18,3049,860,14,7584,2,50,10,-1,1,2,1,0,1,0,False,True,False,0,3,2021-03-04T19:29:23.293,-1,,
2020,18,3049,875,14,7584,13,5,3,10,0,0,0,0,0,0,False,False,False,0,2,2021-01-10T16:45:54.03,0,,
2020,18,3049,880,14,7584,13,19,8,44,0,0,0,0,0,0,False,False,False,0,2,2021-01-10T16:48:20.33,0,,
2020,18,3050,25,29,4866,13,4,10,12,0,0,0,0,0,0,False,False,False,0,3,2021-01-11T13:09:43.3,0,,
2020,18,3050,30,29,7788,2,50,5,-2,1,3,-1,2,-1,0,False,False,False,0,2,2021-01-13T13:13:06.85,1,,
2020,18,3050,35,29,4850,13,6,9,11,0,0,0,0,0,0,False,False,False,0,2,2021-01-10T12:23:23.223,0,,
2020,18,3050,50,27,5069,2,44,3,-4,1,5,-1,2,-1,0,True,False,False,0,2,2021-01-10T12:26:41.54,1,,
2020,18,3050,55,27,4835,3,38,9,2,0,0,0,0,0,0,False,False,False,0,3,2021-01-13T13:13:06.85,0,,
2020,18,3050,80,29,4866,2,4,4,14,15,1,14,1,14,0,False,False,False,0,4,2021-01-10T12:38:31.927,15,,
2020,18,3050,85,29,1958,3,35,10,13,0,0,0,0,0,0,False,False,False,0,3,2021-01-10T12:43:14.087,0,,
2020,18,3050,90,29,4866,2,5,3,10,13,3,13,0,13,0,False,False,False,0,3,2021-01-11T13:10:12.94,13,,
2020,18,3050,160,29,3398,13,5,5,13,0,0,0,0,0,0,False,False,False,0,4,2021-01-10T12:59:03.457,0,,
2020,18,3050,170,29,1958,13,5,5,14,0,0,0,0,0,0,False,False,False,0,2,2021-01-11T13:11:33.837,0,,
2020,18,3050,180,27,650,2,19,6,21,24,3,24,0,24,0,False,False,False,0,2,2021-01-10T13:05:11.59,24,,
2020,18,3050,200,27,7408,13,38,9,3,0,0,0,0,0,0,False,False,False,0,3,2021-01-13T13:48:57.94,0,,
2020,18,3050,215,29,1958,13,12,5,2,0,0,0,0,0,0,True,False,False,0,3,2021-01-12T00:35:11.353,0,,
2020,18,3050,220,29,4866,13,35,2,40,0,0,0,0,0,0,False,False,False,0,3,2021-01-10T13:18:19.21,0,,
2020,18,3050,240,27,650,13,32,3,3,0,0,0,0,0,0,False,False,False,0,3,2021-03-08T16:23:19.3,0,,
2020,18,3050,265,29,4866,2,19,2,38,44,6,41,3,41,0,False,False,False,0,3,2021-01-10T13:27:58.7,44,,
2020,18,3050,275,29,4866,2,4,9,4,6,2,4,2,4,0,False,False,False,0,3,2021-01-10T13:31:09.563,6,,
2020,18,3050,295,27,650,2,5,6,15,19,4,19,0,19,0,False,False,False,0,2,2021-01-10T13:34:47.04,19,,
2020,18,3050,305,27,7408,13,49,3,-5,0,0,0,0,0,0,True,False,False,0,2,2021-03-05T14:33:44.247,0,,
2020,18,3050,345,27,7408,2,12,6,35,51,16,51,0,51,6,True,False,False,0,3,2021-01-10T13:50:27.723,51,,
2020,18,3050,365,29,3398,2,4,5,4,4,0,4,0,4,0,False,False,False,0,2,2021-01-10T13:59:32.95,4,,
2020,18,3050,370,29,7788,2,5,5,4,44,40,15,29,15,0,False,False,False,1,1,2021-01-10T14:01:47.633,44,,
2020,18,3050,405,27,4835,13,39,4,5,0,0,0,0,0,0,False,False,False,0,3,2021-01-10T14:10:39.597,0,,
2020,18,3050,410,27,7408,2,4,3,6,9,3,8,1,8,0,False,False,False,0,2,2021-01-10T14:11:41.577,9,,
2020,18,3050,445,29,4866,13,5,3,6,0,0,0,0,0,0,False,False,False,0,3,2021-01-13T13:49:42.933,0,,
2020,18,3050,485,27,4835,13,11,2,30,0,0,0,0,0,0,True,False,False,0,4,2021-01-10T14:23:25.107,0,,
2020,18,3050,495,27,5050,13,12,2,30,0,0,0,0,0,0,True,False,False,0,1,2021-01-13T13:49:57.06,0,,
2020,18,3050,515,29,4866,13,12,4,8,0,0,0,0,0,0,False,False,False,0,3,2021-01-10T14:35:11.47,0,,
2020,18,3050,540,27,5050,2,51,9,-6,5,11,4,1,4,0,True,False,False,0,1,2021-01-10T14:39:33.293,5,,
2020,18,3050,550,27,7408,13,8,1,46,0,0,0,0,0,0,False,False,False,0,2,2021-01-10T14:41:38.947,0,,
2020,18,3050,565,29,4866,13,6,9,13,0,0,0,0,0,0,False,False,False,0,3,2021-01-10T14:45:47.55,0,,
2020,18,3050,585,27,6397,2,12,3,-1,1,2,0,1,0,0,False,False,False,0,3,2021-03-08T19:18:09.897,1,,
2020,18,3050,590,27,6397,3,4,9,5,0,0,0,0,0,0,False,False,False,0,4,2021-01-13T13:13:06.863,0,,
2020,18,3050,595,27,7408,13,20,6,37,0,0,0,0,0,0,False,False,False,0,2,2021-01-13T13:50:11.353,0,,
2020,18,3050,620,29,3398,13,2,9,11,0,0,0,0,0,0,False,False,False,0,2,2021-01-10T15:01:56.527,0,,
2020,18,3050,625,29,1958,13,5,5,10,0,0,0,0,0,0,False,False,False,0,3,2021-01-11T13:20:34.187,0,,
2020,18,3050,650,27,6397,13,12,10,6,0,0,0,0,0,0,False,False,False,0,4,2021-01-13T13:50:47.507,0,,
2020,18,3050,670,27,4835,13,17,10,8,0,0,0,0,0,0,False,False,False,0,3,2021-01-10T15:20:51.533,0,,
2020,18,3050,680,29,1958,2,33,1,15,20,5,17,3,17,0,False,False,False,0,4,2021-01-10T15:24:09.92,20,,
2020,18,3050,705,29,1958,2,5,5,6,6,0,6,0,6,0,False,False,False,0,3,2021-01-10T15:30:16.233,6,,
2020,18,3050,715,29,1958,2,39,4,6,7,1,7,0,7,0,False,False,False,0,3,2021-01-10T15:33:49.023,7,,
2020,18,3050,745,27,7408,2,4,6,15,15,0,15,0,15,0,False,False,False,0,2,2021-01-11T13:23:09.49,15,,
2020,18,3050,790,29,3356,2,47,5,2,9,7,9,0,9,0,False,False,False,0,1,2021-01-10T15:54:40.8,9,,
2020,18,3050,805,29,1958,2,35,9,11,15,4,15,0,15,6,False,False,False,0,3,2021-01-10T15:59:06.43,15,,
2020,18,3050,820,27,4835,3,6,4,10,0,0,0,0,0,0,False,False,False,0,3,2021-01-10T16:01:36.027,0,,
2020,18,3050,840,27,7408,13,3,2,16,0,0,0,0,0,0,False,False,False,0,2,2021-01-11T13:23:52.8,0,,
2020,18,3050,845,27,7408,2,4,5,9,9,0,9,0,9,0,False,False,False,0,2,2021-01-10T16:07:36.557,9,,
2020,18,3050,850,27,7852,2,9,6,26,28,2,28,0,28,0,False,False,False,0,2,2021-01-13T13:13:06.863,28,,
2020,18,3050,855,27,7408,2,12,4,9,12,3,12,0,12,6,False,False,False,0,3,2021-01-10T16:12:44.34,12,,
2020,18,3050,915,27,7408,3,4,8,18,0,0,0,0,0,0,False,False,False,0,2,2021-01-10T16:26:38.607,0,,
2020,18,3050,920,27,650,13,12,2,44,0,0,0,0,0,0,False,False,False,0,3,2021-03-08T19:18:25.56,0,,
2020,18,3051,10,30,4516,13,4,5,11,0,0,0,0,0,0,True,False,False,0,2,2021-01-10T11:26:36.053,0,,
2020,18,3051,15,30,793,2,4,3,10,15,5,14,1,14,0,False,False,False,0,2,2021-01-10T11:27:54.07,15,,
2020,18,3051,30,30,4516,2,8,8,15,17,2,16,1,16,0,False,False,False,0,3,2021-01-10T11:35:41.573,17,,
2020,18,3051,65,32,6430,3,17,7,34,0,0,0,0,0,0,False,False,False,0,3,2021-01-10T11:45:17.423,0,,
2020,18,3051,70,32,7128,2,13,4,4,5,1,5,0,5,0,False,False,False,0,2,2021-01-10T11:46:32.247,5,,
2020,18,3051,85,30,4516,2,2,10,5,12,7,8,4,8,0,False,False,False,1,3,2021-03-02T21:04:00.617,12,,
2020,18,3051,105,30,793,13,4,9,11,0,0,0,0,0,0,False,False,False,0,3,2021-01-10T11:54:44.91,0,,
2020,18,3051,125,32,6430,2,7,2,23,36,13,27,9,27,0,False,False,False,0,3,2021-01-10T12:00:29.643,36,,
2020,18,3051,135,32,7128,13,4,3,5,0,0,0,0,0,0,False,False,False,0,2,2021-01-12T18:56:02.747,0,,
2020,18,3051,140,30,7891,13,28,9,-1,0,0,0,0,0,0,False,False,False,0,1,2021-01-10T12:06:33.61,0,,
2020,18,3051,145,30,4516,13,11,6,15,0,0,0,0,0,0,True,False,False,0,3,2021-01-10T12:09:52.313,0,,
2020,18,3051,150,30,7268,2,5,2,15,15,0,15,0,15,0,False,False,False,0,2,2021-01-10T12:12:06.96,15,,
2020,18,3051,165,30,37,2,9,2,27,36,9,36,0,36,6,False,False,False,0,3,2021-01-12T18:56:52.13,36,,
2020,18,3051,180,32,1427,2,12,5,13,24,11,24,0,24,0,False,False,False,1,3,2021-01-10T16:30:44.99,24,,
2020,18,3051,185,32,7128,2,6,8,17,18,1,18,0,18,0,False,False,False,0,2,2021-01-10T12:20:51.057,18,,
2020,18,3051,215,32,7494,2,5,3,10,10,0,10,0,10,0,False,False,False,0,3,2021-01-10T12:28:34.51,10,,
2020,18,3051,255,30,4937,2,48,9,-4,4,8,3,1,3,0,False,False,False,0,1,2021-01-10T12:38:44.573,4,,
2020,18,3051,260,30,4937,2,44,3,0,5,5,3,2,3,0,True,False,False,0,1,2021-01-10T12:40:22.997,5,,
2020,18,3051,265,30,4516,2,35,7,22,27,5,25,2,25,6,True,False,False,0,2,2021-03-04T19:33:11.193,27,,
2020,18,3051,280,32,6430,2,4,5,5,5,0,5,0,5,0,False,False,False,0,2,2021-01-10T12:46:13.057,5,,
2020,18,3051,285,32,6430,13,11,5,10,0,0,0,0,0,0,True,False,False,0,3,2021-01-10T12:48:32.473,0,,
2020,18,3051,290,32,6430,2,2,9,4,5,1,4,1,4,0,False,False,False,0,2,2021-01-10T12:50:18.52,5,,
2020,18,3051,305,32,7128,2,4,5,8,8,0,8,0,8,0,False,False,False,0,2,2021-01-10T12:55:38.263,8,,
2020,18,3051,310,32,8237,3,5,6,15,0,0,0,0,0,0,False,False,False,0,3,2021-01-12T19:10:31.943,0,,
2020,18,3051,320,32,6430,13,2,10,7,0,0,0,0,0,0,False,False,False,0,2,2021-01-12T19:11:20.68,0,,
2020,18,3051,340,30,4937,2,48,9,-2,22,24,21,1,21,0,False,False,False,0,1,2021-01-13T14:54:23.393,22,,
2020,18,3051,345,30,2290,2,5,2,17,19,2,17,2,17,0,True,False,False,0,3,2021-01-10T13:08:09.767,19,,
2020,18,3051,355,30,2290,2,6,4,13,24,11,22,2,22,0,True,False,False,1,4,2021-01-13T14:50:00.317,24,,
2020,18,3051,370,30,4516,13,2,10,5,0,0,0,0,0,0,True,False,False,0,3,2021-01-10T13:14:53.74,0,,
2020,18,3051,375,30,63,13,17,4,5,0,0,0,0,0,0,False,False,False,0,3,2021-01-10T13:16:00.907,0,,
2020,18,3051,400,32,7494,3,4,10,5,0,0,0,0,0,0,False,False,False,0,3,2021-01-10T13:20:52.353,0,,
2020,18,3051,405,32,7494,2,4,10,12,12,0,12,0,12,0,False,False,False,0,3,2021-01-10T13:22:08.13,12,,
2020,18,3051,420,30,793,13,4,5,12,0,0,0,0,0,0,False,False,False,0,2,2021-01-10T13:24:22.297,0,,
2020,18,3051,430,30,37,2,4,3,8,13,5,13,0,13,0,False,False,False,1,2,2021-01-13T14:50:12.463,13,,
2020,18,3051,435,30,4516,3,6,4,11,0,0,0,0,0,0,False,False,False,0,3,2021-01-12T18:58:55.787,0,,
2020,18,3051,440,30,2290,13,5,10,12,0,0,0,0,0,0,False,False,False,0,3,2021-01-10T13:29:56.743,0,,
2020,18,3051,460,32,3885,2,28,10,-5,7,12,4,3,4,0,False,False,False,1,1,2021-01-13T14:50:25.19,7,,
2020,18,3051,485,32,7807,3,12,3,2,0,0,0,0,0,0,False,False,False,0,1,2021-01-10T13:55:59.8,0,,
2020,18,3051,490,32,7128,2,4,9,4,12,8,11,1,11,0,False,False,False,0,3,2021-01-12T18:59:59.41,12,,
2020,18,3051,495,32,7128,2,13,10,2,3,1,3,0,3,0,False,False,False,0,2,2021-01-10T13:59:58.233,3,,
2020,18,3051,500,32,1427,2,24,6,21,29,8,26,3,26,0,True,False,False,0,3,2021-01-10T16:31:03.333,29,,
2020,18,3051,515,32,1427,13,39,4,4,0,0,0,0,0,0,True,False,False,0,3,2021-01-13T14:51:46.643,0,,
2020,18,3051,535,30,793,13,19,2,20,0,0,0,0,0,0,False,False,False,0,2,2021-03-17T20:05:38.28,0,,
2020,18,3051,540,30,4516,13,51,9,0,0,0,0,0,0,0,False,False,False,0,3,2021-01-10T14:18:57.997,0,,
2020,18,3051,555,32,6430,13,4,9,5,0,0,0,0,0,0,False,False,False,0,3,2021-01-10T14:24:25.253,0,,
2020,18,3051,565,32,1427,2,32,5,3,12,9,11,1,11,0,False,False,False,0,4,2021-01-10T14:27:20.82,12,,
2020,18,3051,580,30,4516,3,5,3,4,0,0,0,0,0,0,False,False,False,0,3,2021-01-10T14:31:52.643,0,,
2020,18,3051,585,30,793,2,5,5,13,13,0,13,0,13,0,False,False,False,0,3,2021-01-10T14:34:14.917,13,,
2020,18,3051,595,30,793,13,21,6,30,0,0,0,0,0,0,False,False,False,0,2,2021-01-10T14:37:18.533,0,,
2020,18,3051,600,30,2290,2,2,9,8,13,5,13,0,13,0,False,True,False,0,3,2021-01-10T14:38:46.06,14,,
2020,18,3051,610,32,6430,2,5,6,16,19,3,19,0,19,0,False,False,False,0,3,2021-01-10T14:43:51.723,19,,
2020,18,3051,630,32,6430,2,13,9,0,6,6,6,0,6,0,False,False,False,0,3,2021-01-13T14:49:47.27,6,,
2020,18,3051,655,30,4516,3,7,6,23,0,0,0,0,0,0,False,False,False,0,2,2021-01-10T14:59:09.487,0,,
2020,18,3051,660,30,4516,2,13,10,5,7,2,6,1,6,0,False,False,False,0,3,2021-01-10T15:01:24.24,7,,
2020,18,3051,665,30,2290,2,8,10,13,23,10,18,5,18,0,False,False,False,0,3,2021-01-12T18:51:59.603,23,,
2020,18,3051,675,30,793,2,6,1,15,17,2,17,0,17,0,False,False,False,0,3,2021-01-10T15:07:15.293,17,,
2020,18,3051,685,30,4937,2,16,10,4,8,4,7,1,7,0,True,False,False,0,1,2021-01-10T15:15:22.843,8,,
2020,18,3051,695,30,37,13,51,5,0,0,0,0,0,0,0,False,False,False,0,3,2021-01-10T15:19:23.627,0,,
2020,18,3051,715,32,7807,2,45,5,-5,1,6,-1,2,-1,0,False,False,False,0,1,2021-01-10T15:26:20.617,1,,
2020,18,3051,720,32,1427,13,5,2,15,0,0,0,0,0,0,False,False,False,0,3,2021-01-10T15:28:17.513,0,,
2020,18,3051,730,30,793,2,3,2,20,20,0,20,0,20,0,False,False,False,0,2,2021-01-10T15:31:14.063,20,,
2020,18,3051,750,30,793,2,4,2,19,19,0,19,0,19,0,False,False,False,0,2,2021-01-10T15:37:47.233,19,,
2020,18,3051,755,30,2290,13,4,10,3,0,0,0,0,0,0,False,False,False,0,4,2021-01-10T16:13:27.64,0,,
2020,18,3051,775,32,4467,2,28,3,2,8,6,6,2,6,0,True,False,False,0,1,2021-01-11T17:39:13.507,8,,
2020,18,3051,785,32,6430,2,17,8,20,23,3,22,1,22,0,False,False,False,0,3,2021-01-10T15:46:15.943,23,,
2020,18,3051,790,32,1427,2,47,5,3,4,1,4,0,4,0,False,False,False,0,3,2021-01-10T15:47:39.517,4,,
2020,18,3051,795,32,7807,2,47,5,-2,3,5,2,1,2,0,False,False,False,0,1,2021-01-10T15:48:39.78,3,,
2020,18,3051,800,32,1427,2,39,4,5,5,0,5,0,5,0,True,False,False,0,3,2021-01-10T15:49:49.99,5,,
2020,18,3051,805,32,3885,2,28,10,-1,1,2,1,0,1,0,False,False,False,0,1,2021-01-10T15:51:00.6,1,,
2020,18,3051,810,32,7128,2,6,8,16,16,0,16,0,16,0,False,False,False,0,2,2021-01-10T15:52:12.043,16,,
2020,18,3051,815,32,1427,13,5,5,11,0,0,0,0,0,0,False,False,False,0,3,2021-01-10T15:53:17.94,0,,
2020,18,3051,820,32,6430,13,8,4,11,0,0,0,0,0,0,False,False,False,0,3,2021-01-13T14:09:59.213,0,,
2020,18,3051,825,32,7494,2,7,3,11,11,0,11,0,11,6,False,False,False,0,3,2021-01-10T15:58:42.713,11,,
2020,18,3051,845,30,793,2,9,6,29,35,6,32,3,32,0,False,False,False,0,3,2021-01-10T16:03:18.77,35,,
2020,18,3051,880,30,4516,2,39,4,6,16,10,15,1,15,0,False,False,False,0,3,2021-01-10T16:11:17.87,16,,
2020,18,3051,895,32,7128,2,6,7,16,16,0,16,0,16,0,False,False,False,0,2,2021-01-10T16:16:09.6,16,,
2020,18,3051,900,32,6430,2,4,5,10,10,0,10,0,10,0,False,False,False,0,2,2021-01-13T14:09:59.213,10,,
2020,18,3051,905,32,6430,13,8,8,15,0,0,0,0,0,0,False,False,False,0,2,2021-01-13T14:09:59.213,0,,
2020,18,3051,910,32,3885,13,46,3,0,0,0,0,0,0,0,False,False,False,0,1,2021-01-13T14:52:00.813,0,,
2020,18,3051,925,32,1427,13,12,2,33,0,0,0,0,0,0,False,False,False,0,3,2021-01-10T16:24:48.44,0,,
2020,18,3052,20,31,6793,13,9,2,24,0,0,0,0,0,0,False,False,False,0,3,2021-01-11T13:47:06.443,0,,
2020,18,3052,40,3,6454,13,13,9,7,0,0,0,0,0,0,False,False,False,0,3,2021-01-13T20:46:35.657,0,,
2020,18,3052,60,31,6793,2,9,6,23,28,5,23,5,23,0,False,False,False,0,2,2021-01-11T13:59:39.133,28,,
2020,18,3052,65,31,5096,2,46,3,3,4,1,4,0,4,0,True,False,False,0,4,2021-01-11T14:01:04.907,4,,
2020,18,3052,75,31,6793,2,6,4,9,14,5,13,1,13,0,False,False,False,0,2,2021-01-11T14:02:50.073,14,,
2020,18,3052,85,31,5096,2,47,5,4,5,1,5,0,5,0,False,False,False,0,4,2021-01-11T14:05:26.993,5,,
2020,18,3052,90,31,6724,2,2,10,4,9,5,8,1,8,0,True,False,False,0,3,2021-01-11T14:06:42.423,9,,
2020,18,3052,100,31,6793,2,9,3,10,10,0,10,0,10,6,False,False,False,0,3,2021-01-12T18:39:56.29,10,,
2020,18,3052,115,3,6936,2,46,3,2,7,5,4,3,4,0,False,False,False,0,3,2021-01-13T20:16:13.757,7,,
2020,18,3052,125,3,6935,13,7,2,36,0,0,0,0,0,0,False,False,False,0,3,2021-03-05T14:35:56.693,0,,
2020,18,3052,140,31,6724,2,13,4,3,35,32,31,4,31,0,False,False,False,0,4,2021-01-11T14:23:44.63,35,,
2020,18,3052,150,31,6793,13,42,4,6,0,0,0,0,0,0,False,False,False,0,2,2021-01-11T14:26:42.59,0,,
2020,18,3052,155,31,5080,13,5,5,12,0,0,0,0,0,0,False,False,False,0,3,2021-01-13T20:38:42.143,0,,
2020,18,3052,180,3,6454,2,12,2,17,17,0,17,0,17,0,False,False,False,0,3,2021-01-13T20:39:04.993,17,,
2020,18,3052,195,3,2688,2,4,9,3,5,2,5,0,5,0,False,False,False,0,3,2021-01-13T20:35:22.337,5,,
2020,18,3052,210,3,6936,2,9,2,24,28,4,24,4,24,0,False,False,False,0,3,2021-01-11T14:42:37.447,28,,
2020,18,3052,215,3,6454,13,8,10,14,0,0,0,0,0,0,False,False,False,0,4,2021-01-12T21:11:04.21,0,,
2020,18,3052,245,31,2901,2,5,9,5,4,-1,4,0,4,0,False,False,False,0,4,2021-01-11T14:53:46.9,4,,
2020,18,3052,255,31,2865,2,12,5,5,5,0,5,0,5,0,False,False,False,0,4,2021-01-11T14:58:08.37,5,,
2020,18,3052,270,3,6936,2,5,3,8,9,1,9,0,9,0,False,False,False,0,3,2021-01-11T15:04:27.863,9,,
2020,18,3052,315,31,225,2,12,9,-10,-10,0,-10,0,-10,0,False,False,False,0,6,2021-01-11T15:15:53.04,-10,,
2020,18,3052,325,31,6793,13,5,5,10,0,0,0,0,0,0,False,False,False,0,2,2021-01-11T15:19:52.163,0,,
2020,18,3052,345,3,590,13,5,3,6,0,0,0,0,0,0,False,False,False,0,2,2021-01-11T15:22:03.683,0,,
2020,18,3052,355,3,6936,2,12,10,14,19,5,19,0,19,0,False,False,False,1,3,2021-01-13T20:40:03.493,19,,
2020,18,3052,360,3,7671,2,12,9,-6,-6,0,-6,0,-6,0,False,False,False,0,1,2021-01-13T20:47:45.593,-6,,
2020,18,3052,405,3,5017,2,47,10,0,11,11,11,0,11,0,True,False,False,0,4,2021-01-13T20:35:42.287,11,,
2020,18,3052,410,3,6454,2,46,9,0,4,4,3,1,3,0,False,False,False,0,4,2021-01-11T15:45:39.577,4,,
2020,18,3052,435,3,5017,2,4,9,6,6,0,6,0,6,0,False,False,False,0,4,2021-01-13T20:40:54.997,6,,
2020,18,3052,445,3,5017,2,47,10,-1,9,10,7,2,7,0,True,False,False,1,4,2021-01-13T20:41:16.903,9,,
2020,18,3052,475,31,6390,2,26,10,5,6,1,5,1,5,0,False,False,False,0,3,2021-01-11T16:01:52.633,6,,
2020,18,3052,480,31,3504,2,46,3,3,7,4,5,2,5,0,False,False,False,0,1,2021-01-11T16:03:01.727,7,,
2020,18,3052,490,31,5080,13,12,5,3,0,0,0,0,0,0,False,False,False,0,2,2021-01-11T16:05:41.47,0,,
2020,18,3052,505,3,6454,2,47,5,2,3,1,2,1,2,0,False,False,False,0,3,2021-01-11T16:08:06.1,3,,
2020,18,3052,520,31,6793,2,21,2,16,18,2,16,2,16,0,False,False,False,0,2,2021-01-13T20:41:46.043,18,,
2020,18,3052,530,31,7913,2,2,9,10,12,2,11,1,11,0,False,False,False,0,2,2021-01-11T16:16:14.94,12,,
2020,18,3052,540,31,6793,2,38,10,1,3,2,2,1,2,0,False,False,False,0,4,2021-01-13T20:43:08.453,3,,
2020,18,3052,545,31,3504,2,12,10,-6,-2,4,-3,1,-3,0,False,False,False,0,1,2021-01-12T18:40:38.1,-2,,
2020,18,3052,565,3,6936,2,5,6,16,17,1,16,1,16,0,False,False,False,0,3,2021-01-11T16:29:50.173,17,,
2020,18,3052,575,3,6936,2,46,3,1,20,19,5,15,5,0,False,False,False,1,3,2021-01-12T21:04:56.64,20,,
2020,18,3052,585,3,5017,13,47,5,-1,0,0,0,0,0,0,True,False,False,0,4,2021-01-12T21:07:09.88,0,,
2020,18,3052,590,3,6936,13,19,2,34,0,0,0,0,0,0,False,False,False,0,3,2021-01-11T16:37:02.767,0,,
2020,18,3052,605,31,6793,2,5,5,2,10,8,2,8,2,0,False,False,False,1,3,2021-03-02T21:13:17.553,10,,
2020,18,3052,615,31,6793,13,9,6,20,0,0,0,0,0,0,False,False,False,0,3,2021-01-11T16:47:01.963,0,,
2020,18,3052,620,31,5096,13,11,3,1,0,0,0,0,0,0,False,False,False,0,1,2021-01-11T16:48:33.86,0,,
2020,18,3052,635,3,6936,2,4,9,7,9,2,9,0,9,0,False,False,False,1,3,2021-01-12T21:05:12.57,9,,
2020,18,3052,645,3,6454,2,5,9,9,17,8,12,5,12,0,True,False,False,0,3,2021-01-12T21:07:30.49,17,,
2020,18,3052,665,3,2688,2,5,3,4,4,0,4,0,4,0,False,False,False,0,2,2021-01-11T17:00:44.273,4,,
2020,18,3052,670,3,7671,2,47,5,-1,3,4,3,0,3,0,False,False,False,0,1,2021-01-11T17:01:54.01,3,,
2020,18,3052,685,31,3504,2,4,10,4,6,2,5,1,5,0,False,False,False,0,1,2021-01-11T17:24:55.23,6,,
2020,18,3052,705,31,7913,2,4,5,5,5,0,5,0,5,0,False,False,False,0,2,2021-01-11T17:08:41.567,5,,
2020,18,3052,715,31,4037,13,17,8,23,0,0,0,0,0,0,False,False,False,0,2,2021-03-05T14:37:09.7,0,,
2020,18,3052,720,3,6936,13,7,2,18,0,0,0,0,0,0,False,False,False,0,3,2021-01-13T20:44:12.063,0,,
2020,18,3053,10,20,3763,2,5,5,5,5,0,5,0,5,0,False,False,False,0,2,2021-01-11T11:20:39.8,5,,
2020,18,3053,15,20,7888,13,4,10,5,0,0,0,0,0,0,False,False,False,0,2,2021-01-11T11:25:30.873,0,,
2020,18,3053,20,20,3763,2,2,10,7,13,6,9,4,9,0,False,False,False,0,2,2021-01-11T11:27:54.373,13,,
2020,18,3053,30,20,7353,2,51,9,-3,1,4,1,0,1,0,False,False,False,0,2,2021-01-11T11:34:48.007,1,,
2020,18,3053,40,20,7888,2,28,10,1,4,3,4,0,4,0,False,False,False,0,4,2021-01-11T11:40:46.517,4,,
2020,18,3053,70,6,464,13,6,4,11,0,0,0,0,0,0,False,False,False,0,3,2021-01-11T11:57:05.887,0,,
2020,18,3053,80,20,7353,2,44,9,-5,9,14,2,7,2,0,True,False,False,1,1,2021-01-13T00:17:20.76,9,,
2020,18,3053,95,20,4535,2,12,5,1,0,-1,0,0,0,0,False,False,False,0,3,2021-01-13T00:12:46.57,0,,
2020,18,3053,100,20,7353,2,4,9,10,17,7,9,8,9,0,True,False,False,1,2,2021-03-02T21:15:53.37,17,,
2020,18,3053,110,20,213,13,8,1,17,0,0,0,0,0,0,False,False,False,0,3,2021-01-11T12:14:13.277,0,,
2020,18,3053,120,20,3763,2,4,4,6,11,5,10,1,10,6,False,False,False,0,3,2021-01-12T19:57:50.08,11,,
2020,18,3053,135,6,7728,2,30,9,-2,9,11,6,3,6,0,False,False,False,0,4,2021-01-11T12:22:27.9,9,,
2020,18,3053,145,6,6331,2,9,2,26,28,2,26,2,26,0,False,False,False,0,2,2021-01-13T16:38:12.337,28,,
2020,18,3053,150,6,6331,3,21,8,40,0,0,0,0,0,0,False,False,False,0,3,2021-01-13T16:42:59.82,0,,
2020,18,3053,160,6,7728,2,4,10,5,6,1,6,0,6,0,False,False,False,0,3,2021-01-11T12:38:18.64,6,,
2020,18,3053,180,20,568,2,32,3,1,6,5,4,2,4,0,False,False,False,0,1,2021-01-11T12:44:34.917,6,,
2020,18,3053,195,20,7353,2,5,3,14,17,3,17,0,17,0,False,False,False,0,3,2021-01-11T12:49:08.113,17,,
2020,18,3053,210,20,958,13,6,9,13,0,0,0,0,0,0,False,False,False,0,4,2021-01-13T16:37:22.81,0,,
2020,18,3053,235,6,6328,13,5,5,9,0,0,0,0,0,0,False,False,False,0,3,2021-01-11T13:03:55.457,0,,
2020,18,3053,275,6,7728,2,30,9,-2,1,3,-1,2,-1,0,False,False,False,0,4,2021-03-04T19:40:59.897,1,,
2020,18,3053,280,6,6328,2,8,4,11,11,0,11,0,11,0,False,False,False,0,3,2021-01-11T13:25:55.697,11,,
2020,18,3053,300,20,958,2,5,5,7,7,0,7,0,7,0,False,False,False,0,3,2021-01-11T17:04:30.88,7,,
2020,18,3053,310,20,3763,13,8,10,12,0,0,0,0,0,0,False,False,False,0,3,2021-01-13T15:49:06.263,0,,
2020,18,3053,320,20,5140,13,28,10,5,0,0,0,0,0,0,False,False,False,0,1,2021-01-13T16:38:35.337,0,,
2020,18,3053,330,6,6328,2,6,4,10,11,1,10,1,10,0,False,False,False,0,3,2021-01-12T20:00:03.51,11,,
2020,18,3053,340,6,464,2,30,9,1,2,1,2,0,2,0,True,False,False,0,3,2021-03-04T19:41:43.733,2,,
2020,18,3053,345,6,6786,13,4,9,3,0,0,0,0,0,0,False,False,False,0,1,2021-01-11T13:51:49.917,0,,
2020,18,3053,360,20,7888,13,53,10,-3,0,0,0,0,0,0,True,False,False,0,4,2021-01-13T16:43:31.17,0,,
2020,18,3053,365,20,7353,2,5,3,6,24,18,19,5,19,0,False,False,False,1,2,2021-01-11T13:59:04.48,24,,
2020,18,3053,370,20,213,2,51,10,-4,0,4,-2,2,-2,0,True,False,False,0,2,2021-01-13T16:39:31.313,0,,
2020,18,3053,375,20,3763,2,26,5,4,6,2,4,2,4,0,False,False,False,0,3,2021-01-11T14:03:17.137,6,,
2020,18,3053,385,20,3763,13,6,4,11,0,0,0,0,0,0,False,False,False,0,3,2021-01-13T16:38:51.093,0,,
2020,18,3053,455,6,464,2,6,1,21,21,0,21,0,21,0,False,False,False,0,2,2021-01-13T15:49:06.263,21,,
2020,18,3053,465,6,464,2,26,2,15,15,0,15,0,15,0,False,False,False,0,2,2021-03-08T19:32:32.467,15,,
2020,18,3053,480,6,6331,13,5,5,4,0,0,0,0,0,0,True,False,False,0,2,2021-01-11T14:34:33.58,0,,
2020,18,3053,500,20,3763,2,7,6,26,38,12,33,5,33,0,False,False,False,0,3,2021-01-11T14:45:15.537,38,,
2020,18,3053,505,20,958,2,6,4,4,10,6,4,6,4,0,False,False,False,3,3,2021-01-11T17:04:54.637,10,,
2020,18,3053,510,20,5140,2,4,10,4,7,3,5,2,5,0,False,False,False,1,1,2021-01-11T14:49:27.037,7,,
2020,18,3053,520,20,213,2,26,10,3,3,0,3,0,3,0,False,False,False,0,3,2021-01-11T14:53:49.387,3,,
2020,18,3053,530,20,958,13,8,7,19,0,0,0,0,0,0,False,False,False,0,3,2021-01-12T20:03:42.08,0,,
2020,18,3053,540,20,958,2,11,5,10,11,1,11,0,11,0,False,False,False,0,3,2021-01-13T16:39:48.6,11,,
2020,18,3053,555,20,306,2,12,10,-8,6,14,3,3,3,6,False,False,False,1,1,2021-01-13T16:44:08.793,6,,
2020,18,3053,575,6,6331,13,7,6,43,0,0,0,0,0,0,False,False,False,0,3,2021-01-12T20:04:23.353,0,,
2020,18,3053,580,6,3562,2,32,3,-1,3,4,2,1,2,0,True,False,False,0,3,2021-01-11T15:25:11.883,3,,
2020,18,3053,590,20,306,2,46,3,-3,5,8,4,1,4,0,False,False,False,0,1,2021-01-11T15:29:20.517,5,,
2020,18,3053,600,20,5140,2,46,3,5,10,5,10,0,10,0,False,False,False,0,1,2021-01-11T17:13:48.803,10,,
2020,18,3053,605,20,4535,2,31,10,0,5,5,5,0,5,0,False,False,False,0,4,2021-01-11T15:35:05.037,5,,
2020,18,3053,620,20,7353,2,5,5,5,5,0,4,1,4,0,False,False,False,0,2,2021-01-11T15:41:25.473,5,,
2020,18,3053,630,20,958,13,4,9,5,0,0,0,0,0,0,False,False,False,0,3,2021-01-11T15:45:08.237,0,,
2020,18,3053,640,20,7356,2,46,3,3,14,11,7,7,7,0,False,False,False,2,3,2021-01-11T15:49:08.477,14,,
2020,18,3053,650,20,958,2,6,4,5,12,7,8,4,8,0,False,False,False,0,3,2021-01-11T15:52:14.033,12,,
2020,18,3053,670,20,1162,13,33,10,2,0,0,0,0,0,0,False,False,False,0,4,2021-01-11T16:08:10.083,0,,
2020,18,3053,710,6,3562,13,3,5,12,0,0,0,0,0,0,False,False,False,0,2,2021-01-11T16:16:42.467,0,,
2020,18,3053,720,20,7353,2,51,5,-3,10,13,6,4,6,0,False,False,False,0,2,2021-01-11T16:25:04.513,10,,
2020,18,3053,730,20,568,2,28,4,3,9,6,4,5,4,0,False,False,False,0,1,2021-01-11T16:28:14.027,9,,
2020,18,3053,795,6,7728,13,2,9,7,0,0,0,0,0,0,False,False,False,0,2,2021-01-11T16:44:39.653,0,,
2020,18,3053,800,6,3562,2,4,10,6,8,2,8,0,8,0,False,False,False,0,3,2021-01-11T16:46:24.083,8,,
2020,18,3053,810,6,6790,2,4,3,4,18,14,4,14,4,0,False,False,False,1,2,2021-01-11T16:48:13.987,18,,
2020,18,3053,815,6,464,2,26,9,3,5,2,3,2,3,0,False,False,False,0,3,2021-01-13T15:49:06.263,5,,
2020,18,3053,825,6,464,2,4,3,4,5,1,4,1,4,0,False,False,False,0,2,2021-01-11T17:15:15.54,5,,
2020,18,3053,830,6,6790,2,17,10,14,18,4,15,3,15,0,False,False,False,0,3,2021-01-11T16:54:47.037,18,,
2020,18,3053,835,6,464,2,49,3,-1,7,8,7,0,7,0,False,False,False,0,2,2021-01-13T15:49:06.263,7,,
2020,18,3053,840,6,3562,2,5,5,6,6,0,5,1,5,0,False,False,False,0,3,2021-01-13T16:45:14.637,6,,
2020,18,3053,845,6,666,2,13,4,3,6,3,4,2,4,0,False,False,False,0,3,2021-01-11T16:59:40.953,6,,
2020,18,3053,850,6,666,2,17,7,18,19,1,19,0,19,6,False,False,False,0,3,2021-01-13T15:49:06.263,19,,
2020,18,3054,30,25,609,2,46,3,2,4,2,4,0,4,0,True,False,False,0,4,2021-01-11T13:24:39.32,4,,
2020,18,3054,35,25,4587,2,28,9,0,5,5,0,5,0,0,False,False,False,1,1,2021-01-11T13:26:14.53,5,,
2020,18,3054,55,25,7081,13,28,10,1,0,0,0,0,0,0,False,False,False,0,1,2021-01-11T13:34:09.71,0,,
2020,18,3054,60,8,3883,13,12,2,26,0,0,0,0,0,0,False,False,False,0,4,2021-01-11T13:36:42.767,0,,
2020,18,3054,65,8,3883,2,4,9,5,6,1,5,1,5,0,False,False,False,0,4,2021-01-11T13:37:51.727,6,,
2020,18,3054,70,8,232,2,2,9,9,40,31,34,6,34,6,True,False,False,2,3,2021-01-11T13:40:39.747,40,,
2020,18,3054,120,8,232,2,50,9,-2,4,6,3,1,3,0,False,False,False,0,3,2021-01-11T13:51:54.567,4,,
2020,18,3054,125,8,3606,2,7,3,12,12,0,12,0,12,0,False,False,False,0,3,2021-01-11T13:54:15.213,12,,
2020,18,3054,145,25,7060,2,2,9,5,11,6,8,3,8,0,False,False,False,0,2,2021-01-11T13:59:59.157,11,,
2020,18,3054,150,25,7666,2,12,3,3,8,5,8,0,8,0,False,False,False,1,4,2021-03-02T21:27:08.587,8,,
2020,18,3054,155,25,4583,13,35,10,13,0,0,0,0,0,0,False,False,False,0,3,2021-01-11T14:05:30.117,0,,
2020,18,3054,160,25,7060,3,6,1,19,0,0,0,0,0,0,False,False,False,0,2,2021-03-05T14:39:38.363,0,,
2020,18,3054,170,8,6439,2,46,3,4,7,3,7,0,7,0,False,False,False,0,3,2021-01-11T14:10:24.717,7,,
2020,18,3054,190,25,7060,2,12,3,9,18,9,15,3,15,0,False,False,False,0,2,2021-01-11T14:14:14.08,18,,
2020,18,3054,200,25,609,3,47,5,1,0,0,0,0,0,0,False,False,False,0,4,2021-01-11T14:17:19.71,0,,
2020,18,3054,205,25,609,2,27,10,-3,11,14,4,7,4,0,False,False,False,0,4,2021-01-11T14:20:48.767,11,,
2020,18,3054,225,25,4583,2,46,3,1,9,8,9,0,9,0,False,False,False,0,3,2021-01-11T18:39:23.22,9,,
2020,18,3054,230,25,609,2,4,9,5,6,1,5,1,5,0,False,False,False,0,4,2021-01-11T14:26:46.053,6,,
2020,18,3054,235,25,7060,13,8,8,37,0,0,0,0,0,0,False,False,False,0,2,2021-01-11T14:28:28.253,0,,
2020,18,3054,240,25,6486,2,4,9,9,14,5,12,2,12,0,False,False,False,1,2,2021-01-12T20:56:05.623,14,,
2020,18,3054,245,25,7666,2,4,10,4,1,-3,1,0,1,0,False,False,False,0,3,2021-01-13T19:45:06.957,1,,
2020,18,3054,250,25,609,3,6,10,11,0,0,0,0,0,0,False,False,False,0,3,2021-01-11T14:38:20.633,0,,
2020,18,3054,255,25,6486,13,12,6,33,0,0,0,0,0,0,False,False,False,0,2,2021-01-11T14:40:15.03,0,,
2020,18,3054,270,8,3606,3,4,5,10,0,0,0,0,0,0,False,False,False,0,2,2021-01-11T14:42:59.69,0,,
2020,18,3054,275,8,3606,13,24,2,28,0,0,0,0,0,0,False,False,False,0,3,2021-01-11T14:44:33.183,0,,
2020,18,3054,285,25,7060,2,5,5,4,5,1,5,0,5,0,False,False,False,0,2,2021-01-11T14:46:27.48,5,,
2020,18,3054,295,25,181,13,5,10,-1,0,0,0,0,0,0,False,False,False,0,4,2021-03-05T14:40:24.627,0,,
2020,18,3054,310,8,3883,2,12,3,7,16,9,12,4,12,0,False,False,False,0,4,2021-01-11T14:58:12.793,16,,
2020,18,3054,315,8,3883,3,35,7,15,0,0,0,0,0,0,False,False,False,0,3,2021-01-11T15:04:27.983,0,,
2020,18,3054,335,25,7081,2,28,10,1,4,3,4,0,4,0,False,False,False,1,1,2021-01-13T19:42:58.337,4,,
2020,18,3054,340,25,4583,2,5,3,5,5,0,5,0,5,0,False,False,False,0,3,2021-01-11T15:13:54.43,5,,
2020,18,3054,350,25,6486,2,4,5,11,17,6,16,1,16,0,False,False,False,0,2,2021-01-11T15:16:16.55,17,,
2020,18,3054,355,25,6486,2,4,10,6,10,4,10,0,10,0,False,False,False,0,2,2021-01-11T15:17:47.4,10,,
2020,18,3054,360,25,6486,2,9,2,21,27,6,25,2,25,0,False,False,False,0,2,2021-01-11T15:19:28.243,27,,
2020,18,3054,365,25,4587,2,28,9,-5,7,12,4,3,4,0,False,False,False,1,1,2021-03-02T21:27:26.177,7,,
2020,18,3054,370,25,7060,2,18,3,0,6,6,6,0,6,0,False,False,False,0,2,2021-01-11T15:21:43.393,6,,
2020,18,3054,375,25,6486,2,4,5,5,4,-1,4,0,4,0,False,False,False,0,2,2021-01-11T15:22:44.347,4,,
2020,18,3054,380,25,609,2,6,9,3,5,2,5,0,5,0,False,False,False,0,3,2021-01-11T15:23:57.443,5,,
2020,18,3054,385,25,4583,13,29,3,2,0,0,0,0,0,0,False,False,False,0,3,2021-01-11T15:24:55.037,0,,
2020,18,3054,425,8,3606,3,5,3,10,0,0,0,0,0,0,False,False,False,0,3,2021-01-11T15:43:20.04,0,,
2020,18,3054,435,8,6439,2,46,3,-1,1,2,0,1,0,0,False,False,False,0,1,2021-01-11T15:46:24.357,1,,
2020,18,3054,440,8,6439,2,44,3,-4,21,25,19,2,19,0,False,False,False,1,1,2021-01-11T15:51:35.2,21,,
2020,18,3054,445,8,3883,2,39,4,8,8,0,8,0,8,0,False,False,False,0,4,2021-01-11T15:52:48.503,8,,
2020,18,3054,460,8,3883,2,4,10,5,5,0,5,0,5,0,False,False,False,0,3,2021-01-11T15:54:46.83,5,,
2020,18,3054,470,8,3883,2,7,5,7,7,0,7,0,7,6,False,False,False,0,4,2021-01-11T15:56:42.403,7,,
2020,18,3054,495,25,7060,13,4,5,14,0,0,0,0,0,0,False,False,False,0,2,2021-01-11T16:01:17.677,0,,
2020,18,3054,500,25,7060,2,6,10,13,11,-2,12,-1,12,0,False,False,False,1,2,2021-03-02T21:27:44.957,11,,
2020,18,3054,510,25,7666,2,4,6,15,15,0,15,0,15,0,False,False,False,0,2,2021-01-13T18:46:08.313,15,,
2020,18,3054,535,8,3883,2,5,9,5,7,2,5,2,5,0,False,False,False,0,4,2021-01-11T16:08:12.897,7,,
2020,18,3054,545,8,3606,2,2,10,10,16,6,16,0,16,0,False,False,False,0,3,2021-01-11T16:11:32.643,16,,
2020,18,3054,550,8,3883,3,5,10,7,0,0,0,0,0,0,False,False,False,0,4,2021-01-11T16:14:28.9,0,,
2020,18,3054,555,8,232,2,13,4,4,7,3,7,0,7,0,False,False,False,0,3,2021-01-11T16:15:42.997,7,,
2020,18,3054,565,8,3606,13,6,9,13,0,0,0,0,0,0,False,False,False,0,2,2021-01-11T16:23:26.327,0,,
2020,18,3054,575,25,7666,2,18,3,-1,7,8,4,3,4,0,False,False,False,0,2,2021-01-11T16:25:52.45,7,,
2020,18,3054,580,25,609,2,17,10,2,9,7,4,5,4,0,False,False,False,0,4,2021-01-11T16:27:56.113,9,,
2020,18,3054,585,25,4583,2,5,3,10,10,0,10,0,10,0,False,False,False,0,3,2021-01-11T16:29:03.597,10,,
2020,18,3054,590,25,7060,2,5,3,3,12,9,10,2,10,0,False,False,False,0,2,2021-01-11T16:30:26.443,12,,
2020,18,3054,595,25,4587,2,28,10,0,4,4,4,0,4,0,False,False,False,0,1,2021-01-13T19:43:15.947,4,,
2020,18,3054,600,25,609,2,47,5,1,10,9,10,0,10,0,False,False,False,0,4,2021-01-13T19:49:40.257,10,,
2020,18,3054,605,25,7060,2,5,3,13,15,2,15,0,15,0,False,False,False,0,2,2021-01-11T16:35:13.12,15,,
2020,18,3054,610,25,609,2,7,2,17,17,0,17,0,17,6,False,False,False,0,3,2021-01-11T16:40:46.12,17,,
2020,18,3054,625,8,232,13,5,3,6,0,0,0,0,0,0,False,False,False,0,3,2021-01-11T16:45:43.123,0,,
2020,18,3054,635,8,232,13,2,10,4,0,0,0,0,0,0,False,False,False,0,2,2021-01-11T16:47:35.773,0,,
2020,18,3054,645,25,7060,2,2,10,1,1,0,1,0,1,0,False,False,False,0,3,2021-01-11T16:50:00.73,1,,
2020,18,3054,650,25,4583,13,5,5,11,0,0,0,0,0,0,False,False,False,0,3,2021-01-11T16:54:36.033,0,,
2020,18,3054,655,25,7060,2,4,3,13,15,2,15,0,15,0,False,False,False,0,2,2021-01-11T16:56:20.387,15,,
2020,18,3054,665,25,4583,2,9,5,11,27,16,16,11,16,0,False,False,False,1,3,2021-01-13T19:43:27.207,27,,
2020,18,3054,670,25,7666,13,24,5,7,0,0,0,0,0,0,False,False,False,0,2,2021-01-11T17:00:36.067,0,,
2020,18,3054,675,25,7666,13,9,2,15,0,0,0,0,0,0,False,False,False,0,2,2021-01-11T17:01:48.33,0,,
2020,18,3054,680,25,4583,2,4,9,9,15,6,13,2,13,0,False,False,False,0,3,2021-01-11T17:03:11.153,15,,
2020,18,3054,685,25,181,3,39,9,5,0,0,0,0,0,0,False,False,False,0,4,2021-01-11T17:04:27.183,0,,
2020,18,3054,690,25,7060,13,29,3,5,0,0,0,0,0,0,False,False,False,0,2,2021-01-11T17:05:16.737,0,,
2020,18,3054,695,25,609,13,5,3,5,0,0,0,0,0,0,False,False,False,0,3,2021-01-12T20:56:28.693,0,,
2020,18,3054,700,25,4583,2,35,3,5,5,0,5,0,5,6,False,False,False,0,3,2021-01-11T17:07:47.923,5,,
2020,18,3054,725,8,7651,13,5,3,9,0,0,0,0,0,0,False,False,False,0,2,2021-01-11T17:10:34.22,0,,
2020,18,3054,735,25,4583,2,4,3,4,4,0,4,0,4,0,False,False,False,0,2,2021-01-11T17:12:31.167,4,,
2020,18,3054,740,25,4583,2,51,5,-3,-2,1,-3,1,-3,0,False,False,False,0,3,2021-01-11T17:13:34.287,-2,,
2020,18,3054,745,25,4583,2,13,10,6,7,1,7,0,7,0,False,False,False,0,3,2021-01-11T17:14:53.17,7,,
2020,18,3054,765,8,7651,2,4,3,8,8,0,8,0,8,0,False,False,False,0,2,2021-01-11T17:29:28.58,8,,
2020,18,3054,770,8,3606,13,4,9,5,0,0,0,0,0,0,False,False,False,0,3,2021-01-11T17:30:41.833,0,,
2020,18,3054,775,8,232,2,26,10,2,17,15,17,0,17,0,False,False,False,0,3,2021-01-12T19:28:36.433,17,,
2020,18,3054,780,8,232,2,2,10,11,14,3,14,0,14,0,False,False,False,0,3,2021-01-11T17:33:13.643,14,,
2020,18,3054,790,8,6439,2,48,10,-1,40,41,9,31,9,6,False,False,False,1,1,2021-01-11T17:35:06.643,40,,
2020,18,3054,805,25,7060,2,4,10,5,7,2,7,0,7,0,False,False,False,0,2,2021-01-11T17:37:09.957,7,,
2020,18,3054,810,25,7060,2,6,8,15,15,0,15,0,15,0,False,False,False,0,2,2021-01-11T17:38:37.47,15,,
2020,18,3054,815,25,4583,2,20,1,18,25,7,23,2,23,0,False,False,False,0,3,2021-01-13T18:50:44.22,25,,
2020,18,3054,820,25,7666,2,8,8,24,29,5,29,0,29,6,False,False,False,0,2,2021-01-11T17:41:11.267,29,,
2020,18,3054,845,8,232,13,5,5,5,0,0,0,0,0,0,False,False,False,0,3,2021-01-11T17:44:35.367,0,,
2020,18,3054,850,8,5053,2,45,10,-6,13,19,10,3,10,0,False,False,False,0,1,2021-01-11T17:46:21.5,13,,
2020,18,3054,860,8,232,2,6,4,5,17,12,14,3,14,0,False,False,False,1,3,2021-01-11T17:48:48.543,17,,
2020,18,3054,870,8,4976,2,4,9,4,7,3,5,2,5,0,False,False,False,0,4,2021-01-11T18:40:14.473,7,,
2020,18,3054,875,8,3883,2,5,10,8,8,0,8,0,8,0,True,False,False,0,4,2021-01-11T17:51:51.187,8,,
2020,18,3054,890,8,3883,13,7,3,6,0,0,0,0,0,0,True,False,False,0,3,2021-01-11T17:56:53.997,0,,
2020,18,3054,905,25,4583,2,13,9,2,1,-1,1,0,1,0,False,False,False,0,3,2021-01-11T17:58:34.737,1,,
2020,18,3054,910,25,4587,2,28,9,-1,5,6,-1,6,-1,0,False,False,False,1,1,2021-01-11T17:59:52.027,5,,
2020,18,3054,915,25,4587,2,28,9,-4,9,13,9,0,9,0,False,False,False,0,1,2021-01-11T18:00:54.497,9,,
2020,18,3054,920,25,609,13,35,9,8,0,0,0,0,0,0,False,False,False,0,4,2021-03-05T14:41:06.607,0,,
2020,18,3054,930,8,3883,2,32,3,2,5,3,3,2,3,0,False,False,False,0,4,2021-01-11T18:04:47.947,5,,
2020,18,3054,960,25,7060,2,6,7,18,19,1,19,0,19,0,False,False,False,0,2,2021-01-11T18:10:18.117,19,,
2020,18,3054,965,25,4583,13,8,8,22,0,0,0,0,0,0,False,False,False,0,2,2021-01-13T19:49:06.727,0,,
2020,18,3054,970,25,4583,2,12,10,13,18,5,18,0,18,0,False,False,False,0,3,2021-01-11T18:12:43.67,18,,
2020,18,3054,980,25,4583,13,35,8,15,0,0,0,0,0,0,False,False,False,0,3,2021-01-11T18:14:09.553,0,,
2020,18,3054,985,25,7060,3,4,8,16,0,0,0,0,0,0,False,False,False,0,2,2021-01-11T18:15:32.107,0,,
2020,18,3054,990,25,4583,13,17,7,18,0,0,0,0,0,0,False,False,False,0,3,2021-01-11T18:16:38.823,0,,
2020,18,3054,995,25,4583,2,17,7,33,33,0,33,0,33,0,False,False,False,0,3,2021-01-11T18:17:52.443,33,,
2020,18,3054,1000,25,7666,2,3,3,7,7,0,7,0,7,6,False,False,False,0,2,2021-03-04T19:44:40.46,7,,
2020,19,3055,10,29,3398,2,46,3,1,1,0,1,0,1,0,False,False,False,0,3,2021-01-19T15:11:39.337,1,,
2020,19,3055,20,29,1958,13,2,10,7,0,0,0,0,0,0,True,False,False,0,3,2021-01-19T14:53:32.693,0,,
2020,19,3055,35,12,556,2,5,5,6,8,2,7,1,7,0,True,False,False,0,3,2021-01-17T11:44:49.033,8,,
2020,19,3055,50,12,6357,2,4,5,6,12,6,8,4,8,0,False,False,False,1,2,2021-01-17T11:48:54.413,12,,
2020,19,3055,55,12,6356,3,12,5,6,0,0,0,0,0,0,False,False,False,0,3,2021-01-19T15:18:02.197,0,,
2020,19,3055,65,12,6356,2,17,1,19,27,8,20,7,20,0,False,False,False,1,3,2021-01-17T11:54:58.587,27,,
2020,19,3055,75,12,6357,13,12,3,5,0,0,0,0,0,0,False,False,False,0,3,2021-01-19T15:01:07.453,0,,
2020,19,3055,80,12,6691,13,13,9,3,0,0,0,0,0,0,False,False,False,0,3,2021-01-19T15:01:13.56,0,,
2020,19,3055,100,29,1958,2,30,9,-3,3,6,2,1,2,0,False,False,False,0,3,2021-01-19T15:09:19.653,3,,
2020,19,3055,105,29,4875,2,36,1,19,28,9,25,3,25,0,False,False,False,0,3,2021-01-17T12:07:53.79,28,,
2020,19,3055,110,29,1958,2,8,8,17,19,2,19,0,19,0,False,False,False,0,3,2021-01-19T14:53:32.693,19,,
2020,19,3055,165,12,4511,2,32,5,2,9,7,6,3,6,0,False,False,False,0,4,2021-01-17T12:25:19.553,9,,
2020,19,3055,175,12,4511,2,30,3,0,6,6,2,4,2,0,False,False,False,0,4,2021-01-17T12:28:26.697,6,,
2020,19,3055,195,12,556,13,5,9,4,0,0,0,0,0,0,False,False,False,0,3,2021-01-17T12:33:51.887,0,,
2020,19,3055,205,12,6691,2,4,10,6,8,2,7,1,7,0,False,False,False,0,3,2021-01-17T12:53:04.643,8,,
2020,19,3055,220,12,556,2,47,5,1,1,0,1,0,1,6,True,False,False,0,3,2021-01-17T12:57:23.88,1,,
2020,19,3055,245,29,3356,2,28,4,2,4,2,4,0,4,0,False,False,False,0,1,2021-01-19T15:01:24.793,4,,
2020,19,3055,255,12,556,2,51,9,-5,1,6,0,1,0,0,True,False,False,0,3,2021-01-17T13:08:37.5,1,,
2020,19,3055,260,12,4537,2,45,10,-6,14,20,3,11,3,0,False,False,False,1,1,2021-01-17T13:10:39.923,14,,
2020,19,3055,265,12,6357,2,13,4,7,11,4,9,2,9,0,False,False,False,0,3,2021-03-08T16:03:53.733,11,,
2020,19,3055,270,12,6357,2,18,10,0,6,6,5,1,5,0,False,False,False,0,2,2021-01-17T13:19:42.963,6,,
2020,19,3055,280,12,556,2,2,10,6,12,6,11,1,11,0,False,False,False,0,2,2021-01-19T15:18:51.987,12,,
2020,19,3055,350,29,4875,2,42,10,5,21,16,17,4,17,0,False,False,False,0,3,2021-01-17T13:41:06.93,21,,
2020,19,3055,360,29,1958,2,4,3,5,5,0,5,0,5,0,False,False,False,0,3,2021-01-17T13:42:45.167,5,,
2020,19,3055,370,29,7788,2,4,9,4,6,2,5,1,5,0,False,False,False,0,1,2021-01-17T13:45:05.363,6,,
2020,19,3055,375,29,7828,2,4,9,4,4,0,4,0,4,6,False,False,False,0,3,2021-01-17T13:46:03.483,4,,
2020,19,3055,390,12,556,2,24,2,17,21,4,18,3,18,0,True,False,False,0,3,2021-01-17T13:48:34.963,21,,
2020,19,3055,400,12,4511,2,12,2,24,33,9,33,0,33,0,False,False,False,0,4,2021-01-17T13:50:25.71,33,,
2020,19,3055,405,12,6691,13,17,7,21,0,0,0,0,0,0,False,False,False,0,3,2021-01-19T15:02:12.957,0,,
2020,19,3055,410,12,6357,13,17,8,21,0,0,0,0,0,0,False,False,False,0,3,2021-01-17T14:03:54.33,0,,
2020,19,3055,495,12,6357,13,21,6,33,0,0,0,0,0,0,False,False,False,0,2,2021-01-19T15:02:21.377,0,,
2020,19,3055,500,12,6691,2,6,8,15,21,6,16,5,16,0,False,False,False,1,2,2021-01-17T14:38:39.8,21,,
2020,19,3055,510,12,6691,3,19,2,22,0,0,0,0,0,0,True,False,False,0,3,2021-01-18T18:30:30.767,0,,
2020,19,3055,520,12,6357,13,19,8,45,0,0,0,0,0,0,False,False,False,0,2,2021-01-17T14:45:40.78,0,,
2020,19,3055,530,29,7828,2,4,3,4,4,0,4,0,4,0,False,False,False,0,2,2021-01-17T14:49:19.11,4,,
2020,19,3055,535,29,1958,2,46,3,3,6,3,5,1,5,0,True,False,False,0,3,2021-01-17T14:50:29.247,6,,
2020,19,3055,540,29,4875,2,7,6,16,16,0,16,0,16,0,False,False,False,0,3,2021-01-17T14:52:50.63,16,,
2020,19,3055,545,29,3398,2,4,9,4,4,0,4,0,4,0,False,False,False,0,3,2021-01-19T15:02:29.64,4,,
2020,19,3055,550,29,1958,2,5,3,4,5,1,5,0,5,0,False,False,False,0,3,2021-01-17T14:55:25.99,5,,
2020,19,3055,555,29,7828,2,35,8,16,16,0,16,0,16,0,False,False,False,0,3,2021-01-17T14:57:43.463,16,,
2020,19,3055,615,12,6691,2,13,10,4,9,5,6,3,6,0,False,False,False,0,3,2021-01-17T15:29:31.883,9,,
2020,19,3055,620,12,556,2,2,10,6,7,1,6,1,6,0,False,False,False,0,2,2021-01-18T18:29:53.447,7,,
2020,19,3055,630,12,556,2,51,9,-1,4,5,1,3,1,0,True,False,False,0,3,2021-01-19T15:32:34.653,4,,
2020,19,3055,640,12,4537,13,44,3,-6,0,0,0,0,0,0,False,False,False,0,1,2021-01-19T15:33:06.063,0,,
2020,19,3055,655,29,7828,2,4,3,3,8,5,5,3,5,0,False,False,False,1,2,2021-01-17T15:48:17.417,8,,
2020,19,3055,660,29,1958,2,5,3,5,5,0,5,0,5,0,False,False,False,0,3,2021-01-17T15:49:33.05,5,,
2020,19,3055,670,29,7828,2,5,5,9,9,0,9,0,9,0,False,False,False,0,3,2021-01-17T15:52:31.717,9,,
2020,19,3055,675,29,4875,3,4,10,5,0,0,0,0,0,0,False,False,False,0,3,2021-01-19T15:33:37.22,0,,
2020,19,3055,690,29,7828,2,18,3,0,5,5,4,1,4,0,False,False,False,0,2,2021-01-17T15:57:44.217,5,,
2020,19,3055,710,12,6357,2,51,10,0,4,4,1,3,1,0,False,False,False,0,3,2021-01-19T14:39:03.353,4,,
2020,19,3055,715,12,556,2,51,9,0,4,4,2,2,2,0,False,False,False,0,3,2021-01-17T16:18:58.233,4,,
2020,19,3055,720,12,6691,2,8,7,33,58,25,58,0,58,6,False,False,False,0,3,2021-01-17T16:21:17.81,58,,
2020,19,3055,735,29,1958,2,5,3,6,8,2,7,1,7,0,True,False,False,0,3,2021-01-17T16:24:04.41,8,,
2020,19,3055,740,29,4850,13,5,10,5,0,0,0,0,0,0,False,False,False,0,4,2021-01-17T16:27:51.8,0,,
2020,19,3055,750,29,1958,3,32,3,3,0,0,0,0,0,0,False,False,False,0,3,2021-01-19T15:12:13.717,0,,
2020,19,3055,755,29,1958,2,50,10,-4,-3,1,-3,0,-3,0,False,False,False,0,3,2021-01-19T15:34:05.687,-3,,
2020,19,3055,760,29,7828,13,4,5,8,0,0,0,0,0,0,False,False,False,0,2,2021-01-19T14:53:32.71,0,,
2020,19,3055,775,12,4511,2,32,5,2,12,10,10,2,10,0,False,False,False,0,4,2021-01-19T15:19:51.033,12,,
2020,19,3055,795,12,556,2,18,5,1,8,7,4,4,4,0,False,False,False,1,2,2021-01-17T16:49:35.447,8,,
2020,19,3056,45,3,2688,2,46,3,1,1,0,1,0,1,0,False,False,False,0,3,2021-01-19T16:05:02.05,1,,
2020,19,3056,70,3,6935,2,39,4,5,11,6,9,2,9,0,False,False,False,0,3,2021-01-19T16:46:47.793,11,,
2020,19,3056,80,4,2853,2,35,10,10,13,3,12,1,12,0,False,False,False,0,3,2021-01-17T11:34:45.137,13,,
2020,19,3056,90,4,1412,2,4,10,4,4,0,4,0,4,0,False,False,False,0,3,2021-01-19T16:32:09.05,4,,
2020,19,3056,100,4,2853,13,19,2,46,0,0,0,0,0,0,False,False,False,0,2,2021-01-17T11:41:32.947,0,,
2020,19,3056,120,3,7671,3,12,3,8,0,0,0,0,0,0,True,False,False,0,1,2021-01-17T11:47:25.08,0,,
2020,19,3056,130,4,2853,2,5,5,7,16,9,13,3,13,0,False,False,False,0,3,2021-01-17T11:52:10.617,16,,
2020,19,3056,140,4,1412,13,47,5,0,0,0,0,0,0,0,False,False,False,0,3,2021-01-19T16:47:16.083,0,,
2020,19,3056,145,4,6983,2,49,5,-4,1,5,0,1,0,0,False,False,False,0,2,2021-01-17T11:57:54.703,1,,
2020,19,3056,150,4,7646,3,8,4,9,0,0,0,0,0,0,False,False,False,0,3,2021-01-17T12:10:57.99,0,,
2020,19,3056,190,4,2853,13,19,2,47,0,0,0,0,0,0,False,False,False,0,2,2021-01-17T12:34:44.01,0,,
2020,19,3056,195,4,1412,2,12,5,11,11,0,11,0,11,0,False,False,False,0,2,2021-03-02T21:54:10.91,11,,
2020,19,3056,205,4,1412,2,7,2,21,21,0,21,0,21,0,False,False,False,0,3,2021-01-17T12:38:21.9,21,,
2020,19,3056,210,4,7646,13,29,6,21,0,0,0,0,0,0,False,False,False,0,2,2021-01-19T16:05:02.05,0,,
2020,19,3056,215,4,6983,2,48,4,-4,2,6,2,0,2,0,False,False,False,0,1,2021-01-17T17:22:02.34,2,,
2020,19,3056,235,3,7671,2,12,6,19,31,12,23,8,23,0,False,False,False,2,2,2021-01-17T12:51:16.573,31,,
2020,19,3056,240,3,6454,3,12,5,2,0,0,0,0,0,0,False,False,False,0,3,2021-01-19T16:24:24.363,0,,
2020,19,3056,255,3,6454,13,13,3,5,0,0,0,0,0,0,False,False,False,0,3,2021-01-19T16:47:27.317,0,,
2020,19,3056,265,4,2853,2,35,3,11,11,0,11,0,11,0,False,False,False,0,3,2021-01-17T13:05:08.383,11,,
2020,19,3056,270,4,1412,2,12,5,11,10,-1,10,0,10,0,False,False,False,0,2,2021-01-17T13:07:15.337,10,,
2020,19,3056,275,4,7646,13,35,2,28,0,0,0,0,0,0,False,False,False,0,3,2021-01-17T13:09:55.607,0,,
2020,19,3056,280,4,1412,2,47,5,2,2,0,2,0,2,0,False,False,False,0,3,2021-01-19T16:25:10.73,2,,
2020,19,3056,315,3,5017,2,47,10,-1,11,12,9,2,9,0,False,False,False,0,1,2021-01-17T13:22:21.277,11,,
2020,19,3056,320,3,6936,2,35,7,21,21,0,21,0,21,0,False,False,False,0,3,2021-01-19T16:15:49.623,21,,
2020,19,3056,335,3,6454,13,7,5,12,0,0,0,0,0,0,True,False,False,0,4,2021-01-19T16:15:57.163,0,,
2020,19,3056,340,3,6936,13,6,7,16,0,0,0,0,0,0,False,False,False,0,2,2021-01-19T16:47:55.033,0,,
2020,19,3056,355,4,6953,2,31,4,1,4,3,2,2,2,0,False,False,False,0,1,2021-01-19T16:38:46.677,4,,
2020,19,3056,365,4,2853,2,4,3,5,19,14,5,14,5,0,True,False,False,1,2,2021-01-17T17:22:19.417,19,,
2020,19,3056,370,4,594,13,5,5,3,0,0,0,0,0,0,False,False,False,0,3,2021-01-19T16:32:34.977,0,,
2020,19,3056,375,4,1412,2,18,3,-1,6,7,6,0,6,0,False,False,False,0,2,2021-01-17T13:43:13.023,6,,
2020,19,3056,385,4,594,13,6,4,7,0,0,0,0,0,0,False,False,False,0,2,2021-01-17T13:45:33.257,0,,
2020,19,3056,400,3,6454,2,4,4,4,8,4,6,2,6,0,True,False,False,0,3,2021-01-19T16:33:18.3,8,,
2020,19,3056,405,3,6936,2,23,1,27,30,3,30,0,30,0,False,False,False,0,3,2021-01-17T13:52:25.723,30,,
2020,19,3056,415,3,6454,2,5,5,5,5,0,5,0,5,0,False,False,False,0,3,2021-01-19T16:32:45.75,5,,
2020,19,3056,420,3,6935,13,13,5,3,0,0,0,0,0,0,False,False,False,0,3,2021-01-19T16:05:02.05,0,,
2020,19,3056,440,3,6935,2,5,3,5,5,0,5,0,5,0,False,False,False,0,2,2021-01-18T22:40:24.793,5,,
2020,19,3056,480,4,6953,2,46,3,1,14,13,12,2,12,0,False,False,False,0,4,2021-03-04T19:49:59.153,14,,
2020,19,3056,490,4,2853,2,5,10,13,20,7,16,4,16,0,True,False,False,0,3,2021-01-17T14:35:47.87,20,,
2020,19,3056,505,4,2853,13,2,9,8,0,0,0,0,0,0,False,False,False,0,2,2021-01-17T14:39:44.67,0,,
2020,19,3056,510,4,6983,2,47,5,1,9,8,7,2,7,0,True,False,False,0,3,2021-01-17T14:41:31.78,9,,
2020,19,3056,515,4,7646,13,2,9,3,0,0,0,0,0,0,False,False,False,0,2,2021-01-19T16:34:14.873,0,,
2020,19,3056,520,4,2853,2,49,3,-2,3,5,2,1,2,6,False,False,False,0,2,2021-01-19T16:38:57.587,3,,
2020,19,3056,535,3,6936,2,4,9,5,7,2,7,0,7,0,False,False,False,0,2,2021-01-17T14:48:14.433,7,,
2020,19,3056,550,3,6454,2,2,10,7,14,7,9,5,9,0,False,False,False,1,3,2021-03-04T19:51:48.06,14,,
2020,19,3056,555,3,6454,2,46,9,-1,1,2,0,1,0,0,False,False,False,0,3,2021-01-17T14:59:03.73,1,,
2020,19,3056,575,3,2688,2,5,3,4,8,4,6,2,6,0,False,False,False,1,3,2021-01-17T15:05:50.7,8,,
2020,19,3056,585,3,2688,2,4,4,3,9,6,6,3,6,0,True,False,False,2,3,2021-01-17T15:11:30.297,9,,
2020,19,3056,600,3,6936,13,35,9,7,0,0,0,0,0,0,False,False,False,0,3,2021-01-19T16:05:02.05,0,,
2020,19,3056,605,3,6454,13,4,4,9,0,0,0,0,0,0,False,False,False,0,3,2021-01-17T15:19:14.097,0,,
2020,19,3056,645,4,1412,2,2,5,3,4,1,3,1,3,0,False,False,False,0,2,2021-01-19T16:16:13.943,4,,
2020,19,3056,650,4,5119,2,51,9,-3,7,10,7,0,7,0,False,False,False,0,3,2021-03-04T19:52:27.25,7,,
2020,19,3056,655,4,1412,13,29,3,10,0,0,0,0,0,0,False,False,False,0,3,2021-01-17T15:34:05.633,0,,
2020,19,3056,665,4,2853,2,4,3,9,14,5,13,1,13,0,False,False,False,0,2,2021-01-17T15:36:33.47,14,,
2020,19,3056,670,4,2853,2,4,10,10,10,0,10,0,10,0,False,False,False,0,3,2021-01-18T22:03:07.317,10,,
2020,19,3056,680,4,5119,2,30,5,-3,1,4,1,0,1,0,True,False,False,0,4,2021-01-19T16:27:21.933,1,,
2020,19,3056,685,4,1412,13,8,7,39,0,0,0,0,0,0,False,False,False,0,2,2021-01-17T16:01:30.193,0,,
2020,19,3056,700,3,2688,2,5,3,4,5,1,4,1,4,0,False,False,False,0,3,2021-01-19T16:34:25.443,5,,
2020,19,3056,710,3,6454,13,5,5,9,0,0,0,0,0,0,False,False,False,0,3,2021-01-18T22:41:03.037,0,,
2020,19,3056,715,3,2688,2,4,10,3,2,-1,2,0,2,0,False,False,False,0,3,2021-01-19T16:34:36.253,2,,
2020,19,3056,720,3,590,13,4,9,13,0,0,0,0,0,0,False,False,False,0,3,2021-01-19T16:48:35.287,0,,
2020,19,3056,725,3,6936,13,21,2,34,0,0,0,0,0,0,False,False,False,0,3,2021-01-19T16:34:46.917,0,,
2020,19,3056,745,4,1412,2,18,3,-1,4,5,3,1,3,0,False,False,False,0,2,2021-01-17T16:18:11.743,4,,
2020,19,3056,760,3,6935,2,39,10,2,4,2,3,1,3,0,False,False,False,0,3,2021-01-17T16:32:48.83,4,,
2020,19,3056,765,3,7671,2,4,10,4,9,5,6,3,6,0,False,False,False,1,1,2021-01-17T17:22:31.697,9,,
2020,19,3056,770,3,7671,2,4,4,4,11,7,9,2,9,0,False,False,False,0,1,2021-01-19T16:05:02.05,11,,
2020,19,3056,785,3,6936,2,4,8,19,29,10,29,0,29,0,False,False,False,0,3,2021-01-17T16:41:31.373,29,,
2020,19,3056,790,3,6918,13,47,5,-1,0,0,0,0,0,0,False,False,False,0,1,2021-01-19T16:48:45.657,0,,
2020,19,3056,805,3,6454,13,17,4,10,0,0,0,0,0,0,False,False,False,0,3,2021-01-19T16:05:02.05,0,,
2020,19,3056,810,3,7671,3,44,3,4,0,0,0,0,0,0,False,False,False,0,1,2021-02-25T17:52:27.75,0,,
2020,19,3056,815,3,6454,13,17,4,10,0,0,0,0,0,0,False,False,False,0,3,2021-02-25T17:53:56.137,0,,
2020,19,3057,20,16,374,2,39,4,5,7,2,7,0,7,0,False,False,False,0,3,2021-01-18T11:31:28.97,7,,
2020,19,3057,25,16,3938,2,2,8,15,26,11,19,7,19,0,False,False,False,1,3,2021-01-18T11:33:58.143,26,,
2020,19,3057,40,16,7176,2,51,9,-6,-1,5,-2,1,-2,0,True,False,False,0,3,2021-01-18T11:38:12.327,-1,,
2020,19,3057,45,16,6499,2,46,3,-1,9,10,-1,10,-1,0,False,False,False,1,1,2021-03-02T22:06:28.933,9,,
2020,19,3057,80,8,4976,2,53,9,-4,27,31,23,4,23,0,False,False,False,0,4,2021-01-18T11:48:22.027,27,,
2020,19,3057,85,8,232,13,13,9,4,0,0,0,0,0,0,False,False,False,0,3,2021-03-17T20:07:23.44,0,,
2020,19,3057,90,8,3883,13,12,2,15,0,0,0,0,0,0,False,False,False,0,4,2021-01-18T11:55:01.237,0,,
2020,19,3057,95,8,3883,2,32,5,4,11,7,11,0,11,0,False,False,False,0,4,2021-01-18T11:56:51.75,11,,
2020,19,3057,115,8,232,2,34,4,-4,-3,1,-3,0,-3,0,True,False,False,0,3,2021-01-18T12:03:10.8,-3,,
2020,19,3057,130,8,232,2,46,3,3,3,0,3,0,3,0,False,False,False,0,3,2021-01-18T12:05:39.967,3,,
2020,19,3057,145,16,34,13,4,10,5,0,0,0,0,0,0,True,False,False,0,3,2021-01-18T12:10:06.273,0,,
2020,19,3057,150,16,7176,2,34,4,-3,42,45,37,5,37,0,True,False,False,1,4,2021-03-04T20:00:29.84,42,,
2020,19,3057,160,16,7176,2,45,5,-4,9,13,9,0,9,0,True,False,False,0,4,2021-01-18T12:14:45.723,9,,
2020,19,3057,165,16,6500,2,4,9,7,11,4,9,2,9,0,False,False,False,0,3,2021-01-18T12:17:11.187,11,,
2020,19,3057,185,16,374,2,26,9,7,20,13,18,2,18,6,False,False,False,0,3,2021-01-18T12:24:13.973,20,,
2020,19,3057,205,8,232,2,12,3,6,7,1,7,0,7,0,False,False,False,0,3,2021-01-18T12:30:01.713,7,,
2020,19,3057,215,8,7651,2,9,2,21,23,2,23,0,23,0,False,False,False,0,2,2021-01-18T12:35:00.337,23,,
2020,19,3057,220,8,232,2,6,7,17,17,0,17,0,17,0,False,False,False,0,3,2021-01-18T12:36:58.257,17,,
2020,19,3057,225,8,6439,3,4,5,3,0,0,0,0,0,0,True,False,False,0,3,2021-01-18T12:39:06.497,0,,
2020,19,3057,230,8,6439,3,48,4,-2,0,0,0,0,0,0,False,False,False,0,1,2021-01-18T12:41:05.88,0,,
2020,19,3057,235,8,5217,2,12,4,-9,-8,1,-8,0,-8,0,False,False,False,0,6,2021-01-18T12:43:54.92,-8,,
2020,19,3057,250,16,3938,2,4,3,3,8,5,7,1,7,0,True,False,False,0,2,2021-01-18T12:48:50.44,8,,
2020,19,3057,255,16,374,2,35,10,13,14,1,14,0,14,0,True,False,False,0,3,2021-01-18T12:50:22.237,14,,
2020,19,3057,260,16,7176,2,4,3,3,8,5,7,1,7,0,False,False,False,0,2,2021-01-18T12:51:53.93,8,,
2020,19,3057,275,16,374,13,5,3,4,0,0,0,0,0,0,False,False,False,0,3,2021-01-18T12:59:02.743,0,,
2020,19,3057,280,16,3938,2,5,5,8,11,3,11,0,11,0,False,False,False,1,3,2021-03-02T22:06:47.683,11,,
2020,19,3057,285,16,3938,2,4,4,13,15,2,13,2,13,0,True,False,False,0,3,2021-01-18T13:04:01.167,15,,
2020,19,3057,295,16,6500,13,5,3,5,0,0,0,0,0,0,True,False,False,0,2,2021-01-18T13:06:19.753,0,,
2020,19,3057,300,16,3938,13,24,6,23,0,0,0,0,0,0,False,False,False,0,3,2021-01-18T13:07:49.78,0,,
2020,19,3057,310,16,6499,2,48,9,-6,-5,1,-5,0,-5,0,False,False,False,0,1,2021-01-18T13:09:33.737,-5,,
2020,19,3057,330,8,4976,13,12,4,8,0,0,0,0,0,0,False,False,False,0,4,2021-01-19T22:11:24.077,0,,
2020,19,3057,335,8,6439,2,51,3,-5,0,5,0,0,0,0,False,False,False,0,1,2021-01-18T13:20:47.347,0,,
2020,19,3057,340,8,7651,13,19,2,23,0,0,0,0,0,0,False,False,False,0,2,2021-01-18T13:23:20.833,0,,
2020,19,3057,345,8,4976,2,17,8,22,26,4,22,4,22,0,False,False,False,1,3,2021-01-18T13:25:16.91,26,,
2020,19,3057,355,8,5053,13,16,10,5,0,0,0,0,0,0,True,False,False,0,1,2021-01-18T13:26:40.323,0,,
2020,19,3057,360,8,4976,13,4,9,3,0,0,0,0,0,0,False,False,False,0,3,2021-01-18T13:28:35.393,0,,
2020,19,3057,365,8,3606,2,5,2,17,23,6,18,5,18,0,False,False,False,0,3,2021-01-18T13:30:37.317,23,,
2020,19,3057,370,8,3606,2,9,2,21,25,4,25,0,25,0,False,True,True,0,2,2021-01-19T21:34:39.553,25,,
2020,19,3057,375,16,374,2,4,9,6,9,3,9,0,9,0,True,False,False,0,3,2021-01-18T13:36:15.307,9,,
2020,19,3057,380,16,6499,2,46,3,0,7,7,7,0,7,0,False,False,False,0,1,2021-01-18T13:37:24.42,7,,
2020,19,3057,385,16,3938,3,13,4,3,0,0,0,0,0,0,True,False,False,0,3,2021-01-18T13:39:12.14,0,,
2020,19,3057,390,16,6500,2,32,10,-1,3,4,1,2,1,0,False,False,False,0,3,2021-01-18T13:41:15.127,3,,
2020,19,3057,395,16,3938,2,4,9,11,13,2,11,2,11,0,False,False,False,0,4,2021-01-18T13:42:32.407,13,,
2020,19,3057,405,16,374,2,12,9,14,22,8,20,2,20,0,False,False,False,0,3,2021-01-18T13:44:52.04,22,,
2020,19,3057,415,16,3938,2,12,10,7,16,9,14,2,14,0,False,False,False,0,2,2021-01-19T22:49:46.053,16,,
2020,19,3057,440,8,3606,13,2,9,7,0,0,0,0,0,0,False,False,False,0,2,2021-01-18T13:55:09.957,0,,
2020,19,3057,445,8,6439,13,48,10,0,0,0,0,0,0,0,False,False,False,0,1,2021-01-18T13:56:24.09,0,,
2020,19,3057,450,8,232,13,12,10,11,0,0,0,0,0,0,False,False,False,0,3,2021-01-18T14:15:05.78,0,,
2020,19,3057,460,16,34,13,11,5,13,0,0,0,0,0,0,True,False,False,0,1,2021-01-18T14:06:34.813,0,,
2020,19,3057,465,16,374,13,12,5,10,0,0,0,0,0,0,False,False,False,0,3,2021-04-02T14:06:47.337,0,,
2020,19,3057,490,8,3606,2,2,9,14,18,4,15,3,15,0,False,False,False,0,2,2021-01-18T14:16:57.603,18,,
2020,19,3057,500,8,232,2,31,10,0,0,0,0,0,0,0,True,False,False,0,4,2021-01-18T14:19:38.83,0,,
2020,19,3057,510,8,232,2,5,5,4,4,0,4,0,4,6,True,False,False,0,4,2021-01-18T14:22:01.94,4,,
2020,19,3057,525,16,374,13,12,3,6,0,0,0,0,0,0,True,False,False,0,4,2021-01-18T14:26:40.657,0,,
2020,19,3057,530,16,4143,2,29,5,14,14,0,14,0,14,0,False,False,False,0,2,2021-01-18T14:28:25.047,14,,
2020,19,3057,535,16,374,2,39,4,5,8,3,6,2,6,0,False,False,False,0,3,2021-01-18T14:29:18.123,8,,
2020,19,3057,565,16,4143,13,6,3,4,0,0,0,0,0,0,False,False,False,0,2,2021-01-19T21:34:39.553,0,,
2020,19,3057,570,16,374,2,2,9,5,5,0,5,0,5,0,False,False,False,0,3,2021-01-18T14:41:56.633,5,,
2020,19,3057,595,8,4976,2,26,9,2,2,0,2,0,2,0,False,False,False,0,3,2021-01-18T14:54:09.503,2,,
2020,19,3057,615,8,232,2,13,9,2,6,4,3,3,3,0,False,False,False,0,3,2021-01-18T15:00:53.117,6,,
2020,19,3057,620,8,3606,2,35,9,12,17,5,15,2,15,0,False,False,False,0,3,2021-01-18T15:03:21.957,17,,
2020,19,3057,640,8,4976,2,5,9,2,4,2,2,2,2,0,False,False,False,0,4,2021-01-18T15:09:31.353,4,,
2020,19,3057,655,8,232,3,4,9,5,0,0,0,0,0,0,False,False,False,0,3,2021-01-18T15:13:44.65,0,,
2020,19,3057,660,8,232,2,2,9,2,3,1,3,0,3,0,False,False,False,0,2,2021-01-18T15:15:22.24,3,,
2020,19,3057,665,8,3883,2,13,10,4,5,1,5,0,5,0,False,False,False,0,4,2021-01-18T15:17:05.217,5,,
2020,19,3057,675,8,3606,13,7,3,3,0,0,0,0,0,0,False,False,False,0,3,2021-01-18T15:22:02.72,0,,
2020,19,3057,695,16,3938,2,9,2,16,23,7,18,5,18,0,False,False,False,0,3,2021-01-18T15:26:54.223,23,,
2020,19,3057,715,16,374,2,4,10,8,24,16,21,3,21,0,False,False,False,0,2,2021-01-18T15:31:23.92,24,,
2020,19,3057,725,16,4143,13,8,8,38,0,0,0,0,0,0,False,False,False,0,2,2021-01-18T16:06:43.813,0,,
2020,19,3057,730,8,6439,2,45,10,-6,4,10,0,4,0,0,False,False,False,1,1,2021-01-18T15:37:05.47,4,,
2020,19,3057,740,8,3606,2,26,9,0,5,5,2,3,2,0,False,False,False,1,3,2021-01-18T15:39:49.867,5,,
2020,19,3057,765,8,5053,2,45,5,-5,2,7,2,0,2,0,False,False,False,0,1,2021-01-18T15:45:23.69,2,,
2020,19,3057,780,16,3938,2,5,5,4,4,0,4,0,4,0,False,False,False,0,3,2021-01-18T15:49:18.2,4,,
2020,19,3057,785,16,6499,2,44,9,-5,5,10,3,2,3,0,False,False,False,0,1,2021-01-18T15:51:23,5,,
2020,19,3057,815,16,3938,2,47,5,-1,5,6,5,0,5,0,False,False,False,0,3,2021-01-18T15:57:57.89,5,,
2020,19,3058,15,30,2290,2,5,3,5,5,0,5,0,5,0,False,False,False,0,3,2021-01-18T12:36:25.053,5,,
2020,19,3058,20,30,63,13,19,6,28,0,0,0,0,0,0,True,False,False,0,3,2021-01-18T12:39:23.517,0,,
2020,19,3058,35,20,213,2,4,10,7,7,0,7,0,7,0,True,False,False,0,3,2021-01-18T12:42:17.66,7,,
2020,19,3058,40,20,8131,13,18,3,3,0,0,0,0,0,0,False,False,False,0,2,2021-03-08T16:07:25.573,0,,
2020,19,3058,50,20,3763,13,29,5,5,0,0,0,0,0,0,False,False,False,0,2,2021-01-18T12:47:40.297,0,,
2020,19,3058,70,30,2290,13,6,4,12,0,0,0,0,0,0,False,False,False,0,3,2021-01-18T12:51:51.25,0,,
2020,19,3058,85,20,213,13,17,8,19,0,0,0,0,0,0,False,False,False,0,3,2021-01-18T12:56:56.553,0,,
2020,19,3058,90,20,7353,2,44,3,-4,-1,3,-1,0,-1,0,True,False,False,1,3,2021-01-19T19:19:47.28,-1,,
2020,19,3058,95,20,6388,2,6,4,13,13,0,13,0,13,0,False,False,False,0,3,2021-01-18T13:00:09.3,13,,
2020,19,3058,115,20,958,2,4,9,4,4,0,4,0,4,0,False,False,False,0,4,2021-01-18T13:04:24.897,4,,
2020,19,3058,130,20,958,13,8,7,16,0,0,0,0,0,0,True,False,False,0,2,2021-01-18T13:08:54.323,0,,
2020,19,3058,140,20,568,13,28,9,0,0,0,0,0,0,0,False,False,False,0,1,2021-01-18T13:10:50.523,0,,
2020,19,3058,155,30,6414,13,46,9,3,0,0,0,0,0,0,False,False,False,0,1,2021-01-18T13:12:44.387,0,,
2020,19,3058,185,30,793,13,8,7,46,0,0,0,0,0,0,False,False,False,0,2,2021-01-18T13:19:47.103,0,,
2020,19,3058,190,30,37,3,51,10,-8,0,0,0,0,0,0,True,False,False,0,3,2021-01-18T13:21:01.667,0,,
2020,19,3058,200,30,4516,2,50,9,-2,11,13,2,9,2,0,False,False,False,1,3,2021-01-18T13:23:32.483,11,,
2020,19,3058,215,30,2290,2,6,7,16,16,0,16,0,16,0,True,False,False,0,3,2021-01-19T18:31:04.613,16,,
2020,19,3058,230,30,63,13,2,10,5,0,0,0,0,0,0,False,False,False,0,2,2021-01-18T13:30:57.303,0,,
2020,19,3058,260,20,3763,13,47,5,2,0,0,0,0,0,0,False,False,False,0,3,2021-03-05T14:42:59.797,0,,
2020,19,3058,265,30,793,2,17,9,3,3,0,3,0,3,6,False,False,False,0,2,2021-01-18T13:40:50.997,3,,
2020,19,3058,280,20,3763,13,13,9,5,0,0,0,0,0,0,False,False,False,0,3,2021-01-19T17:30:10.743,0,,
2020,19,3058,285,20,958,2,4,10,4,4,0,4,0,4,0,False,False,False,0,3,2021-01-18T13:44:16.53,4,,
2020,19,3058,300,20,5140,2,4,10,2,4,2,4,0,4,0,False,False,False,0,1,2021-01-18T13:49:41.663,4,,
2020,19,3058,310,20,6388,2,33,8,28,56,28,56,0,56,6,False,False,False,0,3,2021-01-19T19:27:45.147,56,,
2020,19,3058,335,30,37,13,19,2,28,0,0,0,0,0,0,False,False,False,0,2,2021-01-18T13:59:31.843,0,,
2020,19,3058,350,20,213,2,39,10,5,10,5,6,4,6,0,False,False,False,0,3,2021-01-18T14:04:37.6,10,,
2020,19,3058,355,20,213,2,5,6,16,16,0,16,0,16,0,True,False,False,0,3,2021-01-18T14:06:53.07,16,,
2020,19,3058,365,20,1162,2,53,10,-7,-3,4,-3,0,-3,0,True,False,False,0,4,2021-01-18T14:09:52.597,-3,,
2020,19,3058,370,20,5140,2,48,10,-7,9,16,-5,14,-5,0,False,False,False,2,1,2021-01-19T19:20:00.223,9,,
2020,19,3058,390,30,4937,3,47,5,0,0,0,0,0,0,0,False,False,False,0,1,2021-01-18T14:14:34.227,0,,
2020,19,3058,400,30,4937,2,46,9,0,8,8,7,1,7,0,False,False,False,0,1,2021-01-18T14:16:26.09,8,,
2020,19,3058,405,30,4516,2,6,4,5,8,3,7,1,7,0,False,False,False,0,3,2021-01-18T14:17:40.707,8,,
2020,19,3058,410,30,4937,2,48,9,-5,14,19,6,8,6,0,False,False,False,0,1,2021-01-18T14:19:03.303,14,,
2020,19,3058,415,30,4516,13,9,8,19,0,0,0,0,0,0,False,False,False,0,3,2021-01-19T18:31:04.63,0,,
2020,19,3058,420,30,4937,2,28,4,3,8,5,6,2,6,0,False,False,False,0,1,2021-01-18T14:21:59.583,8,,
2020,19,3058,435,30,37,2,3,5,10,10,0,10,0,10,0,False,False,False,0,2,2021-01-18T14:24:48.943,10,,
2020,19,3058,450,30,63,13,2,4,9,0,0,0,0,0,0,False,False,False,0,3,2021-01-18T14:26:21.037,0,,
2020,19,3058,455,30,4516,13,8,1,29,0,0,0,0,0,0,False,False,False,0,3,2021-01-18T14:27:54.147,0,,
2020,19,3058,460,30,2290,2,5,5,9,10,1,10,0,10,0,False,False,False,0,3,2021-01-18T14:29:41.56,10,,
2020,19,3058,485,20,5140,2,4,10,4,7,3,6,1,6,0,False,False,False,0,1,2021-01-18T14:34:27.72,7,,
2020,19,3058,520,20,2408,2,16,10,6,13,7,10,3,10,0,False,False,False,0,1,2021-01-19T17:28:34.74,13,,
2020,19,3058,525,20,3763,13,13,10,3,0,0,0,0,0,0,False,False,False,0,3,2021-01-19T18:48:36.163,0,,
2020,19,3058,530,20,6388,2,29,2,15,16,1,15,1,15,6,False,False,False,0,3,2021-01-18T14:50:42.53,16,,
2020,19,3058,550,30,4937,2,47,5,0,8,8,4,4,4,0,False,False,False,0,1,2021-01-18T14:53:42.783,8,,
2020,19,3058,560,30,4516,2,51,9,-2,2,4,1,1,1,0,False,False,False,0,3,2021-01-18T14:58:21.927,2,,
2020,19,3058,565,30,4516,13,2,4,13,0,0,0,0,0,0,True,False,False,0,3,2021-01-18T14:59:55.83,0,,
2020,19,3058,575,20,213,2,30,10,-3,0,3,0,0,0,0,False,False,False,0,4,2021-01-18T15:03:51.49,0,,
2020,19,3058,585,20,6388,13,17,7,22,0,0,0,0,0,0,False,False,False,0,3,2021-01-18T15:06:57.54,0,,
2020,19,3058,590,20,213,13,6,7,16,0,0,0,0,0,0,True,False,False,0,3,2021-01-18T15:09:33.857,0,,
2020,19,3058,595,20,213,2,2,9,7,8,1,8,0,8,0,False,False,False,0,2,2021-01-19T19:30:30.66,8,,
2020,19,3058,600,20,958,2,2,10,3,8,5,7,1,7,0,False,True,True,0,2,2021-01-18T15:13:55.59,8,,
2020,19,3058,605,30,2290,2,35,10,11,19,8,16,3,16,0,False,False,False,0,4,2021-01-18T15:21:22.807,19,,
2020,19,3058,620,30,793,13,35,10,6,0,0,0,0,0,0,False,False,False,0,2,2021-01-19T20:55:15.063,0,,
2020,19,3058,625,30,4937,2,6,4,4,6,2,6,0,6,6,False,False,False,0,1,2021-01-18T15:26:36.633,6,,
2020,19,3058,640,20,8131,13,13,10,2,0,0,0,0,0,0,False,False,False,0,3,2021-01-18T15:28:50.52,0,,
2020,19,3058,645,20,958,2,39,4,5,6,1,5,1,5,0,False,False,False,0,3,2021-01-18T15:30:00.167,6,,
2020,19,3058,650,20,3763,13,29,3,10,0,0,0,0,0,0,False,False,False,0,3,2021-01-18T15:31:16.763,0,,
2020,19,3058,660,20,213,13,2,4,6,0,0,0,0,0,0,False,False,False,0,3,2021-01-18T15:33:57.917,0,,
2020,19,3058,665,20,5140,13,26,9,2,0,0,0,0,0,0,False,False,False,0,3,2021-01-18T15:36:18.033,0,,
2020,19,3058,695,30,7893,2,29,5,13,15,2,15,0,15,0,False,False,False,0,2,2021-01-18T15:43:15.29,15,,
2020,19,3058,710,30,7268,2,21,2,25,29,4,29,0,29,0,True,False,False,0,3,2021-01-18T15:48:27.187,29,,
2020,19,3058,730,30,63,13,7,6,18,0,0,0,0,0,0,False,False,False,0,3,2021-01-18T15:53:01.4,0,,
2020,19,3058,735,30,7268,13,5,5,7,0,0,0,0,0,0,False,False,False,0,3,2021-01-18T15:54:04.683,0,,
2020,19,3058,760,20,213,2,13,9,1,7,6,4,3,4,0,True,False,False,0,3,2021-01-18T15:58:48.91,7,,
2020,19,3058,770,20,5140,13,17,10,10,0,0,0,0,0,0,False,False,False,0,1,2021-01-18T16:03:34.143,0,,
2020,19,3058,780,30,63,2,5,3,7,14,7,9,5,9,0,False,False,False,0,4,2021-01-18T16:05:48.367,14,,
2020,19,3058,805,20,5140,13,16,4,2,0,0,0,0,0,0,False,False,False,0,1,2021-01-18T16:09:53.883,0,,
2020,19,3058,810,20,958,2,47,5,1,6,5,6,0,6,0,False,False,False,0,3,2021-01-18T16:10:47.043,6,,
2020,19,3058,820,20,958,13,24,2,18,0,0,0,0,0,0,False,False,False,0,3,2021-03-05T14:44:02.717,0,,
2020,19,3058,845,30,4516,2,50,9,0,13,13,12,1,12,0,False,False,False,0,2,2021-01-18T16:17:26.693,13,,
2020,20,3059,20,30,793,2,9,6,24,27,3,25,2,25,0,False,False,False,0,3,2021-01-25T14:22:34.57,27,,
2020,20,3059,30,30,4937,3,45,10,-5,0,0,0,0,0,0,False,False,False,0,1,2021-01-25T14:24:45.93,0,,
2020,20,3059,35,30,4516,2,5,5,10,14,4,14,0,14,0,False,False,False,0,3,2021-01-25T14:26:05.74,14,,
2020,20,3059,45,30,4937,13,5,5,2,0,0,0,0,0,0,False,False,False,0,1,2021-01-25T14:28:31.23,0,,
2020,20,3059,50,30,793,2,7,6,15,15,0,15,0,15,6,False,False,False,0,2,2021-01-25T14:29:39.63,15,,
2020,20,3059,70,12,467,2,36,10,12,14,2,14,0,14,0,False,False,False,0,4,2021-01-25T14:33:07.19,14,,
2020,20,3059,80,12,4537,2,47,10,-2,0,2,-2,2,-2,0,False,False,False,1,1,2021-01-25T14:35:49.72,0,,
2020,20,3059,100,30,2290,2,4,3,5,5,0,5,0,5,0,False,False,False,0,2,2021-01-25T14:41:50.88,5,,
2020,20,3059,115,30,7268,2,51,9,-7,-3,4,-5,2,-5,0,False,False,False,0,4,2021-01-26T20:49:15.333,-3,,
2020,20,3059,120,30,4516,2,50,10,1,14,13,12,2,12,0,False,False,False,1,3,2021-01-25T14:46:35.09,14,,
2020,20,3059,125,30,4516,13,24,2,17,0,0,0,0,0,0,True,False,False,0,2,2021-01-26T20:15:25.297,0,,
2020,20,3059,130,30,7893,3,17,8,18,0,0,0,0,0,0,False,False,False,0,3,2021-01-25T14:50:05.56,0,,
2020,20,3059,145,12,4511,2,51,9,-3,2,5,-1,3,-1,0,True,False,False,0,3,2021-01-25T14:53:29.46,2,,
2020,20,3059,155,12,6691,2,12,2,23,23,0,23,0,23,0,False,False,False,0,3,2021-01-25T14:55:43.35,23,,
2020,20,3059,160,12,556,2,44,9,-1,15,16,2,13,2,0,False,False,False,1,3,2021-01-26T19:44:32.863,15,,
2020,20,3059,165,12,4511,2,32,3,0,5,5,4,1,4,0,False,False,False,0,4,2021-01-25T14:58:55.74,5,,
2020,20,3059,180,12,6357,2,19,2,30,50,20,30,20,30,6,False,False,False,0,2,2021-01-25T15:02:20.387,50,,
2020,20,3059,200,30,4516,3,2,10,9,0,0,0,0,0,0,False,False,False,0,3,2021-01-25T15:05:45.227,0,,
2020,20,3059,205,30,4516,2,17,1,47,52,5,52,0,52,0,True,False,False,0,3,2021-01-25T15:07:28.877,52,,
2020,20,3059,225,12,4537,13,12,10,4,0,0,0,0,0,0,False,False,False,0,1,2021-01-26T20:15:57.15,0,,
2020,20,3059,230,12,6357,2,2,9,10,12,2,11,1,11,0,False,False,False,0,3,2021-01-25T15:13:24.287,12,,
2020,20,3059,235,12,556,2,51,3,1,4,3,4,0,4,0,False,False,False,0,3,2021-01-25T15:14:55.68,4,,
2020,20,3059,245,12,556,2,4,9,5,5,0,5,0,5,0,False,False,False,0,3,2021-01-25T15:17:16.467,5,,
2020,20,3059,255,12,467,2,53,10,-3,9,12,6,3,6,0,False,False,False,0,4,2021-01-25T15:19:42.497,9,,
2020,20,3059,260,12,4537,2,51,3,-4,5,9,5,0,5,0,True,True,False,0,1,2021-01-25T15:21:02.673,3,,
2020,20,3059,285,12,556,3,29,3,6,0,0,0,0,0,0,False,False,False,0,2,2021-01-25T15:40:07.283,0,,
2020,20,3059,290,12,556,13,47,5,2,0,0,0,0,0,0,False,False,False,0,3,2021-01-25T15:41:45.74,0,,
2020,20,3059,295,12,556,13,20,4,6,0,0,0,0,0,0,False,False,False,0,3,2021-01-25T15:43:05.373,0,,
2020,20,3059,310,30,4937,2,48,9,-2,7,9,6,1,6,0,False,False,False,0,1,2021-01-25T15:45:44.47,7,,
2020,20,3059,320,30,4516,2,32,5,10,19,9,16,3,16,0,True,False,False,0,4,2021-01-25T15:55:52.403,19,,
2020,20,3059,325,30,7268,13,49,9,-3,0,0,0,0,0,0,False,False,False,0,2,2021-01-25T15:56:55.403,0,,
2020,20,3059,330,30,4937,2,47,5,0,1,1,1,0,1,0,False,False,False,0,1,2021-01-25T15:57:49.203,1,,
2020,20,3059,335,30,2290,13,5,5,6,0,0,0,0,0,0,False,False,False,0,3,2021-01-25T15:59:30.63,0,,
2020,20,3059,355,12,4561,2,31,4,-3,4,7,3,1,3,0,False,False,False,0,1,2021-01-25T16:02:24.317,4,,
2020,20,3059,360,12,6691,2,39,4,8,23,15,14,9,14,0,True,False,False,1,3,2021-01-26T20:49:51.643,23,,
2020,20,3059,375,12,6691,13,8,7,16,0,0,0,0,0,0,False,False,False,0,3,2021-01-25T16:05:39.207,0,,
2020,20,3059,380,30,4937,2,47,10,0,6,6,5,1,5,0,False,False,False,0,1,2021-01-25T16:07:03.713,6,,
2020,20,3059,385,30,793,13,4,5,8,0,0,0,0,0,0,False,False,False,0,2,2021-01-25T16:08:01.447,0,,
2020,20,3059,390,30,2290,13,24,2,25,0,0,0,0,0,0,False,False,False,0,3,2021-01-25T16:09:44.957,0,,
2020,20,3059,405,30,4937,2,5,5,3,6,3,4,2,4,0,False,False,False,0,1,2021-01-26T20:15:25.297,6,,
2020,20,3059,415,30,7268,2,19,6,39,39,0,39,0,39,6,False,False,False,0,3,2021-01-25T16:12:55.287,39,,
2020,20,3059,440,12,4537,2,4,10,2,5,3,3,2,3,0,True,False,False,1,1,2021-01-26T19:46:24.333,5,,
2020,20,3059,445,12,4537,3,4,10,1,0,0,0,0,0,0,False,False,False,0,1,2021-01-25T16:22:23.193,0,,
2020,20,3059,450,12,4537,2,13,9,1,2,1,2,0,2,0,False,True,True,0,3,2021-01-25T16:24:26.26,-1,,
2020,20,3059,455,30,2290,2,17,10,8,8,0,8,0,8,6,True,False,False,0,4,2021-01-26T20:48:24.537,8,,
2020,20,3059,480,12,556,2,2,4,5,10,5,7,3,7,0,False,False,False,0,3,2021-01-25T16:49:33.927,10,,
2020,20,3059,485,12,6357,2,9,2,17,24,7,22,2,22,0,False,False,False,0,3,2021-01-25T16:50:51.057,24,,
2020,20,3059,490,12,6356,2,4,9,5,10,5,8,2,8,0,False,False,False,0,3,2021-01-25T16:52:06.397,10,,
2020,20,3059,500,12,6691,2,12,10,8,16,8,13,3,13,0,False,False,False,0,3,2021-01-25T16:56:18.407,16,,
2020,20,3059,505,12,4511,2,4,10,8,8,0,8,0,8,6,False,False,False,0,4,2021-01-25T16:57:36.027,8,,
2020,20,3059,530,30,4516,13,7,2,35,0,0,0,0,0,0,False,False,False,0,3,2021-01-25T17:04:26.853,0,,
2020,20,3059,535,30,793,13,9,2,30,0,0,0,0,0,0,False,False,False,0,3,2021-01-25T17:07:00.103,0,,
2020,20,3059,540,12,8279,13,11,2,27,0,0,0,0,0,0,False,False,False,0,4,2021-01-25T17:16:14.753,0,,
2020,20,3059,545,12,4561,2,51,4,-5,2,7,0,2,0,0,False,False,False,0,1,2021-01-25T17:17:34.517,2,,
2020,20,3059,550,12,556,2,51,3,0,4,4,4,0,4,0,False,False,False,0,3,2021-01-25T17:24:28.547,4,,
2020,20,3059,555,12,7742,2,47,5,2,13,11,8,5,8,0,False,False,False,0,1,2021-01-26T20:50:21.6,13,,
2020,20,3059,565,12,4511,2,32,3,2,7,5,5,2,5,0,False,False,False,0,4,2021-01-25T17:29:38.307,7,,
2020,20,3059,570,12,467,2,32,10,2,5,3,5,0,5,0,False,False,False,0,4,2021-01-25T17:30:57.087,5,,
2020,20,3059,580,12,4561,2,11,5,1,11,10,7,4,7,0,False,False,False,0,1,2021-01-26T19:46:00.503,11,,
2020,20,3059,590,12,556,2,5,5,5,7,2,7,0,7,0,False,False,False,0,3,2021-01-25T17:36:59.703,7,,
2020,20,3059,605,12,556,2,2,10,2,2,0,2,0,2,6,False,False,False,0,2,2021-01-25T17:41:59.083,2,,
2020,20,3059,630,30,793,3,19,2,30,0,0,0,0,0,0,False,False,False,0,2,2021-01-25T17:45:54.75,0,,
2020,20,3059,635,30,7893,2,6,1,16,16,0,16,0,16,0,True,False,False,0,3,2021-01-26T17:23:45.433,16,,
2020,20,3059,650,30,4937,2,51,5,-6,-1,5,-2,1,-2,0,False,False,False,0,1,2021-01-25T17:56:44.86,-1,,
2020,20,3059,655,30,793,3,35,8,25,0,0,0,0,0,0,False,False,False,0,2,2021-01-25T17:58:20.15,0,,
2020,20,3059,660,12,556,13,23,7,41,0,0,0,0,0,0,False,False,False,0,3,2021-01-26T20:15:25.297,0,,
2020,20,3059,665,12,4561,2,46,9,-1,5,6,5,0,5,0,True,False,False,0,1,2021-01-25T18:02:40.147,5,,
2020,20,3059,685,30,2290,2,4,9,5,6,1,6,0,6,0,False,False,False,0,4,2021-01-25T18:06:24.677,6,,
2020,20,3059,690,30,793,13,19,2,30,0,0,0,0,0,0,False,False,False,0,2,2021-01-25T18:07:42.267,0,,
2020,20,3059,700,12,6357,13,19,2,31,0,0,0,0,0,0,False,False,False,0,2,2021-01-25T18:10:05.617,0,,
2020,20,3059,705,12,6691,3,2,9,10,0,0,0,0,0,0,False,False,False,0,3,2021-01-25T18:12:23.93,0,,
2020,20,3059,720,30,4516,2,13,10,6,11,5,8,3,8,0,False,False,False,0,3,2021-01-25T18:15:55.33,11,,
2020,20,3059,730,30,63,2,53,10,-5,29,34,9,20,9,0,False,False,False,0,4,2021-01-25T18:18:23.05,29,,
2020,20,3059,740,30,4516,13,5,3,8,0,0,0,0,0,0,True,False,False,0,4,2021-01-25T18:22:46.183,0,,
2020,20,3059,765,12,6357,2,17,1,19,29,10,22,7,22,0,False,False,False,1,3,2021-01-26T20:50:33.637,29,,
2020,20,3059,770,12,6357,13,9,6,24,0,0,0,0,0,0,False,False,False,0,2,2021-01-25T18:28:55.88,0,,
2020,20,3059,775,12,556,2,2,4,5,9,4,9,0,9,0,False,False,False,0,3,2021-01-25T18:29:50.67,9,,
2020,20,3059,780,12,556,2,5,3,4,11,7,6,5,6,0,True,False,False,0,3,2021-01-26T20:59:54.937,11,,
2020,20,3059,785,12,6691,13,2,10,5,0,0,0,0,0,0,False,False,False,0,3,2021-01-25T18:32:28.45,0,,
2020,20,3059,790,12,556,13,2,4,8,0,0,0,0,0,0,False,False,False,0,3,2021-01-25T18:33:37.93,0,,
2020,20,3059,795,12,556,13,20,4,8,0,0,0,0,0,0,False,False,False,0,3,2021-01-25T18:34:55.53,0,,
2020,20,3059,810,30,793,2,26,9,4,9,5,5,4,5,0,False,False,False,0,2,2021-01-25T18:37:07.86,9,,
2020,20,3059,845,30,7893,13,35,9,11,0,0,0,0,0,0,False,False,False,0,3,2021-01-25T18:42:18.197,0,,
2020,20,3060,15,4,594,2,2,4,11,17,6,17,0,17,0,False,False,False,0,3,2021-01-25T16:50:39.13,17,,
2020,20,3060,25,4,594,13,5,3,7,0,0,0,0,0,0,False,False,False,0,3,2021-01-25T12:40:16.557,0,,
2020,20,3060,30,4,2853,2,26,5,3,6,3,6,0,6,0,False,False,False,0,3,2021-01-26T22:25:48.73,6,,
2020,20,3060,35,4,6953,2,32,5,0,8,8,8,0,8,0,False,False,False,0,4,2021-01-25T12:43:14.967,8,,
2020,20,3060,40,4,2251,2,51,9,-4,7,11,5,2,5,0,False,False,False,0,1,2021-01-25T12:44:27.35,7,,
2020,20,3060,50,4,594,13,12,5,13,0,0,0,0,0,0,False,False,False,0,3,2021-01-25T12:47:53.423,0,,
2020,20,3060,65,16,374,2,46,9,0,1,1,1,0,1,0,False,False,False,0,4,2021-01-25T12:51:06.033,1,,
2020,20,3060,75,16,3938,3,7,6,30,0,0,0,0,0,0,False,False,False,0,3,2021-01-25T12:54:06.257,0,,
2020,20,3060,85,4,2853,13,6,10,14,0,0,0,0,0,0,False,False,False,0,2,2021-01-26T17:51:28.283,0,,
2020,20,3060,120,4,6953,2,30,3,0,3,3,3,0,3,6,True,False,False,0,4,2021-01-25T13:05:38.33,3,,
2020,20,3060,135,16,374,2,12,5,10,9,-1,10,-1,10,0,False,False,False,0,3,2021-01-25T13:08:49.457,9,,
2020,20,3060,140,16,7176,2,50,5,-1,1,2,1,0,1,0,False,False,False,0,2,2021-01-25T13:12:24.287,1,,
2020,20,3060,145,16,374,2,32,10,1,11,10,9,2,9,0,False,False,False,1,4,2021-03-02T22:18:11.747,11,,
2020,20,3060,150,16,374,3,4,9,4,0,0,0,0,0,0,False,False,False,0,3,2021-01-25T13:13:44.78,0,,
2020,20,3060,155,16,3938,2,2,9,9,11,2,11,0,11,0,False,False,False,0,3,2021-01-25T13:15:22.407,11,,
2020,20,3060,160,16,374,2,35,7,16,16,0,16,0,16,0,False,False,False,0,3,2021-01-25T16:55:48.987,16,,
2020,20,3060,170,16,7681,13,12,10,7,0,0,0,0,0,0,True,False,False,0,2,2021-01-26T17:52:23.627,0,,
2020,20,3060,175,16,6500,2,4,10,11,11,0,11,0,11,0,False,False,False,0,2,2021-01-25T13:23:28.693,11,,
2020,20,3060,185,16,6499,2,47,5,0,9,9,7,2,7,0,False,False,False,0,1,2021-01-25T13:25:18.513,9,,
2020,20,3060,190,16,3938,2,12,10,8,8,0,8,0,8,0,False,False,False,0,2,2021-01-25T13:27:38.28,8,,
2020,20,3060,200,16,374,2,55,4,-2,3,5,2,1,2,0,False,False,False,0,4,2021-01-25T13:29:12.793,3,,
2020,20,3060,205,16,374,13,5,3,3,0,0,0,0,0,0,False,False,False,0,3,2021-01-25T13:30:35.73,0,,
2020,20,3060,210,16,7176,2,49,3,-2,3,5,1,2,1,6,False,False,False,0,3,2021-01-25T13:32:46.187,3,,
2020,20,3060,225,4,6983,2,46,3,1,2,1,2,0,2,0,True,False,False,0,1,2021-01-25T13:35:22.513,2,,
2020,20,3060,230,4,2853,2,4,3,6,6,0,6,0,6,0,False,False,False,0,2,2021-01-25T13:37:07.147,6,,
2020,20,3060,240,4,6983,3,45,5,-2,0,0,0,0,0,0,False,False,False,0,1,2021-01-26T17:51:41.687,0,,
2020,20,3060,260,16,6500,2,4,10,3,5,2,5,0,5,0,False,False,False,0,3,2021-01-25T13:45:09.86,5,,
2020,20,3060,270,16,374,2,12,10,10,15,5,15,0,15,0,False,False,False,0,4,2021-01-25T13:48:03.513,15,,
2020,20,3060,290,4,1412,13,19,2,17,0,0,0,0,0,0,False,False,False,0,2,2021-01-26T17:55:15.557,0,,
2020,20,3060,300,4,2853,13,4,5,3,0,0,0,0,0,0,False,False,False,0,2,2021-01-25T13:54:50,0,,
2020,20,3060,310,16,6500,13,4,5,7,0,0,0,0,0,0,False,False,False,0,2,2021-01-25T13:58:57.83,0,,
2020,20,3060,315,16,374,2,5,10,8,9,1,9,0,9,0,True,False,False,0,3,2021-01-25T14:00:56.657,9,,
2020,20,3060,325,16,7182,13,12,5,3,0,0,0,0,0,0,False,False,False,0,4,2021-01-26T22:15:01.573,0,,
2020,20,3060,335,16,374,2,4,10,11,11,0,11,0,11,0,False,False,False,0,3,2021-01-25T14:06:02.923,11,,
2020,20,3060,340,16,3938,2,35,10,13,33,20,33,0,33,0,False,False,False,0,3,2021-01-25T14:07:55.15,33,,
2020,20,3060,345,16,374,2,46,3,0,17,17,14,3,14,0,False,False,False,0,4,2021-01-26T21:25:07.243,17,,
2020,20,3060,370,4,594,2,4,10,3,14,11,5,9,5,0,False,False,False,2,3,2021-03-02T22:18:31.343,14,,
2020,20,3060,375,4,2251,13,44,3,4,0,0,0,0,0,0,True,False,False,0,1,2021-01-25T14:15:15.47,0,,
2020,20,3060,380,4,6953,2,38,9,4,12,8,10,2,10,0,False,False,False,0,4,2021-01-25T14:16:34.173,12,,
2020,20,3060,385,4,2251,2,12,10,14,20,6,14,6,14,0,False,False,False,0,1,2021-01-25T14:19:01.917,20,,
2020,20,3060,405,4,6953,13,12,5,7,0,0,0,0,0,0,True,False,False,0,1,2021-01-25T14:22:13.403,0,,
2020,20,3060,410,4,1412,2,2,5,5,7,2,5,2,5,0,False,False,False,0,2,2021-01-25T14:22:59.183,7,,
2020,20,3060,440,4,6953,2,5,3,2,2,0,2,0,2,0,True,False,False,0,3,2021-01-26T17:55:38.183,2,,
2020,20,3060,470,16,3938,2,5,5,4,16,12,16,0,16,0,False,False,False,1,3,2021-01-25T14:40:14.137,16,,
2020,20,3060,475,16,3938,2,4,5,2,5,3,5,0,5,0,False,False,False,1,2,2021-01-25T14:43:01.707,5,,
2020,20,3060,480,16,6500,2,4,10,4,6,2,5,1,5,0,True,False,False,0,3,2021-01-25T14:44:15.26,6,,
2020,20,3060,490,16,374,2,5,3,6,8,2,6,2,6,0,False,False,False,1,3,2021-03-02T22:18:45.43,8,,
2020,20,3060,495,16,3938,2,4,3,5,9,4,7,2,7,0,True,False,False,0,2,2021-01-25T14:48:28.27,9,,
2020,20,3060,500,16,3938,2,34,4,-4,7,11,7,0,7,0,True,False,False,0,3,2021-01-26T22:19:02.163,7,,
2020,20,3060,505,16,6500,13,7,2,17,0,0,0,0,0,0,True,False,False,0,3,2021-01-25T14:52:10.393,0,,
2020,20,3060,510,16,7681,2,45,5,-2,0,2,0,0,0,0,False,False,False,0,1,2021-01-26T22:19:41.587,0,,
2020,20,3060,525,4,594,2,4,10,4,6,2,6,0,6,0,True,False,False,0,3,2021-01-26T17:52:58.027,6,,
2020,20,3060,535,4,1412,2,6,9,14,17,3,15,2,15,0,False,False,False,0,2,2021-01-25T15:06:54.02,17,,
2020,20,3060,540,4,594,2,13,10,6,23,17,23,0,23,0,False,False,False,1,2,2021-01-25T16:51:27.807,23,,
2020,20,3060,560,4,1412,13,12,5,11,0,0,0,0,0,0,False,False,False,0,2,2021-01-26T17:58:16.03,0,,
2020,20,3060,565,4,2251,2,51,5,-4,6,10,4,2,4,0,True,False,False,0,1,2021-01-25T15:15:46.473,6,,
2020,20,3060,575,4,2853,13,7,5,8,0,0,0,0,0,0,True,False,False,0,3,2021-01-26T22:26:23.48,0,,
2020,20,3060,595,16,3938,2,2,9,7,71,64,22,49,22,0,False,False,False,3,3,2021-03-02T22:18:58.393,71,,
2020,20,3060,605,16,7176,13,12,3,3,0,0,0,0,0,0,False,False,False,0,3,2021-01-25T15:28:25.117,0,,
2020,20,3060,610,16,374,2,55,4,-2,1,3,0,1,0,6,False,False,False,0,4,2021-01-26T21:25:07.243,1,,
2020,20,3060,625,4,2251,2,5,10,3,8,5,8,0,8,0,False,False,False,0,1,2021-01-25T15:33:45.843,8,,
2020,20,3060,630,4,2853,13,35,2,37,0,0,0,0,0,0,False,False,False,0,3,2021-01-25T15:35:30.49,0,,
2020,20,3060,635,4,2853,2,2,10,5,6,1,5,1,5,0,True,False,False,0,2,2021-01-26T17:53:12.703,6,,
2020,20,3060,640,4,2853,2,13,9,3,10,7,10,0,10,0,False,False,False,0,3,2021-01-25T15:38:11.067,10,,
2020,20,3060,645,4,594,2,4,9,3,6,3,6,0,6,0,False,False,False,0,3,2021-01-25T16:51:42.223,6,,
2020,20,3060,655,4,594,2,4,10,13,13,0,13,0,13,0,False,False,False,0,3,2021-01-25T16:51:52.803,13,,
2020,20,3060,670,4,2853,13,19,6,30,0,0,0,0,0,0,False,False,False,0,3,2021-01-26T22:26:52.367,0,,
2020,20,3060,680,4,6953,13,35,8,15,0,0,0,0,0,0,False,False,False,0,3,2021-01-26T17:56:05.11,0,,
2020,20,3060,685,4,1412,13,2,9,6,0,0,0,0,0,0,False,False,False,0,2,2021-01-25T15:48:21.657,0,,
2020,20,3060,695,16,374,2,2,10,5,12,7,10,2,10,0,True,False,False,0,3,2021-01-25T15:58:56.353,12,,
2020,20,3060,715,16,7176,3,46,3,1,0,0,0,0,0,0,True,False,False,0,4,2021-01-26T22:22:42.827,0,,
2020,20,3060,720,16,3938,2,5,5,11,12,1,12,0,12,0,False,False,False,0,3,2021-01-25T16:04:09.093,12,,
2020,20,3060,735,16,3938,13,35,5,5,0,0,0,0,0,0,False,False,False,0,2,2021-01-26T22:27:21.96,0,,
2020,20,3060,740,16,374,2,13,9,4,5,1,5,0,5,6,False,False,False,0,4,2021-01-25T16:09:10.25,5,,
2020,20,3060,755,4,7646,13,19,10,0,0,0,0,0,0,0,False,False,False,0,2,2021-01-26T17:56:24.617,0,,
2020,20,3060,770,4,594,2,4,3,0,9,9,9,0,9,0,False,False,False,1,1,2021-01-25T16:52:12.39,9,,
2020,20,3060,775,4,6953,2,13,10,4,11,7,11,0,11,0,False,False,False,0,3,2021-01-25T16:22:00.033,11,,
2020,20,3060,780,4,6983,2,16,10,1,7,6,4,3,4,0,False,False,False,0,1,2021-01-26T17:56:39.26,7,,
2020,20,3060,790,4,2853,2,12,8,15,15,0,15,0,15,0,False,False,False,0,2,2021-01-26T22:27:55.323,15,,
2020,20,3060,795,4,6953,2,30,5,1,6,5,6,0,6,0,True,False,False,0,4,2021-01-26T17:53:30.467,6,,
2020,20,3060,800,4,5119,2,2,9,6,6,0,6,0,6,6,False,False,False,0,3,2021-01-25T16:28:54.187,6,,
2020,20,3060,815,4,2853,2,17,1,30,34,4,34,0,34,0,False,False,False,0,3,2021-01-25T16:34:04.93,34,,
2020,20,3060,820,4,7646,13,9,6,15,0,0,0,0,0,0,False,False,False,0,2,2021-01-25T16:34:47.837,0,,
2020,20,3060,825,4,7646,13,35,7,15,0,0,0,0,0,0,False,False,False,0,3,2021-01-25T16:35:57.717,0,,
2020,21,3061,10,30,4516,2,30,9,0,1,1,1,0,1,0,False,False,False,0,4,2021-02-08T12:44:31.287,1,,
2020,21,3061,20,30,4516,13,5,9,7,0,0,0,0,0,0,False,False,False,0,3,2021-02-08T12:48:19.48,0,,
2020,21,3061,30,16,6500,2,4,5,3,3,0,3,0,3,0,False,False,False,1,2,2021-02-08T12:52:11.05,3,,
2020,21,3061,50,16,7176,13,19,6,22,0,0,0,0,0,0,False,False,False,0,2,2021-02-08T13:03:14.24,0,,
2020,21,3061,55,16,7176,13,22,2,26,0,0,0,0,0,0,False,False,False,0,3,2021-02-09T01:09:11.37,0,,
2020,21,3061,75,30,2290,2,4,9,5,5,0,5,0,5,0,True,False,False,0,3,2021-02-08T13:12:09.053,5,,
2020,21,3061,110,16,6500,13,8,1,35,0,0,0,0,0,0,False,False,False,0,3,2021-02-09T21:37:55.723,0,,
2020,21,3061,115,16,7176,13,11,3,6,0,0,0,0,0,0,True,False,False,0,3,2021-04-01T19:45:04.813,0,,
2020,21,3061,125,16,3938,3,12,6,28,0,0,0,0,0,0,False,False,False,0,3,2021-02-09T19:35:35.243,0,,
2020,21,3061,155,30,793,13,5,7,16,0,0,0,0,0,0,False,False,False,0,2,2021-02-08T13:48:59.677,0,,
2020,21,3061,160,30,37,2,4,2,17,16,-1,16,0,16,0,False,False,False,0,2,2021-02-09T21:37:55.723,16,,
2020,21,3061,165,30,2290,2,53,9,-4,15,19,13,2,13,0,True,False,False,1,4,2021-02-09T22:19:30.797,15,,
2020,21,3061,175,30,37,2,49,3,-2,5,7,3,2,3,0,False,False,False,0,2,2021-02-08T13:55:14.887,5,,
2020,21,3061,180,30,63,2,30,9,0,8,8,8,0,8,6,False,False,False,0,4,2021-02-08T17:25:59.327,8,,
2020,21,3061,195,16,6499,13,47,10,0,0,0,0,0,0,0,False,False,False,0,1,2021-02-08T13:59:33.767,0,,
2020,21,3061,200,16,374,2,4,10,4,6,2,5,1,5,0,False,False,False,0,3,2021-02-08T17:26:14.46,6,,
2020,21,3061,210,16,6499,13,48,10,-6,0,0,0,0,0,0,False,False,False,0,1,2021-02-08T14:02:52.263,0,,
2020,21,3061,220,30,6414,13,45,5,-7,0,0,0,0,0,0,False,False,False,0,1,2021-02-08T14:05:31.513,0,,
2020,21,3061,225,30,63,2,13,5,3,3,0,3,0,3,0,False,False,False,0,4,2021-02-08T14:06:50.683,3,,
2020,21,3061,240,30,793,2,6,1,16,31,15,30,1,30,0,False,False,False,0,2,2021-02-09T22:48:12.377,31,,
2020,21,3061,255,30,4253,13,21,9,2,0,0,0,0,0,0,False,False,False,0,4,2021-03-04T20:03:51.967,0,,
2020,21,3061,270,16,3938,2,13,9,4,14,10,12,2,12,0,False,False,False,2,2,2021-02-09T01:00:00.94,14,,
2020,21,3061,275,16,7176,13,45,5,-3,0,0,0,0,0,0,True,False,False,0,3,2021-02-09T19:38:44.363,0,,
2020,21,3061,285,16,374,3,5,2,15,0,0,0,0,0,0,False,False,False,0,2,2021-02-09T21:37:55.723,0,,
2020,21,3061,300,30,37,2,34,4,-4,-3,1,-3,0,-3,0,True,False,False,0,3,2021-02-09T00:51:00.587,-3,,
2020,21,3061,305,30,63,2,47,10,0,9,9,7,2,7,0,False,False,False,0,3,2021-02-08T14:36:06.44,9,,
2020,21,3061,310,30,793,13,4,5,8,0,0,0,0,0,0,False,False,False,0,2,2021-02-08T14:37:30.48,0,,
2020,21,3061,320,30,4937,2,5,10,0,4,4,2,2,2,0,False,False,False,0,1,2021-02-08T14:40:49.767,4,,
2020,21,3061,325,30,7893,3,13,4,4,0,0,0,0,0,0,False,False,False,0,3,2021-02-08T14:42:41.827,0,,
2020,21,3061,335,30,63,2,12,2,17,17,0,17,0,17,6,False,False,False,0,4,2021-02-08T14:45:59.293,17,,
2020,21,3061,350,16,374,2,4,10,8,13,5,11,2,11,0,False,False,False,0,4,2021-02-08T14:55:10.667,13,,
2020,21,3061,355,16,7176,2,44,3,-5,4,9,1,3,1,0,True,False,False,0,3,2021-02-09T19:36:09.763,4,,
2020,21,3061,360,16,374,2,2,4,8,12,4,12,0,12,0,True,False,False,0,3,2021-02-08T14:58:50.147,12,,
2020,21,3061,375,16,374,2,31,4,3,11,8,3,8,3,0,False,False,False,1,3,2021-02-09T21:37:55.723,11,,
2020,21,3061,385,16,3938,2,45,5,-8,-1,7,-1,0,-1,0,True,False,False,1,1,2021-02-09T22:48:39.197,-1,,
2020,21,3061,390,16,374,2,5,9,5,5,0,5,0,5,0,False,False,False,0,3,2021-02-08T15:06:46.743,5,,
2020,21,3061,420,30,4516,2,50,10,-3,8,11,3,5,3,0,False,False,False,0,3,2021-02-08T15:11:45.157,8,,
2020,21,3061,430,30,63,2,5,10,3,5,2,3,2,3,0,False,False,False,0,3,2021-02-08T15:12:40.533,5,,
2020,21,3061,435,30,793,13,19,6,38,0,0,0,0,0,0,False,False,False,0,2,2021-02-08T15:13:38.597,0,,
2020,21,3061,440,30,4937,2,4,4,2,15,13,11,4,11,0,False,False,False,0,6,2021-02-08T15:14:54.027,15,,
2020,21,3061,455,30,793,13,17,10,9,0,0,0,0,0,0,False,False,False,0,3,2021-02-09T22:43:38.117,0,,
2020,21,3061,460,30,37,2,26,5,1,1,0,1,0,1,6,False,False,False,0,2,2021-02-08T15:18:37.35,1,,
2020,21,3061,495,16,374,2,4,10,4,8,4,6,2,6,0,False,False,False,0,3,2021-02-08T15:31:39.73,8,,
2020,21,3061,510,16,7176,2,18,5,0,0,0,0,0,0,0,False,False,False,1,2,2021-02-08T15:35:09.327,0,,
2020,21,3061,515,16,374,13,12,4,5,0,0,0,0,0,0,True,False,False,0,3,2021-02-09T22:44:25.277,0,,
2020,21,3061,535,30,37,2,50,3,-1,3,4,2,1,2,0,False,False,False,0,2,2021-02-08T15:38:59.227,3,,
2020,21,3061,540,30,4937,2,4,4,3,12,9,6,6,6,0,False,False,False,1,1,2021-02-08T17:22:28.747,12,,
2020,21,3061,550,30,63,2,21,4,10,25,15,22,3,22,0,False,False,False,0,4,2021-02-08T15:43:23.727,25,,
2020,21,3061,580,16,3938,13,12,2,30,0,0,0,0,0,0,False,False,False,0,3,2021-02-08T15:50:13.053,0,,
2020,21,3061,585,30,4937,2,5,9,3,15,12,12,3,12,0,False,False,False,0,1,2021-02-08T15:52:32.307,15,,
2020,21,3061,605,30,6570,13,35,2,19,0,0,0,0,0,0,False,False,False,0,4,2021-02-08T15:56:28.973,0,,
2020,21,3061,610,30,4516,13,11,3,11,0,0,0,0,0,0,False,False,False,0,3,2021-02-08T15:57:50.403,0,,
2020,21,3061,630,16,374,13,12,8,55,0,0,0,0,0,0,True,False,False,0,3,2021-02-08T16:01:29.42,0,,
2020,21,3061,635,16,7681,2,44,3,1,5,4,3,2,3,0,False,False,False,0,1,2021-02-09T01:06:53.42,5,,
2020,21,3061,650,16,374,13,2,4,6,0,0,0,0,0,0,False,False,False,0,3,2021-02-09T19:36:18.81,0,,
2020,21,3061,655,16,3938,2,35,9,11,21,10,17,4,17,0,False,False,False,0,3,2021-02-08T16:08:51.533,21,,
2020,21,3061,660,16,121,2,4,4,12,13,1,13,0,13,0,False,False,False,0,3,2021-02-08T16:10:51.737,13,,
2020,21,3061,665,16,6499,13,12,3,4,0,0,0,0,0,0,False,False,False,0,1,2021-02-09T19:39:16.283,0,,
2020,21,3061,675,16,374,2,2,4,10,17,7,12,5,12,0,True,False,False,0,3,2021-02-08T17:23:16.3,17,,
2020,21,3061,685,16,4143,13,12,5,11,0,0,0,0,0,0,False,False,False,0,2,2021-02-08T16:16:01.813,0,,
2020,21,3061,690,16,6500,13,12,3,11,0,0,0,0,0,0,False,False,False,0,3,2021-02-08T16:17:55.973,0,,
2020,21,3061,700,16,6499,3,12,5,11,0,0,0,0,0,0,False,False,False,0,1,2021-02-08T16:19:30.137,0,,
2020,21,3061,730,30,2290,2,30,9,-1,6,7,4,2,4,0,False,False,False,0,4,2021-02-08T16:26:21.003,6,,
2020,21,3061,745,30,63,13,35,6,25,0,0,0,0,0,0,False,False,False,0,4,2021-02-08T16:29:49.947,0,,
2020,21,3061,755,16,374,2,4,7,17,33,16,28,5,28,0,False,False,False,0,3,2021-02-08T17:26:51.557,33,,
2020,21,3061,765,16,374,13,12,9,10,0,0,0,0,0,0,True,False,False,0,3,2021-02-08T16:39:49.25,0,,
2020,21,3061,770,16,374,2,35,9,12,12,0,12,0,12,0,False,False,False,0,4,2021-02-25T18:12:10.037,12,,
2020,21,3061,775,16,6499,13,4,9,2,0,0,0,0,0,0,False,False,False,0,1,2021-02-08T16:48:13.2,0,,
2020,21,3061,780,16,6499,2,45,10,-5,9,14,2,7,2,0,False,False,False,1,1,2021-02-08T16:44:23.51,9,,
2020,21,3061,785,16,3938,2,12,4,3,4,1,4,0,4,0,False,False,False,0,3,2021-02-09T01:07:58.487,4,,
2020,21,3061,790,16,3938,2,4,5,7,7,0,7,0,7,0,False,False,False,0,3,2021-02-08T17:15:17.393,7,,
2020,21,3061,795,16,374,13,6,7,15,0,0,0,0,0,0,False,False,False,0,3,2021-02-08T16:50:03.537,0,,
2020,21,3061,805,16,3938,2,4,10,9,23,14,23,0,23,0,False,False,False,0,3,2021-02-08T16:52:52.96,23,,
2020,21,3061,810,16,3938,13,12,8,24,0,0,0,0,0,0,False,False,False,0,3,2021-02-08T17:24:37.653,0,,
2020,21,3061,835,30,37,13,19,2,40,0,0,0,0,0,0,False,False,False,0,2,2021-02-09T01:08:56.48,0,,
2020,21,3061,845,16,7681,13,5,3,8,0,0,0,0,0,0,False,False,False,0,1,2021-02-08T17:01:29.65,0,,
2020,21,3061,850,16,3938,2,4,4,8,8,0,8,0,8,0,False,False,False,0,3,2021-02-08T17:02:17.337,8,,
2020,21,3061,855,16,7681,2,46,3,-2,18,20,16,2,16,0,False,False,False,0,1,2021-02-08T17:03:18.923,18,,
2020,21,3061,860,16,4143,13,4,5,10,0,0,0,0,0,0,False,False,False,0,2,2021-02-08T17:16:10.953,0,,
2020,21,3061,865,16,374,2,4,7,15,16,1,13,3,13,0,False,False,False,0,3,2021-02-09T21:02:16.25,16,,
2020,21,3061,875,16,6499,2,44,3,-5,1,6,-1,2,-1,0,False,False,False,0,1,2021-02-08T17:07:49.223,1,,
2020,21,3061,880,16,4143,2,5,5,4,11,7,11,0,11,0,False,False,False,0,2,2021-02-08T17:08:52.44,11,,
2020,21,3061,890,16,3938,2,4,5,5,4,-1,4,0,4,0,True,False,False,0,2,2021-02-09T21:37:55.737,4,,
2020,21,3061,895,16,374,13,4,5,10,0,0,0,0,0,0,False,False,False,0,3,2021-02-08T17:11:23.49,0,,
