season,week,gameId,eventId,teamId,playerId,actionType,targetType,targetDirection,targetDepth,yards,yardsAfterCatch,firstContact,yardsAfterContact,yardsBeforeContact,scoreType,inMotion,fumbled,fumbleLost,missedTackles,targetLinedUp,lastUpdate,trueYardage,noContact,rawYardsAfterContact
2021,1,3062,20,30,4516,13,6,5,14,0,0,0,0,0,0,True,False,False,0,2,2021-09-16T17:09:17.197,0,False,0.0
2021,1,3062,30,9,322,2,19,6,22,28,6,26,2,26,0,False,False,False,0,3,2021-09-16T19:23:10.853,28,False,2.0
2021,1,3062,40,9,6446,2,39,4,5,5,0,5,0,5,0,False,False,False,0,3,2021-09-11T17:49:43.983,5,False,0.0
2021,1,3062,55,9,6446,2,53,10,-3,16,19,15,1,15,0,False,False,False,0,4,2021-09-10T09:26:43.073,16,False,1.0
2021,1,3062,60,9,7816,13,5,6,20,0,0,0,0,0,0,False,False,False,0,2,2021-09-10T09:28:13.127,0,False,0.0
2021,1,3062,65,9,7816,3,4,3,6,0,0,0,0,0,0,False,False,False,0,2,2021-09-10T09:29:28.36,0,False,0.0
2021,1,3062,75,9,7816,13,5,3,14,0,0,0,0,0,0,False,False,False,0,3,2021-09-10T09:31:23.27,0,False,0.0
2021,1,3062,90,30,793,2,2,9,6,10,4,9,1,9,0,False,False,False,0,3,2021-09-10T09:34:30.183,10,False,1.0
2021,1,3062,95,30,793,13,4,3,5,0,0,0,0,0,0,False,False,False,0,2,2021-09-10T09:35:32.36,0,False,0.0
2021,1,3062,100,30,63,2,35,1,16,19,3,18,1,18,0,False,False,False,0,4,2021-09-10T09:37:06.51,19,False,1.0
2021,1,3062,105,30,37,2,20,2,25,28,3,26,2,26,0,False,False,False,0,2,2021-09-10T09:38:38.337,28,False,2.0
2021,1,3062,110,30,37,2,4,5,13,16,3,14,2,14,0,False,False,False,1,2,2021-09-10T09:41:59.277,16,False,2.0
2021,1,3062,120,30,4516,2,4,10,6,8,2,7,1,7,0,True,False,False,0,3,2021-09-10T09:44:54.643,8,True,1.0
2021,1,3062,125,30,4516,2,2,4,5,5,0,5,0,5,6,True,False,False,0,3,2021-09-10T09:46:13.22,5,True,0.0
2021,1,3062,140,9,7183,2,51,9,-5,11,16,9,2,9,0,True,False,False,0,2,2021-09-11T17:52:38.017,11,False,2.0
2021,1,3062,145,9,6436,2,49,3,-4,8,12,6,2,6,0,False,False,False,0,2,2021-09-10T09:50:04.197,8,True,2.0
2021,1,3062,150,9,6436,2,2,10,7,12,5,8,4,8,0,False,False,False,1,2,2021-09-16T17:14:19.403,12,False,4.0
2021,1,3062,155,9,7183,2,34,4,-5,7,12,0,7,0,0,True,False,False,1,3,2022-02-16T20:10:05.88,7,False,7.0
2021,1,3062,160,9,6436,2,3,5,8,8,0,8,0,8,0,False,False,False,0,2,2021-09-10T09:56:49.14,8,True,0.0
2021,1,3062,165,9,4447,2,32,5,1,7,6,6,1,6,0,False,False,False,0,4,2021-09-10T09:58:02.933,7,False,1.0
2021,1,3062,170,9,7816,2,21,6,15,22,7,22,0,22,6,False,False,False,0,2,2021-09-16T17:09:28.37,22,True,0.0
2021,1,3062,190,30,37,2,35,8,15,27,12,27,0,27,0,True,False,False,0,3,2021-09-10T10:05:31.927,27,True,0.0
2021,1,3062,200,30,4937,13,16,10,4,0,0,0,0,0,0,False,False,False,0,1,2021-09-16T17:09:38.467,0,False,0.0
2021,1,3062,205,30,37,13,4,7,15,0,0,0,0,0,0,False,False,False,0,3,2021-09-10T10:09:49.203,0,False,0.0
2021,1,3062,230,9,6441,2,51,9,1,2,1,1,1,1,0,False,False,False,0,3,2022-01-31T19:20:56.52,2,False,1.0
2021,1,3062,235,9,7183,2,4,9,4,5,1,5,0,5,0,False,False,False,0,1,2021-09-10T10:21:25.38,5,False,0.0
2021,1,3062,260,30,63,2,39,4,5,5,0,5,0,5,0,False,False,False,0,4,2021-09-10T10:25:46.237,5,False,0.0
2021,1,3062,265,30,4516,2,47,5,3,19,16,18,1,18,0,True,False,False,0,3,2021-09-11T17:23:09.423,19,False,1.0
2021,1,3062,270,30,4516,2,4,10,14,17,3,16,1,16,0,False,False,False,0,3,2021-09-10T10:29:52.527,17,False,1.0
2021,1,3062,280,30,63,2,32,10,2,2,0,2,0,2,6,False,False,False,0,4,2021-09-10T10:31:54.727,2,False,0.0
2021,1,3062,295,9,7816,2,6,10,14,22,8,15,7,15,0,False,False,False,1,3,2021-09-10T10:34:33.027,22,False,7.0
2021,1,3062,300,9,322,13,29,6,15,0,0,0,0,0,0,False,False,False,0,3,2021-09-16T19:23:10.867,0,False,
2021,1,3062,305,9,4447,2,12,5,6,6,0,6,0,6,0,False,False,False,0,4,2022-02-01T19:05:10.263,6,True,0.0
2021,1,3062,310,9,6436,2,51,3,-2,8,10,5,3,5,0,False,False,False,0,2,2021-09-10T10:39:47.427,8,False,3.0
2021,1,3062,315,9,6436,13,12,6,15,0,0,0,0,0,0,False,False,False,0,2,2021-09-10T10:41:06.723,0,False,
2021,1,3062,320,9,4202,2,51,3,-3,3,6,1,2,1,0,False,False,False,0,3,2021-09-16T19:23:10.867,3,False,2.0
2021,1,3062,325,9,322,2,4,10,4,4,0,4,0,4,0,False,False,False,0,3,2021-09-11T18:10:03.353,4,False,0.0
2021,1,3062,330,9,7816,13,7,3,13,0,0,0,0,0,0,False,False,False,0,3,2022-02-25T14:27:49.877,0,False,0.0
2021,1,3062,350,9,7816,13,19,6,25,0,0,0,0,0,0,True,False,False,0,2,2021-09-16T17:05:05.127,0,False,0.0
2021,1,3062,360,9,6441,2,4,4,12,13,1,12,1,12,0,False,False,False,0,3,2021-09-10T10:51:53.77,13,False,1.0
2021,1,3062,370,9,322,2,3,3,5,5,0,5,0,5,6,False,False,False,0,2,2021-09-10T10:54:57.09,5,False,0.0
2021,1,3062,385,30,4937,3,48,9,1,0,0,0,0,0,0,False,False,False,0,1,2021-09-16T17:30:09.597,0,False,0.0
2021,1,3062,390,9,7816,2,18,3,-3,4,7,2,2,2,0,False,False,False,0,2,2021-09-16T19:24:47.973,4,False,2.0
2021,1,3062,395,9,6436,13,29,6,17,0,0,0,0,0,0,False,False,False,0,2,2021-09-16T19:23:10.867,0,False,0.0
2021,1,3062,400,9,7816,13,17,8,17,0,0,0,0,0,0,False,False,False,0,3,2021-09-10T11:04:11.98,0,False,0.0
2021,1,3062,415,30,4516,2,39,4,5,10,5,9,1,9,0,False,False,False,0,3,2021-09-10T11:06:16.783,10,False,1.0
2021,1,3062,420,30,37,2,19,2,43,47,4,47,0,47,6,False,False,False,0,2,2021-09-10T11:07:39.41,47,False,0.0
2021,1,3062,435,9,322,2,2,9,8,11,3,10,1,10,0,False,False,False,0,2,2021-09-10T11:09:13.947,11,False,1.0
2021,1,3062,445,9,6436,2,4,3,10,8,-2,8,0,8,0,False,False,False,0,2,2021-09-10T11:11:15.98,8,False,
2021,1,3062,450,9,322,2,4,3,6,7,1,7,0,7,0,False,False,False,0,2,2021-09-10T11:13:48.107,7,False,0.0
2021,1,3062,455,9,6436,13,4,3,10,0,0,0,0,0,0,False,False,False,0,2,2021-09-10T11:15:14.163,0,False,0.0
2021,1,3062,460,9,7816,2,4,10,5,10,5,8,2,8,0,False,False,False,0,3,2021-09-10T11:16:52.907,10,False,2.0
2021,1,3062,495,30,931,13,12,5,10,0,0,0,0,0,0,False,False,False,0,1,2022-02-16T20:15:59.523,0,False,0.0
2021,1,3062,500,30,7893,13,5,5,10,0,0,0,0,0,0,False,False,False,0,2,2022-02-16T20:33:18.813,0,False,0.0
2021,1,3062,505,30,63,13,19,2,50,0,0,0,0,0,0,False,False,False,0,2,2022-02-01T19:05:40.657,0,False,0.0
2021,1,3062,520,9,322,13,5,3,4,0,0,0,0,0,0,True,False,False,0,3,2021-09-10T11:37:58.613,0,False,0.0
2021,1,3062,525,9,6446,2,46,3,1,5,4,3,2,3,0,False,False,False,0,4,2021-09-10T11:39:09.217,5,False,2.0
2021,1,3062,530,9,322,2,5,5,10,16,6,16,0,16,0,True,False,False,0,3,2021-09-11T18:12:33.463,16,False,0.0
2021,1,3062,535,9,322,2,5,5,5,6,1,6,0,6,0,False,False,False,0,3,2022-02-16T20:18:09.937,6,False,0.0
2021,1,3062,545,9,322,2,6,4,14,14,0,14,0,14,0,True,False,False,0,3,2021-09-10T11:44:52.63,14,True,0.0
2021,1,3062,550,9,6436,13,2,10,5,0,0,0,0,0,0,False,False,False,0,2,2021-09-10T11:46:05.063,0,False,0.0
2021,1,3062,555,9,4447,13,6,1,16,0,0,0,0,0,0,False,False,False,0,3,2021-09-10T11:47:52.07,0,False,
2021,1,3062,560,9,7183,2,51,10,-5,6,11,1,5,1,0,True,False,False,0,1,2021-09-10T11:50:49.327,6,False,5.0
2021,1,3062,565,9,322,2,4,3,5,4,-1,4,0,4,0,False,False,False,0,2,2021-09-10T11:52:35.853,4,False,0.0
2021,1,3062,575,9,4202,2,47,5,3,3,0,3,0,3,0,False,False,False,0,1,2021-09-10T11:55:08.567,3,True,0.0
2021,1,3062,595,30,4516,13,26,9,3,0,0,0,0,0,0,False,False,False,0,3,2021-09-16T17:09:52.797,0,False,0.0
2021,1,3062,600,30,4516,3,2,9,8,0,0,0,0,0,0,False,False,False,0,3,2021-09-10T12:00:27.527,0,False,0.0
2021,1,3062,620,9,7816,3,6,1,25,0,0,0,0,0,0,False,False,False,0,2,2022-02-16T20:33:28.733,0,False,0.0
2021,1,3062,625,30,63,2,11,2,15,20,5,16,4,16,0,False,False,False,0,4,2021-09-10T12:08:24.537,20,False,4.0
2021,1,3062,630,30,4516,2,50,9,-2,2,4,0,2,0,0,True,False,False,0,3,2021-09-10T12:10:18.057,2,False,2.0
2021,1,3062,635,30,4937,2,46,9,-2,2,4,0,2,0,0,False,False,False,0,1,2021-09-10T12:12:03.933,2,False,2.0
2021,1,3062,640,30,63,2,33,4,2,11,9,11,0,11,6,False,False,False,0,4,2021-09-10T12:13:42.807,11,False,0.0
2021,1,3062,660,9,4447,2,2,9,7,7,0,7,0,7,0,False,False,False,0,3,2021-09-10T12:20:09.493,7,False,0.0
2021,1,3062,670,9,6446,2,4,10,4,10,6,5,5,5,0,False,False,False,2,3,2021-09-10T12:22:28.59,10,False,5.0
2021,1,3062,680,9,7816,2,4,10,3,9,6,7,2,7,0,True,False,False,0,3,2021-09-11T18:13:27.803,9,False,2.0
2021,1,3062,685,9,6446,2,13,5,5,6,1,5,1,5,0,False,False,False,0,4,2021-09-10T12:26:18.063,6,False,1.0
2021,1,3062,700,9,322,2,7,2,21,21,0,21,0,21,6,False,False,False,0,3,2021-09-10T12:29:52.743,21,False,0.0
2021,1,3062,715,30,4937,2,46,9,-3,10,13,6,4,6,0,True,False,False,0,1,2021-09-11T17:23:31.943,10,False,4.0
2021,1,3062,735,30,4937,2,50,9,-2,1,3,0,1,0,0,True,False,False,0,2,2021-09-10T12:37:40.977,1,False,1.0
2021,1,3062,740,30,793,2,5,9,4,5,1,5,0,5,0,False,False,False,0,3,2021-09-10T12:39:30.02,5,False,0.0
2021,1,3062,750,30,793,13,5,10,13,0,0,0,0,0,0,False,False,False,0,3,2021-09-16T17:06:40.843,0,False,0.0
2021,1,3062,755,30,4516,3,17,8,39,0,0,0,0,0,0,False,False,False,0,3,2021-09-16T17:21:28.027,0,False,0.0
2021,1,3062,765,9,322,2,51,3,-3,2,5,0,2,0,0,False,False,False,0,2,2021-09-10T12:46:59.21,2,False,2.0
2021,1,3062,770,9,322,13,4,3,5,0,0,0,0,0,0,False,False,False,0,3,2021-09-16T19:23:10.867,0,False,0.0
2021,1,3062,775,9,322,13,4,5,8,0,0,0,0,0,0,False,False,False,0,2,2021-09-16T19:23:29.917,0,False,0.0
2021,1,3062,785,30,63,2,32,10,1,7,6,7,0,7,0,False,False,False,0,4,2021-09-10T12:53:14.077,7,False,0.0
2021,1,3062,790,30,4516,2,50,9,-4,9,13,0,9,0,0,False,False,False,1,3,2021-09-10T12:54:35.78,9,False,9.0
2021,1,3062,800,30,4937,2,12,5,3,7,4,4,3,4,0,False,False,False,0,1,2021-09-10T12:56:56.717,7,False,3.0
2021,1,3062,810,30,793,2,13,4,6,9,3,6,3,6,0,False,False,False,1,3,2022-02-25T14:28:42.323,9,False,3.0
2021,1,3062,815,30,4937,2,44,9,-6,7,13,4,3,4,0,False,False,False,0,1,2021-09-10T13:02:17.363,7,False,3.0
2021,1,3062,820,30,37,2,44,3,-5,3,8,1,2,1,0,False,False,False,0,3,2021-09-16T17:07:29.76,3,False,2.0
2021,1,3062,835,30,4516,2,51,10,0,11,11,5,6,5,0,True,True,True,2,3,2021-09-10T13:09:00.28,11,False,6.0
2021,1,3062,845,9,6446,2,46,3,-1,3,4,3,0,3,0,False,False,False,1,4,2021-09-10T13:14:29.393,3,False,0.0
2021,1,3062,855,9,7816,2,47,5,0,6,6,4,2,4,0,False,False,False,0,1,2021-09-10T13:17:41.257,6,False,2.0
2021,1,3062,860,9,322,2,4,9,6,11,5,10,1,10,0,False,False,False,0,3,2021-09-10T13:23:01.38,11,False,1.0
2021,1,3062,865,9,0,13,25,2,0,0,0,0,0,0,0,False,False,False,0,2,2021-09-10T13:24:53.097,0,False,
2021,1,3062,870,9,7816,2,20,6,17,23,6,23,0,23,0,False,False,False,0,2,2021-09-16T17:10:43.557,23,True,
2021,1,3062,875,9,6441,2,4,10,9,9,0,9,0,9,0,True,False,False,0,3,2021-09-11T18:13:56.69,9,False,0.0
2021,1,3062,885,9,7816,2,6,9,6,31,25,23,8,23,0,False,False,False,1,3,2021-09-16T17:12:29.037,31,False,8.0
2021,1,3062,895,9,7816,13,4,5,6,0,0,0,0,0,0,False,False,False,0,2,2021-09-10T13:35:10.34,0,False,0.0
2021,1,3062,910,9,4202,2,28,5,-7,0,7,-2,2,-2,0,True,False,False,0,1,2021-09-11T18:14:46.7,0,False,
2021,1,3062,915,9,322,2,4,9,4,10,6,4,6,4,0,False,False,False,2,3,2021-09-16T19:23:10.867,10,False,6.0
2021,1,3062,935,30,931,2,48,9,-6,8,14,7,1,7,0,False,False,False,0,1,2021-09-10T13:43:13.743,8,False,1.0
2021,1,3062,940,30,793,13,12,3,11,0,0,0,0,0,0,False,False,False,0,2,2021-09-16T17:10:54.377,0,False,0.0
2021,1,3062,945,30,931,2,5,9,4,4,0,4,0,4,0,False,False,False,0,1,2021-09-16T17:08:20.813,4,False,0.0
2021,1,3062,960,30,63,2,32,10,-2,6,8,5,1,5,0,False,False,False,0,4,2021-09-10T13:49:56.863,6,False,1.0
2021,1,3062,965,30,63,2,4,10,9,20,11,16,4,16,0,False,False,False,1,4,2021-09-10T13:51:21.547,20,False,4.0
2021,1,3062,970,30,37,13,4,2,32,0,0,0,0,0,0,False,False,False,0,2,2022-02-25T14:30:17.073,0,False,0.0
2021,1,3062,975,30,4516,2,29,6,17,24,7,24,0,24,0,False,False,False,0,3,2021-09-10T13:55:28.313,24,True,0.0
2021,1,3063,15,13,876,13,5,5,4,0,0,0,0,0,0,False,False,False,0,3,2021-09-16T21:44:26.893,0,True,0.0
2021,1,3063,20,13,8417,13,4,5,6,0,0,0,0,0,0,False,False,False,0,2,2022-02-25T14:31:43.897,0,True,0.0
2021,1,3063,30,15,8099,13,28,4,-4,0,0,0,0,0,0,False,False,False,0,1,2021-09-13T19:26:39.957,0,True,
2021,1,3063,45,15,6501,13,5,5,7,0,0,0,0,0,0,False,False,False,0,2,2021-09-16T21:59:39.92,0,True,0.0
2021,1,3063,50,15,7591,2,52,4,4,13,9,13,0,13,0,False,False,False,1,2,2021-09-16T21:52:16.94,13,False,0.0
2021,1,3063,70,13,4662,13,7,2,37,0,0,0,0,0,0,False,False,False,0,4,2021-09-16T21:44:54.89,0,True,0.0
2021,1,3063,80,13,4662,2,47,5,2,10,8,6,4,6,0,False,False,False,0,4,2021-09-13T10:17:03.17,10,False,4.0
2021,1,3063,90,13,100,2,4,9,5,8,3,5,3,5,0,False,False,False,0,3,2021-12-20T21:05:19.183,8,False,3.0
2021,1,3063,95,13,100,2,5,5,7,7,0,7,0,7,0,False,False,False,0,3,2021-12-20T21:04:59.95,7,False,0.0
2021,1,3063,110,13,876,2,7,7,36,40,4,36,4,36,0,False,False,False,0,3,2022-02-16T17:44:08.137,40,False,4.0
2021,1,3063,115,13,6481,3,34,4,-4,0,0,0,0,0,0,True,False,False,0,3,2021-10-15T00:51:50.373,0,True,0.0
2021,1,3063,140,15,914,2,7,2,26,33,7,29,4,29,0,False,False,False,0,3,2021-09-13T10:46:49.007,33,False,4.0
2021,1,3063,150,15,914,2,2,4,11,15,4,15,0,15,0,False,False,False,0,3,2021-09-16T23:30:12.147,15,False,0.0
2021,1,3063,155,15,2757,3,2,10,6,0,0,0,0,0,0,False,False,False,0,3,2021-10-15T00:52:45.527,0,True,0.0
2021,1,3063,160,15,6501,3,2,10,8,0,0,0,0,0,0,False,False,False,0,2,2021-10-15T00:53:08.423,0,True,0.0
2021,1,3063,170,13,2407,2,2,4,13,17,4,16,1,16,0,False,False,False,0,3,2021-09-13T11:03:25.057,17,False,1.0
2021,1,3063,175,13,4662,2,12,3,13,25,12,13,12,13,0,True,False,False,2,3,2022-02-01T19:09:55.283,25,False,12.0
2021,1,3063,185,13,2455,13,26,3,4,0,0,0,0,0,0,False,False,False,0,2,2021-09-13T11:13:56.437,0,True,0.0
2021,1,3063,190,13,2455,2,46,3,6,7,1,7,0,7,6,False,False,False,0,1,2021-09-16T21:45:41.937,7,True,0.0
2021,1,3063,205,15,7591,2,51,3,-2,8,10,5,3,5,0,False,False,False,0,3,2021-09-13T17:38:02.487,8,False,3.0
2021,1,3063,210,15,7591,2,51,5,-2,3,5,2,1,2,0,False,False,False,0,2,2022-02-16T17:38:35.147,3,False,1.0
2021,1,3063,225,15,7591,2,49,3,-4,-1,3,-2,1,-2,0,True,False,False,2,2,2021-09-16T21:53:14.63,-1,False,1.0
2021,1,3063,230,15,914,13,4,9,11,0,0,0,0,0,0,False,False,False,0,3,2021-09-13T11:31:15.893,0,True,0.0
2021,1,3063,245,15,6501,2,4,7,20,27,7,23,4,23,0,False,False,False,0,2,2021-09-16T22:10:10.5,27,False,4.0
2021,1,3063,260,15,6501,3,6,4,10,0,0,0,0,0,0,False,False,False,0,2,2021-09-16T22:10:21.49,0,False,0.0
2021,1,3063,265,15,2757,13,12,5,3,0,0,0,0,0,0,False,False,False,0,3,2022-02-16T17:41:31.187,0,False,
2021,1,3063,270,15,2757,13,6,4,11,0,0,0,0,0,0,False,False,False,0,3,2021-09-13T19:12:54.903,0,True,
2021,1,3063,280,15,3750,2,17,7,19,22,3,21,1,21,6,False,False,False,0,4,2021-09-13T11:56:45.917,22,False,1.0
2021,1,3063,300,13,876,2,7,6,24,24,0,24,0,24,0,False,False,False,0,3,2021-09-16T22:21:13.84,24,False,0.0
2021,1,3063,315,13,876,2,47,5,3,12,9,12,0,12,0,False,False,False,0,1,2021-09-16T21:46:16.917,12,False,0.0
2021,1,3063,330,13,2407,2,39,4,6,10,4,8,2,8,0,False,False,False,0,3,2021-09-16T21:46:26.147,10,False,2.0
2021,1,3063,335,13,1510,13,5,3,0,0,0,0,0,0,0,False,False,False,0,3,2021-12-20T21:57:38.577,0,False,0.0
2021,1,3063,370,15,7591,13,7,6,23,0,0,0,0,0,0,False,False,False,0,3,2021-09-13T19:29:06.283,0,True,
2021,1,3063,375,15,914,2,4,9,6,7,1,6,1,6,0,False,False,False,0,3,2021-09-13T12:35:36.927,7,False,1.0
2021,1,3063,380,15,2406,13,12,7,19,0,0,0,0,0,0,False,False,False,0,2,2021-09-16T22:10:35.597,0,True,0.0
2021,1,3063,395,13,902,13,12,6,19,0,0,0,0,0,0,False,False,False,0,1,2022-02-16T17:46:08.743,0,False,0.0
2021,1,3063,410,15,7514,2,51,3,-3,6,9,6,0,6,0,False,False,False,0,3,2021-09-13T18:02:41.887,6,False,0.0
2021,1,3063,420,15,6501,13,5,6,17,0,0,0,0,0,0,False,False,False,0,2,2021-09-14T01:47:17.833,0,True,0.0
2021,1,3063,435,13,4662,13,32,5,5,0,0,0,0,0,0,False,False,False,0,4,2021-09-13T19:30:23.47,0,True,
2021,1,3063,445,13,8417,13,29,5,2,0,0,0,0,0,0,False,False,False,0,2,2022-02-16T17:42:11.123,0,True,
2021,1,3063,450,13,6528,13,19,9,12,0,0,0,0,0,0,False,False,False,0,3,2021-09-16T23:30:12.147,0,False,0.0
2021,1,3063,475,15,6501,13,17,7,16,0,0,0,0,0,0,False,False,False,0,3,2021-09-13T13:26:06.62,0,False,0.0
2021,1,3063,480,15,2757,3,4,9,7,0,0,0,0,0,0,False,False,False,0,3,2021-09-13T18:02:08.293,0,False,0.0
2021,1,3063,485,15,8099,3,2,9,5,0,0,0,0,0,0,False,False,False,0,2,2021-09-13T13:32:01.363,0,False,0.0
2021,1,3063,495,13,100,2,4,5,7,7,0,7,0,7,0,False,False,False,0,2,2021-09-16T22:22:33.933,7,True,0.0
2021,1,3063,500,13,2455,2,28,5,0,2,2,2,0,2,0,False,False,False,0,1,2021-09-16T21:47:05.117,2,False,0.0
2021,1,3063,505,13,876,2,12,7,52,52,0,52,0,52,0,False,False,False,0,2,2021-09-13T13:43:40.84,52,False,0.0
2021,1,3063,515,13,100,2,13,4,4,8,4,8,0,8,6,False,False,False,0,3,2021-09-16T21:47:20.887,8,True,0.0
2021,1,3063,555,15,7591,3,26,10,3,0,0,0,0,0,0,True,False,False,0,3,2021-10-15T00:55:26.3,0,False,0.0
2021,1,3063,575,13,8417,2,4,5,6,7,1,6,1,6,0,False,False,False,0,2,2021-09-13T14:09:54.147,7,False,1.0
2021,1,3063,580,13,2455,2,30,5,-1,9,10,8,1,8,0,False,False,False,0,1,2022-02-22T19:46:51.673,9,False,1.0
2021,1,3063,600,15,6501,13,12,5,13,0,0,0,0,0,0,False,False,False,0,2,2021-09-16T22:11:09.83,0,False,0.0
2021,1,3063,610,15,8099,2,28,10,-2,5,7,2,3,2,0,False,False,False,0,1,2021-09-16T22:11:20.13,5,False,3.0
2021,1,3063,640,13,4662,2,47,5,1,3,2,2,1,2,0,False,False,False,0,1,2021-09-13T14:34:20.35,3,False,1.0
2021,1,3063,660,13,4662,2,17,1,18,29,11,20,9,20,0,False,False,False,0,4,2021-09-13T14:45:58.57,29,False,9.0
2021,1,3063,680,15,2757,2,30,10,-3,-3,0,-3,0,-3,0,True,False,False,0,4,2021-09-14T20:18:24.41,-3,False,0.0
2021,1,3063,685,15,2757,2,4,9,6,7,1,6,1,6,0,False,False,False,0,3,2021-09-13T18:51:02.463,7,False,1.0
2021,1,3063,690,15,8099,2,2,10,6,15,9,15,0,15,0,False,False,False,0,2,2021-09-16T21:47:45.5,15,False,0.0
2021,1,3063,695,15,6501,2,19,6,37,41,4,39,2,39,6,False,False,False,0,2,2021-09-13T15:09:11.53,41,False,2.0
2021,1,3063,720,13,876,3,6,1,15,0,0,0,0,0,0,False,False,False,0,3,2021-09-16T21:47:55.777,0,False,0.0
2021,1,3063,730,15,6501,13,9,6,25,0,0,0,0,0,0,False,False,False,0,2,2021-09-13T15:21:36.03,0,False,0.0
2021,1,3063,735,15,2757,2,4,4,6,7,1,7,0,7,0,False,False,False,0,3,2021-09-13T18:51:28.803,7,False,0.0
2021,1,3063,745,15,6501,13,5,2,16,0,0,0,0,0,0,False,False,False,0,3,2021-09-16T21:48:06.033,0,False,0.0
2021,1,3063,755,13,4662,13,13,5,3,0,0,0,0,0,0,False,False,False,0,4,2021-09-13T18:55:13.253,0,False,
2021,1,3063,780,13,8417,13,7,5,7,0,0,0,0,0,0,False,False,False,0,3,2021-09-13T15:45:05.023,0,False,0.0
2021,1,3063,785,13,6528,13,4,10,7,0,0,0,0,0,0,False,False,False,0,4,2021-09-13T15:47:28.783,0,False,0.0
2021,1,3063,800,15,2757,2,32,9,0,9,9,6,3,6,0,False,False,False,0,4,2022-02-16T18:02:43.2,9,False,3.0
2021,1,3063,805,15,2757,2,32,10,-2,6,8,3,3,3,0,False,False,False,1,4,2021-09-13T18:52:11.797,6,False,3.0
2021,1,3063,810,15,914,13,4,5,10,0,0,0,0,0,0,False,False,False,0,2,2021-09-16T23:30:12.147,0,False,0.0
2021,1,3063,815,15,8099,13,4,10,7,0,0,0,0,0,0,False,False,False,0,2,2022-02-25T14:33:14.623,0,False,0.0
2021,1,3063,820,15,8099,3,46,3,-1,0,0,0,0,0,0,False,False,False,0,1,2021-09-16T23:30:12.147,0,False,0.0
2021,1,3063,830,15,7591,2,4,9,14,14,0,14,0,14,0,False,False,False,0,3,2022-02-16T17:49:07.68,14,False,0.0
2021,1,3063,835,15,8099,2,48,10,-2,9,11,7,2,7,0,False,True,False,1,1,2021-09-16T21:53:44.31,9,False,2.0
2021,1,3063,840,15,7591,13,8,4,14,0,0,0,0,0,0,False,False,False,0,3,2022-02-25T14:34:12.72,0,False,0.0
2021,1,3063,850,13,876,2,50,9,-1,4,5,-1,5,-1,0,False,False,False,1,2,2021-09-13T16:21:04.58,4,False,5.0
2021,1,3063,875,15,7591,13,4,10,7,0,0,0,0,0,0,False,False,False,0,3,2021-09-13T16:32:21.91,0,False,0.0
2021,1,3063,885,15,153,2,32,5,1,5,4,3,2,3,0,False,False,False,0,1,2021-09-16T22:11:57.07,5,False,2.0
2021,1,3063,910,13,1510,2,48,10,-6,6,12,3,3,3,0,False,False,False,1,1,2021-12-21T18:21:34.643,6,False,3.0
2021,1,3063,930,13,100,2,49,9,-3,4,7,3,1,3,0,False,False,False,0,3,2021-09-13T18:00:51.153,4,False,1.0
2021,1,3063,950,15,6501,2,7,2,17,18,1,18,0,18,0,False,False,False,0,2,2021-09-13T16:57:10.66,18,False,0.0
2021,1,3063,955,15,7591,2,51,9,-3,0,3,0,0,0,0,False,False,False,0,3,2021-09-13T18:00:35.31,0,False,0.0
2021,1,3063,965,15,7591,2,6,3,5,13,8,10,3,10,0,False,False,False,0,2,2021-09-16T23:30:12.147,13,False,3.0
2021,1,3063,970,15,6501,13,2,9,9,0,0,0,0,0,0,False,False,False,0,2,2021-09-16T21:49:15.067,0,False,0.0
2021,1,3063,975,15,153,2,45,10,-5,9,14,5,4,5,0,False,False,False,0,1,2021-09-16T23:30:12.147,9,False,4.0
2021,1,3063,985,15,2757,2,17,8,17,22,5,17,5,17,0,False,False,False,0,3,2021-09-13T18:52:59.133,22,False,5.0
2021,1,3063,990,15,914,13,9,2,17,0,0,0,0,0,0,False,False,False,0,2,2021-09-16T22:01:50.72,0,False,0.0
2021,1,3063,1000,15,914,2,7,2,17,18,1,18,0,18,0,False,False,False,0,2,2021-09-13T17:17:08.55,18,False,0.0
2021,1,3063,1005,15,914,13,35,9,4,0,0,0,0,0,0,False,False,False,0,3,2021-09-16T21:49:56.643,0,False,0.0
2021,1,3063,1010,15,914,2,36,4,4,4,0,4,0,4,6,False,False,False,0,3,2021-09-13T17:21:48.1,4,True,0.0
2021,1,3064,10,26,7453,2,44,3,-3,10,13,10,0,10,0,True,False,False,0,3,2021-09-13T12:33:04.197,10,True,0.0
2021,1,3064,15,26,958,2,5,10,5,6,1,5,1,5,0,False,False,False,0,3,2021-09-15T02:33:25.55,6,False,1.0
2021,1,3064,25,26,4619,2,5,3,5,9,4,7,2,7,0,False,False,False,0,2,2021-09-17T19:27:48.957,9,False,2.0
2021,1,3064,35,26,4619,2,4,10,10,11,1,10,1,10,0,False,False,False,0,2,2022-02-16T22:26:59.837,11,False,1.0
2021,1,3064,45,26,958,2,12,3,-3,-3,0,-3,0,-3,0,False,False,False,0,4,2021-09-17T17:48:34.063,-3,False,0.0
2021,1,3064,55,26,309,2,16,4,2,7,5,4,3,4,0,True,False,False,0,1,2021-09-14T19:34:39.01,7,False,3.0
2021,1,3064,80,32,7807,2,4,4,2,2,0,2,0,2,0,False,False,False,0,1,2021-09-17T19:51:20.38,2,False,0.0
2021,1,3064,85,32,8527,13,35,5,8,0,0,0,0,0,0,False,False,False,0,3,2021-09-17T19:52:10.49,0,False,0.0
2021,1,3064,95,26,309,13,5,3,11,0,0,0,0,0,0,False,False,False,0,3,2021-10-15T00:56:53.637,0,False,0.0
2021,1,3064,105,26,6301,2,46,3,-1,2,3,0,2,0,0,False,False,False,0,1,2021-09-13T13:28:41.473,2,False,2.0
2021,1,3064,130,32,2675,2,5,5,4,6,2,6,0,6,0,False,False,False,0,3,2021-09-17T19:27:21.653,6,True,0.0
2021,1,3064,150,26,309,2,18,3,-1,11,12,0,11,0,0,False,False,False,1,3,2021-09-17T18:24:09.81,11,False,11.0
2021,1,3064,155,26,958,13,8,9,13,0,0,0,0,0,0,False,False,False,0,3,2021-09-17T19:52:28.893,0,False,0.0
2021,1,3064,160,26,7697,2,26,10,4,4,0,4,0,4,0,False,False,False,0,3,2021-09-17T19:57:13.44,4,False,0.0
2021,1,3064,165,26,7453,13,13,4,3,0,0,0,0,0,0,False,False,False,0,3,2022-02-16T22:25:15.787,0,False,0.0
2021,1,3064,175,32,7807,2,50,5,1,5,4,3,2,3,0,True,False,False,1,2,2021-09-17T17:24:43.067,5,False,2.0
2021,1,3064,200,32,8527,13,8,1,55,0,0,0,0,0,0,False,False,False,0,3,2021-09-13T18:34:35.63,0,False,
2021,1,3064,210,32,7807,3,4,5,5,0,0,0,0,0,0,False,False,False,0,2,2021-09-13T18:13:39.893,0,False,0.0
2021,1,3064,230,26,4619,2,9,2,16,18,2,17,1,17,0,False,False,False,0,2,2021-09-17T16:47:05.92,18,False,1.0
2021,1,3064,240,26,309,2,5,9,11,16,5,15,1,15,0,False,False,False,0,3,2021-09-13T14:15:20.637,16,False,1.0
2021,1,3064,250,26,309,2,47,5,2,10,8,9,1,9,0,False,False,False,0,3,2021-09-17T19:57:23.39,10,False,1.0
2021,1,3064,255,26,7453,2,7,6,18,22,4,18,4,18,0,False,False,False,0,3,2021-09-13T14:22:07,22,False,4.0
2021,1,3064,260,26,4619,3,2,10,4,0,0,0,0,0,0,False,False,False,0,2,2022-02-16T22:15:03.413,0,False,0.0
2021,1,3064,275,26,309,3,5,3,7,0,0,0,0,0,0,True,False,False,0,3,2021-09-13T14:27:59.453,0,False,0.0
2021,1,3064,290,32,3885,13,45,10,-9,0,0,0,0,0,0,True,False,False,0,1,2021-09-13T19:23:53.09,0,False,0.0
2021,1,3064,295,32,8527,13,3,2,18,0,0,0,0,0,0,False,False,False,0,2,2021-09-13T19:23:28.13,0,False,0.0
2021,1,3064,300,32,8527,13,5,5,11,0,0,0,0,0,0,False,False,False,0,3,2021-09-13T19:23:39.137,0,False,0.0
2021,1,3064,315,26,4050,2,5,9,0,1,1,1,0,1,0,False,False,False,0,4,2021-09-17T19:24:36.327,1,False,0.0
2021,1,3064,320,26,309,13,26,9,3,0,0,0,0,0,0,False,False,False,0,2,2021-09-17T19:28:04.78,0,False,
2021,1,3064,330,26,4619,2,2,10,4,6,2,4,2,4,0,False,False,False,0,3,2021-09-13T18:04:02.127,6,False,2.0
2021,1,3064,340,26,958,3,46,6,15,0,0,0,0,0,0,False,False,False,0,4,2021-09-17T19:57:59.233,0,False,0.0
2021,1,3064,345,26,4619,2,6,4,10,11,1,10,1,10,0,False,False,False,0,3,2021-09-17T19:58:11.867,11,False,
2021,1,3064,350,26,7453,2,18,5,-1,17,18,4,13,4,0,False,False,False,2,2,2021-09-13T19:18:21.107,17,False,13.0
2021,1,3064,355,26,4619,2,4,5,3,4,1,3,1,3,0,False,False,False,0,2,2021-09-13T15:01:11.36,4,False,1.0
2021,1,3064,365,26,8552,2,5,6,16,17,1,17,0,17,0,False,False,False,0,2,2021-09-17T19:28:20.83,17,False,0.0
2021,1,3064,370,26,4619,2,2,4,3,11,8,6,5,6,0,False,False,False,0,2,2021-09-17T18:20:36.597,11,False,5.0
2021,1,3064,410,26,7453,3,35,10,6,0,0,0,0,0,0,False,False,False,0,3,2021-10-15T00:57:35.33,0,False,0.0
2021,1,3064,425,26,958,13,8,4,9,0,0,0,0,0,0,False,False,False,0,3,2021-09-17T19:28:33.603,0,False,0.0
2021,1,3064,445,32,7128,13,19,6,33,0,0,0,0,0,0,False,False,False,0,2,2021-10-15T00:58:04.227,0,False,
2021,1,3064,450,32,1427,2,5,3,8,12,4,12,0,12,0,False,False,False,0,3,2021-09-17T19:59:33.483,12,True,0.0
2021,1,3064,455,32,1427,2,5,3,6,7,1,7,0,7,0,False,False,False,0,3,2021-09-13T19:24:37.04,7,True,0.0
2021,1,3064,490,32,7807,2,4,4,0,11,11,0,11,0,0,False,False,False,1,1,2021-09-17T19:58:51.577,11,False,11.0
2021,1,3064,500,32,7128,2,50,10,-2,9,11,4,5,4,0,False,False,False,0,2,2021-09-13T19:25:13.587,9,False,5.0
2021,1,3064,505,32,7128,2,26,9,2,2,0,2,0,2,0,False,False,False,0,3,2021-09-13T19:25:24.227,2,False,0.0
2021,1,3064,515,32,7128,2,22,7,33,34,1,33,1,33,0,False,False,False,0,2,2021-09-13T19:25:35.973,34,False,1.0
2021,1,3064,520,32,1427,2,35,9,11,11,0,0,11,0,6,False,False,False,0,4,2021-09-17T19:26:02.66,11,False,11.0
2021,1,3064,540,26,309,2,5,10,5,7,2,6,1,6,0,False,False,False,0,3,2021-09-13T16:02:26.9,7,False,1.0
2021,1,3064,545,26,958,2,47,5,2,11,9,7,4,7,0,False,False,False,0,4,2021-09-17T16:50:04.587,11,False,4.0
2021,1,3064,550,26,309,13,19,2,34,0,0,0,0,0,0,False,False,False,0,2,2021-09-15T02:34:45.593,0,False,0.0
2021,1,3064,555,26,4619,13,29,2,16,0,0,0,0,0,0,False,False,False,0,2,2021-09-17T19:55:33.447,0,False,0.0
2021,1,3064,560,26,958,2,7,3,12,23,11,19,4,19,0,False,False,False,0,3,2021-09-17T19:29:03.613,23,False,4.0
2021,1,3064,570,26,4619,3,20,6,20,0,0,0,0,0,0,False,False,False,0,2,2021-09-13T16:14:24.143,0,False,0.0
2021,1,3064,580,26,309,2,7,3,4,6,2,4,2,4,0,True,False,False,0,3,2021-09-13T16:19:31.65,6,False,2.0
2021,1,3064,600,32,6430,2,6,1,16,17,1,16,1,16,0,False,False,False,0,2,2021-09-17T17:59:04.54,17,False,1.0
2021,1,3064,615,32,8659,13,46,3,-2,0,0,0,0,0,0,False,False,False,0,1,2022-02-16T22:30:57.203,0,False,0.0
2021,1,3064,640,32,7128,2,12,3,9,17,8,15,2,15,0,False,False,False,0,3,2021-09-17T19:59:41.42,17,False,2.0
2021,1,3064,665,32,8527,2,18,5,-2,-2,0,-2,0,-2,0,False,False,False,0,2,2021-09-13T19:26:57.78,-2,False,0.0
2021,1,3064,675,26,958,2,8,1,15,19,4,18,1,18,0,False,False,False,0,4,2021-09-13T16:57:58.213,19,False,1.0
2021,1,3064,685,26,4619,13,4,9,11,0,0,0,0,0,0,False,False,False,0,3,2021-10-15T00:59:21.04,0,False,0.0
2021,1,3064,690,26,309,2,5,2,17,17,0,17,0,17,0,False,True,False,1,3,2021-09-17T18:25:03.277,17,False,0.0
2021,1,3064,695,26,4050,13,7,2,16,0,0,0,0,0,0,False,False,False,0,1,2021-09-17T18:01:01.177,0,False,0.0
2021,1,3064,710,26,7491,13,12,5,3,0,0,0,0,0,0,False,False,False,0,4,2021-09-17T16:52:42.313,0,False,0.0
2021,1,3064,715,26,4619,2,29,3,3,3,0,3,0,3,6,False,False,False,0,2,2022-02-16T22:37:59.303,3,False,0.0
2021,1,3064,730,32,7807,3,48,10,-4,0,0,0,0,0,0,False,False,False,0,1,2021-09-17T19:59:50.513,0,False,0.0
2021,1,3064,740,32,2675,13,5,10,3,0,0,0,0,0,0,True,False,False,0,3,2021-09-17T19:55:47.297,0,False,
2021,1,3064,765,32,8527,2,51,10,-2,0,2,0,0,0,0,False,False,False,0,3,2021-09-17T17:49:43.39,0,False,
2021,1,3064,770,32,2675,2,18,3,-1,4,5,2,2,2,0,False,False,False,0,2,2021-09-13T17:29:43.8,4,False,2.0
2021,1,3064,795,26,309,2,8,1,16,18,2,18,0,18,0,False,False,False,0,3,2021-09-17T19:17:15.497,18,False,
2021,1,3064,805,26,309,2,4,1,15,17,2,17,0,17,0,False,False,False,0,3,2021-09-13T17:40:22.587,17,False,0.0
2021,1,3064,810,26,309,13,18,9,-2,0,0,0,0,0,0,False,False,False,0,3,2021-09-17T19:59:22.197,0,False,0.0
2021,1,3064,815,26,7697,2,5,3,4,7,3,6,1,6,0,False,False,False,0,3,2021-09-13T17:44:05.107,7,False,1.0
2021,1,3064,820,26,7697,2,6,9,12,19,7,14,5,14,0,False,False,False,0,3,2021-09-13T17:45:51.8,19,False,5.0
2021,1,3064,835,26,4619,2,7,6,19,20,1,19,1,19,0,False,False,False,0,3,2021-09-17T19:18:10.923,20,False,1.0
2021,1,3064,865,26,309,2,16,10,5,9,4,9,0,9,0,True,False,False,0,3,2021-09-17T16:56:15.443,9,False,0.0
2021,1,3065,15,14,1119,13,39,4,4,0,0,0,0,0,0,False,False,False,0,3,2021-09-13T09:36:37.36,0,False,0.0
2021,1,3065,25,14,8403,2,6,9,10,10,0,10,0,10,0,False,False,False,0,2,2021-09-13T09:40:02.51,10,False,0.0
2021,1,3065,30,14,4449,2,44,3,-3,6,9,4,2,4,0,True,False,False,0,3,2021-09-13T15:24:35.893,6,False,2.0
2021,1,3065,50,14,6543,2,6,10,6,10,4,9,1,9,0,False,False,False,0,2,2021-09-13T10:06:31.49,10,False,1.0
2021,1,3065,75,14,7582,2,48,9,-5,7,12,5,2,5,0,False,False,False,0,1,2021-09-13T10:17:32.08,7,False,2.0
2021,1,3065,135,27,650,2,17,1,23,23,0,23,0,23,6,True,False,False,0,3,2021-09-17T18:40:14.55,23,True,0.0
2021,1,3065,180,27,4850,2,53,10,-3,11,14,8,3,8,0,False,False,False,0,4,2021-09-13T15:30:11.317,11,False,3.0
2021,1,3065,190,27,6397,2,5,3,3,6,3,5,1,5,0,False,False,False,0,3,2021-09-13T10:54:46.597,6,False,1.0
2021,1,3065,200,27,6397,2,7,2,16,22,6,20,2,20,0,False,False,False,0,4,2021-09-17T18:06:54.38,22,False,2.0
2021,1,3065,210,27,4850,2,13,4,5,9,4,9,0,9,6,False,False,False,0,2,2021-09-17T19:27:43.143,9,True,0.0
2021,1,3065,225,14,6938,2,35,2,22,24,2,24,0,24,0,False,False,False,0,3,2021-09-13T15:31:57.63,24,False,0.0
2021,1,3065,230,14,6543,2,4,5,6,6,0,6,0,6,0,False,False,False,0,2,2021-09-17T18:06:54.38,6,False,0.0
2021,1,3065,245,14,7582,2,4,4,4,10,6,7,3,7,0,False,False,False,0,1,2021-09-17T19:11:36.247,10,False,3.0
2021,1,3065,255,14,7584,2,13,4,4,14,10,11,3,11,0,False,False,False,0,3,2021-09-13T11:52:26.433,14,False,3.0
2021,1,3065,260,14,4449,2,36,10,10,10,0,10,0,10,6,False,False,False,0,3,2021-09-17T18:06:54.38,10,True,0.0
2021,1,3065,275,27,5050,2,47,10,0,16,16,10,6,10,0,False,False,False,1,1,2021-09-13T11:58:02.433,16,False,6.0
2021,1,3065,285,27,650,2,4,10,4,4,0,4,0,4,0,False,False,False,0,3,2021-09-13T12:00:58.207,4,False,0.0
2021,1,3065,290,27,7852,13,26,9,4,0,0,0,0,0,0,False,False,False,0,3,2021-09-13T12:03:02.83,0,False,0.0
2021,1,3065,300,14,7582,2,5,5,4,8,4,6,2,6,0,False,False,False,0,1,2021-09-14T20:02:38.453,8,False,2.0
2021,1,3065,310,14,7584,2,30,3,5,12,7,7,5,7,0,True,False,False,1,4,2021-09-17T19:17:36.737,12,False,
2021,1,3065,315,14,5197,13,29,2,23,0,0,0,0,0,0,False,False,False,0,3,2021-09-13T12:14:55.467,0,False,0.0
2021,1,3065,340,27,8472,2,4,3,6,6,0,6,0,6,0,False,False,False,0,2,2021-09-13T12:23:35.81,6,False,0.0
2021,1,3065,350,27,4850,2,53,9,-4,21,25,9,12,9,0,False,False,False,0,4,2021-09-13T12:26:49.853,21,False,
2021,1,3065,360,27,650,2,23,1,51,69,18,59,10,59,6,False,False,False,1,2,2021-09-13T12:38:47.91,69,False,10.0
2021,1,3065,375,14,6543,13,5,3,0,0,0,0,0,0,0,False,False,False,0,1,2021-09-13T12:41:42.043,0,False,0.0
2021,1,3065,380,14,6543,2,48,10,-4,4,8,2,2,2,0,False,False,False,0,1,2021-09-13T12:42:54.883,4,False,2.0
2021,1,3065,390,14,1119,2,32,5,4,5,1,5,0,5,0,False,False,False,0,3,2021-09-13T15:38:18.303,5,False,0.0
2021,1,3065,415,27,5050,2,46,3,1,4,3,3,1,3,0,False,False,False,1,1,2021-09-13T12:50:46.817,4,False,1.0
2021,1,3065,420,27,7408,2,4,4,7,12,5,10,2,10,0,False,False,False,0,3,2021-09-17T18:06:54.38,12,False,2.0
2021,1,3065,435,27,650,13,24,6,27,0,0,0,0,0,0,False,False,False,0,2,2021-09-17T19:18:18.263,0,False,0.0
2021,1,3065,450,14,7582,2,48,9,-7,7,14,4,3,4,0,False,False,False,0,1,2021-09-13T13:00:23.557,7,False,3.0
2021,1,3065,455,14,6938,13,12,4,11,0,0,0,0,0,0,False,False,False,0,2,2021-09-17T19:06:02.43,0,False,0.0
2021,1,3065,480,27,7850,2,45,5,-3,5,8,4,1,4,0,False,False,False,0,1,2021-09-13T13:10:38.867,5,False,1.0
2021,1,3065,495,14,7584,13,12,4,4,0,0,0,0,0,0,False,False,False,0,2,2021-09-17T19:06:29.91,0,False,0.0
2021,1,3065,520,27,7408,2,30,5,-1,3,4,2,1,2,0,True,False,False,0,2,2021-09-13T13:21:47.503,3,False,1.0
2021,1,3065,530,14,7582,2,48,9,-4,15,19,13,2,13,0,False,False,False,0,1,2021-09-13T13:27:50.74,15,False,2.0
2021,1,3065,560,27,6397,2,28,3,2,9,7,4,5,4,0,True,False,False,1,4,2021-09-13T13:57:22.643,9,False,5.0
2021,1,3065,575,27,7408,13,19,2,35,0,0,0,0,0,0,False,False,False,0,2,2021-09-13T14:03:35.28,0,False,0.0
2021,1,3065,590,14,4449,3,2,4,8,0,0,0,0,0,0,False,False,False,0,3,2021-09-13T14:08:24.24,0,False,0.0
2021,1,3065,595,14,8403,2,6,8,16,16,0,16,0,16,0,False,False,False,0,2,2021-09-13T14:10:09.863,16,False,0.0
2021,1,3065,620,14,6938,13,7,2,18,0,0,0,0,0,0,False,False,False,0,3,2021-09-13T14:15:05.59,0,False,0.0
2021,1,3065,625,14,6543,2,48,10,-3,8,11,6,2,6,0,False,False,False,0,1,2021-09-13T14:17:00.557,8,False,2.0
2021,1,3065,630,14,1119,2,47,5,2,9,7,9,0,9,0,False,False,False,0,3,2021-09-13T14:18:14.39,9,True,0.0
2021,1,3065,640,14,1119,2,4,4,7,7,0,7,0,7,0,False,False,False,0,4,2021-09-13T14:21:30.567,7,False,0.0
2021,1,3065,645,14,6543,13,4,10,5,0,0,0,0,0,0,True,False,False,0,3,2021-09-13T14:22:28.983,0,False,0.0
2021,1,3065,655,14,7584,2,2,10,5,8,3,7,1,7,0,False,False,False,2,2,2021-09-13T14:29:44.32,8,False,1.0
2021,1,3065,665,27,7408,2,5,6,20,30,10,26,4,26,0,False,False,False,0,3,2021-09-13T14:33:07.717,30,False,4.0
2021,1,3065,670,27,5050,2,51,10,-6,6,12,3,3,3,0,False,False,False,2,1,2021-09-17T19:15:07.507,6,False,3.0
2021,1,3065,675,27,650,2,4,5,4,4,0,4,0,4,0,False,False,False,0,2,2021-09-13T14:37:33.5,4,False,0.0
2021,1,3065,695,27,7408,2,8,7,15,15,0,15,0,15,6,False,False,False,0,3,2021-09-13T14:45:18.047,15,True,0.0
2021,1,3065,710,14,7582,2,32,10,0,13,13,10,3,10,0,False,False,False,0,1,2021-09-13T14:47:57.107,13,False,3.0
2021,1,3065,725,14,7582,3,12,3,0,0,0,0,0,0,0,False,False,False,0,1,2022-02-01T19:11:35.323,0,False,0.0
2021,1,3065,730,14,7584,2,3,5,6,7,1,7,0,7,0,False,False,False,0,2,2021-09-17T19:16:52.07,7,False,0.0
2021,1,3065,735,14,8403,13,5,5,13,0,0,0,0,0,0,False,False,False,0,2,2021-09-13T14:54:53.97,0,False,
2021,1,3065,740,14,6543,2,38,4,0,1,1,1,0,1,0,False,False,False,0,1,2021-09-17T19:17:11.757,1,False,0.0
2021,1,3065,745,14,4449,2,6,4,14,16,2,16,0,16,0,False,False,False,0,3,2021-09-13T14:59:57.55,16,False,0.0
2021,1,3065,765,14,4449,2,8,10,11,11,0,11,0,11,6,False,False,False,0,3,2021-09-13T15:06:27.787,11,True,0.0
2021,1,3065,825,14,6543,2,47,10,0,19,19,19,0,19,0,False,False,False,0,1,2021-09-13T15:21:12.36,19,True,0.0
2021,1,3065,830,14,5197,13,47,5,3,0,0,0,0,0,0,False,False,False,0,3,2021-09-17T19:18:51.657,0,False,0.0
2021,1,3066,15,22,2391,2,46,3,1,7,6,5,2,5,0,False,False,False,0,4,2021-09-13T10:01:53.717,7,False,2.0
2021,1,3066,40,22,8451,3,50,3,-2,0,0,0,0,0,0,False,False,False,0,2,2021-09-13T10:01:33.003,0,False,0.0
2021,1,3066,50,5,4799,2,51,10,-4,11,15,6,5,6,0,False,False,False,0,1,2021-09-13T10:13:49.41,11,False,5.0
2021,1,3066,59,5,4799,2,48,3,-6,18,24,5,13,5,0,False,False,False,0,1,2021-09-17T17:06:48.953,18,False,
2021,1,3066,70,5,8406,13,29,2,20,0,0,0,0,0,0,False,False,False,0,3,2021-09-13T10:29:34.537,0,False,0.0
2021,1,3066,85,22,5080,13,12,2,41,0,0,0,0,0,0,False,False,False,0,2,2021-09-15T01:47:48.983,0,False,0.0
2021,1,3066,90,22,6812,13,22,2,24,0,0,0,0,0,0,False,False,False,0,2,2021-09-17T17:18:57.907,0,False,0.0
2021,1,3066,110,5,5220,2,4,3,9,13,4,9,4,9,0,False,False,False,0,2,2021-09-17T17:18:25.47,13,False,4.0
2021,1,3066,115,5,5220,2,34,4,-3,-5,-2,-5,0,-5,0,True,False,False,0,3,2021-09-17T15:03:53.66,-5,False,0.0
2021,1,3066,120,5,8406,2,5,9,6,8,2,7,1,7,0,True,False,False,0,3,2021-09-14T20:54:04.197,8,False,1.0
2021,1,3066,125,5,5152,2,46,3,0,1,1,1,0,1,0,False,False,False,0,3,2021-09-13T11:05:08.887,1,False,0.0
2021,1,3066,155,22,8454,3,13,4,2,0,0,0,0,0,0,False,False,False,0,3,2021-09-13T11:19:32.777,0,False,0.0
2021,1,3066,160,22,8454,13,19,8,50,0,0,0,0,0,0,True,False,False,0,2,2021-09-17T15:03:53.66,0,False,0.0
2021,1,3066,180,5,5220,3,2,9,11,0,0,0,0,0,0,False,False,False,0,2,2021-09-13T11:31:23.103,0,False,0.0
2021,1,3066,185,5,4799,2,2,10,5,9,4,6,3,6,0,True,False,False,0,3,2021-09-13T11:34:10.593,9,False,3.0
2021,1,3066,205,5,5220,2,7,2,23,26,3,26,0,26,0,False,False,False,0,2,2022-02-16T17:01:00.78,26,False,0.0
2021,1,3066,210,5,4799,2,48,9,-2,5,7,3,2,3,0,False,False,False,0,1,2021-09-13T11:43:02.553,5,False,2.0
2021,1,3066,215,5,5220,2,29,6,27,27,0,26,1,26,0,False,False,False,0,2,2021-09-13T16:36:18.627,27,False,1.0
2021,1,3066,220,5,6425,13,17,3,13,0,0,0,0,0,0,False,False,False,0,4,2021-09-17T15:04:14.627,0,False,0.0
2021,1,3066,245,22,5080,2,35,10,13,35,22,17,18,17,0,False,False,False,2,3,2021-09-13T12:05:06.18,35,False,18.0
2021,1,3066,255,22,2391,3,32,4,0,0,0,0,0,0,0,False,False,False,0,4,2022-02-16T16:57:48.63,0,False,0.0
2021,1,3066,260,22,2391,13,36,5,10,0,0,0,0,0,0,False,False,False,0,4,2021-09-17T16:50:06.337,0,False,0.0
2021,1,3066,265,5,4799,2,47,10,2,15,13,12,3,12,0,False,False,False,0,1,2021-09-17T17:09:07.873,15,False,3.0
2021,1,3066,270,5,4799,2,48,10,-3,11,14,8,3,8,0,True,False,False,0,1,2021-09-13T12:23:00.193,11,False,3.0
2021,1,3066,285,5,8406,13,5,5,3,0,0,0,0,0,0,True,False,False,0,3,2021-09-14T20:54:21.277,0,False,0.0
2021,1,3066,300,22,7118,13,12,5,13,0,0,0,0,0,0,False,False,False,0,3,2021-09-17T17:27:22.447,0,False,0.0
2021,1,3066,305,22,2629,2,47,5,3,10,7,7,3,7,0,False,False,False,1,4,2021-09-13T12:36:20.933,10,False,3.0
2021,1,3066,310,22,8451,2,46,9,2,14,12,12,2,12,0,False,False,False,0,1,2021-09-17T15:03:53.66,14,False,2.0
2021,1,3066,320,22,2629,2,4,9,5,10,5,7,3,7,0,False,False,False,0,4,2021-09-13T12:44:12.76,10,False,3.0
2021,1,3066,325,22,2629,13,32,10,0,0,0,0,0,0,0,False,False,False,0,4,2022-02-16T16:58:09.957,0,False,0.0
2021,1,3066,340,5,3477,2,8,8,44,57,13,57,0,57,6,False,False,False,0,3,2022-02-16T16:58:31.397,57,True,0.0
2021,1,3066,355,22,2629,13,5,5,5,0,0,0,0,0,0,False,False,False,0,4,2021-09-13T12:56:52.783,0,False,0.0
2021,1,3066,360,22,6270,2,4,9,5,8,3,7,1,7,0,False,False,False,0,3,2021-09-13T12:59:20.297,8,False,1.0
2021,1,3066,385,5,4799,2,16,10,4,14,10,12,2,12,0,False,False,False,0,1,2021-09-17T16:52:54.29,14,False,2.0
2021,1,3066,390,5,4799,2,12,3,2,4,2,4,0,4,0,False,False,False,0,1,2021-09-13T13:10:15.017,4,False,0.0
2021,1,3066,395,5,5152,2,5,3,3,5,2,5,0,5,0,True,False,False,0,4,2021-09-13T13:13:22.647,5,False,0.0
2021,1,3066,400,5,8406,2,2,10,7,11,4,9,2,9,0,False,False,False,0,3,2021-09-13T13:19:12.173,11,False,2.0
2021,1,3066,405,5,4799,2,6,4,4,22,18,14,8,14,0,False,False,False,2,1,2022-02-16T16:59:49.933,22,False,8.0
2021,1,3066,445,5,3477,13,5,9,13,0,0,0,0,0,0,False,False,False,0,3,2021-09-17T17:10:43.05,0,False,0.0
2021,1,3066,470,22,6270,13,44,3,-2,0,0,0,0,0,0,True,False,False,0,3,2021-09-15T01:39:08.293,0,False,0.0
2021,1,3066,475,22,2629,13,35,10,11,0,0,0,0,0,0,False,False,False,0,3,2021-09-17T15:03:53.66,0,False,
2021,1,3066,480,22,8454,2,34,4,-4,-3,1,-3,0,-3,0,True,False,False,0,3,2021-09-15T01:39:24.43,-3,False,0.0
2021,1,3066,485,22,2391,13,4,9,4,0,0,0,0,0,0,True,False,False,0,4,2021-09-13T13:45:36.077,0,False,0.0
2021,1,3066,490,22,6270,13,6,9,7,0,0,0,0,0,0,False,False,False,0,3,2021-09-13T13:49:36.263,0,False,0.0
2021,1,3066,505,5,6425,2,13,10,2,17,15,11,6,11,0,False,False,False,0,4,2021-09-17T17:02:47.217,17,False,6.0
2021,1,3066,510,5,8409,2,46,3,1,1,0,1,0,1,0,False,False,False,0,1,2021-09-13T13:59:43.58,1,False,0.0
2021,1,3066,515,5,3477,13,19,2,32,0,0,0,0,0,0,False,False,False,0,2,2021-09-13T14:01:53.46,0,False,0.0
2021,1,3066,520,5,5152,13,4,10,12,0,0,0,0,0,0,False,False,False,0,3,2021-09-13T14:04:39.463,0,False,0.0
2021,1,3066,535,22,6270,2,50,3,-3,1,4,1,0,1,0,False,False,False,0,3,2021-09-17T16:49:38.473,1,False,0.0
2021,1,3066,540,22,6812,2,12,3,4,11,7,11,0,11,0,False,False,False,0,4,2021-09-15T01:48:25.803,11,False,0.0
2021,1,3066,555,5,5220,13,7,6,19,0,0,0,0,0,0,False,False,False,0,3,2021-09-13T14:20:39.86,0,False,0.0
2021,1,3066,560,5,8406,3,5,5,14,0,0,0,0,0,0,False,False,False,0,4,2021-09-13T16:48:19.653,0,False,0.0
2021,1,3066,580,22,5080,2,6,7,19,20,1,20,0,20,0,False,False,False,0,2,2021-09-17T15:03:53.66,20,False,0.0
2021,1,3066,585,22,2391,2,4,9,5,7,2,7,0,7,0,False,False,False,0,4,2021-09-17T15:03:53.66,7,False,0.0
2021,1,3066,600,22,2391,2,31,10,4,8,4,5,3,5,0,False,False,False,0,4,2021-09-17T17:03:47.08,8,False,3.0
2021,1,3066,615,22,5080,2,12,2,22,22,0,22,0,22,6,False,False,False,0,3,2021-09-13T14:48:38.963,22,True,0.0
2021,1,3066,645,5,5220,2,4,4,5,7,2,7,0,7,0,False,False,False,0,3,2021-09-13T15:11:48.54,7,False,0.0
2021,1,3066,670,5,5220,2,50,9,-1,12,13,8,4,8,0,False,False,False,1,2,2021-09-13T15:11:20.35,12,False,4.0
2021,1,3066,685,5,8406,2,50,9,-2,7,9,5,2,5,0,False,False,False,0,3,2021-09-13T15:20:18.017,7,False,2.0
2021,1,3066,710,22,5080,3,5,3,5,0,0,0,0,0,0,False,False,False,0,3,2021-09-13T15:26:19.76,0,False,0.0
2021,1,3066,740,5,8409,2,4,9,0,3,3,3,0,3,0,False,False,False,0,1,2021-09-13T15:37:59.123,3,False,0.0
2021,1,3066,745,5,4799,2,47,10,-6,-2,4,-4,2,-4,0,False,False,False,0,1,2021-09-17T16:53:40.18,-2,False,2.0
2021,1,3066,760,22,2629,2,46,3,3,6,3,5,1,5,0,False,False,False,0,4,2021-09-15T01:38:54.823,6,False,1.0
2021,1,3066,765,22,8454,2,19,7,19,22,3,22,0,22,0,False,False,False,0,2,2021-09-17T15:03:53.66,22,False,
2021,1,3066,770,22,6270,2,6,4,12,15,3,13,2,13,0,False,False,False,0,3,2021-09-13T15:54:27.827,15,False,2.0
2021,1,3066,775,22,6270,2,46,3,2,2,0,2,0,2,0,False,False,False,0,3,2021-09-13T15:56:07.653,2,False,0.0
2021,1,3066,780,22,6812,3,47,10,-1,0,0,0,0,0,0,False,False,False,0,1,2021-09-17T16:53:53.827,0,False,0.0
2021,1,3066,785,22,8454,13,8,6,38,0,0,0,0,0,0,False,False,False,0,3,2021-09-13T16:01:54.027,0,False,0.0
2021,1,3066,790,22,6270,2,8,7,17,25,8,22,3,22,0,False,False,False,0,3,2021-09-17T15:03:53.673,25,False,3.0
2021,1,3066,795,22,7610,2,12,6,30,40,10,35,5,35,0,False,False,False,0,2,2022-02-16T17:04:33.75,40,False,5.0
2021,1,3066,805,22,5080,2,13,4,4,12,8,10,2,10,0,False,False,False,0,2,2021-09-13T16:14:21.647,12,False,2.0
2021,1,3066,815,22,5080,2,5,5,8,8,0,8,0,8,6,False,False,False,0,2,2021-09-17T16:54:05.873,8,True,0.0
2021,1,3067,15,18,4572,2,51,5,-5,9,14,6,3,6,0,False,False,False,0,1,2021-09-18T09:37:55.957,9,False,3.0
2021,1,3067,25,18,6361,2,6,4,5,6,1,5,1,5,0,False,False,False,0,4,2021-09-14T16:35:53.803,6,False,1.0
2021,1,3067,30,18,1381,2,5,3,12,12,0,12,0,12,0,True,False,False,0,3,2021-09-14T16:36:16.347,12,False,0.0
2021,1,3067,45,18,1381,2,39,4,4,4,0,4,0,4,0,False,False,False,0,3,2022-02-16T17:21:31.897,4,False,
2021,1,3067,50,18,7711,3,6,9,11,0,0,0,0,0,0,False,False,False,0,3,2021-09-18T06:57:20.417,0,False,0.0
2021,1,3067,55,18,4940,2,2,9,6,11,5,12,-1,12,0,False,False,False,0,3,2021-09-13T11:00:03.83,11,False,-1.0
2021,1,3067,65,7,4679,2,48,9,-2,5,7,4,1,4,0,False,False,False,0,1,2021-09-13T11:03:51.963,5,False,1.0
2021,1,3067,80,7,3521,3,46,3,3,0,0,0,0,0,0,False,False,False,0,3,2021-12-23T22:02:09.94,0,False,0.0
2021,1,3067,85,7,2631,2,51,3,-1,3,4,0,3,0,0,False,False,False,0,4,2021-09-18T06:57:20.417,3,False,3.0
2021,1,3067,110,18,1381,3,6,3,10,0,0,0,0,0,0,False,False,False,0,2,2021-09-13T11:25:44.727,0,False,0.0
2021,1,3067,130,7,4455,2,44,3,-5,7,12,5,2,5,0,False,False,False,0,1,2022-02-16T17:20:13.953,7,False,2.0
2021,1,3067,140,18,4572,2,46,3,0,9,9,6,3,6,0,False,False,False,0,1,2021-09-13T11:37:30.99,9,False,3.0
2021,1,3067,155,18,7711,2,50,10,-4,-1,3,-1,0,-1,0,False,False,False,0,3,2021-09-18T06:57:20.417,-1,False,0.0
2021,1,3067,180,7,7659,13,6,10,6,0,0,0,0,0,0,False,False,False,0,2,2021-12-23T22:02:36.393,0,False,0.0
2021,1,3067,200,18,7711,13,9,6,37,0,0,0,0,0,0,False,False,False,0,2,2021-09-18T09:43:01.64,0,False,0.0
2021,1,3067,210,18,6361,2,32,10,1,2,1,2,0,2,0,False,False,False,0,4,2021-09-14T16:36:55.897,2,False,0.0
2021,1,3067,220,18,4572,2,48,9,-4,9,13,6,3,6,0,False,False,False,0,1,2021-09-18T09:15:58.637,9,False,3.0
2021,1,3067,225,18,6900,2,45,5,-4,4,8,1,3,1,0,False,False,False,0,1,2021-09-18T09:33:06.66,4,False,3.0
2021,1,3067,235,18,7711,2,35,3,12,17,5,17,0,17,0,False,False,False,0,2,2022-02-16T17:23:23.08,17,False,0.0
2021,1,3067,240,18,7712,2,35,5,11,11,0,11,0,11,0,False,False,False,0,3,2021-09-13T19:20:56.467,11,True,0.0
2021,1,3067,255,18,1381,13,12,5,13,0,0,0,0,0,0,False,False,False,0,2,2021-09-18T09:43:26.983,0,False,
2021,1,3067,265,18,7712,2,47,5,4,25,21,8,17,8,0,False,False,False,1,3,2021-09-13T12:44:05.04,25,False,17.0
2021,1,3067,285,18,1381,2,5,5,5,5,0,5,0,5,6,False,False,False,0,2,2021-09-13T12:51:13.323,5,True,0.0
2021,1,3067,300,7,4679,2,26,3,2,12,10,10,2,10,0,False,False,False,0,3,2021-09-18T09:19:22.26,12,False,2.0
2021,1,3067,315,7,8317,2,5,6,17,17,0,17,0,17,0,False,False,False,0,3,2021-09-18T09:43:50.063,17,False,0.0
2021,1,3067,330,7,8317,2,2,5,5,13,8,9,4,9,0,False,False,False,0,2,2021-09-18T09:16:36.163,13,False,4.0
2021,1,3067,335,7,7659,13,19,2,29,0,0,0,0,0,0,False,False,False,0,2,2021-09-13T19:15:18.73,0,False,
2021,1,3067,350,7,7659,2,35,10,2,2,0,2,0,2,6,False,False,False,0,3,2021-09-13T13:18:32.177,2,True,0.0
2021,1,3067,365,18,4572,3,46,3,0,0,0,0,0,0,0,False,False,False,0,1,2021-09-13T13:20:53.77,0,False,0.0
2021,1,3067,370,18,6361,2,6,10,4,8,4,8,0,8,0,False,False,False,0,4,2021-09-13T19:24:15.42,8,False,
2021,1,3067,375,18,566,2,44,3,-3,5,8,3,2,3,0,False,False,False,0,1,2021-09-13T13:26:21.32,5,False,2.0
2021,1,3067,380,18,6361,2,38,10,2,6,4,4,2,4,0,False,False,False,0,4,2021-09-18T09:34:29.95,6,False,2.0
2021,1,3067,395,7,7659,2,2,10,10,14,4,12,2,12,0,False,False,False,0,2,2021-09-13T13:31:04.263,14,False,2.0
2021,1,3067,400,7,4679,2,47,10,0,2,2,1,1,1,0,False,False,False,1,1,2022-02-16T17:09:01.393,2,False,1.0
2021,1,3067,405,7,3521,2,5,3,9,9,0,9,0,9,0,False,False,False,0,3,2021-12-23T22:06:10.21,9,False,0.0
2021,1,3067,410,7,8317,2,19,2,35,50,15,46,4,46,6,False,False,False,0,2,2021-09-18T09:16:59.783,50,False,4.0
2021,1,3067,430,18,1381,2,6,1,18,20,2,20,0,20,0,False,False,False,0,2,2021-09-13T13:48:06.84,20,False,0.0
2021,1,3067,440,18,4940,2,12,5,7,8,1,8,0,8,0,False,False,False,0,3,2021-09-13T14:02:55.827,8,True,
2021,1,3067,445,18,1381,2,50,3,0,0,0,0,0,0,0,False,False,False,0,2,2021-09-13T14:03:17.553,0,False,0.0
2021,1,3067,455,18,7712,13,4,5,6,0,0,0,0,0,0,False,False,False,0,3,2021-09-13T14:04:34.663,0,False,0.0
2021,1,3067,460,18,7711,2,12,3,11,9,-2,9,0,9,0,False,False,False,0,2,2021-09-14T02:45:24.953,9,False,0.0
2021,1,3067,490,7,4679,2,47,5,-2,4,6,4,0,4,0,True,False,False,0,1,2022-02-16T17:14:40.693,4,False,0.0
2021,1,3067,495,7,7659,2,3,5,12,28,16,17,11,17,0,False,False,False,1,3,2021-09-13T14:49:32.04,28,False,11.0
2021,1,3067,505,7,3445,13,22,2,24,0,0,0,0,0,0,False,False,False,0,3,2021-09-13T14:53:52.603,0,False,0.0
2021,1,3067,510,7,3521,2,4,10,7,5,-2,5,0,5,0,False,False,False,0,3,2021-09-15T00:27:09.94,5,False,0.0
2021,1,3067,525,7,7659,2,5,5,11,14,3,14,0,14,0,False,False,False,0,2,2021-09-13T15:05:51.867,14,False,0.0
2021,1,3067,560,18,566,2,12,3,5,10,5,10,0,10,0,False,False,False,0,2,2021-09-14T02:45:47.417,10,False,0.0
2021,1,3067,570,18,6262,3,39,10,6,0,0,0,0,0,0,False,False,False,0,3,2021-09-18T09:07:01.76,0,False,0.0
2021,1,3067,575,18,7712,2,2,10,7,10,3,10,0,10,0,False,False,False,0,3,2021-09-13T15:28:44.943,10,False,0.0
2021,1,3067,595,7,8317,2,2,10,8,15,7,10,5,10,0,False,False,False,1,2,2022-02-16T17:13:18.087,15,False,5.0
2021,1,3067,605,18,6262,13,11,3,7,0,0,0,0,0,0,True,False,False,0,3,2022-02-16T17:17:43.58,0,False,0.0
2021,1,3067,615,18,7711,3,2,4,10,0,0,0,0,0,0,False,False,False,0,3,2021-09-18T09:35:52.837,0,False,0.0
2021,1,3067,620,18,1381,2,2,10,4,24,20,24,0,24,6,True,False,False,0,3,2021-09-13T16:01:47.703,24,True,0.0
2021,1,3067,665,7,3445,13,51,3,1,0,0,0,0,0,0,False,False,False,0,3,2021-09-18T06:57:20.417,0,False,0.0
2021,1,3067,680,18,1381,2,18,5,-1,5,6,2,3,2,0,False,False,False,0,2,2021-09-18T09:24:56.57,5,False,3.0
2021,1,3067,690,18,1381,13,6,4,5,0,0,0,0,0,0,False,False,False,0,3,2021-09-18T06:57:20.417,0,False,
2021,1,3067,700,18,4152,2,26,9,1,6,5,1,5,1,0,False,False,False,0,4,2021-09-18T09:18:48.8,6,False,5.0
2021,1,3067,710,18,7711,13,35,7,22,0,0,0,0,0,0,False,False,False,0,3,2021-09-13T16:46:51.993,0,False,0.0
2021,1,3067,720,18,4572,2,28,10,1,9,8,7,2,7,0,False,False,False,0,1,2021-09-13T16:49:28.293,9,False,2.0
2021,1,3067,725,18,7712,2,39,4,5,8,3,8,0,8,0,False,False,False,0,3,2021-09-14T02:46:14.543,8,False,0.0
2021,1,3067,730,18,7711,2,6,1,16,34,18,16,18,16,0,False,False,False,1,3,2021-09-18T06:57:20.417,34,False,18.0
2021,1,3067,750,7,3521,2,2,4,7,18,11,18,0,18,0,False,False,False,0,3,2022-02-16T17:19:09.49,18,False,0.0
2021,1,3067,760,7,8317,13,21,2,44,0,0,0,0,0,0,False,False,False,0,2,2021-09-18T09:29:05.517,0,False,0.0
2021,1,3067,775,18,1381,13,12,7,21,0,0,0,0,0,0,False,False,False,0,3,2021-09-18T10:14:18.787,0,False,
2021,1,3067,785,18,7712,2,4,10,10,10,0,10,0,10,0,False,False,False,0,3,2021-09-13T17:19:47.86,10,False,0.0
2021,1,3067,845,18,4572,2,28,4,2,7,5,5,2,5,0,False,False,False,0,1,2021-09-14T02:47:06.247,7,False,2.0
2021,1,3067,850,18,6361,2,17,1,21,27,6,27,0,27,0,False,False,False,0,4,2021-09-13T17:40:17.56,27,False,0.0
2021,1,3067,855,18,7712,13,7,6,23,0,0,0,0,0,0,False,False,False,0,3,2021-09-13T17:44:49.423,0,False,0.0
2021,1,3067,860,18,4572,2,45,5,-5,0,5,0,0,0,0,False,False,False,0,1,2021-09-13T17:49:46.42,0,False,0.0
2021,1,3067,865,18,7712,2,13,4,4,6,2,6,0,6,0,False,False,False,0,3,2021-09-14T02:47:28.207,6,False,0.0
2021,1,3067,870,18,7712,2,2,9,5,6,1,6,0,6,0,False,False,False,0,3,2021-09-13T17:55:55.663,6,False,0.0
2021,1,3067,875,18,1381,2,3,5,14,14,0,14,0,14,0,False,False,False,0,2,2021-09-13T17:58:44.19,14,False,0.0
2021,1,3067,915,7,3445,2,26,5,4,5,1,5,0,5,0,True,False,False,0,3,2022-02-16T17:15:18.037,5,False,0.0
2021,1,3067,945,18,1381,2,6,4,7,7,0,7,0,7,0,True,False,False,0,3,2021-09-14T16:38:40.113,7,False,0.0
2021,1,3067,970,7,8317,13,2,4,12,0,0,0,0,0,0,False,False,False,0,2,2021-09-15T00:27:49.49,0,False,0.0
2021,1,3067,985,18,7711,13,35,2,22,0,0,0,0,0,0,False,False,False,0,3,2021-09-14T02:34:07.193,0,False,
2021,1,3067,990,18,4152,2,30,5,1,3,2,3,0,3,0,False,False,False,0,4,2021-09-18T06:57:20.433,3,True,0.0
2021,1,3067,995,18,1381,2,5,5,4,5,1,5,0,5,0,True,False,False,0,3,2021-09-18T09:08:58.097,5,False,0.0
2021,1,3067,1000,18,7711,2,13,4,3,12,9,9,3,9,0,False,False,False,0,3,2021-09-18T09:37:00.087,12,False,3.0
2021,1,3067,1015,7,8317,2,50,3,-2,6,8,3,3,3,0,False,False,False,0,2,2021-09-18T09:07:25.533,6,False,3.0
2021,1,3067,1035,7,2631,2,35,6,15,32,17,32,0,32,0,False,False,False,0,4,2021-09-13T18:58:48.507,32,False,0.0
2021,1,3068,15,31,3504,2,4,4,2,3,1,3,0,3,0,False,False,False,0,1,2021-09-13T09:12:43.757,3,False,0.0
2021,1,3068,20,31,3911,13,4,10,10,0,0,0,0,0,0,False,False,False,0,3,2021-09-13T09:14:30.323,0,False,0.0
2021,1,3068,30,1,245,2,7,6,28,38,10,38,0,38,0,False,False,False,0,2,2021-09-13T09:18:35.253,38,False,0.0
2021,1,3068,40,1,6406,2,12,3,-4,1,5,-1,2,-1,0,False,False,False,0,1,2021-09-17T13:45:40.41,1,False,2.0
2021,1,3068,45,1,910,2,9,2,20,21,1,21,0,21,0,False,False,False,0,2,2021-09-17T11:39:25.36,21,False,0.0
2021,1,3068,70,1,6405,2,42,4,4,8,4,8,0,8,0,False,False,False,0,3,2021-09-17T13:45:54.73,8,False,0.0
2021,1,3068,75,1,8439,13,9,8,15,0,0,0,0,0,0,False,False,False,0,3,2021-09-17T11:39:49.007,0,False,0.0
2021,1,3068,110,1,910,13,9,5,5,0,0,0,0,0,0,False,False,False,0,2,2021-09-13T09:44:19.123,0,False,0.0
2021,1,3068,115,1,2071,13,12,5,5,0,0,0,0,0,0,False,False,False,0,3,2021-09-17T13:46:25.54,0,False,0.0
2021,1,3068,125,1,245,2,12,10,5,5,0,5,0,5,6,False,False,False,0,2,2022-02-01T19:14:36.997,5,True,0.0
2021,1,3068,150,31,4545,13,48,10,-2,0,0,0,0,0,0,False,False,False,0,1,2021-09-13T09:54:55.957,0,False,0.0
2021,1,3068,165,1,245,2,4,9,2,3,1,3,0,3,0,False,False,False,0,2,2021-09-17T13:46:41.227,3,False,0.0
2021,1,3068,170,1,910,13,2,10,3,0,0,0,0,0,0,False,False,False,0,2,2021-09-13T10:01:47.983,0,False,0.0
2021,1,3068,185,31,3911,2,13,9,4,4,0,4,0,4,0,False,False,False,0,3,2021-09-13T10:09:19.92,4,False,0.0
2021,1,3068,190,31,4545,2,32,3,2,8,6,8,0,8,0,False,False,False,0,4,2021-09-13T10:12:02.613,8,False,0.0
2021,1,3068,195,31,6802,2,17,4,4,6,2,5,1,5,0,False,False,False,0,4,2021-09-13T10:17:50.57,6,False,1.0
2021,1,3068,235,1,245,2,4,9,10,10,0,10,0,10,0,False,False,False,0,2,2021-09-13T14:28:25.997,10,False,0.0
2021,1,3068,240,1,245,13,29,2,15,0,0,0,0,0,0,False,False,False,0,2,2021-09-14T19:17:40.593,0,False,
2021,1,3068,255,1,6405,2,50,10,-1,3,4,-1,4,-1,0,False,False,False,0,3,2021-09-14T19:18:01.593,3,False,4.0
2021,1,3068,275,1,245,2,2,9,4,17,13,16,1,16,6,False,False,False,0,3,2021-09-13T14:28:54.69,17,False,1.0
2021,1,3068,290,31,6793,13,50,9,0,0,0,0,0,0,0,False,False,False,0,2,2021-09-17T11:42:19.983,0,False,0.0
2021,1,3068,295,31,6793,2,2,9,8,12,4,9,3,9,0,False,False,False,1,3,2021-09-17T13:45:02.58,12,False,3.0
2021,1,3068,305,31,6724,2,5,5,5,11,6,9,2,9,0,True,False,False,0,4,2021-09-17T13:48:06.943,11,False,2.0
2021,1,3068,310,31,3911,2,21,2,23,39,16,36,3,36,0,False,False,False,0,3,2022-02-16T20:41:45.463,39,False,3.0
2021,1,3068,315,31,661,13,8,10,11,0,0,0,0,0,0,False,False,False,0,3,2021-09-13T14:47:44.993,0,False,0.0
2021,1,3068,320,31,2865,13,17,4,11,0,0,0,0,0,0,False,False,False,0,4,2021-09-13T11:09:10.227,0,False,0.0
2021,1,3068,325,31,7913,2,2,9,7,10,3,8,2,8,0,False,False,False,0,3,2021-09-13T11:10:54.057,10,False,2.0
2021,1,3068,355,1,2416,13,12,2,23,0,0,0,0,0,0,False,False,False,0,4,2022-02-01T19:15:10.86,0,False,0.0
2021,1,3068,360,1,910,13,9,5,12,0,0,0,0,0,0,False,False,False,0,2,2021-09-14T19:18:31.393,0,False,0.0
2021,1,3068,365,1,8439,2,12,6,18,18,0,18,0,18,0,False,False,False,0,3,2021-09-17T13:43:50.973,18,False,0.0
2021,1,3068,385,1,910,2,5,5,4,4,0,4,0,4,0,False,False,False,0,2,2021-09-17T13:48:33.33,4,False,0.0
2021,1,3068,390,1,6405,2,35,8,20,22,2,20,2,20,0,False,False,False,0,3,2021-09-17T13:40:20.073,22,False,2.0
2021,1,3068,405,1,6406,2,4,3,-2,3,5,2,1,2,0,False,False,False,0,2,2021-09-14T19:19:31.313,3,False,1.0
2021,1,3068,430,31,661,2,2,9,5,9,4,8,1,8,0,False,False,False,0,2,2021-09-13T11:50:21.983,9,False,1.0
2021,1,3068,440,31,4545,2,28,4,5,9,4,9,0,9,0,False,False,False,0,1,2021-09-13T12:01:02.583,9,False,0.0
2021,1,3068,445,31,6724,2,5,5,4,4,0,4,0,4,0,False,False,False,0,3,2021-09-13T12:01:18.307,4,True,0.0
2021,1,3068,450,31,6724,2,4,9,4,4,0,4,0,4,0,False,False,False,0,3,2021-09-13T12:01:25.22,4,False,0.0
2021,1,3068,460,31,661,13,4,6,16,0,0,0,0,0,0,False,False,False,0,2,2021-09-13T14:35:50.69,0,False,
2021,1,3068,465,31,661,13,5,3,12,0,0,0,0,0,0,False,False,False,0,3,2022-02-16T20:42:51.873,0,False,0.0
2021,1,3068,470,31,6793,13,8,8,28,0,0,0,0,0,0,False,False,False,0,3,2021-09-13T12:02:54.217,0,False,0.0
2021,1,3068,480,1,8439,2,50,9,-3,12,15,9,3,9,0,False,False,False,0,3,2021-09-13T12:05:32.183,12,False,3.0
2021,1,3068,500,1,6406,2,48,4,0,36,36,27,9,27,0,False,False,False,0,1,2021-09-13T12:09:12.673,36,False,9.0
2021,1,3068,520,1,6406,2,51,10,-6,3,9,3,0,3,0,False,False,False,0,1,2021-09-13T12:24:26.47,3,False,0.0
2021,1,3068,525,1,2071,13,12,7,21,0,0,0,0,0,0,False,False,False,0,3,2021-09-17T13:41:54.51,0,False,0.0
2021,1,3068,530,31,6793,2,5,3,14,19,5,14,5,14,0,False,False,False,1,2,2021-09-17T13:49:03.793,19,False,5.0
2021,1,3068,535,31,6793,2,8,4,13,13,0,13,0,13,6,False,False,False,0,3,2021-09-17T13:40:33.073,13,True,0.0
2021,1,3068,550,1,8439,2,50,9,-4,29,33,5,24,5,0,False,False,False,1,3,2021-09-14T19:20:39.947,29,False,24.0
2021,1,3068,560,1,245,2,4,3,7,10,3,9,1,9,0,False,False,False,0,2,2022-02-16T20:44:08.83,10,False,1.0
2021,1,3068,570,1,2071,13,30,5,0,0,0,0,0,0,0,False,False,False,0,4,2021-09-17T13:49:19.113,0,False,0.0
2021,1,3068,580,1,6405,2,7,8,26,26,0,26,0,26,6,False,False,False,0,3,2021-09-13T12:51:05.427,26,True,0.0
2021,1,3068,600,31,3911,2,39,9,7,9,2,9,0,9,0,False,False,False,0,3,2021-09-17T13:49:34.023,9,False,0.0
2021,1,3068,610,31,661,13,2,8,20,0,0,0,0,0,0,False,False,False,0,2,2021-09-17T13:42:10.093,0,False,0.0
2021,1,3068,615,1,245,13,12,6,19,0,0,0,0,0,0,False,False,False,0,2,2021-09-13T13:06:44.073,0,False,0.0
2021,1,3068,620,1,910,13,5,5,10,0,0,0,0,0,0,True,False,False,0,2,2021-09-14T19:20:59.37,0,False,0.0
2021,1,3068,685,1,6405,2,29,5,11,11,0,11,0,11,6,False,False,False,0,3,2021-09-13T13:25:21.373,11,True,0.0
2021,1,3068,700,31,3911,13,2,4,7,0,0,0,0,0,0,False,False,False,0,3,2021-09-17T13:41:01.343,0,False,0.0
2021,1,3068,710,31,661,2,3,3,10,10,0,10,0,10,0,False,False,False,0,2,2021-09-13T13:31:09.91,10,False,0.0
2021,1,3068,720,31,6793,13,25,5,8,0,0,0,0,0,0,False,False,False,0,2,2021-09-13T13:33:46.41,0,False,0.0
2021,1,3068,725,31,6793,2,47,10,2,5,3,5,0,5,0,False,False,False,0,3,2021-09-13T14:37:31.913,5,False,0.0
2021,1,3068,730,31,7913,13,2,9,5,0,0,0,0,0,0,False,False,False,0,3,2021-09-13T13:36:49.28,0,False,0.0
2021,1,3068,735,31,3504,13,2,4,5,0,0,0,0,0,0,True,False,False,0,3,2021-09-17T11:44:21.22,0,False,0.0
2021,1,3068,740,31,6724,13,31,10,3,0,0,0,0,0,0,False,False,False,0,4,2021-09-13T14:46:48.903,0,False,0.0
2021,1,3068,800,31,661,2,13,10,3,10,7,6,4,6,0,False,False,False,2,3,2021-09-13T13:55:34.587,10,False,4.0
2021,1,3068,805,31,3504,2,48,9,-4,8,12,5,3,5,0,False,False,False,0,1,2021-09-13T13:56:57.777,8,False,3.0
2021,1,3068,810,31,3911,2,5,5,7,10,3,9,1,9,0,False,False,False,0,3,2021-09-17T13:51:28.687,10,False,1.0
2021,1,3068,815,31,3504,2,4,10,3,8,5,8,0,8,0,False,False,False,0,1,2021-09-17T13:41:15.2,8,False,0.0
2021,1,3068,825,31,4545,2,31,4,3,7,4,5,2,5,0,False,False,False,1,1,2021-09-13T14:03:41.93,7,False,2.0
2021,1,3068,830,31,6793,13,5,5,9,0,0,0,0,0,0,False,False,False,0,2,2021-09-17T11:44:43.7,0,False,0.0
2021,1,3068,840,1,8439,2,55,4,-4,9,13,4,5,4,0,False,False,False,0,1,2021-09-17T13:51:58.32,9,False,5.0
2021,1,3069,15,11,6810,2,13,5,3,22,19,14,8,14,0,True,False,False,0,3,2021-09-14T20:09:27.147,22,False,8.0
2021,1,3069,25,11,3312,3,2,10,6,0,0,0,0,0,0,False,False,False,0,2,2021-09-16T19:08:23.193,0,False,0.0
2021,1,3069,30,11,4561,2,32,5,-2,6,8,3,3,3,0,False,False,False,0,1,2021-09-13T09:16:48.98,6,False,3.0
2021,1,3069,55,11,8359,13,11,6,20,0,0,0,0,0,0,False,False,False,0,2,2021-09-16T19:54:03.573,0,False,0.0
2021,1,3069,60,11,7732,2,48,3,-8,-8,0,-8,0,-8,0,False,False,False,0,1,2021-09-16T18:32:29.807,-8,False,0.0
2021,1,3069,65,11,7732,13,5,5,4,0,0,0,0,0,0,False,False,False,0,1,2021-09-16T19:11:44.337,0,False,0.0
2021,1,3069,85,28,4922,2,13,5,3,23,20,20,3,20,0,False,False,False,0,4,2021-09-13T16:36:05.907,23,False,3.0
2021,1,3069,100,28,917,2,5,3,5,7,2,6,1,6,0,False,False,False,0,3,2021-09-16T19:12:32.4,7,False,1.0
2021,1,3069,105,28,6410,2,26,3,3,5,2,5,0,5,6,False,False,False,0,2,2021-09-13T16:36:51.887,5,True,0.0
2021,1,3069,120,11,6810,13,2,9,7,0,0,0,0,0,0,False,False,False,0,2,2021-09-13T10:07:41.233,0,False,0.0
2021,1,3069,135,11,6629,13,47,5,2,0,0,0,0,0,0,True,False,False,0,1,2021-09-14T20:09:43.07,0,False,
2021,1,3069,145,11,7732,2,28,9,2,12,10,8,4,8,0,False,False,False,1,1,2021-09-13T10:21:40.013,12,False,4.0
2021,1,3069,150,11,6810,2,5,3,11,12,1,12,0,12,0,False,False,False,0,3,2021-09-13T16:37:16.17,12,True,0.0
2021,1,3069,165,11,6810,2,47,5,1,1,0,1,0,1,0,False,False,False,0,4,2021-09-13T10:33:59.903,1,False,0.0
2021,1,3069,170,11,3312,2,2,3,3,7,4,4,3,4,0,False,False,False,0,2,2021-09-14T20:03:19.367,7,False,3.0
2021,1,3069,190,11,7732,2,26,9,3,3,0,3,0,3,0,False,False,False,0,1,2021-09-16T17:52:49.09,3,False,0.0
2021,1,3069,195,11,6810,2,5,3,4,6,2,5,1,5,6,False,False,False,0,3,2021-09-13T10:39:58.937,6,False,1.0
2021,1,3069,215,28,7224,2,6,1,18,29,11,25,4,25,0,False,False,False,0,2,2021-09-13T10:49:17.373,29,False,4.0
2021,1,3069,220,28,7224,2,4,9,5,8,3,5,3,5,0,False,False,False,0,3,2021-09-13T10:51:10.26,8,False,3.0
2021,1,3069,245,11,1430,2,32,3,1,2,1,2,0,2,0,False,False,False,0,4,2021-09-16T19:53:31.873,2,False,0.0
2021,1,3069,250,11,4561,2,5,3,4,6,2,5,1,5,0,False,False,False,0,3,2021-09-13T16:38:07.903,6,False,1.0
2021,1,3069,275,11,3312,2,39,4,3,7,4,6,1,6,0,False,False,False,0,3,2021-09-13T11:09:44.6,7,False,1.0
2021,1,3069,290,28,262,2,30,3,5,7,2,5,2,5,0,True,False,False,0,4,2021-09-17T00:29:34.343,7,False,2.0
2021,1,3069,305,28,7224,2,6,10,14,23,9,20,3,20,0,False,False,False,0,3,2021-09-13T11:22:05.64,23,False,3.0
2021,1,3069,315,28,7224,2,30,3,4,7,3,7,0,7,0,False,False,False,0,3,2021-09-13T11:26:05.79,7,True,0.0
2021,1,3069,335,11,6810,2,30,5,0,10,10,7,3,7,0,False,False,False,1,4,2021-09-17T00:25:27.32,10,False,3.0
2021,1,3069,350,11,7732,2,44,3,-1,-1,0,-2,1,-2,0,False,False,False,0,1,2021-09-16T17:52:49.09,-1,False,1.0
2021,1,3069,355,11,6810,13,6,4,7,0,0,0,0,0,0,False,False,False,0,3,2021-09-16T18:51:59.77,0,False,0.0
2021,1,3069,390,11,4561,2,28,5,-2,7,9,4,3,4,0,False,False,False,0,1,2021-09-17T00:47:29.067,7,False,3.0
2021,1,3069,400,28,7224,2,34,4,-4,14,18,9,5,9,0,True,False,False,0,3,2021-09-14T19:52:01.853,14,False,5.0
2021,1,3069,405,28,4922,13,2,3,7,0,0,0,0,0,0,False,False,False,0,2,2021-09-13T11:54:59.053,0,False,0.0
2021,1,3069,410,28,6410,2,4,9,14,18,4,15,3,15,0,False,False,False,0,3,2021-09-13T11:58:17.887,18,False,3.0
2021,1,3069,455,28,4922,2,35,3,14,35,21,20,15,20,0,True,False,False,1,4,2021-09-14T19:52:15.277,35,False,15.0
2021,1,3069,465,28,4922,2,6,5,7,8,1,7,1,7,0,False,False,False,0,4,2021-09-16T19:19:36.697,8,False,1.0
2021,1,3069,475,28,7224,3,2,10,3,0,0,0,0,0,0,False,False,False,0,3,2021-09-16T18:29:03.23,0,False,0.0
2021,1,3069,495,11,4037,3,5,5,6,0,0,0,0,0,0,False,False,False,0,3,2021-09-13T12:27:20.887,0,False,0.0
2021,1,3069,500,11,3312,13,19,7,24,0,0,0,0,0,0,False,False,False,0,3,2021-09-13T16:17:07.89,0,False,
2021,1,3069,510,11,7732,3,16,10,6,0,0,0,0,0,0,False,False,False,0,1,2021-09-13T12:39:39.627,0,False,0.0
2021,1,3069,515,11,4561,3,5,5,4,0,0,0,0,0,0,False,False,False,0,3,2021-09-16T17:52:49.09,0,False,0.0
2021,1,3069,540,28,7224,13,2,4,10,0,0,0,0,0,0,False,False,False,0,3,2021-09-13T12:49:44.293,0,False,0.0
2021,1,3069,550,28,7224,2,21,2,25,79,54,79,0,79,6,True,False,False,0,2,2021-09-14T19:52:28.83,79,True,0.0
2021,1,3069,575,11,6629,3,47,5,1,0,0,0,0,0,0,False,False,False,0,4,2021-09-14T20:03:47.27,0,False,0.0
2021,1,3069,585,11,4561,2,28,9,0,11,11,8,3,8,0,False,False,False,1,1,2021-09-13T13:06:44.89,11,False,3.0
2021,1,3069,590,11,4561,2,28,9,0,6,6,5,1,5,0,False,False,False,0,1,2021-09-13T16:52:06.493,6,False,1.0
2021,1,3069,595,11,7732,2,48,9,-4,43,47,23,20,23,6,False,False,False,1,1,2021-09-13T13:10:50.393,43,False,20.0
2021,1,3069,615,28,7224,2,6,10,14,16,2,15,1,15,0,False,False,False,0,3,2021-09-16T18:53:20.61,16,False,1.0
2021,1,3069,620,28,7224,2,34,4,-4,2,6,1,1,1,0,True,False,False,0,3,2021-09-16T19:25:47.637,2,False,1.0
2021,1,3069,645,11,8359,2,31,9,3,3,0,3,0,3,0,False,False,False,0,3,2021-09-13T13:24:38.377,3,False,0.0
2021,1,3069,655,11,7733,3,29,6,23,0,0,0,0,0,0,False,False,False,0,2,2021-09-13T16:27:04.18,0,False,0.0
2021,1,3069,675,28,6410,13,35,9,9,0,0,0,0,0,0,False,False,False,0,2,2021-09-13T13:41:05.05,0,False,0.0
2021,1,3069,680,28,7751,2,47,5,0,15,15,8,7,8,0,False,False,False,1,1,2021-09-13T13:44:09.307,15,False,7.0
2021,1,3069,695,28,4922,2,48,3,-5,12,17,8,4,8,0,False,False,False,0,1,2021-09-13T13:52:17.363,12,False,4.0
2021,1,3069,710,11,6810,2,4,4,12,23,11,20,3,20,0,False,False,False,0,4,2021-09-13T14:00:25.703,23,False,3.0
2021,1,3069,715,11,6831,2,4,3,5,5,0,4,1,4,0,False,False,False,0,2,2021-09-13T14:04:40.073,5,False,1.0
2021,1,3069,720,11,8359,2,12,3,14,14,0,14,0,14,0,False,False,False,0,3,2022-02-01T19:16:42.083,14,True,
2021,1,3069,725,11,6810,2,53,9,-4,6,10,5,1,5,0,False,False,False,0,4,2021-09-16T19:28:24.17,6,False,
2021,1,3069,730,11,6831,13,3,3,7,0,0,0,0,0,0,False,False,False,0,2,2021-09-13T14:14:52.487,0,False,0.0
2021,1,3069,735,11,4037,2,5,3,5,5,0,5,0,5,0,False,False,False,0,3,2021-09-13T14:18:07.007,5,True,0.0
2021,1,3069,740,11,6831,3,13,5,4,0,0,0,0,0,0,False,False,False,0,3,2022-02-16T17:31:21.707,0,False,0.0
2021,1,3069,755,28,7224,3,2,3,5,0,0,0,0,0,0,False,False,False,0,2,2021-09-13T14:25:00.95,0,False,0.0
2021,1,3069,765,11,6831,2,4,5,3,3,0,3,0,3,0,False,False,False,0,2,2021-09-13T14:35:18.93,3,False,0.0
2021,1,3069,770,11,6810,2,5,5,9,10,1,10,0,10,0,False,False,False,0,3,2021-09-13T14:37:05.903,10,True,0.0
2021,1,3069,775,11,7732,2,16,10,4,5,1,5,0,5,0,False,False,False,0,1,2021-09-13T14:39:53.863,5,False,0.0
2021,1,3069,780,11,7733,13,19,2,43,0,0,0,0,0,0,False,False,False,0,2,2021-09-13T16:27:31.497,0,False,0.0
2021,1,3069,785,11,6831,13,5,5,13,0,0,0,0,0,0,False,False,False,0,3,2021-09-13T15:04:27.78,0,False,
2021,1,3069,790,11,7732,13,28,4,3,0,0,0,0,0,0,False,False,False,0,1,2021-09-13T14:47:10.603,0,False,0.0
2021,1,3069,795,11,7732,2,45,5,-5,6,11,0,6,0,0,False,False,False,1,1,2021-09-13T14:49:26.933,6,False,6.0
2021,1,3069,800,11,7732,2,28,4,3,5,2,3,2,3,0,False,False,False,1,1,2021-09-16T18:48:28.98,5,False,2.0
2021,1,3069,805,11,4561,2,28,3,-1,3,4,1,2,1,0,False,False,False,0,1,2021-09-16T18:49:19.293,3,False,2.0
2021,1,3069,810,11,4561,2,28,4,3,8,5,7,1,7,0,False,False,False,0,1,2021-09-13T14:59:25.283,8,False,1.0
2021,1,3069,815,11,7733,2,12,5,5,7,2,6,1,6,0,False,False,False,0,2,2022-02-01T19:17:00.707,7,False,1.0
2021,1,3069,820,11,4561,2,48,3,-5,9,14,6,3,6,0,False,False,False,0,1,2021-09-13T15:04:14.64,9,False,3.0
2021,1,3069,830,11,6831,13,9,6,17,0,0,0,0,0,0,False,False,False,0,2,2021-09-17T00:47:45.557,0,False,
2021,1,3069,850,11,6831,2,4,5,10,11,1,10,1,10,0,False,False,False,0,2,2021-09-13T15:12:31.953,11,False,1.0
2021,1,3069,855,11,6810,2,5,5,10,13,3,13,0,13,0,False,False,False,0,3,2021-09-13T15:12:38.867,13,False,0.0
2021,1,3069,865,11,7733,2,5,3,3,3,0,3,0,3,0,False,False,False,0,2,2021-09-13T16:28:05.6,3,False,0.0
2021,1,3069,870,11,4037,2,29,2,18,20,2,20,0,20,0,False,False,False,0,2,2021-09-17T00:47:57.743,20,True,0.0
2021,1,3069,875,11,7733,2,9,3,2,2,0,2,0,2,6,False,False,False,0,2,2021-09-16T18:31:19.577,2,True,0.0
2021,1,3069,915,28,7224,2,4,4,6,11,5,11,0,11,0,False,True,True,0,3,2021-09-16T18:50:11.017,11,False,0.0
2021,1,3069,919,11,6831,13,9,6,25,0,0,0,0,0,0,False,False,False,0,2,2021-09-16T19:31:29.557,0,False,0.0
2021,1,3069,925,11,8359,2,5,6,20,20,0,20,0,20,0,False,False,False,0,3,2021-09-13T15:42:50.557,20,False,0.0
2021,1,3069,930,11,7733,13,9,6,21,0,0,0,0,0,0,False,False,False,0,2,2021-09-13T16:28:58.11,0,False,0.0
2021,1,3069,935,11,4037,2,6,8,23,25,2,25,0,25,0,False,False,False,0,2,2021-09-16T18:50:36.663,25,False,0.0
2021,1,3069,955,11,6810,13,5,5,5,0,0,0,0,0,0,False,False,False,0,3,2021-09-13T16:31:40.867,0,False,0.0
2021,1,3069,960,11,8359,13,25,3,8,0,0,0,0,0,0,False,False,False,0,3,2021-09-13T15:54:44.297,0,False,0.0
2021,1,3070,10,4,594,2,4,10,3,7,4,5,2,5,0,False,False,False,0,3,2021-09-13T05:52:43.733,7,False,2.0
2021,1,3070,15,4,2853,2,46,3,-1,-2,-1,-2,0,-2,0,False,False,False,0,3,2021-09-13T05:54:29.667,-2,False,0.0
2021,1,3070,20,4,2853,13,4,9,8,0,0,0,0,0,0,False,False,False,0,2,2021-09-13T05:55:57.92,0,False,0.0
2021,1,3070,40,25,7060,2,50,5,-3,14,17,11,3,11,0,False,False,False,0,2,2021-09-13T06:04:46.55,14,False,3.0
2021,1,3070,55,25,7060,13,26,10,2,0,0,0,0,0,0,False,False,False,0,2,2021-09-13T06:07:44.977,0,False,0.0
2021,1,3070,80,4,2853,2,2,10,5,6,1,6,0,6,0,False,False,False,0,3,2021-09-13T06:21:33.847,6,False,0.0
2021,1,3070,85,4,594,2,5,3,5,5,0,5,0,5,0,False,False,False,0,3,2021-09-13T12:07:29.147,5,False,0.0
2021,1,3070,90,4,6953,2,32,5,2,10,8,8,2,8,0,False,False,False,0,3,2021-09-13T06:24:58.66,10,False,2.0
2021,1,3070,95,4,594,3,5,9,5,0,0,0,0,0,0,False,False,False,0,3,2021-09-13T06:26:30.843,0,False,0.0
2021,1,3070,100,4,213,2,5,6,16,16,0,16,0,16,0,False,False,False,0,2,2021-09-13T06:38:59.827,16,False,0.0
2021,1,3070,105,4,2853,2,4,5,5,10,5,4,6,4,0,False,False,False,1,2,2021-09-16T16:24:47.897,10,False,
2021,1,3070,115,4,213,13,21,8,48,0,0,0,0,0,0,False,False,False,0,3,2021-09-13T06:47:27.637,0,False,0.0
2021,1,3070,120,4,594,3,12,6,23,0,0,0,0,0,0,False,False,False,0,3,2022-02-01T19:18:07.203,0,False,0.0
2021,1,3070,130,25,7060,2,5,3,4,6,2,6,0,6,0,False,False,False,0,3,2021-09-16T16:25:06.567,6,False,0.0
2021,1,3070,135,25,7666,13,5,3,3,0,0,0,0,0,0,False,False,False,0,3,2021-09-13T06:58:00.753,0,False,0.0
2021,1,3070,150,4,2853,13,35,8,20,0,0,0,0,0,0,False,False,False,0,3,2021-09-16T16:11:42.573,0,False,0.0
2021,1,3070,160,4,2853,13,22,6,21,0,0,0,0,0,0,False,False,False,0,3,2022-02-16T16:33:16.533,0,False,0.0
2021,1,3070,170,25,4583,2,44,3,0,6,6,3,3,3,0,True,False,False,0,3,2021-09-13T07:12:01.493,6,False,3.0
2021,1,3070,180,25,4583,2,7,3,12,12,0,12,0,12,0,False,False,False,0,3,2021-09-13T12:01:18.457,12,False,0.0
2021,1,3070,185,25,6486,2,50,5,-4,9,13,8,1,8,0,False,False,False,0,2,2021-09-13T07:17:42.443,9,False,1.0
2021,1,3070,205,25,7666,13,29,2,17,0,0,0,0,0,0,False,False,False,0,3,2022-02-16T16:41:18.833,0,False,0.0
2021,1,3070,220,4,213,2,5,3,13,13,0,13,0,13,0,False,False,False,0,3,2021-09-13T07:26:47.383,13,False,0.0
2021,1,3070,225,4,594,2,4,10,4,4,0,4,0,4,0,False,False,False,0,3,2021-09-13T07:28:12.033,4,False,0.0
2021,1,3070,235,4,2853,2,4,5,5,7,2,5,2,5,0,False,False,False,0,2,2021-09-13T07:32:21.617,7,False,2.0
2021,1,3070,240,4,2853,13,23,8,42,0,0,0,0,0,0,False,False,False,0,2,2021-09-13T07:34:19.57,0,False,0.0
2021,1,3070,245,4,594,13,49,3,-1,0,0,0,0,0,0,False,False,False,0,2,2021-09-13T07:35:52.597,0,False,0.0
2021,1,3070,255,25,7060,13,5,2,15,0,0,0,0,0,0,False,False,False,0,2,2021-09-13T07:38:52.567,0,False,0.0
2021,1,3070,270,25,4583,13,4,10,10,0,0,0,0,0,0,False,False,False,0,3,2021-09-13T07:42:12.863,0,False,0.0
2021,1,3070,285,4,213,13,6,10,5,0,0,0,0,0,0,False,False,False,0,2,2021-09-13T07:46:53.8,0,False,0.0
2021,1,3070,295,25,4583,2,30,5,-3,10,13,0,10,0,0,False,False,False,1,3,2021-09-13T12:10:12.723,10,False,10.0
2021,1,3070,310,25,8421,3,4,4,0,0,0,0,0,0,0,False,False,False,0,1,2021-09-13T08:06:51.373,0,False,0.0
2021,1,3070,325,4,6953,2,6,4,12,12,0,12,0,12,0,False,False,False,0,3,2021-09-13T08:10:41.683,12,False,0.0
2021,1,3070,330,4,213,13,12,5,1,0,0,0,0,0,0,False,False,False,0,2,2021-09-16T15:46:37.143,0,False,
2021,1,3070,335,4,594,2,4,10,5,10,5,8,2,8,0,False,False,False,0,3,2021-09-13T08:17:01.767,10,False,2.0
2021,1,3070,340,4,6983,2,4,3,5,5,0,5,0,5,0,False,False,False,0,2,2021-09-13T08:18:08.627,5,False,0.0
2021,1,3070,345,4,7646,2,8,8,26,37,11,30,7,30,0,False,False,False,1,2,2022-02-16T16:39:50.893,37,False,7.0
2021,1,3070,355,4,2853,2,4,3,5,5,0,5,0,5,0,False,False,False,0,2,2021-09-13T12:06:00.127,5,False,
2021,1,3070,360,4,2853,2,2,9,7,10,3,8,2,8,0,False,False,False,0,2,2021-09-13T08:42:16.97,10,False,2.0
2021,1,3070,375,4,594,2,4,9,4,8,4,7,1,7,0,False,False,False,0,3,2021-09-13T08:44:51.837,8,False,1.0
2021,1,3070,410,4,7646,2,7,9,3,3,0,3,0,3,6,True,False,False,0,3,2021-09-14T17:49:36.853,3,True,0.0
2021,1,3070,450,25,7060,13,12,3,10,0,0,0,0,0,0,False,False,False,0,2,2022-02-01T19:18:45.92,0,False,
2021,1,3070,455,25,7060,2,50,5,-4,6,10,3,3,3,0,False,False,False,0,2,2021-09-13T09:02:10.35,6,False,3.0
2021,1,3070,460,25,4583,13,2,9,3,0,0,0,0,0,0,False,False,False,0,3,2022-02-16T16:45:03.073,0,False,0.0
2021,1,3070,465,25,609,2,8,8,16,19,3,16,3,16,0,False,False,False,0,4,2021-09-16T16:18:49.613,19,False,3.0
2021,1,3070,470,25,7666,2,9,2,17,22,5,17,5,17,0,False,False,False,0,2,2021-09-16T16:25:28.203,22,False,5.0
2021,1,3070,475,25,7060,2,5,3,4,5,1,5,0,5,0,False,False,False,0,2,2021-09-13T09:12:47.58,5,False,0.0
2021,1,3070,485,25,8421,13,47,5,-1,0,0,0,0,0,0,False,False,False,0,1,2021-09-13T09:22:44.323,0,False,0.0
2021,1,3070,500,4,2853,2,4,3,4,7,3,5,2,5,0,False,False,False,0,2,2021-09-13T09:24:28.737,7,False,2.0
2021,1,3070,505,4,2853,13,5,3,13,0,0,0,0,0,0,False,False,False,0,2,2021-09-13T09:25:32.327,0,False,0.0
2021,1,3070,510,4,2853,2,2,9,5,9,4,7,2,7,0,False,False,False,0,2,2021-09-13T09:26:47.437,9,False,2.0
2021,1,3070,515,4,213,2,39,4,4,9,5,8,1,8,0,False,False,False,0,3,2021-09-13T09:28:29.303,9,False,1.0
2021,1,3070,525,4,213,13,17,8,27,0,0,0,0,0,0,False,False,False,0,3,2021-09-13T09:31:45.38,0,False,0.0
2021,1,3070,540,4,7646,3,4,9,6,0,0,0,0,0,0,False,False,False,0,3,2021-09-16T15:51:19.073,0,False,0.0
2021,1,3070,550,4,594,13,42,1,15,0,0,0,0,0,0,False,False,False,0,3,2021-09-13T09:38:04.553,0,False,0.0
2021,1,3070,555,4,7646,13,17,1,30,0,0,0,0,0,0,False,False,False,0,3,2021-09-13T09:39:37.613,0,False,0.0
2021,1,3070,560,25,4583,13,51,3,0,0,0,0,0,0,0,False,False,False,0,3,2021-09-13T09:41:21.75,0,False,0.0
2021,1,3070,565,25,7666,2,2,9,4,9,5,7,2,7,0,False,False,False,0,2,2021-09-13T09:46:37.487,9,False,2.0
2021,1,3070,575,25,4583,13,13,10,5,0,0,0,0,0,0,False,False,False,0,3,2021-09-13T09:49:18.527,0,False,0.0
2021,1,3070,580,25,8422,2,4,4,14,24,10,22,2,22,0,False,False,False,0,4,2021-09-13T09:50:40.293,24,False,2.0
2021,1,3070,585,25,7060,13,4,3,5,0,0,0,0,0,0,False,False,False,0,2,2021-09-13T09:51:44.053,0,False,0.0
2021,1,3070,600,25,609,13,12,3,6,0,0,0,0,0,0,False,False,False,0,3,2021-09-16T16:19:33.82,0,False,0.0
2021,1,3070,605,25,8421,2,13,4,2,4,2,2,2,2,0,False,False,False,0,3,2021-09-13T10:01:17.217,4,False,2.0
2021,1,3070,620,4,594,2,4,10,4,12,8,5,7,5,0,False,False,False,1,3,2021-09-13T10:07:25.823,12,False,7.0
2021,1,3070,625,4,594,13,4,4,4,0,0,0,0,0,0,False,False,False,0,3,2021-09-13T10:08:34.51,0,False,0.0
2021,1,3070,650,4,2853,2,4,3,6,7,1,7,0,7,0,False,False,False,0,2,2021-09-13T10:16:07.387,7,False,0.0
2021,1,3070,665,25,7053,2,53,10,-2,-2,0,-2,0,-2,0,False,False,False,0,4,2021-09-13T10:22:13.993,-2,False,0.0
2021,1,3070,675,25,7666,13,9,6,21,0,0,0,0,0,0,False,False,False,0,2,2021-09-16T15:52:19.27,0,False,
2021,1,3070,685,25,7060,2,9,3,5,5,0,5,0,5,6,False,False,False,0,2,2021-09-13T10:27:48.727,5,True,0.0
2021,1,3070,700,4,594,2,26,9,4,4,0,4,0,4,0,False,False,False,0,3,2021-09-13T10:30:56.443,4,False,0.0
2021,1,3070,705,4,213,13,17,7,20,0,0,0,0,0,0,False,False,False,0,3,2021-09-13T10:32:47.41,0,False,0.0
2021,1,3070,730,4,6953,2,4,10,6,6,0,6,0,6,0,False,False,False,0,4,2021-09-13T10:38:08.33,6,False,0.0
2021,1,3070,735,4,2853,2,5,5,4,12,8,10,2,10,0,False,False,False,0,3,2021-09-16T16:25:51.11,12,False,2.0
2021,1,3070,765,4,6983,2,47,5,-1,-1,0,-1,0,-1,0,False,True,False,0,1,2021-09-13T10:46:41.867,-2,False,0.0
2021,1,3070,780,25,7060,13,19,6,30,0,0,0,0,0,0,False,False,False,0,2,2021-10-15T01:02:46.59,0,False,
2021,1,3070,790,25,4583,2,29,8,17,24,7,19,5,19,0,False,False,False,0,3,2021-09-13T12:09:06.42,24,False,5.0
2021,1,3070,805,25,7060,3,5,3,4,0,0,0,0,0,0,False,False,False,0,2,2021-09-13T10:57:31.177,0,False,0.0
2021,1,3070,810,25,7666,2,35,10,13,14,1,11,3,11,0,False,False,False,0,3,2022-02-16T16:48:55.013,14,False,3.0
2021,1,3070,830,25,7060,13,29,5,14,0,0,0,0,0,0,False,False,False,0,2,2021-09-16T15:14:49.623,0,False,0.0
2021,1,3070,835,25,6486,2,50,3,-1,1,2,0,1,0,0,False,False,False,0,2,2021-09-16T17:12:01.567,1,False,1.0
2021,1,3070,855,4,7646,3,4,10,10,0,0,0,0,0,0,False,False,False,0,3,2021-09-13T11:08:04.15,0,False,0.0
2021,1,3070,860,4,6983,3,31,10,-1,0,0,0,0,0,0,False,False,False,0,3,2021-09-14T17:49:15.923,0,False,0.0
2021,1,3070,865,4,6983,13,28,4,2,0,0,0,0,0,0,False,False,False,0,1,2021-09-13T11:13:51.74,0,False,0.0
2021,1,3070,870,4,213,2,4,3,14,14,0,14,0,14,0,False,False,False,0,2,2021-09-16T15:54:47.137,14,False,0.0
2021,1,3070,880,4,6953,2,47,5,2,13,11,13,0,13,0,False,False,False,0,3,2021-09-13T11:17:33.067,13,False,0.0
2021,1,3070,895,4,594,2,4,4,7,10,3,9,1,9,0,False,False,False,0,3,2021-09-13T11:20:42.633,10,False,1.0
2021,1,3070,900,4,2853,2,4,3,13,13,0,13,0,13,0,False,False,False,0,2,2021-09-16T15:14:49.623,13,False,0.0
2021,1,3070,905,4,6983,2,4,3,0,5,5,5,0,5,0,False,True,False,0,2,2021-09-16T15:14:49.623,5,False,0.0
2021,1,3070,910,4,594,13,12,2,19,0,0,0,0,0,0,False,False,False,0,3,2021-09-13T11:58:03.99,0,False,
2021,1,3070,915,4,213,13,17,10,14,0,0,0,0,0,0,False,False,False,0,3,2021-09-13T11:58:24.127,0,False,
2021,1,3071,10,2,5223,2,4,7,16,16,0,16,0,16,0,False,False,False,0,3,2021-09-13T08:50:49.11,16,False,0.0
2021,1,3071,25,2,811,2,30,10,2,1,-1,1,0,1,0,False,False,False,0,4,2021-09-13T09:29:03.233,1,False,0.0
2021,1,3071,30,2,5223,2,5,5,7,11,4,8,3,8,0,False,False,False,0,3,2021-09-13T09:33:07.613,11,False,3.0
2021,1,3071,35,2,8389,13,5,5,8,0,0,0,0,0,0,False,False,False,0,3,2021-09-13T09:35:34.013,0,False,0.0
2021,1,3071,45,2,5223,2,6,4,11,12,1,11,1,11,0,False,False,False,0,3,2021-09-17T20:23:39.183,12,False,1.0
2021,1,3071,60,2,5214,2,30,9,0,7,7,5,2,5,0,False,False,False,1,4,2021-09-13T09:50:34.903,7,False,2.0
2021,1,3071,70,2,6247,13,42,9,3,0,0,0,0,0,0,False,False,False,0,2,2021-09-13T09:55:10.913,0,False,0.0
2021,1,3071,75,2,2554,3,46,3,1,0,0,0,0,0,0,False,False,False,0,1,2021-09-13T09:57:14.027,0,False,0.0
2021,1,3071,90,24,7800,2,51,9,-5,10,15,9,1,9,0,False,False,False,0,3,2021-09-13T10:04:46.713,10,False,1.0
2021,1,3071,95,24,7800,2,51,10,-4,11,15,11,0,11,0,False,False,False,0,3,2021-09-17T20:23:12.983,11,True,0.0
2021,1,3071,100,24,7800,2,47,5,0,2,2,2,0,2,0,False,False,False,0,4,2021-09-13T10:10:10.823,2,False,0.0
2021,1,3071,125,24,8509,2,9,6,18,18,0,18,0,18,6,False,False,False,0,3,2021-09-17T18:43:12.997,18,True,0.0
2021,1,3071,145,2,2835,2,30,10,-3,3,6,-2,5,-2,0,False,False,False,1,1,2021-09-15T00:54:57.92,3,False,5.0
2021,1,3071,155,2,5214,2,45,5,-1,7,8,6,1,6,0,True,False,False,0,2,2021-09-13T10:34:30.67,7,False,1.0
2021,1,3071,170,2,8389,13,5,9,4,0,0,0,0,0,0,True,False,False,0,3,2021-09-17T20:22:03.91,0,False,0.0
2021,1,3071,180,2,8389,2,26,10,1,1,0,1,0,1,0,False,False,False,0,4,2022-02-16T16:22:27.28,1,False,0.0
2021,1,3071,210,2,8389,13,5,5,5,0,0,0,0,0,0,False,False,False,0,3,2021-09-13T11:17:44.81,0,False,0.0
2021,1,3071,230,2,2554,13,32,3,2,0,0,0,0,0,0,True,False,False,0,1,2021-09-17T20:56:54.363,0,False,0.0
2021,1,3071,245,24,6373,2,13,5,8,13,5,10,3,10,0,False,False,False,0,4,2021-09-13T11:25:38.367,13,False,3.0
2021,1,3071,250,24,894,2,24,2,26,28,2,28,0,28,0,False,False,False,0,4,2021-09-13T11:28:09.287,28,False,0.0
2021,1,3071,255,24,6937,13,28,4,2,0,0,0,0,0,0,False,False,False,0,1,2021-09-13T11:30:19.99,0,False,0.0
2021,1,3071,265,24,8509,13,2,9,4,0,0,0,0,0,0,False,False,False,0,2,2021-09-17T20:22:15.607,0,False,0.0
2021,1,3071,280,2,2554,2,45,5,-4,9,13,6,3,6,0,False,False,False,1,1,2021-09-15T00:57:08.003,9,False,3.0
2021,1,3071,315,2,5214,2,39,10,6,9,3,9,0,9,0,False,False,False,0,3,2021-09-13T11:59:09.887,9,False,0.0
2021,1,3071,330,24,8509,2,4,10,3,8,5,7,1,7,0,False,False,False,0,2,2021-09-13T12:03:58.73,8,False,1.0
2021,1,3071,335,24,8509,2,4,5,3,4,1,4,0,4,0,False,False,False,0,3,2021-09-13T12:07:09.967,4,False,0.0
2021,1,3071,340,24,8509,2,12,5,12,19,7,17,2,17,0,False,False,False,0,3,2021-09-15T00:35:22.247,19,False,2.0
2021,1,3071,345,24,8509,2,5,5,3,3,0,3,0,3,0,False,False,False,0,3,2021-09-13T12:10:20.283,3,True,0.0
2021,1,3071,355,24,7798,2,25,3,11,9,-2,9,0,9,0,False,False,False,0,2,2021-09-13T16:25:49.35,9,False,0.0
2021,1,3071,365,24,8513,2,45,10,-6,-3,3,-3,0,-3,0,False,False,False,0,1,2021-09-13T12:19:29.937,-3,False,0.0
2021,1,3071,375,24,8509,13,12,5,10,0,0,0,0,0,0,False,False,False,0,2,2021-09-15T00:35:36.397,0,False,0.0
2021,1,3071,380,24,7798,2,50,5,0,1,1,0,1,0,0,False,False,False,0,2,2021-09-13T12:24:29.187,1,False,1.0
2021,1,3071,420,24,8513,2,4,10,0,9,9,9,0,9,0,False,False,False,0,1,2021-09-13T12:37:26.807,9,False,0.0
2021,1,3071,425,24,8513,13,4,5,-2,0,0,0,0,0,0,False,False,False,0,1,2021-09-13T12:38:55.22,0,False,0.0
2021,1,3071,445,24,894,2,32,5,3,6,3,5,1,5,0,False,False,False,0,3,2021-09-13T12:44:35.933,6,False,1.0
2021,1,3071,480,24,7798,2,12,5,9,10,1,10,0,10,0,False,False,False,0,2,2021-09-17T20:27:36.847,10,False,0.0
2021,1,3071,490,24,6373,2,5,5,12,12,0,12,0,12,0,False,False,False,0,3,2021-09-13T12:56:06.463,12,False,0.0
2021,1,3071,500,24,8513,2,30,10,2,4,2,3,1,3,0,False,False,False,0,1,2021-09-13T12:59:20.357,4,False,
2021,1,3071,505,24,6373,2,12,10,9,9,0,9,0,9,6,False,False,False,0,3,2021-09-17T20:25:00.15,9,True,0.0
2021,1,3071,560,2,5223,2,4,9,4,5,1,5,0,5,0,False,False,False,1,2,2021-09-15T00:57:53.947,5,False,0.0
2021,1,3071,570,2,5223,13,6,4,13,0,0,0,0,0,0,False,False,False,0,3,2021-09-17T20:54:43.86,0,False,0.0
2021,1,3071,580,24,7798,2,45,10,-8,-1,7,-1,0,-1,0,True,False,False,0,3,2021-09-13T13:27:50.9,-1,False,0.0
2021,1,3071,610,24,6937,2,45,10,-4,5,9,0,5,0,0,False,False,False,1,1,2021-09-13T13:36:53.07,5,False,5.0
2021,1,3071,615,24,6373,13,4,5,9,0,0,0,0,0,0,False,False,False,0,2,2021-09-13T13:39:22.027,0,False,0.0
2021,1,3071,625,2,8389,2,46,3,2,11,9,11,0,11,0,False,False,False,0,3,2022-02-16T16:30:36.363,11,False,
2021,1,3071,630,2,8389,2,17,7,15,18,3,16,2,16,0,False,False,False,0,3,2021-09-13T13:51:07.403,18,False,2.0
2021,1,3071,640,2,2554,2,44,3,2,21,19,20,1,20,0,True,False,False,0,1,2021-09-15T01:03:28.463,21,False,
2021,1,3071,645,2,5214,2,32,3,3,5,2,5,0,5,0,False,False,False,0,4,2021-09-13T14:02:28.027,5,False,0.0
2021,1,3071,655,24,6373,2,53,10,-5,8,13,5,3,5,0,True,False,False,0,4,2021-09-15T00:20:01.5,8,False,3.0
2021,1,3071,675,24,6937,2,48,10,-8,25,33,-3,28,-3,0,False,False,False,3,1,2021-09-17T20:27:55.43,25,False,28.0
2021,1,3071,700,2,2554,13,42,10,3,0,0,0,0,0,0,True,False,False,0,3,2021-09-15T01:04:02.417,0,False,
2021,1,3071,705,2,811,2,4,5,4,12,8,8,4,8,0,False,False,False,0,2,2021-09-13T14:23:29.983,12,False,4.0
2021,1,3071,720,2,8389,13,7,9,10,0,0,0,0,0,0,False,False,False,0,3,2021-09-17T20:25:29.633,0,False,0.0
2021,1,3071,725,2,5223,13,4,10,11,0,0,0,0,0,0,False,False,False,0,2,2021-09-13T14:32:41.273,0,False,0.0
2021,1,3071,735,24,7798,2,50,10,-3,7,10,4,3,4,0,False,False,False,0,3,2022-02-16T16:23:20.223,7,False,3.0
2021,1,3071,745,24,8509,2,4,10,14,19,5,18,1,18,0,False,False,False,0,2,2021-09-13T14:40:00.99,19,False,1.0
2021,1,3071,755,24,6937,2,46,3,-1,9,10,9,0,9,0,False,False,False,0,1,2021-09-13T14:45:38.867,9,False,0.0
2021,1,3071,770,2,2835,2,39,4,5,6,1,5,1,5,0,True,False,False,0,3,2021-09-15T01:04:28.617,6,False,1.0
2021,1,3071,775,2,2835,2,6,10,7,9,2,7,2,7,0,False,False,False,0,3,2021-09-15T00:59:08.313,9,False,2.0
2021,1,3071,780,2,5223,3,7,2,20,0,0,0,0,0,0,False,False,False,0,3,2022-02-16T16:28:20.033,0,False,0.0
2021,1,3071,785,2,2554,3,45,5,-5,0,0,0,0,0,0,False,False,False,0,1,2021-09-13T14:59:37.193,0,False,0.0
2021,1,3071,790,2,8389,2,4,10,7,7,0,7,0,7,0,False,False,False,0,4,2021-09-17T20:25:40.79,7,False,0.0
2021,1,3071,815,24,6937,2,46,3,0,0,0,0,0,0,0,False,False,False,0,1,2021-09-13T15:09:15.087,0,False,0.0
2021,1,3071,825,2,2554,2,46,3,0,6,6,6,0,6,0,False,False,False,0,1,2021-09-17T20:50:46.887,6,False,0.0
2021,1,3071,830,2,2554,2,4,4,2,8,6,6,2,6,0,False,False,False,1,1,2021-09-13T15:18:46.263,8,False,2.0
2021,1,3071,845,2,5223,2,4,3,7,7,0,7,0,7,0,False,False,False,0,2,2021-09-13T15:26:41.26,7,False,0.0
2021,1,3071,865,24,7798,2,50,3,-2,23,25,23,0,23,6,False,False,False,0,2,2022-02-16T16:30:10.173,23,True,0.0
2021,1,3071,880,2,5223,13,5,6,19,0,0,0,0,0,0,False,False,False,0,3,2021-09-17T20:54:12.107,0,False,
2021,1,3071,885,2,8389,2,5,5,5,5,0,5,0,5,0,False,False,False,0,3,2021-09-13T15:49:07.203,5,False,0.0
2021,1,3071,895,2,6247,13,5,5,9,0,0,0,0,0,0,False,False,False,0,2,2021-09-17T20:53:22.773,0,False,0.0
2021,1,3072,15,8,6439,2,46,3,0,8,8,6,2,6,0,False,False,False,0,1,2021-09-13T09:17:45.047,8,False,2.0
2021,1,3072,25,8,3883,2,47,5,2,14,12,13,1,13,0,True,False,False,0,4,2022-03-08T18:45:52.13,14,False,1.0
2021,1,3072,30,8,4000,3,6,9,5,0,0,0,0,0,0,True,False,False,0,1,2021-09-17T15:55:58.72,0,False,0.0
2021,1,3072,40,8,8349,2,35,8,16,16,0,16,0,16,0,False,False,False,0,3,2022-03-08T18:46:58.697,16,False,0.0
2021,1,3072,50,8,4976,13,12,2,19,0,0,0,0,0,0,False,False,False,0,3,2021-09-13T09:33:44.287,0,False,0.0
2021,1,3072,55,8,3883,2,31,5,8,8,0,8,0,8,0,False,False,False,0,3,2021-09-13T09:36:20.26,8,False,0.0
2021,1,3072,60,8,3883,2,2,9,4,5,1,4,1,4,0,False,False,False,0,2,2021-09-13T09:38:39.983,5,False,1.0
2021,1,3072,95,16,374,2,2,10,11,17,6,13,4,13,0,False,False,False,0,3,2021-09-17T15:57:46.963,17,False,4.0
2021,1,3072,105,16,374,2,2,9,7,9,2,8,1,8,0,False,False,False,0,3,2021-09-13T09:57:35.867,9,False,1.0
2021,1,3072,110,16,7681,2,46,9,-1,11,12,4,7,4,0,False,False,False,2,1,2022-03-08T18:47:26.52,11,False,7.0
2021,1,3072,115,16,3938,2,4,7,17,24,7,24,0,24,0,False,False,False,0,3,2021-09-13T10:04:48.777,24,False,0.0
2021,1,3072,125,16,3938,13,35,10,14,0,0,0,0,0,0,False,False,False,0,3,2021-09-13T10:09:04.187,0,False,0.0
2021,1,3072,130,16,374,2,12,5,6,12,6,9,3,9,0,False,False,False,0,4,2022-02-01T19:19:45.37,12,False,
2021,1,3072,135,16,3938,13,8,8,23,0,0,0,0,0,0,False,False,False,0,3,2021-09-17T15:57:58.23,0,False,
2021,1,3072,140,16,4143,2,12,9,8,9,1,8,1,8,0,False,False,False,0,3,2022-02-01T19:20:02.097,9,False,1.0
2021,1,3072,155,8,8349,2,7,2,39,44,5,44,0,44,0,False,False,False,0,2,2022-03-08T18:48:13.61,44,True,0.0
2021,1,3072,160,8,7652,2,32,3,2,17,15,16,1,16,0,False,False,False,0,4,2021-09-13T10:26:13.357,17,False,1.0
2021,1,3072,180,8,4976,2,4,9,3,3,0,3,0,3,0,False,False,False,0,4,2021-09-13T10:32:33.88,3,False,0.0
2021,1,3072,205,16,3938,2,4,5,4,8,4,8,0,8,0,True,False,False,0,2,2021-09-13T10:42:36.553,8,False,0.0
2021,1,3072,220,16,3938,2,34,10,-4,-6,-2,-5,-1,-5,0,True,False,False,0,4,2021-09-17T16:07:58.54,-6,False,-1.0
2021,1,3072,225,16,7176,13,8,8,24,0,0,0,0,0,0,False,False,False,0,3,2021-09-17T14:58:44.577,0,False,
2021,1,3072,230,16,7176,2,51,3,-3,4,7,2,2,2,0,False,False,False,0,3,2021-09-17T15:57:33.797,4,False,2.0
2021,1,3072,235,16,3938,2,4,9,10,11,1,10,1,10,0,False,False,False,0,3,2021-09-13T10:57:59.407,11,False,1.0
2021,1,3072,240,16,3938,13,12,2,38,0,0,0,0,0,0,False,False,False,0,3,2021-09-13T11:00:09.54,0,False,0.0
2021,1,3072,245,16,6500,2,13,9,3,6,3,4,2,4,0,False,False,False,0,3,2021-09-13T11:02:08.237,6,False,2.0
2021,1,3072,250,16,3938,2,35,6,22,22,0,22,0,22,0,False,False,False,0,3,2021-09-17T15:58:09.563,22,False,0.0
2021,1,3072,255,16,374,2,5,3,12,19,7,14,5,14,0,True,False,False,1,3,2022-03-08T18:49:15.857,19,False,5.0
2021,1,3072,260,16,504,2,55,10,-1,-2,-1,-3,1,-3,0,False,False,False,1,4,2022-02-24T18:51:29.04,-2,False,1.0
2021,1,3072,285,8,8349,2,4,10,5,9,4,6,3,6,0,False,False,False,0,3,2021-09-13T11:20:05.913,9,False,3.0
2021,1,3072,295,8,6439,2,48,9,-3,10,13,9,1,9,0,False,False,False,0,1,2021-09-13T11:23:08.157,10,False,1.0
2021,1,3072,300,8,232,2,3,5,9,9,0,9,0,9,0,True,False,False,0,3,2021-09-13T11:26:25.4,9,False,0.0
2021,1,3072,325,16,3938,2,4,9,3,9,6,7,2,7,0,False,False,False,0,3,2021-09-13T11:37:36.59,9,False,2.0
2021,1,3072,330,16,3938,2,12,2,22,28,6,26,2,26,0,False,False,False,0,3,2021-09-13T11:40:02.177,28,False,2.0
2021,1,3072,345,16,6500,13,13,9,2,0,0,0,0,0,0,False,False,False,0,3,2021-09-17T14:44:27.877,0,False,0.0
2021,1,3072,350,16,3938,13,22,6,25,0,0,0,0,0,0,False,False,False,0,3,2021-09-17T16:00:06.423,0,False,0.0
2021,1,3072,380,8,4976,2,24,2,30,43,13,30,13,30,0,False,False,False,0,3,2021-09-17T16:02:50.723,43,False,13.0
2021,1,3072,395,8,8349,13,9,6,36,0,0,0,0,0,0,False,False,False,0,3,2021-09-13T12:01:41.39,0,False,0.0
2021,1,3072,400,8,4976,13,12,8,36,0,0,0,0,0,0,False,False,False,0,3,2022-02-01T19:20:17,0,False,
2021,1,3072,415,8,232,2,49,5,3,32,29,30,2,30,0,False,False,False,1,2,2021-09-17T16:10:08.89,32,False,2.0
2021,1,3072,440,16,3938,2,4,5,6,6,0,6,0,6,0,True,False,False,0,2,2021-09-13T12:31:43.173,6,False,0.0
2021,1,3072,450,16,7176,2,4,9,5,7,2,5,2,5,0,False,False,False,0,2,2021-09-13T12:36:13.803,7,False,2.0
2021,1,3072,460,16,374,2,4,10,6,12,6,8,4,8,0,False,False,False,1,3,2021-09-17T16:03:08.643,12,False,4.0
2021,1,3072,465,16,374,13,6,10,9,0,0,0,0,0,0,False,False,False,0,3,2021-09-13T12:43:49.01,0,False,0.0
2021,1,3072,485,16,3938,2,13,10,8,6,-2,7,-1,7,0,False,False,False,0,3,2021-09-13T12:51:38.523,6,False,-1.0
2021,1,3072,505,16,374,2,5,3,6,11,5,8,3,8,6,False,False,False,0,3,2021-09-13T12:58:18.767,11,False,3.0
2021,1,3072,540,16,7176,2,30,5,-2,8,10,8,0,8,0,True,False,False,0,1,2022-03-08T18:49:41.823,8,True,0.0
2021,1,3072,555,16,2568,2,47,5,0,3,3,1,2,1,0,False,False,False,0,4,2022-02-16T18:15:28.583,3,False,2.0
2021,1,3072,560,16,7681,2,44,3,-3,14,17,13,1,13,0,False,False,False,0,1,2021-09-13T13:22:01.523,14,False,1.0
2021,1,3072,580,16,4143,13,12,2,25,0,0,0,0,0,0,False,False,False,0,2,2022-02-01T19:20:34.257,0,False,0.0
2021,1,3072,595,8,232,2,2,10,5,11,6,6,5,6,0,False,False,False,0,2,2021-09-13T13:33:36.24,11,False,5.0
2021,1,3072,610,8,232,2,44,3,-7,9,16,9,0,9,0,True,False,False,0,3,2021-09-17T16:03:33.203,9,True,0.0
2021,1,3072,620,8,4976,2,35,6,23,30,7,26,4,26,0,False,False,False,0,4,2021-09-13T13:46:46.51,30,False,4.0
2021,1,3072,655,16,3938,2,12,2,45,75,30,75,0,75,6,False,False,False,0,3,2022-02-16T18:19:11.81,75,True,0.0
2021,1,3072,675,8,5053,2,5,3,4,4,0,4,0,4,0,False,False,False,0,1,2022-02-16T18:18:30.19,4,False,0.0
2021,1,3072,680,8,4976,13,12,6,27,0,0,0,0,0,0,False,False,False,0,3,2021-09-17T14:57:12.847,0,False,0.0
2021,1,3072,700,16,374,2,4,9,4,8,4,5,3,5,6,False,False,False,1,3,2021-09-13T14:14:26.993,8,False,3.0
2021,1,3072,720,8,232,2,4,10,7,10,3,9,1,9,0,False,False,False,0,3,2021-09-13T14:20:47.537,10,False,1.0
2021,1,3072,730,8,8349,13,19,6,28,0,0,0,0,0,0,False,False,False,0,2,2021-09-13T14:23:56.827,0,False,0.0
2021,1,3072,745,16,7681,2,18,3,-2,4,6,1,3,1,0,False,False,False,0,2,2021-09-17T14:58:44.577,4,False,3.0
2021,1,3072,750,16,3938,2,4,5,11,14,3,13,1,13,0,False,False,False,0,3,2021-09-13T14:32:52.373,14,False,1.0
2021,1,3072,770,16,3938,13,2,10,6,0,0,0,0,0,0,False,False,False,0,2,2021-09-17T15:56:14.687,0,False,0.0
2021,1,3072,790,8,5053,2,47,5,0,3,3,1,2,1,0,False,False,False,0,1,2021-09-13T14:40:53.14,3,False,2.0
2021,1,3072,800,8,7651,2,2,10,4,4,0,4,0,4,0,False,False,False,0,2,2021-09-13T14:44:27.85,4,False,0.0
2021,1,3072,805,8,5053,2,48,10,-4,19,23,14,5,14,0,False,False,False,0,1,2021-09-17T16:04:25.42,19,False,5.0
2021,1,3072,810,8,7652,13,12,3,10,0,0,0,0,0,0,False,False,False,0,3,2022-02-01T19:21:42.09,0,False,0.0
2021,1,3073,15,20,8131,2,35,10,13,14,1,14,0,14,0,False,False,False,0,3,2021-09-13T11:21:00.017,14,False,0.0
2021,1,3073,40,20,7888,13,13,4,5,0,0,0,0,0,0,False,False,False,0,3,2022-02-16T19:38:24.227,0,False,0.0
2021,1,3073,45,20,8131,13,19,2,25,0,0,0,0,0,0,False,False,False,0,3,2021-09-13T11:45:39.603,0,False,0.0
2021,1,3073,65,12,556,2,5,3,4,4,0,4,0,4,0,False,False,False,0,3,2021-09-13T11:49:50.977,4,False,0.0
2021,1,3073,70,12,4537,2,13,5,1,6,5,4,2,4,0,False,False,False,0,3,2021-09-13T11:51:51.35,6,False,2.0
2021,1,3073,80,12,6357,2,4,9,1,3,2,1,2,1,0,False,False,False,0,2,2021-09-13T11:53:19.043,3,False,2.0
2021,1,3073,90,12,4511,3,54,5,-2,0,0,0,0,0,0,True,False,False,0,4,2022-02-16T19:41:43.807,0,False,0.0
2021,1,3073,120,20,5140,2,45,5,-5,3,8,2,1,2,0,True,False,False,0,1,2021-09-17T17:28:31.36,3,False,1.0
2021,1,3073,130,20,7353,2,5,6,17,17,0,17,0,17,0,False,False,False,0,2,2021-09-13T12:12:07.367,17,True,0.0
2021,1,3073,160,20,5140,2,5,9,0,2,2,2,0,2,0,False,False,False,0,1,2021-09-13T12:19:48.653,2,False,0.0
2021,1,3073,180,20,8126,2,47,5,0,3,3,2,1,2,0,False,False,False,0,1,2021-09-13T12:21:59.34,3,False,1.0
2021,1,3073,185,20,5140,2,34,4,-4,3,7,1,2,1,6,True,False,False,0,3,2021-09-13T12:23:04.247,3,False,2.0
2021,1,3073,215,12,556,2,6,10,7,7,0,7,0,7,0,False,False,False,0,3,2021-09-13T12:28:54.517,7,False,0.0
2021,1,3073,220,12,6357,13,5,2,17,0,0,0,0,0,0,False,False,False,0,3,2021-09-17T18:55:34.01,0,False,0.0
2021,1,3073,230,20,7888,2,53,10,-4,8,12,3,5,3,0,False,False,False,0,4,2021-09-13T12:35:20.62,8,False,5.0
2021,1,3073,280,20,8127,2,53,10,-6,12,18,8,4,8,0,False,False,False,0,4,2021-09-13T12:55:57.003,12,False,4.0
2021,1,3073,295,20,2408,2,47,5,0,5,5,3,2,3,0,True,False,False,0,3,2021-09-13T12:59:19.653,5,False,2.0
2021,1,3073,320,20,8127,2,7,10,1,1,0,1,0,1,6,False,False,False,0,4,2021-09-13T13:04:55.027,1,True,0.0
2021,1,3073,335,12,6691,2,8,10,13,14,1,13,1,13,0,False,False,False,0,2,2021-09-13T13:06:46.323,14,False,1.0
2021,1,3073,340,12,6691,13,9,5,14,0,0,0,0,0,0,False,False,False,0,2,2021-09-13T13:07:43.777,0,False,0.0
2021,1,3073,345,12,6357,2,5,3,3,4,1,4,0,4,0,False,False,False,0,3,2021-09-13T14:20:29.367,4,False,0.0
2021,1,3073,350,12,6691,13,19,2,23,0,0,0,0,0,0,False,False,False,0,2,2021-09-13T13:13:55.71,0,False,
2021,1,3073,355,12,556,2,7,2,28,31,3,29,2,29,0,False,False,False,0,3,2021-09-13T14:22:16.777,31,False,2.0
2021,1,3073,370,12,4511,13,5,3,5,0,0,0,0,0,0,False,False,False,0,2,2021-09-13T13:26:09.313,0,False,0.0
2021,1,3073,390,12,556,13,2,9,5,0,0,0,0,0,0,False,False,False,0,2,2021-09-13T13:31:00.393,0,False,
2021,1,3073,400,12,6357,2,17,4,6,10,4,10,0,10,0,False,False,False,0,3,2021-09-13T13:44:53.887,10,False,0.0
2021,1,3073,405,12,467,2,13,9,5,19,14,18,1,18,0,False,False,False,0,4,2021-09-13T13:46:01.127,19,False,1.0
2021,1,3073,410,12,6357,13,19,6,38,0,0,0,0,0,0,False,False,False,0,2,2021-09-13T13:53:29.837,0,False,0.0
2021,1,3073,415,12,4537,2,48,9,-2,7,9,6,1,6,0,False,False,False,0,1,2021-09-13T13:54:55.003,7,False,1.0
2021,1,3073,420,12,6357,13,7,2,21,0,0,0,0,0,0,False,False,False,0,2,2021-09-13T13:57:39.36,0,False,0.0
2021,1,3073,425,12,4511,13,36,10,13,0,0,0,0,0,0,False,False,False,0,3,2021-09-13T13:59:05.247,0,False,
2021,1,3073,430,12,556,2,18,5,-1,8,9,4,4,4,0,False,False,False,1,3,2021-09-13T14:12:08.757,8,False,4.0
2021,1,3073,435,12,4511,2,53,4,-2,5,7,4,1,4,0,False,False,False,0,4,2021-09-13T14:13:29.667,5,False,1.0
2021,1,3073,445,12,556,13,13,9,2,0,0,0,0,0,0,False,False,False,0,3,2021-09-13T16:42:19.74,0,False,0.0
2021,1,3073,450,20,7888,2,28,9,6,6,0,6,0,6,0,False,False,False,0,4,2021-09-17T18:57:17.033,6,False,0.0
2021,1,3073,470,20,7888,2,26,10,5,4,-1,4,0,4,0,False,False,False,0,3,2021-09-13T14:28:28.57,4,False,0.0
2021,1,3073,475,20,5140,13,5,5,4,0,0,0,0,0,0,False,False,False,0,1,2021-09-13T14:30:33.727,0,False,0.0
2021,1,3073,480,20,7888,3,38,9,6,0,0,0,0,0,0,False,False,False,0,3,2021-09-13T14:32:14.597,0,False,0.0
2021,1,3073,490,12,6357,13,12,4,5,0,0,0,0,0,0,False,False,False,0,3,2021-09-13T14:37:35.897,0,False,0.0
2021,1,3073,495,12,4537,2,46,3,-2,6,8,4,2,4,0,False,False,False,0,1,2021-09-13T14:38:48.813,6,False,
2021,1,3073,505,12,6357,13,8,8,57,0,0,0,0,0,0,False,False,False,0,3,2021-09-13T16:42:33.06,0,False,0.0
2021,1,3073,520,20,1361,2,12,9,10,10,0,10,0,10,6,False,False,False,0,3,2021-09-17T18:58:43.657,10,True,0.0
2021,1,3073,540,12,6691,13,12,5,1,0,0,0,0,0,0,True,False,False,0,3,2021-09-13T15:04:11.417,0,False,0.0
2021,1,3073,545,12,556,2,2,10,4,6,2,6,0,6,0,False,False,False,0,3,2021-09-13T16:51:03.837,6,False,0.0
2021,1,3073,550,12,556,13,13,5,5,0,0,0,0,0,0,False,False,False,0,3,2021-09-13T15:07:07.213,0,False,0.0
2021,1,3073,555,20,7888,3,35,5,12,0,0,0,0,0,0,False,False,False,0,4,2021-09-13T15:08:38.633,0,False,0.0
2021,1,3073,565,20,8127,13,17,1,20,0,0,0,0,0,0,False,False,False,0,3,2021-09-13T15:12:03.08,0,False,
2021,1,3073,580,20,8127,2,9,3,8,8,0,8,0,8,6,False,False,False,0,3,2021-09-13T15:16:52.653,8,True,0.0
2021,1,3073,595,12,6691,2,51,9,-6,2,8,0,2,0,0,True,False,False,0,4,2021-09-13T15:19:35.69,2,False,2.0
2021,1,3073,600,12,7742,2,48,9,-4,7,11,-3,10,-3,0,False,False,False,1,1,2021-09-13T15:20:56.713,7,False,10.0
2021,1,3073,610,12,7742,13,12,5,2,0,0,0,0,0,0,False,False,False,0,1,2021-09-13T15:25:10.743,0,False,0.0
2021,1,3073,640,20,7353,2,7,6,48,55,7,55,0,55,6,True,False,False,0,2,2021-09-13T15:32:39.44,55,True,0.0
2021,1,3073,665,12,8371,2,35,3,14,19,5,19,0,19,0,False,False,False,0,3,2021-09-13T15:40:16.683,19,False,0.0
2021,1,3073,675,12,4511,2,46,3,0,3,3,2,1,2,0,True,False,False,0,4,2021-09-13T16:52:38.753,3,False,1.0
2021,1,3073,680,12,7460,13,19,6,23,0,0,0,0,0,0,False,False,False,0,2,2021-09-13T15:45:01.873,0,False,0.0
2021,1,3073,725,12,496,2,8,6,28,32,4,32,0,32,0,False,False,False,0,3,2021-09-13T16:05:38.163,32,True,0.0
2021,1,3073,735,12,6691,13,29,6,17,0,0,0,0,0,0,False,False,False,0,2,2021-09-13T16:17:52.727,0,False,0.0
2021,1,3073,755,12,7460,2,51,3,-1,7,8,5,2,5,0,False,False,False,0,3,2021-09-13T16:17:44.36,7,False,2.0
2021,1,3073,760,12,7460,2,2,9,6,7,1,6,1,6,0,False,False,False,1,2,2021-09-17T19:24:09.33,7,False,1.0
2021,1,3074,15,21,7090,13,5,3,5,0,0,0,0,0,0,False,False,False,0,2,2021-09-13T08:52:45.2,0,False,0.0
2021,1,3074,20,21,7090,2,19,2,38,42,4,42,0,42,0,False,False,False,0,2,2021-09-17T15:00:11.113,42,False,0.0
2021,1,3074,25,21,8518,2,34,4,-4,-6,-2,-5,-1,-5,0,True,False,False,0,3,2021-09-15T02:19:58.307,-6,False,-1.0
2021,1,3074,35,21,3680,13,3,3,7,0,0,0,0,0,0,False,False,False,0,3,2021-09-17T13:35:59.04,0,False,0.0
2021,1,3074,55,10,6840,2,2,4,10,15,5,15,0,15,0,False,False,False,0,3,2022-02-16T20:04:37.88,15,False,0.0
2021,1,3074,70,10,6281,13,19,6,31,0,0,0,0,0,0,False,False,False,0,2,2021-09-17T14:27:06.583,0,False,0.0
2021,1,3074,85,21,8518,2,51,9,-6,4,10,2,2,2,0,True,False,False,0,1,2021-09-17T13:37:14.8,4,False,2.0
2021,1,3074,100,10,7700,2,4,7,16,13,-3,13,0,13,0,False,False,False,1,2,2021-09-17T16:21:26.84,13,False,0.0
2021,1,3074,105,10,4702,2,32,10,-1,7,8,5,2,5,0,False,False,False,0,4,2021-09-17T14:27:55.537,7,False,2.0
2021,1,3074,120,10,4930,2,4,9,6,6,0,5,1,5,0,True,False,False,0,3,2021-09-15T03:11:04.337,6,False,1.0
2021,1,3074,130,10,282,2,47,5,1,1,0,1,0,1,0,False,False,False,0,1,2021-09-17T14:29:00.367,1,False,0.0
2021,1,3074,135,10,7700,13,7,6,19,0,0,0,0,0,0,False,False,False,0,3,2021-09-17T14:29:17.867,0,False,0.0
2021,1,3074,140,10,4930,2,6,4,12,15,3,13,2,13,0,False,False,False,0,2,2021-09-13T10:04:54.287,15,False,2.0
2021,1,3074,150,10,7701,2,6,4,7,9,2,9,0,9,0,False,False,False,0,3,2021-09-15T03:11:17.737,9,False,0.0
2021,1,3074,165,10,6840,13,32,5,1,0,0,0,0,0,0,False,False,False,0,4,2021-09-13T10:16:59,0,False,0.0
2021,1,3074,190,21,4492,2,8,1,15,17,2,17,0,17,0,False,False,False,0,3,2021-09-17T16:11:40.613,17,False,0.0
2021,1,3074,200,21,6228,2,48,10,-5,1,6,1,0,1,0,False,False,False,1,1,2021-09-17T15:03:01.43,1,False,0.0
2021,1,3074,205,21,7090,13,2,9,4,0,0,0,0,0,0,False,False,False,0,2,2021-09-17T14:30:08.933,0,False,
2021,1,3074,210,21,3957,2,5,9,2,6,4,4,2,4,0,False,False,False,0,1,2021-09-17T15:03:57.053,6,False,2.0
2021,1,3074,220,21,3680,2,2,4,4,8,4,5,3,5,0,False,False,False,0,3,2021-09-13T10:45:09.443,8,False,3.0
2021,1,3074,225,21,3680,2,35,3,14,37,23,16,21,16,6,False,False,False,1,3,2021-09-17T16:22:28.21,37,False,21.0
2021,1,3074,240,10,6840,2,5,3,3,5,2,4,1,4,0,True,False,False,0,1,2021-09-17T13:38:25.85,5,False,1.0
2021,1,3074,250,10,6840,2,43,3,12,25,13,20,5,20,0,False,False,False,0,4,2021-09-17T16:06:33.74,25,False,5.0
2021,1,3074,255,10,8541,2,48,9,-8,-4,4,-8,4,-8,0,False,False,False,1,1,2021-09-17T14:30:33.343,-4,False,4.0
2021,1,3074,260,10,7700,2,4,5,4,5,1,5,0,5,0,False,False,False,0,3,2021-09-13T11:18:50.513,5,False,0.0
2021,1,3074,265,10,7700,2,26,3,3,11,8,11,0,11,0,False,False,False,0,3,2021-09-17T15:07:00.62,11,False,0.0
2021,1,3074,275,10,7703,2,32,3,-1,6,7,4,2,4,0,False,True,True,0,4,2021-09-13T11:30:13.337,6,False,2.0
2021,1,3074,285,21,4180,13,46,3,2,0,0,0,0,0,0,False,False,False,0,1,2022-02-16T20:00:19.293,0,False,0.0
2021,1,3074,290,21,813,2,46,3,1,2,1,2,0,2,0,True,False,False,0,3,2021-09-15T02:20:54.387,2,False,0.0
2021,1,3074,300,10,6840,2,28,4,2,2,0,2,0,2,0,False,False,False,0,4,2021-09-13T11:46:32.75,2,False,0.0
2021,1,3074,315,10,7700,2,39,4,6,6,0,6,0,6,0,False,False,False,0,3,2021-09-17T14:30:52.7,6,False,0.0
2021,1,3074,325,10,6281,2,8,4,13,14,1,14,0,14,0,False,False,False,0,3,2021-09-13T11:56:56.207,14,False,0.0
2021,1,3074,330,10,7700,2,5,5,14,17,3,17,0,17,0,False,False,False,0,3,2021-09-13T12:00:23.687,17,False,0.0
2021,1,3074,335,10,4930,2,5,5,13,16,3,15,1,15,0,False,False,False,1,3,2021-09-17T16:25:40.027,16,False,1.0
2021,1,3074,345,10,4930,2,30,3,1,2,1,2,0,2,6,True,False,False,0,4,2021-09-17T16:12:59.397,2,True,0.0
2021,1,3074,380,10,6281,13,6,3,6,0,0,0,0,0,0,False,False,False,0,2,2021-09-17T16:07:52.497,0,False,0.0
2021,1,3074,385,10,7701,2,12,10,8,10,2,9,1,9,0,False,False,False,0,2,2022-02-01T19:23:40.737,10,False,1.0
2021,1,3074,395,10,6840,13,35,2,24,0,0,0,0,0,0,False,False,False,0,4,2021-09-17T14:31:17.853,0,False,0.0
2021,1,3074,400,10,7703,2,13,3,5,6,1,5,1,5,0,False,False,False,0,4,2021-09-13T12:43:59.38,6,False,1.0
2021,1,3074,405,10,7701,3,17,1,49,0,0,0,0,0,0,False,False,False,0,2,2021-09-13T12:46:53.763,0,False,0.0
2021,1,3074,415,10,6840,2,13,4,3,8,5,5,3,5,0,False,False,False,0,3,2021-09-13T12:51:23.373,8,False,3.0
2021,1,3074,430,10,7700,2,35,6,20,20,0,20,0,20,0,False,False,False,0,3,2021-09-13T12:59:22.657,20,False,0.0
2021,1,3074,445,10,6840,2,5,5,5,7,2,5,2,5,0,False,False,False,0,3,2021-09-13T13:07:24.63,7,False,2.0
2021,1,3074,450,10,7703,2,12,10,-4,4,8,-3,7,-3,6,False,False,False,1,4,2022-02-01T19:23:55.953,4,False,7.0
2021,1,3074,475,21,813,13,39,4,5,0,0,0,0,0,0,False,False,False,0,4,2021-09-17T16:08:38.767,0,False,0.0
2021,1,3074,480,21,3680,2,5,5,6,15,9,10,5,10,0,True,False,False,0,3,2021-09-15T02:22:06.563,15,False,5.0
2021,1,3074,490,21,3680,13,4,10,13,0,0,0,0,0,0,False,False,False,0,3,2021-09-13T13:27:01.513,0,False,0.0
2021,1,3074,495,21,3680,2,8,8,15,20,5,15,5,15,0,False,False,False,0,2,2021-09-17T13:41:34.28,20,False,5.0
2021,1,3074,500,21,7090,2,3,5,9,8,-1,8,0,8,0,False,False,False,0,2,2021-09-13T13:32:16.21,8,False,0.0
2021,1,3074,505,21,7090,13,5,5,4,0,0,0,0,0,0,False,False,False,0,3,2021-09-13T13:34:31.54,0,False,0.0
2021,1,3074,525,10,4702,3,32,10,1,0,0,0,0,0,0,False,False,False,0,4,2021-09-13T13:44:05.4,0,False,0.0
2021,1,3074,530,10,7701,2,5,2,22,22,0,22,0,22,0,False,False,False,0,2,2022-02-16T20:06:47.46,22,True,0.0
2021,1,3074,565,10,282,2,48,10,-5,13,18,11,2,11,0,False,False,False,0,1,2021-09-13T14:02:47.647,13,False,2.0
2021,1,3074,600,21,7090,3,26,9,2,0,0,0,0,0,0,True,False,False,0,2,2022-02-16T20:01:27.92,0,False,0.0
2021,1,3074,615,21,4492,2,6,7,17,17,0,17,0,17,0,False,False,False,0,3,2021-09-13T14:27:22.007,17,False,0.0
2021,1,3074,620,21,6228,3,4,4,5,0,0,0,0,0,0,False,False,False,0,1,2021-09-17T14:33:43.97,0,False,0.0
2021,1,3074,635,21,6228,13,17,5,7,0,0,0,0,0,0,True,False,False,0,1,2021-09-17T14:54:17.41,0,False,0.0
2021,1,3074,645,21,813,13,7,5,6,0,0,0,0,0,0,False,False,False,0,3,2022-02-25T14:37:39.98,0,False,0.0
2021,1,3074,650,21,4492,13,5,5,6,0,0,0,0,0,0,False,False,False,0,2,2021-09-17T16:13:41.25,0,False,0.0
2021,1,3074,665,10,282,2,44,3,0,3,3,1,2,1,0,False,False,False,0,1,2021-09-15T03:10:42.297,3,False,2.0
2021,1,3074,685,21,4492,2,3,3,14,14,0,14,0,14,0,False,False,False,0,2,2021-09-13T16:00:02.227,14,False,0.0
2021,1,3074,690,21,813,2,31,10,4,6,2,4,2,4,0,False,False,False,0,4,2021-09-17T14:38:13.417,6,False,2.0
2021,1,3074,695,21,4492,2,6,1,16,16,0,16,0,16,0,False,False,False,0,2,2021-09-13T15:12:30.12,16,False,0.0
2021,1,3074,700,21,813,13,17,4,11,0,0,0,0,0,0,False,False,False,0,4,2021-09-17T13:44:27.323,0,False,0.0
2021,1,3074,705,21,7090,13,5,3,10,0,0,0,0,0,0,False,False,False,0,2,2021-09-13T15:14:47.41,0,False,0.0
2021,1,3074,720,21,4492,13,9,6,21,0,0,0,0,0,0,False,False,False,0,2,2021-09-13T15:19:11.327,0,False,0.0
2021,1,3074,755,21,3680,2,8,1,15,16,1,16,0,16,0,False,False,False,0,2,2021-09-17T13:44:58.423,16,False,0.0
2021,1,3074,760,21,8522,2,47,10,0,6,6,6,0,6,0,False,False,False,0,1,2021-09-13T15:34:24.56,6,False,0.0
2021,1,3074,765,21,3680,2,5,3,8,9,1,9,0,9,0,False,False,False,0,3,2021-09-13T15:37:01.823,9,False,0.0
2021,1,3074,770,21,7090,2,12,2,15,15,0,15,0,15,0,False,False,False,0,2,2021-09-13T15:39:41.687,15,False,0.0
2021,1,3074,780,21,3680,2,4,9,8,8,0,8,0,8,0,False,False,False,0,3,2021-09-13T15:46:19.59,8,False,0.0
2021,1,3074,785,21,5015,2,5,3,6,6,0,6,0,6,0,False,False,False,0,2,2021-09-13T15:48:58.803,6,False,0.0
2021,1,3075,40,19,1328,2,38,4,1,4,3,4,0,4,0,False,False,False,0,1,2022-02-24T18:52:10.943,4,False,0.0
2021,1,3075,50,17,8483,2,4,9,7,17,10,13,4,13,0,False,False,False,2,3,2021-09-13T09:37:26.273,17,False,4.0
2021,1,3075,60,17,8483,2,54,5,0,5,5,5,0,5,0,True,False,False,0,3,2021-09-17T14:53:18.38,5,False,0.0
2021,1,3075,75,17,6276,2,28,10,3,9,6,7,2,7,0,False,False,False,0,1,2021-09-13T16:03:35.57,9,False,2.0
2021,1,3075,85,17,7618,2,51,3,-3,18,21,18,0,18,0,True,False,False,0,1,2021-09-13T09:56:22.21,18,False,0.0
2021,1,3075,110,19,2256,2,4,3,4,7,3,5,2,5,0,False,False,False,0,2,2021-09-13T10:05:07.323,7,False,2.0
2021,1,3075,120,19,7175,2,47,5,2,4,2,3,1,3,0,False,False,False,0,3,2021-09-17T17:08:20.453,4,False,1.0
2021,1,3075,125,19,8493,2,28,4,-2,9,11,4,5,4,0,False,True,True,1,1,2021-09-17T16:40:07.77,9,False,5.0
2021,1,3075,130,17,6274,13,2,4,11,0,0,0,0,0,0,False,False,False,0,3,2022-02-16T19:26:22.507,0,False,0.0
2021,1,3075,170,19,5096,2,4,9,3,8,5,5,3,5,0,False,False,False,0,3,2021-09-17T17:12:26.95,8,False,3.0
2021,1,3075,190,19,7175,2,13,3,4,5,1,5,0,5,0,False,False,False,0,3,2021-09-17T14:53:18.38,5,False,0.0
2021,1,3075,195,19,7175,13,4,10,4,0,0,0,0,0,0,False,False,False,0,3,2021-09-13T10:37:18.057,0,False,0.0
2021,1,3075,205,19,7175,2,11,3,7,22,15,20,2,20,0,False,False,False,0,3,2021-09-13T10:41:35.8,22,False,2.0
2021,1,3075,220,19,5096,2,13,10,6,6,0,6,0,6,0,False,False,False,0,3,2021-09-17T14:53:18.38,6,False,0.0
2021,1,3075,225,19,5096,2,50,3,-3,7,10,5,2,5,0,True,True,False,0,2,2021-09-14T16:25:32.653,7,False,2.0
2021,1,3075,240,17,6274,13,29,3,13,0,0,0,0,0,0,False,False,False,0,3,2021-09-17T16:36:55.133,0,False,0.0
2021,1,3075,245,17,2253,2,6,3,11,23,12,19,4,19,0,False,False,False,0,2,2021-09-13T10:58:16.783,23,False,4.0
2021,1,3075,250,17,2253,13,6,1,17,0,0,0,0,0,0,False,False,False,0,2,2021-09-17T16:28:23.023,0,False,0.0
2021,1,3075,255,17,2253,13,2,10,11,0,0,0,0,0,0,False,False,False,0,3,2021-09-17T17:12:52.167,0,False,0.0
2021,1,3075,260,17,8483,3,5,5,14,0,0,0,0,0,0,False,False,False,0,3,2021-09-13T11:05:57.153,0,False,0.0
2021,1,3075,270,19,2256,2,6,9,12,12,0,12,0,12,0,False,False,False,0,3,2021-09-13T11:11:44.1,12,False,0.0
2021,1,3075,280,19,7175,13,8,7,28,0,0,0,0,0,0,False,False,False,0,3,2022-02-16T19:28:16.24,0,False,0.0
2021,1,3075,285,19,2256,13,5,5,7,0,0,0,0,0,0,False,False,False,0,3,2021-09-13T16:12:36.577,0,False,0.0
2021,1,3075,295,17,7618,2,45,5,-1,6,7,-1,7,-1,0,False,False,False,1,1,2021-09-13T11:20:43.2,6,False,7.0
2021,1,3075,305,17,8483,13,12,2,20,0,0,0,0,0,0,False,False,False,0,3,2022-02-16T19:27:20.563,0,False,0.0
2021,1,3075,315,19,7172,2,47,5,-1,8,9,6,2,6,0,False,False,False,1,1,2021-09-17T16:45:54.853,8,False,2.0
2021,1,3075,325,19,2256,2,17,1,25,25,0,25,0,25,0,False,False,False,0,3,2021-09-17T14:53:18.38,25,False,0.0
2021,1,3075,330,19,1328,13,5,3,3,0,0,0,0,0,0,True,False,False,0,3,2021-09-14T16:25:47.32,0,False,0.0
2021,1,3075,335,19,7172,2,5,9,1,9,8,7,2,7,0,False,False,False,0,1,2021-09-13T11:39:19.36,9,False,2.0
2021,1,3075,350,19,2256,2,4,9,4,7,3,7,0,7,6,False,False,False,0,3,2021-09-17T16:46:38.237,7,True,0.0
2021,1,3075,365,17,8483,2,19,6,28,36,8,36,0,36,0,False,False,False,0,3,2021-09-13T16:10:30.927,36,False,0.0
2021,1,3075,380,17,2253,13,29,6,15,0,0,0,0,0,0,False,False,False,0,3,2021-09-13T12:08:20.247,0,False,0.0
2021,1,3075,385,17,7024,2,5,5,4,4,0,4,0,4,0,False,False,False,0,1,2021-09-13T15:42:15.69,4,False,0.0
2021,1,3075,405,17,7024,2,5,5,2,10,8,10,0,10,0,False,False,False,0,1,2021-09-17T17:19:13.803,10,True,0.0
2021,1,3075,410,17,364,13,21,6,23,0,0,0,0,0,0,True,False,False,0,2,2021-09-14T23:04:15.503,0,False,0.0
2021,1,3075,445,17,6276,3,4,10,3,0,0,0,0,0,0,False,False,False,0,3,2021-09-13T12:26:33.017,0,False,0.0
2021,1,3075,450,17,2253,2,19,2,30,30,0,30,0,30,0,False,False,False,0,2,2021-09-13T12:28:28.413,30,False,0.0
2021,1,3075,460,17,7024,2,2,10,3,12,9,12,0,12,0,True,False,False,0,2,2021-09-17T17:22:12.54,12,False,0.0
2021,1,3075,480,17,8483,2,47,5,0,3,3,1,2,1,6,True,False,False,0,3,2022-02-16T19:20:37.3,3,False,2.0
2021,1,3075,510,19,2256,2,4,9,2,5,3,3,2,3,0,False,False,False,0,3,2022-02-16T19:30:06.927,5,False,
2021,1,3075,515,19,7172,13,28,4,4,0,0,0,0,0,0,False,False,False,0,1,2021-09-17T17:25:00.76,0,False,0.0
2021,1,3075,520,19,2256,2,29,6,21,21,0,21,0,21,0,False,False,False,0,2,2021-09-13T13:05:20.23,21,False,0.0
2021,1,3075,525,19,4912,2,12,2,26,33,7,31,2,31,0,False,False,False,1,2,2021-09-17T16:59:21.4,33,False,
2021,1,3075,530,19,4912,2,44,3,1,11,10,11,0,11,0,True,False,False,0,3,2021-11-09T14:04:57.017,11,False,
2021,1,3075,540,19,2256,13,6,4,12,0,0,0,0,0,0,False,False,False,0,2,2021-09-13T16:18:51.863,0,False,0.0
2021,1,3075,545,19,1328,2,11,2,16,26,10,16,10,16,0,False,False,False,0,1,2021-09-13T13:17:02.313,26,False,10.0
2021,1,3075,550,19,4282,2,12,5,5,9,4,8,1,8,0,False,False,False,0,4,2021-09-13T13:19:10.183,9,False,1.0
2021,1,3075,565,19,1328,2,5,3,3,6,3,4,2,4,0,False,False,False,0,1,2021-09-13T13:24:36.757,6,False,2.0
2021,1,3075,570,19,4912,13,29,6,15,0,0,0,0,0,0,True,False,False,0,3,2021-09-17T16:45:09.647,0,False,0.0
2021,1,3075,590,17,7618,13,19,2,29,0,0,0,0,0,0,False,False,False,0,2,2021-09-13T13:36:23.507,0,False,0.0
2021,1,3075,595,17,7024,2,48,10,-4,-2,2,-2,0,-2,0,False,False,False,0,1,2021-09-13T16:15:52.453,-2,False,0.0
2021,1,3075,605,19,4912,2,13,9,5,17,12,17,0,17,0,False,False,False,4,3,2021-09-13T15:50:01.977,17,False,0.0
2021,1,3075,615,19,4282,2,6,9,11,16,5,13,3,13,0,False,False,False,0,3,2021-09-17T14:53:18.38,16,False,3.0
2021,1,3075,625,19,1328,2,4,3,3,4,1,4,0,4,0,True,False,False,0,2,2021-09-17T17:25:55.187,4,False,0.0
2021,1,3075,630,19,1328,2,30,10,-5,1,6,0,1,0,0,False,False,False,0,1,2021-09-17T16:30:26.277,1,False,1.0
2021,1,3075,635,19,4282,2,5,5,6,6,0,6,0,6,0,False,False,False,0,3,2021-09-13T14:13:33.29,6,False,0.0
2021,1,3075,640,19,5096,2,47,5,4,10,6,8,2,8,0,False,False,False,0,4,2021-09-13T14:10:32.767,10,False,2.0
2021,1,3075,645,19,7175,2,46,5,-1,3,4,3,0,3,0,True,False,False,0,3,2021-09-14T16:26:32.763,3,False,0.0
2021,1,3075,650,19,4912,13,50,3,-1,0,0,0,0,0,0,False,False,False,0,3,2021-09-17T17:26:33.093,0,True,0.0
2021,1,3075,655,19,1328,2,4,10,4,8,4,7,1,7,0,False,False,False,0,1,2021-09-13T14:18:02.45,8,False,1.0
2021,1,3075,670,19,7175,3,47,5,3,0,0,0,0,0,0,True,False,False,0,3,2021-09-14T16:26:43.28,0,False,0.0
2021,1,3075,685,17,2253,2,2,9,3,15,12,12,3,12,0,False,False,False,0,3,2021-09-17T16:33:00.243,15,False,3.0
2021,1,3075,695,17,7024,2,47,5,-1,3,4,3,0,3,0,False,False,False,0,1,2021-09-13T15:44:59.16,3,False,0.0
2021,1,3075,700,17,6274,2,4,9,2,2,0,2,0,2,0,False,False,False,0,3,2021-09-17T16:33:21.297,2,False,
2021,1,3075,705,17,364,13,12,5,7,0,0,0,0,0,0,False,False,False,0,3,2021-09-17T17:27:57.12,0,False,0.0
2021,1,3075,715,19,7175,2,5,5,2,3,1,3,0,3,0,False,False,False,0,3,2022-02-16T19:23:46.35,3,False,0.0
2021,1,3075,720,19,7175,2,6,10,7,7,0,7,0,7,0,False,False,False,0,3,2021-09-13T14:53:46.45,7,False,0.0
2021,1,3075,745,19,5096,2,17,4,5,11,6,7,4,7,0,False,False,False,0,4,2021-09-13T15:03:29.167,11,False,4.0
2021,1,3075,760,17,2253,2,2,10,4,13,9,13,0,13,0,False,False,False,0,2,2021-09-17T16:33:34.187,13,False,0.0
2021,1,3076,10,6,7725,2,4,10,4,4,0,4,0,4,0,False,False,False,0,4,2021-09-14T17:43:10.527,4,False,0.0
2021,1,3076,25,6,1378,2,5,5,7,9,2,8,1,8,0,False,False,False,0,3,2021-09-13T07:12:42.3,9,False,1.0
2021,1,3076,40,6,7725,13,8,9,8,0,0,0,0,0,0,False,False,False,0,3,2021-09-13T07:15:03.33,0,False,0.0
2021,1,3076,50,29,3398,2,2,10,5,7,2,6,1,6,0,False,False,False,0,3,2021-09-17T21:23:34.69,7,False,1.0
2021,1,3076,55,29,7828,2,8,8,46,67,21,66,1,66,6,False,False,False,1,2,2021-09-17T21:31:35.443,67,False,1.0
2021,1,3076,75,6,464,2,4,10,5,5,0,5,0,5,0,False,False,False,0,3,2021-09-14T17:43:22.243,5,False,0.0
2021,1,3076,80,6,7728,2,2,4,7,10,3,9,1,9,0,False,False,False,0,3,2021-09-13T07:26:16.99,10,False,1.0
2021,1,3076,85,6,464,3,4,9,5,0,0,0,0,0,0,False,False,False,0,4,2021-09-13T07:27:59.01,0,False,0.0
2021,1,3076,95,6,1400,2,45,5,-4,4,8,2,2,2,0,False,False,False,0,1,2021-09-13T07:31:53.393,4,False,2.0
2021,1,3076,100,6,464,13,2,10,5,0,0,0,0,0,0,False,False,False,0,2,2021-09-13T07:33:22.127,0,False,0.0
2021,1,3076,105,29,4866,2,32,5,0,1,1,1,0,1,0,False,False,False,0,4,2021-09-13T07:36:17.037,1,False,0.0
2021,1,3076,110,29,967,2,35,8,18,18,0,18,0,18,0,False,False,False,0,3,2021-09-13T07:38:45.583,18,False,0.0
2021,1,3076,120,29,4866,2,4,3,4,4,0,4,0,4,0,False,False,False,0,3,2021-09-17T11:37:07.807,4,False,0.0
2021,1,3076,125,29,7828,13,9,6,27,0,0,0,0,0,0,False,False,False,0,2,2021-09-13T07:42:06.85,0,False,0.0
2021,1,3076,145,6,1378,2,4,10,8,19,11,9,10,9,0,False,False,False,1,2,2021-09-13T15:46:34.523,19,False,10.0
2021,1,3076,155,6,7725,2,51,10,-3,-2,1,-2,0,-2,0,True,False,False,0,2,2022-02-16T18:47:13.073,-2,False,0.0
2021,1,3076,160,6,3233,2,4,3,9,10,1,10,0,10,0,False,False,False,0,2,2021-09-13T07:52:17.193,10,False,0.0
2021,1,3076,170,29,3398,2,53,9,-4,17,21,12,5,12,0,False,False,False,0,4,2021-09-17T21:53:28.137,17,False,5.0
2021,1,3076,205,29,7828,2,35,5,11,13,2,12,1,12,0,False,False,False,0,3,2021-09-13T08:01:06.397,13,False,1.0
2021,1,3076,210,29,7378,2,4,10,2,17,15,2,15,2,0,False,False,False,1,1,2021-09-13T08:02:34.233,17,False,15.0
2021,1,3076,220,29,4866,13,7,5,4,0,0,0,0,0,0,False,False,False,0,3,2021-09-13T08:04:59.383,0,False,0.0
2021,1,3076,225,29,1958,13,13,9,4,0,0,0,0,0,0,False,False,False,0,3,2021-09-17T22:17:09.597,0,False,0.0
2021,1,3076,245,6,7725,2,4,9,8,9,1,9,0,9,0,False,False,False,0,3,2021-09-13T08:09:31.64,9,False,0.0
2021,1,3076,250,6,1378,2,5,5,7,7,0,7,0,7,0,False,False,False,0,2,2021-09-13T08:10:44.02,7,False,0.0
2021,1,3076,265,6,3233,2,51,9,-3,3,6,0,3,0,0,False,False,False,0,3,2021-09-13T08:14:38.35,3,False,3.0
2021,1,3076,270,6,464,13,2,10,7,0,0,0,0,0,0,False,False,False,0,2,2021-09-13T08:15:49.61,0,False,0.0
2021,1,3076,280,29,3398,2,50,10,-3,1,4,0,1,0,0,False,False,False,0,3,2021-09-13T08:25:48.05,1,False,1.0
2021,1,3076,295,29,1958,2,51,9,-1,6,7,5,1,5,0,False,False,False,0,3,2022-02-16T18:48:40.253,6,False,1.0
2021,1,3076,305,6,7728,2,32,5,1,10,9,6,4,6,0,False,False,False,0,4,2021-09-13T08:31:37.973,10,False,4.0
2021,1,3076,320,6,464,2,26,10,6,9,3,7,2,7,0,False,False,False,0,3,2021-09-13T08:36:07.527,9,False,2.0
2021,1,3076,335,6,464,2,13,4,3,8,5,7,1,7,0,False,False,False,0,2,2021-09-13T08:38:49.26,8,False,1.0
2021,1,3076,385,29,4866,13,4,3,3,0,0,0,0,0,0,False,False,False,0,3,2021-09-17T21:04:32.143,0,False,0.0
2021,1,3076,395,29,1958,2,8,1,18,19,1,19,0,19,0,False,False,False,0,2,2021-09-13T08:50:12.587,19,False,0.0
2021,1,3076,400,29,4866,2,8,7,44,56,12,56,0,56,6,False,False,False,0,3,2021-09-13T08:52:26.867,56,True,0.0
2021,1,3076,415,6,7725,2,4,5,6,6,0,6,0,6,0,False,False,False,0,2,2021-09-13T08:59:01.37,6,False,0.0
2021,1,3076,425,6,464,2,4,3,7,7,0,7,0,7,0,False,False,False,0,2,2021-09-13T09:01:20.513,7,False,0.0
2021,1,3076,435,6,6786,2,47,10,0,10,10,6,4,6,0,False,False,False,0,1,2021-09-13T09:03:45.233,10,False,4.0
2021,1,3076,445,6,1400,2,45,5,-3,8,11,3,5,3,0,False,False,False,0,1,2021-09-13T09:07:33.047,8,False,5.0
2021,1,3076,450,6,7728,2,30,9,0,3,3,1,2,1,0,False,False,False,0,4,2021-09-13T09:09:33.383,3,False,2.0
2021,1,3076,460,6,1378,2,4,5,7,10,3,9,1,9,0,False,False,False,0,2,2022-02-16T18:50:30.98,10,False,1.0
2021,1,3076,475,6,464,2,55,9,-2,1,3,0,1,0,0,True,False,False,0,4,2021-09-17T21:16:35.217,1,False,1.0
2021,1,3076,490,6,666,2,29,3,10,11,1,11,0,11,0,False,False,False,0,2,2021-09-13T09:25:34.883,11,False,0.0
2021,1,3076,515,29,4866,3,6,9,5,0,0,0,0,0,0,False,False,False,0,3,2021-09-17T21:04:32.157,0,False,0.0
2021,1,3076,520,29,3398,2,16,9,5,6,1,5,1,5,0,True,False,False,0,4,2021-09-13T09:31:30.63,6,False,1.0
2021,1,3076,525,29,3398,2,7,2,18,37,19,31,6,31,0,False,False,False,0,4,2021-09-17T21:56:15.467,37,False,6.0
2021,1,3076,530,29,967,2,51,9,-3,3,6,0,3,0,0,False,False,False,0,3,2021-09-13T09:34:44.593,3,False,3.0
2021,1,3076,535,29,4866,2,5,3,5,6,1,6,0,6,0,False,False,False,0,3,2021-09-13T09:35:34.93,6,False,0.0
2021,1,3076,540,29,4866,2,2,9,4,17,13,7,10,7,0,False,False,False,1,2,2021-09-17T21:59:15.103,17,False,10.0
2021,1,3076,560,6,1400,2,16,10,3,5,2,5,0,5,0,True,False,False,2,1,2021-09-17T21:32:10.427,5,False,0.0
2021,1,3076,565,6,1400,2,16,9,3,11,8,8,3,8,0,False,False,False,0,1,2021-09-13T14:45:28.953,11,False,3.0
2021,1,3076,570,6,464,13,5,3,6,0,0,0,0,0,0,False,False,False,0,3,2021-09-17T22:17:19.553,0,False,0.0
2021,1,3076,590,6,7725,2,4,10,6,9,3,7,2,7,0,False,False,False,0,3,2021-09-13T14:53:37.557,9,False,2.0
2021,1,3076,600,6,7728,2,13,10,1,9,8,8,1,8,0,False,False,False,0,4,2021-09-13T14:56:24.657,9,False,1.0
2021,1,3076,615,6,7728,3,4,4,9,0,0,0,0,0,0,False,False,False,0,3,2022-02-16T18:52:50.183,0,False,0.0
2021,1,3076,620,6,7728,2,33,9,5,10,5,5,5,5,0,False,False,False,1,4,2021-09-13T15:01:39.18,10,False,5.0
2021,1,3076,625,6,7725,13,5,5,13,0,0,0,0,0,0,False,False,False,0,3,2021-09-13T15:03:40.68,0,False,0.0
2021,1,3076,655,29,4866,13,12,2,26,0,0,0,0,0,0,False,False,False,0,3,2022-02-01T19:24:50.217,0,False,
2021,1,3076,660,29,4866,2,51,9,-3,15,18,2,13,2,0,False,False,False,3,3,2021-09-13T15:16:37.24,15,False,13.0
2021,1,3076,670,29,4866,2,2,9,7,9,2,7,2,7,0,False,False,False,0,3,2021-09-13T15:20:37.763,9,False,2.0
2021,1,3076,685,29,3398,13,17,4,5,0,0,0,0,0,0,False,False,False,0,3,2021-09-13T15:23:57.993,0,False,0.0
2021,1,3076,700,29,1958,2,6,4,2,2,0,2,0,2,6,False,False,False,0,2,2021-09-17T21:04:32.157,2,True,0.0
2021,1,3076,715,6,464,2,4,5,5,5,0,5,0,5,0,False,False,False,0,2,2021-09-13T15:29:37.56,5,False,0.0
2021,1,3076,720,6,3233,2,6,4,4,6,2,5,1,5,0,False,False,False,0,3,2021-09-13T15:30:58.197,6,False,1.0
2021,1,3076,725,6,464,13,12,5,3,0,0,0,0,0,0,False,False,False,0,2,2021-09-17T22:17:36.327,0,False,0.0
2021,1,3076,730,6,1400,13,44,3,-4,0,0,0,0,0,0,True,False,False,0,1,2021-09-13T15:34:04.803,0,False,0.0
2021,1,3076,735,6,666,13,46,3,2,0,0,0,0,0,0,False,False,False,0,3,2021-09-17T22:17:43.97,0,False,0.0
2021,1,3077,10,23,2994,13,4,5,6,0,0,0,0,0,0,False,False,False,0,2,2021-09-17T19:48:41.63,0,False,0.0
2021,1,3077,15,23,7240,2,12,3,5,9,4,8,1,8,0,False,False,False,0,2,2021-09-17T21:24:35.103,9,False,1.0
2021,1,3077,35,23,2994,2,2,10,5,13,8,12,1,12,0,False,False,False,0,3,2021-09-14T11:35:33.227,13,False,1.0
2021,1,3077,45,23,7250,13,24,6,23,0,0,0,0,0,0,False,False,False,0,3,2021-09-14T11:45:10.983,0,False,0.0
2021,1,3077,50,23,7241,3,4,3,6,0,0,0,0,0,0,False,False,False,0,2,2021-09-14T11:47:18.3,0,False,0.0
2021,1,3077,75,3,8274,2,44,3,-6,2,8,1,1,1,0,False,False,False,0,1,2021-09-14T12:03:14.803,2,False,1.0
2021,1,3077,85,3,121,2,4,9,6,8,2,8,0,8,0,False,False,False,0,3,2022-02-16T18:58:01.133,8,False,0.0
2021,1,3077,95,3,6454,13,4,10,7,0,0,0,0,0,0,False,False,False,0,4,2021-09-17T21:24:03.093,0,False,0.0
2021,1,3077,115,23,2994,13,33,8,22,0,0,0,0,0,0,False,False,False,0,4,2021-09-17T20:57:17.653,0,False,0.0
2021,1,3077,120,23,2994,13,25,2,34,0,0,0,0,0,0,False,False,False,0,3,2021-09-17T21:24:03.093,0,False,0.0
2021,1,3077,125,23,2994,13,6,1,16,0,0,0,0,0,0,False,False,False,0,3,2021-09-14T12:33:13.853,0,False,0.0
2021,1,3077,135,3,6936,2,51,5,-3,0,3,0,0,0,0,False,False,False,0,2,2021-09-14T12:36:33.83,0,False,0.0
2021,1,3077,140,3,8274,2,46,3,2,21,19,19,2,19,0,False,False,False,0,1,2021-09-17T19:50:59.11,21,False,2.0
2021,1,3077,150,3,121,13,4,9,6,0,0,0,0,0,0,False,False,False,0,2,2022-02-16T19:10:01.937,0,False,0.0
2021,1,3077,155,3,6454,2,5,5,6,6,0,6,0,6,0,False,False,False,0,3,2021-09-17T21:24:03.093,6,False,0.0
2021,1,3077,185,23,2994,13,6,5,13,0,0,0,0,0,0,False,False,False,0,4,2021-09-17T21:24:03.093,0,False,0.0
2021,1,3077,190,23,2994,13,4,9,12,0,0,0,0,0,0,False,False,False,0,3,2021-09-17T21:24:03.093,0,False,0.0
2021,1,3077,200,3,7672,2,51,5,-3,6,9,4,2,4,0,True,False,False,0,2,2021-09-14T13:04:48.567,6,False,2.0
2021,1,3077,220,3,121,3,4,9,6,0,0,0,0,0,0,False,False,False,0,3,2021-09-14T13:10:27.07,0,False,0.0
2021,1,3077,235,23,7241,2,12,4,1,6,5,6,0,6,0,False,False,False,0,1,2022-02-16T18:59:25.437,6,False,0.0
2021,1,3077,255,3,6936,2,35,6,17,29,12,29,0,29,0,False,False,False,0,3,2021-09-17T20:58:29.82,29,False,0.0
2021,1,3077,265,3,121,2,13,9,4,29,25,29,0,29,0,False,False,False,1,3,2021-09-17T19:24:20.357,29,False,0.0
2021,1,3077,270,3,6816,13,17,4,14,0,0,0,0,0,0,False,False,False,0,4,2021-09-14T13:33:22.357,0,False,0.0
2021,1,3077,280,3,6936,2,12,10,10,10,0,10,0,10,6,False,False,False,0,3,2021-09-17T20:58:42.327,10,True,0.0
2021,1,3077,295,23,7240,2,5,3,3,5,2,5,0,5,0,False,False,False,0,3,2021-09-14T13:42:57.133,5,False,0.0
2021,1,3077,300,23,4307,2,5,3,2,6,4,6,0,6,0,False,False,False,0,1,2021-09-14T13:45:32.423,6,False,0.0
2021,1,3077,305,23,7250,2,2,4,7,12,5,8,4,8,0,False,False,False,0,3,2021-09-14T13:47:32.343,12,False,4.0
2021,1,3077,310,23,2994,2,51,3,-3,9,12,7,2,7,0,True,False,False,0,4,2021-09-14T13:50:05.137,9,False,2.0
2021,1,3077,320,23,2994,2,8,8,18,24,6,22,2,22,0,False,False,False,0,3,2021-09-14T13:53:57.25,24,False,2.0
2021,1,3077,325,23,7688,3,13,9,5,0,0,0,0,0,0,False,False,False,0,3,2021-09-14T13:58:04.9,0,False,0.0
2021,1,3077,330,23,2994,2,5,5,6,8,2,7,1,7,0,False,False,False,0,3,2021-09-14T14:01:04.067,8,False,1.0
2021,1,3077,340,23,7250,13,21,3,11,0,0,0,0,0,0,False,False,False,0,3,2021-09-17T21:40:49.677,0,False,
2021,1,3077,365,3,6936,2,13,10,4,13,9,13,0,13,0,False,False,False,0,3,2021-09-14T14:11:28.987,13,True,0.0
2021,1,3077,385,3,6454,2,12,4,4,4,0,4,0,4,0,False,False,False,0,4,2022-02-01T19:25:57.527,4,False,0.0
2021,1,3077,405,23,2994,13,35,2,18,0,0,0,0,0,0,False,False,False,0,3,2021-09-17T19:55:31.507,0,False,0.0
2021,1,3077,415,23,4949,2,12,7,15,15,0,15,0,15,0,False,False,False,0,2,2022-02-01T19:26:31.373,15,False,0.0
2021,1,3077,420,23,7250,13,5,5,8,0,0,0,0,0,0,False,False,False,0,3,2021-09-17T20:59:00.133,0,False,0.0
2021,1,3077,425,23,7688,13,19,6,40,0,0,0,0,0,0,False,False,False,0,2,2021-09-17T21:00:16.773,0,False,0.0
2021,1,3077,430,23,7250,2,13,9,4,13,9,13,0,13,0,False,False,False,0,3,2021-09-14T14:36:27.583,13,False,0.0
2021,1,3077,440,23,7250,2,5,3,3,7,4,7,0,7,0,False,False,False,0,3,2021-09-14T14:38:14.067,7,False,0.0
2021,1,3077,445,23,7689,13,19,2,27,0,0,0,0,0,0,False,False,False,0,2,2021-09-14T14:40:25.493,0,False,0.0
2021,1,3077,450,23,2994,13,24,2,29,0,0,0,0,0,0,False,False,False,0,3,2021-10-15T01:05:19.073,0,False,
2021,1,3077,480,3,6454,2,4,10,9,10,1,10,0,10,0,False,False,False,0,3,2021-09-14T18:42:15.66,10,False,0.0
2021,1,3077,485,3,7672,13,19,6,45,0,0,0,0,0,0,False,False,False,0,2,2021-09-14T14:55:59.647,0,False,0.0
2021,1,3077,490,3,6454,13,8,8,45,0,0,0,0,0,0,False,False,False,0,3,2021-09-17T21:24:03.093,0,False,
2021,1,3077,500,3,121,3,39,4,5,0,0,0,0,0,0,False,False,False,0,3,2021-09-14T15:02:35.77,0,False,0.0
2021,1,3077,505,3,121,13,8,10,12,0,0,0,0,0,0,False,False,False,0,2,2021-09-17T18:59:47.89,0,False,0.0
2021,1,3077,520,23,2994,3,4,3,4,0,0,0,0,0,0,False,False,False,0,4,2021-09-14T15:09:53.847,0,False,0.0
2021,1,3077,525,23,2994,2,13,3,7,22,15,22,0,22,0,False,False,False,0,4,2021-09-14T15:12:08.763,22,False,
2021,1,3077,545,3,5017,13,30,10,1,0,0,0,0,0,0,False,False,False,0,1,2021-09-17T21:00:33.313,0,False,0.0
2021,1,3077,565,3,8274,13,4,5,2,0,0,0,0,0,0,False,False,False,0,2,2021-09-14T15:29:22.157,0,False,0.0
2021,1,3077,585,23,4307,2,4,5,-1,4,5,1,3,1,0,False,False,False,0,2,2021-09-17T19:26:01.773,4,False,3.0
2021,1,3077,590,23,7689,13,8,1,32,0,0,0,0,0,0,False,False,False,0,3,2021-09-17T21:05:03.863,0,False,
2021,1,3077,600,23,4307,2,31,9,-1,12,13,2,10,2,0,False,False,False,1,1,2021-09-14T15:42:22.963,12,False,10.0
2021,1,3077,605,23,2994,2,6,10,13,16,3,16,0,16,0,False,False,False,0,3,2021-09-14T15:44:52.457,16,False,0.0
2021,1,3077,610,23,2994,2,51,9,0,2,2,2,0,2,0,False,False,False,0,3,2021-09-17T18:27:00.887,2,False,0.0
2021,1,3077,615,23,7240,2,47,5,2,3,1,3,0,3,0,False,False,False,0,3,2021-09-14T15:48:15.443,3,False,0.0
2021,1,3077,620,23,7250,2,13,5,2,4,2,4,0,4,0,False,False,False,0,3,2021-09-14T15:49:52.803,4,False,0.0
2021,1,3077,635,3,8274,2,46,3,1,6,5,5,1,5,0,False,False,False,0,1,2021-09-17T18:28:30.263,6,False,1.0
2021,1,3077,645,3,6936,2,13,4,4,4,0,4,0,4,0,False,False,False,0,3,2021-09-17T21:24:03.093,4,False,0.0
2021,1,3077,665,23,7688,13,35,6,17,0,0,0,0,0,0,False,False,False,0,3,2021-09-14T16:08:48.12,0,False,0.0
2021,1,3077,680,23,4307,2,16,4,6,21,15,12,9,12,0,False,False,False,1,1,2021-09-17T19:29:49.233,21,False,9.0
2021,1,3077,690,3,6936,2,4,5,13,13,0,13,0,13,0,False,False,False,0,2,2021-09-14T16:15:05.4,13,False,0.0
2021,1,3077,705,23,2994,2,51,10,0,4,4,4,0,4,0,True,False,False,0,4,2021-09-14T16:25:30.747,4,False,0.0
2021,1,3077,710,23,7240,2,12,5,2,5,3,5,0,5,0,False,False,False,0,1,2022-02-01T19:26:57.957,5,False,0.0
2021,1,3077,725,23,4307,2,4,4,6,16,10,14,2,14,0,False,False,False,0,1,2021-09-15T20:38:57.333,16,False,2.0
2021,1,3077,750,3,5017,2,38,10,3,6,3,4,2,4,0,False,False,False,0,4,2021-09-14T16:41:28.13,6,False,2.0
2021,1,3077,765,3,121,2,35,2,39,49,10,47,2,47,0,False,False,False,0,3,2021-09-17T21:24:03.093,49,False,2.0
2021,1,3077,785,23,2994,2,5,3,7,9,2,9,0,9,0,False,False,False,0,3,2022-02-16T19:06:24.447,9,False,0.0
2021,1,3077,795,23,7250,2,5,3,7,7,0,7,0,7,0,False,False,False,0,3,2021-09-14T16:55:06.637,7,False,0.0
2021,1,3077,800,23,7688,2,4,9,8,9,1,9,0,9,0,False,False,False,0,3,2021-09-14T16:58:18.57,9,False,0.0
2021,1,3077,805,23,2994,13,13,9,6,0,0,0,0,0,0,False,False,False,0,3,2021-09-14T17:00:13.937,0,False,0.0
2021,1,3077,815,23,7688,2,8,2,30,37,7,37,0,37,0,False,False,False,0,3,2021-09-14T17:03:08.49,37,False,0.0
2021,1,3077,825,23,2994,2,5,5,7,10,3,9,1,9,0,False,False,False,0,3,2021-09-14T17:06:14.113,10,False,1.0
2021,1,3077,830,23,2994,2,2,10,6,10,4,7,3,7,6,False,False,False,2,4,2022-02-16T19:04:04.947,10,False,3.0
2021,1,3077,850,3,5017,2,38,9,6,9,3,9,0,9,0,False,False,False,0,4,2021-09-14T17:15:06.47,9,False,0.0
2021,1,3077,915,23,7689,2,6,1,18,20,2,20,0,20,0,False,False,False,0,2,2021-09-14T17:26:18.397,20,False,0.0
2021,1,3077,925,23,7689,2,8,8,18,18,0,18,0,18,0,False,False,False,0,3,2021-09-17T21:41:03.32,18,False,0.0
2021,1,3077,960,23,7689,2,4,10,10,11,1,10,1,10,0,True,False,False,0,2,2021-09-14T17:38:05.25,11,False,1.0
2021,1,3077,970,23,7250,2,26,3,0,27,27,5,22,5,0,False,False,False,3,3,2021-09-14T17:42:21.07,27,False,22.0
2021,1,3077,990,23,7689,2,11,2,22,32,10,30,2,30,0,False,False,False,0,3,2021-09-17T21:01:19.583,32,False,2.0
2021,1,3077,1010,23,7250,13,21,5,5,0,0,0,0,0,0,False,False,False,0,3,2021-09-17T21:01:34.563,0,False,0.0
2021,1,3077,1015,23,2688,3,26,4,3,0,0,0,0,0,0,False,False,False,0,3,2022-02-16T19:07:15.5,0,False,0.0
2021,1,3077,1030,3,121,2,42,4,5,10,5,8,2,8,0,False,False,False,0,3,2021-09-17T21:02:07.783,10,False,2.0
2021,1,3077,1040,3,6454,13,39,4,11,0,0,0,0,0,0,False,False,False,0,3,2021-09-14T18:04:44.017,0,False,0.0
2021,1,3077,1060,23,4949,2,35,2,27,31,4,31,0,31,6,False,False,False,0,3,2021-09-17T21:24:03.093,31,True,0.0
2021,2,3078,10,32,1427,13,17,7,16,0,0,0,0,0,0,False,False,False,0,4,2021-09-17T09:41:15.333,0,False,0.0
2021,2,3078,15,32,7128,2,51,10,-2,7,9,5,2,5,0,False,False,False,0,3,2021-09-17T09:42:38,7,False,2.0
2021,2,3078,35,21,813,2,6,10,10,12,2,12,0,12,0,False,False,False,0,3,2021-09-17T09:54:52.983,12,False,0.0
2021,2,3078,40,21,4492,2,17,8,15,16,1,16,0,16,0,False,False,False,0,2,2021-09-17T09:56:02.447,16,False,0.0
2021,2,3078,55,21,3680,2,3,9,13,13,0,13,0,13,0,False,False,False,0,3,2021-09-23T17:08:52.223,13,False,0.0
2021,2,3078,60,21,3680,2,50,3,-2,4,6,0,4,0,0,False,False,False,1,2,2021-09-17T10:01:27.223,4,False,4.0
2021,2,3078,75,21,3680,13,13,10,2,0,0,0,0,0,0,False,False,False,0,3,2021-10-15T01:09:12.357,0,False,
2021,2,3078,100,32,1427,2,5,10,5,5,0,5,0,5,0,True,False,False,0,1,2021-09-17T10:13:16.18,5,False,0.0
2021,2,3078,120,21,6228,3,28,10,-4,0,0,0,0,0,0,False,False,False,0,1,2021-10-15T01:09:36.18,0,False,0.0
2021,2,3078,165,32,8527,2,6,7,19,22,3,21,1,21,0,False,False,False,0,2,2021-09-17T10:29:57.953,22,False,1.0
2021,2,3078,175,32,7128,2,4,9,6,12,6,11,1,11,0,False,False,False,0,2,2021-09-17T10:32:51.1,12,False,1.0
2021,2,3078,185,32,7128,2,26,10,4,4,0,4,0,4,0,False,False,False,0,3,2021-09-17T10:35:17.293,4,False,0.0
2021,2,3078,215,32,7807,2,4,10,1,4,3,3,1,3,0,False,False,False,0,1,2021-09-17T10:41:20.293,4,False,1.0
2021,2,3078,225,32,7128,2,5,6,16,16,0,16,0,16,0,False,False,False,0,2,2021-09-17T10:43:52.79,16,False,0.0
2021,2,3078,230,32,7128,2,2,10,11,11,0,11,0,11,6,False,False,False,0,2,2021-09-17T10:45:24.173,11,True,0.0
2021,2,3078,245,21,4492,13,6,7,17,0,0,0,0,0,0,False,False,False,0,2,2021-09-23T18:26:58.05,0,False,0.0
2021,2,3078,265,32,1427,2,53,10,-2,8,10,2,6,2,0,True,False,False,0,4,2021-09-17T10:55:29.37,3,False,6.0
2021,2,3078,270,32,7128,13,6,8,19,0,0,0,0,0,0,False,False,False,0,2,2021-09-17T10:59:05.067,0,False,0.0
2021,2,3078,275,32,1427,13,7,2,17,0,0,0,0,0,0,False,False,False,0,3,2021-09-17T11:00:00.28,0,False,0.0
2021,2,3078,280,32,3885,2,4,10,2,12,10,11,1,11,0,False,False,False,0,1,2021-09-17T11:01:04.833,12,False,1.0
2021,2,3078,295,21,3680,2,2,4,4,4,0,4,0,4,0,False,False,False,0,3,2021-09-17T11:05:03.49,4,False,0.0
2021,2,3078,315,21,6228,2,6,9,2,8,6,6,2,6,0,False,False,False,0,1,2021-09-23T18:27:09.393,8,False,2.0
2021,2,3078,325,21,4492,13,2,9,10,0,0,0,0,0,0,False,False,False,0,3,2021-09-23T17:20:39.08,0,False,0.0
2021,2,3078,330,21,4492,13,19,6,18,0,0,0,0,0,0,False,False,False,0,2,2021-09-23T17:20:56.86,0,False,
2021,2,3078,335,21,3680,2,50,10,-1,2,3,2,0,2,0,False,False,False,0,2,2021-09-17T11:17:26.19,2,False,0.0
2021,2,3078,345,21,3680,2,42,4,4,6,2,5,1,5,0,False,False,False,0,3,2021-09-17T11:19:49.44,6,False,1.0
2021,2,3078,365,32,7807,2,45,5,-2,0,2,0,0,0,0,False,False,False,0,1,2021-09-17T11:26:31.747,0,False,0.0
2021,2,3078,370,32,1427,2,17,8,20,24,4,22,2,22,0,True,False,False,0,2,2021-09-17T11:28:39.397,24,False,2.0
2021,2,3078,375,32,2675,2,51,9,-3,12,15,3,9,3,0,False,False,False,1,3,2021-09-17T11:30:23.267,12,False,9.0
2021,2,3078,380,32,2675,2,45,5,-3,7,10,7,0,7,0,False,False,False,0,3,2021-09-17T11:31:33.487,7,True,0.0
2021,2,3078,400,32,3885,2,4,9,2,6,4,6,0,6,0,False,False,False,0,1,2021-09-17T11:37:43.413,6,False,0.0
2021,2,3078,405,32,7128,2,2,9,9,10,1,10,0,10,0,False,False,False,0,2,2022-02-17T18:50:31.02,10,False,0.0
2021,2,3078,415,32,8527,2,6,10,5,7,2,5,2,5,0,False,False,False,0,2,2021-09-17T11:39:48.473,7,False,2.0
2021,2,3078,470,21,3680,2,6,8,15,17,2,15,2,15,0,False,False,False,0,3,2021-09-17T11:55:10.92,17,False,2.0
2021,2,3078,475,21,7226,2,31,9,2,3,1,3,0,3,0,False,False,False,0,3,2021-09-17T11:56:39.193,3,False,0.0
2021,2,3078,490,21,6228,2,47,5,3,4,1,2,2,2,0,False,False,False,0,1,2021-09-17T12:00:31.99,4,False,2.0
2021,2,3078,500,21,3680,2,16,10,5,5,0,5,0,5,0,True,False,False,0,4,2021-09-23T18:27:20.52,5,False,
2021,2,3078,510,21,3957,2,46,9,0,2,2,0,2,0,0,False,False,False,0,1,2021-09-17T15:24:22.913,2,False,2.0
2021,2,3078,515,21,7090,2,4,10,6,8,2,8,0,8,0,False,False,False,0,3,2021-09-17T12:11:27.143,8,False,0.0
2021,2,3078,530,32,7128,2,50,9,-2,4,6,3,1,3,0,False,False,False,0,2,2021-09-17T12:18:02.627,4,False,1.0
2021,2,3078,535,32,1427,2,38,10,2,4,2,4,0,4,0,False,False,False,0,4,2021-09-17T12:19:28.38,4,False,0.0
2021,2,3078,540,32,7128,13,5,5,13,0,0,0,0,0,0,False,False,False,0,3,2021-09-17T12:20:57.843,0,False,0.0
2021,2,3078,550,21,4492,13,9,2,29,0,0,0,0,0,0,False,False,False,0,3,2021-09-23T15:33:28.563,0,False,0.0
2021,2,3078,565,21,3680,13,4,9,12,0,0,0,0,0,0,False,False,False,0,3,2021-09-23T17:07:51.327,0,False,
2021,2,3078,575,21,4492,2,4,3,12,12,0,12,0,12,0,False,False,False,0,2,2021-09-23T15:34:24.23,12,False,0.0
2021,2,3078,580,21,3680,2,35,7,15,19,4,19,0,19,0,False,False,False,0,3,2021-09-17T12:37:51.847,19,False,0.0
2021,2,3078,585,21,4492,3,2,9,12,0,0,0,0,0,0,False,False,False,0,3,2021-09-17T12:39:06.56,0,False,0.0
2021,2,3078,590,21,7090,2,19,6,32,33,1,32,1,32,6,False,False,False,0,2,2021-09-23T18:27:41.023,33,False,1.0
2021,2,3078,610,32,2675,13,17,8,21,0,0,0,0,0,0,False,False,False,0,3,2021-09-17T12:50:51.123,0,False,
2021,2,3078,615,32,2675,2,38,10,5,8,3,8,0,8,0,False,False,False,0,3,2021-09-23T15:35:18.257,8,False,0.0
2021,2,3078,625,32,8527,13,19,2,24,0,0,0,0,0,0,False,False,False,0,2,2022-02-17T18:55:10.113,0,False,0.0
2021,2,3078,635,32,2675,2,13,9,6,6,0,6,0,6,0,True,False,False,0,3,2021-09-17T13:02:16.523,6,False,
2021,2,3078,655,21,7090,2,3,5,13,13,0,13,0,13,0,False,False,False,0,2,2022-02-17T18:46:38.7,13,False,0.0
2021,2,3078,660,21,7226,2,35,10,14,21,7,21,0,21,0,False,False,False,0,3,2021-09-17T13:13:24.753,21,False,0.0
2021,2,3078,665,21,4492,13,2,10,12,0,0,0,0,0,0,False,False,False,0,3,2021-09-17T13:16:52.457,0,False,
2021,2,3078,670,21,4492,2,4,5,9,10,1,10,0,10,0,False,False,False,0,2,2021-09-17T13:18:26.817,10,False,0.0
2021,2,3078,685,21,3680,2,4,9,8,8,0,8,0,8,0,False,False,False,0,3,2021-09-17T13:24:36.76,8,False,0.0
2021,2,3078,700,32,7128,2,2,4,7,18,11,15,3,15,0,False,False,False,0,2,2021-09-17T13:29:26.697,18,False,3.0
2021,2,3078,710,32,7128,2,4,10,6,9,3,9,0,9,0,False,False,False,0,2,2022-02-17T18:47:01.137,9,False,0.0
2021,2,3078,715,32,2675,2,51,9,-4,0,4,-2,2,-2,0,False,False,False,0,3,2021-09-17T13:34:50.653,0,False,2.0
2021,2,3078,720,32,2675,2,51,3,-1,3,4,3,0,3,0,True,False,False,0,3,2021-09-18T18:37:49.207,3,False,0.0
2021,2,3078,730,32,7128,2,4,9,10,10,0,10,0,10,0,False,False,False,0,3,2021-09-23T18:27:53.983,10,False,0.0
2021,2,3078,735,32,8527,13,5,3,7,0,0,0,0,0,0,False,False,False,0,2,2021-09-17T13:58:03.273,0,False,0.0
2021,2,3078,740,32,8527,13,9,2,26,0,0,0,0,0,0,False,False,False,0,3,2021-09-17T14:06:21.223,0,False,0.0
2021,2,3078,745,32,2675,2,4,10,6,7,1,7,0,7,0,False,False,False,0,3,2021-09-17T14:09:08.383,7,False,0.0
2021,2,3078,760,21,3680,2,5,2,18,21,3,21,0,21,0,False,False,False,0,3,2021-09-17T14:11:39.297,21,False,0.0
2021,2,3078,780,21,7090,3,8,8,42,0,0,0,0,0,0,False,False,False,0,2,2021-09-23T15:35:33.817,0,False,0.0
2021,2,3078,815,32,3885,2,24,2,22,56,34,56,0,56,0,False,False,False,0,2,2021-09-17T14:27:04.093,56,False,0.0
2021,2,3078,820,32,4788,2,11,2,19,19,0,19,0,19,6,False,False,False,0,4,2022-02-17T18:47:41.017,19,True,0.0
2021,2,3078,835,21,4492,13,4,3,7,0,0,0,0,0,0,False,False,False,0,2,2021-09-17T14:33:55.267,0,False,0.0
2021,2,3078,840,21,813,2,6,4,12,13,1,13,0,13,0,False,False,False,0,3,2021-09-17T14:35:08.597,13,False,0.0
2021,2,3078,850,21,7090,13,4,5,8,0,0,0,0,0,0,False,False,False,0,2,2021-09-17T14:39:01.507,0,False,0.0
2021,2,3078,855,21,7090,13,3,5,12,0,0,0,0,0,0,False,False,False,0,2,2021-09-23T15:36:12.557,0,False,0.0
2021,2,3078,880,32,7128,13,4,10,3,0,0,0,0,0,0,False,False,False,0,3,2021-09-23T17:18:30.583,0,False,0.0
2021,2,3078,905,21,3680,3,2,10,6,0,0,0,0,0,0,False,False,False,0,3,2022-02-17T18:49:08.157,0,False,0.0
2021,2,3078,925,32,3885,2,4,9,2,2,0,2,0,2,0,False,False,False,0,2,2021-09-17T14:57:15.97,2,False,0.0
2021,2,3078,930,32,2675,3,4,10,12,0,0,0,0,0,0,False,False,False,0,3,2021-09-17T14:58:35.767,0,False,0.0
2021,2,3078,935,32,3885,2,6,10,2,7,5,7,0,7,0,False,False,False,0,1,2021-09-23T17:17:23.633,7,False,0.0
2021,2,3078,945,32,1427,2,4,10,9,9,0,9,0,9,0,False,False,False,0,3,2021-09-17T15:02:49.857,9,False,0.0
2021,2,3078,960,32,3885,13,11,5,8,0,0,0,0,0,0,False,False,False,0,1,2021-09-23T15:36:38.01,0,False,0.0
2021,2,3078,965,32,8527,2,6,10,5,5,0,5,0,5,0,False,False,False,0,2,2021-09-17T15:09:17.91,5,False,0.0
2021,2,3078,980,32,2675,2,5,5,4,7,3,5,2,5,0,True,False,False,0,3,2021-09-23T17:10:17.597,7,False,2.0
2021,2,3078,985,32,7128,2,2,10,6,6,0,6,0,6,0,False,False,False,0,2,2021-09-23T15:37:06.037,6,False,0.0
2021,2,3079,15,19,4912,2,4,10,6,7,1,7,0,7,0,False,False,False,0,3,2021-09-20T09:11:25.063,7,False,0.0
2021,2,3079,25,19,5096,2,32,3,1,5,4,3,2,3,0,False,False,False,0,4,2021-09-24T18:03:22.093,5,False,2.0
2021,2,3079,30,19,1328,2,28,9,4,5,1,4,1,4,0,False,False,False,0,1,2021-09-24T16:24:29.34,5,False,1.0
2021,2,3079,35,19,7172,2,32,3,2,2,0,2,0,2,0,False,False,False,0,1,2021-09-20T09:20:53.267,2,False,0.0
2021,2,3079,40,19,1328,2,48,9,-2,-1,1,-1,0,-1,0,False,False,False,0,1,2021-09-20T16:11:48.163,-1,False,
2021,2,3079,45,19,7175,2,6,4,3,7,4,4,3,4,0,False,False,False,0,3,2021-09-20T09:27:29.077,7,False,3.0
2021,2,3079,70,22,5080,13,4,4,14,0,0,0,0,0,0,False,False,False,0,3,2022-02-17T17:23:21.8,0,False,0.0
2021,2,3079,85,19,7175,2,44,3,-5,-1,4,-5,4,-5,0,False,False,False,0,3,2021-09-24T14:19:18.567,-1,False,4.0
2021,2,3079,95,19,2256,2,50,9,0,2,2,2,0,2,0,False,False,False,0,3,2021-09-24T14:21:31.413,2,False,0.0
2021,2,3079,100,19,5096,3,52,4,2,0,0,0,0,0,0,False,False,False,0,3,2022-02-17T17:23:59.393,0,False,0.0
2021,2,3079,120,22,5080,3,35,5,20,0,0,0,0,0,0,False,False,False,0,3,2021-12-15T20:05:25.513,0,False,0.0
2021,2,3079,125,19,1328,2,48,10,-2,28,30,23,5,23,0,False,False,False,0,1,2022-02-17T17:25:17.833,28,False,5.0
2021,2,3079,135,19,4912,13,8,1,30,0,0,0,0,0,0,False,False,False,0,2,2021-09-20T10:14:39.11,0,False,
2021,2,3079,145,19,5096,2,38,3,7,19,12,14,5,14,0,False,False,False,0,3,2022-02-17T17:25:43.217,19,False,5.0
2021,2,3079,200,22,8454,2,11,6,23,27,4,27,0,27,0,False,False,False,0,3,2021-09-20T10:49:01.19,27,True,0.0
2021,2,3079,205,22,6270,2,51,5,0,7,7,6,1,6,0,False,False,False,0,3,2021-09-20T10:51:42.133,7,False,1.0
2021,2,3079,245,19,4912,2,50,9,-2,3,5,2,1,2,0,True,False,False,0,3,2021-09-24T18:03:22.093,3,False,1.0
2021,2,3079,275,22,8454,13,7,6,15,0,0,0,0,0,0,False,False,False,0,3,2021-09-24T15:01:23.863,0,False,0.0
2021,2,3079,280,19,7175,2,9,6,21,24,3,21,3,21,0,False,False,False,0,3,2021-09-20T11:16:20.01,24,False,3.0
2021,2,3079,290,19,1328,2,44,3,-1,-1,0,-1,0,-1,0,False,False,False,0,1,2021-09-20T16:15:51.817,-1,False,0.0
2021,2,3079,295,19,7175,13,9,6,19,0,0,0,0,0,0,False,False,False,0,3,2021-09-24T16:36:03.553,0,False,0.0
2021,2,3079,310,22,6270,2,5,5,8,11,3,9,2,9,0,False,False,False,0,3,2021-09-20T11:29:38.153,11,False,2.0
2021,2,3079,320,22,5080,13,6,3,4,0,0,0,0,0,0,False,False,False,0,2,2021-09-20T11:34:23.463,0,False,0.0
2021,2,3079,345,19,4282,2,2,10,4,10,6,9,1,9,0,True,False,False,0,3,2021-09-21T15:55:24.2,10,False,1.0
2021,2,3079,350,19,2256,2,5,3,10,10,0,10,0,10,0,False,False,False,0,3,2021-09-24T15:59:39.993,10,True,0.0
2021,2,3079,355,19,1328,2,31,9,3,3,0,3,0,3,0,False,False,False,0,1,2021-09-20T11:45:12.44,3,False,0.0
2021,2,3079,360,19,1328,2,48,9,-5,11,16,-3,14,-3,0,False,False,False,0,1,2021-09-20T11:47:06.287,11,False,14.0
2021,2,3079,375,19,7175,2,47,5,2,8,6,8,0,8,0,False,False,False,0,3,2021-09-20T11:49:43.943,8,True,0.0
2021,2,3079,415,22,8454,2,12,5,9,9,0,9,0,9,0,False,False,False,0,3,2021-09-24T16:37:35.197,9,False,0.0
2021,2,3079,425,22,2629,13,12,3,13,0,0,0,0,0,0,False,False,False,0,4,2022-02-17T17:26:35.903,0,False,0.0
2021,2,3079,445,22,8454,2,5,3,11,11,0,11,0,11,0,False,False,False,0,2,2021-09-24T17:00:47.337,11,False,
2021,2,3079,450,22,8454,13,9,6,33,0,0,0,0,0,0,False,False,False,0,2,2021-09-24T17:02:51.793,0,False,0.0
2021,2,3079,455,19,2256,2,4,9,9,9,0,9,0,9,0,False,False,False,0,2,2021-09-20T12:30:54,9,False,0.0
2021,2,3079,490,22,8454,2,5,3,6,8,2,8,0,8,0,False,False,False,0,3,2021-09-20T12:56:59.647,8,True,0.0
2021,2,3079,505,22,5080,13,21,2,38,0,0,0,0,0,0,False,False,False,0,3,2021-09-24T18:03:22.093,0,False,
2021,2,3079,515,22,2391,2,12,5,4,5,1,5,0,5,0,False,False,False,0,4,2021-09-24T17:34:30.773,5,True,0.0
2021,2,3079,535,19,4282,2,17,8,16,32,16,25,7,25,0,False,False,False,0,4,2021-09-20T13:10:39.893,32,False,7.0
2021,2,3079,545,19,5096,2,47,5,0,3,3,1,2,1,0,False,False,False,0,3,2021-09-24T16:43:59.7,3,False,2.0
2021,2,3079,560,19,4282,13,5,10,4,0,0,0,0,0,0,False,False,False,0,4,2021-09-20T13:21:11.98,0,False,0.0
2021,2,3079,565,19,1328,2,47,10,-1,-1,0,-1,0,-1,0,False,False,False,0,1,2021-09-20T13:23:03.29,-1,False,0.0
2021,2,3079,580,22,5080,2,32,3,2,3,1,3,0,3,0,True,False,False,0,4,2021-09-22T00:46:09.577,3,False,0.0
2021,2,3079,585,22,8451,2,47,10,1,17,16,4,13,4,0,False,False,False,2,1,2021-09-24T18:03:22.093,17,False,13.0
2021,2,3079,595,22,2391,13,35,6,23,0,0,0,0,0,0,False,False,False,0,4,2021-09-20T13:32:45.51,0,False,
2021,2,3079,600,22,6270,2,4,3,4,4,0,4,0,4,0,False,False,False,0,2,2021-09-20T13:36:45.107,4,False,0.0
2021,2,3079,605,22,5080,13,7,2,15,0,0,0,0,0,0,False,False,False,0,3,2021-09-24T18:03:22.093,0,False,
2021,2,3079,610,22,8451,13,12,5,1,0,0,0,0,0,0,False,False,False,0,1,2021-09-22T00:48:14.263,0,False,0.0
2021,2,3079,615,22,5080,2,50,5,-2,5,7,3,2,3,0,False,False,False,0,2,2021-09-24T14:22:30.423,5,False,2.0
2021,2,3079,620,22,8454,2,26,9,3,3,0,3,0,3,0,False,False,False,0,2,2021-09-24T18:03:22.093,3,False,0.0
2021,2,3079,625,22,6270,13,5,3,2,0,0,0,0,0,0,True,False,False,0,3,2021-09-24T16:45:21.333,0,False,0.0
2021,2,3079,630,19,5096,2,48,9,-3,1,4,0,1,0,0,True,False,False,0,1,2021-09-21T15:55:35.413,1,False,1.0
2021,2,3079,640,19,4282,13,12,3,13,0,0,0,0,0,0,False,False,False,0,4,2021-09-20T13:57:57.573,0,False,0.0
2021,2,3079,660,22,6270,3,6,9,6,0,0,0,0,0,0,True,False,False,0,4,2021-09-24T18:03:22.093,0,False,0.0
2021,2,3079,665,22,6270,2,7,6,27,27,0,27,0,27,0,False,False,False,0,3,2021-09-24T17:35:18.437,27,False,0.0
2021,2,3079,685,22,2391,2,31,4,1,5,4,3,2,3,0,False,False,False,0,4,2021-09-24T18:03:22.093,5,False,2.0
2021,2,3079,695,22,8454,13,18,3,-4,0,0,0,0,0,0,False,False,False,0,2,2022-02-01T19:30:48.23,0,False,0.0
2021,2,3079,725,19,7175,13,17,9,9,0,0,0,0,0,0,False,False,False,0,3,2021-09-20T15:00:31.353,0,False,0.0
2021,2,3079,730,19,4912,3,4,3,8,0,0,0,0,0,0,False,False,False,0,2,2021-09-20T15:02:45.333,0,False,0.0
2021,2,3079,740,22,6270,13,5,5,3,0,0,0,0,0,0,False,False,False,0,3,2021-09-24T17:36:06.14,0,False,0.0
2021,2,3079,745,22,2629,2,13,10,3,8,5,5,3,5,0,True,False,False,0,3,2021-09-22T00:46:40.933,8,False,3.0
2021,2,3079,750,22,8454,13,9,6,29,0,0,0,0,0,0,False,False,False,0,2,2021-09-20T15:11:04.193,0,False,0.0
2021,2,3079,755,22,6270,13,12,6,15,0,0,0,0,0,0,False,False,False,0,3,2021-09-20T16:17:09.41,0,False,0.0
2021,2,3079,810,22,6270,2,5,3,6,6,0,6,0,6,0,False,False,False,0,3,2021-09-20T15:27:12.143,6,True,0.0
2021,2,3079,815,22,7118,13,5,6,17,0,0,0,0,0,0,False,False,False,0,3,2021-09-24T16:54:56.447,0,False,0.0
2021,2,3079,825,22,7118,2,22,6,29,35,6,35,0,35,0,False,False,False,0,2,2021-09-24T17:36:20.25,35,True,0.0
2021,2,3079,840,22,6270,2,32,3,3,6,3,6,0,6,0,False,False,False,0,3,2021-09-20T15:36:17.84,6,True,0.0
2021,2,3079,845,22,8451,2,46,3,2,12,10,8,4,8,0,False,False,False,1,1,2021-09-20T15:38:04.33,12,False,4.0
2021,2,3079,850,22,6270,2,4,4,7,12,5,12,0,12,0,False,False,False,0,3,2021-09-20T15:39:58.887,12,False,0.0
2021,2,3080,15,15,914,2,6,9,3,4,1,3,1,3,0,False,False,False,0,2,2022-02-17T00:03:20.187,4,False,1.0
2021,2,3080,20,15,2757,2,7,6,21,24,3,23,1,23,0,False,False,False,0,3,2021-09-20T17:56:14.097,24,False,1.0
2021,2,3080,25,15,7591,13,2,10,10,0,0,0,0,0,0,False,False,False,0,2,2021-09-20T11:13:55.813,0,True,0.0
2021,2,3080,35,15,7591,13,5,2,18,0,0,0,0,0,0,False,False,False,0,3,2021-09-24T14:07:10.363,0,True,
2021,2,3080,40,15,914,2,4,3,7,7,0,7,0,7,0,False,False,False,0,2,2022-02-17T00:03:40.443,7,False,0.0
2021,2,3080,45,15,4179,13,21,2,33,0,0,0,0,0,0,False,False,False,0,2,2021-09-20T11:34:51.553,0,True,0.0
2021,2,3080,50,15,914,2,35,3,10,13,3,13,0,13,0,False,False,False,0,3,2021-09-24T14:07:10.363,13,False,0.0
2021,2,3080,70,15,914,2,19,2,25,25,0,25,0,25,6,False,False,False,0,2,2021-09-20T11:53:23.44,25,True,0.0
2021,2,3080,90,10,7703,2,32,5,3,6,3,6,0,6,0,False,False,False,0,4,2021-09-20T12:06:27.217,6,False,0.0
2021,2,3080,95,10,4930,13,7,6,19,0,0,0,0,0,0,True,False,False,0,2,2021-09-24T16:16:01.73,0,True,
2021,2,3080,105,10,6281,2,4,5,11,13,2,12,1,12,0,False,False,False,0,2,2022-02-17T00:19:58.583,13,False,1.0
2021,2,3080,110,10,4930,2,4,9,6,14,8,8,6,8,0,True,False,False,1,3,2021-09-21T16:39:05.977,14,False,6.0
2021,2,3080,125,10,282,2,46,3,3,8,5,8,0,8,0,False,False,False,0,1,2021-09-20T12:44:39.787,8,False,0.0
2021,2,3080,140,10,6281,2,4,3,6,6,0,6,0,6,0,False,False,False,0,2,2022-02-17T00:04:09.577,6,False,0.0
2021,2,3080,145,10,6840,2,4,4,6,6,0,5,1,5,0,False,False,False,0,3,2021-09-20T13:03:27.107,6,False,1.0
2021,2,3080,160,15,8099,2,5,5,-1,-2,-1,-2,0,-2,0,False,False,False,0,1,2021-09-24T16:17:05.873,-2,False,0.0
2021,2,3080,175,15,7591,13,4,5,5,0,0,0,0,0,0,False,False,False,0,2,2021-10-15T01:11:29.523,0,True,0.0
2021,2,3080,180,15,7591,13,35,6,18,0,0,0,0,0,0,False,False,False,0,3,2021-09-20T13:12:00.493,0,True,0.0
2021,2,3080,190,10,4702,2,32,5,0,7,7,6,1,6,0,False,False,False,0,4,2021-09-20T13:15:03.52,7,False,1.0
2021,2,3080,205,10,6840,2,12,5,4,4,0,4,0,4,0,False,False,False,0,4,2021-09-20T13:24:44.68,4,False,0.0
2021,2,3080,210,10,6281,13,19,6,45,0,0,0,0,0,0,False,False,False,0,2,2021-09-20T18:01:45.32,0,True,0.0
2021,2,3080,235,15,6501,13,24,6,36,0,0,0,0,0,0,False,False,False,0,3,2021-09-24T16:28:45.03,0,True,
2021,2,3080,240,15,7591,2,45,5,-8,-8,0,-8,0,-8,0,True,False,False,0,4,2021-09-21T20:40:05.897,-8,False,0.0
2021,2,3080,250,15,6501,13,7,2,18,0,0,0,0,0,0,False,False,False,0,2,2021-09-20T14:00:14.6,0,True,0.0
2021,2,3080,265,10,6281,13,8,8,44,0,0,0,0,0,0,False,False,False,0,2,2021-09-20T14:05:42.467,0,True,0.0
2021,2,3080,270,10,7701,13,19,6,23,0,0,0,0,0,0,False,False,False,0,2,2021-09-20T14:07:31.88,0,True,0.0
2021,2,3080,290,15,7591,3,16,4,5,0,0,0,0,0,0,False,False,False,0,3,2021-09-24T14:07:10.363,0,True,0.0
2021,2,3080,305,10,8541,2,45,5,-4,10,14,6,4,6,0,False,False,False,0,1,2021-09-20T14:19:27.273,10,False,4.0
2021,2,3080,310,10,6281,2,4,1,15,16,1,16,0,16,0,False,False,False,0,3,2021-09-20T14:25:10.247,16,False,0.0
2021,2,3080,320,10,6281,2,12,2,26,33,7,28,5,28,0,False,False,False,0,3,2022-02-01T19:33:20.95,33,False,5.0
2021,2,3080,325,10,6840,13,32,5,4,0,0,0,0,0,0,False,False,False,0,4,2021-09-21T16:37:57.083,0,True,0.0
2021,2,3080,330,10,7938,2,4,3,9,15,6,10,5,10,0,False,False,False,0,2,2022-02-17T00:13:34.17,15,False,5.0
2021,2,3080,340,10,4930,2,13,9,2,12,10,12,0,12,6,True,False,False,0,3,2021-09-20T17:53:46.337,12,True,0.0
2021,2,3080,355,15,8343,2,26,10,5,6,1,6,0,6,0,False,False,False,0,3,2021-09-20T14:36:05.687,6,False,0.0
2021,2,3080,365,15,7591,2,5,3,3,5,2,4,1,4,0,False,False,False,0,3,2021-09-20T14:40:40.183,5,False,1.0
2021,2,3080,370,15,6501,2,6,7,16,19,3,17,2,17,0,False,False,False,0,2,2021-09-20T14:42:32.717,19,False,2.0
2021,2,3080,385,15,153,13,5,10,4,0,0,0,0,0,0,False,False,False,0,1,2021-09-20T14:48:17.073,0,True,0.0
2021,2,3080,395,15,914,13,7,2,27,0,0,0,0,0,0,False,False,False,0,3,2021-09-20T14:51:23.33,0,True,0.0
2021,2,3080,400,15,7591,13,5,5,5,0,0,0,0,0,0,False,False,False,0,3,2021-09-20T14:57:55.723,0,True,0.0
2021,2,3080,415,15,153,13,16,4,5,0,0,0,0,0,0,False,False,False,0,1,2022-02-17T00:15:35,0,True,0.0
2021,2,3080,420,15,914,13,3,5,10,0,0,0,0,0,0,False,False,False,0,2,2021-09-20T15:04:20.397,0,True,0.0
2021,2,3080,435,10,6840,13,32,3,1,0,0,0,0,0,0,False,False,False,0,4,2021-09-20T15:09:30.02,0,True,0.0
2021,2,3080,440,10,6840,2,32,5,2,9,7,8,1,8,0,False,False,False,0,4,2021-09-20T15:11:51.093,9,False,1.0
2021,2,3080,445,10,7701,13,17,7,24,0,0,0,0,0,0,False,False,False,0,3,2021-09-20T15:31:26.473,0,True,0.0
2021,2,3080,455,10,282,2,12,4,8,30,22,28,2,28,0,False,False,False,1,1,2021-09-20T18:12:50.453,30,False,2.0
2021,2,3080,475,10,6281,2,8,1,51,55,4,52,3,52,0,False,False,False,0,2,2021-09-20T15:40:39.91,55,False,3.0
2021,2,3080,485,10,6840,2,5,10,5,14,9,7,7,7,6,False,False,False,1,3,2021-09-20T17:54:19.487,14,False,7.0
2021,2,3080,500,15,914,2,32,5,-2,0,2,-1,1,-1,0,False,False,False,1,4,2022-02-17T00:16:35.78,0,False,1.0
2021,2,3080,535,10,7701,2,4,10,5,5,0,5,0,5,0,False,False,False,0,3,2021-09-20T15:58:39.89,5,False,0.0
2021,2,3080,540,10,6281,2,26,3,4,10,6,10,0,10,0,False,False,False,0,2,2021-09-20T16:00:28.657,10,False,0.0
2021,2,3080,575,15,8343,13,43,6,18,0,0,0,0,0,0,False,False,False,0,4,2021-09-20T16:10:45.98,0,True,0.0
2021,2,3080,580,10,6281,2,2,10,8,11,3,11,0,11,0,False,False,False,0,2,2022-02-17T00:17:39.25,11,False,0.0
2021,2,3080,585,10,6281,2,2,3,7,9,2,8,1,8,0,False,False,False,0,2,2021-09-20T16:15:35.75,9,False,1.0
2021,2,3080,600,10,7703,2,12,3,-1,0,1,-1,1,-1,0,True,False,False,0,4,2021-09-20T16:23:10.047,0,False,1.0
2021,2,3080,610,10,4930,13,7,3,13,0,0,0,0,0,0,False,False,False,0,3,2021-09-20T16:25:40.783,0,True,0.0
2021,2,3080,625,15,8343,3,30,3,2,0,0,0,0,0,0,False,False,False,0,4,2022-02-17T00:18:04.723,0,True,
2021,2,3080,635,15,8099,2,45,5,-5,6,11,2,4,2,0,False,False,False,1,1,2021-09-24T15:51:21.807,6,False,4.0
2021,2,3080,640,15,6501,13,7,2,17,0,0,0,0,0,0,False,False,False,0,3,2021-09-20T16:36:47.963,0,True,0.0
2021,2,3080,645,15,3750,13,32,5,9,0,0,0,0,0,0,False,False,False,0,3,2022-02-17T00:20:53.83,0,False,0.0
2021,2,3080,655,10,7703,2,30,5,0,4,4,2,2,2,0,True,False,False,0,1,2021-12-15T18:20:54.23,4,False,2.0
2021,2,3080,680,15,914,13,19,6,40,0,0,0,0,0,0,False,False,False,0,2,2021-10-15T01:11:54.963,0,True,0.0
2021,2,3080,695,15,914,13,23,1,35,0,0,0,0,0,0,False,False,False,0,3,2021-09-20T16:51:36.94,0,True,0.0
2021,2,3080,705,15,6501,13,22,6,33,0,0,0,0,0,0,False,False,False,0,2,2021-09-20T16:54:19.703,0,True,
2021,2,3080,710,15,914,2,3,5,6,6,0,6,0,6,0,False,False,False,0,2,2022-01-31T19:42:11.36,6,False,0.0
2021,2,3080,715,15,8099,2,47,5,0,13,13,3,10,3,0,False,False,False,1,1,2021-09-20T17:00:52.493,13,False,10.0
2021,2,3080,725,15,7514,13,19,6,44,0,0,0,0,0,0,False,False,False,0,2,2021-09-24T15:08:41.97,0,True,0.0
2021,2,3080,740,10,4930,13,19,1,41,0,0,0,0,0,0,False,False,False,0,3,2021-09-20T17:49:27.02,0,True,
2021,2,3080,760,10,6281,13,19,2,30,0,0,0,0,0,0,False,False,False,0,2,2021-09-20T17:19:23.61,0,True,0.0
2021,2,3080,775,10,4930,2,4,4,3,11,8,9,2,9,0,False,False,False,0,3,2021-09-24T15:51:43.463,11,False,2.0
2021,2,3080,810,10,7703,2,32,5,4,14,10,9,5,9,0,False,False,False,0,4,2021-09-20T17:29:34.843,14,False,5.0
2021,2,3080,815,10,6281,2,2,10,3,6,3,6,0,6,0,False,False,False,0,2,2021-09-24T15:07:16.63,6,False,0.0
2021,2,3081,30,4,2853,13,4,3,3,0,0,0,0,0,0,False,False,False,0,2,2021-09-20T19:49:51.943,0,False,0.0
2021,2,3081,60,17,2253,2,2,9,9,14,5,13,1,13,0,False,False,False,0,2,2021-09-24T15:24:14.35,14,False,
2021,2,3081,65,17,7024,13,48,10,-7,0,0,0,0,0,0,False,False,False,0,1,2021-09-20T09:58:39.067,0,False,0.0
2021,2,3081,70,17,8483,2,50,9,-5,13,18,11,2,11,0,True,False,False,0,2,2021-09-24T15:44:03.51,13,False,2.0
2021,2,3081,75,17,8483,13,2,10,4,0,0,0,0,0,0,True,False,False,0,3,2021-09-20T19:50:57.427,0,False,0.0
2021,2,3081,80,4,5119,2,46,3,0,1,1,1,0,1,0,False,False,False,0,3,2021-09-20T19:51:27.89,1,False,0.0
2021,2,3081,95,4,213,2,19,6,29,35,6,32,3,32,0,True,False,False,0,3,2021-09-24T15:38:17.683,35,False,3.0
2021,2,3081,110,4,2853,2,12,4,5,5,0,5,0,5,6,False,False,False,0,3,2021-09-24T15:38:43.61,5,True,0.0
2021,2,3081,125,17,2253,2,2,9,4,7,3,4,3,4,0,False,False,False,0,2,2022-02-17T16:41:21.993,7,False,3.0
2021,2,3081,155,4,7645,2,45,5,1,6,5,6,0,6,0,False,True,True,0,1,2021-09-24T12:29:50.503,6,False,0.0
2021,2,3081,170,17,2253,13,4,5,6,0,0,0,0,0,0,False,False,False,0,2,2021-09-24T15:39:11.98,0,False,0.0
2021,2,3081,180,17,6274,13,11,2,16,0,0,0,0,0,0,False,False,False,0,3,2021-09-24T12:29:50.503,0,False,0.0
2021,2,3081,195,4,213,13,35,3,1,0,0,0,0,0,0,False,False,False,0,2,2021-09-24T15:26:08.107,0,False,0.0
2021,2,3081,205,17,7024,2,5,5,4,6,2,5,1,5,0,False,False,False,0,1,2021-09-20T18:27:29.143,6,False,1.0
2021,2,3081,210,17,6274,13,13,10,8,0,0,0,0,0,0,False,False,False,0,3,2021-09-20T18:26:46.267,0,False,0.0
2021,2,3081,215,17,8483,2,6,5,9,9,0,9,0,9,0,False,False,False,0,2,2021-09-24T12:29:50.503,9,True,0.0
2021,2,3081,235,17,8483,2,13,9,3,5,2,6,-1,6,0,False,False,False,0,3,2021-09-20T18:34:15.637,5,False,-1.0
2021,2,3081,250,17,6274,2,35,9,14,18,4,18,0,18,0,False,False,False,0,3,2021-09-24T15:26:20.45,18,False,0.0
2021,2,3081,255,17,2253,13,12,7,32,0,0,0,0,0,0,False,False,False,0,2,2021-09-24T15:26:40.707,0,False,0.0
2021,2,3081,260,17,4484,2,13,9,4,7,3,5,2,5,0,False,False,False,0,3,2021-12-15T18:51:52.507,7,False,
2021,2,3081,265,17,6274,2,2,9,12,12,0,12,0,12,0,False,False,False,0,3,2021-09-24T15:24:28.95,12,False,0.0
2021,2,3081,275,17,8483,2,51,5,-3,4,7,3,1,3,0,False,False,False,0,3,2021-09-20T18:35:39.213,4,False,1.0
2021,2,3081,280,17,364,3,5,3,5,0,0,0,0,0,0,False,False,False,0,3,2021-09-24T15:47:17.84,0,False,0.0
2021,2,3081,285,17,4305,2,16,9,5,5,0,5,0,5,0,False,True,True,0,3,2021-09-24T15:27:14.537,0,False,0.0
2021,2,3081,295,4,594,2,50,9,-3,1,4,1,0,1,0,True,False,False,0,3,2021-09-24T15:44:03.51,1,False,0.0
2021,2,3081,300,4,594,2,2,4,6,7,1,7,0,7,0,True,False,False,0,3,2021-09-21T18:10:33.033,7,False,0.0
2021,2,3081,310,4,6983,13,11,6,17,0,0,0,0,0,0,True,False,False,0,2,2021-09-24T12:29:50.563,0,False,0.0
2021,2,3081,315,4,2853,13,2,9,9,0,0,0,0,0,0,False,False,False,0,2,2021-09-24T15:30:03.297,0,False,0.0
2021,2,3081,330,17,8483,2,2,10,8,14,6,11,3,11,0,False,False,False,0,3,2021-09-24T15:27:38.163,14,False,3.0
2021,2,3081,370,17,2253,2,4,10,4,4,0,5,-1,5,0,False,False,False,0,3,2021-09-24T15:27:50.907,4,False,-1.0
2021,2,3081,375,17,7024,2,32,9,1,11,10,6,5,6,0,False,False,False,0,1,2021-09-24T15:40:10.433,11,False,5.0
2021,2,3081,385,17,2253,2,5,3,10,16,6,14,2,14,0,False,False,False,0,2,2021-09-20T18:38:02.21,16,False,2.0
2021,2,3081,390,17,2253,13,29,6,18,0,0,0,0,0,0,False,False,False,0,3,2021-09-24T12:29:50.563,0,False,0.0
2021,2,3081,400,17,6274,2,5,3,9,11,2,10,1,10,0,True,False,False,0,2,2021-09-24T15:30:40.59,11,False,1.0
2021,2,3081,405,17,364,3,6,10,5,0,0,0,0,0,0,False,False,False,0,2,2022-02-17T16:45:11.35,0,False,0.0
2021,2,3081,415,17,8483,2,50,5,-6,3,9,2,1,2,0,True,False,False,0,2,2022-02-17T17:13:36.467,3,False,1.0
2021,2,3081,455,4,213,13,35,9,10,0,0,0,0,0,0,False,False,False,0,3,2021-10-13T14:30:43.347,0,False,0.0
2021,2,3081,465,4,2853,13,35,6,27,0,0,0,0,0,0,False,False,False,0,3,2021-09-20T14:19:35.267,0,False,0.0
2021,2,3081,470,4,2853,2,13,9,4,7,3,7,0,7,0,True,False,False,0,3,2022-02-17T16:45:30.677,7,False,0.0
2021,2,3081,480,4,213,13,4,6,28,0,0,0,0,0,0,False,False,False,0,2,2022-02-17T16:45:57.997,0,False,0.0
2021,2,3081,510,4,594,2,39,4,11,22,11,21,1,21,0,False,False,False,0,3,2021-09-20T14:36:32.563,22,False,1.0
2021,2,3081,515,4,213,2,35,4,12,13,1,13,0,13,0,False,False,False,0,2,2021-09-20T14:38:34.313,13,False,0.0
2021,2,3081,520,4,213,13,35,3,14,0,0,0,0,0,0,False,False,False,0,3,2021-09-24T16:08:52.19,0,False,0.0
2021,2,3081,525,4,6983,2,51,3,-4,6,10,0,6,0,0,True,True,False,2,1,2021-09-24T15:45:35.137,6,False,6.0
2021,2,3081,540,4,2853,2,6,9,6,7,1,6,1,6,0,False,False,False,0,2,2021-09-24T16:02:51.57,7,False,1.0
2021,2,3081,545,4,6953,2,35,3,8,8,0,8,0,8,6,False,False,False,0,4,2021-09-24T15:24:46.19,8,True,0.0
2021,2,3081,560,17,364,2,4,9,3,5,2,5,0,5,0,False,False,False,0,2,2021-09-20T18:40:01.03,5,False,0.0
2021,2,3081,565,17,6274,13,2,5,6,0,0,0,0,0,0,True,False,False,0,2,2021-10-15T01:12:47.363,0,False,0.0
2021,2,3081,570,17,2253,2,3,3,8,8,0,8,0,8,0,False,False,False,0,2,2021-09-20T18:40:34.82,8,False,0.0
2021,2,3081,580,17,8483,3,51,5,-1,0,0,0,0,0,0,False,False,False,0,3,2022-02-17T16:46:35.933,0,False,0.0
2021,2,3081,590,17,7024,2,46,3,0,0,0,0,0,0,0,True,False,False,0,1,2021-09-24T12:14:07.503,0,False,0.0
2021,2,3081,615,4,6953,13,13,5,4,0,0,0,0,0,0,False,False,False,0,4,2021-09-24T15:31:58.797,0,False,0.0
2021,2,3081,620,4,2853,13,29,3,13,0,0,0,0,0,0,False,False,False,0,2,2021-09-24T15:25:07.987,0,False,0.0
2021,2,3081,635,17,7024,2,32,9,-4,4,8,3,1,3,0,False,False,False,2,1,2021-09-24T15:35:40.587,4,False,1.0
2021,2,3081,640,17,7087,2,4,3,2,2,0,1,1,1,0,False,False,False,1,2,2021-09-24T15:45:46.253,2,False,1.0
2021,2,3081,645,17,2253,2,6,10,5,7,2,5,2,5,0,False,False,False,1,2,2021-09-20T19:54:26.153,7,False,2.0
2021,2,3081,650,17,4716,2,4,10,8,8,0,8,0,8,0,False,False,False,0,3,2021-09-20T18:44:09.013,8,False,0.0
2021,2,3081,655,17,7618,13,16,10,4,0,0,0,0,0,0,False,False,False,0,1,2021-09-24T15:29:14.017,0,False,0.0
2021,2,3081,660,17,7087,13,2,10,5,0,0,0,0,0,0,False,False,False,0,2,2021-09-24T16:03:03.913,0,False,0.0
2021,2,3081,665,17,7087,13,13,9,1,0,0,0,0,0,0,False,False,False,0,3,2021-09-24T15:22:25.847,0,False,0.0
2021,2,3081,670,4,594,2,50,5,-3,6,9,3,3,3,0,False,False,False,0,2,2021-09-24T15:33:48.573,6,False,3.0
2021,2,3081,685,4,5119,13,11,6,16,0,0,0,0,0,0,True,False,False,0,4,2021-09-24T15:32:58.117,0,False,0.0
2021,2,3081,690,4,6953,2,30,3,-1,9,10,6,3,6,0,False,False,False,0,4,2021-09-24T15:33:12.703,9,False,3.0
2021,2,3081,710,4,213,13,35,2,17,0,0,0,0,0,0,False,False,False,0,3,2021-09-20T16:34:42.85,0,False,0.0
2021,2,3081,715,4,7645,2,55,4,-1,2,3,0,2,0,0,False,False,False,1,1,2021-09-24T15:46:02.47,2,False,2.0
2021,2,3081,740,17,2253,13,4,10,13,0,0,0,0,0,0,False,False,False,0,2,2021-09-20T16:46:55.493,0,False,0.0
2021,2,3081,760,4,2853,2,19,6,40,41,1,40,1,40,0,False,False,False,0,2,2021-09-20T16:55:57.607,41,False,1.0
2021,2,3081,770,4,6983,2,44,9,-5,3,8,2,1,2,0,False,False,False,0,1,2021-09-20T16:59:09.337,3,False,1.0
2021,2,3081,785,4,2630,13,35,9,11,0,0,0,0,0,0,False,False,False,0,4,2021-09-24T15:33:30.287,0,False,0.0
2021,2,3081,825,17,364,2,13,9,3,4,1,3,1,3,0,False,False,False,0,3,2021-09-24T16:03:15.537,4,False,1.0
2021,2,3081,830,17,364,2,51,10,-1,5,6,5,0,5,0,True,False,False,0,3,2021-09-24T15:25:24.957,5,False,0.0
2021,2,3081,840,17,364,13,5,6,18,0,0,0,0,0,0,False,False,False,0,3,2021-09-24T15:42:11.943,0,False,
2021,2,3081,875,17,364,2,5,5,5,6,1,5,1,5,0,False,False,False,1,3,2021-12-15T18:52:40.37,6,False,1.0
2021,2,3081,880,17,7618,13,16,10,2,0,0,0,0,0,0,False,False,False,0,1,2021-09-20T17:51:31.13,0,False,0.0
2021,2,3081,885,17,7618,3,12,3,3,0,0,0,0,0,0,False,False,False,0,2,2021-09-24T15:29:42.207,0,False,0.0
2021,2,3082,15,28,262,3,48,9,-3,0,0,0,0,0,0,True,False,False,0,1,2021-09-20T09:38:43.477,0,False,0.0
2021,2,3082,20,28,7224,2,52,4,2,10,8,7,3,7,0,False,False,False,0,3,2021-09-20T09:41:02.013,10,False,3.0
2021,2,3082,40,24,8509,13,4,3,10,0,0,0,0,0,0,False,False,False,0,2,2021-09-21T20:47:52.277,0,False,
2021,2,3082,45,24,8509,13,8,7,46,0,0,0,0,0,0,False,False,False,0,3,2021-09-20T09:56:19.627,0,False,0.0
2021,2,3082,50,24,7798,2,50,3,-2,4,6,-1,5,-1,0,False,False,False,1,2,2021-09-20T09:59:03.517,4,False,5.0
2021,2,3082,70,28,7224,3,51,9,-10,0,0,0,0,0,0,True,False,False,0,3,2021-09-20T16:38:49.47,0,False,0.0
2021,2,3082,75,28,917,13,5,3,12,0,0,0,0,0,0,False,False,False,0,3,2022-02-17T17:37:01.473,0,False,0.0
2021,2,3082,85,24,8509,2,4,9,7,11,4,8,3,8,0,False,False,False,0,2,2021-09-20T16:32:12.773,11,False,3.0
2021,2,3082,95,24,6937,2,46,3,1,4,3,3,1,3,0,False,False,False,0,1,2021-09-20T10:17:55.05,4,False,1.0
2021,2,3082,115,24,8513,2,13,9,4,9,5,7,2,7,0,True,False,False,0,3,2021-09-20T10:23:55.35,9,False,2.0
2021,2,3082,125,24,7798,2,50,10,-3,1,4,-1,2,-1,0,False,False,False,0,3,2021-09-24T15:37:47.007,1,False,2.0
2021,2,3082,130,24,8509,13,35,6,15,0,0,0,0,0,0,False,False,False,0,3,2021-09-20T10:41:03.65,0,False,0.0
2021,2,3082,145,28,4922,2,5,3,1,1,0,1,0,1,0,True,False,False,0,3,2021-09-24T15:37:47.007,1,False,0.0
2021,2,3082,150,28,7619,13,6,8,18,0,0,0,0,0,0,False,False,False,0,3,2021-09-20T10:49:33.463,0,False,0.0
2021,2,3082,155,28,7751,2,32,3,3,8,5,8,0,8,0,False,False,False,0,4,2021-09-20T10:52:20.453,8,False,0.0
2021,2,3082,170,24,6937,13,4,5,4,0,0,0,0,0,0,False,False,False,0,2,2021-09-20T15:11:00.54,0,False,0.0
2021,2,3082,180,24,8509,2,12,5,5,5,0,5,0,5,0,False,False,False,0,2,2021-09-20T11:02:15.577,5,False,0.0
2021,2,3082,190,24,7800,2,5,2,19,26,7,26,0,26,0,False,False,False,0,3,2021-09-20T16:17:26.927,26,False,0.0
2021,2,3082,195,24,7798,13,19,2,35,0,0,0,0,0,0,False,False,False,0,2,2021-09-20T11:08:56.57,0,True,0.0
2021,2,3082,230,28,262,2,5,9,6,7,1,7,0,7,0,False,False,False,0,1,2021-09-20T11:21:56.853,7,False,0.0
2021,2,3082,235,28,4922,2,32,3,-2,6,8,4,2,4,0,True,False,False,0,4,2021-09-20T11:24:02.333,6,False,2.0
2021,2,3082,255,28,6410,13,6,9,5,0,0,0,0,0,0,False,False,False,0,2,2022-01-05T17:51:28.607,0,False,0.0
2021,2,3082,260,28,8471,2,48,10,-5,11,16,8,3,8,0,False,False,False,0,1,2021-09-20T11:34:56.513,11,False,3.0
2021,2,3082,270,28,6410,13,5,2,21,0,0,0,0,0,0,False,False,False,0,2,2021-09-20T11:42:17.27,0,False,0.0
2021,2,3082,275,28,7224,2,4,7,16,17,1,16,1,16,0,False,False,False,0,3,2021-09-20T11:43:49.273,17,False,1.0
2021,2,3082,290,24,7800,2,19,2,39,91,52,72,19,72,0,False,False,False,1,2,2021-09-20T11:48:37.653,91,False,19.0
2021,2,3082,300,24,8513,13,48,10,-6,0,0,0,0,0,0,False,False,False,0,1,2021-09-20T11:51:54.29,0,False,0.0
2021,2,3082,305,24,8509,13,2,9,11,0,0,0,0,0,0,False,False,False,0,3,2021-09-24T15:37:47.007,0,False,
2021,2,3082,310,24,894,13,12,5,1,0,0,0,0,0,0,False,False,False,0,4,2021-09-20T11:55:49.963,0,False,0.0
2021,2,3082,340,28,7224,2,4,9,5,5,0,5,0,5,0,False,False,False,0,2,2021-09-20T12:09:02.157,5,False,0.0
2021,2,3082,355,28,4922,2,53,10,-2,8,10,3,5,3,0,False,False,False,1,4,2021-09-20T12:14:47.083,8,False,5.0
2021,2,3082,365,28,7751,2,48,4,-5,5,10,0,5,0,0,False,False,False,1,1,2021-09-20T12:17:50.827,5,False,5.0
2021,2,3082,370,28,7751,2,16,4,3,6,3,5,1,5,0,False,False,False,0,1,2021-09-20T16:39:04.44,6,False,1.0
2021,2,3082,380,28,7751,2,47,5,0,2,2,1,1,1,0,False,False,False,0,1,2021-09-20T12:27:18.56,2,False,1.0
2021,2,3082,395,28,7224,2,17,7,15,40,25,16,24,16,0,False,False,False,1,3,2021-09-24T18:04:57.51,40,False,24.0
2021,2,3082,400,28,7753,2,26,9,6,11,5,11,0,11,6,False,False,False,0,3,2021-09-20T12:35:27.277,11,True,0.0
2021,2,3082,440,24,8509,13,19,8,49,0,0,0,0,0,0,False,False,False,0,3,2021-09-20T12:51:30.397,0,False,0.0
2021,2,3082,460,28,6410,2,2,9,7,9,2,7,2,7,0,False,False,False,0,2,2021-09-20T12:59:20.6,9,False,2.0
2021,2,3082,475,28,4922,2,53,10,-3,4,7,2,2,2,0,False,True,False,0,4,2021-09-20T13:05:37.303,2,False,2.0
2021,2,3082,480,28,7224,13,5,3,11,0,0,0,0,0,0,False,False,False,0,2,2021-09-20T13:08:55.873,0,False,0.0
2021,2,3082,525,24,894,2,5,5,6,6,0,6,0,6,0,True,False,False,0,2,2021-09-20T16:37:32.757,6,False,0.0
2021,2,3082,535,24,8509,13,19,2,27,0,0,0,0,0,0,False,False,False,0,2,2021-09-20T13:40:19.45,0,False,0.0
2021,2,3082,540,24,7798,13,5,5,11,0,0,0,0,0,0,False,False,False,0,2,2021-09-20T13:43:50.033,0,False,0.0
2021,2,3082,550,28,7224,2,44,3,-3,6,9,3,3,3,0,True,False,False,0,3,2021-09-20T13:47:02.1,6,False,3.0
2021,2,3082,565,28,7753,2,50,10,-5,6,11,3,3,3,0,False,False,False,0,3,2022-01-31T19:45:44.153,6,False,3.0
2021,2,3082,570,28,7619,2,4,5,5,6,1,5,1,5,0,False,False,False,0,2,2021-09-20T13:53:15.67,6,False,1.0
2021,2,3082,580,28,8471,2,48,10,-4,0,4,0,0,0,0,False,False,False,0,1,2021-09-20T16:39:56.16,0,False,0.0
2021,2,3082,590,28,7224,2,6,4,10,15,5,10,5,10,0,False,False,False,1,3,2021-09-24T17:58:02.313,15,False,5.0
2021,2,3082,625,28,7751,13,55,4,-3,0,0,0,0,0,0,False,False,False,0,1,2022-02-17T17:36:07.193,0,False,0.0
2021,2,3082,630,28,917,13,7,3,3,0,0,0,0,0,0,False,False,False,0,3,2021-09-20T16:22:39.897,0,False,
2021,2,3082,655,24,7798,13,8,8,48,0,0,0,0,0,0,False,False,False,0,2,2021-09-20T14:28:09.687,0,False,0.0
2021,2,3082,660,24,6373,2,53,9,-5,10,15,8,2,8,0,False,False,False,0,4,2021-09-20T14:45:35.93,10,False,2.0
2021,2,3082,665,24,8509,13,12,5,10,0,0,0,0,0,0,False,False,False,0,2,2021-09-20T14:52:26.763,0,False,0.0
2021,2,3082,750,24,8513,2,28,9,1,9,8,2,7,2,0,False,False,False,2,1,2021-09-20T15:57:17.617,9,False,7.0
2021,2,3082,765,24,6373,2,5,5,12,14,2,12,2,12,0,False,False,False,0,4,2021-09-24T18:05:30.127,14,False,2.0
2021,2,3082,790,28,262,2,4,10,5,8,3,5,3,5,0,False,False,False,0,4,2021-09-20T16:09:40.81,8,False,3.0
2021,2,3083,10,14,7584,2,4,10,4,14,10,12,2,12,0,False,False,False,0,2,2022-02-16T23:54:54.343,14,False,2.0
2021,2,3083,15,14,7495,2,34,4,-4,10,14,5,5,5,0,True,False,False,0,3,2021-09-20T09:37:04.323,10,False,5.0
2021,2,3083,20,14,7584,2,4,5,6,9,3,7,2,7,0,False,False,False,0,2,2021-09-20T09:38:03.877,9,False,2.0
2021,2,3083,35,14,1119,2,4,10,5,5,0,5,0,5,0,False,False,False,0,3,2021-09-20T09:40:30.033,5,False,0.0
2021,2,3083,70,29,1958,2,8,9,13,16,3,13,3,13,0,False,False,False,0,3,2021-09-20T13:43:33.393,16,False,3.0
2021,2,3083,75,29,7378,2,44,3,1,23,22,15,8,15,0,False,False,False,2,1,2021-09-20T09:52:23.943,23,False,8.0
2021,2,3083,80,29,7828,2,6,4,14,14,0,14,0,14,0,False,False,False,0,3,2021-09-20T09:53:48.647,14,False,0.0
2021,2,3083,90,29,4866,2,50,3,-1,13,14,10,3,10,0,False,False,False,0,2,2021-09-20T09:55:46.927,13,False,3.0
2021,2,3083,100,29,4866,2,17,7,16,16,0,16,0,16,6,False,False,False,0,1,2021-09-20T09:58:17.143,16,True,0.0
2021,2,3083,125,14,4449,2,39,4,7,9,2,9,0,9,0,False,False,False,0,3,2021-09-20T10:04:10.277,9,False,0.0
2021,2,3083,130,14,7584,2,8,2,42,42,0,42,0,42,0,False,False,False,0,3,2021-09-24T17:38:20.237,42,False,0.0
2021,2,3083,140,14,7582,2,18,5,-1,2,3,1,1,1,0,False,False,False,0,2,2021-09-20T13:43:54.827,2,False,1.0
2021,2,3083,155,14,6543,3,6,9,4,0,0,0,0,0,0,False,False,False,0,2,2022-02-16T23:55:34.723,0,False,0.0
2021,2,3083,175,29,4866,13,6,1,20,0,0,0,0,0,0,False,False,False,0,3,2021-09-24T19:29:01.563,0,False,0.0
2021,2,3083,185,14,5197,2,4,9,5,18,13,6,12,6,0,False,False,False,1,3,2021-09-24T19:43:33.593,18,False,12.0
2021,2,3083,200,14,7584,2,4,10,6,7,1,6,1,6,0,False,False,False,0,3,2021-09-20T10:25:28.697,7,False,1.0
2021,2,3083,210,14,1119,13,55,10,0,0,0,0,0,0,0,True,False,False,0,4,2021-09-24T18:17:29.893,0,False,0.0
2021,2,3083,215,29,4866,2,25,10,1,9,8,6,3,6,0,False,False,False,0,2,2021-09-21T23:18:36.617,9,False,3.0
2021,2,3083,225,29,7378,2,28,9,1,4,3,3,1,3,0,False,False,False,0,1,2021-09-20T10:34:39.683,4,False,1.0
2021,2,3083,235,29,3398,2,2,10,5,8,3,7,1,7,0,False,False,False,0,2,2021-09-20T10:36:04.2,8,False,1.0
2021,2,3083,245,29,1958,2,8,4,14,16,2,15,1,15,0,False,False,False,0,3,2021-09-20T10:37:57.117,16,False,1.0
2021,2,3083,260,29,4866,2,35,9,11,11,0,11,0,11,0,False,False,False,0,3,2021-09-20T10:40:46.38,11,False,0.0
2021,2,3083,270,29,4866,2,5,3,4,14,10,6,8,6,0,False,False,False,1,3,2021-09-20T10:43:22.36,14,False,8.0
2021,2,3083,275,29,7378,13,45,5,-3,0,0,0,0,0,0,True,False,False,0,1,2021-09-20T10:44:12.32,0,False,0.0
2021,2,3083,290,29,1958,13,12,9,11,0,0,0,0,0,0,False,False,False,0,3,2021-09-24T19:29:16.437,0,False,0.0
2021,2,3083,305,14,1119,2,13,9,5,13,8,11,2,11,0,False,False,False,0,3,2021-09-20T10:52:11.28,13,False,2.0
2021,2,3083,315,14,6543,2,28,9,2,7,5,5,2,5,0,False,False,False,0,1,2022-01-28T16:33:39.403,7,False,2.0
2021,2,3083,340,14,7584,2,13,4,3,3,0,3,0,3,0,False,False,False,0,3,2021-09-20T10:57:51.973,3,False,0.0
2021,2,3083,345,14,4449,2,46,3,3,7,4,7,0,7,0,False,False,False,0,3,2021-09-20T10:58:52.39,7,False,0.0
2021,2,3083,350,14,7495,13,12,8,28,0,0,0,0,0,0,False,False,False,0,2,2021-09-20T10:59:52.71,0,False,0.0
2021,2,3083,360,14,8403,13,9,6,27,0,0,0,0,0,0,False,False,False,0,2,2021-09-20T11:01:03.87,0,False,0.0
2021,2,3083,380,29,1958,3,4,10,5,0,0,0,0,0,0,False,False,False,0,3,2022-02-16T23:56:11.893,0,False,0.0
2021,2,3083,385,29,4866,2,50,3,0,43,43,41,2,41,0,False,False,False,0,2,2021-09-20T11:14:08.157,43,False,2.0
2021,2,3083,430,14,5197,13,13,4,2,0,0,0,0,0,0,False,False,False,0,4,2021-09-24T19:29:29.763,0,False,0.0
2021,2,3083,445,29,7378,2,48,9,-3,2,5,0,2,0,0,False,False,False,0,1,2021-09-20T11:24:16.513,2,False,2.0
2021,2,3083,450,29,7378,3,44,3,-4,0,0,0,0,0,0,False,False,False,0,1,2021-09-24T18:23:09.003,0,False,0.0
2021,2,3083,455,29,4866,13,4,4,10,0,0,0,0,0,0,False,False,False,0,3,2021-09-24T20:03:29.39,0,False,0.0
2021,2,3083,480,14,1119,2,46,3,2,12,10,7,5,7,0,False,False,False,0,4,2021-09-21T20:47:02.123,12,False,5.0
2021,2,3083,485,14,7584,2,7,6,21,23,2,23,0,23,0,False,False,False,0,3,2021-09-20T11:36:25.597,23,False,0.0
2021,2,3083,490,14,1119,13,4,9,7,0,0,0,0,0,0,False,False,False,0,3,2021-09-20T11:37:15.237,0,False,0.0
2021,2,3083,515,14,7584,13,12,10,5,0,0,0,0,0,0,False,False,False,0,1,2021-09-24T19:43:10.957,0,False,0.0
2021,2,3083,520,14,4449,2,8,10,8,8,0,8,0,8,6,False,False,False,0,2,2021-09-20T11:56:31.59,8,True,0.0
2021,2,3083,540,29,7828,13,13,10,3,0,0,0,0,0,0,False,False,False,0,2,2021-09-20T11:58:59.733,0,False,0.0
2021,2,3083,545,29,1958,13,6,1,21,0,0,0,0,0,0,False,False,False,0,2,2021-09-24T18:24:01.773,0,False,0.0
2021,2,3083,555,14,1119,2,31,10,-10,0,10,-2,2,-2,0,True,False,False,0,4,2021-09-24T19:29:44.847,0,False,2.0
2021,2,3083,560,14,7584,2,4,10,7,15,8,11,4,11,0,False,False,False,0,3,2021-09-20T12:30:30.693,15,False,4.0
2021,2,3083,565,14,5024,13,32,5,-2,0,0,0,0,0,0,False,False,False,0,1,2022-02-01T19:36:05.333,0,False,0.0
2021,2,3083,575,14,7584,13,12,2,19,0,0,0,0,0,0,False,False,False,0,3,2021-09-20T13:41:55.743,0,False,0.0
2021,2,3083,600,29,7828,3,4,7,18,0,0,0,0,0,0,False,False,False,0,3,2021-09-24T18:25:38.703,0,False,0.0
2021,2,3083,620,29,1958,2,4,3,8,11,3,11,0,11,0,False,False,False,0,2,2021-09-24T18:26:12.433,11,False,0.0
2021,2,3083,630,29,4866,2,21,6,20,44,24,38,6,38,0,True,False,False,1,3,2021-09-24T17:38:20.237,44,False,6.0
2021,2,3083,635,29,4866,2,8,4,10,10,0,10,0,10,6,False,False,False,0,3,2021-09-24T18:27:16.01,10,True,0.0
2021,2,3083,660,14,4449,2,51,9,-3,9,12,5,4,5,0,True,False,False,0,3,2021-09-20T12:53:17.187,9,False,4.0
2021,2,3083,675,14,1119,2,7,2,16,34,18,33,1,33,0,True,False,False,0,4,2021-09-20T12:55:29.593,34,False,1.0
2021,2,3083,690,14,7584,13,12,3,5,0,0,0,0,0,0,False,False,False,0,2,2021-09-20T13:04:23.103,0,False,0.0
2021,2,3083,705,29,1958,3,5,5,9,0,0,0,0,0,0,False,False,False,0,4,2021-09-20T13:05:38.737,0,False,0.0
2021,2,3083,710,29,1958,2,4,10,6,14,8,11,3,11,0,False,False,False,0,3,2021-09-20T13:06:59.15,14,False,3.0
2021,2,3083,720,29,1958,2,26,9,5,7,2,7,0,7,0,False,False,False,0,3,2021-09-20T13:08:24.87,7,False,0.0
2021,2,3083,725,29,4866,2,30,5,-1,3,4,3,0,3,0,False,False,False,0,4,2021-09-20T13:09:51.217,3,False,0.0
2021,2,3083,785,14,4449,13,46,3,4,0,0,0,0,0,0,False,False,False,0,3,2021-09-20T13:18:19.103,0,False,0.0
2021,2,3083,790,14,1119,13,7,2,20,0,0,0,0,0,0,False,False,False,0,3,2022-02-17T00:01:00.993,0,False,0.0
2021,2,3083,825,14,7584,3,6,1,21,0,0,0,0,0,0,False,False,False,0,3,2021-09-24T17:38:20.237,0,False,0.0
2021,2,3083,830,14,7584,2,5,3,10,10,0,10,0,10,0,False,False,False,0,2,2021-09-20T13:25:53.07,10,False,0.0
2021,2,3083,835,14,4449,2,4,10,8,5,-3,5,0,5,0,False,False,False,0,3,2022-02-15T14:20:19.34,5,False,0.0
2021,2,3084,10,25,4583,2,4,9,4,6,2,5,1,5,0,False,False,False,0,4,2021-09-20T09:21:08.57,6,False,1.0
2021,2,3084,20,25,4583,2,4,10,4,5,1,5,0,5,0,False,False,False,0,3,2021-09-21T15:59:01.11,5,False,0.0
2021,2,3084,30,25,4583,2,30,10,-2,2,4,0,2,0,0,True,False,False,0,4,2021-09-20T09:43:31.127,2,False,2.0
2021,2,3084,35,25,609,13,12,6,15,0,0,0,0,0,0,True,False,False,0,4,2021-09-24T18:55:36.027,0,False,0.0
2021,2,3084,45,23,7246,13,39,9,5,0,0,0,0,0,0,False,False,False,0,4,2021-09-21T15:41:09.1,0,False,0.0
2021,2,3084,50,23,116,2,4,9,6,9,3,9,0,9,0,False,False,False,0,2,2021-09-21T15:41:36.02,9,False,0.0
2021,2,3084,65,23,7250,2,4,10,3,3,0,2,1,2,0,False,False,False,0,3,2021-09-24T19:01:24.84,3,False,1.0
2021,2,3084,80,25,7666,13,9,2,22,0,0,0,0,0,0,False,False,False,0,3,2021-09-20T10:29:56.587,0,False,0.0
2021,2,3084,95,25,7666,2,18,3,-1,2,3,1,1,1,0,False,False,False,0,2,2021-09-21T15:59:30.1,2,False,1.0
2021,2,3084,100,25,7060,13,12,6,32,0,0,0,0,0,0,False,False,False,0,2,2021-09-24T18:57:29.793,0,False,0.0
2021,2,3084,105,23,4307,2,18,3,-1,11,12,9,2,9,0,False,False,False,0,2,2021-09-20T10:45:00.2,11,False,2.0
2021,2,3084,125,23,4307,2,4,9,3,10,7,9,1,9,0,False,False,False,0,1,2021-09-24T19:01:40.297,10,False,1.0
2021,2,3084,140,25,8421,2,47,5,-2,9,11,1,8,1,0,False,False,False,3,1,2021-09-24T19:10:59.54,9,False,8.0
2021,2,3084,145,25,7060,2,51,9,-3,7,10,6,1,6,0,False,False,False,0,3,2021-09-24T18:54:30.177,7,False,1.0
2021,2,3084,150,25,7060,2,2,9,7,9,2,7,2,7,0,False,False,False,1,2,2021-09-24T19:11:27.477,9,False,2.0
2021,2,3084,165,25,4583,2,50,9,-2,17,19,-2,19,-2,0,False,False,False,2,3,2021-09-24T17:14:51.08,17,False,19.0
2021,2,3084,185,25,4583,2,39,4,5,6,1,6,0,6,0,False,False,False,0,3,2021-09-20T19:12:06.217,6,False,0.0
2021,2,3084,195,25,7666,13,19,6,38,0,0,0,0,0,0,False,False,False,0,2,2021-09-20T11:47:41.433,0,False,0.0
2021,2,3084,200,25,7666,13,19,8,28,0,0,0,0,0,0,False,False,False,0,2,2021-09-24T18:53:32.313,0,False,0.0
2021,2,3084,220,23,7250,2,4,10,3,17,14,3,14,3,0,False,False,False,2,3,2021-09-20T18:29:50.377,17,False,14.0
2021,2,3084,240,23,2994,13,47,5,2,0,0,0,0,0,0,True,False,False,0,4,2021-09-21T15:47:08.76,0,False,0.0
2021,2,3084,255,25,7060,2,3,5,14,13,-1,14,-1,14,0,False,False,False,0,2,2021-09-20T12:28:06.803,13,False,-1.0
2021,2,3084,270,25,4583,2,4,9,5,5,0,5,0,5,0,False,False,False,0,4,2021-09-20T12:37:19.71,5,False,0.0
2021,2,3084,275,25,7060,2,19,6,33,41,8,34,7,34,0,False,False,False,0,2,2021-09-20T12:42:52.933,41,False,7.0
2021,2,3084,300,23,7688,2,47,10,1,13,12,12,1,12,0,False,False,False,0,3,2021-09-20T12:56:10.59,13,False,1.0
2021,2,3084,305,23,7250,2,12,10,10,10,0,11,-1,11,0,False,False,False,0,3,2021-09-24T19:02:00.353,10,False,-1.0
2021,2,3084,310,23,7246,2,17,7,20,25,5,22,3,22,0,False,False,False,0,4,2021-09-20T19:01:34.977,25,False,3.0
2021,2,3084,315,23,7240,13,7,2,16,0,0,0,0,0,0,False,False,False,0,1,2021-09-24T19:19:10.557,0,False,0.0
2021,2,3084,320,23,7689,2,12,9,5,6,1,4,2,4,0,False,False,False,0,2,2021-09-24T19:02:13.16,6,False,2.0
2021,2,3084,325,23,7250,2,4,9,3,4,1,3,1,3,0,False,False,False,0,3,2021-09-20T18:16:33.107,4,False,1.0
2021,2,3084,340,23,4307,2,46,3,0,3,3,2,1,2,0,False,False,False,0,1,2021-09-20T13:27:22.733,3,False,1.0
2021,2,3084,350,23,2994,2,5,9,7,8,1,8,0,8,0,False,False,False,0,4,2021-09-24T19:02:30.123,8,False,0.0
2021,2,3084,375,23,7689,2,2,4,7,7,0,7,0,7,6,False,False,False,0,3,2021-09-24T18:56:14.24,7,True,
2021,2,3084,380,23,2994,13,11,2,17,0,0,0,0,0,0,False,False,False,0,4,2021-09-24T19:02:43.963,0,True,0.0
2021,2,3084,385,23,7689,2,50,3,-1,9,10,6,3,6,0,False,False,False,0,2,2021-09-24T17:14:51.08,9,False,
2021,2,3084,415,23,2994,2,42,9,4,9,5,4,5,4,0,False,False,False,0,3,2021-09-20T13:59:34.633,9,False,5.0
2021,2,3084,425,23,2688,2,2,10,7,14,7,7,7,7,0,False,False,False,1,3,2021-09-20T14:06:04.04,14,False,7.0
2021,2,3084,430,23,2994,13,2,10,12,0,0,0,0,0,0,False,False,False,0,2,2021-09-20T14:08:41.853,0,False,0.0
2021,2,3084,440,23,4307,3,12,3,9,0,0,0,0,0,0,False,False,False,0,1,2021-09-20T14:16:44.39,0,False,0.0
2021,2,3084,450,25,7666,13,19,2,37,0,0,0,0,0,0,False,False,False,0,2,2021-09-20T14:22:23.863,0,False,0.0
2021,2,3084,455,25,7060,2,51,9,-4,5,9,5,0,5,0,False,False,False,0,3,2021-09-24T19:03:26.097,5,False,0.0
2021,2,3084,460,25,8422,2,5,10,8,14,6,8,6,8,0,True,False,False,0,4,2021-09-21T16:01:18.02,14,False,6.0
2021,2,3084,475,25,7060,2,13,4,2,3,1,2,1,2,0,False,False,False,0,2,2021-09-20T14:37:40.953,3,False,1.0
2021,2,3084,485,23,7689,2,6,1,15,18,3,15,3,15,0,False,False,False,0,3,2021-09-24T18:56:26.387,18,False,3.0
2021,2,3084,490,23,4307,2,16,10,4,9,5,7,2,7,0,False,False,False,0,1,2021-09-20T18:32:48.843,9,False,2.0
2021,2,3084,500,23,7250,2,21,8,18,23,5,23,0,23,0,False,False,False,0,3,2021-09-20T18:19:56.053,23,False,0.0
2021,2,3084,510,23,7688,2,6,1,15,30,15,17,13,17,0,False,False,False,1,3,2021-09-24T18:59:25.09,30,False,13.0
2021,2,3084,515,23,7246,2,7,3,9,9,0,9,0,9,6,False,False,False,0,3,2022-02-17T17:48:31.48,9,True,0.0
2021,2,3084,535,25,8422,2,4,5,6,8,2,5,3,5,0,True,False,False,0,4,2021-09-21T16:00:54.32,8,False,3.0
2021,2,3084,545,25,7666,2,3,3,14,16,2,16,0,16,0,False,False,False,0,2,2021-09-20T15:36:03.413,16,True,0.0
2021,2,3084,555,25,7666,13,2,5,10,0,0,0,0,0,0,False,False,False,0,2,2021-09-20T15:42:23.603,0,True,0.0
2021,2,3084,560,25,7060,13,4,2,30,0,0,0,0,0,0,False,False,False,0,2,2022-02-25T14:46:42.567,0,False,0.0
2021,2,3084,570,23,4307,2,45,10,-5,13,18,13,0,13,0,False,False,False,0,1,2021-09-20T15:56:45.937,13,False,0.0
2021,2,3084,575,23,7688,2,51,9,-3,2,5,0,2,0,0,False,False,False,0,3,2021-09-24T19:04:04.887,2,False,2.0
2021,2,3084,580,23,2994,2,2,9,6,13,7,10,3,10,0,False,False,False,0,4,2021-09-24T19:04:17.833,13,False,3.0
2021,2,3084,590,23,7689,2,4,3,4,16,12,3,13,3,0,False,False,False,1,2,2021-09-24T19:11:59.493,16,False,13.0
2021,2,3084,595,23,7688,2,5,5,4,7,3,5,2,5,0,False,False,False,0,3,2021-09-20T16:19:49.593,7,False,2.0
2021,2,3084,605,23,7250,13,2,10,6,0,0,0,0,0,0,False,False,False,0,4,2021-09-24T19:04:34.243,0,False,0.0
2021,2,3084,620,25,7666,2,19,6,40,52,12,47,5,47,0,False,False,False,1,2,2021-09-24T19:05:05.063,52,False,5.0
2021,2,3084,635,25,7060,13,7,6,25,0,0,0,0,0,0,False,False,False,0,2,2021-09-24T19:05:20.007,0,False,0.0
2021,2,3084,640,25,8421,2,5,3,4,25,21,5,20,5,6,False,False,False,1,1,2021-09-24T19:05:33.53,25,False,20.0
2021,2,3084,655,23,116,2,13,9,2,4,2,3,1,3,0,False,False,False,0,4,2021-09-20T16:49:19.827,4,False,1.0
2021,2,3084,660,23,2994,2,5,3,10,10,0,10,0,10,0,False,False,False,0,4,2021-09-20T16:52:11.907,10,False,0.0
2021,2,3084,665,23,7250,13,9,2,20,0,0,0,0,0,0,False,False,False,0,3,2021-09-20T18:21:13.847,0,False,0.0
2021,2,3084,675,23,7688,13,4,5,10,0,0,0,0,0,0,False,False,False,0,2,2021-09-24T18:57:59.16,0,False,0.0
2021,2,3084,680,23,7688,2,8,1,47,61,14,46,15,46,6,False,False,False,0,3,2021-09-20T17:01:10.973,61,False,15.0
2021,2,3084,695,25,7060,2,18,3,-1,4,5,2,2,2,0,False,False,False,0,2,2021-09-24T18:59:55.033,4,False,2.0
2021,2,3084,700,25,6486,3,2,10,5,0,0,0,0,0,0,False,False,False,0,2,2021-09-24T18:55:12.537,0,False,0.0
2021,2,3084,705,25,8422,2,13,9,3,5,2,4,1,4,0,False,False,False,0,4,2021-09-24T19:05:49.287,5,False,1.0
2021,2,3084,745,25,8422,2,39,4,6,9,3,6,3,6,0,False,False,False,0,4,2021-09-20T17:26:50.37,9,False,3.0
2021,2,3084,750,25,8421,2,5,10,0,5,5,4,1,4,0,False,False,False,0,1,2021-09-20T18:36:18.38,5,False,1.0
2021,2,3084,755,25,8421,2,48,10,-3,4,7,0,4,0,0,False,False,False,1,1,2021-09-24T19:00:08.4,4,False,4.0
2021,2,3084,760,25,7060,2,18,3,0,12,12,10,2,10,0,False,False,False,0,2,2021-09-20T18:36:28.923,12,False,2.0
2021,2,3084,765,25,8421,2,6,9,0,0,0,-2,2,-2,0,False,False,False,0,1,2021-09-24T19:06:03.257,0,False,2.0
2021,2,3084,770,25,4583,13,13,3,3,0,0,0,0,0,0,False,False,False,0,3,2021-09-20T17:45:36.05,0,False,0.0
2021,2,3084,775,25,7666,13,6,9,12,0,0,0,0,0,0,False,False,False,0,2,2021-09-24T17:15:03.37,0,False,0.0
2021,2,3084,795,23,2994,2,11,2,20,25,5,21,4,21,0,True,False,False,0,4,2021-09-20T17:58:14.74,25,False,4.0
2021,2,3084,845,25,7060,2,52,4,2,11,9,11,0,11,0,False,False,False,0,2,2021-09-24T19:06:17.097,11,False,0.0
2021,2,3085,20,6,7725,2,4,10,11,10,-1,10,0,10,0,False,False,False,0,3,2021-09-20T18:59:15.057,10,False,0.0
2021,2,3085,25,6,7725,2,35,2,17,17,0,17,0,17,0,False,False,False,0,3,2022-02-16T23:22:27.68,17,False,0.0
2021,2,3085,30,6,1400,2,34,4,-5,-5,0,-5,0,-5,0,True,False,False,0,3,2021-09-21T12:17:41.283,-5,False,0.0
2021,2,3085,35,6,1400,2,47,5,3,3,0,3,0,3,0,False,False,False,0,1,2022-02-16T23:28:05.5,3,False,0.0
2021,2,3085,40,6,1378,13,12,6,31,0,0,0,0,0,0,False,False,False,0,2,2022-02-01T19:37:59.107,0,False,
2021,2,3085,45,6,6786,2,4,10,3,3,0,3,0,3,0,False,False,False,0,1,2021-09-24T18:03:48.193,3,False,0.0
2021,2,3085,55,6,464,2,8,10,11,11,0,12,-1,12,6,False,False,False,0,2,2021-09-24T18:05:32.587,11,False,-1.0
2021,2,3085,75,7,4679,2,18,3,-1,2,3,0,2,0,0,False,False,False,0,2,2021-09-21T11:26:09.503,2,False,2.0
2021,2,3085,80,7,7659,2,4,4,6,7,1,6,1,6,0,False,False,False,0,2,2021-09-21T11:34:13.087,7,False,1.0
2021,2,3085,100,7,8317,3,2,10,6,0,0,0,0,0,0,False,False,False,0,2,2021-09-20T13:03:43.477,0,False,0.0
2021,2,3085,105,7,3521,2,35,10,10,12,2,11,1,11,0,False,False,False,0,3,2021-09-20T13:19:05.66,12,False,1.0
2021,2,3085,115,7,3521,2,2,10,7,10,3,8,2,8,0,False,False,False,0,3,2021-09-21T18:13:31.343,10,False,2.0
2021,2,3085,125,7,7659,13,6,9,2,0,0,0,0,0,0,False,False,False,0,2,2021-09-24T16:49:27.583,0,False,0.0
2021,2,3085,160,6,6786,13,46,9,-2,0,0,0,0,0,0,False,False,False,0,1,2021-09-20T19:01:56.543,0,False,0.0
2021,2,3085,165,6,7725,2,49,5,-2,2,4,1,1,1,0,False,False,False,0,3,2021-09-24T18:07:43.727,2,False,1.0
2021,2,3085,180,6,6786,2,44,3,0,36,36,32,4,32,0,True,False,False,1,2,2022-02-16T23:24:36.907,36,False,
2021,2,3085,185,6,1378,13,3,2,18,0,0,0,0,0,0,False,False,False,0,3,2022-02-16T23:25:10.17,0,False,0.0
2021,2,3085,245,7,2631,2,32,5,-2,3,5,-2,5,-2,0,False,False,False,2,2,2022-02-16T23:26:33.593,3,False,5.0
2021,2,3085,250,7,8317,2,2,9,7,12,5,7,5,7,0,False,False,False,0,3,2021-09-24T17:56:27.103,12,False,5.0
2021,2,3085,255,7,2631,2,47,5,1,1,0,1,0,1,0,False,False,False,0,4,2021-09-24T17:41:40.587,1,False,0.0
2021,2,3085,270,7,7659,13,4,5,4,0,0,0,0,0,0,False,False,False,0,2,2021-09-24T18:10:48.627,0,False,0.0
2021,2,3085,280,6,6786,2,46,3,2,10,8,5,5,5,0,False,False,False,0,1,2021-09-20T18:52:21.5,10,False,5.0
2021,2,3085,295,6,7725,2,4,10,5,5,0,5,0,5,0,False,False,False,1,3,2021-09-20T18:52:40.38,5,False,0.0
2021,2,3085,310,7,3521,2,5,9,2,2,0,2,0,2,0,False,False,False,0,3,2021-09-20T15:04:49.17,2,False,0.0
2021,2,3085,320,7,7659,2,5,5,10,14,4,13,1,13,0,False,False,False,0,3,2021-09-20T15:10:16.193,14,False,1.0
2021,2,3085,330,7,7659,2,6,4,5,8,3,6,2,6,0,False,False,False,0,3,2021-09-24T16:49:27.583,8,False,2.0
2021,2,3085,345,7,4679,13,2,9,2,0,0,0,0,0,0,False,False,False,0,2,2021-09-20T15:17:22.113,0,False,0.0
2021,2,3085,365,6,7725,2,5,5,10,11,1,11,0,11,0,False,False,False,0,3,2021-09-20T15:25:01.257,11,False,0.0
2021,2,3085,375,6,1378,2,5,5,10,10,0,10,0,10,0,False,False,False,0,3,2021-09-24T18:12:54.47,10,False,0.0
2021,2,3085,385,6,1400,13,31,4,4,0,0,0,0,0,0,False,False,False,0,1,2021-09-20T15:32:07.977,0,False,0.0
2021,2,3085,430,7,3521,2,13,4,5,7,2,5,2,5,0,False,False,False,0,3,2021-09-24T19:48:39.947,7,False,2.0
2021,2,3085,435,7,7659,13,8,7,40,0,0,0,0,0,0,False,False,False,0,3,2022-02-16T23:31:58.15,0,False,0.0
2021,2,3085,460,7,4455,13,46,3,1,0,0,0,0,0,0,False,False,False,0,1,2022-02-16T23:27:15.767,0,False,0.0
2021,2,3085,470,7,8325,2,16,10,4,14,10,11,3,11,0,False,False,False,0,1,2021-09-24T18:16:23.943,14,False,3.0
2021,2,3085,505,6,7725,13,35,6,20,0,0,0,0,0,0,False,False,False,0,3,2021-09-20T16:06:02.69,0,False,0.0
2021,2,3085,535,7,7659,2,6,4,14,14,0,14,0,14,0,False,True,True,0,3,2022-02-16T23:29:59.547,14,False,0.0
2021,2,3085,555,6,464,2,4,3,4,13,9,5,8,5,0,False,False,False,1,2,2021-09-20T16:40:33.45,13,False,8.0
2021,2,3085,560,6,7725,2,35,6,20,21,1,21,0,21,0,False,False,False,0,3,2021-09-20T16:42:43.247,21,True,0.0
2021,2,3085,585,6,464,13,9,3,10,0,0,0,0,0,0,False,False,False,0,2,2021-09-20T19:33:08.153,0,False,0.0
2021,2,3085,615,7,3521,2,26,4,5,22,17,20,2,20,0,False,False,False,1,3,2021-09-20T17:02:28.753,22,False,2.0
2021,2,3085,630,7,3521,13,4,10,1,0,0,0,0,0,0,False,False,False,0,3,2021-09-24T17:52:46.807,0,False,0.0
2021,2,3085,655,7,7659,13,4,3,10,0,0,0,0,0,0,False,False,False,0,3,2022-01-02T18:14:01.647,0,False,0.0
2021,2,3085,670,6,464,13,19,6,35,0,0,0,0,0,0,False,False,False,0,2,2021-09-20T17:28:30.457,0,False,0.0
2021,2,3085,675,6,7728,2,6,3,12,13,1,12,1,12,0,False,False,False,0,3,2021-09-20T19:25:36.877,13,False,
2021,2,3085,680,6,6786,2,32,5,1,5,4,2,3,2,0,False,False,False,1,4,2021-09-20T17:33:58.123,5,False,3.0
2021,2,3085,695,7,3521,13,17,4,-5,0,0,0,0,0,0,False,False,False,0,3,2021-09-24T17:50:47.967,0,False,0.0
2021,2,3085,710,6,7725,13,13,3,4,0,0,0,0,0,0,False,False,False,0,3,2021-09-20T19:33:43.95,0,False,0.0
2021,2,3085,730,7,3521,2,42,9,3,5,2,5,0,5,0,False,False,False,0,3,2021-09-20T17:46:19.14,5,False,0.0
2021,2,3085,735,7,7659,2,50,3,-2,10,12,7,3,7,0,False,False,False,1,2,2021-09-24T18:56:21.123,10,False,3.0
2021,2,3085,740,7,8317,13,19,6,35,0,0,0,0,0,0,False,False,False,0,2,2021-09-20T17:51:25.27,0,False,0.0
2021,2,3085,750,7,3521,2,5,5,13,15,2,15,0,15,0,False,False,False,0,3,2021-09-24T18:22:20.927,15,False,0.0
2021,2,3085,755,7,8317,2,19,2,32,42,10,32,10,32,6,False,False,False,1,2,2021-09-24T18:00:27.653,42,False,10.0
2021,2,3085,785,6,1378,13,13,4,2,0,0,0,0,0,0,False,False,False,0,3,2022-02-16T23:33:03.947,0,False,0.0
2021,2,3085,790,7,7659,2,4,10,7,7,0,7,0,7,6,False,False,False,0,3,2021-09-20T18:03:47.553,7,False,0.0
2021,2,3085,815,6,7728,2,47,5,0,0,0,0,0,0,0,False,False,False,0,3,2021-09-20T18:07:34.16,0,False,0.0
2021,2,3086,15,8,232,2,49,10,-2,9,11,7,2,7,0,False,False,False,0,3,2021-09-20T11:04:35.833,9,False,2.0
2021,2,3086,20,8,6439,2,48,9,-5,3,8,3,0,3,0,False,False,False,0,1,2021-09-20T20:10:25.98,3,False,0.0
2021,2,3086,40,8,7652,2,19,6,24,29,5,27,2,27,0,False,False,False,0,2,2021-12-22T16:29:59.02,29,False,2.0
2021,2,3086,45,8,3883,2,4,10,4,4,0,4,0,4,0,False,False,False,0,4,2021-09-24T22:03:53.733,4,False,0.0
2021,2,3086,70,13,8417,2,2,9,11,32,21,26,6,26,0,False,False,False,0,3,2022-02-16T23:40:43.26,32,False,6.0
2021,2,3086,75,13,902,2,46,9,-1,-1,0,-1,0,-1,0,False,False,False,0,1,2021-09-20T11:24:50.713,-1,False,0.0
2021,2,3086,85,13,876,2,5,3,12,12,0,12,0,12,0,False,False,False,0,2,2021-09-24T20:49:25.157,12,False,0.0
2021,2,3086,95,13,2407,2,2,9,6,13,7,10,3,10,0,False,False,False,0,2,2021-09-20T11:37:20.69,13,False,3.0
2021,2,3086,100,13,876,2,12,10,5,6,1,6,0,6,0,False,False,False,0,3,2022-02-01T19:38:47.507,6,False,0.0
2021,2,3086,105,13,6481,2,48,10,-5,22,27,21,1,21,6,False,False,False,0,1,2021-09-24T23:22:29.723,22,False,1.0
2021,2,3086,125,8,4976,2,53,9,-3,11,14,9,2,9,0,False,False,False,0,4,2021-09-20T11:54:07.04,11,False,2.0
2021,2,3086,140,8,3883,2,32,9,-2,13,15,9,4,9,0,False,False,False,0,4,2021-09-20T12:07:02.21,13,False,4.0
2021,2,3086,145,8,7651,2,8,9,14,15,1,15,0,15,0,False,True,True,0,3,2021-09-20T20:03:45.993,14,False,0.0
2021,2,3086,185,13,876,2,50,9,-5,-3,2,-4,1,-4,0,True,False,False,0,3,2021-09-24T21:42:14.557,-3,False,1.0
2021,2,3086,190,13,876,2,52,4,4,13,9,11,2,11,0,False,False,False,0,3,2021-09-24T23:16:22.473,13,False,2.0
2021,2,3086,205,8,3606,2,8,9,12,14,2,13,1,13,0,False,False,False,0,3,2021-09-24T23:30:25.23,14,False,1.0
2021,2,3086,215,8,3883,2,2,9,10,13,3,13,0,13,0,False,False,False,0,3,2021-09-20T12:55:45.537,13,False,0.0
2021,2,3086,230,8,4976,13,17,9,14,0,0,0,0,0,0,False,False,False,0,3,2022-02-25T14:51:37.583,0,False,0.0
2021,2,3086,235,8,8349,13,6,7,16,0,0,0,0,0,0,False,False,False,0,2,2021-09-24T23:21:59.557,0,False,0.0
2021,2,3086,245,13,100,2,4,10,4,9,5,7,2,7,0,False,False,False,0,3,2021-09-20T13:27:37.89,9,False,2.0
2021,2,3086,250,13,876,2,11,5,14,22,8,22,0,22,0,True,False,False,0,3,2021-09-24T21:42:45.063,22,True,0.0
2021,2,3086,260,13,902,13,5,5,6,0,0,0,0,0,0,False,False,False,0,3,2021-09-20T13:38:32.59,0,False,0.0
2021,2,3086,290,8,7652,2,30,9,0,8,8,4,4,4,0,True,False,False,0,4,2021-09-20T13:55:00.66,8,False,4.0
2021,2,3086,325,8,4976,2,12,5,6,7,1,7,0,7,0,False,False,False,0,2,2021-09-24T22:11:56.097,7,False,0.0
2021,2,3086,420,13,876,13,13,4,5,0,0,0,0,0,0,False,False,False,0,3,2021-09-20T15:09:00.543,0,False,0.0
2021,2,3086,435,8,7652,2,5,9,6,6,0,6,0,6,0,False,False,False,0,2,2021-09-20T15:18:20.55,6,False,0.0
2021,2,3086,440,8,3606,2,8,9,13,13,0,13,0,13,0,False,False,False,0,3,2021-09-24T23:37:51.117,13,False,0.0
2021,2,3086,445,8,7652,2,26,10,3,6,3,4,2,4,0,False,False,False,0,3,2021-09-20T15:26:47.47,6,False,2.0
2021,2,3086,455,8,3883,2,53,10,-3,5,8,3,2,3,0,False,False,False,0,4,2021-09-21T22:56:52.83,5,False,2.0
2021,2,3086,470,8,6439,2,12,10,-6,1,7,-2,3,-2,0,False,False,False,0,1,2022-02-01T19:39:10.73,1,False,
2021,2,3086,475,8,8354,2,50,9,-4,33,37,4,29,4,6,False,False,False,2,3,2021-09-24T23:24:40.28,33,False,29.0
2021,2,3086,500,13,1028,13,6,4,10,0,0,0,0,0,0,False,False,False,0,3,2021-09-24T23:22:12.507,0,False,0.0
2021,2,3086,540,13,876,13,19,1,54,0,0,0,0,0,0,False,False,False,0,3,2021-09-25T00:10:37.123,0,False,0.0
2021,2,3086,550,13,6528,2,5,3,10,17,7,10,7,10,0,False,False,False,0,4,2021-09-20T16:49:05.317,17,False,7.0
2021,2,3086,555,13,6528,13,4,4,13,0,0,0,0,0,0,False,False,False,0,4,2021-09-24T23:16:53.56,0,False,0.0
2021,2,3086,570,13,2455,2,32,10,-2,14,16,5,9,5,0,False,False,False,2,1,2021-09-20T17:04:25.353,14,False,9.0
2021,2,3086,590,13,876,13,11,2,30,0,0,0,0,0,0,False,False,False,0,3,2021-09-24T21:46:40.533,0,False,
2021,2,3086,600,13,876,2,26,9,6,7,1,7,0,7,0,False,False,False,0,3,2021-09-24T23:21:47.323,7,False,0.0
2021,2,3086,620,13,876,2,2,10,1,2,1,2,0,2,6,False,False,False,0,2,2021-09-24T23:17:05.533,2,True,0.0
2021,2,3086,640,8,3883,2,4,10,4,5,1,5,0,5,0,False,False,False,0,4,2021-09-24T22:03:53.733,5,False,0.0
2021,2,3086,650,8,8354,2,45,5,0,18,18,9,9,9,0,True,False,False,1,2,2021-09-25T00:01:49.73,18,False,9.0
2021,2,3086,690,13,4662,13,39,4,5,0,0,0,0,0,0,False,False,False,0,3,2021-09-20T18:24:10.293,0,False,0.0
2021,2,3086,695,13,876,13,13,9,8,0,0,0,0,0,0,False,False,False,0,3,2022-02-16T23:42:41.337,0,False,0.0
2021,2,3086,700,13,876,13,9,2,37,0,0,0,0,0,0,False,False,False,0,2,2021-09-20T18:35:05.317,0,False,0.0
2021,2,3086,720,8,5053,2,26,10,1,2,1,2,0,2,0,True,False,False,0,3,2021-09-25T00:04:37.123,2,False,0.0
2021,2,3086,740,13,2455,2,48,9,-6,11,17,5,6,5,0,False,False,False,1,1,2021-09-20T20:05:16.857,8,False,6.0
2021,2,3086,745,13,876,2,5,3,11,11,0,11,0,11,0,False,False,False,0,2,2022-02-16T23:39:07.97,11,False,0.0
2021,2,3086,750,13,876,2,13,10,4,8,4,7,1,7,0,False,False,False,0,3,2021-09-20T20:02:03.2,8,False,1.0
2021,2,3086,755,13,2407,13,12,5,5,0,0,0,0,0,0,False,False,False,0,2,2021-09-24T23:17:27.527,0,False,0.0
2021,2,3086,760,13,1028,2,12,2,19,35,16,35,0,35,0,False,False,False,0,3,2022-02-01T19:40:24.857,35,True,0.0
2021,2,3086,785,13,876,13,26,9,8,0,0,0,0,0,0,False,False,False,0,2,2021-09-20T19:16:55.127,0,False,0.0
2021,2,3087,15,5,4799,2,16,10,6,32,26,16,16,16,0,False,False,False,3,1,2021-09-24T23:27:19.933,32,False,16.0
2021,2,3087,25,5,5220,2,5,3,12,20,8,16,4,16,0,False,False,False,0,3,2021-09-20T10:19:12.95,20,False,4.0
2021,2,3087,30,5,6372,2,35,10,13,20,7,20,0,20,6,False,False,False,0,3,2021-09-20T10:21:19.65,20,True,0.0
2021,2,3087,45,20,8126,13,48,9,-4,0,0,0,0,0,0,False,False,False,0,1,2022-02-16T23:12:54.34,0,True,
2021,2,3087,55,20,7353,2,5,5,7,9,2,7,2,7,0,False,False,False,1,2,2021-09-23T18:48:00.71,9,False,2.0
2021,2,3087,75,20,5140,2,50,5,-2,7,9,5,2,5,0,False,False,False,0,2,2021-09-23T18:48:12.433,7,False,2.0
2021,2,3087,95,5,8409,13,47,5,4,0,0,0,0,0,0,False,False,False,0,1,2021-09-24T23:19:54.657,0,False,
2021,2,3087,105,5,5152,2,2,9,7,19,12,15,4,15,0,False,False,False,0,4,2021-09-24T23:31:32.127,19,False,4.0
2021,2,3087,110,5,5220,13,35,7,16,0,0,0,0,0,0,False,False,False,0,3,2021-10-13T17:42:47.833,0,False,0.0
2021,2,3087,115,5,5220,2,4,5,8,8,0,8,0,8,0,False,False,False,0,2,2021-09-21T16:13:31.053,8,False,0.0
2021,2,3087,120,5,5152,13,12,3,5,0,0,0,0,0,0,False,False,False,0,3,2021-09-24T21:51:17.59,0,True,0.0
2021,2,3087,135,20,8131,2,4,9,4,4,0,4,0,4,0,False,False,False,0,2,2021-09-20T10:57:04.29,4,False,0.0
2021,2,3087,140,20,1361,13,2,9,7,0,0,0,0,0,0,False,False,False,0,2,2021-09-20T10:59:59.517,0,False,0.0
2021,2,3087,155,5,8406,2,51,3,-3,5,8,4,1,4,0,False,False,False,0,3,2021-09-23T18:48:36.62,5,False,1.0
2021,2,3087,180,5,5220,2,2,9,4,13,9,4,9,4,0,False,False,False,0,2,2021-09-24T23:27:46.457,13,False,9.0
2021,2,3087,190,5,3477,2,35,7,17,18,1,16,2,16,0,False,False,False,0,3,2021-10-13T17:42:11.01,18,False,2.0
2021,2,3087,210,5,5220,2,39,9,5,8,3,8,0,8,0,False,False,False,0,3,2021-09-24T23:35:44.817,8,False,
2021,2,3087,215,5,5152,2,6,4,13,19,6,17,2,17,0,False,False,False,0,3,2021-09-20T11:26:00.53,19,False,2.0
2021,2,3087,255,20,1361,2,4,9,7,16,9,12,4,12,0,False,False,False,0,3,2021-09-20T11:37:51.687,16,False,4.0
2021,2,3087,265,20,5140,2,4,10,2,3,1,3,0,3,0,False,False,False,0,1,2022-02-16T23:19:37.093,3,False,0.0
2021,2,3087,270,20,5140,2,5,9,4,7,3,5,2,5,0,False,False,False,0,3,2021-09-24T23:20:09.457,7,False,2.0
2021,2,3087,280,5,5220,2,5,5,3,5,2,3,2,3,0,False,False,False,0,3,2021-09-21T16:13:51.87,5,False,2.0
2021,2,3087,290,5,5220,2,26,10,2,16,14,14,2,14,0,False,False,False,0,2,2021-09-24T23:39:55.927,16,False,2.0
2021,2,3087,305,5,6425,2,30,10,-1,7,8,4,3,4,0,True,False,False,0,4,2021-09-21T16:14:34.847,7,False,3.0
2021,2,3087,315,5,6425,3,53,10,-4,0,0,0,0,0,0,False,False,False,0,4,2021-09-20T11:56:40.563,0,False,0.0
2021,2,3087,320,5,5152,2,12,2,15,17,2,17,0,17,0,False,False,False,0,3,2022-02-01T19:41:30.923,17,False,0.0
2021,2,3087,340,5,5220,2,2,10,2,2,0,2,0,2,6,False,False,False,0,2,2021-09-20T12:04:20.313,2,True,0.0
2021,2,3087,360,20,8131,2,5,3,3,4,1,3,1,3,0,False,False,False,0,3,2021-09-20T12:18:18.263,4,False,1.0
2021,2,3087,365,20,7356,2,6,8,18,27,9,25,2,25,0,False,False,False,1,2,2021-09-24T23:28:15.983,27,False,2.0
2021,2,3087,375,20,8131,3,13,9,2,0,0,0,0,0,0,False,False,False,0,3,2022-02-16T23:17:43.547,0,False,0.0
2021,2,3087,380,20,8127,13,5,5,11,0,0,0,0,0,0,False,False,False,0,3,2021-09-24T23:22:33.75,0,False,0.0
2021,2,3087,385,20,7353,13,8,1,31,0,0,0,0,0,0,False,False,False,0,3,2021-09-24T23:28:25.857,0,False,0.0
2021,2,3087,390,5,4799,2,47,5,2,10,8,10,0,10,0,False,False,False,0,1,2021-09-20T14:59:36.44,10,False,0.0
2021,2,3087,400,5,5220,2,2,10,5,6,1,5,1,5,0,False,False,False,0,2,2021-09-20T12:32:06.423,6,False,1.0
2021,2,3087,430,20,8131,13,5,6,16,0,0,0,0,0,0,False,False,False,0,2,2021-09-21T18:27:43.817,0,False,0.0
2021,2,3087,450,5,4799,2,47,10,-1,7,8,5,2,5,0,False,False,False,0,1,2021-09-24T23:28:38.47,7,False,2.0
2021,2,3087,455,5,6372,2,2,10,5,13,8,8,5,8,0,False,False,False,0,2,2021-09-24T23:19:18.187,13,False,5.0
2021,2,3087,465,5,4799,2,5,9,2,8,6,8,0,8,0,False,False,False,0,1,2021-09-20T12:52:11.753,8,True,0.0
2021,2,3087,470,5,3477,13,21,2,26,0,0,0,0,0,0,False,False,False,0,2,2021-09-20T12:53:58.59,0,False,0.0
2021,2,3087,475,5,8406,2,50,10,-2,1,3,1,0,1,0,False,False,False,0,3,2021-09-24T23:18:12.503,1,False,0.0
2021,2,3087,525,5,5220,13,35,3,12,0,0,0,0,0,0,False,False,False,0,2,2021-09-24T23:11:40.64,0,False,0.0
2021,2,3087,565,5,8409,13,4,9,-2,0,0,0,0,0,0,False,False,False,0,1,2021-09-24T23:24:54.77,0,False,0.0
2021,2,3087,580,20,2408,2,47,5,1,3,2,2,1,2,0,False,False,False,0,3,2021-09-20T13:36:36.703,3,False,1.0
2021,2,3087,615,5,3477,2,5,3,3,4,1,3,1,3,0,False,False,False,0,3,2021-09-20T13:46:03.23,4,False,1.0
2021,2,3087,620,5,4799,2,5,5,4,8,4,7,1,7,0,False,False,False,0,1,2021-09-20T13:47:47.89,8,False,1.0
2021,2,3087,625,5,6372,2,35,9,10,11,1,11,0,11,0,False,False,False,0,3,2021-09-20T15:09:55.91,11,False,0.0
2021,2,3087,635,5,5220,13,5,5,11,0,0,0,0,0,0,False,False,False,0,3,2021-09-20T14:54:30.8,0,False,0.0
2021,2,3087,655,20,5140,13,46,3,1,0,0,0,0,0,0,False,False,False,0,1,2021-09-20T13:57:48.657,0,False,0.0
2021,2,3087,665,20,1361,13,13,9,6,0,0,0,0,0,0,False,False,False,0,3,2021-09-24T23:22:22.577,0,False,0.0
2021,2,3087,680,5,4799,2,44,3,-8,-8,0,-8,0,-8,0,True,False,False,0,1,2021-09-24T23:23:15.24,-8,False,
2021,2,3087,685,5,3477,13,9,6,34,0,0,0,0,0,0,False,False,False,0,2,2021-09-20T14:08:22.59,0,False,0.0
2021,2,3087,690,5,4799,13,50,5,-1,0,0,0,0,0,0,True,False,False,0,2,2021-09-24T20:13:53.95,0,False,0.0
2021,2,3087,695,5,8406,2,2,9,4,11,7,8,3,8,0,False,False,False,0,3,2021-09-20T14:11:27.6,11,False,3.0
2021,2,3087,705,5,3477,2,5,5,6,16,10,5,11,5,0,False,False,False,1,3,2021-09-20T14:13:55.627,16,False,11.0
2021,2,3087,725,20,5140,2,4,3,1,8,7,7,1,7,0,False,False,False,0,1,2021-09-20T14:17:54.897,8,False,1.0
2021,2,3087,730,20,5140,3,4,9,1,0,0,0,0,0,0,False,False,False,0,1,2021-09-25T00:01:10.97,0,False,0.0
2021,2,3087,740,20,7356,13,5,6,16,0,0,0,0,0,0,False,False,False,0,3,2022-02-16T23:16:17.407,0,False,0.0
2021,2,3087,760,5,5220,2,4,3,8,9,1,8,1,8,0,False,False,False,0,2,2021-09-23T18:51:40.027,9,False,1.0
2021,2,3087,780,20,8127,2,17,8,19,23,4,20,3,20,0,False,False,False,0,3,2021-09-20T14:33:11.817,23,False,3.0
2021,2,3087,785,20,8127,13,12,1,29,0,0,0,0,0,0,False,False,False,0,3,2022-02-01T19:42:18.57,0,False,0.0
2021,2,3088,15,18,7712,2,19,2,31,64,33,60,4,60,6,False,False,False,0,3,2021-09-24T14:32:03.49,64,False,4.0
2021,2,3088,35,1,2416,2,39,4,4,4,0,4,0,4,0,False,False,False,0,4,2021-09-20T15:52:21.903,4,False,0.0
2021,2,3088,60,1,245,2,52,10,3,8,5,8,0,8,0,False,False,False,0,2,2021-09-24T16:04:09.027,8,False,0.0
2021,2,3088,80,18,7711,2,4,5,7,6,-1,7,-1,7,0,False,False,False,0,2,2021-09-24T14:45:28.22,6,False,-1.0
2021,2,3088,85,18,6361,13,16,10,2,0,0,0,0,0,0,True,False,False,0,3,2021-09-24T13:58:54.817,0,False,0.0
2021,2,3088,105,1,245,2,4,9,12,15,3,15,0,15,0,False,False,False,0,2,2022-01-31T19:56:53.643,15,False,0.0
2021,2,3088,110,1,245,2,2,9,11,16,5,14,2,14,0,False,False,False,0,2,2021-09-20T15:53:14.823,16,False,2.0
2021,2,3088,120,1,6406,2,4,10,4,4,0,4,0,4,0,False,False,False,0,1,2021-09-24T14:46:29.387,4,False,0.0
2021,2,3088,130,1,8439,2,51,9,-5,0,5,0,0,0,0,True,False,False,0,2,2021-09-21T21:30:04.78,0,False,0.0
2021,2,3088,140,1,245,2,12,6,15,15,0,0,15,0,6,False,False,False,0,2,2021-09-20T15:54:00.73,15,False,15.0
2021,2,3088,170,18,4572,2,4,4,3,14,11,13,1,13,0,False,False,False,0,1,2021-09-20T10:11:30.043,14,False,1.0
2021,2,3088,175,18,1381,2,18,3,-1,5,6,1,4,1,0,False,False,False,0,2,2021-09-24T14:22:00.7,5,False,4.0
2021,2,3088,185,18,4572,2,34,4,-3,3,6,2,1,2,0,True,False,False,0,3,2022-02-16T22:46:57.383,3,False,1.0
2021,2,3088,200,18,1381,2,8,9,7,7,0,0,7,0,6,False,False,False,0,3,2021-09-24T14:36:14.623,7,False,7.0
2021,2,3088,225,1,2416,2,45,10,-4,3,7,0,3,0,0,False,False,False,0,4,2021-09-20T15:54:16.357,3,False,3.0
2021,2,3088,265,18,6361,2,53,9,-4,9,13,8,1,8,0,False,False,False,0,4,2021-09-20T10:41:23.517,9,False,1.0
2021,2,3088,290,18,7711,2,12,3,14,14,0,0,14,0,6,False,False,False,0,3,2022-02-01T19:44:25.123,14,False,14.0
2021,2,3088,315,1,2416,2,12,4,5,34,29,29,5,29,0,False,False,False,0,4,2022-01-31T19:57:11.44,34,False,5.0
2021,2,3088,325,1,2416,2,4,9,4,9,5,4,5,4,0,False,False,False,0,4,2021-09-20T15:54:58.81,9,False,5.0
2021,2,3088,340,1,6405,2,4,1,19,19,0,19,0,19,0,False,False,False,0,3,2021-09-24T13:58:54.817,19,False,0.0
2021,2,3088,350,1,8439,2,34,3,-4,4,8,4,0,4,0,True,True,False,0,2,2021-09-24T14:47:30.827,3,False,0.0
2021,2,3088,370,18,1381,2,50,3,-7,-3,4,-3,0,-3,0,True,False,False,0,3,2021-09-20T11:44:02.963,-3,False,0.0
2021,2,3088,400,1,8439,2,12,6,36,77,41,0,77,0,6,False,False,False,0,3,2022-02-16T22:55:00.613,77,False,77.0
2021,2,3088,420,18,7712,2,46,3,3,4,1,4,0,4,0,False,False,False,0,3,2021-09-20T11:54:10.193,4,False,0.0
2021,2,3088,425,18,1381,2,3,2,16,15,-1,15,0,15,0,False,False,False,0,2,2021-09-20T11:56:25.22,15,False,0.0
2021,2,3088,435,18,6361,2,32,5,2,6,4,6,0,6,0,False,False,False,0,4,2021-09-24T14:37:44.703,6,False,0.0
2021,2,3088,455,18,6361,13,33,10,4,0,0,0,0,0,0,False,False,False,0,4,2021-09-20T12:06:19.843,0,False,0.0
2021,2,3088,460,18,7712,2,32,5,3,6,3,6,0,6,0,False,False,False,0,3,2021-09-24T14:38:27.443,6,False,0.0
2021,2,3088,475,1,8439,2,49,5,-1,4,5,4,0,4,0,False,False,False,0,3,2021-09-24T16:04:45.627,4,False,0.0
2021,2,3088,480,1,8439,2,26,3,1,18,17,18,0,18,0,False,False,False,2,2,2021-09-21T21:30:23.303,18,True,0.0
2021,2,3088,505,1,8439,13,4,10,6,0,0,0,0,0,0,False,False,False,0,3,2021-09-20T16:06:38.187,0,False,0.0
2021,2,3088,535,1,8439,2,44,3,-3,6,9,3,3,3,0,True,False,False,2,3,2021-09-20T15:20:46.65,6,False,3.0
2021,2,3088,545,1,6406,2,5,3,4,13,9,11,2,11,0,False,False,False,0,1,2021-09-24T16:05:06.887,13,False,2.0
2021,2,3088,555,1,2416,2,17,8,22,25,3,24,1,24,0,False,False,False,0,4,2021-09-20T15:21:19.013,25,False,1.0
2021,2,3088,560,1,910,2,18,5,-1,9,10,2,7,2,6,False,False,False,1,2,2021-09-24T16:05:23.177,9,False,7.0
2021,2,3088,585,18,1381,13,6,9,10,0,0,0,0,0,0,False,False,False,0,3,2021-09-24T14:39:02.757,0,False,0.0
2021,2,3088,600,18,7711,2,50,3,1,12,11,10,2,10,0,False,False,False,1,2,2021-09-20T12:56:58.213,12,False,2.0
2021,2,3088,615,1,6405,2,35,5,10,11,1,10,1,10,0,False,False,False,0,3,2021-09-20T13:01:02.983,11,False,1.0
2021,2,3088,625,1,910,2,9,2,23,29,6,26,3,26,0,False,False,False,0,2,2021-09-20T15:21:57.523,29,False,3.0
2021,2,3088,635,1,6405,13,8,1,34,0,0,0,0,0,0,False,False,False,0,3,2021-09-24T16:03:15.177,0,False,0.0
2021,2,3088,645,18,7711,3,5,3,7,0,0,0,0,0,0,False,False,False,0,2,2022-02-16T22:56:31.77,0,False,0.0
2021,2,3088,655,18,7711,13,3,5,7,0,0,0,0,0,0,False,False,False,0,2,2021-09-24T13:58:54.817,0,False,0.0
2021,2,3088,670,18,4572,3,44,3,-5,0,0,0,0,0,0,False,False,False,0,1,2021-09-20T13:29:38.497,0,False,0.0
2021,2,3088,680,18,7711,2,2,9,7,13,6,10,3,10,0,False,False,False,0,2,2021-09-20T13:31:54.833,13,False,3.0
2021,2,3088,720,1,8439,2,49,5,-1,6,7,4,2,4,0,True,False,False,0,2,2022-02-16T22:49:16.353,6,False,2.0
2021,2,3088,725,1,2416,2,31,10,-2,2,4,1,1,1,0,False,False,False,0,4,2021-09-24T14:40:38.21,2,False,1.0
2021,2,3088,755,18,7711,2,5,3,8,7,-1,7,0,7,0,False,False,False,0,3,2021-09-24T14:42:05.433,7,False,0.0
2021,2,3088,765,18,7711,13,19,2,33,0,0,0,0,0,0,False,False,False,0,2,2021-09-24T16:31:44.16,0,False,0.0
2021,2,3088,775,1,6405,13,5,3,5,0,0,0,0,0,0,False,False,False,0,3,2022-02-16T22:51:37.33,0,False,
2021,2,3088,780,1,910,2,4,5,6,6,0,6,0,6,0,False,False,False,0,2,2021-09-20T14:23:14.003,6,False,0.0
2021,2,3088,785,1,2416,2,5,5,3,17,14,7,10,7,0,False,False,False,1,4,2021-09-20T15:22:49.013,17,False,10.0
2021,2,3088,790,1,6406,2,28,5,0,2,2,2,0,2,0,False,False,False,0,1,2022-02-16T22:52:13.59,2,False,0.0
2021,2,3088,795,1,6406,2,4,4,2,3,1,3,0,3,0,False,False,False,0,1,2021-09-20T14:29:22.77,3,False,0.0
2021,2,3088,805,1,6405,2,17,1,31,35,4,31,4,31,0,False,False,False,0,3,2021-09-24T13:58:54.817,35,False,4.0
2021,2,3088,820,1,910,3,2,10,2,0,0,0,0,0,0,False,False,False,0,2,2022-01-31T19:57:24.893,0,False,0.0
2021,2,3088,825,1,910,13,8,4,9,0,0,0,0,0,0,False,False,False,0,2,2021-09-20T14:42:02.567,0,False,0.0
2021,2,3088,850,18,7711,2,4,5,13,13,0,13,0,13,0,False,False,False,0,3,2021-09-24T14:43:27.467,13,False,0.0
2021,2,3088,860,18,566,13,46,3,2,0,0,0,0,0,0,False,False,False,0,1,2021-09-24T13:58:54.817,0,False,0.0
2021,2,3088,885,1,6406,2,31,4,0,7,7,5,2,5,0,True,False,False,0,1,2021-09-21T21:28:40.707,7,False,2.0
2021,2,3088,900,18,1381,2,44,3,-3,3,6,3,0,3,0,False,False,False,0,1,2021-09-20T15:01:27.297,3,False,0.0
2021,2,3088,915,18,6900,2,48,9,-2,17,19,9,8,9,0,False,False,False,1,1,2021-09-24T16:06:43.477,17,False,8.0
2021,2,3088,920,18,7712,13,47,5,2,0,0,0,0,0,0,False,False,False,0,3,2021-09-20T15:23:53.317,0,False,0.0
2021,2,3088,925,18,7711,3,9,6,28,0,0,0,0,0,0,False,False,False,0,2,2021-10-15T01:13:47.92,0,False,0.0
2021,2,3088,930,18,1381,2,5,3,9,12,3,12,0,12,0,True,False,False,0,3,2021-09-21T13:39:09.917,12,False,0.0
2021,2,3088,935,18,7712,2,2,4,7,9,2,9,0,9,0,False,False,False,0,3,2021-09-20T15:13:26.35,9,False,0.0
2021,2,3088,940,18,7712,2,2,9,5,8,3,8,0,8,0,False,False,False,0,3,2021-09-24T14:22:54.087,8,False,0.0
2021,2,3089,10,30,793,2,4,7,19,20,1,20,0,20,0,False,False,False,0,2,2021-09-20T09:05:15.24,20,False,0.0
2021,2,3089,20,30,793,2,17,1,20,25,5,23,2,23,0,False,False,False,0,2,2021-09-20T09:09:58.83,25,False,2.0
2021,2,3089,25,30,37,13,19,2,22,0,0,0,0,0,0,True,False,False,0,2,2021-09-20T09:11:36.817,0,False,0.0
2021,2,3089,35,30,63,2,7,2,15,20,5,18,2,18,6,False,False,False,0,3,2021-09-20T09:15:16.13,20,False,2.0
2021,2,3089,50,2,2554,2,47,5,-3,0,3,-1,1,-1,0,False,False,False,1,1,2021-09-20T09:20:03.29,0,False,1.0
2021,2,3089,60,2,811,13,2,4,1,0,0,0,0,0,0,False,False,False,0,2,2021-09-20T09:25:59.693,0,False,0.0
2021,2,3089,70,30,4516,2,6,10,13,16,3,15,1,15,0,False,False,False,0,3,2021-09-20T09:28:59.097,16,False,1.0
2021,2,3089,80,30,4937,2,48,10,-1,16,17,10,6,10,0,False,False,False,0,1,2021-09-20T09:32:16.333,16,False,6.0
2021,2,3089,85,30,63,2,13,10,4,9,5,6,3,6,0,False,False,False,1,4,2021-09-20T09:33:48.817,9,False,3.0
2021,2,3089,95,30,793,13,9,5,13,0,0,0,0,0,0,False,False,False,0,2,2021-09-20T09:36:20,0,False,0.0
2021,2,3089,100,30,4937,2,45,10,-7,5,12,3,2,3,0,False,False,False,2,1,2021-09-20T09:37:56.433,5,False,2.0
2021,2,3089,110,2,5223,2,4,10,9,9,0,9,0,9,0,False,False,False,0,2,2021-09-24T20:15:21.34,9,False,0.0
2021,2,3089,120,2,6247,2,13,10,2,5,3,2,3,2,0,False,False,False,0,3,2021-09-20T09:51:01.693,5,False,3.0
2021,2,3089,125,2,7303,13,38,10,6,0,0,0,0,0,0,False,False,False,0,4,2022-02-17T18:20:13.76,0,False,0.0
2021,2,3089,130,2,1377,2,12,4,6,9,3,9,0,9,0,False,False,False,0,3,2022-02-01T19:46:34.083,9,False,0.0
2021,2,3089,155,30,6414,13,46,3,-1,0,0,0,0,0,0,False,False,False,0,1,2021-09-20T09:57:07.99,0,False,0.0
2021,2,3089,160,30,793,13,4,10,14,0,0,0,0,0,0,False,False,False,0,3,2022-02-17T18:21:08.757,0,False,0.0
2021,2,3089,175,2,8389,2,6,4,4,4,0,4,0,4,0,False,False,False,0,3,2021-09-24T14:42:17.743,4,False,0.0
2021,2,3089,215,30,4516,2,39,4,4,8,4,7,1,7,0,False,False,False,0,3,2021-09-20T10:12:40.547,8,False,1.0
2021,2,3089,225,30,4516,13,35,2,22,0,0,0,0,0,0,False,False,False,0,3,2022-02-17T18:21:44.25,0,False,
2021,2,3089,230,30,63,2,32,5,1,1,0,1,0,1,6,False,False,False,0,4,2021-09-20T10:20:01.773,1,True,0.0
2021,2,3089,245,2,6247,2,4,10,5,5,0,5,0,5,0,False,False,False,0,3,2021-09-20T10:22:56.527,5,False,0.0
2021,2,3089,250,2,811,2,51,3,-7,23,30,20,3,20,0,False,False,False,0,1,2021-09-24T14:28:24.333,23,False,3.0
2021,2,3089,255,2,8389,2,35,3,14,24,10,20,4,20,0,False,False,False,0,3,2021-09-24T14:15:37.7,24,False,4.0
2021,2,3089,260,2,811,2,4,9,4,4,0,4,0,4,0,True,False,False,0,3,2021-09-20T10:33:08.2,4,False,0.0
2021,2,3089,280,30,793,13,8,1,50,0,0,0,0,0,0,False,False,False,0,3,2021-09-20T10:38:28.353,0,False,0.0
2021,2,3089,285,30,63,2,5,9,5,9,4,6,3,6,0,False,False,False,0,4,2021-09-24T14:30:20.413,9,False,3.0
2021,2,3089,295,30,6414,13,45,5,-4,0,0,0,0,0,0,False,False,False,0,1,2021-09-20T10:42:48.687,0,False,0.0
2021,2,3089,300,30,7893,2,39,4,4,5,1,5,0,5,0,False,False,False,0,3,2021-09-20T10:44:11.237,5,False,0.0
2021,2,3089,305,30,4516,13,2,10,7,0,0,0,0,0,0,False,False,False,0,3,2021-09-20T10:45:33.863,0,False,0.0
2021,2,3089,315,2,5223,13,24,2,40,0,0,0,0,0,0,False,False,False,0,3,2021-09-20T10:48:34.12,0,False,0.0
2021,2,3089,325,2,3506,2,4,10,4,8,4,7,1,7,0,False,False,False,0,3,2021-09-20T10:50:50.637,8,False,1.0
2021,2,3089,340,2,8389,2,2,4,5,24,19,18,6,18,0,True,False,False,0,3,2021-09-20T10:53:19.913,24,False,6.0
2021,2,3089,350,2,5223,2,4,10,2,7,5,6,1,6,0,False,False,False,0,2,2021-09-24T13:28:49.873,7,False,1.0
2021,2,3089,355,2,5214,2,12,5,6,6,0,6,0,6,0,False,False,False,0,2,2022-02-01T19:47:36.437,6,False,0.0
2021,2,3089,365,2,2554,2,45,5,-5,1,6,1,0,1,0,False,False,False,0,1,2021-09-20T11:01:00.59,1,False,0.0
2021,2,3089,385,30,4516,2,8,1,17,26,9,23,3,23,0,False,False,False,0,4,2021-09-20T11:06:41.063,26,False,3.0
2021,2,3089,395,30,37,2,5,7,16,17,1,17,0,17,0,True,False,False,0,3,2022-02-17T18:22:21.41,17,False,0.0
2021,2,3089,405,30,4523,2,17,7,18,21,3,19,2,19,0,False,False,False,0,4,2021-09-20T14:18:00.877,21,False,2.0
2021,2,3089,430,30,793,2,26,5,3,3,0,3,0,3,6,False,False,False,0,2,2021-09-20T11:19:57.363,3,True,0.0
2021,2,3089,445,2,8389,2,17,9,10,14,4,13,1,13,0,False,False,False,0,3,2021-09-20T11:22:48.093,14,False,1.0
2021,2,3089,450,2,2554,13,5,4,1,0,0,0,0,0,0,False,False,False,0,1,2021-09-24T14:16:33.193,0,False,
2021,2,3089,455,2,6240,2,5,5,8,8,0,8,0,8,0,False,False,False,0,2,2021-09-20T11:33:27.89,8,False,0.0
2021,2,3089,465,2,5223,13,7,6,18,0,0,0,0,0,0,False,False,False,0,2,2022-02-17T18:40:58.2,0,False,0.0
2021,2,3089,495,2,6247,13,4,10,5,0,0,0,0,0,0,False,False,False,0,3,2021-09-21T19:29:36.673,0,False,0.0
2021,2,3089,500,30,793,13,21,6,15,0,0,0,0,0,0,False,False,False,0,2,2021-09-20T11:46:07.527,0,False,0.0
2021,2,3089,505,30,2290,2,4,9,7,8,1,7,1,7,0,True,False,False,0,3,2021-09-24T15:07:36.267,8,False,1.0
2021,2,3089,515,30,4516,13,13,3,4,0,0,0,0,0,0,True,False,False,0,3,2021-09-20T11:50:51.677,0,False,
2021,2,3089,520,30,793,2,9,3,1,1,0,1,0,1,6,False,False,False,0,2,2021-09-20T11:52:25.673,1,True,0.0
2021,2,3089,535,2,5223,2,26,5,3,3,0,3,0,3,0,False,False,False,0,2,2021-09-20T11:55:18.443,3,False,0.0
2021,2,3089,540,2,6247,2,51,9,-2,8,10,7,1,7,0,False,False,False,0,3,2021-09-24T15:46:59.337,8,False,1.0
2021,2,3089,545,2,5223,2,5,3,13,14,1,14,0,14,0,False,False,False,0,3,2022-02-17T18:25:46.32,14,False,0.0
2021,2,3089,550,2,2835,3,46,3,2,0,0,0,0,0,0,False,False,False,0,4,2021-09-20T12:00:38.173,0,False,0.0
2021,2,3089,555,2,2554,2,46,3,-1,4,5,4,0,4,0,False,False,False,0,1,2021-09-21T19:31:22.027,4,False,0.0
2021,2,3089,560,2,811,2,11,3,3,23,20,7,16,7,0,False,False,False,1,1,2021-09-20T12:06:30.1,23,False,16.0
2021,2,3089,570,2,5223,13,5,5,7,0,0,0,0,0,0,False,False,False,0,2,2021-09-20T12:09:31.2,0,False,0.0
2021,2,3089,575,2,7303,2,4,9,11,12,1,12,0,12,0,False,False,False,0,3,2021-09-20T12:11:40.843,12,False,0.0
2021,2,3089,580,2,6247,2,4,10,4,8,4,7,1,7,0,False,False,False,0,2,2021-09-24T14:59:20.307,8,False,1.0
2021,2,3089,590,2,8389,2,2,9,4,7,3,6,1,6,0,False,False,False,0,2,2021-09-20T12:18:38.123,7,False,1.0
2021,2,3089,595,2,5223,2,2,10,3,3,0,3,0,3,6,False,False,False,0,2,2021-09-20T12:21:03.237,3,True,0.0
2021,2,3089,610,30,4937,2,48,9,-2,2,4,2,0,2,0,False,True,False,0,1,2021-09-20T12:24:21.53,-2,False,0.0
2021,2,3089,615,30,37,13,19,2,27,0,0,0,0,0,0,False,False,False,0,2,2022-02-17T18:43:39.06,0,False,0.0
2021,2,3089,645,2,7303,13,4,10,5,0,0,0,0,0,0,False,False,False,0,3,2021-09-20T12:34:46.007,0,False,0.0
2021,2,3089,650,2,5223,2,13,9,4,22,18,7,15,7,0,True,False,False,1,3,2021-09-21T19:31:44.547,22,False,15.0
2021,2,3089,660,2,5223,2,5,5,5,5,0,5,0,5,0,False,False,False,0,3,2021-09-24T14:20:28.88,5,False,0.0
2021,2,3089,665,2,811,2,28,10,-1,7,8,7,0,7,6,False,False,False,0,1,2021-09-20T12:48:02.193,7,True,0.0
2021,2,3089,680,30,6414,2,5,3,4,9,5,9,0,9,0,False,False,False,0,1,2021-09-20T12:53:50.057,9,True,0.0
2021,2,3089,690,30,7893,3,51,5,-1,0,0,0,0,0,0,False,False,False,0,2,2022-02-17T18:26:35.317,0,False,0.0
2021,2,3089,710,30,63,13,17,2,18,0,0,0,0,0,0,False,False,False,0,4,2021-09-20T13:02:16.407,0,False,0.0
2021,2,3089,720,30,931,2,52,4,4,10,6,9,1,9,0,False,False,False,0,1,2021-09-24T13:28:49.873,10,False,1.0
2021,2,3089,730,2,2554,2,4,10,1,8,7,5,3,5,0,False,False,False,1,1,2022-02-17T18:26:53.727,8,False,3.0
2021,2,3089,735,2,811,2,45,5,-1,1,2,-1,2,-1,0,False,False,False,0,1,2021-09-24T14:32:38.983,1,False,2.0
2021,2,3089,750,30,793,2,6,8,21,26,5,23,3,23,0,False,False,False,0,2,2021-09-20T13:14:25.903,26,False,3.0
2021,2,3089,755,30,4937,2,46,9,3,5,2,5,0,5,0,False,False,False,1,1,2022-02-17T18:27:10.463,5,False,0.0
2021,2,3089,760,30,4516,2,7,5,12,12,0,12,0,12,6,True,False,False,0,3,2021-09-20T13:18:50.21,12,True,0.0
2021,2,3089,775,2,6247,2,50,9,-2,2,4,1,1,1,0,False,False,False,0,3,2021-09-20T13:21:07.507,2,False,1.0
2021,2,3089,780,2,2554,2,44,3,-3,4,7,2,2,2,0,False,False,False,0,1,2022-02-17T18:27:31.043,4,False,2.0
2021,2,3089,785,2,6247,13,4,10,0,0,0,0,0,0,0,True,False,False,0,3,2021-09-21T19:45:12.713,0,False,0.0
2021,2,3089,800,2,7303,2,4,10,4,10,6,10,0,10,0,False,False,False,0,3,2021-09-20T13:31:21.953,10,False,0.0
2021,2,3089,810,2,2554,2,47,5,-1,2,3,1,1,1,0,False,False,False,0,1,2021-09-20T13:36:34.967,2,False,1.0
2021,2,3089,815,2,2554,2,16,10,2,6,4,6,0,6,0,False,False,False,0,1,2021-09-24T14:33:58.223,6,False,0.0
2021,2,3089,820,2,8389,13,6,4,4,0,0,0,0,0,0,False,False,False,0,4,2021-09-20T13:40:45.187,0,False,0.0
2021,2,3089,835,30,931,2,45,5,-4,6,10,0,6,0,0,False,False,False,1,1,2021-09-20T13:45:16.417,6,False,6.0
2021,2,3089,845,2,811,13,47,5,-19,0,0,0,0,0,0,True,False,False,0,1,2021-09-20T13:51:46.473,0,False,0.0
2021,2,3089,875,2,7540,13,30,9,0,0,0,0,0,0,0,False,False,False,0,4,2021-09-24T15:01:58.183,0,False,0.0
2021,2,3089,890,2,3506,13,4,2,17,0,0,0,0,0,0,False,False,False,0,2,2021-09-20T14:05:21.257,0,False,0.0
2021,2,3090,15,27,7408,13,5,3,6,0,0,0,0,0,0,False,False,False,0,2,2021-09-20T09:12:48.017,0,False,0.0
2021,2,3090,40,31,3911,2,39,4,10,10,0,10,0,10,0,False,False,False,0,3,2021-09-20T09:19:55.377,10,False,0.0
2021,2,3090,50,27,650,2,7,6,49,51,2,50,1,50,0,False,False,False,0,3,2021-09-20T09:23:20.423,51,False,1.0
2021,2,3090,65,27,650,13,12,5,14,0,0,0,0,0,0,False,False,False,0,3,2021-09-20T09:28:19.687,0,False,0.0
2021,2,3090,80,31,7913,2,32,5,5,6,1,6,0,6,0,False,False,False,0,3,2021-09-20T09:31:21.25,6,False,0.0
2021,2,3090,95,31,6793,3,24,6,30,0,0,0,0,0,0,True,False,False,0,3,2021-09-24T13:24:15.503,0,False,0.0
2021,2,3090,105,31,7916,2,28,10,-1,14,15,11,3,11,0,False,False,False,0,4,2021-09-20T09:39:00.403,14,False,3.0
2021,2,3090,110,31,6793,2,6,10,13,13,0,13,0,13,0,False,False,False,0,3,2021-09-20T09:40:39.713,13,False,0.0
2021,2,3090,120,31,2865,2,5,10,5,5,0,5,0,5,0,False,False,False,0,4,2021-09-24T19:19:24.63,5,False,0.0
2021,2,3090,125,31,661,2,6,7,17,17,0,17,0,17,0,False,False,False,0,2,2021-09-20T09:45:43.527,17,False,0.0
2021,2,3090,140,31,3911,13,6,8,15,0,0,0,0,0,0,False,False,False,0,3,2021-09-20T09:49:03.58,0,False,0.0
2021,2,3090,145,31,6793,13,9,6,15,0,0,0,0,0,0,False,False,False,0,3,2021-09-20T09:50:31.443,0,False,0.0
2021,2,3090,165,27,7408,2,51,5,-2,4,6,2,2,2,0,False,False,False,1,3,2021-09-21T16:32:40.177,4,False,2.0
2021,2,3090,170,27,7852,2,26,5,3,9,6,6,3,6,0,False,False,False,0,3,2021-09-20T09:56:46.697,9,False,3.0
2021,2,3090,180,27,7408,2,5,5,3,4,1,3,1,3,0,False,False,False,0,2,2021-09-20T09:59:06.543,4,False,1.0
2021,2,3090,195,27,7408,13,4,5,8,0,0,0,0,0,0,False,False,False,0,2,2021-09-20T10:00:39.253,0,False,0.0
2021,2,3090,215,27,7852,2,50,3,-2,5,7,1,4,1,0,False,False,False,0,2,2021-09-20T10:08:43.13,5,False,4.0
2021,2,3090,235,31,661,2,19,7,45,51,6,46,5,46,0,False,False,False,0,2,2021-09-20T10:14:57.207,51,False,5.0
2021,2,3090,240,31,661,2,35,5,13,15,2,14,1,14,0,False,False,False,0,3,2021-09-20T10:16:48.26,15,False,1.0
2021,2,3090,275,27,7408,2,6,4,8,16,8,11,5,11,0,False,False,False,0,3,2021-09-24T19:17:45.983,16,False,5.0
2021,2,3090,285,27,650,2,35,7,28,63,35,31,32,31,6,False,False,False,1,3,2022-02-17T18:17:10.183,63,False,32.0
2021,2,3090,335,31,3504,2,48,9,-3,15,18,14,1,14,0,False,False,False,0,1,2021-09-20T10:44:12.3,15,False,1.0
2021,2,3090,340,31,661,2,6,9,9,19,10,14,5,14,0,False,False,False,0,2,2021-09-20T10:45:40.753,19,False,5.0
2021,2,3090,350,31,7913,13,7,8,23,0,0,0,0,0,0,True,False,False,0,4,2022-02-17T18:09:24.847,0,False,
2021,2,3090,370,31,661,13,35,9,6,0,0,0,0,0,0,False,False,False,0,3,2021-09-24T19:37:58.4,0,True,0.0
2021,2,3090,385,27,7404,2,28,10,0,11,11,11,0,11,0,False,False,False,0,1,2021-09-20T10:58:54.23,11,True,0.0
2021,2,3090,390,27,650,2,5,5,8,8,0,8,0,8,0,False,False,False,0,2,2021-09-20T11:00:18.24,8,True,0.0
2021,2,3090,395,27,7852,2,5,3,3,12,9,12,0,12,0,False,False,False,0,3,2021-09-20T11:01:45.913,12,True,0.0
2021,2,3090,405,27,7408,2,5,3,7,8,1,8,0,8,0,False,False,False,0,2,2021-09-20T11:03:13.28,8,True,0.0
2021,2,3090,415,27,7408,13,9,3,11,0,0,0,0,0,0,False,False,False,0,2,2021-09-20T11:05:40.677,0,False,0.0
2021,2,3090,420,27,650,13,8,10,11,0,0,0,0,0,0,False,False,False,0,3,2022-02-17T18:14:44.263,0,False,
2021,2,3090,470,31,2901,2,39,4,6,6,0,6,0,6,0,False,False,False,0,4,2021-09-20T11:17:42.85,6,False,0.0
2021,2,3090,480,31,6793,2,4,7,15,15,0,15,0,15,0,False,False,False,0,3,2021-09-20T11:20:27.063,15,False,0.0
2021,2,3090,490,31,2901,2,28,10,3,15,12,13,2,13,0,False,False,False,0,4,2021-09-20T13:55:19.417,15,False,2.0
2021,2,3090,495,31,2901,13,6,4,7,0,0,0,0,0,0,False,False,False,0,3,2021-10-15T01:14:45.8,0,False,
2021,2,3090,520,27,650,2,49,3,0,1,1,0,1,0,0,False,False,False,0,2,2022-02-17T18:10:36.1,1,False,1.0
2021,2,3090,530,27,7408,2,4,9,6,14,8,6,8,6,0,False,False,False,1,3,2021-09-24T19:18:15.213,14,False,8.0
2021,2,3090,535,27,650,2,12,5,9,10,1,10,0,10,0,False,False,False,0,3,2021-09-20T11:41:51.153,10,True,0.0
2021,2,3090,545,27,650,2,5,5,11,11,0,11,0,11,0,False,False,False,0,2,2021-09-20T11:46:24.15,11,False,0.0
2021,2,3090,570,31,2901,2,8,1,18,22,4,20,2,20,0,True,False,False,0,4,2021-09-21T16:12:36.183,22,False,2.0
2021,2,3090,575,31,3504,2,5,4,2,12,10,9,3,9,0,False,False,False,0,1,2021-09-20T11:53:10.2,12,False,3.0
2021,2,3090,590,31,6793,13,6,10,11,0,0,0,0,0,0,False,False,False,0,3,2021-09-20T11:57:11.063,0,False,0.0
2021,2,3090,595,31,661,3,5,9,6,0,0,0,0,0,0,False,False,False,0,3,2021-09-20T11:58:31.443,0,False,0.0
2021,2,3090,600,31,3911,2,4,4,11,12,1,12,0,12,0,False,False,False,0,3,2021-09-20T12:00:07.86,12,False,0.0
2021,2,3090,610,31,2865,2,39,4,5,5,0,5,0,5,0,False,False,False,0,3,2021-09-20T12:02:38.657,5,False,0.0
2021,2,3090,615,31,4545,13,28,3,0,0,0,0,0,0,0,False,False,False,0,1,2021-09-20T12:04:25.653,0,False,0.0
2021,2,3090,630,27,5050,2,48,9,-6,2,8,2,0,2,0,False,False,False,0,1,2021-09-20T12:08:59.173,2,False,
2021,2,3090,635,27,7852,2,50,9,-2,1,3,1,0,1,0,False,False,False,0,3,2021-09-20T12:11:19.24,1,False,0.0
2021,2,3090,640,27,650,2,4,10,5,7,2,6,1,6,0,False,False,False,0,3,2021-09-20T12:12:39.823,7,False,1.0
2021,2,3090,645,27,7852,2,19,7,33,68,35,68,0,68,6,False,False,False,0,2,2021-09-20T12:14:45.863,68,True,0.0
2021,2,3090,660,31,6793,2,6,10,13,15,2,14,1,14,0,False,False,False,0,3,2021-09-20T12:17:27.19,15,False,1.0
2021,2,3090,685,27,4850,2,30,9,2,3,1,3,0,3,0,False,False,False,0,4,2021-09-20T12:22:48.57,3,False,0.0
2021,2,3090,690,27,7408,13,9,6,23,0,0,0,0,0,0,False,False,False,0,2,2021-09-20T12:24:28,0,False,0.0
2021,2,3090,715,31,6793,13,2,9,3,0,0,0,0,0,0,False,False,False,0,2,2021-09-20T12:30:13.633,0,False,0.0
2021,2,3090,725,31,6793,13,19,2,46,0,0,0,0,0,0,False,False,False,0,3,2021-09-20T12:33:43.61,0,False,0.0
2021,2,3090,740,31,661,2,4,8,15,16,1,15,1,15,0,False,False,False,0,3,2021-09-20T12:39:16.053,16,False,1.0
2021,2,3090,745,31,7916,13,28,10,-1,0,0,0,0,0,0,False,False,False,0,4,2021-09-20T12:40:52.173,0,False,0.0
2021,2,3090,755,27,650,13,5,5,6,0,0,0,0,0,0,False,False,False,0,2,2021-09-20T12:45:12.52,0,False,0.0
2021,2,3090,760,27,7408,2,13,9,5,7,2,6,1,6,0,False,False,False,0,3,2021-09-24T19:16:47.64,7,False,1.0
2021,2,3090,780,31,661,2,5,10,7,10,3,7,3,7,0,False,False,False,0,3,2021-09-20T12:56:34.617,10,False,3.0
2021,2,3090,785,31,3504,2,48,9,-3,14,17,10,4,10,0,False,False,False,0,1,2021-09-20T12:58:14.223,14,False,4.0
2021,2,3090,790,31,3504,2,4,4,4,4,0,4,0,4,0,False,False,False,0,1,2021-09-20T12:59:57.18,4,False,0.0
2021,2,3090,795,31,4545,2,4,9,3,9,6,7,2,7,0,False,False,False,0,1,2021-09-20T13:01:38.033,9,False,2.0
2021,2,3090,805,31,4545,2,4,4,2,12,10,9,3,9,0,False,False,False,0,1,2021-09-20T13:04:04.15,12,False,3.0
2021,2,3090,825,31,3504,2,6,4,3,4,1,3,1,3,0,False,False,False,0,1,2021-09-20T13:07:29.663,4,False,1.0
2021,2,3090,830,31,4545,2,6,4,4,5,1,4,1,4,0,False,False,False,0,1,2021-09-24T19:22:06.27,5,False,1.0
2021,2,3090,865,27,7404,2,46,3,2,3,1,3,0,3,0,False,False,False,0,1,2021-09-20T13:15:52.1,3,False,0.0
2021,2,3090,875,27,4850,13,12,5,13,0,0,0,0,0,0,False,False,False,0,4,2021-09-20T13:18:22.26,0,False,0.0
2021,2,3090,895,27,650,2,51,3,0,27,27,25,2,25,0,False,False,False,0,2,2021-09-20T13:22:49.867,27,False,2.0
2021,2,3090,910,31,3504,2,4,4,5,6,1,5,1,5,0,False,False,False,0,1,2021-09-20T13:25:26.46,6,False,1.0
2021,2,3090,920,31,3911,13,6,4,7,0,0,0,0,0,0,False,False,False,0,3,2021-09-20T13:28:05.447,0,False,
2021,2,3090,930,31,6793,3,24,2,19,0,0,0,0,0,0,False,False,False,0,3,2021-09-24T14:15:11.57,0,False,0.0
2021,2,3090,935,31,3911,3,51,10,-3,0,0,0,0,0,0,False,False,False,0,3,2022-02-17T18:13:40.113,0,False,0.0
2021,2,3090,940,31,3911,13,5,10,13,0,0,0,0,0,0,False,False,False,0,3,2021-09-24T14:15:28.947,0,False,0.0
2021,2,3090,950,27,650,13,11,6,28,0,0,0,0,0,0,True,False,False,0,2,2021-09-24T14:15:49.42,0,False,0.0
2021,2,3090,955,27,7408,13,9,6,17,0,0,0,0,0,0,False,False,False,0,2,2021-09-20T13:38:49.053,0,False,0.0
2021,2,3091,15,9,7816,2,4,5,5,6,1,5,1,5,0,False,False,False,0,3,2021-09-24T20:13:33.213,6,False,1.0
2021,2,3091,25,9,6446,2,30,3,-2,7,9,-1,8,-1,0,False,False,False,0,4,2022-02-17T16:06:15.147,7,False,8.0
2021,2,3091,40,9,322,13,2,3,4,0,0,0,0,0,0,False,False,False,0,2,2022-02-17T16:23:05.74,0,False,
2021,2,3091,50,9,7183,2,45,5,-5,6,11,0,6,0,0,False,False,False,1,1,2021-09-24T20:15:16.097,6,False,6.0
2021,2,3091,65,9,4447,2,4,4,9,20,11,17,3,17,0,False,False,False,0,4,2021-09-20T09:30:35.967,20,False,3.0
2021,2,3091,75,9,322,13,8,3,11,0,0,0,0,0,0,False,False,False,0,2,2022-01-31T20:07:36.84,0,False,0.0
2021,2,3091,80,9,322,2,5,5,6,7,1,7,0,7,0,False,False,False,0,2,2021-09-20T09:38:09.66,7,False,0.0
2021,2,3091,105,26,309,2,12,2,22,22,0,22,0,22,0,False,False,False,0,3,2022-02-01T19:49:24.94,22,True,0.0
2021,2,3091,110,26,309,13,35,3,13,0,0,0,0,0,0,False,False,False,0,3,2021-09-24T19:28:33.923,0,False,0.0
2021,2,3091,115,9,7816,2,5,6,18,17,-1,17,0,17,0,False,False,False,0,2,2021-09-24T17:53:59.583,17,True,0.0
2021,2,3091,125,9,7816,13,35,2,26,0,0,0,0,0,0,False,False,False,0,3,2021-09-24T19:30:44.163,0,False,0.0
2021,2,3091,130,26,4616,2,51,3,-5,11,16,8,3,8,0,False,False,False,0,1,2021-09-24T17:53:59.583,11,False,3.0
2021,2,3091,135,26,4619,2,30,5,0,7,7,6,1,6,0,False,False,False,0,3,2021-09-20T10:08:57.527,7,False,1.0
2021,2,3091,145,26,4616,2,51,3,-5,0,5,0,0,0,0,True,False,False,0,1,2021-09-24T19:38:42.74,0,False,0.0
2021,2,3091,170,9,7183,2,47,5,0,12,12,11,1,11,0,False,False,False,0,1,2021-09-20T10:24:29.617,12,False,1.0
2021,2,3091,180,9,7816,2,4,3,7,10,3,9,1,9,0,False,False,False,0,2,2021-09-20T10:29:12.95,10,False,1.0
2021,2,3091,185,9,7816,2,13,3,4,13,9,11,2,11,0,False,False,False,0,3,2021-09-24T19:52:47.55,13,False,2.0
2021,2,3091,225,26,8552,2,32,4,0,5,5,3,2,3,0,False,False,False,0,4,2021-09-24T20:18:46.28,5,False,2.0
2021,2,3091,230,26,309,2,30,5,3,14,11,10,4,10,0,False,False,False,1,3,2022-01-31T20:08:00.617,14,False,4.0
2021,2,3091,235,26,958,13,5,6,16,0,0,0,0,0,0,True,False,False,0,3,2021-09-24T19:42:21.183,0,False,
2021,2,3091,245,26,4616,2,45,5,-5,-2,3,-3,1,-3,0,False,False,False,0,1,2021-09-20T11:00:15.913,-2,False,1.0
2021,2,3091,250,26,958,2,46,3,3,12,9,10,2,10,0,False,False,False,0,4,2021-09-24T19:40:35.783,12,False,2.0
2021,2,3091,260,26,7453,2,4,5,4,9,5,6,3,6,0,False,False,False,0,2,2021-09-20T11:09:28.487,9,False,3.0
2021,2,3091,275,26,4619,2,12,2,19,27,8,27,0,27,0,False,False,False,0,2,2022-02-01T19:50:28.33,27,False,0.0
2021,2,3091,280,26,4619,2,18,3,0,12,12,1,11,1,6,False,False,False,1,2,2021-09-24T19:52:59.343,12,False,11.0
2021,2,3091,300,9,322,2,5,5,5,5,0,5,0,5,0,True,False,False,0,3,2021-09-20T11:30:52.813,5,False,0.0
2021,2,3091,315,9,6441,2,44,3,-4,16,20,-2,18,-2,0,True,False,False,2,3,2021-09-24T17:53:59.583,16,False,18.0
2021,2,3091,340,9,4447,2,4,3,10,10,0,10,0,10,0,False,False,False,0,3,2021-09-20T11:49:12.313,10,False,0.0
2021,2,3091,345,9,322,13,4,5,10,0,0,0,0,0,0,False,False,False,0,2,2021-09-20T11:51:42.457,0,False,0.0
2021,2,3091,355,26,4619,2,39,4,8,14,6,11,3,11,0,False,False,False,0,3,2021-09-20T11:55:35.843,14,False,3.0
2021,2,3091,360,26,4619,2,2,5,5,8,3,6,2,6,0,False,False,False,0,2,2021-09-20T11:57:24.127,8,False,2.0
2021,2,3091,370,26,8557,2,28,5,-1,-1,0,-1,0,-1,0,False,False,False,0,1,2021-09-24T20:23:15.977,-1,False,0.0
2021,2,3091,390,26,309,2,30,5,5,14,9,14,0,14,0,False,False,False,0,4,2021-09-24T20:25:23.543,14,False,
2021,2,3091,395,26,958,2,46,3,4,6,2,6,0,6,0,False,False,False,0,4,2022-02-17T16:07:37.77,6,False,0.0
2021,2,3091,400,26,958,2,2,3,4,10,6,8,2,8,0,False,False,False,0,3,2021-09-20T12:19:50.817,10,False,2.0
2021,2,3091,410,26,4616,2,13,3,1,7,6,4,3,4,0,True,False,False,0,3,2021-09-21T17:13:46.27,7,False,3.0
2021,2,3091,425,26,4619,13,19,2,26,0,0,0,0,0,0,False,False,False,0,2,2021-09-20T12:27:11.693,0,False,0.0
2021,2,3091,430,26,309,13,5,5,5,0,0,0,0,0,0,False,False,False,0,3,2021-09-20T12:29:07.157,0,False,0.0
2021,2,3091,450,9,7816,2,12,3,7,34,27,9,25,9,0,False,False,False,2,2,2021-09-21T23:42:04.207,34,False,25.0
2021,2,3091,470,26,4616,2,46,3,1,8,7,6,2,6,0,True,False,False,0,4,2021-09-24T20:25:58.663,8,False,2.0
2021,2,3091,485,26,4619,2,8,6,31,31,0,31,0,31,0,False,False,False,0,3,2021-09-24T20:27:34.533,31,False,
2021,2,3091,500,26,958,13,6,3,13,0,0,0,0,0,0,False,False,False,0,3,2021-09-20T13:09:02.063,0,False,0.0
2021,2,3091,505,26,309,2,19,2,39,42,3,42,0,42,0,False,False,False,0,2,2021-09-20T13:11:24.92,42,True,0.0
2021,2,3091,510,26,6301,2,4,4,2,8,6,5,3,5,0,False,False,False,0,1,2021-09-20T13:13:51.43,8,False,3.0
2021,2,3091,520,26,4616,2,45,5,-2,-2,0,-2,0,-2,0,True,False,False,0,1,2021-09-20T13:18:02.663,-2,False,0.0
2021,2,3091,530,26,958,13,6,4,12,0,0,0,0,0,0,False,False,False,0,3,2022-02-17T16:17:00.58,0,False,0.0
2021,2,3091,550,9,7816,2,4,3,4,4,0,4,0,4,0,False,False,False,0,3,2021-09-24T20:29:35.87,4,False,0.0
2021,2,3091,560,9,7183,2,50,3,-4,13,17,8,5,8,0,False,False,False,0,2,2021-09-24T17:53:59.583,13,False,5.0
2021,2,3091,570,9,7816,2,18,5,-4,-4,0,-4,0,-4,0,False,False,False,0,2,2021-09-20T13:37:46.813,-4,False,0.0
2021,2,3091,595,26,4616,2,4,5,0,5,5,0,5,0,0,False,False,False,2,1,2021-09-20T13:50:36.983,5,False,5.0
2021,2,3091,600,26,4050,2,30,5,2,7,5,5,2,5,0,False,False,False,0,4,2021-09-20T13:52:58.127,7,False,2.0
2021,2,3091,605,26,4616,13,17,2,23,0,0,0,0,0,0,False,False,False,0,1,2021-09-24T17:53:59.583,0,False,
2021,2,3091,615,26,309,3,30,5,-2,0,0,0,0,0,0,False,False,False,0,3,2021-09-20T14:01:46.357,0,False,0.0
2021,2,3091,620,26,8552,2,5,5,8,16,8,16,0,16,0,False,False,False,0,3,2021-09-20T14:04:33.333,16,False,0.0
2021,2,3091,625,26,4619,2,5,3,6,8,2,8,0,8,0,False,False,False,0,2,2021-09-20T14:06:54.23,8,False,0.0
2021,2,3091,630,26,7491,2,43,6,29,36,7,30,6,30,6,False,False,False,1,4,2021-09-20T14:11:31.3,36,False,
2021,2,3091,635,26,4616,2,24,6,17,20,3,19,1,19,0,True,False,False,0,3,2021-09-21T17:12:34.41,20,False,1.0
2021,2,3091,640,26,7453,2,26,5,4,4,0,4,0,4,0,False,False,False,0,2,2021-09-20T14:23:26.963,4,False,0.0
2021,2,3091,645,26,4619,13,29,3,8,0,0,0,0,0,0,False,False,False,0,2,2021-09-24T20:30:17.663,0,False,0.0
2021,2,3091,650,26,309,13,6,3,9,0,0,0,0,0,0,False,False,False,0,3,2022-02-17T16:23:52.66,0,False,0.0
2021,2,3091,680,9,7816,2,51,3,-3,1,4,1,0,1,0,False,False,False,0,3,2022-01-31T20:06:39.733,1,False,0.0
2021,2,3091,685,9,6446,2,5,3,11,11,0,11,0,11,0,False,False,False,0,4,2021-09-20T14:43:00.853,11,False,0.0
2021,2,3091,695,9,4447,13,7,3,10,0,0,0,0,0,0,False,False,False,0,3,2021-09-20T14:47:06.557,0,False,0.0
2021,2,3091,725,26,4050,2,32,5,1,2,1,1,1,1,0,True,False,False,0,4,2021-09-21T17:12:48.033,2,False,1.0
2021,2,3091,730,26,4619,2,4,4,10,15,5,14,1,14,0,False,False,False,0,3,2021-09-20T14:59:32.547,15,False,1.0
2021,2,3091,750,26,309,2,6,6,17,30,13,24,6,24,0,True,False,False,0,4,2021-09-24T20:41:48.51,30,False,6.0
2021,2,3091,755,26,958,2,46,3,1,2,1,1,1,1,6,True,False,False,0,3,2021-09-24T20:42:08.02,2,False,
2021,2,3091,760,26,4619,13,29,5,7,0,0,0,0,0,0,False,False,False,0,3,2021-09-24T17:53:59.583,0,False,0.0
2021,2,3091,770,26,4616,2,16,4,7,14,7,12,2,12,0,False,False,False,0,1,2021-09-20T15:19:31.05,14,False,2.0
2021,2,3091,790,9,4447,2,4,5,3,7,4,3,4,3,0,False,False,False,1,3,2021-09-20T15:25:45.36,7,False,4.0
2021,2,3091,795,9,4202,2,47,5,1,7,6,6,1,6,0,False,False,False,0,4,2021-09-20T15:27:54.55,7,False,1.0
2021,2,3091,820,9,4202,2,31,4,1,5,4,2,3,2,0,False,False,False,0,1,2021-09-20T15:38:27.893,5,False,3.0
2021,2,3091,825,9,322,2,2,3,8,12,4,8,4,8,0,False,False,False,0,2,2021-09-20T15:36:34.77,12,False,4.0
2021,2,3091,835,9,6441,2,46,3,2,4,2,4,0,4,0,True,False,False,0,3,2021-09-24T20:35:20.223,4,False,0.0
2021,2,3092,15,3,6936,13,17,8,38,0,0,0,0,0,0,False,False,False,0,3,2021-09-24T19:27:29.093,0,False,0.0
2021,2,3092,20,3,121,13,4,10,7,0,0,0,0,0,0,False,False,False,0,3,2021-09-24T20:02:51.55,0,False,0.0
2021,2,3092,45,3,6936,2,4,9,7,11,4,11,0,11,0,False,False,False,0,3,2021-09-20T09:38:43.49,11,False,0.0
2021,2,3092,80,16,7176,2,2,9,4,6,2,5,1,5,0,False,False,False,1,2,2021-09-24T20:24:51.357,6,False,1.0
2021,2,3092,85,16,3938,2,5,5,7,7,0,7,0,7,0,False,False,False,0,3,2021-09-20T10:01:19.28,7,True,0.0
2021,2,3092,90,16,7176,2,12,4,8,19,11,19,0,19,0,False,False,False,1,2,2021-09-24T20:25:08.347,19,False,0.0
2021,2,3092,105,16,374,2,51,9,0,10,10,9,1,9,0,True,False,False,0,4,2021-09-20T10:07:19.433,10,False,1.0
2021,2,3092,110,16,4143,2,23,8,33,33,0,33,0,33,6,False,False,False,0,2,2021-09-24T19:39:57.85,33,True,0.0
2021,2,3092,125,3,6936,2,4,3,6,17,11,6,11,6,0,True,False,False,1,3,2021-09-24T20:25:44.123,17,False,11.0
2021,2,3092,155,3,121,13,19,2,24,0,0,0,0,0,0,False,False,False,0,2,2021-09-20T14:41:08.487,0,False,0.0
2021,2,3092,160,3,6936,2,51,10,-6,-4,2,-4,0,-4,0,True,False,False,0,2,2021-09-20T10:29:55.923,-4,False,0.0
2021,2,3092,165,3,6936,13,8,1,27,0,0,0,0,0,0,False,False,False,0,3,2021-09-20T10:32:09.137,0,False,0.0
2021,2,3092,170,16,7176,2,12,2,17,17,0,17,0,17,0,False,False,False,0,3,2022-02-16T23:08:33.64,17,True,0.0
2021,2,3092,175,16,568,2,48,10,-2,4,6,3,1,3,0,False,False,False,0,1,2021-09-20T10:35:48.883,4,False,
2021,2,3092,200,16,7170,2,4,3,7,11,4,7,4,7,0,False,False,False,0,2,2021-09-20T10:48:35.63,11,False,4.0
2021,2,3092,215,3,6454,2,4,10,3,7,4,7,0,7,0,False,False,False,0,4,2021-09-20T10:52:37.043,7,False,0.0
2021,2,3092,235,16,374,2,5,10,5,14,9,12,2,12,0,False,False,False,0,3,2021-09-20T10:59:05.473,14,False,2.0
2021,2,3092,245,16,4143,2,31,10,6,10,4,10,0,10,0,False,False,False,0,3,2021-09-20T11:01:36.67,10,False,0.0
2021,2,3092,250,16,7176,13,4,8,16,0,0,0,0,0,0,False,False,False,0,2,2021-09-20T11:03:36.18,0,False,0.0
2021,2,3092,255,16,7176,13,35,8,21,0,0,0,0,0,0,False,False,False,0,3,2021-09-20T11:05:00.43,0,False,0.0
2021,2,3092,260,16,4143,13,12,5,13,0,0,0,0,0,0,False,False,False,0,3,2021-10-15T01:16:42.32,0,False,0.0
2021,2,3092,280,3,6936,2,4,8,15,20,5,20,0,20,0,False,False,False,0,3,2021-09-20T11:15:16.827,20,False,0.0
2021,2,3092,285,3,6454,2,5,3,10,8,-2,8,0,8,0,False,False,False,0,3,2021-09-20T11:18:22.213,8,False,0.0
2021,2,3092,295,3,6936,13,12,9,1,0,0,0,0,0,0,True,False,False,0,2,2022-02-24T19:14:17.5,0,False,0.0
2021,2,3092,305,3,8274,2,44,3,1,9,8,7,2,7,0,False,False,False,0,1,2021-09-20T11:25:37.82,9,False,2.0
2021,2,3092,310,3,8274,2,5,9,2,7,5,6,1,6,0,False,False,False,0,1,2021-09-20T11:27:13.947,7,False,1.0
2021,2,3092,335,16,3938,2,46,3,-2,4,6,-1,5,-1,0,True,False,False,1,4,2021-09-20T11:35:34.46,4,False,5.0
2021,2,3092,340,16,374,2,5,3,6,14,8,14,0,14,0,False,False,False,0,3,2021-09-20T11:36:45.743,14,False,0.0
2021,2,3092,350,16,2568,2,53,10,-4,20,24,16,4,16,0,False,False,False,0,4,2021-09-20T11:52:10.423,20,False,4.0
2021,2,3092,365,16,797,2,4,3,2,14,12,8,6,8,0,True,False,False,0,2,2021-09-20T11:55:36.687,14,False,6.0
2021,2,3092,385,3,121,2,2,9,7,11,4,9,2,9,0,False,False,False,0,2,2021-09-20T11:59:00.32,11,False,2.0
2021,2,3092,400,3,8274,2,4,10,2,4,2,4,0,4,0,False,False,False,0,1,2021-09-20T12:01:52.293,4,False,
2021,2,3092,415,3,6454,2,4,10,9,12,3,11,1,11,0,False,False,False,0,4,2021-09-20T12:05:14.733,12,False,1.0
2021,2,3092,430,3,121,2,5,3,5,8,3,8,0,8,0,False,False,False,0,2,2021-09-20T12:10:36.99,8,False,0.0
2021,2,3092,465,16,374,2,5,10,3,5,2,5,0,5,0,False,False,False,0,3,2021-09-20T12:27:35.643,5,False,0.0
2021,2,3092,470,16,568,2,46,9,-2,11,13,9,2,9,0,True,False,False,0,1,2021-09-20T12:29:04.233,11,False,2.0
2021,2,3092,480,16,6500,2,4,4,5,40,35,40,0,40,6,False,False,False,1,3,2021-09-20T12:31:35.983,40,True,0.0
2021,2,3092,495,3,6936,2,2,9,7,27,20,24,3,24,0,False,False,False,0,3,2021-09-20T12:36:07.343,27,False,3.0
2021,2,3092,510,3,6454,2,38,9,3,20,17,18,2,18,0,False,False,False,0,4,2021-09-20T12:41:10.247,20,False,2.0
2021,2,3092,515,3,6936,2,17,1,19,42,23,42,0,42,6,False,False,False,0,3,2021-09-20T12:43:50.17,42,True,0.0
2021,2,3092,540,16,7176,2,4,9,5,5,0,5,0,5,0,False,False,False,0,3,2022-02-16T23:09:22.597,5,False,0.0
2021,2,3092,550,16,7176,13,19,6,44,0,0,0,0,0,0,False,False,False,0,2,2021-09-20T12:52:40.927,0,False,0.0
2021,2,3092,555,16,374,2,12,10,3,46,43,4,42,4,6,False,False,False,4,3,2021-09-24T20:27:13.34,46,False,42.0
2021,2,3092,575,3,6454,2,38,10,-2,-2,0,-2,0,-2,0,False,False,False,0,4,2021-09-20T12:59:56.183,-2,False,
2021,2,3092,610,16,3938,2,18,5,-4,3,7,3,0,3,0,False,False,False,0,2,2021-09-22T01:39:54.91,3,False,0.0
2021,2,3092,620,16,374,13,12,9,7,0,0,0,0,0,0,False,False,False,0,3,2021-09-24T20:04:05.54,0,False,0.0
2021,2,3092,635,3,121,2,35,4,12,19,7,17,2,17,0,False,False,False,0,3,2021-09-20T13:18:39.053,19,False,2.0
2021,2,3092,650,3,6816,2,13,9,5,9,4,7,2,7,0,False,False,False,0,4,2021-09-22T02:13:07.54,9,False,2.0
2021,2,3092,680,16,7176,2,4,9,5,8,3,6,2,6,0,False,False,False,0,3,2021-09-20T13:36:57.673,8,False,2.0
2021,2,3092,690,16,4143,2,4,3,3,3,0,3,0,3,0,False,False,False,0,2,2021-09-20T13:39:22.77,3,False,0.0
2021,2,3092,695,16,3938,13,5,2,15,0,0,0,0,0,0,False,False,False,0,3,2021-09-20T13:41:31.793,0,False,0.0
2021,2,3092,715,3,121,3,2,10,7,0,0,0,0,0,0,True,False,False,0,2,2021-09-24T19:47:37.173,0,False,0.0
2021,2,3092,735,3,6454,2,35,9,9,10,1,10,0,10,0,False,False,False,0,4,2021-09-24T20:58:52.687,10,False,0.0
2021,2,3092,755,3,6936,13,17,10,12,0,0,0,0,0,0,False,False,False,0,3,2021-09-24T19:27:29.093,0,False,0.0
2021,2,3092,790,16,6500,2,6,1,16,23,7,23,0,23,0,False,False,False,0,3,2021-09-20T14:14:28.093,23,False,0.0
2021,2,3092,795,16,374,2,13,9,4,13,9,10,3,10,0,False,False,False,0,3,2021-09-20T14:15:53.06,13,False,3.0
2021,2,3092,805,16,374,2,51,9,-1,7,8,4,3,4,0,True,False,False,1,4,2021-09-20T14:18:41.717,7,False,3.0
2021,2,3092,835,3,121,2,2,9,5,6,1,5,1,5,0,False,False,False,0,2,2021-09-24T19:27:29.14,6,False,1.0
2021,2,3093,15,11,4037,2,4,3,5,8,3,7,1,7,0,False,False,False,0,2,2021-09-21T13:45:35.363,8,False,1.0
2021,2,3093,20,11,7733,2,12,6,30,46,16,44,2,44,0,False,False,False,0,2,2021-09-21T13:47:19.527,46,False,2.0
2021,2,3093,25,11,6810,2,30,3,1,9,8,8,1,8,0,False,False,False,0,4,2021-09-21T13:48:57.083,9,False,1.0
2021,2,3093,40,11,7733,2,7,3,5,5,0,5,0,5,6,False,False,False,0,3,2021-09-21T13:54:05.313,5,True,0.0
2021,2,3093,70,12,556,2,4,9,4,18,14,18,0,18,0,False,False,False,1,3,2021-12-13T16:27:56.783,18,True,0.0
2021,2,3093,90,12,4511,2,53,10,-3,19,22,14,5,14,0,False,False,False,0,4,2021-09-21T14:04:46.1,19,False,5.0
2021,2,3093,110,12,4537,2,34,4,-5,4,9,3,1,3,6,True,False,False,0,3,2021-09-21T14:10:34.127,4,False,1.0
2021,2,3093,125,11,8359,2,4,9,5,6,1,6,0,6,0,False,False,False,0,4,2021-09-21T14:12:58.91,6,False,0.0
2021,2,3093,135,11,6810,2,5,5,4,4,0,4,0,4,0,False,False,False,0,3,2021-09-21T14:15:19.353,4,False,0.0
2021,2,3093,160,11,7733,2,13,9,3,5,2,4,1,4,0,False,False,False,0,2,2021-09-24T19:55:44.943,5,False,1.0
2021,2,3093,175,11,7732,2,48,9,-6,11,17,7,4,7,0,False,False,False,1,1,2021-09-21T14:23:41.95,11,False,4.0
2021,2,3093,195,12,6357,13,19,2,31,0,0,0,0,0,0,False,False,False,0,2,2021-09-21T14:29:00.997,0,False,0.0
2021,2,3093,200,12,556,2,5,5,4,5,1,3,2,3,0,False,False,False,1,3,2021-09-21T14:30:21.913,5,False,2.0
2021,2,3093,220,11,6629,2,46,3,0,4,4,3,1,3,0,False,False,False,0,1,2021-09-21T14:34:18.59,4,False,1.0
2021,2,3093,245,11,4037,2,46,3,4,10,6,10,0,10,0,True,False,False,0,3,2021-09-21T14:39:43.873,10,False,0.0
2021,2,3093,255,11,6810,2,9,3,8,8,0,8,0,8,6,False,False,False,0,3,2021-09-21T14:42:26.76,8,True,0.0
2021,2,3093,285,12,556,2,51,10,-2,6,8,3,3,3,0,False,False,False,0,2,2021-09-21T14:47:27.293,6,False,3.0
2021,2,3093,290,12,4537,2,46,9,1,9,8,2,7,2,0,False,False,False,1,1,2021-09-24T19:41:42.87,9,False,7.0
2021,2,3093,305,12,4537,2,51,3,-4,13,17,11,2,11,0,True,False,False,0,1,2021-09-24T19:41:05.697,13,False,2.0
2021,2,3093,315,12,6357,13,2,10,1,0,0,0,0,0,0,False,False,False,0,2,2021-09-21T14:55:35.483,0,False,0.0
2021,2,3093,320,12,4537,2,47,5,0,1,1,1,0,1,6,False,False,False,0,1,2021-09-21T14:56:43.157,1,False,0.0
2021,2,3093,345,11,6810,2,12,4,13,20,7,17,3,17,0,True,False,False,0,4,2021-09-21T15:17:10.417,20,False,3.0
2021,2,3093,355,11,4561,2,44,3,-4,1,5,-2,3,-2,0,True,False,False,0,1,2021-09-21T15:19:49.597,1,False,3.0
2021,2,3093,365,11,8359,3,11,2,18,0,0,0,0,0,0,True,False,False,0,2,2021-09-22T15:49:00.42,0,False,0.0
2021,2,3093,370,11,7733,13,19,6,23,0,0,0,0,0,0,False,False,False,0,2,2021-09-21T15:23:04.983,0,False,0.0
2021,2,3093,410,12,4537,2,46,3,2,10,8,7,3,7,0,False,False,False,0,4,2021-09-21T15:31:04.293,10,False,3.0
2021,2,3093,425,12,556,2,19,2,46,50,4,48,2,48,0,False,False,False,0,2,2021-09-24T20:05:23.193,50,False,2.0
2021,2,3093,440,12,4511,2,17,8,19,22,3,19,3,19,6,False,False,False,0,3,2021-09-21T15:39:33.327,22,False,3.0
2021,2,3093,460,11,4561,2,47,5,2,6,4,3,3,3,0,False,False,False,0,1,2021-09-21T15:43:31.697,6,False,3.0
2021,2,3093,470,11,6810,2,16,10,7,15,8,12,3,12,0,True,False,False,0,3,2021-09-24T20:06:25.167,15,False,3.0
2021,2,3093,475,11,6810,13,25,6,29,0,0,0,0,0,0,True,False,False,0,3,2021-09-22T15:48:06.27,0,False,0.0
2021,2,3093,490,11,8359,2,4,9,7,7,0,7,0,7,0,False,False,False,0,3,2022-02-16T23:52:40.907,7,False,0.0
2021,2,3093,495,11,7733,13,4,3,5,0,0,0,0,0,0,False,False,False,0,2,2021-09-21T15:56:17.83,0,False,0.0
2021,2,3093,500,12,6357,13,19,2,45,0,0,0,0,0,0,False,False,False,0,2,2021-09-24T19:37:06.223,0,False,0.0
2021,2,3093,510,12,496,2,39,4,13,14,1,14,0,14,0,False,False,False,0,3,2021-09-22T17:02:06.977,14,False,0.0
2021,2,3093,520,12,4511,13,7,2,27,0,0,0,0,0,0,False,False,False,0,4,2021-09-21T16:04:47.873,0,False,
2021,2,3093,525,12,556,13,12,8,21,0,0,0,0,0,0,False,False,False,0,3,2022-02-16T23:50:46.557,0,False,0.0
2021,2,3093,530,12,496,2,51,3,2,3,1,3,0,3,0,False,False,False,0,3,2021-09-22T17:02:31.007,3,False,0.0
2021,2,3093,535,12,496,2,5,5,9,9,0,9,0,9,0,False,False,False,0,3,2021-09-21T17:49:50.543,9,False,0.0
2021,2,3093,540,12,556,2,51,3,-1,5,6,5,0,5,0,False,False,False,1,3,2021-09-21T16:12:06.683,5,False,0.0
2021,2,3093,545,12,556,2,2,7,15,22,7,17,5,17,0,False,False,False,0,3,2021-09-21T16:15:31.76,22,False,5.0
2021,2,3093,565,12,4537,2,46,9,0,11,11,10,1,10,6,False,False,False,0,1,2021-09-21T16:20:34.893,11,False,1.0
2021,2,3093,595,12,4511,2,53,10,-2,11,13,9,2,9,0,False,False,False,1,4,2021-09-21T16:50:35.077,11,False,2.0
2021,2,3093,600,12,556,2,51,9,0,0,0,0,0,0,0,False,False,False,0,3,2021-09-21T16:52:04.323,0,False,0.0
2021,2,3093,610,12,556,13,2,9,5,0,0,0,0,0,0,False,False,False,0,2,2021-09-21T16:54:13.907,0,False,
2021,2,3093,630,11,6810,2,53,10,-2,2,4,0,2,0,0,False,False,False,0,4,2021-09-21T16:57:34.783,2,False,2.0
2021,2,3093,635,11,6810,2,26,10,5,5,0,5,0,5,0,False,False,False,0,3,2021-09-21T16:59:00.707,5,False,0.0
2021,2,3093,640,11,6810,2,47,5,2,3,1,3,0,3,0,True,False,False,0,4,2021-09-21T17:00:08.857,3,False,0.0
2021,2,3093,650,11,4561,2,5,5,3,5,2,5,0,5,0,False,False,False,0,1,2021-09-21T17:02:01.4,5,False,0.0
2021,2,3093,655,11,7733,2,13,9,0,7,7,6,1,6,0,False,False,False,0,2,2021-09-21T17:03:17.017,7,False,1.0
2021,2,3093,670,12,556,2,12,2,15,15,0,15,0,15,0,False,False,False,0,3,2022-02-01T19:51:55.12,15,False,0.0
2021,2,3093,680,12,7742,2,12,5,8,8,0,8,0,8,0,False,False,False,0,1,2021-09-21T17:13:03.683,8,False,0.0
2021,2,3093,685,12,6356,2,45,5,-1,0,1,0,0,0,0,False,False,False,0,3,2021-09-21T17:14:12.127,0,False,0.0
2021,2,3093,710,11,7733,13,3,5,12,0,0,0,0,0,0,False,False,False,0,2,2021-09-24T19:40:10.417,0,False,0.0
2021,2,3093,720,11,6831,13,12,5,12,0,0,0,0,0,0,False,False,False,0,2,2021-09-21T17:21:55.637,0,False,0.0
2021,2,3093,745,12,6357,13,19,2,32,0,0,0,0,0,0,False,False,False,0,2,2021-09-21T17:25:52.857,0,False,0.0
2021,2,3093,755,11,7732,2,44,3,-3,7,10,7,0,7,0,False,False,False,1,1,2021-09-21T17:31:52.353,7,True,0.0
2021,2,3093,760,11,8359,2,4,10,4,5,1,5,0,5,0,False,False,False,0,3,2021-09-21T17:33:04.77,5,False,0.0
2021,2,3093,765,11,6831,2,13,10,2,24,22,17,7,17,0,False,False,False,0,3,2021-09-21T17:34:09.197,24,False,7.0
2021,2,3093,770,11,7732,2,28,5,-5,16,21,6,10,6,0,False,False,False,2,1,2021-09-21T17:35:14.83,16,False,10.0
2021,2,3093,775,11,8359,13,5,3,10,0,0,0,0,0,0,False,False,False,0,3,2021-09-24T19:40:24.097,0,False,0.0
2021,2,3093,780,11,7732,2,45,5,-5,7,12,7,0,7,0,False,False,False,0,1,2021-09-24T19:40:40.8,7,False,0.0
2021,2,3093,790,11,7732,13,6,4,6,0,0,0,0,0,0,True,False,False,0,3,2021-09-21T17:39:02.19,0,False,0.0
2021,2,3093,800,11,6831,13,12,6,32,0,0,0,0,0,0,False,False,False,0,2,2022-02-01T19:52:15.553,0,False,0.0
2021,3,3094,10,5,5220,2,4,3,7,7,0,7,0,7,0,False,False,False,0,2,2021-09-24T12:24:22.053,7,False,0.0
2021,3,3094,15,5,5152,13,17,1,16,0,0,0,0,0,0,True,False,False,0,3,2021-09-24T12:26:24.43,0,False,0.0
2021,3,3094,20,5,5220,13,4,3,5,0,0,0,0,0,0,False,False,False,0,2,2021-09-24T12:27:58.947,0,False,0.0
2021,3,3094,35,13,902,2,48,3,-1,-1,0,-1,0,-1,0,False,False,False,0,1,2021-09-24T12:32:13.353,-1,False,0.0
2021,3,3094,40,13,876,13,50,3,-3,0,0,0,0,0,0,True,False,False,0,3,2022-02-17T21:31:49.737,0,False,0.0
2021,3,3094,65,5,4799,2,48,3,-5,1,6,-1,2,-1,0,False,False,False,0,1,2021-09-24T12:38:32.447,1,False,2.0
2021,3,3094,70,5,5220,3,12,3,4,0,0,0,0,0,0,False,False,False,0,3,2021-09-24T12:40:03.2,0,False,0.0
2021,3,3094,75,5,5220,2,12,8,23,29,6,27,2,27,0,False,False,False,0,2,2021-09-24T18:34:14.7,29,False,2.0
2021,3,3094,80,5,8406,2,35,9,11,12,1,12,0,12,0,False,False,False,0,3,2021-09-24T12:43:13.607,12,False,0.0
2021,3,3094,90,5,5220,2,6,4,13,26,13,21,5,21,0,False,False,False,1,3,2021-09-24T12:45:46.79,26,False,5.0
2021,3,3094,125,13,876,2,4,5,9,11,2,11,0,11,0,False,False,False,0,2,2021-09-24T12:56:06.28,11,False,0.0
2021,3,3094,130,13,6328,2,4,9,4,4,0,4,0,4,0,False,False,False,0,3,2021-09-24T12:57:08.137,4,False,0.0
2021,3,3094,145,5,5220,2,50,9,-2,1,3,-1,2,-1,0,False,False,False,0,3,2021-09-24T13:05:25.27,1,False,2.0
2021,3,3094,150,5,5220,2,3,3,13,13,0,13,0,13,0,False,False,False,0,2,2021-09-24T13:07:28.407,13,False,0.0
2021,3,3094,160,5,3477,2,2,4,4,4,0,4,0,4,0,False,False,False,0,3,2021-09-24T13:12:03.443,4,False,
2021,3,3094,185,5,4799,2,46,3,0,8,8,1,7,1,0,False,False,False,1,1,2021-09-24T13:23:00.083,8,False,7.0
2021,3,3094,200,5,5220,13,35,3,10,0,0,0,0,0,0,False,False,False,0,3,2021-09-24T13:28:38.003,0,False,0.0
2021,3,3094,205,5,5220,2,4,7,18,24,6,24,0,24,0,False,False,False,0,2,2021-09-24T13:30:12.317,24,False,0.0
2021,3,3094,215,5,8409,3,45,5,-4,0,0,0,0,0,0,False,False,False,0,1,2021-09-24T13:46:05.927,0,False,0.0
2021,3,3094,225,5,5152,2,4,4,10,12,2,12,0,12,0,False,False,False,0,3,2021-09-24T13:48:06.96,12,False,0.0
2021,3,3094,235,13,2407,3,2,10,11,0,0,0,0,0,0,True,False,False,0,2,2022-02-17T21:33:42.483,0,False,
2021,3,3094,265,13,6328,13,35,2,28,0,0,0,0,0,0,False,False,False,0,3,2021-09-24T14:02:49.403,0,False,
2021,3,3094,300,5,5152,13,4,4,8,0,0,0,0,0,0,True,False,False,0,3,2021-09-24T14:13:19.78,0,False,0.0
2021,3,3094,305,5,8409,2,48,10,-2,7,9,5,2,5,0,True,False,False,0,1,2021-10-01T16:15:42.037,7,False,2.0
2021,3,3094,325,13,1510,2,28,5,1,5,4,5,0,5,0,False,False,False,0,1,2021-09-24T14:28:50.577,5,False,0.0
2021,3,3094,335,5,3477,3,4,3,3,0,0,0,0,0,0,False,False,False,0,2,2021-10-15T01:18:04.39,0,False,0.0
2021,3,3094,340,5,6282,2,4,10,4,8,4,7,1,7,0,False,False,False,0,1,2021-09-24T14:32:39.643,8,False,1.0
2021,3,3094,365,13,876,2,4,5,8,8,0,8,0,8,0,False,False,False,0,2,2021-09-24T14:38:16.843,8,False,0.0
2021,3,3094,370,13,876,2,7,2,26,30,4,30,0,30,0,False,False,False,0,2,2021-09-24T14:41:01.097,30,True,0.0
2021,3,3094,380,13,6528,2,4,5,8,10,2,10,0,10,0,False,False,False,0,4,2021-12-21T23:49:05.003,10,False,0.0
2021,3,3094,390,13,876,2,2,9,5,11,6,11,0,11,0,False,False,False,0,2,2021-09-24T14:46:30.007,11,False,0.0
2021,3,3094,400,13,6328,2,2,10,1,1,0,1,0,1,6,False,False,False,0,2,2021-09-24T14:51:00.64,1,True,0.0
2021,3,3094,415,5,8409,2,4,4,6,10,4,10,0,10,0,False,False,False,0,1,2021-09-24T14:53:33.13,10,False,0.0
2021,3,3094,445,13,6328,2,4,9,6,10,4,8,2,8,0,False,False,False,0,3,2021-09-24T16:16:06.64,10,False,2.0
2021,3,3094,455,13,6528,2,46,3,0,5,5,1,4,1,0,False,False,False,1,4,2021-09-24T18:31:55.94,5,False,4.0
2021,3,3094,460,13,6328,2,5,5,5,5,0,5,0,5,0,False,False,False,0,3,2021-09-24T16:19:20.793,5,False,0.0
2021,3,3094,465,13,2407,13,17,7,15,0,0,0,0,0,0,False,False,False,0,3,2021-09-24T16:22:08.553,0,False,0.0
2021,3,3094,475,13,876,13,3,3,14,0,0,0,0,0,0,False,False,False,0,2,2021-09-24T16:36:43.693,0,False,
2021,3,3094,485,13,6328,13,6,6,16,0,0,0,0,0,0,False,False,False,0,3,2022-02-17T21:47:59.953,0,False,
2021,3,3094,490,13,876,13,24,6,35,0,0,0,0,0,0,False,False,False,0,3,2022-02-17T21:48:39.053,0,False,0.0
2021,3,3094,495,13,6328,13,12,2,18,0,0,0,0,0,0,False,False,False,0,3,2021-09-24T16:38:31.557,0,False,0.0
2021,3,3094,515,5,5220,2,2,9,6,10,4,7,3,7,0,False,False,False,0,2,2021-10-01T16:15:58.057,10,False,3.0
2021,3,3094,530,5,8406,13,50,9,-3,0,0,0,0,0,0,False,False,False,0,3,2022-02-17T21:53:43.8,0,False,0.0
2021,3,3094,535,5,5220,2,6,10,13,16,3,16,0,16,0,False,False,False,0,2,2021-09-24T16:50:02.79,16,False,0.0
2021,3,3094,545,5,4341,2,35,5,12,25,13,25,0,25,0,False,False,False,0,3,2021-09-24T16:59:41.85,25,False,0.0
2021,3,3094,595,5,8409,2,4,10,4,10,6,5,5,5,0,True,False,False,1,3,2021-10-01T16:14:40.557,10,False,5.0
2021,3,3094,600,5,8406,2,4,9,8,8,0,8,0,8,0,False,False,False,0,3,2021-09-24T17:17:08.12,8,False,0.0
2021,3,3094,610,5,5152,13,5,5,6,0,0,0,0,0,0,True,False,False,0,3,2021-09-24T17:21:14.837,0,False,
2021,3,3094,625,5,8408,2,11,2,25,30,5,28,2,28,0,False,False,False,0,4,2021-09-24T17:25:41.38,30,False,2.0
2021,3,3094,640,5,8406,2,46,3,2,5,3,4,1,4,0,False,False,False,0,3,2021-09-24T17:50:45.06,5,False,1.0
2021,3,3094,660,13,876,2,4,5,12,13,1,13,0,13,0,True,False,False,0,2,2021-12-22T00:57:09.79,13,False,0.0
2021,3,3094,665,13,876,2,6,8,15,15,0,15,0,15,0,False,False,False,0,3,2021-09-25T17:16:38.273,15,True,0.0
2021,3,3094,670,13,6328,13,12,3,-5,0,0,0,0,0,0,False,False,False,0,2,2021-09-24T17:40:35.533,0,False,0.0
2021,3,3094,675,13,876,2,2,10,5,11,6,11,0,11,0,False,False,False,0,2,2021-09-24T17:42:43.737,11,False,0.0
2021,3,3094,680,13,6528,13,4,9,5,0,0,0,0,0,0,False,False,False,0,4,2022-02-17T21:50:10.563,0,False,0.0
2021,3,3094,685,13,876,2,12,5,5,5,0,5,0,5,0,True,False,False,0,2,2021-09-24T17:45:59.987,5,False,0.0
2021,3,3094,710,5,3477,2,4,9,3,8,5,5,3,5,0,False,False,False,0,3,2021-09-24T17:52:34.477,8,False,3.0
2021,3,3094,725,5,5220,13,8,6,35,0,0,0,0,0,0,False,False,False,0,2,2021-09-24T17:56:03.673,0,False,0.0
2021,3,3094,730,5,5152,2,32,5,6,11,5,10,1,10,0,False,False,False,0,3,2021-10-01T16:13:00.027,11,False,1.0
2021,3,3094,735,5,8406,2,6,5,14,23,9,18,5,18,0,True,False,False,1,3,2021-09-24T17:59:26.933,23,False,5.0
2021,3,3094,755,5,8409,3,46,3,1,0,0,0,0,0,0,True,False,False,0,1,2021-09-24T18:05:58.757,0,False,0.0
2021,3,3094,785,13,6528,2,5,5,5,12,7,8,4,8,0,False,False,False,0,4,2021-09-24T18:12:04.86,12,False,4.0
2021,3,3094,800,13,6528,2,5,3,5,5,0,5,0,5,0,False,False,False,0,4,2021-09-24T18:31:25.463,5,False,0.0
2021,3,3094,810,13,876,2,4,3,8,8,0,8,0,8,0,False,False,False,0,2,2021-09-24T18:28:03.203,8,False,0.0
2021,3,3095,10,31,6793,13,50,3,0,0,0,0,0,0,0,False,False,False,0,2,2021-09-27T09:19:18.697,0,False,0.0
2021,3,3095,30,14,1119,3,46,3,2,0,0,0,0,0,0,True,False,False,0,4,2022-02-18T15:53:57.977,0,False,0.0
2021,3,3095,40,14,6938,13,13,10,3,0,0,0,0,0,0,False,False,False,0,3,2021-09-27T09:34:51.437,0,False,0.0
2021,3,3095,65,31,3504,2,44,3,-3,6,9,4,2,4,0,True,False,False,0,1,2021-09-27T09:47:19.8,6,False,2.0
2021,3,3095,75,31,6793,13,9,2,30,0,0,0,0,0,0,False,False,False,0,3,2021-09-28T17:49:32.91,0,False,0.0
2021,3,3095,80,31,661,2,2,3,4,15,11,14,1,14,0,False,False,False,0,2,2021-09-28T17:49:44.623,15,False,1.0
2021,3,3095,100,31,3911,2,2,9,6,6,0,6,0,6,6,False,False,False,0,3,2021-09-27T10:04:48.34,6,True,0.0
2021,3,3095,125,14,1119,2,6,10,9,10,1,10,0,10,0,False,False,False,0,4,2021-09-27T10:13:01.22,10,False,0.0
2021,3,3095,130,14,7584,13,6,4,14,0,0,0,0,0,0,False,False,False,0,2,2021-10-01T15:40:17.353,0,False,0.0
2021,3,3095,145,31,7913,2,4,10,5,9,4,7,2,7,0,False,False,False,0,3,2021-09-27T10:19:54.437,9,False,2.0
2021,3,3095,155,31,2865,3,4,10,5,0,0,0,0,0,0,False,False,False,0,4,2021-10-01T15:45:05.087,0,False,0.0
2021,3,3095,160,31,2865,2,47,5,1,3,2,2,1,2,0,True,False,False,0,1,2021-09-27T10:25:19.907,3,False,1.0
2021,3,3095,165,31,3911,13,35,10,10,0,0,0,0,0,0,True,False,False,0,3,2021-09-28T17:51:09.803,0,False,
2021,3,3095,180,31,7916,13,31,4,2,0,0,0,0,0,0,False,False,False,0,4,2021-10-01T14:48:17.513,0,False,0.0
2021,3,3095,200,14,7582,2,48,10,-5,8,13,6,2,6,0,False,False,False,0,1,2022-02-18T15:55:25.023,8,False,2.0
2021,3,3095,205,14,7584,2,2,10,5,8,3,6,2,6,0,False,False,False,0,2,2021-09-27T10:42:00.69,8,False,2.0
2021,3,3095,215,14,6543,2,34,4,-5,7,12,5,2,5,0,True,False,False,1,2,2021-09-28T16:13:43.27,7,False,2.0
2021,3,3095,225,14,7584,2,50,10,-4,12,16,10,2,10,0,False,False,False,0,3,2021-09-27T10:51:05.367,12,False,2.0
2021,3,3095,255,31,661,2,7,6,19,25,6,25,0,25,0,False,False,False,0,3,2021-10-01T12:51:09.783,25,False,0.0
2021,3,3095,275,31,661,2,4,10,3,7,4,3,4,3,0,False,False,False,2,3,2021-10-01T14:47:52.483,7,False,4.0
2021,3,3095,285,31,7913,2,2,9,6,18,12,16,2,16,6,False,False,False,0,2,2021-09-28T17:50:32.357,18,False,2.0
2021,3,3095,305,14,6938,2,13,5,2,4,2,3,1,3,0,False,False,False,0,3,2021-09-27T11:24:25.37,4,False,1.0
2021,3,3095,320,31,2865,2,47,10,2,26,24,25,1,25,0,True,False,False,0,1,2021-09-28T17:50:54.093,26,False,1.0
2021,3,3095,330,31,3504,2,48,3,-3,14,17,10,4,10,0,False,False,False,1,1,2021-09-27T11:33:39.163,14,False,4.0
2021,3,3095,350,31,661,13,7,6,23,0,0,0,0,0,0,False,False,False,0,3,2021-09-27T11:40:24.737,0,False,0.0
2021,3,3095,365,31,3911,3,4,10,5,0,0,0,0,0,0,False,False,False,0,3,2021-10-01T14:48:32.717,0,False,0.0
2021,3,3095,385,14,7584,2,6,7,18,18,0,18,0,18,0,False,False,False,0,3,2021-10-01T15:51:09.173,18,False,0.0
2021,3,3095,420,14,4449,2,5,5,4,4,0,4,0,4,0,False,False,False,0,3,2021-09-27T12:02:32.22,4,False,0.0
2021,3,3095,425,14,6938,13,4,10,8,0,0,0,0,0,0,False,False,False,0,2,2021-09-27T12:24:47.607,0,False,
2021,3,3095,450,14,7584,2,26,3,3,3,0,3,0,3,0,False,False,False,0,3,2021-10-01T15:53:54.747,3,False,0.0
2021,3,3095,460,14,7584,13,44,3,-2,0,0,0,0,0,0,True,False,False,0,2,2021-09-27T12:21:33.873,0,False,0.0
2021,3,3095,465,14,5197,2,53,9,-3,11,14,5,6,5,0,True,False,False,1,4,2022-02-18T15:56:30.307,11,False,6.0
2021,3,3095,470,14,6543,2,45,5,0,4,4,2,2,2,0,True,False,False,0,3,2021-10-01T15:55:07.49,4,False,2.0
2021,3,3095,480,14,6938,2,2,9,4,5,1,5,0,5,0,False,False,False,0,2,2021-09-27T12:32:30.903,5,False,0.0
2021,3,3095,490,14,7584,13,8,9,9,0,0,0,0,0,0,False,False,False,0,3,2021-09-27T12:36:55.717,0,False,0.0
2021,3,3095,495,14,4449,13,5,5,9,0,0,0,0,0,0,False,False,False,0,3,2021-09-27T12:38:59.443,0,False,0.0
2021,3,3095,500,14,4449,3,16,4,7,0,0,0,0,0,0,False,False,False,0,3,2021-09-27T12:42:57.327,0,False,0.0
2021,3,3095,525,31,4545,13,28,4,1,0,0,0,0,0,0,False,False,False,0,1,2021-09-27T12:51:08.337,0,False,0.0
2021,3,3095,545,31,6390,2,4,3,13,13,0,13,0,13,0,False,False,False,0,2,2021-09-27T12:58:25.597,13,False,0.0
2021,3,3095,550,31,7913,2,2,10,9,13,4,10,3,10,0,False,True,True,0,2,2021-10-01T14:42:21.047,13,False,3.0
2021,3,3095,565,14,6938,13,3,3,11,0,0,0,0,0,0,False,False,False,0,2,2021-09-27T14:51:06.237,0,False,0.0
2021,3,3095,570,14,7584,13,4,10,4,0,0,0,0,0,0,False,False,False,0,3,2021-09-27T13:12:31.79,0,False,0.0
2021,3,3095,600,31,7913,13,19,6,35,0,0,0,0,0,0,False,False,False,0,3,2021-09-27T13:22:22.77,0,False,
2021,3,3095,610,31,2865,2,47,10,-2,-2,0,-2,0,-2,0,False,False,False,0,4,2021-09-27T13:26:28.673,-2,False,0.0
2021,3,3095,615,31,4545,2,47,5,4,10,6,10,0,10,6,False,False,False,0,1,2021-09-27T13:28:21.913,10,True,0.0
2021,3,3095,630,14,4449,2,12,6,26,27,1,27,0,27,0,False,False,False,0,3,2022-02-01T19:55:06.58,27,False,0.0
2021,3,3095,635,14,7584,13,24,6,22,0,0,0,0,0,0,False,False,False,0,3,2021-09-27T13:34:41.63,0,False,0.0
2021,3,3095,640,14,6938,13,4,5,4,0,0,0,0,0,0,False,False,False,0,2,2021-09-27T13:37:21.483,0,False,
2021,3,3095,645,14,6543,2,46,3,0,36,36,36,0,36,0,False,False,False,2,1,2021-10-01T14:44:18.063,36,False,0.0
2021,3,3095,650,14,4449,13,35,9,7,0,0,0,0,0,0,False,False,False,0,3,2021-10-01T15:56:49.09,0,False,0.0
2021,3,3095,660,14,4449,13,7,5,5,0,0,0,0,0,0,False,False,False,0,3,2021-09-27T13:47:41.387,0,False,0.0
2021,3,3095,690,31,3504,2,4,3,2,11,9,5,6,5,0,False,False,False,1,2,2021-10-01T14:53:20.8,11,False,6.0
2021,3,3095,695,31,7913,2,5,5,11,13,2,11,2,11,0,True,False,False,0,2,2021-09-27T14:00:10.02,13,False,2.0
2021,3,3095,710,31,2901,2,39,4,5,7,2,5,2,5,0,False,False,False,0,3,2021-09-27T14:06:47.8,7,False,2.0
2021,3,3095,745,31,7916,2,53,10,-4,3,7,2,1,2,0,False,False,False,0,4,2021-09-27T14:16:16.31,3,False,1.0
2021,3,3095,765,14,7584,2,7,2,18,18,0,18,0,18,0,False,False,False,0,2,2021-09-27T14:20:05.277,18,False,0.0
2021,3,3095,770,14,4449,13,4,4,10,0,0,0,0,0,0,False,False,False,0,3,2021-10-01T14:43:07.927,0,False,0.0
2021,3,3095,780,14,5197,2,32,5,-3,3,6,2,1,2,0,False,False,False,0,3,2021-09-27T14:26:03.577,3,False,1.0
2021,3,3095,785,14,6543,2,28,10,3,4,1,4,0,4,0,False,False,False,0,1,2021-09-27T14:28:06.35,4,False,0.0
2021,3,3095,795,14,7584,2,2,10,5,9,4,5,4,5,0,False,False,False,0,2,2021-10-01T13:25:16.66,9,False,4.0
2021,3,3095,800,14,6543,2,32,9,0,3,3,3,0,3,0,False,False,False,0,1,2021-10-01T13:25:16.66,3,False,0.0
2021,3,3095,805,14,6543,13,32,5,1,0,0,0,0,0,0,False,False,False,0,1,2021-09-27T14:33:52.41,0,False,0.0
2021,3,3095,815,14,7584,13,19,2,33,0,0,0,0,0,0,False,False,False,0,2,2021-10-01T16:09:53.143,0,False,0.0
2021,3,3096,15,2,2554,2,28,5,-4,3,7,2,1,2,0,False,False,False,0,1,2021-09-28T18:41:31.68,3,False,1.0
2021,3,3096,20,2,7303,13,26,10,2,0,0,0,0,0,0,False,False,False,0,3,2021-09-27T08:24:08.277,0,False,
2021,3,3096,30,2,811,2,32,10,-5,8,13,5,3,5,0,False,False,False,1,1,2021-09-27T08:31:19.067,8,False,3.0
2021,3,3096,45,21,6228,2,32,9,0,14,14,14,0,14,0,False,False,False,0,1,2021-09-27T08:45:14.76,14,False,0.0
2021,3,3096,60,21,7090,2,4,10,6,8,2,8,0,8,0,False,False,False,0,2,2022-03-08T18:51:32.34,8,False,0.0
2021,3,3096,65,21,5015,2,19,2,34,38,4,35,3,35,0,False,False,False,0,2,2021-09-27T09:09:36.69,38,False,3.0
2021,3,3096,85,21,4422,13,30,9,-4,0,0,0,0,0,0,True,False,False,0,4,2022-02-14T18:27:58.647,0,False,0.0
2021,3,3096,110,2,5223,2,6,4,12,19,7,13,6,13,0,False,False,False,0,3,2021-10-01T17:02:10.613,19,False,6.0
2021,3,3096,125,2,5223,13,4,3,11,0,0,0,0,0,0,False,False,False,0,2,2021-09-27T09:39:05.69,0,False,0.0
2021,3,3096,135,21,4492,2,4,10,11,19,8,10,9,10,0,False,False,False,2,2,2021-10-01T19:53:42.133,19,False,9.0
2021,3,3096,145,21,4422,2,4,4,7,8,1,7,1,7,0,False,False,False,0,3,2021-09-27T10:51:14.237,8,False,1.0
2021,3,3096,150,21,3680,13,5,5,5,0,0,0,0,0,0,True,False,False,0,3,2021-09-29T03:36:30.19,0,False,0.0
2021,3,3096,160,2,7303,13,39,4,6,0,0,0,0,0,0,False,False,False,0,3,2022-02-01T19:59:47.96,0,False,0.0
2021,3,3096,165,2,1377,2,12,10,-1,3,4,2,1,2,0,True,False,False,0,4,2022-03-08T18:52:26.65,3,False,1.0
2021,3,3096,170,2,5223,2,26,9,2,4,2,4,0,4,0,False,False,False,0,3,2022-03-08T18:52:46.707,4,False,0.0
2021,3,3096,180,21,4422,13,12,5,13,0,0,0,0,0,0,False,False,False,0,4,2021-09-27T10:07:36.35,0,False,0.0
2021,3,3096,210,21,4492,2,2,10,10,18,8,14,4,14,0,False,False,False,0,2,2021-09-27T10:21:28.18,18,False,4.0
2021,3,3096,215,21,3680,2,4,9,14,12,-2,11,1,11,0,False,False,False,0,3,2021-09-27T10:24:23.613,12,False,1.0
2021,3,3096,225,21,4492,13,4,10,11,0,0,0,0,0,0,False,False,False,0,2,2021-09-27T10:28:57.337,0,False,0.0
2021,3,3096,230,21,8518,2,6,4,5,9,4,7,2,7,0,False,False,False,1,2,2021-10-01T20:07:26.37,9,False,2.0
2021,3,3096,235,21,8518,2,54,3,-6,7,13,-2,9,-2,0,True,False,False,1,3,2021-09-29T03:36:47.137,7,False,9.0
2021,3,3096,250,21,3680,2,51,5,-2,4,6,3,1,3,0,False,False,False,0,3,2021-09-27T10:45:21.933,4,False,1.0
2021,3,3096,260,21,7592,2,4,5,12,16,4,11,5,11,0,False,False,False,1,2,2021-10-01T19:15:57.12,16,False,5.0
2021,3,3096,275,2,811,2,4,5,2,9,7,6,3,6,0,False,False,False,0,2,2022-03-08T18:54:14.553,9,False,3.0
2021,3,3096,290,2,5223,13,6,8,16,0,0,0,0,0,0,False,False,False,0,2,2021-10-01T17:02:10.613,0,False,0.0
2021,3,3096,295,2,5223,2,13,4,2,20,18,20,0,20,0,False,False,False,0,2,2021-09-27T11:17:26.583,20,True,0.0
2021,3,3096,305,2,5223,2,42,4,4,4,0,4,0,4,0,False,False,False,0,3,2021-10-01T20:09:46.8,4,False,0.0
2021,3,3096,310,2,5223,2,4,10,6,6,0,6,0,6,0,True,False,False,0,3,2022-03-08T18:54:38.03,6,False,0.0
2021,3,3096,315,2,7303,13,12,8,18,0,0,0,0,0,0,False,False,False,0,3,2021-10-01T16:50:13.187,0,False,0.0
2021,3,3096,325,21,5015,13,6,9,11,0,0,0,0,0,0,False,False,False,0,2,2021-09-27T11:37:04.773,0,False,0.0
2021,3,3096,335,21,5015,2,4,5,10,15,5,12,3,12,0,False,False,False,0,2,2021-09-27T11:40:30.68,15,False,
2021,3,3096,340,21,8518,13,4,9,8,0,0,0,0,0,0,False,False,False,0,3,2021-10-01T20:11:29.45,0,False,0.0
2021,3,3096,365,2,2554,2,47,5,-1,12,13,4,8,4,0,False,False,False,1,1,2021-10-01T20:12:00.657,12,False,8.0
2021,3,3096,370,2,7303,2,8,4,14,14,0,14,0,14,0,False,False,False,0,2,2021-09-27T11:54:00.24,14,False,0.0
2021,3,3096,375,2,5223,2,44,3,-4,3,7,1,2,1,0,True,False,False,0,2,2021-09-27T11:56:46.85,3,False,2.0
2021,3,3096,380,2,5223,13,3,3,4,0,0,0,0,0,0,False,False,False,0,2,2021-09-27T12:01:25.837,0,False,0.0
2021,3,3096,395,2,7303,2,42,4,4,4,0,4,0,4,6,False,False,False,0,3,2022-03-08T18:55:20.487,4,True,0.0
2021,3,3096,410,21,6228,2,45,5,-6,0,6,-2,2,-2,0,False,False,False,0,1,2021-09-27T12:08:17.283,0,False,2.0
2021,3,3096,415,21,4422,2,4,4,9,13,4,11,2,11,0,False,True,True,0,3,2021-09-27T12:13:49.487,13,False,2.0
2021,3,3096,420,2,811,13,45,5,-6,0,0,0,0,0,0,False,False,False,0,1,2021-10-01T20:17:24.023,0,False,0.0
2021,3,3096,425,2,2554,2,4,4,1,1,0,1,0,1,0,False,False,False,0,1,2021-09-27T12:21:10.893,1,False,0.0
2021,3,3096,460,21,7592,2,4,5,13,13,0,13,0,13,0,False,False,False,0,2,2022-03-08T18:55:51.31,13,False,0.0
2021,3,3096,465,21,4492,2,4,5,9,11,2,10,1,10,0,False,False,False,0,2,2022-03-08T18:56:12.27,11,False,1.0
2021,3,3096,470,21,4422,13,2,4,7,0,0,0,0,0,0,False,False,False,0,3,2021-10-01T19:54:51.67,0,False,0.0
2021,3,3096,475,21,7592,13,12,8,16,0,0,0,0,0,0,False,False,False,0,2,2022-02-17T23:41:51.09,0,False,0.0
2021,3,3096,495,2,5214,13,42,10,5,0,0,0,0,0,0,False,False,False,0,3,2021-09-28T18:43:01.66,0,False,0.0
2021,3,3096,500,2,811,2,16,10,5,12,7,10,2,10,0,False,False,False,0,1,2022-03-08T18:56:30.22,12,False,2.0
2021,3,3096,510,21,6228,2,48,10,-3,20,23,20,0,20,0,False,False,False,0,1,2022-03-08T18:56:50.067,20,True,
2021,3,3096,515,21,7592,2,4,3,7,10,3,7,3,7,0,False,False,False,0,2,2021-09-27T13:20:09.06,10,False,3.0
2021,3,3096,530,21,6228,3,4,10,5,0,0,0,0,0,0,False,False,False,0,3,2022-02-17T23:40:51.967,0,False,0.0
2021,3,3096,540,21,7592,13,20,2,24,0,0,0,0,0,0,False,False,False,0,2,2021-10-01T16:32:46.917,0,False,0.0
2021,3,3096,570,2,1377,2,31,10,1,3,2,3,0,3,0,False,False,False,0,4,2021-09-27T13:53:58.623,3,False,0.0
2021,3,3096,575,2,7303,13,5,7,16,0,0,0,0,0,0,False,False,False,0,3,2021-10-19T17:08:47.71,0,False,0.0
2021,3,3096,595,21,6228,2,48,9,-5,12,17,9,3,9,0,False,False,False,0,1,2021-09-27T14:10:20.99,12,False,3.0
2021,3,3096,600,21,6228,2,48,9,-5,3,8,3,0,3,0,False,False,False,0,1,2022-03-08T18:57:15.94,3,False,0.0
2021,3,3096,605,21,7592,2,6,5,5,7,2,5,2,5,0,False,False,False,0,2,2021-09-27T14:16:10.673,7,False,2.0
2021,3,3096,625,21,7592,2,39,10,4,5,1,5,0,5,0,False,False,False,0,3,2021-09-27T14:32:03.847,5,False,0.0
2021,3,3096,635,21,4492,2,4,3,13,16,3,15,1,15,0,False,False,False,0,2,2021-09-27T14:38:56.367,16,False,1.0
2021,3,3096,640,21,4492,13,9,3,8,0,0,0,0,0,0,False,False,False,0,2,2021-09-27T14:40:55.367,0,False,
2021,3,3096,665,2,811,2,28,5,-4,-1,3,-3,2,-3,0,False,False,False,0,1,2021-09-27T14:48:27.38,-1,False,2.0
2021,3,3096,675,2,8389,2,2,10,10,10,0,10,0,10,0,False,False,False,0,3,2021-09-27T14:51:09.927,10,False,0.0
2021,3,3096,685,2,811,2,16,10,3,26,23,8,18,8,0,False,False,False,1,1,2022-03-08T18:57:34.147,26,False,18.0
2021,3,3096,695,2,2554,2,48,5,-5,4,9,-2,6,-2,0,False,False,False,1,1,2021-09-28T18:43:29.63,4,False,6.0
2021,3,3096,700,2,3506,2,2,9,5,6,1,5,1,5,0,False,False,False,0,2,2022-03-08T18:58:13.347,6,False,1.0
2021,3,3096,710,2,7303,2,5,3,6,14,8,12,2,12,0,False,False,False,0,3,2021-09-27T15:25:46.167,14,False,2.0
2021,3,3096,715,2,5223,2,52,10,0,4,4,3,1,3,0,True,False,False,0,2,2021-09-28T18:44:51.817,4,False,1.0
2021,3,3096,720,2,5223,2,13,10,2,1,-1,1,0,1,0,False,False,False,0,3,2021-09-27T15:31:58.723,1,False,0.0
2021,3,3096,725,2,8389,13,4,10,6,0,0,0,0,0,0,False,False,False,0,4,2021-09-27T15:34:12.687,0,False,0.0
2021,3,3096,730,2,8389,13,8,4,6,0,0,0,0,0,0,False,False,False,0,3,2021-10-01T20:24:54.84,0,False,
2021,3,3096,740,2,1377,2,33,9,1,1,0,1,0,1,6,False,False,False,0,4,2021-09-28T18:44:25.553,1,True,0.0
2021,3,3096,755,21,6228,2,47,5,-1,4,5,4,0,4,0,False,False,False,0,1,2021-09-27T15:44:41.973,4,False,0.0
2021,3,3096,765,21,7226,2,39,4,4,9,5,8,1,8,0,False,False,False,0,3,2021-09-27T15:51:21.81,9,False,1.0
2021,3,3096,775,21,4492,13,2,9,6,0,0,0,0,0,0,False,False,False,0,2,2021-09-27T15:54:12.587,0,False,
2021,3,3096,780,21,4422,13,39,4,5,0,0,0,0,0,0,False,False,False,0,4,2021-09-27T15:56:31.827,0,False,0.0
2021,3,3096,790,21,6228,2,48,9,-5,10,15,5,5,5,0,False,False,False,0,1,2021-09-27T16:00:50.183,10,False,5.0
2021,3,3096,805,2,811,2,50,9,-1,28,29,0,28,0,0,False,False,False,0,2,2021-10-01T20:25:54.687,28,False,28.0
2021,3,3096,815,2,8389,2,7,2,16,25,9,22,3,22,0,False,False,False,0,3,2022-03-08T18:58:34.963,25,False,3.0
2021,3,3097,15,26,309,2,49,10,-1,0,1,0,0,0,0,False,False,False,0,3,2021-10-01T15:12:14.883,0,False,0.0
2021,3,3097,20,26,4616,2,44,3,-4,4,8,0,4,0,0,True,False,False,0,2,2021-09-27T09:15:02.443,4,False,4.0
2021,3,3097,35,16,3938,2,47,5,0,7,7,6,1,6,0,True,False,False,0,3,2021-09-27T09:29:38.007,7,False,1.0
2021,3,3097,40,16,374,13,5,10,14,0,0,0,0,0,0,False,False,False,0,3,2021-09-28T17:26:40.273,0,False,0.0
2021,3,3097,50,16,7176,2,34,4,-4,15,19,2,13,2,0,True,False,False,1,3,2021-10-01T17:20:00.37,15,False,13.0
2021,3,3097,60,16,7170,2,26,9,4,5,1,5,0,5,0,False,False,False,0,3,2021-09-27T09:46:14.147,5,False,0.0
2021,3,3097,65,16,2568,2,46,3,0,6,6,3,3,3,0,False,False,False,0,4,2021-09-27T09:48:35.75,6,False,3.0
2021,3,3097,75,16,5039,3,4,4,12,0,0,0,0,0,0,False,False,False,0,2,2021-09-27T09:54:38.617,0,False,0.0
2021,3,3097,80,26,8177,2,47,5,0,3,3,2,1,2,0,False,False,False,0,1,2021-10-01T14:27:45.087,3,False,1.0
2021,3,3097,95,26,4616,2,44,9,-2,8,10,7,1,7,0,False,False,False,0,1,2021-10-01T15:21:12.14,8,False,1.0
2021,3,3097,100,26,309,13,39,4,4,0,0,0,0,0,0,False,False,False,0,4,2021-09-27T10:04:51.883,0,False,0.0
2021,3,3097,130,16,6499,2,31,10,4,6,2,4,2,4,0,False,False,False,0,1,2021-09-27T10:56:21.443,6,False,2.0
2021,3,3097,145,16,3938,2,6,4,8,8,0,8,0,8,0,False,True,True,0,3,2021-09-27T18:37:09.97,8,False,0.0
2021,3,3097,150,26,8177,2,32,5,-2,8,10,6,2,6,0,False,False,False,0,1,2021-09-27T11:11:02.38,8,False,2.0
2021,3,3097,165,26,8557,3,5,5,1,0,0,0,0,0,0,False,False,False,0,1,2021-10-01T14:34:06.263,0,False,0.0
2021,3,3097,170,26,4619,2,2,10,6,11,5,11,0,11,0,False,False,False,0,2,2021-09-27T12:05:47.763,11,True,0.0
2021,3,3097,190,26,7491,2,35,10,11,19,8,19,0,19,0,False,False,False,0,4,2021-09-27T12:10:12.203,19,True,0.0
2021,3,3097,200,26,309,2,4,4,4,4,0,4,0,4,6,False,False,False,0,3,2021-09-27T12:17:02.63,4,True,0.0
2021,3,3097,235,16,374,2,2,4,5,17,12,5,12,5,0,False,False,False,1,3,2021-10-01T15:40:37.183,17,False,12.0
2021,3,3097,250,26,4619,2,6,3,4,20,16,6,14,6,0,False,False,False,1,2,2021-10-01T17:20:25.207,20,False,14.0
2021,3,3097,255,26,4619,2,2,10,3,8,5,7,1,7,0,False,False,False,0,2,2021-09-27T13:03:13.413,8,False,1.0
2021,3,3097,260,26,309,2,3,3,8,6,-2,6,0,6,0,False,False,False,0,2,2021-09-28T19:42:07.657,6,False,0.0
2021,3,3097,270,26,4616,2,4,9,1,16,15,14,2,14,6,False,False,False,0,1,2021-10-01T15:42:51.627,16,False,2.0
2021,3,3097,290,16,7681,2,48,4,-2,-1,1,-1,0,-1,0,False,False,False,0,1,2021-09-27T13:22:50.453,-1,False,0.0
2021,3,3097,305,26,4616,2,4,4,2,5,3,5,0,5,0,False,False,False,0,1,2021-09-27T13:28:34.083,5,False,0.0
2021,3,3097,310,26,4616,2,47,10,0,12,12,11,1,11,0,False,False,False,0,1,2021-10-01T15:45:41.8,12,False,1.0
2021,3,3097,320,26,4616,2,45,5,0,7,7,3,4,3,0,False,False,False,0,1,2021-10-01T15:47:05.1,7,False,4.0
2021,3,3097,325,26,7453,13,12,6,49,0,0,0,0,0,0,False,False,False,0,2,2022-02-01T20:04:05.32,0,False,0.0
2021,3,3097,330,26,309,2,13,4,2,30,28,29,1,29,0,False,False,False,0,3,2021-10-01T15:48:29.96,30,False,
2021,3,3097,340,16,6500,2,6,4,5,5,0,5,0,5,0,False,False,False,0,2,2021-10-01T15:49:00.6,5,False,0.0
2021,3,3097,350,16,374,2,4,4,11,15,4,14,1,14,0,False,False,False,0,3,2021-09-27T14:00:55.303,15,False,1.0
2021,3,3097,360,16,374,2,9,6,27,28,1,27,1,27,0,False,False,False,0,3,2021-09-27T14:06:26.693,28,False,1.0
2021,3,3097,365,16,7176,13,6,4,8,0,0,0,0,0,0,False,False,False,0,3,2021-10-01T13:42:04.64,0,False,0.0
2021,3,3097,370,16,374,2,2,4,6,7,1,7,0,7,0,False,False,False,0,3,2021-09-27T14:10:16.617,7,False,0.0
2021,3,3097,395,16,6500,13,13,9,3,0,0,0,0,0,0,False,False,False,0,2,2021-10-01T18:03:12.783,0,False,0.0
2021,3,3097,405,16,4143,2,53,4,-4,6,10,5,1,5,0,False,False,False,0,4,2021-09-27T14:20:45.36,6,False,1.0
2021,3,3097,440,16,4143,2,4,8,15,11,-4,11,0,11,0,False,False,False,0,3,2021-10-01T15:51:03.257,11,False,0.0
2021,3,3097,450,16,6500,3,7,2,24,0,0,0,0,0,0,False,False,False,0,2,2022-02-17T22:09:42.297,0,False,0.0
2021,3,3097,460,16,3938,2,13,4,3,12,9,10,2,10,0,False,False,False,0,3,2021-09-27T14:41:00.597,12,False,2.0
2021,3,3097,465,16,374,2,4,9,8,8,0,8,0,8,0,False,False,False,0,3,2021-09-27T14:44:48.983,8,False,0.0
2021,3,3097,475,16,374,13,4,4,7,0,0,0,0,0,0,False,False,False,0,4,2021-10-01T15:52:21.52,0,False,
2021,3,3097,485,16,7176,2,34,4,-4,10,14,-1,11,-1,0,True,False,False,1,3,2021-10-01T17:20:44.657,10,False,11.0
2021,3,3097,490,16,7681,13,12,5,3,0,0,0,0,0,0,True,False,False,0,1,2022-02-01T20:04:38.033,0,False,0.0
2021,3,3097,500,16,7170,2,17,4,2,2,0,2,0,2,6,False,False,False,0,3,2021-10-01T13:42:04.64,2,True,0.0
2021,3,3097,540,16,374,2,2,10,6,6,0,6,0,6,0,True,False,False,0,4,2021-10-01T15:58:12.157,6,False,0.0
2021,3,3097,545,16,3938,13,11,2,15,0,0,0,0,0,0,True,False,False,0,3,2022-02-17T22:10:15.667,0,False,0.0
2021,3,3097,555,16,374,2,6,4,8,23,15,19,4,19,0,False,False,False,0,2,2021-10-01T16:33:17.137,23,False,4.0
2021,3,3097,570,16,3938,2,12,6,15,18,3,18,0,18,0,False,False,False,0,2,2021-09-27T15:57:43.61,18,True,0.0
2021,3,3097,580,16,6499,13,46,3,0,0,0,0,0,0,0,False,False,False,0,1,2021-10-01T16:01:53.973,0,False,0.0
2021,3,3097,585,16,7681,2,48,9,-4,10,14,10,0,10,6,False,False,False,0,1,2021-10-01T16:02:16.773,10,True,0.0
2021,3,3097,610,26,958,2,33,3,11,21,10,12,9,12,0,False,False,False,0,4,2021-10-01T15:03:58.1,21,False,9.0
2021,3,3097,615,26,309,13,5,5,10,0,0,0,0,0,0,False,False,False,0,3,2022-02-25T14:52:55.233,0,False,0.0
2021,3,3097,620,26,309,2,4,10,5,11,6,9,2,9,0,False,False,False,0,3,2021-09-27T16:21:12.453,11,False,2.0
2021,3,3097,630,26,309,2,5,3,5,5,0,5,0,5,0,False,False,False,0,3,2021-09-27T16:25:36.487,5,False,0.0
2021,3,3097,635,26,309,2,47,10,0,0,0,0,0,0,0,True,False,False,0,3,2021-10-01T16:04:00.743,0,False,0.0
2021,3,3097,645,26,309,2,2,4,6,9,3,9,0,9,0,False,False,False,0,3,2021-10-01T16:05:54.443,9,False,0.0
2021,3,3097,655,26,4619,2,9,2,17,20,3,20,0,20,6,False,False,False,0,2,2021-10-01T16:07:46.817,20,True,0.0
2021,3,3097,670,16,8537,2,30,10,-3,5,8,4,1,4,0,False,False,False,0,4,2021-09-27T16:42:07.853,5,False,1.0
2021,3,3097,685,16,6499,2,44,3,-4,5,9,4,1,4,0,False,False,False,0,1,2021-09-27T16:48:38.103,5,False,1.0
2021,3,3097,695,16,6500,2,4,9,4,7,3,6,1,6,0,False,False,False,0,4,2021-10-01T14:28:42,7,False,1.0
2021,3,3097,715,16,3938,2,5,3,11,11,0,11,0,11,0,False,False,False,0,3,2021-10-01T16:11:25.38,11,False,0.0
2021,3,3097,725,16,7176,2,34,4,-4,8,12,6,2,6,6,True,False,False,0,3,2021-09-27T17:03:13.43,8,False,2.0
2021,3,3097,740,26,4619,2,17,7,21,43,22,34,9,34,0,False,False,False,1,3,2021-09-27T17:06:42.15,43,False,9.0
2021,3,3097,765,26,309,13,5,5,5,0,0,0,0,0,0,False,False,False,0,2,2021-09-28T19:43:45.16,0,False,0.0
2021,3,3097,775,26,309,13,9,5,5,0,0,0,0,0,0,False,False,False,0,3,2021-09-27T18:30:00.42,0,False,
2021,3,3097,785,26,8177,2,30,5,-1,1,2,0,1,0,6,False,False,False,0,4,2021-09-27T17:26:52.427,1,False,
2021,3,3097,795,26,309,13,12,5,6,0,0,0,0,0,0,False,False,False,0,3,2021-10-01T15:05:58.283,0,False,0.0
2021,3,3097,820,16,374,3,6,4,11,0,0,0,0,0,0,False,False,False,0,3,2022-02-17T22:11:49.13,0,False,0.0
2021,3,3097,825,16,374,13,12,2,32,0,0,0,0,0,0,False,False,False,0,3,2021-10-01T14:52:18.87,0,False,0.0
2021,3,3097,830,26,958,3,4,9,5,0,0,0,0,0,0,False,False,False,0,4,2022-02-17T22:16:01.697,0,False,0.0
2021,3,3097,840,26,309,2,2,10,8,15,7,13,2,13,0,True,False,False,0,3,2021-10-01T16:22:18.083,15,False,2.0
2021,3,3097,850,26,958,2,47,5,1,6,5,3,3,3,0,False,False,False,0,4,2021-10-01T16:22:48.133,6,False,3.0
2021,3,3097,860,26,4619,3,2,10,5,0,0,0,0,0,0,False,False,False,0,2,2021-10-01T16:23:56.067,0,False,0.0
2021,3,3097,865,26,4619,13,2,9,4,0,0,0,0,0,0,False,False,False,0,2,2021-10-01T16:24:17.87,0,False,0.0
2021,3,3097,880,26,7453,13,29,2,15,0,0,0,0,0,0,False,False,False,0,2,2021-09-27T18:27:32.39,0,False,
2021,3,3097,885,26,4619,2,29,3,14,16,2,16,0,16,0,False,False,False,0,2,2021-09-27T18:00:58.523,16,False,0.0
2021,3,3097,890,26,4619,2,29,3,4,4,0,4,0,4,6,False,False,False,0,2,2021-10-01T16:24:41.013,4,True,0.0
2021,3,3097,905,16,3938,13,8,1,40,0,0,0,0,0,0,False,False,False,0,3,2021-10-01T16:26:21.703,0,False,0.0
2021,3,3097,915,16,374,13,7,6,16,0,0,0,0,0,0,False,False,False,0,4,2021-10-01T16:27:52.543,0,False,0.0
2021,3,3097,920,16,6500,3,17,1,25,0,0,0,0,0,0,False,False,False,0,3,2021-10-01T16:28:11.797,0,False,0.0
2021,3,3097,930,16,3938,13,19,7,47,0,0,0,0,0,0,False,False,False,0,3,2021-10-01T16:28:32.577,0,False,0.0
2021,3,3098,20,25,7666,2,50,5,-1,5,6,4,1,4,0,False,False,False,0,2,2021-10-01T15:03:40.56,5,False,1.0
2021,3,3098,25,25,6486,13,19,6,28,0,0,0,0,0,0,False,False,False,0,2,2021-10-15T01:19:01.55,0,False,0.0
2021,3,3098,40,7,3521,13,7,6,22,0,0,0,0,0,0,False,False,False,0,3,2021-09-27T10:16:26.27,0,False,0.0
2021,3,3098,55,7,8325,2,52,4,0,12,12,11,1,11,0,False,False,False,0,3,2021-10-01T18:11:45.11,12,False,1.0
2021,3,3098,70,25,4583,2,51,10,0,3,3,3,0,3,0,True,False,False,0,3,2021-10-01T17:19:38.87,3,False,0.0
2021,3,3098,75,25,8421,2,47,5,1,12,11,10,2,10,0,False,False,False,1,3,2021-09-27T10:50:47.403,12,False,
2021,3,3098,80,25,7666,3,2,5,4,0,0,0,0,0,0,False,False,False,0,2,2021-10-01T17:46:34.457,0,False,0.0
2021,3,3098,85,25,7666,2,50,5,-2,0,2,0,0,0,0,False,False,False,0,2,2021-10-01T15:03:40.56,0,False,0.0
2021,3,3098,100,7,3521,13,8,1,29,0,0,0,0,0,0,False,False,False,0,3,2022-02-18T15:27:48.74,0,False,0.0
2021,3,3098,110,25,609,13,35,4,8,0,0,0,0,0,0,False,False,False,0,4,2021-09-27T11:27:36.573,0,False,0.0
2021,3,3098,120,25,7666,13,19,3,1,0,0,0,0,0,0,False,False,False,0,2,2021-10-01T17:22:33.2,0,False,0.0
2021,3,3098,135,7,8317,2,5,5,11,15,4,12,3,12,0,False,False,False,0,2,2021-09-27T11:35:34.663,15,False,3.0
2021,3,3098,150,7,3521,2,46,3,1,7,6,6,1,6,0,False,False,False,0,2,2021-09-27T11:40:26.92,7,False,1.0
2021,3,3098,155,7,3521,2,26,4,3,17,14,7,10,7,6,False,False,False,1,3,2021-09-27T11:42:38.9,17,False,10.0
2021,3,3098,180,25,6486,13,5,2,15,0,0,0,0,0,0,False,False,False,0,2,2021-09-27T16:53:51.03,0,False,
2021,3,3098,190,25,7666,2,4,9,4,6,2,4,2,4,0,False,False,False,0,3,2021-10-01T17:48:21.153,6,False,2.0
2021,3,3098,220,25,7666,2,4,9,2,3,1,3,0,3,0,False,False,False,0,2,2021-09-27T12:07:24.797,3,False,0.0
2021,3,3098,225,25,7666,13,35,4,6,0,0,0,0,0,0,False,False,False,0,3,2021-09-27T12:09:53.6,0,False,0.0
2021,3,3098,265,25,8421,2,44,3,-6,7,13,-2,9,-2,0,False,False,False,1,1,2021-10-01T17:56:45.437,7,False,9.0
2021,3,3098,270,25,8422,2,4,10,3,3,0,3,0,3,0,False,False,False,0,4,2021-10-01T18:43:28.507,3,False,0.0
2021,3,3098,280,25,4583,2,4,4,3,16,13,13,3,13,0,False,False,False,0,3,2021-09-27T12:29:44.563,16,False,3.0
2021,3,3098,295,25,7666,2,5,3,5,12,7,5,7,5,0,False,False,False,0,2,2022-02-18T15:29:22.963,12,False,7.0
2021,3,3098,305,25,4583,2,6,4,6,6,0,6,0,6,0,False,False,False,0,2,2021-09-28T17:52:55.427,6,False,0.0
2021,3,3098,310,25,8421,2,13,4,4,6,2,4,2,4,0,False,False,False,0,3,2021-10-01T18:01:08.403,6,False,2.0
2021,3,3098,315,25,4227,2,54,4,-1,3,4,0,3,0,0,False,False,False,0,1,2021-10-01T15:03:40.577,3,False,3.0
2021,3,3098,330,25,8421,2,46,9,-7,18,25,14,4,14,0,False,False,False,0,1,2021-09-27T12:52:10.117,18,False,4.0
2021,3,3098,340,25,8422,2,54,4,-2,4,6,2,2,2,6,False,False,False,0,4,2021-10-01T17:18:55.6,4,False,2.0
2021,3,3098,355,7,3521,2,4,4,4,7,3,7,0,7,0,False,False,False,0,3,2021-09-27T16:55:05.91,7,False,0.0
2021,3,3098,360,7,3521,3,17,1,25,0,0,0,0,0,0,False,False,False,0,3,2021-10-01T17:21:24.3,0,False,
2021,3,3098,365,7,3445,2,2,10,11,19,8,19,0,19,0,False,False,False,0,2,2021-10-01T15:03:40.577,19,False,0.0
2021,3,3098,375,7,8317,2,19,6,34,34,0,34,0,34,6,False,False,False,0,2,2021-09-27T13:07:23.753,34,True,0.0
2021,3,3098,390,25,7666,13,5,3,10,0,0,0,0,0,0,False,False,False,0,2,2021-09-27T13:09:57.91,0,False,0.0
2021,3,3098,395,25,8421,13,12,4,8,0,0,0,0,0,0,False,False,False,0,1,2022-02-18T15:31:17.013,0,False,0.0
2021,3,3098,415,7,6383,2,6,1,21,21,0,21,0,21,0,False,False,False,0,2,2021-10-01T18:14:28.14,21,False,
2021,3,3098,440,7,6383,2,2,10,7,14,7,12,2,12,0,False,False,False,0,2,2021-09-27T13:28:58.937,14,False,2.0
2021,3,3098,455,7,4455,2,4,10,4,8,4,5,3,5,0,False,False,False,0,2,2021-09-27T13:35:56.827,8,False,3.0
2021,3,3098,470,7,8325,2,13,4,-1,14,15,3,11,3,0,False,False,False,1,2,2021-10-01T17:25:16.107,14,False,11.0
2021,3,3098,485,7,3521,2,4,4,3,5,2,4,1,4,0,False,False,False,0,3,2021-10-01T18:44:03.62,5,False,1.0
2021,3,3098,490,7,2631,3,47,5,3,0,0,0,0,0,0,False,False,False,0,4,2021-10-15T01:19:28.39,0,False,0.0
2021,3,3098,505,25,8421,2,18,3,-1,6,7,4,2,4,0,False,False,False,1,2,2021-10-01T17:25:28.023,6,False,2.0
2021,3,3098,510,25,8421,3,51,3,-7,0,0,0,0,0,0,False,False,False,0,1,2021-10-01T15:03:40.577,0,False,0.0
2021,3,3098,515,25,4583,13,39,4,1,0,0,0,0,0,0,False,False,False,0,3,2021-10-01T18:04:26.787,0,False,0.0
2021,3,3098,530,7,8317,2,2,4,9,9,0,9,0,9,6,False,False,False,0,2,2021-09-27T14:06:56.393,9,True,0.0
2021,3,3098,545,25,8422,2,4,9,11,15,4,12,3,12,0,True,False,False,0,4,2022-03-11T18:23:58.437,15,False,3.0
2021,3,3098,555,25,8421,2,46,9,-1,21,22,1,20,1,0,False,False,False,4,1,2021-10-01T17:26:24.597,21,False,20.0
2021,3,3098,560,25,8421,3,50,3,-3,0,0,0,0,0,0,False,False,False,0,2,2021-09-27T14:17:02.437,0,False,0.0
2021,3,3098,565,25,8422,13,7,1,24,0,0,0,0,0,0,False,False,False,0,3,2021-10-01T15:03:40.577,0,False,0.0
2021,3,3098,570,25,7666,13,23,7,24,0,0,0,0,0,0,False,False,False,0,3,2022-02-18T15:36:08.43,0,False,0.0
2021,3,3098,590,7,4679,2,47,5,-1,4,5,3,1,3,0,False,False,False,0,1,2021-09-27T14:31:59.467,4,False,1.0
2021,3,3098,605,25,6259,3,26,9,3,0,0,0,0,0,0,False,False,False,0,3,2022-02-18T15:33:23.087,0,False,0.0
2021,3,3098,615,25,7666,2,2,10,9,16,7,9,7,9,0,False,False,False,0,2,2021-09-27T14:41:39.99,16,False,7.0
2021,3,3098,620,25,6486,2,2,3,4,4,0,4,0,4,0,False,False,False,0,2,2022-03-11T18:25:35.783,4,False,0.0
2021,3,3098,635,25,6259,2,7,6,17,24,7,24,0,24,0,False,False,False,0,3,2022-02-18T15:39:01.483,24,True,0.0
2021,3,3098,640,25,8421,2,47,4,-2,0,2,-2,2,-2,0,False,False,False,1,1,2021-09-27T15:03:00.713,0,False,2.0
2021,3,3098,645,25,7984,2,13,10,2,6,4,5,1,5,0,False,False,False,0,3,2021-09-27T15:04:31.57,6,False,1.0
2021,3,3098,650,25,7666,2,18,3,-1,8,9,6,2,6,0,False,False,False,0,2,2021-09-28T17:53:58.347,8,False,2.0
2021,3,3098,655,25,6259,2,39,4,3,3,0,3,0,3,0,False,False,False,0,3,2021-10-01T15:03:40.577,3,False,0.0
2021,3,3098,660,25,6259,2,39,4,4,5,1,5,0,5,0,False,True,False,0,3,2021-10-01T15:03:40.577,6,False,0.0
2021,3,3098,665,25,7666,13,19,6,25,0,0,0,0,0,0,False,False,False,0,2,2022-02-18T15:34:17.42,0,False,
2021,3,3098,670,25,8422,3,5,3,12,0,0,0,0,0,0,False,False,False,0,4,2021-09-27T15:17:34.42,0,False,0.0
2021,3,3098,675,25,6486,2,5,5,8,8,0,8,0,8,0,False,False,False,0,2,2021-09-27T15:19:15.457,8,False,0.0
2021,3,3098,680,25,8421,2,2,10,2,7,5,3,4,3,0,False,False,False,1,2,2021-10-01T18:06:27.66,7,False,4.0
2021,3,3098,685,25,8422,2,51,3,-4,-1,3,-1,0,-1,0,False,False,False,0,3,2021-09-27T15:23:18.34,-1,False,
2021,3,3098,700,25,8421,2,5,9,4,5,1,4,1,4,0,False,False,False,1,3,2021-10-01T17:25:39.863,5,False,1.0
2021,3,3098,705,25,8421,2,5,3,4,8,4,6,2,6,0,False,False,False,1,3,2021-10-01T17:25:49.12,8,False,2.0
2021,3,3098,720,7,8317,13,2,4,6,0,0,0,0,0,0,False,False,False,0,3,2021-10-01T18:19:16.767,0,False,0.0
2021,3,3098,735,7,8317,2,2,4,6,7,1,6,1,6,0,False,False,False,0,3,2021-09-28T17:09:13.407,7,False,1.0
2021,3,3098,745,25,609,3,2,10,12,0,0,0,0,0,0,False,False,False,0,4,2021-09-27T15:47:28.717,0,False,0.0
2021,3,3098,750,25,6486,13,19,7,40,0,0,0,0,0,0,False,False,False,0,2,2021-10-01T18:20:22.03,0,False,0.0
2021,3,3098,755,25,7984,2,3,3,11,11,0,11,0,11,0,False,False,False,0,2,2021-09-27T16:57:59.263,11,False,0.0
2021,3,3098,760,25,7666,2,3,5,13,17,4,15,2,15,0,False,False,False,0,2,2021-09-27T15:53:44.993,17,False,2.0
2021,3,3098,765,25,8421,2,4,4,1,5,4,3,2,3,0,False,False,False,0,1,2021-09-27T15:55:56.407,5,False,2.0
2021,3,3098,770,25,7666,2,19,6,27,29,2,28,1,28,0,False,False,False,0,2,2022-02-18T15:37:52.7,29,False,1.0
2021,3,3098,775,25,8421,2,28,3,-3,9,12,9,0,9,0,False,False,False,0,1,2021-09-27T16:57:41.173,9,False,0.0
2021,3,3098,780,25,8421,2,5,3,3,3,0,3,0,3,0,True,False,False,0,3,2022-03-11T18:32:58.513,3,False,0.0
2021,3,3098,795,25,6486,2,13,4,2,8,6,7,1,7,0,True,False,False,0,3,2021-10-01T15:03:40.577,8,False,1.0
2021,3,3098,800,25,609,13,7,3,12,0,0,0,0,0,0,False,False,False,0,4,2021-09-27T16:11:31.887,0,False,0.0
2021,3,3098,810,25,8421,2,45,10,-6,-1,5,-4,3,-4,0,True,False,False,2,1,2021-10-01T17:26:04.613,-1,False,3.0
2021,3,3098,855,25,8421,2,44,9,-3,8,11,6,2,6,0,False,False,False,0,1,2021-09-27T16:19:41.583,8,False,2.0
2021,3,3098,860,25,8421,3,47,10,-2,0,0,0,0,0,0,False,False,False,0,1,2021-09-27T16:21:08.647,0,False,0.0
2021,3,3098,865,25,7666,3,2,9,1,0,0,0,0,0,0,False,False,False,0,2,2021-09-27T16:22:26.297,0,False,0.0
2021,3,3098,870,25,8421,3,4,4,4,0,0,0,0,0,0,False,False,False,0,1,2021-09-27T16:23:38.97,0,False,0.0
2021,3,3099,10,8,7652,13,7,6,32,0,0,0,0,0,0,False,False,False,0,3,2021-10-01T20:33:00.527,0,False,0.0
2021,3,3099,15,8,1067,13,2,10,5,0,0,0,0,0,0,False,False,False,0,3,2021-09-27T09:28:24.533,0,False,0.0
2021,3,3099,20,8,1067,2,4,9,13,13,0,13,0,13,0,False,False,False,0,3,2021-09-27T09:30:51.883,13,False,0.0
2021,3,3099,30,8,8349,13,5,3,11,0,0,0,0,0,0,False,False,False,0,3,2021-09-27T09:33:54.37,0,False,0.0
2021,3,3099,50,8,8354,13,11,6,21,0,0,0,0,0,0,True,False,False,0,1,2021-09-27T09:45:35.76,0,False,0.0
2021,3,3099,105,8,1067,13,19,2,28,0,0,0,0,0,0,False,False,False,0,2,2021-09-27T10:02:37.87,0,False,
2021,3,3099,110,8,8354,2,30,5,1,13,12,13,0,13,0,False,False,False,0,3,2022-02-17T20:04:07.353,13,False,0.0
2021,3,3099,120,8,7651,2,29,6,21,21,0,21,0,21,0,False,False,False,0,2,2021-09-27T10:08:25.36,21,True,0.0
2021,3,3099,130,8,1067,2,2,4,5,7,2,6,1,6,0,False,False,False,0,3,2021-09-27T14:05:18.783,7,False,1.0
2021,3,3099,135,8,8354,2,45,5,-4,0,4,-1,1,-1,0,True,False,False,0,2,2021-09-27T10:13:25.903,0,False,1.0
2021,3,3099,160,6,7728,2,4,10,6,11,5,10,1,10,0,False,False,False,0,3,2021-09-27T10:21:17.517,11,False,1.0
2021,3,3099,175,8,5053,2,47,5,-1,3,4,-2,5,-2,0,False,False,False,1,1,2021-10-01T19:20:25.12,3,False,5.0
2021,3,3099,180,8,5053,2,48,9,-3,18,21,14,4,14,0,False,False,False,0,1,2021-09-27T13:55:19.367,18,False,4.0
2021,3,3099,220,8,1067,13,3,2,15,0,0,0,0,0,0,False,False,False,0,2,2021-09-27T10:38:48.09,0,False,0.0
2021,3,3099,270,8,3883,13,13,9,4,0,0,0,0,0,0,False,False,False,0,4,2021-09-27T10:49:53.283,0,False,0.0
2021,3,3099,275,8,3606,2,5,7,17,17,0,17,0,17,0,False,False,False,0,3,2021-10-01T19:35:16.157,17,False,0.0
2021,3,3099,280,8,3606,2,38,10,1,7,6,6,1,6,0,False,False,False,0,4,2021-09-27T10:58:20.133,7,False,1.0
2021,3,3099,315,6,7725,2,4,10,6,9,3,7,2,7,0,False,False,False,0,2,2021-09-27T11:09:03.33,9,False,2.0
2021,3,3099,325,6,464,2,12,3,9,9,0,9,0,9,0,False,False,False,0,2,2021-10-01T20:34:28.477,9,False,0.0
2021,3,3099,330,6,7725,13,4,3,6,0,0,0,0,0,0,False,False,False,0,2,2021-09-27T11:17:11.417,0,False,0.0
2021,3,3099,365,8,7651,2,21,2,17,18,1,18,0,18,0,False,False,False,0,2,2021-09-27T11:27:35.383,18,True,0.0
2021,3,3099,375,8,5053,2,16,9,4,17,13,12,5,12,0,False,False,False,0,1,2021-09-27T13:56:00.697,17,False,5.0
2021,3,3099,385,8,3883,2,2,4,4,6,2,5,1,5,0,False,False,False,0,4,2021-10-01T19:03:06.343,6,False,1.0
2021,3,3099,395,8,5053,2,16,10,2,4,2,2,2,2,0,False,False,False,0,1,2021-09-27T13:56:18,4,False,2.0
2021,3,3099,405,8,5053,13,47,5,0,0,0,0,0,0,0,True,False,False,0,1,2021-09-28T22:41:17.32,0,False,0.0
2021,3,3099,410,8,5053,2,48,10,-3,9,12,7,2,7,0,False,False,False,0,1,2021-09-27T13:56:34.607,9,False,2.0
2021,3,3099,430,8,3883,2,17,4,13,13,0,13,0,13,6,False,False,False,0,3,2021-09-27T11:46:30.007,13,True,0.0
2021,3,3099,460,6,7728,13,4,10,5,0,0,0,0,0,0,False,False,False,0,3,2022-02-17T20:13:34.337,0,False,0.0
2021,3,3099,465,6,7725,13,2,10,5,0,0,0,0,0,0,False,False,False,0,3,2022-02-17T20:12:55.66,0,False,0.0
2021,3,3099,490,8,1067,2,29,2,26,26,0,26,0,26,0,False,False,False,0,2,2021-09-27T12:01:08.883,26,True,0.0
2021,3,3099,530,6,1378,13,3,2,15,0,0,0,0,0,0,False,False,False,0,2,2021-09-27T12:14:18.687,0,False,0.0
2021,3,3099,575,6,666,13,30,3,-4,0,0,0,0,0,0,False,False,False,0,4,2021-10-01T19:41:46.927,0,False,0.0
2021,3,3099,580,6,464,13,4,9,5,0,0,0,0,0,0,False,False,False,0,3,2022-02-17T20:11:35.023,0,False,0.0
2021,3,3099,585,6,464,2,3,3,10,18,8,10,8,10,0,False,False,False,1,2,2021-10-01T19:28:19.607,18,False,8.0
2021,3,3099,590,6,6786,13,46,3,4,0,0,4,-1003,4,0,False,False,False,0,1,2021-09-27T12:29:47.983,0,False,0.0
2021,3,3099,600,6,7728,2,53,10,0,6,6,4,2,4,0,False,False,False,0,4,2021-09-27T12:33:55.133,6,False,
2021,3,3099,605,6,464,13,12,2,57,0,0,0,0,0,0,False,False,False,0,2,2022-02-17T20:08:16.19,0,False,
2021,3,3099,620,6,6786,2,47,5,2,11,9,7,4,7,0,False,False,False,1,1,2021-09-27T12:45:48.723,11,False,4.0
2021,3,3099,640,8,1067,2,2,9,11,16,5,16,0,16,0,False,False,False,0,3,2021-09-27T12:48:35.83,16,False,0.0
2021,3,3099,645,8,1067,13,7,2,29,0,0,0,0,0,0,False,False,False,0,2,2021-10-01T20:36:17.013,0,False,0.0
2021,3,3099,650,8,5053,2,48,9,-3,23,26,13,10,13,0,False,False,False,0,1,2021-09-27T12:52:49.63,23,False,10.0
2021,3,3099,665,8,1067,13,19,6,28,0,0,0,0,0,0,False,False,False,0,2,2021-10-01T19:03:06.343,0,False,0.0
2021,3,3099,690,6,464,13,4,3,6,0,0,0,0,0,0,False,False,False,0,2,2021-09-27T13:00:56.483,0,False,0.0
2021,3,3099,695,6,6786,13,46,3,2,0,0,0,0,0,0,False,False,False,0,1,2021-09-27T13:02:49.58,0,False,
2021,3,3099,700,6,7725,13,5,3,4,0,0,0,0,0,0,False,False,False,0,3,2021-09-27T13:04:32.72,0,False,0.0
2021,3,3099,710,6,7728,13,4,10,6,0,0,0,0,0,0,False,False,False,0,3,2021-09-27T13:06:33.233,0,False,0.0
2021,3,3099,720,8,1067,2,3,6,15,15,0,15,0,15,0,False,False,False,0,2,2021-09-27T13:08:28.393,15,True,0.0
2021,3,3099,740,8,7652,13,35,5,14,0,0,0,0,0,0,False,False,False,0,4,2021-10-01T19:03:06.343,0,False,0.0
2021,3,3099,770,6,464,13,2,9,8,0,0,0,0,0,0,False,False,False,0,2,2021-09-27T13:20:09.77,0,False,0.0
2021,3,3099,855,6,6786,2,48,9,-5,10,15,8,2,8,0,False,False,False,1,1,2021-09-27T13:41:48.87,10,False,2.0
2021,3,3099,860,6,6786,13,4,9,2,0,0,0,0,0,0,False,False,False,0,1,2021-09-27T13:42:58.643,0,False,0.0
2021,3,3099,870,6,464,13,5,5,11,0,0,0,0,0,0,False,False,False,0,3,2021-09-27T13:45:54.657,0,False,0.0
2021,3,3100,10,11,4037,13,3,5,10,0,0,0,0,0,0,True,False,False,0,3,2021-10-01T13:52:14.393,0,False,0.0
2021,3,3100,15,11,1430,2,13,9,5,11,6,10,1,10,0,False,False,False,0,4,2021-09-27T09:19:26.473,11,False,1.0
2021,3,3100,25,11,4037,13,4,3,5,0,0,0,0,0,0,False,False,False,0,2,2021-10-01T16:35:42.39,0,False,0.0
2021,3,3100,35,11,1430,13,5,3,8,0,0,0,0,0,0,False,False,False,0,3,2021-09-27T09:29:49.213,0,False,0.0
2021,3,3100,45,3,6936,2,5,5,5,5,0,5,0,5,0,False,False,False,0,3,2021-09-27T09:33:49.76,5,False,0.0
2021,3,3100,70,11,3393,13,12,4,-9,0,0,0,0,0,0,False,False,False,0,6,2022-02-17T21:11:19.93,0,False,0.0
2021,3,3100,85,3,6454,2,5,5,14,16,2,16,0,16,0,False,False,False,0,3,2021-09-27T09:52:13.29,16,False,0.0
2021,3,3100,90,3,6936,2,4,9,12,11,-1,11,0,11,0,False,False,False,0,2,2021-09-27T09:54:40.953,11,False,0.0
2021,3,3100,125,11,4037,2,30,5,1,3,2,3,0,3,0,True,False,False,0,4,2021-09-27T10:07:05.017,3,False,0.0
2021,3,3100,130,11,7732,2,38,9,2,4,2,4,0,4,0,False,False,False,0,3,2021-10-01T16:08:20.867,4,False,0.0
2021,3,3100,150,3,6454,13,6,1,15,0,0,0,0,0,0,False,False,False,0,4,2022-02-17T21:13:19.34,0,False,0.0
2021,3,3100,170,3,6816,2,5,9,3,6,3,6,0,6,0,False,False,False,0,3,2021-09-27T10:22:09.733,6,False,0.0
2021,3,3100,220,3,121,13,19,2,42,0,0,0,0,0,0,False,False,False,0,2,2021-09-27T10:41:40.177,0,False,0.0
2021,3,3100,225,3,6454,2,35,3,14,21,7,21,0,21,0,False,False,False,0,3,2021-10-01T16:07:31.4,21,False,0.0
2021,3,3100,235,3,6936,3,8,7,25,0,0,0,0,0,0,False,False,False,0,3,2021-09-27T10:48:06.393,0,False,0.0
2021,3,3100,255,11,6810,2,4,9,5,5,0,5,0,5,0,False,False,False,0,3,2021-09-27T10:53:02.833,5,False,0.0
2021,3,3100,265,11,7732,13,11,2,15,0,0,0,0,0,0,False,False,False,0,1,2021-09-27T10:55:59.63,0,False,
2021,3,3100,270,11,4037,13,19,6,40,0,0,0,0,0,0,False,False,False,0,2,2021-10-15T01:21:11.05,0,False,0.0
2021,3,3100,310,3,6936,2,35,2,25,37,12,37,0,37,0,False,False,False,0,3,2021-10-01T14:51:05.847,37,False,0.0
2021,3,3100,325,3,8274,13,12,2,18,0,0,0,0,0,0,False,False,False,0,2,2021-09-27T11:24:01.21,0,False,0.0
2021,3,3100,330,3,7672,2,7,6,19,19,0,19,0,19,6,False,False,False,0,3,2021-09-27T11:25:55.243,19,True,0.0
2021,3,3100,345,11,7733,2,5,10,3,8,5,8,0,8,0,False,False,False,1,3,2021-10-01T14:40:44.41,8,False,0.0
2021,3,3100,355,11,4037,2,46,3,0,1,1,1,0,1,0,False,False,False,0,3,2021-09-28T15:32:14.467,1,False,0.0
2021,3,3100,375,3,6936,3,19,2,35,0,0,0,0,0,0,False,False,False,0,2,2021-09-27T11:38:25.69,0,False,0.0
2021,3,3100,380,3,7673,2,12,2,29,29,0,29,0,29,0,False,False,False,0,3,2021-10-27T17:40:52.117,29,True,0.0
2021,3,3100,390,3,7672,2,13,9,3,3,0,1,2,1,0,False,False,False,1,3,2021-10-01T15:55:36.377,3,False,2.0
2021,3,3100,395,3,6936,3,19,6,34,0,0,0,0,0,0,False,False,False,0,3,2021-09-27T11:46:06.713,0,False,0.0
2021,3,3100,405,11,6831,3,50,9,-3,0,0,0,0,0,0,False,False,False,0,2,2022-02-17T21:14:20.38,0,False,0.0
2021,3,3100,410,11,4561,2,28,9,0,15,15,12,3,12,0,False,False,False,0,1,2021-09-27T11:53:22.773,15,False,3.0
2021,3,3100,415,11,4561,2,32,9,-3,10,13,10,0,10,0,False,False,False,1,1,2021-09-27T11:55:03.817,10,False,0.0
2021,3,3100,425,11,4037,13,12,7,17,0,0,0,0,0,0,False,False,False,0,3,2021-10-01T16:36:02.163,0,False,0.0
2021,3,3100,450,3,121,2,12,5,10,9,-1,9,0,9,0,False,False,False,0,2,2021-09-27T12:04:34.433,9,False,0.0
2021,3,3100,460,3,6454,2,35,6,23,41,18,41,0,41,0,True,False,False,0,4,2021-10-01T16:36:18.933,41,False,0.0
2021,3,3100,465,3,121,13,19,8,29,0,0,0,0,0,0,False,False,False,0,2,2021-10-01T16:12:37.447,0,False,0.0
2021,3,3100,475,3,6454,13,17,1,32,0,0,0,0,0,0,False,False,False,0,3,2022-02-17T21:15:06.89,0,False,0.0
2021,3,3100,490,11,6810,2,26,10,3,5,2,3,2,3,0,False,False,False,0,3,2021-09-28T15:33:23.593,5,False,2.0
2021,3,3100,495,11,4037,2,4,5,5,12,7,9,3,9,0,False,False,False,0,3,2021-09-28T15:33:56.24,12,False,3.0
2021,3,3100,505,11,7732,2,45,5,-2,11,13,3,8,3,0,True,False,False,2,1,2021-09-27T12:25:18.283,11,False,8.0
2021,3,3100,515,11,7732,2,16,9,2,14,12,10,4,10,0,True,False,False,0,1,2021-09-28T15:37:24.79,14,False,4.0
2021,3,3100,520,11,7732,2,30,10,-1,19,20,17,2,17,0,False,False,False,1,3,2021-09-27T12:34:29.463,19,False,2.0
2021,3,3100,530,11,6633,2,5,3,9,9,0,9,0,9,0,False,False,False,0,3,2021-10-01T16:13:23.38,9,False,0.0
2021,3,3100,535,11,8359,2,34,4,-4,2,6,0,2,0,0,True,False,False,1,2,2022-02-17T21:17:01.573,2,False,2.0
2021,3,3100,555,3,6454,2,5,5,7,7,0,7,0,7,0,False,False,False,0,4,2021-09-27T12:44:27.77,7,False,0.0
2021,3,3100,580,3,6454,2,17,8,15,24,9,24,0,24,0,False,False,False,0,3,2021-09-27T12:50:52.84,24,False,0.0
2021,3,3100,585,3,121,13,6,4,10,0,0,0,0,0,0,False,False,False,0,3,2021-09-27T12:52:42.993,0,False,0.0
2021,3,3100,590,3,121,2,26,3,5,5,0,5,0,5,0,False,False,False,0,2,2021-10-01T16:36:42.333,5,False,0.0
2021,3,3100,610,11,7732,2,51,10,-8,-3,5,-3,0,-3,0,False,False,False,0,1,2021-10-01T13:41:45.08,-3,False,0.0
2021,3,3100,620,11,7733,13,19,6,33,0,0,0,0,0,0,False,False,False,0,2,2021-10-01T16:37:01.78,0,False,
2021,3,3100,635,11,4037,2,4,10,11,11,0,11,0,11,0,False,False,False,0,3,2021-09-28T15:34:47.36,11,False,0.0
2021,3,3100,660,11,7732,2,51,9,-5,9,14,8,1,8,0,True,False,False,0,1,2021-09-27T13:13:04.913,9,False,1.0
2021,3,3100,670,11,7732,2,46,3,1,6,5,6,0,6,0,False,False,False,0,3,2021-10-01T16:15:57.283,6,False,0.0
2021,3,3100,695,3,121,2,4,6,15,18,3,18,0,18,0,False,False,False,0,2,2021-10-01T13:52:14.393,18,False,0.0
2021,3,3100,715,3,121,13,12,6,24,0,0,0,0,0,0,False,False,False,0,3,2022-02-01T20:09:58.3,0,False,0.0
2021,3,3100,720,11,1430,2,35,9,9,24,15,22,2,22,0,False,False,False,0,4,2022-02-17T21:23:41.093,24,False,2.0
2021,3,3100,730,11,4037,2,9,6,18,19,1,19,0,19,0,False,False,False,0,3,2022-02-17T21:22:19.86,19,False,0.0
2021,3,3100,740,11,4037,2,50,5,-2,22,24,20,2,20,0,False,False,False,0,2,2021-09-27T13:41:38.243,22,False,2.0
2021,3,3100,795,3,7672,13,2,10,10,0,0,0,0,0,0,False,False,False,0,2,2021-10-01T16:37:42.227,0,False,0.0
2021,3,3100,810,3,121,2,35,6,29,36,7,36,0,36,0,False,False,False,0,2,2021-09-27T13:54:37.007,36,False,0.0
2021,3,3101,20,20,1361,13,2,4,11,0,0,0,0,0,0,False,False,False,0,3,2022-02-17T23:12:13.893,0,False,0.0
2021,3,3101,35,19,2256,13,21,6,32,0,0,0,0,0,0,False,False,False,0,2,2021-10-01T14:40:07.863,0,False,0.0
2021,3,3101,40,19,1328,13,11,6,25,0,0,0,0,0,0,True,False,False,0,1,2021-10-01T19:17:17.857,0,False,0.0
2021,3,3101,50,20,5140,2,51,5,-5,9,14,9,0,9,0,False,False,False,0,1,2021-10-01T14:40:07.863,9,False,0.0
2021,3,3101,70,20,7353,2,4,10,12,12,0,12,0,12,0,False,False,False,0,3,2021-10-01T19:42:36.253,12,False,0.0
2021,3,3101,75,20,2136,2,26,7,15,17,2,17,0,17,0,False,False,False,0,2,2022-02-17T23:12:58.093,17,False,0.0
2021,3,3101,90,20,7888,13,4,10,5,0,0,0,0,0,0,False,False,False,0,4,2021-10-01T19:15:43.96,0,False,0.0
2021,3,3101,100,20,5140,2,16,4,5,11,6,11,0,11,6,False,False,False,0,1,2021-09-27T15:58:36.18,11,True,0.0
2021,3,3101,120,19,8001,2,48,4,-3,-1,2,-1,0,-1,0,False,False,False,0,1,2021-10-01T20:21:07.227,-1,False,0.0
2021,3,3101,125,19,4912,2,3,3,14,14,0,14,0,14,0,False,False,False,0,2,2021-10-01T20:23:59.99,14,False,0.0
2021,3,3101,145,20,8131,2,4,5,11,11,0,11,0,11,0,False,False,False,0,2,2021-09-27T15:34:45.11,11,False,0.0
2021,3,3101,155,20,8126,2,47,5,5,6,1,6,0,6,0,False,False,False,0,1,2022-02-17T23:29:22.333,6,True,0.0
2021,3,3101,160,20,8131,2,2,5,3,13,10,9,4,9,0,False,False,False,0,2,2022-02-14T18:31:23.7,13,False,4.0
2021,3,3101,165,20,8126,2,28,4,2,4,2,3,1,3,0,False,False,False,0,1,2021-09-27T10:24:53.93,4,False,1.0
2021,3,3101,170,20,2136,13,8,1,37,0,0,0,0,0,0,False,False,False,0,2,2021-09-27T10:27:03.833,0,False,0.0
2021,3,3101,210,19,7175,2,39,9,4,7,3,5,2,5,0,False,False,False,0,3,2021-09-27T15:48:07.26,7,False,2.0
2021,3,3101,215,19,7175,13,6,6,15,0,0,0,0,0,0,True,False,False,0,3,2021-10-01T20:25:21.52,0,False,0.0
2021,3,3101,230,20,8127,13,35,2,26,0,0,0,0,0,0,False,False,False,0,3,2021-12-20T21:56:14.567,0,False,0.0
2021,3,3101,265,19,5096,3,8,1,19,0,0,0,0,0,0,False,False,False,0,4,2021-09-27T11:04:43.323,0,False,0.0
2021,3,3101,270,19,7172,2,5,5,2,2,0,2,0,2,0,False,False,False,0,1,2021-10-01T20:28:14.543,2,False,0.0
2021,3,3101,275,19,4282,2,5,5,9,9,0,9,0,9,0,False,False,False,0,4,2021-10-01T20:28:53.34,9,False,0.0
2021,3,3101,280,19,5096,13,7,2,18,0,0,0,0,0,0,True,False,False,0,4,2021-10-01T19:18:05.243,0,False,0.0
2021,3,3101,285,19,7175,13,5,5,5,0,0,0,0,0,0,False,False,False,0,3,2022-02-17T23:26:48.993,0,False,0.0
2021,3,3101,290,19,4282,2,31,10,4,6,2,4,2,4,0,False,False,False,0,4,2021-09-27T11:17:45.147,6,False,2.0
2021,3,3101,315,20,5140,2,18,3,-5,9,14,9,0,9,0,True,False,False,0,2,2021-12-20T21:56:34.61,9,False,0.0
2021,3,3101,345,19,7175,2,35,7,16,17,1,16,1,16,0,True,False,False,0,2,2021-10-01T20:29:36.44,17,False,1.0
2021,3,3101,350,19,7175,13,6,6,16,0,0,0,0,0,0,False,False,False,0,3,2022-02-17T23:30:38.493,0,False,0.0
2021,3,3101,355,19,5096,13,13,3,3,0,0,0,0,0,0,False,False,False,0,4,2021-10-01T19:18:30.827,0,False,0.0
2021,3,3101,360,19,4282,13,35,4,11,0,0,0,0,0,0,False,False,False,0,4,2021-09-27T23:00:58.483,0,False,0.0
2021,3,3101,385,20,8131,2,2,4,7,7,0,7,0,7,6,False,False,False,0,3,2021-09-27T11:54:42.77,7,True,0.0
2021,3,3101,400,19,4912,2,2,4,6,31,25,16,15,16,0,False,False,False,1,3,2021-10-01T19:22:08.323,31,False,15.0
2021,3,3101,405,19,2256,2,5,3,8,13,5,13,0,13,0,False,False,False,0,2,2021-10-01T20:30:13.593,13,False,0.0
2021,3,3101,420,19,7175,2,5,3,6,7,1,7,0,7,0,False,False,False,0,3,2021-09-27T15:48:55.153,7,False,0.0
2021,3,3101,465,19,5096,3,13,9,9,0,0,0,0,0,0,False,False,False,0,4,2021-10-01T19:21:36.75,0,False,0.0
2021,3,3101,485,19,4282,2,5,5,3,3,0,3,0,3,0,True,False,False,0,4,2021-09-28T14:46:10.903,3,False,0.0
2021,3,3101,490,19,5096,3,49,9,0,0,0,0,0,0,0,True,False,False,0,2,2021-12-20T21:57:12.96,0,False,0.0
2021,3,3101,515,20,2136,13,12,6,33,0,0,0,0,0,0,False,False,False,0,2,2021-09-27T12:36:09.16,0,False,0.0
2021,3,3101,520,20,8131,2,13,10,3,10,7,10,0,10,0,False,False,False,0,3,2021-09-27T12:39:17.803,10,False,0.0
2021,3,3101,540,19,7175,2,39,4,5,10,5,5,5,5,0,True,False,False,1,2,2021-09-27T15:49:54.603,10,False,5.0
2021,3,3101,545,19,4912,2,2,10,8,8,0,8,0,8,0,False,False,False,0,3,2021-10-01T14:40:07.863,8,False,0.0
2021,3,3101,550,19,7175,2,7,7,21,27,6,27,0,27,0,False,False,False,0,3,2021-09-27T15:50:08.44,27,False,0.0
2021,3,3101,560,19,7175,2,5,10,7,7,0,7,0,7,0,False,False,False,0,3,2021-09-27T15:50:21.73,7,False,0.0
2021,3,3101,570,19,2256,13,7,1,32,0,0,0,0,0,0,True,False,False,0,2,2021-10-01T19:18:58.617,0,False,0.0
2021,3,3101,575,19,4282,2,5,9,9,9,0,9,0,9,0,False,False,False,0,4,2021-09-27T13:05:55.91,9,False,0.0
2021,3,3101,585,19,8001,2,4,3,4,4,0,4,0,4,0,False,False,False,0,2,2021-09-28T14:45:37.027,4,False,0.0
2021,3,3101,590,19,7175,2,42,10,4,4,0,4,0,4,0,False,False,False,0,2,2021-09-28T14:45:48.217,4,False,0.0
2021,3,3101,595,19,2256,2,31,9,0,4,4,2,2,2,0,False,False,False,0,3,2021-10-01T14:40:07.863,4,False,2.0
2021,3,3101,610,19,5096,2,44,9,-5,4,9,3,1,3,0,True,False,False,0,1,2021-09-27T13:23:16.807,4,False,1.0
2021,3,3101,635,20,5140,13,12,4,1,0,0,0,0,0,0,False,False,False,0,1,2022-02-01T20:11:36.82,0,False,0.0
2021,3,3101,650,19,2256,13,6,5,12,0,0,0,0,0,0,False,False,False,0,3,2021-09-27T13:35:17.103,0,False,0.0
2021,3,3101,655,19,4912,2,4,3,10,11,1,11,0,11,0,False,False,False,0,3,2021-10-01T20:36:36.77,11,False,0.0
2021,3,3101,660,19,7175,2,26,9,5,5,0,5,0,5,0,False,False,False,0,3,2021-09-27T15:50:54.707,5,False,0.0
2021,3,3101,700,19,4912,13,19,6,44,0,0,0,0,0,0,False,False,False,0,2,2021-12-20T21:58:05.063,0,False,0.0
2021,3,3101,705,19,2256,13,4,5,10,0,0,0,0,0,0,False,False,False,0,2,2021-09-27T14:01:39,0,False,
2021,3,3101,715,19,4912,2,29,2,17,22,5,13,9,13,6,False,False,False,0,3,2022-02-17T23:32:38.99,22,False,9.0
2021,3,3101,730,20,8131,13,12,3,13,0,0,0,0,0,0,False,False,False,0,3,2022-02-01T20:11:56.29,0,False,0.0
2021,3,3101,745,20,7353,2,3,5,12,12,0,12,0,12,0,False,False,False,0,3,2021-09-27T14:12:05.327,12,False,0.0
2021,3,3101,760,20,7353,2,5,3,6,7,1,7,0,7,0,False,False,False,0,2,2021-09-28T16:01:01.28,7,False,0.0
2021,3,3101,820,19,4282,2,13,9,3,9,6,6,3,6,0,False,False,False,0,4,2021-10-01T19:19:38.44,9,False,3.0
2021,3,3101,825,19,2256,13,8,1,46,0,0,0,0,0,0,False,False,False,0,3,2021-09-27T14:36:03.38,0,False,0.0
2021,3,3101,830,19,4912,2,2,4,5,10,5,10,0,10,0,False,False,False,0,3,2021-09-27T14:38:18.24,10,False,0.0
2021,3,3101,840,19,4912,13,19,2,39,0,0,0,0,0,0,False,False,False,0,2,2021-10-01T14:40:07.863,0,False,0.0
2021,3,3101,845,19,1212,2,45,5,-2,4,6,1,3,1,0,False,False,False,0,1,2021-09-27T14:44:28.85,4,False,3.0
2021,3,3101,850,19,1212,2,4,10,4,5,1,5,0,5,0,False,False,False,0,1,2021-09-27T14:46:31.353,5,False,0.0
2021,3,3101,865,19,7175,13,35,6,36,0,0,0,0,0,0,False,False,False,0,3,2021-10-15T01:22:03.633,0,False,0.0
2021,3,3101,870,19,7172,2,48,9,-5,-5,0,-5,0,-5,0,False,False,False,0,1,2021-09-27T14:55:19.39,-5,False,0.0
2021,3,3101,875,19,7175,2,2,9,9,10,1,9,1,9,0,False,False,False,0,3,2021-09-27T15:51:23.083,10,False,1.0
2021,3,3101,885,19,1212,2,5,9,6,14,8,14,0,14,0,False,False,False,0,4,2021-10-01T20:42:16.157,14,False,0.0
2021,3,3101,890,19,2256,13,19,6,25,0,0,0,0,0,0,False,False,False,0,2,2021-10-01T14:40:07.863,0,False,0.0
2021,3,3101,895,19,1212,13,12,6,15,0,0,0,0,0,0,False,False,False,0,1,2021-10-01T20:42:55.92,0,False,0.0
2021,3,3101,900,19,7175,13,17,8,22,0,0,0,0,0,0,False,False,False,0,3,2021-09-27T15:06:31.617,0,False,0.0
2021,3,3101,905,19,2256,13,6,6,23,0,0,0,0,0,0,False,False,False,0,2,2021-09-27T15:08:29.097,0,False,0.0
2021,3,3102,15,15,4835,2,4,10,5,6,1,6,0,6,0,True,False,False,0,2,2021-09-28T20:27:15.023,6,False,0.0
2021,3,3102,20,15,914,13,13,10,4,0,0,0,0,0,0,False,False,False,0,3,2021-09-27T09:38:50.65,0,False,0.0
2021,3,3102,35,1,245,2,4,9,3,7,4,7,0,7,0,True,False,False,0,3,2021-09-28T18:17:37.74,7,False,0.0
2021,3,3102,40,1,910,13,2,10,7,0,0,0,0,0,0,False,False,False,0,2,2021-09-27T09:48:36.807,0,False,0.0
2021,3,3102,60,15,8099,2,38,9,0,0,0,0,0,0,0,False,False,False,0,3,2021-09-27T09:55:56.253,0,False,0.0
2021,3,3102,70,1,2416,2,39,4,6,7,1,6,1,6,0,False,False,False,0,4,2021-09-27T09:59:22.367,7,False,1.0
2021,3,3102,75,1,2416,2,47,5,1,5,4,2,3,2,0,False,False,False,1,3,2021-10-01T21:40:55.027,5,False,3.0
2021,3,3102,80,1,6405,2,17,1,22,28,6,25,3,25,0,False,False,False,0,3,2021-10-01T23:33:51.737,28,False,3.0
2021,3,3102,90,1,6405,2,5,3,4,9,5,6,3,6,0,True,False,False,0,3,2021-10-01T23:29:15.583,9,False,3.0
2021,3,3102,115,15,6501,13,19,6,30,0,0,0,0,0,0,False,False,False,0,2,2021-10-01T21:40:55.027,0,False,0.0
2021,3,3102,120,15,914,2,30,5,0,8,8,5,3,5,0,True,False,False,1,4,2021-10-01T23:37:34.39,8,False,3.0
2021,3,3102,130,15,914,2,6,4,14,14,0,14,0,14,0,False,False,False,0,2,2021-09-27T10:27:53.837,14,False,0.0
2021,3,3102,145,15,4835,13,5,3,10,0,0,0,0,0,0,False,False,False,0,3,2021-10-01T23:30:32.377,0,False,0.0
2021,3,3102,160,1,2416,2,26,5,6,7,1,7,0,7,0,False,False,False,0,4,2021-10-01T23:30:41.743,7,False,0.0
2021,3,3102,185,15,914,2,35,5,9,11,2,11,0,11,0,False,False,False,0,3,2021-09-27T10:48:13.833,11,False,0.0
2021,3,3102,205,15,7591,2,5,5,13,20,7,18,2,18,0,False,False,False,0,3,2021-10-01T21:40:55.027,20,False,2.0
2021,3,3102,220,15,4835,13,6,4,10,0,0,0,0,0,0,False,False,False,0,3,2021-10-01T23:32:45.373,0,False,0.0
2021,3,3102,230,1,245,2,50,3,1,8,7,2,6,2,0,False,False,False,2,2,2021-09-27T11:03:17.993,8,False,6.0
2021,3,3102,240,1,6406,2,32,10,-3,6,9,5,1,5,0,False,False,False,0,1,2021-10-01T21:40:55.027,6,False,1.0
2021,3,3102,245,1,910,2,4,5,9,10,1,9,1,9,0,False,False,False,0,2,2021-09-28T18:21:32.06,10,False,1.0
2021,3,3102,265,15,6501,13,6,4,13,0,0,0,0,0,0,False,False,False,0,3,2022-02-17T22:01:07.893,0,False,0.0
2021,3,3102,290,1,4587,2,46,3,3,10,7,4,6,4,0,False,False,False,1,1,2021-10-01T23:54:25.703,10,False,6.0
2021,3,3102,305,1,245,2,9,6,17,29,12,27,2,27,0,False,False,False,0,3,2021-09-27T16:16:47.23,29,False,
2021,3,3102,310,1,8439,2,51,10,-5,-2,3,-2,0,-2,0,False,False,False,1,3,2021-10-01T23:37:49.197,-2,False,0.0
2021,3,3102,320,15,7591,2,5,5,5,7,2,6,1,6,0,False,False,False,0,3,2021-09-27T11:38:39.933,7,False,1.0
2021,3,3102,330,15,7591,2,45,5,1,9,8,7,2,7,0,True,False,False,0,2,2022-02-17T22:01:54.483,9,False,2.0
2021,3,3102,360,15,7591,2,39,4,6,12,6,9,3,9,0,False,False,False,1,3,2021-10-01T23:38:20.83,12,False,3.0
2021,3,3102,365,15,914,2,6,4,11,13,2,13,0,13,0,False,False,False,0,3,2021-10-01T23:53:18.01,13,False,0.0
2021,3,3102,375,15,914,2,4,5,4,5,1,5,0,5,0,True,False,False,0,2,2021-09-28T20:27:53.447,5,False,0.0
2021,3,3102,380,15,6501,2,7,3,12,12,0,12,0,12,6,False,False,False,0,2,2021-09-27T11:57:42.517,12,True,0.0
2021,3,3102,410,1,6406,2,18,3,5,12,7,6,6,6,0,False,False,False,1,2,2021-10-01T23:38:51.42,12,False,6.0
2021,3,3102,440,1,6405,2,4,10,5,5,0,5,0,5,0,False,False,False,0,3,2021-09-27T12:10:14.543,5,False,0.0
2021,3,3102,445,1,245,2,5,3,6,6,0,6,0,6,0,False,False,False,0,2,2021-09-27T15:41:27.87,6,False,0.0
2021,3,3102,460,1,6405,13,8,1,43,0,0,0,0,0,0,False,False,False,0,3,2021-09-27T12:19:46.253,0,False,0.0
2021,3,3102,470,15,4835,13,11,6,17,0,0,0,0,0,0,False,False,False,0,4,2021-09-27T12:23:52.403,0,False,0.0
2021,3,3102,475,15,914,13,5,3,9,0,0,0,0,0,0,False,False,False,0,2,2021-10-01T23:52:40.817,0,False,0.0
2021,3,3102,490,1,910,2,7,6,20,34,14,25,9,25,0,True,False,False,2,3,2021-09-28T18:20:10.677,34,False,9.0
2021,3,3102,495,1,6405,2,3,5,8,8,0,8,0,8,0,False,False,False,0,3,2021-10-01T23:50:53.683,8,True,0.0
2021,3,3102,515,1,245,3,29,6,16,0,0,0,0,0,0,False,False,False,0,2,2021-10-15T01:22:54.25,0,False,0.0
2021,3,3102,520,1,6405,2,12,9,4,3,-1,4,-1,4,0,False,False,False,0,3,2021-09-27T12:44:04.36,3,False,-1.0
2021,3,3102,525,1,245,13,2,4,10,0,0,0,0,0,0,False,False,False,0,3,2021-10-01T21:40:55.027,0,False,0.0
2021,3,3102,530,1,6406,13,2,9,3,0,0,0,0,0,0,False,False,False,0,2,2021-09-28T18:19:19.323,0,False,0.0
2021,3,3102,535,1,6406,2,32,10,-3,7,10,-1,8,-1,0,False,False,False,1,1,2021-10-01T23:39:09.653,7,False,8.0
2021,3,3102,600,1,6406,2,48,3,-4,9,13,1,8,1,0,False,False,False,0,1,2021-10-01T21:40:55.027,9,False,8.0
2021,3,3102,605,1,6405,2,2,4,6,18,12,15,3,15,0,False,False,False,0,3,2021-10-01T23:29:36.287,18,False,3.0
2021,3,3102,615,1,6405,2,7,2,19,33,14,21,12,21,0,False,False,False,2,3,2021-09-27T13:22:59.083,33,False,12.0
2021,3,3102,640,15,4835,13,11,5,4,0,0,0,0,0,0,True,False,False,0,4,2022-02-17T22:04:43.847,0,False,0.0
2021,3,3102,670,15,914,2,13,10,5,10,5,8,2,8,0,False,False,False,0,3,2021-09-27T13:39:16.943,10,False,
2021,3,3102,690,1,910,2,5,3,13,13,0,13,0,13,0,True,False,False,0,2,2021-09-28T18:20:35.54,13,False,0.0
2021,3,3102,700,1,6406,2,16,10,0,1,1,1,0,1,0,False,False,False,0,1,2022-02-17T22:05:28.23,1,False,0.0
2021,3,3102,705,1,910,2,8,1,36,36,0,36,0,36,0,False,False,False,0,2,2021-09-27T13:58:46.683,36,False,0.0
2021,3,3102,715,1,8439,2,51,3,-4,3,7,-2,5,-2,0,True,False,False,1,3,2021-10-01T23:48:52.14,3,False,5.0
2021,3,3102,725,1,6406,2,5,5,5,7,2,6,1,6,0,False,False,False,0,3,2021-09-27T14:08:49.31,7,False,1.0
2021,3,3102,755,15,914,2,4,3,7,11,4,7,4,7,0,False,False,False,0,2,2021-09-27T14:17:27.497,11,False,4.0
2021,3,3102,765,15,8099,2,12,3,4,6,2,5,1,5,0,False,False,False,0,1,2021-09-27T14:21:36.56,6,False,1.0
2021,3,3102,780,15,6501,2,5,3,11,12,1,12,0,12,0,False,False,False,0,2,2021-09-27T14:27:35.72,12,False,0.0
2021,3,3102,785,15,8343,2,5,5,3,2,-1,4,-2,4,0,False,True,False,0,4,2022-02-17T22:05:46.983,-1,False,-2.0
2021,3,3102,805,1,910,2,4,8,19,19,0,19,0,19,0,False,False,False,0,2,2022-02-01T20:19:50.613,19,False,0.0
2021,3,3102,835,1,6406,2,48,3,-4,7,11,5,2,5,0,False,False,False,2,1,2021-10-01T23:48:20.363,7,False,2.0
2021,3,3102,850,15,8099,2,32,3,-2,5,7,5,0,5,0,False,False,False,1,1,2022-02-17T22:06:14.16,5,True,
2021,3,3102,855,15,8099,2,48,9,-5,12,17,7,5,7,0,False,False,False,1,1,2021-10-01T23:44:09.453,12,False,5.0
2021,3,3102,865,15,8099,2,4,3,7,9,2,9,0,9,0,False,True,False,0,2,2021-09-27T15:02:32.37,9,False,0.0
2021,3,3102,870,15,8099,2,4,4,4,13,9,9,4,9,0,False,False,False,0,1,2021-10-01T21:40:55.027,13,False,4.0
2021,3,3102,880,15,8099,2,48,9,-1,6,7,3,3,3,0,False,False,False,0,1,2021-10-01T23:58:15.92,6,False,3.0
2021,3,3102,885,15,1116,13,12,7,22,0,0,0,0,0,0,False,False,False,0,2,2021-10-01T23:32:10.007,0,False,0.0
2021,3,3102,890,15,6501,2,12,6,15,25,10,23,2,23,0,True,False,False,0,2,2021-10-01T23:59:06.443,25,False,2.0
2021,3,3102,900,15,4835,2,38,4,5,9,4,8,1,8,0,False,False,False,0,4,2021-10-01T21:40:55.027,9,False,1.0
2021,3,3103,15,4,6983,3,46,3,-1,0,0,0,0,0,0,False,False,False,0,1,2021-09-27T10:24:14.783,0,False,0.0
2021,3,3103,25,4,7646,2,4,8,18,23,5,23,0,23,0,False,False,False,0,3,2022-02-17T19:44:12.737,23,False,0.0
2021,3,3103,34,4,213,2,4,10,6,11,5,8,3,8,0,False,False,False,0,3,2021-10-01T19:28:02.37,11,False,3.0
2021,3,3103,40,4,2853,2,13,4,3,13,10,11,2,11,0,True,False,False,0,3,2021-09-28T17:35:10.603,13,False,2.0
2021,3,3103,45,4,6990,2,12,5,1,1,0,1,0,1,0,False,False,False,0,4,2022-02-01T20:28:08.3,1,False,0.0
2021,3,3103,50,4,213,2,12,2,28,28,0,28,0,28,6,False,False,False,0,3,2022-02-01T20:28:25.17,28,True,0.0
2021,3,3103,70,32,7128,2,13,10,1,0,-1,0,0,0,0,False,False,False,0,3,2021-09-27T10:51:11.127,0,False,0.0
2021,3,3103,75,32,7128,2,13,10,1,16,15,16,0,16,0,False,False,False,0,3,2021-09-27T17:48:11.55,16,True,
2021,3,3103,80,32,1427,2,46,3,1,11,10,8,3,8,0,False,False,False,0,3,2021-09-27T17:56:06.537,11,False,3.0
2021,3,3103,90,4,2853,2,4,5,3,3,0,3,0,3,0,False,False,False,0,2,2021-09-27T18:08:59.81,3,False,0.0
2021,3,3103,105,4,2853,13,19,2,39,0,0,0,0,0,0,False,False,False,0,2,2021-10-01T18:52:10.92,0,False,0.0
2021,3,3103,110,4,7645,2,48,9,-3,7,10,6,1,6,0,False,False,False,0,1,2022-02-17T19:45:51.12,7,False,1.0
2021,3,3103,115,4,213,2,13,9,5,9,4,9,0,9,0,False,False,False,0,3,2021-10-01T19:29:20.753,9,False,0.0
2021,3,3103,120,4,2853,13,23,7,43,0,0,0,0,0,0,False,False,False,0,2,2021-10-01T15:33:46.663,0,False,0.0
2021,3,3103,125,4,594,2,5,5,7,7,0,7,0,7,0,False,False,False,0,3,2021-09-27T11:21:21.02,7,False,0.0
2021,3,3103,135,4,6983,2,46,3,0,0,0,0,0,0,0,True,False,False,0,3,2021-09-28T17:35:20.393,0,False,0.0
2021,3,3103,140,32,8527,13,19,6,35,0,0,0,0,0,0,False,False,False,0,2,2021-10-01T19:21:21.463,0,False,0.0
2021,3,3103,150,32,1427,2,4,4,8,17,9,8,9,8,0,False,True,True,1,3,2021-10-01T19:22:49.03,15,False,9.0
2021,3,3103,165,4,2853,13,4,3,10,0,0,0,0,0,0,False,False,False,0,3,2021-09-27T12:17:15.843,0,False,
2021,3,3103,170,4,7645,2,16,9,2,17,15,10,7,10,0,False,False,False,2,1,2021-10-01T19:07:26.587,17,False,7.0
2021,3,3103,195,4,594,2,4,5,4,4,0,4,0,4,0,False,False,False,0,3,2021-09-27T12:23:50.64,4,False,0.0
2021,3,3103,205,4,7645,2,26,5,2,7,5,7,0,7,6,False,False,False,0,1,2021-09-27T12:27:27.91,7,True,0.0
2021,3,3103,220,32,7128,2,12,5,10,10,0,10,0,10,0,False,False,False,0,3,2021-10-01T15:27:59.96,10,False,0.0
2021,3,3103,230,32,7128,13,12,3,4,0,0,0,0,0,0,False,False,False,0,3,2022-02-17T19:58:27.993,0,False,0.0
2021,3,3103,240,4,594,13,12,5,14,0,0,0,0,0,0,True,False,False,0,3,2021-10-01T18:52:47.57,0,False,0.0
2021,3,3103,245,4,6953,2,29,5,14,14,0,14,0,14,6,False,False,False,0,2,2021-10-01T15:33:46.663,14,True,0.0
2021,3,3103,265,32,7807,2,48,5,-5,73,78,10,63,10,6,False,False,False,0,1,2022-02-17T19:56:12.417,73,False,63.0
2021,3,3103,290,32,1427,2,4,4,10,14,4,14,0,14,0,False,False,False,0,3,2021-09-27T17:56:49.26,14,False,0.0
2021,3,3103,295,32,7807,3,47,5,0,0,0,0,0,0,0,False,False,False,0,1,2021-09-28T21:11:23.04,0,False,0.0
2021,3,3103,315,4,594,2,4,4,11,18,7,14,4,14,0,False,False,False,0,2,2021-09-28T22:59:21.677,18,False,4.0
2021,3,3103,325,4,594,2,4,3,1,2,1,2,0,2,0,False,False,False,0,3,2021-09-27T13:17:49.447,2,False,0.0
2021,3,3103,330,4,6953,3,13,4,4,0,0,0,0,0,0,False,False,False,0,3,2022-02-17T19:47:42.947,0,False,0.0
2021,3,3103,350,32,2675,2,4,4,4,7,3,7,0,7,0,True,False,False,0,3,2021-10-01T15:33:46.663,7,False,0.0
2021,3,3103,360,4,213,2,19,6,33,41,8,35,6,35,0,False,False,False,0,3,2021-10-01T19:31:01.127,41,False,6.0
2021,3,3103,365,4,594,2,51,5,-3,7,10,6,1,6,0,True,False,False,0,3,2021-10-01T19:32:12.36,7,False,1.0
2021,3,3103,420,32,1427,13,4,5,8,0,0,0,0,0,0,False,False,False,0,3,2021-10-01T18:58:43.333,0,False,
2021,3,3103,425,32,3885,2,6,9,2,4,2,4,0,4,0,True,False,False,0,2,2021-09-28T21:28:15.007,4,False,0.0
2021,3,3103,430,32,2675,13,5,5,6,0,0,0,0,0,0,False,False,False,0,3,2021-09-27T14:18:50.64,0,False,0.0
2021,3,3103,435,32,2675,13,39,4,6,0,0,0,0,0,0,False,False,False,0,3,2021-09-27T14:20:28.62,0,False,0.0
2021,3,3103,445,4,2853,2,4,5,13,13,0,13,0,13,0,False,False,False,0,2,2021-09-27T14:24:13.903,13,True,0.0
2021,3,3103,450,4,594,2,12,8,17,22,5,16,6,16,0,False,False,False,0,3,2022-02-01T20:29:18.14,22,False,6.0
2021,3,3103,460,4,2853,2,4,5,11,11,0,11,0,11,0,False,False,False,0,2,2021-09-27T14:29:37.653,11,False,0.0
2021,3,3103,470,4,6953,2,47,5,2,5,3,5,0,5,0,False,False,False,0,3,2021-09-27T14:31:30.73,5,False,0.0
2021,3,3103,490,32,7128,2,5,2,15,15,0,15,0,15,0,False,False,False,0,3,2021-09-28T21:12:36.63,15,False,0.0
2021,3,3103,505,32,7128,13,4,3,10,0,0,0,0,0,0,False,False,False,0,2,2021-09-27T14:59:11.577,0,False,0.0
2021,3,3103,520,4,594,2,2,10,8,11,3,9,2,9,0,False,False,False,0,3,2021-09-27T15:02:45.88,11,False,2.0
2021,3,3103,525,4,2853,2,6,3,4,9,5,7,2,7,0,False,False,False,0,3,2021-09-27T15:05:44.887,9,False,2.0
2021,3,3103,535,4,594,2,47,5,3,5,2,3,2,3,0,False,False,False,0,3,2021-10-01T18:56:53.84,5,False,2.0
2021,3,3103,545,4,594,2,51,9,0,6,6,2,4,2,0,False,False,False,0,3,2021-10-01T15:34:49.653,6,False,4.0
2021,3,3103,550,4,2853,2,2,9,10,13,3,10,3,10,0,True,False,False,0,3,2021-09-28T17:35:55.963,13,False,3.0
2021,3,3103,560,4,2853,13,19,6,27,0,0,0,0,0,0,False,False,False,0,2,2021-10-01T18:57:06.967,0,False,0.0
2021,3,3103,565,4,594,2,4,10,5,10,5,10,0,10,0,False,False,False,1,3,2021-09-27T15:22:53.143,10,False,0.0
2021,3,3103,570,4,6953,2,4,4,11,11,0,11,0,11,0,False,False,False,0,4,2021-09-28T17:37:48.863,11,False,0.0
2021,3,3103,585,4,594,2,50,3,-3,6,9,4,2,4,0,False,False,False,0,3,2021-10-01T18:50:33.6,6,False,2.0
2021,3,3103,600,4,213,2,5,3,5,5,0,5,0,5,6,False,False,False,0,2,2021-10-01T18:50:19.267,5,True,0.0
2021,3,3103,630,32,2675,13,12,1,19,0,0,0,0,0,0,False,False,False,0,3,2021-10-01T18:58:28.053,0,False,0.0
2021,3,3103,635,4,7937,13,9,6,17,0,0,0,0,0,0,False,False,False,0,1,2021-09-28T22:59:21.677,0,False,0.0
2021,3,3103,645,4,594,13,2,4,5,0,0,0,0,0,0,True,False,False,0,3,2021-10-01T17:44:32.74,0,False,0.0
2021,3,3103,670,32,8527,3,13,9,4,0,0,0,0,0,0,False,False,False,0,3,2021-09-27T16:14:43.833,0,False,0.0
2021,3,3103,680,4,213,13,2,4,6,0,0,0,0,0,0,False,False,False,0,3,2021-09-27T16:17:58.63,0,False,0.0
2021,3,3103,695,4,2853,13,12,10,8,0,0,0,0,0,0,False,False,False,0,2,2021-09-27T16:21:29.48,0,False,0.0
2021,3,3103,710,32,6430,3,4,3,3,0,0,0,0,0,0,False,False,False,0,3,2021-10-01T18:57:48.863,0,False,0.0
2021,3,3103,715,32,3885,2,4,4,3,11,8,8,3,8,0,False,False,False,0,1,2021-09-27T17:00:02.663,11,False,3.0
2021,3,3103,725,32,2877,2,12,4,-5,-2,3,-2,0,-2,0,False,False,False,0,6,2022-02-17T19:59:28.277,-2,True,0.0
2021,3,3103,740,4,6953,2,17,4,12,19,7,15,4,15,0,False,False,False,0,4,2022-02-17T19:55:19.8,19,False,4.0
2021,3,3103,785,32,6430,2,4,5,9,15,6,10,5,10,0,False,False,False,0,2,2021-09-27T17:18:51.577,15,False,5.0
2021,3,3103,795,32,7807,13,31,5,1,0,0,0,0,0,0,False,False,False,0,1,2021-09-27T18:14:51.72,0,False,
2021,3,3103,800,32,7128,2,2,3,10,37,27,10,27,10,0,False,False,False,3,2,2021-10-01T19:08:02.673,37,False,27.0
2021,3,3103,805,32,7128,13,12,3,7,0,0,0,0,0,0,False,False,False,0,3,2021-09-27T17:27:26.753,0,False,0.0
2021,3,3103,820,32,1427,2,5,3,2,2,0,2,0,2,6,False,False,False,0,3,2021-10-01T15:33:46.663,2,True,0.0
2021,3,3103,850,4,6990,2,47,5,1,1,0,1,0,1,0,False,False,False,0,4,2021-10-01T19:39:56.637,1,False,0.0
2021,3,3104,10,10,4930,2,5,3,4,6,2,5,1,5,0,False,False,False,0,3,2021-09-27T09:11:34.503,6,False,1.0
2021,3,3104,15,10,4930,2,2,9,8,10,2,9,1,9,0,False,False,False,0,3,2021-09-27T09:16:34.67,10,False,1.0
2021,3,3104,20,10,7701,13,7,6,22,0,0,0,0,0,0,False,False,False,0,3,2021-09-27T09:22:06.31,0,False,0.0
2021,3,3104,30,10,282,13,44,3,-5,0,0,0,0,0,0,False,False,False,0,1,2021-09-27T10:30:19.46,0,False,0.0
2021,3,3104,40,22,5080,2,4,9,11,11,0,11,0,11,0,False,False,False,0,3,2021-09-27T09:34:17.803,11,False,0.0
2021,3,3104,55,22,8454,13,5,3,11,0,0,0,0,0,0,False,False,False,0,2,2021-09-27T09:40:49.43,0,False,0.0
2021,3,3104,70,10,6281,2,4,5,8,8,0,8,0,8,0,False,False,False,0,2,2021-09-27T09:51:42.187,8,False,0.0
2021,3,3104,85,10,6281,2,39,4,5,5,0,5,0,5,0,False,False,False,0,3,2021-09-27T09:57:04.25,5,False,0.0
2021,3,3104,95,10,7701,2,5,2,16,28,12,25,3,25,0,False,False,False,0,3,2021-09-27T10:03:39.083,28,False,3.0
2021,3,3104,105,10,6840,2,32,10,4,6,2,4,2,4,0,False,False,False,0,4,2021-12-09T12:12:58.793,6,False,2.0
2021,3,3104,140,22,5080,13,4,10,5,0,0,0,0,0,0,False,False,False,0,3,2021-09-27T10:25:00.173,0,False,0.0
2021,3,3104,155,10,8541,2,46,3,3,17,14,13,4,13,0,False,False,False,0,1,2021-09-27T10:29:43.9,17,False,4.0
2021,3,3104,170,10,7703,2,5,3,4,6,2,5,1,5,0,False,False,False,0,3,2021-09-27T10:38:37.887,6,False,1.0
2021,3,3104,185,10,6840,13,7,2,17,0,0,0,0,0,0,True,False,False,0,3,2021-10-01T22:48:01.257,0,False,0.0
2021,3,3104,205,22,2629,2,31,9,4,4,0,4,0,4,0,True,False,False,0,4,2021-10-01T21:17:47.447,4,False,0.0
2021,3,3104,210,22,2629,2,13,3,8,8,0,8,0,8,0,False,False,False,0,4,2021-10-01T21:18:05.977,8,False,0.0
2021,3,3104,215,22,5080,2,4,10,6,7,1,6,1,6,0,False,False,False,0,3,2021-09-27T10:51:37.293,7,False,1.0
2021,3,3104,225,22,5080,2,2,9,4,6,2,5,1,5,0,False,False,False,0,2,2021-09-27T10:55:42.493,6,False,1.0
2021,3,3104,230,22,8454,2,51,5,-4,5,9,2,3,2,0,True,False,False,1,1,2021-10-01T21:17:47.447,5,False,3.0
2021,3,3104,235,22,8451,3,16,10,6,0,0,0,0,0,0,False,False,False,0,1,2021-09-27T11:03:40.74,0,False,0.0
2021,3,3104,240,22,6812,2,46,3,2,6,4,2,4,2,0,False,False,False,0,1,2021-10-01T22:49:16.82,6,False,4.0
2021,3,3104,250,22,8451,2,48,10,-7,-5,2,-6,1,-6,0,False,False,False,0,1,2021-09-27T11:11:10.84,-5,False,1.0
2021,3,3104,255,22,5080,13,12,6,33,0,0,0,0,0,0,False,False,False,0,2,2021-10-01T21:21:50.613,0,False,0.0
2021,3,3104,285,10,6840,2,13,10,2,9,7,8,1,8,0,False,False,False,0,4,2021-09-27T11:27:43.17,9,False,1.0
2021,3,3104,315,10,7701,13,7,6,23,0,0,0,0,0,0,False,False,False,0,3,2021-09-27T11:38:02.117,0,False,0.0
2021,3,3104,340,10,4930,2,19,2,22,27,5,22,5,22,0,False,False,False,0,3,2021-09-27T11:49:54.513,27,False,5.0
2021,3,3104,345,10,6281,2,2,10,5,6,1,4,2,4,0,False,False,False,0,2,2021-09-27T11:52:16.447,6,False,2.0
2021,3,3104,355,10,8541,3,48,3,-4,0,0,0,0,0,0,False,False,False,0,1,2021-09-27T12:02:07.827,0,False,0.0
2021,3,3104,360,10,6281,13,19,6,20,0,0,0,0,0,0,False,False,False,0,2,2021-09-27T12:03:47.707,0,False,
2021,3,3104,380,22,8454,2,5,3,13,14,1,14,0,14,0,False,False,False,0,3,2021-09-27T12:13:30.31,14,True,0.0
2021,3,3104,395,22,6812,13,16,9,6,0,0,0,0,0,0,False,False,False,0,1,2021-09-27T12:16:34.113,0,False,0.0
2021,3,3104,415,22,5080,3,6,4,14,0,0,0,0,0,0,False,False,False,0,3,2021-10-01T21:17:47.447,0,False,0.0
2021,3,3104,430,22,8454,13,35,9,5,0,0,0,0,0,0,False,False,False,0,3,2021-09-27T12:31:59.4,0,False,0.0
2021,3,3104,455,10,282,2,44,3,-1,21,22,13,8,13,0,False,False,False,2,1,2021-09-27T12:48:40.507,21,False,8.0
2021,3,3104,460,10,7082,2,51,5,-2,-3,-1,-3,0,-3,0,False,False,False,0,2,2022-02-14T18:35:25.437,-3,False,0.0
2021,3,3104,505,22,2391,2,6,9,3,5,2,4,1,4,0,False,False,False,0,1,2021-09-27T13:04:51.263,5,False,1.0
2021,3,3104,510,22,8454,13,3,3,9,0,0,0,0,0,0,False,False,False,0,2,2021-09-27T13:08:27.887,0,False,0.0
2021,3,3104,530,10,8541,2,16,4,4,9,5,7,2,7,0,False,False,False,0,1,2021-09-27T13:19:18.86,9,False,2.0
2021,3,3104,545,22,8454,2,34,4,-4,3,7,1,2,1,0,True,False,False,0,3,2021-09-27T13:24:00.097,3,False,2.0
2021,3,3104,550,22,6270,2,35,6,20,22,2,21,1,21,0,False,False,False,0,3,2021-09-27T13:30:06.017,22,False,1.0
2021,3,3104,555,22,2391,2,53,10,-6,8,14,3,5,3,0,False,False,False,0,4,2021-09-27T13:28:54.147,8,False,
2021,3,3104,560,22,4997,2,4,10,7,7,0,7,0,7,0,False,False,False,0,3,2021-09-27T13:32:22.353,7,False,0.0
2021,3,3104,565,22,5080,2,4,3,5,4,-1,4,0,4,0,False,False,False,0,2,2021-09-27T13:34:17.117,4,False,0.0
2021,3,3104,580,22,6812,3,13,10,3,0,0,0,0,0,0,True,False,False,0,2,2021-09-27T13:37:51.427,0,False,0.0
2021,3,3104,600,10,4702,2,13,3,2,10,8,8,2,8,0,False,False,False,0,4,2021-10-01T22:55:55.47,10,False,
2021,3,3104,605,10,8541,2,46,3,2,7,5,5,2,5,0,False,False,False,0,1,2021-09-27T13:55:41.947,7,False,2.0
2021,3,3104,610,10,4930,2,43,6,22,24,2,24,0,24,0,False,False,False,0,4,2022-02-17T20:33:05.703,24,False,0.0
2021,3,3104,620,10,6281,2,17,9,12,14,2,14,0,14,0,False,False,False,0,3,2021-09-28T18:02:53.31,14,False,0.0
2021,3,3104,630,10,6281,2,18,10,-3,4,7,1,3,1,0,True,False,False,0,2,2021-10-01T22:40:40.637,4,False,3.0
2021,3,3104,650,22,8451,2,47,5,-1,10,11,2,8,2,0,False,False,False,1,1,2021-09-27T14:10:46.977,10,False,8.0
2021,3,3104,655,22,4997,2,7,6,22,23,1,23,0,23,0,False,False,False,0,3,2021-09-27T15:32:05.173,23,False,0.0
2021,3,3104,660,22,6812,13,16,9,4,0,0,0,0,0,0,False,False,False,0,1,2021-09-27T14:15:19.54,0,False,0.0
2021,3,3104,665,22,5080,13,5,10,10,0,0,0,0,0,0,False,False,False,0,3,2021-09-27T14:17:12.637,0,False,0.0
2021,3,3104,680,10,4930,2,29,6,28,31,3,28,3,28,0,False,False,False,0,2,2021-09-27T14:24:27.763,31,False,3.0
2021,3,3104,690,22,6270,2,5,5,3,4,1,4,0,4,0,True,False,False,0,3,2021-09-27T14:28:54.397,4,False,0.0
2021,3,3104,695,22,6812,13,31,9,3,0,0,0,0,0,0,False,False,False,0,1,2021-10-01T21:17:47.447,0,False,0.0
2021,3,3104,775,22,5080,2,5,5,13,13,0,13,0,13,0,False,False,False,0,3,2021-10-01T22:54:29.753,13,True,0.0
2021,3,3104,780,22,5080,13,3,5,12,0,0,0,0,0,0,False,False,False,0,2,2021-10-01T22:39:46.757,0,False,0.0
2021,3,3104,785,22,7118,2,5,3,12,13,1,13,0,13,0,False,False,False,0,2,2021-10-01T22:54:58.567,13,True,0.0
2021,3,3104,790,22,6270,3,12,9,22,0,0,0,0,0,0,False,False,False,0,3,2021-10-01T22:43:06.863,0,False,0.0
2021,3,3105,15,23,7688,13,11,6,19,0,0,0,0,0,0,True,False,False,0,3,2021-09-27T09:08:05.607,0,False,0.0
2021,3,3105,35,17,3356,13,46,3,0,0,0,0,0,0,0,False,False,False,0,1,2021-09-27T09:15:57.067,0,False,0.0
2021,3,3105,40,17,2253,2,2,9,4,8,4,4,4,4,0,False,False,False,0,2,2021-10-01T22:51:53.5,8,False,4.0
2021,3,3105,50,17,6276,13,32,10,-3,0,0,0,0,0,0,False,False,False,0,4,2021-10-01T22:52:54.34,0,False,0.0
2021,3,3105,70,23,7250,2,6,10,13,24,11,21,3,21,0,False,False,False,0,3,2022-02-17T22:28:56.307,24,False,3.0
2021,3,3105,75,23,2994,2,2,10,4,7,3,6,1,6,0,False,False,False,0,4,2021-09-27T17:10:52.4,7,False,1.0
2021,3,3105,85,23,7689,2,13,10,2,23,21,2,21,2,0,False,False,False,2,2,2021-10-01T22:35:36.673,23,False,21.0
2021,3,3105,95,23,7246,13,13,10,6,0,0,0,0,0,0,False,False,False,0,3,2021-10-01T22:54:02.7,0,False,0.0
2021,3,3105,115,23,7250,2,50,3,-3,6,9,3,3,3,0,False,False,False,0,3,2021-10-01T19:25:56.563,6,False,3.0
2021,3,3105,145,17,8483,2,13,4,5,5,0,5,0,5,0,False,False,False,0,3,2021-10-01T22:55:54.667,5,False,0.0
2021,3,3105,165,23,4307,13,5,9,0,0,0,0,0,0,0,False,False,False,0,1,2021-09-27T10:05:48.187,0,False,0.0
2021,3,3105,170,23,4307,2,5,10,3,10,7,4,6,4,0,False,False,False,0,1,2021-09-27T10:07:48.233,10,False,6.0
2021,3,3105,175,23,7688,13,5,5,4,0,0,0,0,0,0,False,False,False,0,3,2021-09-27T10:09:59.04,0,False,0.0
2021,3,3105,180,23,7250,13,5,3,10,0,0,0,0,0,0,False,False,False,0,3,2021-09-27T10:11:47.823,0,False,0.0
2021,3,3105,185,23,7250,2,24,6,24,25,1,25,0,25,0,False,False,False,0,3,2021-09-27T10:14:43.14,25,False,0.0
2021,3,3105,195,23,4307,13,24,6,21,0,0,0,0,0,0,False,False,False,0,1,2021-09-27T10:35:19.177,0,False,0.0
2021,3,3105,200,23,7246,2,38,9,2,8,6,4,4,4,0,False,False,False,0,4,2021-09-27T10:37:03.713,8,False,4.0
2021,3,3105,210,17,8483,2,18,3,0,-1,-1,-1,0,-1,0,False,False,False,0,2,2021-10-01T23:31:49.817,-1,False,0.0
2021,3,3105,235,23,4307,13,4,10,3,0,0,0,0,0,0,False,False,False,0,1,2021-09-29T00:00:09.47,0,False,0.0
2021,3,3105,240,23,7688,2,7,2,18,18,0,18,0,18,0,False,False,False,0,3,2021-09-27T10:59:15.853,18,True,0.0
2021,3,3105,250,23,2994,2,2,9,6,8,2,6,2,6,0,False,False,False,0,2,2021-09-27T17:11:39.897,8,False,2.0
2021,3,3105,260,23,3708,13,24,6,20,0,0,0,0,0,0,False,False,False,0,1,2021-09-27T11:06:29.243,0,False,0.0
2021,3,3105,280,17,2253,2,4,10,12,12,0,12,0,12,0,False,False,False,0,2,2021-10-01T19:25:56.563,12,False,0.0
2021,3,3105,290,17,3951,2,12,10,8,8,0,8,0,8,0,False,False,False,0,2,2021-09-27T11:14:50.583,8,False,0.0
2021,3,3105,305,17,6274,2,55,4,-3,4,7,4,0,4,0,False,False,False,0,4,2021-10-01T22:31:00.553,4,False,0.0
2021,3,3105,320,17,7024,13,48,9,-8,0,0,0,0,0,0,False,False,False,0,1,2021-10-15T01:23:58.553,0,False,0.0
2021,3,3105,330,23,3708,2,45,10,-5,5,10,1,4,1,0,False,False,False,0,1,2022-02-17T22:42:11.687,5,False,4.0
2021,3,3105,340,23,7688,2,35,7,23,23,0,23,0,23,0,False,False,False,0,3,2021-10-01T23:08:15.74,23,False,0.0
2021,3,3105,345,23,3708,3,32,3,1,0,0,0,0,0,0,False,False,False,0,1,2021-09-27T11:36:41.7,0,False,0.0
2021,3,3105,355,23,2994,2,13,3,5,12,7,12,0,12,0,False,False,False,0,4,2021-09-27T17:12:05.823,12,False,0.0
2021,3,3105,370,23,7688,2,46,3,1,21,20,21,0,21,0,True,False,False,1,3,2021-09-27T11:44:20.733,21,False,0.0
2021,3,3105,385,23,7240,2,47,10,1,1,0,0,1,0,6,False,False,False,0,1,2022-02-17T22:31:49.407,1,False,1.0
2021,3,3105,400,17,3951,3,12,2,25,0,0,0,0,0,0,False,False,False,0,2,2022-02-17T22:32:42.233,0,False,
2021,3,3105,430,17,3951,2,4,9,8,10,2,9,1,9,0,False,False,False,0,2,2021-09-27T12:07:09.17,10,False,1.0
2021,3,3105,440,17,6274,2,5,3,10,9,-1,9,0,9,0,False,False,False,0,3,2021-09-27T12:09:29.093,9,False,0.0
2021,3,3105,445,17,8483,2,39,4,5,7,2,5,2,5,0,False,False,False,0,3,2021-10-01T19:25:56.563,7,False,2.0
2021,3,3105,455,17,3356,13,28,9,-5,0,0,0,0,0,0,False,False,False,0,1,2021-10-01T22:33:34.7,0,False,0.0
2021,3,3105,460,17,8483,2,13,4,4,4,0,4,0,4,0,False,False,False,0,3,2021-10-01T19:25:56.563,4,False,0.0
2021,3,3105,485,17,8483,2,34,10,-4,13,17,9,4,9,0,True,False,False,0,3,2021-10-01T23:11:58.73,5,False,4.0
2021,3,3105,495,17,7024,2,48,9,-3,4,7,4,0,4,0,False,False,False,0,1,2021-09-27T12:34:52.677,4,False,0.0
2021,3,3105,500,17,8483,2,2,9,3,4,1,4,0,4,0,False,True,False,0,3,2021-09-27T12:37:02.693,4,False,0.0
2021,3,3105,515,23,7688,13,23,6,52,0,0,0,0,0,0,False,False,False,0,3,2021-10-01T19:25:56.563,0,False,0.0
2021,3,3105,520,23,2994,2,51,10,-2,4,6,1,3,1,0,False,False,False,0,3,2021-09-27T17:12:31.92,4,False,3.0
2021,3,3105,525,23,4949,2,26,3,1,15,14,14,1,14,0,True,False,False,0,2,2021-10-01T22:33:44.9,15,False,1.0
2021,3,3105,545,23,7246,2,5,5,6,11,5,10,1,10,0,False,False,False,0,3,2021-09-27T12:54:41.1,11,False,
2021,3,3105,555,23,7250,2,4,9,4,10,6,8,2,8,0,False,False,False,0,3,2021-09-27T12:57:54.597,10,False,2.0
2021,3,3105,560,23,7250,2,26,10,6,12,6,10,2,10,6,False,False,False,0,3,2021-10-01T22:34:52.54,12,False,2.0
2021,3,3105,575,17,2253,13,19,6,30,0,0,0,0,0,0,False,False,False,0,2,2021-09-27T13:03:51.957,0,False,0.0
2021,3,3105,580,17,8483,2,50,10,-4,2,6,2,0,2,0,False,False,False,0,2,2021-09-27T13:06:09.46,2,False,0.0
2021,3,3105,585,17,8483,2,4,3,6,7,1,6,1,6,0,False,False,False,0,3,2021-09-27T13:08:15.44,7,False,1.0
2021,3,3105,590,17,7024,13,16,9,3,0,0,0,0,0,0,False,False,False,0,1,2021-09-27T13:10:49.777,0,False,0.0
2021,3,3105,600,17,6274,13,12,6,18,0,0,0,0,0,0,False,False,False,0,3,2021-10-01T22:37:35.633,0,False,0.0
2021,3,3105,620,23,3708,2,4,9,3,23,20,23,0,23,0,False,False,False,0,1,2021-10-01T23:16:46.303,23,False,0.0
2021,3,3105,630,23,7689,13,19,6,21,0,0,0,0,0,0,False,False,False,0,2,2021-09-27T13:27:53.517,0,False,0.0
2021,3,3105,635,23,4307,2,32,5,-7,7,14,-1,8,-1,0,False,False,False,1,1,2021-09-27T13:29:46.18,7,False,8.0
2021,3,3105,640,23,2994,2,5,6,21,23,2,22,1,22,0,False,False,False,0,3,2021-09-27T13:31:57.78,23,False,1.0
2021,3,3105,660,23,4307,2,16,9,5,16,11,12,4,12,0,False,False,False,0,1,2021-09-27T13:38:27.737,16,False,4.0
2021,3,3105,690,17,3951,13,6,7,16,0,0,0,0,0,0,False,False,False,0,2,2021-09-27T13:46:24.837,0,False,0.0
2021,3,3105,700,17,6274,2,2,9,6,8,2,7,1,7,0,False,False,False,0,3,2021-09-27T17:32:11.7,8,False,1.0
2021,3,3105,705,17,8483,2,4,9,9,9,0,9,0,9,0,False,False,False,0,3,2021-09-27T13:52:46.4,9,False,0.0
2021,3,3105,710,17,7024,2,47,5,0,2,2,2,0,2,0,False,False,False,0,1,2021-09-27T13:54:29.927,2,False,0.0
2021,3,3105,730,17,3951,2,45,5,-5,2,7,0,2,0,0,False,False,False,0,3,2022-02-17T22:33:42.117,2,False,2.0
2021,3,3105,755,23,3708,2,44,3,-5,3,8,1,2,1,0,False,False,False,0,1,2021-09-27T14:13:24.63,3,False,2.0
2021,3,3105,760,23,7689,13,13,4,2,0,0,0,0,0,0,False,False,False,0,3,2021-09-29T00:01:15.023,0,False,0.0
2021,3,3105,770,17,7024,2,47,5,-2,3,5,2,1,2,0,True,False,False,0,1,2021-09-28T20:34:32.26,3,False,1.0
2021,3,3105,775,17,8483,13,35,5,13,0,0,0,0,0,0,False,False,False,0,3,2021-09-27T14:19:26.45,0,False,0.0
2021,3,3105,780,17,2253,13,12,7,27,0,0,0,0,0,0,False,False,False,0,2,2021-10-01T23:32:24.15,0,False,
2021,3,3105,785,17,6274,2,4,10,3,5,2,6,-1,6,0,False,False,False,0,3,2021-10-01T23:18:44.99,5,False,-1.0
2021,3,3105,840,17,8483,2,39,4,3,9,6,3,6,3,0,False,False,False,1,3,2021-10-01T19:25:56.563,9,False,6.0
2021,3,3105,845,17,6274,2,39,4,6,6,0,6,0,6,0,False,False,False,0,3,2021-09-27T14:42:15.83,6,False,0.0
2021,3,3105,850,17,6274,2,12,5,4,7,3,6,1,6,0,False,False,False,0,3,2022-02-01T20:36:14.163,7,False,1.0
2021,3,3105,860,17,7024,13,11,5,2,0,0,0,0,0,0,False,False,False,0,1,2021-10-01T23:20:32.237,0,False,0.0
2021,3,3105,870,17,2253,2,6,1,15,15,0,15,0,15,0,False,False,False,0,2,2021-10-01T23:21:42.963,15,False,0.0
2021,3,3105,880,17,8483,2,39,4,3,4,1,3,1,3,0,False,False,False,0,3,2021-10-01T23:22:23.623,4,False,1.0
2021,3,3105,885,17,6274,2,5,5,7,10,3,10,0,10,0,False,False,False,0,3,2021-10-01T23:32:40.35,10,False,0.0
2021,3,3105,890,17,6274,2,6,10,9,9,0,9,0,9,0,False,False,False,0,3,2021-10-01T23:23:34.773,9,False,0.0
2021,3,3105,895,17,4383,13,8,8,27,0,0,0,0,0,0,False,False,False,0,2,2021-10-01T23:23:52.27,0,False,
2021,3,3105,960,23,7688,2,11,6,16,16,0,16,0,16,0,True,False,False,0,4,2022-02-17T22:44:47.33,16,False,0.0
2021,3,3105,970,23,7689,2,7,7,25,32,7,28,4,28,0,False,False,False,0,3,2021-09-27T15:43:02.56,32,False,4.0
2021,3,3105,980,23,2994,13,24,2,20,0,0,0,0,0,0,False,False,False,0,4,2021-09-27T15:46:42.513,0,False,0.0
2021,3,3105,1000,17,3951,13,19,6,49,0,0,0,0,0,0,False,False,False,0,2,2021-09-27T15:49:47.373,0,False,0.0
2021,3,3105,1005,17,4484,2,12,6,16,16,0,16,0,16,0,False,False,False,0,4,2021-09-27T15:51:34.993,16,True,
2021,3,3105,1010,17,2253,13,6,9,10,0,0,0,0,0,0,False,False,False,0,2,2022-02-17T22:34:34.773,0,False,0.0
2021,3,3105,1020,17,2253,13,8,7,55,0,0,0,0,0,0,False,False,False,0,3,2021-10-01T23:27:32.75,0,False,0.0
2021,3,3105,1030,17,6274,2,12,6,23,27,4,23,4,23,0,False,False,False,0,3,2022-02-01T20:36:50.527,27,False,4.0
2021,3,3105,1035,17,6274,13,39,4,3,0,0,0,0,0,0,False,False,False,0,3,2021-09-27T16:13:31.863,0,False,0.0
2021,3,3105,1040,17,8483,2,51,10,-4,3,7,2,1,2,0,False,False,False,0,3,2022-02-17T22:35:07.067,3,False,1.0
2021,3,3105,1050,17,3951,13,17,7,40,0,0,0,0,0,0,False,False,False,0,3,2022-02-17T22:40:39.197,0,False,0.0
2021,3,3105,1055,17,2253,2,4,9,5,7,2,7,0,7,0,False,False,False,0,3,2021-10-01T23:29:08.157,7,False,0.0
2021,3,3105,1060,17,6274,2,55,9,-3,1,4,-1,2,-1,0,False,False,False,0,4,2021-10-01T23:30:00.923,1,False,2.0
2021,3,3105,1075,23,2994,13,24,2,22,0,0,0,0,0,0,False,False,False,0,4,2021-09-27T16:36:05.933,0,False,0.0
2021,3,3105,1085,23,7689,2,35,2,29,34,5,34,0,34,0,False,False,False,0,3,2021-09-27T16:39:24.697,34,False,0.0
2021,3,3106,10,27,7408,2,2,10,11,17,6,17,0,17,0,False,False,False,0,2,2021-09-27T09:11:20.657,17,False,0.0
2021,3,3106,30,27,5050,2,28,10,3,5,2,4,1,4,0,False,False,False,0,1,2021-09-28T15:16:53.11,5,False,1.0
2021,3,3106,40,27,7408,2,36,9,11,28,17,24,4,24,0,False,False,False,1,2,2021-10-01T19:27:45.257,28,False,4.0
2021,3,3106,50,27,7408,2,5,5,7,10,3,9,1,9,6,True,False,False,0,2,2021-09-27T09:33:28.367,10,False,1.0
2021,3,3106,70,18,6900,2,48,9,-3,20,23,14,6,14,0,False,False,False,0,1,2021-09-27T09:43:52.813,20,False,6.0
2021,3,3106,75,18,6361,2,35,10,10,17,7,14,3,14,0,False,False,False,0,4,2021-09-27T09:45:57.923,17,False,3.0
2021,3,3106,80,18,7711,2,18,3,-2,8,10,3,5,3,0,False,False,False,0,2,2021-09-27T09:51:43.023,8,False,5.0
2021,3,3106,85,18,7711,2,5,3,5,10,5,6,4,6,0,True,False,False,0,3,2021-09-27T09:53:41.107,10,False,4.0
2021,3,3106,95,18,6361,2,5,3,6,7,1,6,1,6,6,False,False,False,0,4,2021-09-27T09:57:33.033,7,False,1.0
2021,3,3106,120,27,7852,2,2,10,7,10,3,7,3,7,0,False,False,False,0,2,2021-09-27T10:10:57.08,10,False,3.0
2021,3,3106,125,27,7408,2,6,10,12,12,0,12,0,12,0,False,False,False,0,3,2021-09-27T10:14:39.953,12,False,0.0
2021,3,3106,145,27,650,2,54,3,-7,9,16,3,6,3,0,True,False,False,1,3,2021-10-01T20:15:43.343,3,False,6.0
2021,3,3106,150,27,4850,2,49,3,-3,5,8,3,2,3,0,True,False,False,1,2,2021-10-01T20:16:44.353,5,False,2.0
2021,3,3106,185,18,6361,13,32,5,-1,0,0,0,0,0,0,False,False,False,0,4,2021-09-27T10:33:33.377,0,False,0.0
2021,3,3106,190,18,1381,13,3,5,10,0,0,0,0,0,0,False,False,False,0,2,2021-09-27T10:36:23.827,0,False,0.0
2021,3,3106,205,27,7408,2,20,6,20,21,1,21,0,21,0,False,False,False,0,2,2021-09-27T10:43:30.817,21,False,0.0
2021,3,3106,240,18,6900,2,28,10,2,6,4,5,1,5,0,False,False,False,0,1,2021-09-27T10:52:23.13,6,False,1.0
2021,3,3106,255,18,6900,2,48,10,-3,23,26,16,7,16,0,False,False,False,1,1,2021-10-01T20:17:27.273,23,False,7.0
2021,3,3106,270,18,7711,2,6,4,13,26,13,22,4,22,0,False,False,False,0,3,2021-09-27T11:03:26.26,26,False,4.0
2021,3,3106,275,18,6361,2,4,9,7,7,0,7,0,7,0,False,False,False,0,3,2021-09-27T11:04:53.097,7,False,0.0
2021,3,3106,285,18,6900,13,48,9,-4,0,0,0,0,0,0,False,False,False,0,1,2022-02-17T22:57:25.637,0,False,0.0
2021,3,3106,290,18,1381,2,8,8,15,15,0,15,0,15,6,True,False,False,0,2,2021-09-28T19:01:28.783,15,True,0.0
2021,3,3106,305,27,7496,2,34,9,-4,7,11,3,4,3,0,True,False,False,0,3,2021-09-27T11:16:42.897,7,False,4.0
2021,3,3106,310,27,6397,2,35,9,9,39,30,21,18,21,0,False,False,False,1,4,2021-09-27T11:23:16.847,39,False,18.0
2021,3,3106,320,27,7408,13,20,6,24,0,0,0,0,0,0,False,False,False,0,2,2021-09-27T11:20:43.857,0,False,0.0
2021,3,3106,325,27,650,2,5,3,6,7,1,7,0,7,0,True,False,False,0,3,2021-10-01T20:20:17.683,7,False,0.0
2021,3,3106,345,18,6900,2,48,4,-3,7,10,5,2,5,0,False,False,False,0,1,2021-09-27T11:31:24.157,7,False,2.0
2021,3,3106,365,18,6900,2,28,4,2,4,2,4,0,4,0,False,False,False,0,1,2021-09-27T11:43:32.577,4,False,0.0
2021,3,3106,380,18,1381,2,4,9,7,7,0,7,0,7,0,False,False,False,0,3,2021-09-27T11:46:07.983,7,False,0.0
2021,3,3106,385,18,7711,3,6,5,6,0,0,0,0,0,0,False,False,False,0,2,2021-09-27T11:47:34.313,0,False,0.0
2021,3,3106,395,18,7711,2,2,4,9,9,0,9,0,9,0,False,False,False,0,3,2021-09-27T11:50:03.2,9,False,0.0
2021,3,3106,405,18,6361,2,13,10,2,16,14,12,4,12,0,False,False,False,0,2,2021-09-27T11:52:43.673,16,False,4.0
2021,3,3106,415,18,7711,2,26,5,3,3,0,3,0,3,6,False,False,False,0,2,2022-02-17T22:58:00.77,3,True,0.0
2021,3,3106,430,27,7404,2,4,4,5,12,7,9,3,9,0,False,False,False,0,1,2021-09-27T11:56:20.047,12,False,3.0
2021,3,3106,440,27,4850,2,32,10,-1,11,12,7,4,7,0,False,False,False,1,4,2021-09-27T11:57:58.643,11,False,4.0
2021,3,3106,445,27,7404,2,44,9,-1,31,32,17,14,17,0,False,False,False,1,1,2021-10-01T20:20:57.92,31,False,14.0
2021,3,3106,470,18,1381,2,45,5,-7,-4,3,-4,0,-4,0,False,False,False,0,1,2021-09-27T12:31:05.22,-4,False,0.0
2021,3,3106,475,18,7711,2,4,3,10,15,5,11,4,11,0,False,False,False,0,2,2021-10-01T18:20:26.407,15,False,4.0
2021,3,3106,485,18,6361,2,32,9,1,5,4,3,2,3,0,False,False,False,0,4,2021-10-01T19:14:21.837,5,False,2.0
2021,3,3106,495,18,1381,13,3,2,17,0,0,0,0,0,0,False,False,False,0,2,2021-09-27T12:37:35.7,0,False,0.0
2021,3,3106,505,18,7711,2,5,3,8,8,0,8,0,8,0,False,False,False,0,3,2021-09-27T12:40:20.42,8,True,0.0
2021,3,3106,515,18,1381,2,5,3,4,9,5,9,0,9,0,False,False,False,0,3,2021-10-01T20:21:48.093,9,False,0.0
2021,3,3106,525,18,7711,13,26,10,5,0,0,0,0,0,0,False,False,False,0,3,2022-02-17T22:59:45.843,0,False,0.0
2021,3,3106,565,27,7404,2,48,9,-6,5,11,4,1,4,0,False,False,False,0,1,2021-09-27T12:55:45.707,5,False,1.0
2021,3,3106,575,18,6900,2,48,4,-3,-1,2,-3,2,-3,0,False,False,False,0,1,2021-09-27T12:59:30.253,-1,False,2.0
2021,3,3106,580,18,1381,2,6,8,19,21,2,21,0,21,0,False,False,False,0,2,2021-10-01T18:20:26.407,21,False,0.0
2021,3,3106,590,18,1381,13,12,2,18,0,0,0,0,0,0,False,False,False,0,2,2022-02-17T23:00:32.033,0,False,0.0
2021,3,3106,595,18,7712,2,5,5,6,11,5,8,3,8,0,True,False,False,0,3,2021-09-27T13:07:37.967,11,False,3.0
2021,3,3106,605,18,7711,2,8,7,15,28,13,25,3,25,0,False,False,False,0,3,2021-09-27T13:12:44.743,28,False,3.0
2021,3,3106,615,18,6361,2,13,9,2,4,2,4,0,4,0,False,False,False,0,4,2021-09-27T13:25:08.027,4,False,0.0
2021,3,3106,625,18,6900,13,12,3,7,0,0,0,0,0,0,True,False,False,0,1,2021-10-01T19:45:43.897,0,False,0.0
2021,3,3106,645,27,4850,2,4,10,4,14,10,6,8,6,0,False,False,False,0,4,2021-10-01T19:34:49.23,14,False,8.0
2021,3,3106,650,27,650,2,4,10,6,6,0,6,0,6,0,False,False,False,0,2,2021-09-27T13:41:03.563,6,False,0.0
2021,3,3106,655,27,5050,2,48,10,-8,-3,5,-3,0,-3,0,False,False,False,0,1,2021-09-27T13:44:23.577,-3,False,0.0
2021,3,3106,660,27,7852,13,2,4,11,0,0,0,0,0,0,False,False,False,0,2,2022-02-17T23:01:17.673,0,False,0.0
2021,3,3106,680,18,6361,2,2,10,7,14,7,12,2,12,0,False,False,False,0,3,2021-09-27T13:59:34.637,14,False,2.0
2021,3,3106,695,18,7712,2,2,9,5,15,10,6,9,6,0,False,False,False,0,3,2021-09-27T14:06:47.143,15,False,9.0
2021,3,3106,720,18,1381,2,49,9,-2,2,4,-1,3,-1,0,False,False,False,0,2,2021-10-01T19:38:13.5,2,False,3.0
2021,3,3106,740,27,7408,2,8,9,14,19,5,18,1,18,0,False,False,False,0,2,2022-03-11T18:52:25.027,19,False,1.0
2021,3,3106,745,27,650,13,12,5,13,0,0,0,0,0,0,False,False,False,0,2,2022-02-01T20:37:36.983,0,False,
2021,3,3106,760,27,7408,13,12,6,35,0,0,0,0,0,0,False,False,False,0,2,2022-02-17T23:02:18.05,0,False,0.0
2021,3,3106,765,27,7496,13,19,6,43,0,0,0,0,0,0,False,False,False,0,3,2022-02-17T23:06:24.42,0,False,0.0
2021,3,3106,790,18,7711,2,5,5,11,11,0,11,0,11,0,False,False,False,0,3,2021-09-27T14:44:37.91,11,True,0.0
2021,3,3106,825,27,4850,2,5,5,7,7,0,7,0,7,0,False,False,False,0,3,2021-09-27T14:52:55.677,7,True,0.0
2021,3,3106,830,27,4850,2,5,5,8,17,9,16,1,16,0,False,False,False,0,3,2021-09-27T14:54:04.89,17,False,1.0
2021,3,3106,835,27,7408,13,3,3,7,0,0,0,0,0,0,False,False,False,0,2,2021-09-27T14:55:32.527,0,False,0.0
2021,3,3106,840,27,650,2,4,5,6,15,9,15,0,15,0,False,False,False,0,2,2022-02-17T23:04:41.573,15,False,0.0
2021,3,3107,15,30,2290,2,4,9,8,8,0,8,0,8,0,False,False,False,0,4,2021-09-27T09:29:47.853,8,False,0.0
2021,3,3107,25,30,7893,13,5,3,6,0,0,0,0,0,0,True,False,False,0,3,2021-09-27T09:31:37.237,0,False,0.0
2021,3,3107,35,29,4866,13,7,6,15,0,0,0,0,0,0,False,False,False,0,3,2021-09-27T09:34:30.073,0,False,0.0
2021,3,3107,45,29,7828,13,39,9,4,0,0,0,0,0,0,False,False,False,0,3,2021-09-27T09:38:26.973,0,False,0.0
2021,3,3107,60,30,2290,2,5,3,4,5,1,5,0,5,0,False,False,False,0,4,2021-09-27T09:48:34.277,5,False,0.0
2021,3,3107,65,30,931,2,46,3,1,1,0,1,0,1,0,False,False,False,0,1,2021-09-27T09:49:18.947,1,False,0.0
2021,3,3107,80,29,1958,2,18,5,2,7,5,5,2,5,0,False,False,False,0,3,2021-09-28T23:01:25.993,7,False,2.0
2021,3,3107,85,29,4866,3,17,9,11,0,0,0,0,0,0,False,False,False,0,3,2022-02-17T22:20:14.627,0,False,0.0
2021,3,3107,90,29,1958,13,51,9,-2,0,0,0,0,0,0,False,False,False,0,3,2022-02-17T22:20:44.69,0,False,0.0
2021,3,3107,95,29,967,13,8,7,42,0,0,0,0,0,0,False,False,False,0,3,2021-10-01T18:42:17.79,0,False,0.0
2021,3,3107,105,30,4937,2,28,10,0,15,15,3,12,3,0,False,False,False,2,1,2021-09-27T10:05:27.333,15,False,12.0
2021,3,3107,110,30,4516,13,30,9,0,0,0,0,0,0,0,False,False,False,0,4,2022-02-25T19:43:58.59,0,False,0.0
2021,3,3107,115,30,4516,2,5,9,5,17,12,17,0,17,0,False,False,False,0,3,2021-09-27T15:56:58.803,17,False,0.0
2021,3,3107,120,30,4937,2,4,10,4,4,0,4,0,4,0,False,False,False,0,1,2021-10-01T18:01:01.927,4,False,0.0
2021,3,3107,130,30,63,3,7,6,26,0,0,0,0,0,0,False,False,False,0,3,2022-02-17T22:21:54.027,0,False,0.0
2021,3,3107,145,29,6266,2,48,9,-4,6,10,0,6,0,0,False,False,False,0,1,2021-09-27T10:23:21.053,6,False,6.0
2021,3,3107,150,29,3398,2,50,5,0,12,12,9,3,9,0,False,False,False,0,2,2021-09-27T10:26:07.14,12,False,3.0
2021,3,3107,155,29,4866,2,7,6,21,22,1,22,0,22,0,False,False,False,0,3,2021-10-01T17:44:03.363,22,True,0.0
2021,3,3107,160,29,7828,2,4,3,8,11,3,11,0,11,0,False,False,False,0,2,2021-10-01T18:42:49.037,11,False,0.0
2021,3,3107,165,29,3398,2,53,9,-5,5,10,5,0,5,0,False,True,False,0,4,2021-09-27T10:40:08.587,5,False,0.0
2021,3,3107,180,29,4866,13,24,6,16,0,0,0,0,0,0,False,False,False,0,3,2021-09-27T10:43:50.887,0,False,
2021,3,3107,205,29,1958,2,39,4,4,6,2,6,0,6,0,False,False,False,0,3,2021-10-01T18:42:58.7,6,False,0.0
2021,3,3107,210,29,3398,2,5,5,4,6,2,6,0,6,0,False,False,False,0,3,2021-09-27T10:53:15.58,6,False,0.0
2021,3,3107,220,29,3398,2,50,5,0,6,6,6,0,6,6,False,False,False,0,2,2021-09-27T10:55:21.283,6,True,0.0
2021,3,3107,235,30,7268,2,50,5,-1,3,4,1,2,1,0,False,False,False,0,2,2021-09-27T10:57:40.437,3,False,2.0
2021,3,3107,240,30,793,13,19,2,42,0,0,0,0,0,0,False,False,False,0,2,2021-09-27T10:58:56.6,0,False,0.0
2021,3,3107,245,30,931,2,45,5,-4,7,11,7,0,7,0,False,True,False,0,1,2021-09-27T11:01:06.467,7,False,0.0
2021,3,3107,260,30,4516,2,13,9,3,7,4,5,2,5,0,False,False,False,0,3,2021-09-27T11:05:44.673,7,False,2.0
2021,3,3107,265,30,6414,2,12,5,3,3,0,3,0,3,0,False,False,False,0,1,2021-09-27T11:07:29.403,3,False,
2021,3,3107,270,30,8307,2,50,5,-1,0,1,0,0,0,0,False,False,False,0,2,2021-09-27T11:09:30.803,0,False,0.0
2021,3,3107,275,30,793,2,5,5,14,17,3,15,2,15,0,False,False,False,0,3,2021-09-27T11:11:03.967,17,False,2.0
2021,3,3107,285,30,4516,2,49,5,-3,5,8,2,3,2,0,False,False,False,0,2,2022-02-14T18:37:31.247,5,False,3.0
2021,3,3107,295,30,63,2,35,5,11,26,15,26,0,26,0,False,False,False,0,4,2021-09-27T11:24:18.433,26,False,0.0
2021,3,3107,310,30,931,2,34,4,-4,3,7,0,3,0,0,True,False,False,0,2,2021-09-27T11:27:01.09,3,False,3.0
2021,3,3107,330,29,4866,2,4,10,5,9,4,9,0,9,0,False,False,False,0,3,2021-09-27T11:30:51.033,9,False,0.0
2021,3,3107,340,29,6266,2,32,3,-2,2,4,2,0,2,0,False,False,False,0,3,2021-09-27T11:33:18.587,2,False,0.0
2021,3,3107,345,29,967,13,9,6,23,0,0,0,0,0,0,False,False,False,0,3,2021-09-27T11:35:02.037,0,False,
2021,3,3107,360,29,3398,2,2,10,5,11,6,11,0,11,0,True,False,False,0,3,2021-09-27T11:45:17.18,11,False,0.0
2021,3,3107,365,29,967,13,24,6,40,0,0,0,0,0,0,False,False,False,0,2,2021-10-01T18:24:56.557,0,False,0.0
2021,3,3107,370,29,7828,2,8,10,13,21,8,17,4,17,0,False,False,False,0,2,2021-10-01T17:44:03.377,21,False,4.0
2021,3,3107,375,29,4866,13,2,9,5,0,0,0,0,0,0,False,False,False,0,2,2021-10-01T18:25:08.357,0,False,0.0
2021,3,3107,380,29,4866,2,11,5,13,22,9,20,2,20,0,False,False,False,0,3,2021-09-27T11:54:39.22,22,False,2.0
2021,3,3107,385,29,4866,2,29,3,2,2,0,2,0,2,6,False,False,False,0,3,2021-09-27T11:56:27.657,2,True,0.0
2021,3,3107,400,30,4516,2,2,4,5,20,15,19,1,19,0,False,False,False,0,3,2021-09-27T11:58:48.437,20,False,
2021,3,3107,405,30,793,13,3,6,19,0,0,0,0,0,0,False,False,False,0,2,2021-09-27T12:00:46.717,0,False,0.0
2021,3,3107,410,30,931,2,48,9,-5,32,37,17,15,17,0,False,False,False,1,1,2021-09-27T12:03:17.497,32,False,15.0
2021,3,3107,420,30,793,2,13,10,4,14,10,14,0,14,0,False,False,False,0,3,2021-09-27T12:04:56.58,14,True,0.0
2021,3,3107,435,30,7268,2,13,4,5,8,3,8,0,8,0,False,False,False,0,3,2021-10-01T18:43:09.303,8,False,0.0
2021,3,3107,465,29,1958,13,12,6,18,0,0,0,0,0,0,False,False,False,0,3,2021-09-27T12:32:37.507,0,False,0.0
2021,3,3107,470,29,967,2,20,8,44,75,31,75,0,75,6,False,False,False,0,3,2021-10-01T18:25:23.287,75,True,0.0
2021,3,3107,490,30,793,2,4,6,17,20,3,20,0,20,0,False,False,False,0,2,2021-10-01T18:01:53.793,20,False,0.0
2021,3,3107,500,30,63,2,17,9,12,15,3,15,0,15,0,False,False,False,0,4,2021-10-01T18:43:18.547,15,False,0.0
2021,3,3107,510,30,793,2,4,5,4,11,7,5,6,5,0,False,False,False,0,2,2021-09-27T12:59:42.97,11,False,6.0
2021,3,3107,515,30,63,2,13,10,3,6,3,5,1,5,0,False,False,False,0,4,2021-09-27T13:00:56.26,6,False,1.0
2021,3,3107,520,30,4937,2,5,5,4,7,3,7,0,7,0,True,False,False,0,3,2021-09-27T13:02:42.397,7,True,0.0
2021,3,3107,525,30,2290,2,53,5,-4,17,21,14,3,14,0,False,False,False,0,4,2021-09-27T13:05:44.403,17,False,3.0
2021,3,3107,545,29,7828,2,51,5,-2,0,2,0,0,0,0,False,False,False,0,2,2022-02-17T22:22:54.25,0,False,0.0
2021,3,3107,550,29,6266,13,12,3,4,0,0,0,0,0,0,False,False,False,0,3,2021-09-27T13:13:05.903,0,False,0.0
2021,3,3107,555,29,1958,2,6,7,20,20,0,20,0,20,0,False,False,False,0,2,2021-10-01T18:25:48.843,20,False,0.0
2021,3,3107,560,29,1958,13,12,2,17,0,0,0,0,0,0,False,False,False,0,3,2021-09-27T13:15:43.2,0,False,0.0
2021,3,3107,565,29,967,2,4,10,5,5,0,5,0,5,0,False,False,False,0,3,2021-09-27T13:16:42.15,5,False,0.0
2021,3,3107,570,29,967,2,13,10,7,40,33,40,0,40,0,False,False,False,0,3,2021-09-27T13:18:06.603,40,False,0.0
2021,3,3107,575,29,4866,2,5,5,5,10,5,10,0,10,6,False,False,False,0,3,2021-09-27T13:24:08.157,10,True,0.0
2021,3,3107,590,30,4523,2,39,9,3,11,8,3,8,3,0,False,False,False,1,4,2021-10-01T18:03:05.68,11,False,8.0
2021,3,3107,610,30,931,2,48,9,-7,-4,3,-4,0,-4,0,False,False,False,0,1,2021-09-27T13:39:11.5,-4,False,0.0
2021,3,3107,625,29,7828,13,9,2,30,0,0,0,0,0,0,False,False,False,0,2,2021-09-27T13:41:57.787,0,False,0.0
2021,3,3107,630,29,4866,2,51,10,-2,5,7,5,0,5,0,False,False,False,0,3,2022-02-17T22:23:19.153,5,False,0.0
2021,3,3107,645,30,7893,2,17,7,17,23,6,20,3,20,0,False,False,False,0,3,2021-09-27T16:07:19.42,23,False,3.0
2021,3,3107,650,30,7893,13,4,5,6,0,0,0,0,0,0,False,False,False,0,3,2021-09-27T16:08:14.81,0,False,0.0
2021,3,3107,655,30,793,2,17,10,13,13,0,13,0,13,0,False,False,False,0,3,2021-09-27T13:51:17.883,13,False,0.0
2021,3,3107,660,30,7893,2,9,6,26,31,5,31,0,31,0,False,False,False,0,4,2021-09-27T13:54:14.433,31,False,0.0
2021,3,3107,665,30,7893,13,6,10,8,0,0,0,0,0,0,False,False,False,0,3,2021-10-01T18:43:26.627,0,False,0.0
2021,3,3107,670,30,63,3,5,3,8,0,0,0,0,0,0,True,False,False,0,3,2022-02-17T22:23:53.857,0,False,0.0
2021,3,3107,705,29,4866,2,5,6,17,17,0,17,0,17,0,False,False,False,0,2,2021-09-27T14:35:30.24,17,False,0.0
2021,3,3107,710,29,4866,2,4,5,4,6,2,5,1,5,0,False,False,False,1,3,2021-10-01T18:12:09.61,6,False,1.0
2021,3,3107,725,29,6266,2,50,3,-2,4,6,2,2,2,0,False,False,False,0,2,2021-09-27T14:41:41.293,4,False,2.0
2021,3,3107,735,29,7828,2,18,3,2,10,8,2,8,2,0,False,False,False,1,2,2021-09-27T14:43:40.44,10,False,8.0
2021,3,3107,750,29,4866,2,26,9,2,3,1,3,0,3,0,False,False,False,0,3,2021-09-27T14:47:37.227,3,False,0.0
2021,3,3107,770,30,793,2,3,2,15,17,2,17,0,17,0,False,False,False,0,2,2021-09-27T15:01:19.66,17,False,0.0
2021,3,3107,775,30,63,13,9,2,20,0,0,0,0,0,0,False,False,False,0,3,2021-09-27T15:02:49.673,0,False,0.0
2021,3,3107,780,30,7268,13,12,7,15,0,0,0,0,0,0,False,False,False,0,2,2021-09-27T16:07:36.523,0,False,0.0
2021,3,3107,790,30,63,2,28,3,0,8,8,8,0,8,0,False,False,False,0,4,2021-09-27T15:09:29.873,8,False,0.0
2021,3,3107,795,30,793,13,5,3,8,0,0,0,0,0,0,False,False,False,0,3,2021-09-27T15:11:58.293,0,False,0.0
2021,3,3107,830,30,931,2,45,5,-2,-2,0,-2,0,-2,0,False,False,False,0,1,2021-10-01T18:43:44.577,-2,False,0.0
2021,3,3107,835,30,4516,2,4,9,11,11,0,11,0,11,0,False,False,False,0,3,2021-10-01T18:03:16.447,11,False,0.0
2021,3,3107,840,30,931,2,46,9,-1,8,9,8,0,8,0,False,False,False,0,1,2021-09-27T15:26:32.287,8,False,0.0
2021,3,3107,845,30,793,2,13,4,2,5,3,5,0,5,0,False,False,False,0,3,2021-09-27T15:32:16.59,5,False,0.0
2021,3,3107,850,30,2290,2,5,5,5,5,0,5,0,5,0,False,False,False,0,3,2021-09-27T15:33:31.91,5,False,0.0
2021,3,3107,855,30,4516,2,17,7,20,21,1,21,0,21,0,False,False,False,0,3,2021-09-27T15:35:50.41,21,False,0.0
2021,3,3107,865,30,931,2,48,10,-2,-1,1,-1,0,-1,0,True,False,False,0,1,2021-09-28T14:54:48.993,-1,False,0.0
2021,3,3107,880,30,4516,2,50,3,-1,13,14,5,8,5,0,False,False,False,0,2,2021-10-01T18:12:19.967,13,False,8.0
2021,3,3107,895,30,7893,2,6,10,5,9,4,7,2,7,0,False,False,False,0,3,2021-09-27T15:48:37.77,9,False,2.0
2021,3,3107,900,30,793,2,4,3,3,9,6,9,0,9,0,False,False,False,0,2,2021-09-27T15:50:00.173,9,False,0.0
2021,3,3107,905,30,931,2,16,9,4,7,3,6,1,6,6,False,False,False,0,1,2021-09-27T15:51:27.7,7,False,1.0
2021,3,3108,20,12,6691,2,9,2,22,42,20,33,9,33,0,False,False,False,0,3,2021-09-27T11:47:27.023,42,False,9.0
2021,3,3108,25,12,4537,2,48,10,-3,11,14,8,3,8,0,False,False,False,1,1,2021-10-01T23:30:33.04,11,False,3.0
2021,3,3108,30,12,494,2,12,9,-4,-4,0,-4,0,-4,0,False,False,False,0,6,2022-02-18T15:48:47.417,-4,False,0.0
2021,3,3108,45,12,556,2,50,10,-2,2,4,1,1,1,0,False,False,False,0,3,2021-09-27T11:55:32.407,2,False,1.0
2021,3,3108,65,28,4922,2,4,10,6,8,2,6,2,6,0,False,False,False,0,4,2022-02-18T15:45:44.313,8,False,2.0
2021,3,3108,75,28,7619,2,4,10,6,7,1,7,0,7,0,False,False,False,0,2,2021-10-01T22:18:44.363,7,False,0.0
2021,3,3108,80,28,917,13,6,10,8,0,0,0,0,0,0,False,False,False,0,3,2021-09-27T12:02:33.263,0,False,0.0
2021,3,3108,90,12,556,2,4,5,5,12,7,9,3,9,0,False,False,False,0,2,2021-09-27T12:04:02.363,12,False,3.0
2021,3,3108,95,12,7742,2,47,5,2,2,0,2,0,2,0,False,False,False,0,1,2021-09-27T12:05:12.89,2,False,0.0
2021,3,3108,100,12,6357,2,8,2,37,47,10,42,5,42,0,False,False,False,0,3,2021-09-27T12:07:20.66,47,False,5.0
2021,3,3108,115,12,556,2,12,9,14,14,0,14,0,14,0,False,False,False,0,3,2021-09-27T12:11:28.83,14,False,0.0
2021,3,3108,120,12,556,2,46,9,0,1,1,1,0,1,6,True,False,False,0,3,2021-09-27T12:12:52.35,1,True,0.0
2021,3,3108,145,28,4922,13,13,10,1,0,0,0,0,0,0,False,False,False,0,3,2021-09-27T12:23:31.513,0,False,0.0
2021,3,3108,165,12,6691,13,9,2,23,0,0,0,0,0,0,False,False,False,0,3,2021-09-27T12:27:13.507,0,False,
2021,3,3108,175,12,6357,2,45,5,-8,0,8,0,0,0,0,True,False,False,0,3,2021-10-01T23:28:33.167,0,False,0.0
2021,3,3108,190,28,4922,13,23,1,41,0,0,0,0,0,0,False,False,False,0,4,2021-09-27T12:35:43.62,0,False,0.0
2021,3,3108,195,12,556,2,51,5,3,10,7,8,2,8,0,False,False,False,1,3,2021-09-27T12:37:06.813,10,False,2.0
2021,3,3108,220,12,4537,2,46,3,0,3,3,3,0,3,0,False,True,False,0,1,2021-09-28T00:15:33.81,3,False,0.0
2021,3,3108,225,12,496,13,11,3,3,0,0,0,0,0,0,True,False,False,0,3,2022-02-18T15:47:03.833,0,False,0.0
2021,3,3108,230,28,8463,3,26,9,1,0,0,0,0,0,0,False,False,False,0,1,2021-09-27T12:43:59.233,0,False,0.0
2021,3,3108,235,28,7619,2,2,9,6,6,0,6,0,6,0,False,False,False,0,2,2021-09-27T12:45:24.75,6,False,0.0
2021,3,3108,240,28,7224,2,2,10,4,4,0,4,0,4,0,True,False,False,0,3,2021-09-27T12:47:54.077,4,False,0.0
2021,3,3108,250,28,7619,2,4,7,16,16,0,16,0,16,0,False,False,False,0,2,2021-09-27T12:49:51.727,16,False,0.0
2021,3,3108,260,28,262,2,28,3,3,8,5,6,2,6,0,False,False,False,0,1,2021-10-01T22:52:50.91,8,False,2.0
2021,3,3108,270,28,4922,2,2,10,13,16,3,13,3,13,0,False,False,False,1,3,2021-09-27T12:54:32.523,16,False,3.0
2021,3,3108,290,12,556,13,19,6,40,0,0,0,0,0,0,False,False,False,0,2,2021-09-27T13:00:50.353,0,False,0.0
2021,3,3108,295,12,7743,2,46,3,0,4,4,3,1,3,0,True,False,False,0,1,2021-09-27T13:02:12.417,4,False,1.0
2021,3,3108,300,12,556,13,7,2,34,0,0,0,0,0,0,False,False,False,0,2,2021-10-01T22:53:39.69,0,False,
2021,3,3108,315,12,556,2,29,3,11,15,4,15,0,15,0,False,False,False,0,2,2021-09-27T13:08:05.567,15,False,0.0
2021,3,3108,325,12,556,2,29,6,19,19,0,19,0,19,0,False,False,False,0,2,2021-09-27T13:09:55.663,19,False,0.0
2021,3,3108,335,12,4511,2,51,10,-1,6,7,2,4,2,0,False,False,False,1,3,2021-10-01T21:37:34.377,6,False,4.0
2021,3,3108,360,28,4922,2,4,9,6,10,4,7,3,7,0,False,False,False,0,4,2021-09-28T16:21:30.443,10,False,3.0
2021,3,3108,365,28,7619,13,2,10,6,0,0,0,0,0,0,False,False,False,0,2,2021-10-01T22:55:47.633,0,False,0.0
2021,3,3108,370,28,917,2,6,4,11,11,0,11,0,11,0,False,False,False,0,3,2021-10-01T22:21:48.207,11,False,0.0
2021,3,3108,380,28,262,2,26,3,5,5,0,5,0,5,0,False,False,False,0,1,2021-10-01T22:55:07.703,5,False,0.0
2021,3,3108,390,28,7619,13,2,9,6,0,0,0,0,0,0,False,False,False,0,3,2022-02-25T14:55:21.27,0,False,0.0
2021,3,3108,400,28,917,13,17,4,6,0,0,0,0,0,0,False,False,False,0,3,2021-09-27T13:43:23.603,0,False,
2021,3,3108,405,28,7224,3,12,10,1,0,0,0,0,0,0,False,False,False,0,3,2021-10-01T23:29:26.813,0,False,
2021,3,3108,415,28,7619,3,2,9,1,0,0,0,0,0,0,False,False,False,0,3,2021-10-01T22:41:10.81,0,False,0.0
2021,3,3108,440,28,4922,2,31,9,-3,7,10,0,7,0,0,True,False,False,1,4,2021-10-01T23:29:39.917,7,False,7.0
2021,3,3108,455,28,7224,2,51,3,-2,19,21,17,2,17,0,True,False,False,0,3,2021-09-27T16:34:31.06,19,False,2.0
2021,3,3108,475,28,7224,2,34,4,-5,1,6,-2,3,-2,0,True,False,False,0,3,2021-09-27T14:21:10.263,1,False,3.0
2021,3,3108,480,28,8463,2,44,3,-5,0,5,-3,3,-3,0,False,False,False,0,1,2021-09-27T14:22:25.837,0,False,3.0
2021,3,3108,485,28,7224,2,4,8,15,16,1,16,0,16,0,False,False,False,0,3,2021-09-27T14:23:38.42,16,False,0.0
2021,3,3108,500,28,7619,2,4,10,8,8,0,8,0,8,6,False,False,False,0,3,2021-09-27T14:27:32.227,8,True,0.0
2021,3,3108,520,12,556,2,51,5,1,1,0,1,0,1,0,False,False,False,0,3,2021-09-27T14:40:31.537,1,False,0.0
2021,3,3108,525,12,556,3,2,10,11,0,0,0,0,0,0,False,False,False,0,2,2021-09-27T14:41:39.56,0,False,0.0
2021,3,3108,540,28,4922,2,51,10,-6,0,6,-3,3,-3,0,True,False,False,0,3,2021-09-27T14:46:15.207,0,False,3.0
2021,3,3108,545,28,917,13,6,4,8,0,0,0,0,0,0,False,False,False,0,3,2021-09-27T14:47:30.963,0,False,0.0
2021,3,3108,555,12,556,2,2,10,8,9,1,9,0,9,0,False,False,False,0,2,2021-09-27T14:55:12.713,9,False,0.0
2021,3,3108,565,12,7742,2,46,9,0,6,6,4,2,4,0,False,False,False,0,1,2022-02-01T20:40:20.103,6,False,2.0
2021,3,3108,570,12,556,2,51,10,1,7,6,6,1,6,0,False,False,False,0,3,2021-09-27T14:59:01.787,7,False,1.0
2021,3,3108,585,12,4511,13,17,8,26,0,0,0,0,0,0,False,False,False,0,3,2021-09-27T15:02:31.473,0,False,
2021,3,3108,605,12,6357,2,7,3,12,12,0,12,0,12,6,False,False,False,0,3,2021-09-27T15:10:53.737,12,True,0.0
2021,3,3108,630,28,7619,13,12,1,35,0,0,0,0,0,0,False,False,False,0,3,2022-02-01T20:41:27.047,0,False,
2021,3,3108,635,28,917,2,6,7,15,16,1,16,0,16,0,False,False,False,0,3,2021-09-27T15:21:38.887,16,False,0.0
2021,3,3108,645,28,262,2,2,10,9,12,3,12,0,12,0,False,False,False,0,3,2021-09-27T15:29:37.54,12,False,0.0
2021,3,3108,650,28,917,2,26,10,3,9,6,8,1,8,0,True,False,False,0,3,2021-09-27T15:30:41.487,9,False,1.0
2021,3,3108,665,28,7619,13,35,5,3,0,0,0,0,0,0,False,False,False,0,2,2021-09-27T15:34:12.87,0,False,
2021,3,3108,685,12,556,13,8,1,37,0,0,0,0,0,0,False,False,False,0,2,2021-09-27T15:41:34.473,0,False,0.0
2021,3,3108,690,12,6357,13,19,2,33,0,0,0,0,0,0,False,False,False,0,2,2021-09-27T15:42:56.56,0,False,0.0
2021,3,3108,700,12,556,13,9,2,24,0,0,0,0,0,0,False,False,False,0,3,2021-09-27T15:44:12.61,0,False,0.0
2021,3,3108,715,28,8463,2,46,3,3,3,0,3,0,3,0,False,False,False,0,1,2021-09-27T15:46:53.927,3,False,0.0
2021,3,3108,730,28,7224,13,4,10,5,0,0,0,0,0,0,False,False,False,0,3,2021-09-27T15:53:31.033,0,False,0.0
2021,3,3108,760,12,556,13,19,6,17,0,0,0,0,0,0,False,False,False,0,2,2021-09-27T15:59:13.367,0,False,0.0
2021,3,3108,775,28,7224,13,44,3,-6,0,0,0,0,0,0,True,False,False,0,3,2021-09-27T16:04:48.423,0,False,0.0
2021,3,3108,780,28,7224,13,7,6,23,0,0,0,0,0,0,False,False,False,0,3,2021-09-27T16:05:56.373,0,False,0.0
2021,3,3108,785,28,4922,2,6,9,11,39,28,16,23,16,0,False,False,False,1,3,2021-09-27T16:07:07.663,39,False,23.0
2021,3,3108,790,28,7224,13,6,4,13,0,0,0,0,0,0,False,False,False,0,3,2021-09-27T16:09:18.68,0,False,0.0
2021,3,3108,795,28,917,13,5,5,5,0,0,0,0,0,0,False,False,False,0,3,2021-10-01T23:00:28.77,0,False,0.0
2021,3,3108,800,28,7224,2,4,10,12,12,0,12,0,12,0,False,False,False,0,3,2021-10-01T23:30:10.667,12,False,0.0
2021,3,3108,805,28,4922,2,5,3,4,12,8,4,8,4,0,True,False,False,1,3,2021-09-27T16:13:10.92,12,False,8.0
2021,3,3108,810,28,262,2,16,4,5,12,7,7,5,7,6,False,False,False,1,1,2021-09-27T16:14:33.477,12,False,5.0
2021,3,3108,825,12,556,2,6,1,25,25,0,25,0,25,0,False,False,False,0,2,2021-09-27T16:19:46.987,25,False,0.0
2021,3,3108,835,12,556,13,6,9,12,0,0,0,0,0,0,False,False,False,0,3,2021-09-27T16:21:31.437,0,False,0.0
2021,3,3108,840,12,556,2,6,7,17,17,0,17,0,17,0,False,False,False,0,2,2021-09-27T16:22:39.163,17,False,0.0
2021,3,3109,10,9,6446,2,39,4,5,8,3,6,2,6,0,False,False,False,0,4,2021-09-28T09:06:21.213,8,False,2.0
2021,3,3109,20,9,4202,2,4,4,2,8,6,7,1,7,0,False,False,False,0,1,2021-09-28T09:08:48.807,8,False,1.0
2021,3,3109,30,9,7816,2,8,1,41,44,3,42,2,42,0,False,False,False,0,3,2021-09-28T09:12:54.327,44,False,2.0
2021,3,3109,50,24,6373,2,6,8,15,38,23,35,3,35,0,False,False,False,1,4,2021-09-28T09:18:39.457,38,False,3.0
2021,3,3109,55,24,7800,2,47,5,0,5,5,4,1,4,0,False,False,False,0,4,2021-09-28T09:19:54.64,5,False,1.0
2021,3,3109,60,24,7798,13,9,2,31,0,0,0,0,0,0,False,False,False,0,2,2021-09-28T09:21:11.31,0,False,0.0
2021,3,3109,90,9,322,2,4,3,7,7,0,7,0,7,0,False,False,False,0,2,2021-09-28T09:28:37.757,7,False,0.0
2021,3,3109,110,9,7816,13,4,5,6,0,0,0,0,0,0,False,False,False,0,2,2021-09-28T09:35:13.493,0,False,
2021,3,3109,115,9,6446,13,8,8,26,0,0,0,0,0,0,False,False,False,0,3,2021-09-28T09:37:13.623,0,False,0.0
2021,3,3109,125,9,4447,2,39,10,3,8,5,4,4,4,0,False,False,False,0,4,2021-09-28T09:39:30.773,8,False,4.0
2021,3,3109,140,9,4202,2,47,5,3,4,1,4,0,4,0,False,False,False,0,4,2021-09-28T09:44:05.903,4,False,0.0
2021,3,3109,150,24,894,3,4,4,4,0,0,0,0,0,0,False,False,False,0,3,2021-09-28T09:48:32.657,0,False,0.0
2021,3,3109,155,24,8509,2,4,3,5,5,0,5,0,5,0,False,False,False,0,2,2021-09-28T09:50:07.217,5,False,0.0
2021,3,3109,185,9,6446,2,35,10,10,12,2,12,0,12,0,False,False,False,0,4,2021-09-28T09:56:18.807,12,False,0.0
2021,3,3109,200,9,6446,2,9,2,17,19,2,19,0,19,6,True,False,False,0,4,2021-09-28T10:00:55.297,19,True,0.0
2021,3,3109,215,24,6937,2,48,9,-5,9,14,5,4,5,0,False,False,False,1,1,2021-09-28T10:04:24.79,9,False,4.0
2021,3,3109,225,24,894,13,12,5,13,0,0,0,0,0,0,False,False,False,0,3,2022-02-01T20:43:17.55,0,False,0.0
2021,3,3109,245,9,4202,2,48,10,-6,0,6,-2,2,-2,0,False,False,False,0,1,2021-09-28T10:16:07.91,0,False,
2021,3,3109,255,9,4446,2,12,5,9,9,0,9,0,9,0,False,False,False,0,2,2021-09-28T10:18:55.977,9,True,0.0
2021,3,3109,265,9,6446,2,13,9,4,8,4,6,2,6,0,False,False,False,0,3,2021-09-28T10:21:29.623,8,False,2.0
2021,3,3109,290,9,4447,2,32,10,2,6,4,3,3,3,0,False,False,False,0,4,2021-09-28T10:26:29.183,6,False,3.0
2021,3,3109,300,9,4202,2,48,10,-4,9,13,8,1,8,0,True,False,False,0,1,2021-10-01T18:23:56.9,9,False,1.0
2021,3,3109,310,9,322,2,18,5,-2,6,8,4,2,4,0,False,False,False,0,2,2021-09-28T10:31:51.243,6,False,2.0
2021,3,3109,350,24,6373,13,6,9,5,0,0,0,0,0,0,False,False,False,0,2,2021-09-28T10:41:27.253,0,False,0.0
2021,3,3109,370,9,6441,13,19,6,34,0,0,0,0,0,0,True,False,False,0,3,2021-09-28T10:48:59.063,0,False,0.0
2021,3,3109,385,24,8509,2,4,10,6,19,13,7,12,7,0,False,False,False,1,3,2021-09-28T10:53:33.073,19,False,12.0
2021,3,3109,395,24,7800,2,12,1,19,21,2,20,1,20,0,False,False,False,0,3,2021-10-01T18:52:28.33,21,False,
2021,3,3109,405,24,7798,2,2,5,1,7,6,4,3,4,0,False,False,False,0,2,2021-10-01T19:10:25.13,7,False,3.0
2021,3,3109,410,24,6937,2,51,9,-8,19,27,15,4,15,0,False,False,False,0,1,2021-09-28T10:59:39.203,19,False,4.0
2021,3,3109,440,24,6373,2,13,9,3,28,25,21,7,21,0,False,False,False,1,4,2021-09-28T11:06:23.11,28,False,7.0
2021,3,3109,445,24,6373,13,13,10,5,0,0,0,0,0,0,False,False,False,0,4,2021-09-28T11:07:59.91,0,False,0.0
2021,3,3109,450,24,8509,13,5,3,6,0,0,0,0,0,0,False,False,False,0,3,2021-09-28T11:09:29.397,0,False,0.0
2021,3,3109,465,24,8513,13,11,3,1,0,0,0,0,0,0,False,False,False,0,1,2021-09-28T11:13:03.503,0,False,0.0
2021,3,3109,505,24,894,13,5,2,15,0,0,0,0,0,0,False,False,False,0,3,2021-09-28T11:22:13.847,0,False,0.0
2021,3,3109,525,24,7800,2,7,6,38,41,3,38,3,38,0,False,False,False,0,3,2021-09-28T11:26:21.157,41,False,3.0
2021,3,3109,535,24,894,2,30,10,0,27,27,23,4,23,0,False,False,False,0,4,2021-09-28T11:36:02.09,27,False,4.0
2021,3,3109,540,24,6937,2,51,9,-6,0,6,0,0,0,0,False,False,False,0,1,2021-09-28T11:50:51.44,0,True,0.0
2021,3,3109,550,24,894,2,47,10,2,3,1,3,0,3,6,False,False,False,0,4,2021-09-28T11:53:20.937,3,True,0.0
2021,3,3109,570,9,6441,2,8,1,15,15,0,15,0,15,0,False,False,False,0,3,2021-10-01T19:10:25.13,15,False,0.0
2021,3,3109,575,9,7816,2,4,9,14,15,1,14,1,14,0,False,False,False,0,3,2021-09-28T11:59:38.947,15,False,1.0
2021,3,3109,585,9,6441,13,4,10,5,0,0,0,0,0,0,False,False,False,0,3,2021-09-28T12:01:55.897,0,False,0.0
2021,3,3109,600,24,8509,2,50,9,0,10,10,6,4,6,0,False,False,False,1,2,2021-09-28T13:43:31.053,10,False,
2021,3,3109,605,24,8509,2,13,9,3,4,1,4,0,4,0,False,False,False,0,2,2021-09-28T12:07:11.573,4,False,0.0
2021,3,3109,610,24,6937,13,46,3,3,0,0,0,0,0,0,False,False,False,0,1,2021-09-28T12:09:12.72,0,False,0.0
2021,3,3109,615,24,8509,13,8,7,18,0,0,0,0,0,0,False,False,False,0,3,2021-09-28T12:10:39.787,0,False,0.0
2021,3,3109,625,9,322,2,2,9,7,13,6,11,2,11,0,True,False,False,0,2,2021-09-28T12:12:33.363,13,False,2.0
2021,3,3109,635,9,322,13,21,2,27,0,0,0,0,0,0,False,False,False,0,2,2021-09-28T12:16:23.637,0,False,0.0
2021,3,3109,640,9,6446,2,53,10,-4,11,15,8,3,8,0,False,False,False,1,4,2021-09-28T12:18:22.51,11,False,3.0
2021,3,3109,660,9,7816,2,18,3,-2,7,9,5,2,5,0,False,False,False,0,2,2021-09-28T12:29:09.503,7,False,2.0
2021,3,3109,680,9,4202,2,18,3,-1,7,8,4,3,4,0,False,False,False,0,3,2021-09-28T12:33:50.78,7,False,
2021,3,3109,690,9,6441,2,12,10,2,2,0,2,0,2,6,False,False,False,0,3,2021-09-28T12:36:07.327,2,True,0.0
2021,3,3109,705,24,8513,2,51,10,-6,1,7,-1,2,-1,0,False,False,False,0,1,2021-09-28T12:39:00.737,1,False,2.0
2021,3,3109,710,24,7798,2,2,10,4,5,1,4,1,4,0,False,False,False,0,2,2021-09-28T12:41:55.387,5,False,1.0
2021,3,3109,715,24,7798,2,13,9,5,12,7,9,3,9,0,True,False,False,0,3,2021-10-01T18:24:11.87,12,False,3.0
2021,3,3109,720,24,7800,2,11,2,20,24,4,21,3,21,0,False,False,False,0,4,2021-09-28T12:45:35.95,24,False,
2021,3,3109,725,24,7798,13,2,9,7,0,0,0,0,0,0,False,False,False,0,2,2021-10-01T18:53:03.3,0,False,0.0
2021,3,3109,730,24,8509,13,19,2,35,0,0,0,0,0,0,False,False,False,0,2,2021-10-01T19:21:10.743,0,False,0.0
2021,3,3109,735,24,7798,2,50,5,1,5,4,5,0,5,0,False,False,False,0,2,2021-09-28T12:52:12.683,5,False,0.0
2021,3,3109,750,9,7183,2,50,5,-2,5,7,5,0,5,0,False,False,False,0,2,2021-09-28T13:07:16.573,5,False,0.0
2021,3,3109,755,9,6446,2,47,5,3,22,19,17,5,17,6,False,False,False,2,4,2021-09-28T13:10:28.01,22,False,5.0
2021,3,3109,775,24,894,2,5,10,8,7,-1,7,0,7,0,False,False,False,0,3,2021-09-28T13:14:25.833,7,False,0.0
2021,3,3109,780,24,7798,2,35,6,22,24,2,23,1,23,0,False,False,False,0,3,2021-10-01T18:24:57.49,24,False,1.0
2021,3,3109,785,24,8513,2,12,5,5,5,0,5,0,5,0,False,False,False,0,1,2021-09-28T13:18:08.947,5,False,
2021,3,3109,790,24,6373,2,12,5,3,7,4,5,2,5,0,False,False,False,0,4,2022-02-01T20:44:37.047,7,False,
2021,3,3109,795,24,8513,2,48,10,-7,19,26,5,14,5,0,False,False,False,0,1,2021-09-28T13:24:21.723,19,False,14.0
2021,3,3109,800,24,894,2,17,10,12,16,4,15,1,15,0,False,False,False,0,4,2021-09-28T13:25:28.573,16,False,1.0
2021,3,3109,805,24,8513,2,46,9,0,12,12,5,7,5,0,False,False,False,1,1,2021-09-28T13:26:27.63,12,False,7.0
2021,3,3109,810,24,4382,2,12,2,15,15,0,15,0,15,6,False,False,False,0,3,2021-09-28T13:27:43.59,15,True,0.0
2021,3,3109,850,24,6389,2,48,10,-7,-4,3,-5,1,-5,0,False,False,False,0,1,2021-09-28T13:34:58.507,-4,False,1.0
2021,3,3109,855,24,7798,13,3,3,12,0,0,0,0,0,0,False,False,False,0,2,2021-10-01T18:24:31.13,0,False,0.0
2021,3,3109,860,24,6389,2,51,9,-6,9,15,9,0,9,0,False,False,False,0,1,2021-09-28T13:37:16.687,9,False,0.0
2021,4,3110,45,15,7591,13,17,7,24,0,0,0,0,0,0,False,False,False,0,3,2021-10-01T11:36:46.7,0,False,0.0
2021,4,3110,55,7,3521,2,13,9,2,33,31,31,2,31,0,False,False,False,0,3,2021-10-01T11:42:16.503,33,False,2.0
2021,4,3110,60,7,8317,2,50,9,-2,-2,0,-2,0,-2,0,False,False,False,0,2,2021-10-01T11:45:13.67,-2,False,0.0
2021,4,3110,65,7,3521,13,9,3,8,0,0,0,0,0,0,False,False,False,0,3,2021-10-01T11:46:35.357,0,False,0.0
2021,4,3110,70,7,8317,2,5,6,15,15,0,15,0,15,0,False,False,False,0,3,2021-10-01T11:47:56.473,15,False,0.0
2021,4,3110,75,7,6383,2,2,4,10,18,8,10,8,10,0,False,False,False,2,3,2021-10-01T11:49:37.043,18,False,8.0
2021,4,3110,85,7,4679,2,48,10,-3,0,3,0,0,0,0,False,False,False,0,1,2021-10-01T11:51:31.847,0,False,0.0
2021,4,3110,90,7,8317,2,29,5,11,13,2,11,2,11,0,False,False,False,0,2,2021-10-01T16:37:46.103,13,False,
2021,4,3110,95,7,3521,2,50,9,-3,10,13,4,6,4,0,False,False,False,0,3,2021-10-01T11:57:17.927,10,False,6.0
2021,4,3110,110,15,957,2,4,5,7,8,1,8,0,8,0,False,False,False,0,2,2021-10-01T12:01:50.11,8,True,0.0
2021,4,3110,135,15,5152,2,51,10,0,17,17,9,8,9,0,False,False,False,1,4,2021-10-01T12:13:57.937,17,False,8.0
2021,4,3110,160,7,8317,13,2,9,12,0,0,0,0,0,0,False,False,False,0,2,2021-10-01T12:19:49.67,0,False,0.0
2021,4,3110,165,7,2631,13,12,5,9,0,0,0,0,0,0,False,False,False,0,3,2021-10-01T12:21:39.1,0,False,0.0
2021,4,3110,175,15,914,2,2,9,7,7,0,7,0,7,0,False,False,False,0,3,2021-10-01T12:24:33.57,7,False,0.0
2021,4,3110,195,15,957,13,4,4,12,0,0,0,0,0,0,False,False,False,0,2,2021-10-02T18:48:08.327,0,False,0.0
2021,4,3110,210,7,3521,2,35,10,12,21,9,17,4,17,0,False,False,False,0,3,2021-10-01T12:32:52.957,21,False,4.0
2021,4,3110,225,7,3521,13,12,2,36,0,0,0,0,0,0,False,False,False,0,3,2021-10-01T12:41:40.277,0,False,0.0
2021,4,3110,235,15,5152,2,30,10,0,12,12,8,4,8,0,True,False,False,1,4,2021-10-07T17:03:42.14,12,False,4.0
2021,4,3110,255,15,914,2,5,5,6,10,4,7,3,7,0,False,False,False,0,3,2021-10-01T12:50:39.907,10,False,3.0
2021,4,3110,270,15,3750,2,39,4,4,7,3,6,1,6,0,False,False,False,0,4,2021-10-01T12:54:21.63,7,False,1.0
2021,4,3110,280,15,8343,2,13,10,4,7,3,4,3,4,0,False,False,False,0,4,2021-10-01T16:52:27.64,7,False,3.0
2021,4,3110,315,7,3445,2,13,9,0,0,0,0,0,0,0,False,False,False,0,3,2021-10-01T13:05:47.68,0,False,0.0
2021,4,3110,325,15,7591,2,12,2,47,52,5,52,0,52,0,True,False,False,0,3,2022-02-07T19:51:11.773,52,False,0.0
2021,4,3110,355,15,7591,2,2,9,4,7,3,4,3,4,0,False,False,False,0,2,2021-10-01T13:12:05.27,7,False,3.0
2021,4,3110,400,7,8317,13,4,3,7,0,0,0,0,0,0,False,False,False,0,2,2021-10-01T13:20:20.72,0,False,0.0
2021,4,3110,405,7,8317,2,19,6,27,44,17,41,3,41,0,False,False,False,0,2,2021-10-01T13:30:39.713,44,False,3.0
2021,4,3110,415,7,2631,2,30,9,4,22,18,14,8,14,6,True,False,False,1,4,2022-02-16T13:29:20.34,22,False,8.0
2021,4,3110,440,15,8099,13,28,10,-3,0,0,0,0,0,0,False,False,False,0,1,2021-10-07T16:58:21.23,0,False,0.0
2021,4,3110,460,7,7046,2,24,6,24,25,1,25,0,25,0,False,False,False,0,3,2021-10-01T13:56:23.49,25,True,0.0
2021,4,3110,465,7,4679,3,48,9,-7,0,0,0,0,0,0,False,False,False,0,1,2022-02-16T13:29:51.55,0,False,0.0
2021,4,3110,470,7,3521,2,5,3,6,12,6,11,1,11,0,False,False,False,0,3,2021-10-01T14:01:35.353,12,False,1.0
2021,4,3110,490,7,8317,2,50,9,0,1,1,0,1,0,0,False,False,False,1,2,2021-10-01T14:14:47.163,1,False,1.0
2021,4,3110,495,7,3521,2,4,10,8,11,3,11,0,11,0,False,False,False,0,3,2021-10-01T14:15:42.08,11,False,0.0
2021,4,3110,525,15,7591,2,50,9,-3,4,7,2,2,2,0,False,False,False,0,2,2021-10-01T14:34:26.427,4,False,2.0
2021,4,3110,530,15,4487,2,35,6,27,27,0,27,0,27,0,False,False,False,0,3,2022-02-16T13:31:02.333,27,True,0.0
2021,4,3110,545,15,957,13,5,3,5,0,0,0,0,0,0,False,False,False,0,3,2021-10-01T14:45:03.48,0,False,0.0
2021,4,3110,550,15,7591,2,5,3,1,5,4,4,1,4,0,False,False,False,0,3,2021-10-01T14:47:35.553,5,False,1.0
2021,4,3110,560,15,4835,2,28,9,2,5,3,3,2,3,0,True,False,False,0,1,2021-10-01T14:52:36.13,5,False,2.0
2021,4,3110,565,15,7591,2,5,5,7,20,13,7,13,7,0,False,False,False,1,3,2021-10-07T16:54:25.313,20,False,13.0
2021,4,3110,570,15,8099,2,28,10,-5,-2,3,-2,0,-2,0,False,False,False,0,1,2021-10-01T14:59:34.113,-2,False,0.0
2021,4,3110,605,7,2631,2,5,10,5,8,3,7,1,7,0,False,False,False,0,3,2021-10-01T15:23:40.233,8,False,1.0
2021,4,3110,620,7,3521,2,4,5,4,4,0,4,0,4,0,False,False,False,0,3,2021-10-01T15:27:14.39,4,False,0.0
2021,4,3110,625,7,3521,2,2,9,5,8,3,5,3,5,0,False,False,False,0,2,2021-10-01T15:30:32.67,8,False,3.0
2021,4,3110,635,7,8317,2,2,10,7,12,5,10,2,10,0,False,False,False,0,3,2021-10-02T14:57:20.18,12,False,2.0
2021,4,3110,640,7,8317,13,19,2,30,0,0,0,0,0,0,False,False,False,0,2,2021-10-01T15:35:44.333,0,False,0.0
2021,4,3110,645,7,8317,2,2,4,5,7,2,6,1,6,0,False,False,False,0,3,2021-10-01T15:37:21.327,7,False,1.0
2021,4,3110,650,7,2631,2,12,6,15,31,16,31,0,31,6,False,False,False,0,3,2021-10-01T15:40:32.86,31,True,0.0
2021,4,3110,665,15,914,2,3,3,7,7,0,7,0,7,0,True,False,False,0,2,2022-02-16T13:31:25.917,7,False,0.0
2021,4,3110,675,15,7591,2,6,9,11,11,0,11,0,11,0,False,False,False,0,3,2021-10-01T15:50:40.687,11,False,0.0
2021,4,3110,695,15,7514,13,12,6,34,0,0,0,0,0,0,False,False,False,0,3,2022-02-16T13:32:42.377,0,False,0.0
2021,4,3110,705,7,3521,2,42,4,5,12,7,10,2,10,0,False,False,False,0,3,2021-10-01T16:02:07.62,12,False,2.0
2021,4,3110,730,7,4455,2,4,5,3,15,12,11,4,11,0,False,False,False,0,2,2021-10-01T16:16:17.547,15,False,4.0
2021,4,3110,740,7,2631,2,4,4,5,9,4,6,3,6,0,False,False,False,0,3,2021-10-01T16:18:50.377,9,False,3.0
2021,4,3110,755,7,3521,2,26,9,5,7,2,5,2,5,0,False,False,False,1,3,2021-10-01T16:24:18.673,7,False,2.0
2021,4,3110,760,7,2631,2,50,5,1,25,24,15,10,15,0,False,False,False,0,2,2021-10-01T16:28:26.337,25,False,10.0
2021,4,3111,20,22,4997,13,4,8,15,0,0,0,0,0,0,False,False,False,0,2,2021-10-04T09:41:24.767,0,False,0.0
2021,4,3111,45,31,6390,13,9,2,35,0,0,0,0,0,0,False,False,False,0,3,2021-10-04T10:03:02.96,0,False,0.0
2021,4,3111,55,31,4545,2,48,9,-6,27,33,25,2,25,0,True,False,False,1,1,2021-10-05T18:49:54.913,27,False,2.0
2021,4,3111,65,31,7913,2,51,3,-1,5,6,2,3,2,0,False,False,False,0,3,2021-10-04T10:18:23.967,5,False,3.0
2021,4,3111,70,31,7913,13,29,2,17,0,0,0,0,0,0,False,False,False,0,2,2021-10-04T10:22:24.097,0,False,
2021,4,3111,85,31,4875,13,9,6,19,0,0,0,0,0,0,False,False,False,0,3,2022-02-16T15:21:37.783,0,False,0.0
2021,4,3111,110,22,743,2,48,9,-6,9,15,8,1,8,0,False,False,False,0,1,2021-10-04T10:29:44.08,9,False,1.0
2021,4,3111,120,22,8451,2,50,10,-4,-4,0,-4,0,-4,0,True,False,False,0,3,2021-10-04T10:32:24.993,-4,False,0.0
2021,4,3111,125,22,5080,3,6,4,13,0,0,0,0,0,0,False,False,False,0,3,2021-10-04T10:33:53.21,0,False,0.0
2021,4,3111,150,31,4875,2,2,9,5,11,6,7,4,7,0,False,False,False,0,2,2021-10-04T17:30:35.93,11,False,4.0
2021,4,3111,155,31,7916,2,11,3,10,14,4,14,0,14,0,True,False,False,0,4,2022-02-18T19:34:10.833,14,False,0.0
2021,4,3111,170,31,3504,2,47,5,2,16,14,12,4,12,0,False,False,False,1,1,2021-10-04T10:51:07.86,16,False,4.0
2021,4,3111,215,22,5080,13,6,7,18,0,0,0,0,0,0,False,False,False,0,2,2021-10-04T11:07:34.89,0,False,0.0
2021,4,3111,220,31,3504,2,4,10,2,4,2,2,2,2,0,True,False,False,0,1,2021-10-05T18:50:09.453,4,False,2.0
2021,4,3111,230,31,6390,13,29,5,10,0,0,0,0,0,0,False,False,False,0,3,2021-10-04T11:17:02.113,0,False,0.0
2021,4,3111,250,22,2391,13,35,10,13,0,0,0,0,0,0,False,False,False,0,4,2021-10-04T11:22:58.153,0,False,0.0
2021,4,3111,255,22,2629,13,12,2,24,0,0,0,0,0,0,False,False,False,0,4,2022-02-16T15:22:21.48,0,False,0.0
2021,4,3111,260,22,5080,2,5,5,13,13,0,13,0,13,0,False,True,False,0,2,2021-10-08T17:13:06.813,13,False,0.0
2021,4,3111,265,22,5080,2,5,6,15,30,15,15,15,15,0,True,False,False,1,3,2021-10-08T17:14:05.023,30,False,15.0
2021,4,3111,270,22,2391,2,32,10,2,8,6,6,2,6,0,False,False,False,0,4,2021-10-08T15:45:21.543,8,False,2.0
2021,4,3111,285,22,6812,2,46,9,1,6,5,4,2,4,0,False,False,False,0,1,2021-10-04T11:43:23.907,6,False,2.0
2021,4,3111,295,22,3170,2,51,9,-2,3,5,1,2,1,0,False,False,False,0,3,2021-10-08T17:14:32.303,3,False,2.0
2021,4,3111,330,31,7913,13,5,5,3,0,0,0,0,0,0,True,False,False,0,3,2021-10-05T18:50:21.31,0,False,0.0
2021,4,3111,370,31,6724,2,4,10,4,7,3,6,1,6,0,False,False,False,0,3,2021-10-04T12:23:59.33,7,False,1.0
2021,4,3111,375,31,3911,2,2,4,6,10,4,6,4,6,0,False,False,False,0,3,2021-10-04T12:25:14.727,10,False,4.0
2021,4,3111,380,31,4545,2,48,9,-6,0,6,0,0,0,0,False,False,False,0,1,2021-10-04T12:26:30.167,0,True,0.0
2021,4,3111,385,31,3911,2,5,5,8,12,4,10,2,10,0,False,False,False,0,3,2021-10-04T12:28:00.093,12,False,2.0
2021,4,3111,390,31,4875,2,4,3,7,7,0,7,0,7,0,False,False,False,0,2,2021-10-04T17:30:57.133,7,False,0.0
2021,4,3111,395,31,3504,2,47,10,-4,5,9,4,1,4,0,False,False,False,0,1,2021-10-04T12:37:13.33,5,False,
2021,4,3111,400,31,6724,2,4,10,8,10,2,8,2,8,0,False,False,False,0,3,2021-10-08T17:15:48.24,10,False,2.0
2021,4,3111,435,31,4875,2,13,4,3,9,6,5,4,5,0,False,False,False,0,3,2021-10-04T17:31:20.76,9,False,4.0
2021,4,3111,450,31,4545,2,47,5,0,1,1,1,0,1,0,False,False,False,0,1,2022-02-16T15:23:33.563,1,False,0.0
2021,4,3111,455,31,4875,13,19,8,50,0,0,0,0,0,0,False,False,False,0,3,2021-10-08T15:45:21.543,0,False,0.0
2021,4,3111,475,22,3170,2,5,3,6,6,0,6,0,6,0,True,False,False,0,3,2021-10-04T13:04:22.753,6,False,0.0
2021,4,3111,490,31,968,2,12,10,-2,4,6,3,1,3,0,False,False,False,0,5,2022-02-16T15:24:25.34,4,False,
2021,4,3111,495,31,4545,2,48,9,-6,23,29,-4,27,-4,0,False,False,False,0,1,2021-10-06T21:28:20.493,23,False,27.0
2021,4,3111,500,31,4875,2,2,9,8,9,1,8,1,8,0,False,False,False,0,3,2021-10-04T13:15:25.4,9,False,1.0
2021,4,3111,515,31,6390,13,21,2,25,0,0,0,0,0,0,False,False,False,0,2,2021-10-04T13:23:39.977,0,False,0.0
2021,4,3111,540,22,5080,2,2,9,12,15,3,13,2,13,0,False,False,False,0,3,2021-10-04T13:30:06.737,15,False,2.0
2021,4,3111,545,22,6812,2,4,4,4,6,2,5,1,5,0,False,False,False,0,1,2021-10-04T13:31:44.433,6,False,1.0
2021,4,3111,555,22,4997,2,12,2,50,54,4,54,0,54,0,False,False,False,0,2,2021-10-04T13:35:41.633,54,False,0.0
2021,4,3111,560,22,3170,3,51,3,2,0,0,0,0,0,0,False,False,False,0,3,2021-10-06T21:15:48.94,0,False,0.0
2021,4,3111,565,22,3170,2,50,5,-2,5,7,3,2,3,0,False,False,False,0,2,2021-10-04T13:39:26.903,5,False,2.0
2021,4,3111,570,22,2391,13,7,5,9,0,0,0,0,0,0,False,False,False,0,4,2021-10-04T13:47:02.3,0,False,0.0
2021,4,3111,585,31,2901,2,53,9,-6,14,20,11,3,11,0,False,False,False,1,4,2021-10-04T13:49:25.903,14,False,3.0
2021,4,3111,630,22,5080,13,12,8,44,0,0,0,0,0,0,False,False,False,0,3,2021-10-05T22:02:28.717,0,False,
2021,4,3111,635,22,3170,13,5,3,9,0,0,0,0,0,0,False,False,False,0,3,2021-10-04T14:05:16.067,0,False,0.0
2021,4,3111,640,22,3170,2,35,6,25,29,4,29,0,29,0,False,False,False,0,3,2021-10-04T14:36:33.7,29,False,0.0
2021,4,3111,650,22,3170,2,5,5,3,3,0,3,0,3,6,False,False,False,0,3,2021-10-04T14:13:07.803,3,True,0.0
2021,4,3111,685,22,5080,2,12,2,51,53,2,51,2,51,6,True,False,False,0,3,2022-02-16T15:25:17.507,53,False,2.0
2021,4,3111,700,31,6724,3,13,10,3,0,0,0,0,0,0,False,False,False,0,4,2021-10-04T14:25:45.313,0,False,0.0
2021,4,3111,705,31,2865,13,17,7,15,0,0,0,0,0,0,False,False,False,0,4,2021-10-04T14:28:37.987,0,False,0.0
2021,4,3111,710,31,4875,13,9,6,23,0,0,0,0,0,0,False,False,False,0,2,2021-10-04T14:31:28.86,0,False,0.0
2021,4,3111,720,22,8451,13,12,5,0,0,0,0,0,0,0,False,False,False,0,1,2022-02-16T15:26:01.49,0,False,0.0
2021,4,3111,725,22,3170,2,5,3,2,4,2,4,0,4,0,False,False,False,0,3,2021-10-04T14:40:18.063,4,False,0.0
2021,4,3111,745,31,7913,2,2,10,11,18,7,15,3,15,0,False,False,False,0,3,2021-10-04T15:23:33.803,18,False,3.0
2021,4,3111,755,31,7913,13,6,7,20,0,0,0,0,0,0,False,False,False,0,3,2022-02-18T19:38:19.567,0,False,0.0
2021,4,3111,760,31,4545,2,44,9,-2,9,11,8,1,8,0,False,False,False,0,1,2021-10-04T15:32:10.97,9,False,1.0
2021,4,3111,775,31,4545,13,48,10,-4,0,0,0,0,0,0,False,False,False,0,1,2021-10-04T15:43:59.553,0,False,0.0
2021,4,3111,780,31,7913,13,35,10,14,0,0,0,0,0,0,True,False,False,0,3,2021-10-04T15:48:25.56,0,False,0.0
2021,4,3111,815,22,6270,2,30,9,-7,0,7,-1,1,-1,0,True,False,False,0,3,2021-10-08T17:07:38.1,0,False,1.0
2021,4,3111,825,22,5080,13,5,5,14,0,0,0,0,0,0,False,False,False,0,2,2021-10-04T15:57:36.12,0,False,0.0
2021,4,3111,845,31,3911,13,5,5,7,0,0,0,0,0,0,False,False,False,0,3,2021-10-04T16:00:24.717,0,False,0.0
2021,4,3111,850,31,7913,13,12,2,30,0,0,0,0,0,0,False,False,False,0,2,2021-10-04T16:04:21.317,0,False,0.0
2021,4,3111,855,31,3911,13,6,1,22,0,0,0,0,0,0,False,False,False,0,3,2021-10-04T16:06:07.413,0,False,
2021,4,3111,860,31,4545,2,48,10,-4,15,19,4,11,4,0,False,False,False,1,1,2021-10-04T16:08:49.783,15,False,11.0
2021,4,3111,870,31,4545,13,32,10,-2,0,0,0,0,0,0,False,False,False,0,1,2021-10-04T16:17:40.603,0,False,0.0
2021,4,3111,875,31,4875,2,2,10,8,12,4,11,1,11,0,False,False,False,0,2,2021-10-04T16:15:37.733,12,False,1.0
2021,4,3111,885,31,4875,2,5,3,11,11,0,11,0,11,0,False,False,False,0,3,2021-10-04T16:20:31.697,11,False,0.0
2021,4,3111,890,31,7913,2,4,10,4,6,2,5,1,5,0,False,False,False,0,2,2021-10-04T16:21:48.113,6,False,1.0
2021,4,3111,895,31,6724,2,13,10,6,6,0,6,0,6,0,False,False,False,0,3,2021-10-04T16:23:41.73,6,False,0.0
2021,4,3111,900,31,7913,13,6,10,2,0,0,0,0,0,0,False,False,False,0,3,2021-10-06T21:28:53.72,0,False,0.0
2021,4,3111,905,31,6390,2,46,3,1,2,1,2,0,2,6,True,False,False,0,3,2021-10-04T16:30:53.973,2,True,0.0
2021,4,3111,935,22,8451,13,5,5,2,0,0,0,0,0,0,False,False,False,0,1,2021-10-04T16:42:41.13,0,False,0.0
2021,4,3111,940,22,4997,2,2,10,6,9,3,7,2,7,0,False,False,False,0,2,2021-10-04T16:46:11.553,9,False,2.0
2021,4,3111,950,22,7121,13,12,3,1,0,0,0,0,0,0,False,False,False,0,1,2021-10-08T17:08:18.78,0,False,0.0
2021,4,3111,965,22,4997,2,7,6,29,29,0,29,0,29,0,False,False,False,0,3,2021-10-04T16:55:07.127,29,True,0.0
2021,4,3111,980,22,3170,2,5,5,6,11,5,9,2,9,0,False,False,False,0,3,2021-10-04T16:58:18.027,11,False,2.0
2021,4,3111,990,22,2391,13,13,5,5,0,0,0,0,0,0,False,False,False,0,4,2021-10-04T17:00:23.703,0,False,0.0
2021,4,3111,995,22,743,2,48,10,-5,8,13,-2,10,-2,0,False,False,False,0,1,2021-10-04T17:03:30.59,8,False,10.0
2021,4,3111,1025,31,3911,2,4,8,15,20,5,20,0,20,0,False,False,False,0,3,2021-10-08T15:02:00.71,20,False,0.0
2021,4,3111,1040,31,4545,2,48,4,-6,-6,0,-6,0,-6,0,False,False,False,0,1,2021-10-08T15:45:21.543,-6,True,0.0
2021,4,3111,1045,31,4545,2,5,4,2,5,3,4,1,4,0,False,False,False,0,1,2022-02-18T19:44:33.937,5,False,1.0
2021,4,3111,1050,31,3911,2,5,3,9,9,0,9,0,9,0,False,False,False,0,2,2022-02-18T19:43:50.543,9,False,0.0
2021,4,3111,1060,31,3911,2,6,10,10,12,2,12,0,12,0,False,False,False,0,3,2021-10-04T17:16:18.433,12,False,0.0
2021,4,3111,1070,31,4545,13,32,5,-1,0,0,0,0,0,0,False,False,False,0,4,2021-10-04T17:18:46.573,0,False,0.0
2021,4,3111,1075,31,3911,2,13,4,5,7,2,6,1,6,0,False,False,False,0,3,2021-10-04T17:20:37.58,7,False,
2021,4,3111,1080,31,6724,3,17,8,15,0,0,0,0,0,0,False,False,False,0,3,2021-10-06T21:19:10.613,0,False,0.0
2021,4,3111,1090,31,4545,13,12,4,2,0,0,0,0,0,0,False,False,False,0,1,2022-02-07T19:54:00.263,0,False,0.0
2021,4,3112,15,24,894,2,30,10,2,13,11,9,4,9,0,True,False,False,0,4,2021-10-04T09:17:23.33,13,False,4.0
2021,4,3112,20,24,8509,2,50,9,-2,22,24,11,11,11,0,False,False,False,1,2,2021-10-08T21:15:31.69,22,False,11.0
2021,4,3112,25,24,6373,2,17,9,14,21,7,21,0,21,0,False,False,False,0,4,2021-10-04T09:24:50.847,21,False,0.0
2021,4,3112,35,24,894,13,17,7,16,0,0,0,0,0,0,False,False,False,0,3,2021-10-04T09:29:40.35,0,False,0.0
2021,4,3112,75,16,7681,2,47,10,-1,11,12,11,0,11,0,False,False,False,0,1,2021-10-04T09:59:42.037,11,False,0.0
2021,4,3112,85,16,3938,2,4,9,9,9,0,9,0,9,0,False,False,False,1,3,2021-10-04T10:08:21.26,9,False,0.0
2021,4,3112,95,16,3938,2,4,7,17,36,19,17,19,17,0,False,False,False,1,3,2021-10-04T11:55:25.173,36,False,19.0
2021,4,3112,100,16,7681,2,55,10,0,1,1,0,1,0,6,False,False,False,0,1,2021-10-08T21:27:48.95,1,False,1.0
2021,4,3112,125,24,7800,2,47,5,3,12,9,12,0,12,0,False,False,False,0,4,2021-10-04T10:33:48.937,12,False,0.0
2021,4,3112,130,24,6937,2,5,10,2,10,8,3,7,3,0,False,False,False,1,1,2021-10-08T21:17:31.783,10,False,7.0
2021,4,3112,140,24,8509,2,2,10,5,6,1,5,1,5,0,False,False,False,0,2,2021-10-04T16:39:36.763,6,False,1.0
2021,4,3112,145,24,7800,2,47,5,2,3,1,3,0,3,0,False,False,False,0,4,2022-02-16T15:36:38.08,3,False,0.0
2021,4,3112,155,24,894,2,31,4,4,5,1,5,0,5,0,False,False,False,0,3,2021-10-04T10:46:17.427,5,False,0.0
2021,4,3112,160,24,8513,2,13,10,4,12,8,10,2,10,0,True,False,False,0,2,2021-10-04T10:50:09.6,12,False,2.0
2021,4,3112,170,24,8513,2,50,5,-1,15,16,12,3,12,0,False,False,False,0,2,2021-10-04T10:57:16.143,15,False,3.0
2021,4,3112,175,24,6373,2,5,5,3,3,0,3,0,3,6,False,False,False,0,3,2021-10-04T10:58:31.863,3,True,0.0
2021,4,3112,235,16,7176,2,51,10,-3,9,12,4,5,4,0,False,False,False,0,3,2021-10-04T11:33:56.433,9,False,5.0
2021,4,3112,240,16,3938,2,50,5,-2,2,4,1,1,1,0,True,False,False,0,2,2021-10-08T21:29:41.163,2,False,1.0
2021,4,3112,250,16,6500,2,8,1,15,19,4,19,0,19,0,False,False,False,0,3,2021-10-04T11:43:19.033,19,False,0.0
2021,4,3112,255,16,7176,2,44,3,-3,10,13,7,3,7,0,True,False,False,0,2,2022-02-16T15:38:30.987,10,False,
2021,4,3112,260,16,3938,2,19,2,26,32,6,32,0,32,0,False,False,False,0,2,2021-10-08T21:30:54.637,32,True,0.0
2021,4,3112,265,16,374,2,55,4,-2,4,6,1,3,1,0,False,False,False,0,4,2021-10-04T11:52:16.843,4,False,3.0
2021,4,3112,270,16,8537,13,12,5,6,0,0,0,0,0,0,False,False,False,0,4,2022-02-16T15:39:08.867,0,False,0.0
2021,4,3112,275,16,3938,2,5,9,6,6,0,6,0,6,6,False,False,False,0,3,2021-10-04T12:02:11.437,6,True,0.0
2021,4,3112,310,24,8509,2,4,10,7,7,0,7,0,7,0,False,False,False,0,2,2021-10-08T23:16:47.237,7,False,0.0
2021,4,3112,315,24,7800,13,7,6,22,0,0,0,0,0,0,False,False,False,0,3,2022-02-14T18:49:04.223,0,False,0.0
2021,4,3112,320,24,8513,2,11,3,3,14,11,14,0,14,0,True,False,False,0,2,2021-10-04T12:25:23.08,14,False,0.0
2021,4,3112,330,24,7800,2,50,3,-1,18,19,14,4,14,0,False,False,False,0,2,2021-10-04T16:37:47.283,18,False,4.0
2021,4,3112,335,24,6937,2,46,3,2,6,4,6,0,6,0,False,False,False,0,1,2021-10-04T12:32:14.327,6,False,0.0
2021,4,3112,340,24,6373,2,30,3,1,6,5,1,5,1,0,False,False,False,0,4,2021-10-04T17:17:37.353,6,False,
2021,4,3112,345,24,4382,13,5,5,3,0,0,0,0,0,0,False,False,False,0,3,2022-02-16T15:40:29.04,0,False,0.0
2021,4,3112,355,24,7800,13,12,9,7,0,0,0,0,0,0,False,False,False,0,3,2022-02-18T19:59:20.907,0,False,0.0
2021,4,3112,380,16,6500,2,32,3,4,4,0,4,0,4,0,False,False,False,0,4,2021-10-04T12:51:23.44,4,False,0.0
2021,4,3112,395,16,7176,13,7,6,15,0,0,0,0,0,0,False,False,False,0,3,2021-10-04T12:55:16.09,0,False,0.0
2021,4,3112,400,16,6499,2,48,10,-5,9,14,9,0,9,0,False,False,False,2,1,2021-10-04T16:37:34.037,9,False,0.0
2021,4,3112,415,16,7170,2,55,9,-1,2,3,1,1,1,6,False,False,False,0,4,2022-02-18T19:57:25.563,2,False,1.0
2021,4,3112,430,24,8509,2,7,2,37,37,0,37,0,37,0,False,False,False,0,3,2021-10-08T21:46:03.85,37,False,0.0
2021,4,3112,435,24,8509,2,5,5,12,12,0,12,0,12,0,False,False,False,0,2,2021-10-08T21:40:18.887,12,True,0.0
2021,4,3112,440,24,8509,13,4,5,13,0,0,0,0,0,0,False,False,False,0,2,2022-02-18T19:56:49.287,0,False,0.0
2021,4,3112,445,24,8513,2,28,3,0,1,1,1,0,1,0,False,False,False,0,1,2021-10-08T20:32:15.56,1,False,0.0
2021,4,3112,470,16,3938,2,2,9,9,15,6,13,2,13,0,False,False,False,0,3,2021-10-04T13:34:28.383,15,False,2.0
2021,4,3112,475,16,7176,2,51,10,-3,7,10,3,4,3,0,False,False,False,1,3,2021-10-04T13:37:33.56,7,False,4.0
2021,4,3112,480,16,3938,13,19,3,7,0,0,0,0,0,0,False,False,False,0,2,2022-02-18T19:59:53.55,0,False,0.0
2021,4,3112,490,16,374,13,4,4,10,0,0,0,0,0,0,False,False,False,0,3,2021-10-08T21:13:28.647,0,False,0.0
2021,4,3112,500,24,8509,2,3,2,17,21,4,21,0,21,0,False,False,False,0,3,2021-10-04T13:51:42.303,21,False,0.0
2021,4,3112,505,24,894,2,2,10,7,8,1,7,1,7,0,False,False,False,0,4,2022-02-16T15:40:51.833,8,False,1.0
2021,4,3112,520,24,8513,2,4,10,3,7,4,7,0,7,0,False,False,False,0,1,2021-10-04T16:37:08.093,7,False,0.0
2021,4,3112,535,24,894,13,36,9,12,0,0,0,0,0,0,False,False,False,0,4,2022-02-16T15:41:39.773,0,False,0.0
2021,4,3112,540,24,894,2,4,10,6,6,0,6,0,6,0,False,False,False,0,4,2021-10-04T14:06:38.44,6,False,0.0
2021,4,3112,555,24,894,2,47,5,1,3,2,2,1,2,0,False,False,False,0,4,2021-10-08T21:41:15.823,3,False,
2021,4,3112,570,16,374,2,54,10,-1,6,7,6,0,6,0,False,False,False,0,4,2021-10-04T14:24:26.333,6,False,0.0
2021,4,3112,580,16,374,2,4,4,3,3,0,3,0,3,0,False,False,False,0,4,2021-10-04T14:28:10.24,3,False,0.0
2021,4,3112,585,16,3938,2,2,3,7,14,7,12,2,12,0,True,False,False,0,2,2021-10-08T21:19:24.797,14,False,2.0
2021,4,3112,600,16,6499,2,32,3,1,7,6,7,0,7,0,False,False,False,0,1,2021-10-04T14:35:10.423,7,False,0.0
2021,4,3112,610,16,374,2,4,9,5,10,5,9,1,9,0,False,False,False,1,3,2021-10-04T16:36:42.78,10,False,1.0
2021,4,3112,635,24,6373,2,30,5,1,4,3,4,0,4,0,True,True,False,0,4,2021-10-08T21:41:47.05,4,False,0.0
2021,4,3112,640,24,6373,2,32,5,2,14,12,14,0,14,0,False,False,False,0,4,2021-10-04T14:48:19.57,14,False,0.0
2021,4,3112,660,24,6373,2,4,4,10,14,4,10,4,10,0,False,False,False,1,3,2021-10-08T23:17:16.703,14,False,4.0
2021,4,3112,670,24,8513,2,5,5,5,9,4,9,0,9,0,False,False,False,0,1,2021-10-04T15:00:34.863,9,False,0.0
2021,4,3112,710,16,374,13,2,9,6,0,0,0,0,0,0,False,False,False,0,2,2021-10-15T01:26:01.6,0,False,0.0
2021,4,3112,720,16,3938,2,5,5,2,5,3,5,0,5,0,False,False,False,0,3,2021-10-04T15:18:56.203,5,False,0.0
2021,4,3112,745,16,3938,2,2,9,9,12,3,12,0,12,6,True,False,False,0,2,2021-10-04T16:36:05.853,12,True,0.0
2021,4,3112,765,24,6937,2,28,9,-3,18,21,12,6,12,0,False,False,False,1,1,2021-10-08T21:20:51.933,18,False,6.0
2021,4,3112,770,24,7800,13,12,5,6,0,0,0,0,0,0,False,False,False,0,3,2021-10-04T15:35:00.917,0,False,0.0
2021,4,3112,775,24,894,2,7,6,19,19,0,19,0,19,0,False,False,False,0,3,2021-10-04T15:36:46.413,19,True,0.0
2021,4,3112,780,24,8509,13,19,6,34,0,0,0,0,0,0,False,False,False,0,2,2021-10-04T15:43:09.877,0,False,0.0
2021,4,3112,790,24,7800,13,4,9,12,0,0,0,0,0,0,False,False,False,0,3,2021-12-02T20:11:46.48,0,False,0.0
2021,4,3112,820,16,3938,2,5,3,11,11,0,11,0,11,0,False,False,False,0,3,2021-10-04T15:59:05.453,11,False,0.0
2021,4,3112,840,16,6499,2,47,5,0,8,8,8,0,8,0,False,False,False,0,1,2021-10-04T16:51:33.223,8,False,
2021,4,3112,850,16,3938,2,23,7,41,44,3,44,0,44,6,False,False,False,0,3,2021-10-04T16:09:51.363,44,True,0.0
2021,4,3112,865,24,8513,13,4,9,2,0,0,0,0,0,0,False,False,False,0,1,2021-10-04T16:35:36.877,0,False,0.0
2021,4,3112,880,24,8509,2,4,3,12,17,5,17,0,17,0,False,False,False,2,3,2021-10-04T16:16:41.857,17,False,0.0
2021,4,3112,885,24,8509,13,19,6,22,0,0,0,0,0,0,False,False,False,0,2,2021-10-04T16:18:23.89,0,False,0.0
2021,4,3112,890,24,7798,2,50,5,-1,9,10,9,0,9,0,False,False,False,1,2,2021-10-08T21:22:48.477,9,False,0.0
2021,4,3112,900,24,8513,13,47,5,-2,0,0,0,0,0,0,False,False,False,0,1,2021-10-04T16:23:35.04,0,False,0.0
2021,4,3112,910,24,894,2,12,9,-7,9,16,-1,10,-1,0,False,False,False,1,3,2022-02-07T19:58:44.88,9,False,10.0
2021,4,3112,915,24,4382,2,8,1,15,15,0,15,0,15,6,False,False,False,0,3,2021-10-04T16:38:25.773,15,True,0.0
2021,4,3113,20,9,6446,13,26,9,5,0,0,0,0,0,0,False,False,False,0,3,2021-10-04T09:34:48.96,0,False,0.0
2021,4,3113,35,5,3477,13,2,9,5,0,0,0,0,0,0,True,False,False,0,3,2021-10-05T15:48:49.207,0,False,0.0
2021,4,3113,55,9,4446,2,6,9,5,9,4,7,2,7,0,False,False,False,0,2,2021-10-04T09:48:31.933,9,False,
2021,4,3113,70,9,6446,2,32,5,-1,18,19,15,3,15,0,False,False,False,0,4,2021-10-07T22:05:11.357,18,False,3.0
2021,4,3113,90,9,6446,13,46,3,1,0,0,0,0,0,0,False,False,False,0,3,2021-10-05T16:39:28.17,0,False,0.0
2021,4,3113,115,5,5220,13,19,6,34,0,0,0,0,0,0,True,False,False,0,2,2021-10-05T15:49:27.003,0,False,0.0
2021,4,3113,125,5,5220,2,30,9,-2,9,11,5,4,5,0,False,False,False,0,3,2021-10-04T10:28:41.647,9,False,4.0
2021,4,3113,135,5,5220,2,6,9,10,29,19,11,18,11,0,False,False,False,2,3,2021-10-05T15:46:33.407,29,False,18.0
2021,4,3113,145,5,5220,2,47,5,5,9,4,9,0,9,0,False,False,False,0,1,2021-10-04T15:52:55.263,9,False,0.0
2021,4,3113,165,9,7816,13,4,9,7,0,0,0,0,0,0,False,False,False,0,3,2021-10-04T10:41:02.84,0,False,0.0
2021,4,3113,170,9,6446,2,5,10,4,12,8,6,6,6,0,False,False,False,0,3,2021-10-04T10:44:55.623,12,False,6.0
2021,4,3113,185,9,6446,2,4,10,3,10,7,9,1,9,0,False,False,False,0,3,2021-10-07T17:43:18.893,10,False,1.0
2021,4,3113,215,9,322,2,4,5,13,14,1,14,0,14,0,False,False,False,0,2,2021-10-07T17:43:18.893,14,False,0.0
2021,4,3113,220,9,4447,2,2,10,6,18,12,16,2,16,6,True,False,False,0,3,2021-10-07T22:07:38.32,18,False,2.0
2021,4,3113,245,5,8409,2,28,10,0,3,3,3,0,3,0,False,False,False,0,1,2021-10-04T11:14:33.547,3,False,0.0
2021,4,3113,250,5,3477,13,19,6,27,0,0,0,0,0,0,True,False,False,0,2,2021-10-07T22:08:13.31,0,False,0.0
2021,4,3113,255,5,3477,2,4,9,13,13,0,13,0,13,0,False,False,False,0,2,2021-10-07T22:09:58.64,13,False,0.0
2021,4,3113,265,5,8408,13,11,6,34,0,0,0,0,0,0,False,False,False,0,4,2021-10-07T22:10:47.507,0,False,0.0
2021,4,3113,285,5,3477,2,51,3,-5,6,11,4,2,4,0,True,False,False,2,2,2022-02-16T13:36:55.687,6,False,2.0
2021,4,3113,290,5,5220,2,3,3,5,5,0,5,0,5,0,False,False,False,0,2,2021-10-07T22:34:27.197,5,False,0.0
2021,4,3113,295,5,8195,2,12,10,3,17,14,13,4,13,0,False,False,False,0,1,2021-10-07T20:36:10.38,17,False,4.0
2021,4,3113,300,5,6425,2,53,10,-4,1,5,0,1,0,0,False,False,False,0,4,2021-10-04T11:37:37.187,1,False,1.0
2021,4,3113,320,9,7816,13,4,3,6,0,0,0,0,0,0,False,False,False,0,2,2021-10-07T17:43:18.893,0,False,
2021,4,3113,330,9,6446,2,53,10,-4,4,8,0,4,0,0,False,False,False,1,4,2021-10-07T22:12:38.313,4,False,4.0
2021,4,3113,335,9,6441,2,51,3,-1,7,8,7,0,7,0,False,False,False,0,3,2021-10-04T11:50:43.853,7,True,0.0
2021,4,3113,350,9,4447,13,5,9,5,0,0,0,0,0,0,False,False,False,0,3,2021-10-05T16:41:41.417,0,False,0.0
2021,4,3113,365,5,5220,2,13,4,3,8,5,8,0,8,0,False,False,False,0,3,2021-10-04T12:04:16.46,8,False,0.0
2021,4,3113,370,5,3477,2,46,3,2,5,3,5,0,5,0,True,False,False,0,2,2021-10-07T22:36:20.99,5,False,0.0
2021,4,3113,395,5,6425,2,13,10,2,9,7,6,3,6,0,False,False,False,0,3,2021-10-04T12:16:14.117,9,False,3.0
2021,4,3113,410,9,322,2,6,10,5,20,15,8,12,8,0,True,False,False,1,2,2021-10-05T16:36:08.71,20,False,12.0
2021,4,3113,415,9,4202,13,5,5,4,0,0,0,0,0,0,False,False,False,0,3,2022-02-16T13:38:57.11,0,False,0.0
2021,4,3113,420,9,7816,13,6,10,13,0,0,0,0,0,0,False,False,False,0,2,2021-10-04T12:22:17.45,0,False,0.0
2021,4,3113,425,9,4447,13,2,9,9,0,0,0,0,0,0,False,False,False,0,3,2021-10-04T12:23:55.257,0,False,0.0
2021,4,3113,465,5,5220,2,13,9,4,39,35,38,1,38,0,False,False,False,0,3,2021-10-04T12:44:01.053,39,False,1.0
2021,4,3113,475,5,8406,13,35,8,16,0,0,0,0,0,0,False,False,False,0,3,2021-10-04T12:46:51.01,0,False,0.0
2021,4,3113,480,5,5220,13,7,9,14,0,0,0,0,0,0,False,False,False,0,3,2021-10-04T12:49:14.46,0,False,0.0
2021,4,3113,505,9,322,2,24,2,34,35,1,34,1,34,6,True,False,False,0,3,2021-10-04T13:12:18.31,35,False,1.0
2021,4,3113,525,5,8406,13,6,9,5,0,0,0,0,0,0,False,False,False,0,2,2022-02-18T17:05:58.337,0,False,0.0
2021,4,3113,540,9,7816,2,6,9,6,6,0,6,0,6,0,False,False,False,0,2,2021-10-07T20:35:41.57,6,False,0.0
2021,4,3113,545,9,7816,2,4,5,6,7,1,7,0,7,0,False,False,False,0,2,2021-10-04T13:14:04.02,7,True,0.0
2021,4,3113,555,9,6446,2,47,5,2,6,4,6,0,6,6,False,False,False,0,4,2022-02-16T13:39:35.637,6,True,0.0
2021,4,3113,570,5,5220,13,35,10,9,0,0,0,0,0,0,False,False,False,0,3,2021-10-04T13:28:56.22,0,False,0.0
2021,4,3113,575,5,3477,2,12,5,10,9,-1,9,0,9,0,False,False,False,0,2,2021-10-04T13:32:42.997,9,True,0.0
2021,4,3113,610,5,3477,13,35,1,15,0,0,0,0,0,0,False,False,False,0,3,2021-10-07T20:36:35.61,0,False,0.0
2021,4,3113,625,9,6441,2,21,10,14,23,9,17,6,17,6,False,False,False,1,3,2021-10-04T13:47:59.587,23,False,6.0
2021,4,3113,645,5,3477,13,35,6,17,0,0,0,0,0,0,False,False,False,0,3,2021-10-04T13:54:45.637,0,False,0.0
2021,4,3113,650,5,5220,13,5,5,-3,0,0,0,0,0,0,False,False,False,0,2,2021-10-07T22:16:06.84,0,False,0.0
2021,4,3113,695,5,8195,2,28,4,3,15,12,8,7,8,0,False,False,False,1,1,2021-10-04T14:13:59.027,15,False,7.0
2021,4,3113,700,5,8406,2,46,3,2,2,0,2,0,2,0,True,False,False,0,2,2021-10-07T22:36:50.253,2,False,0.0
2021,4,3113,715,5,8408,13,35,4,11,0,0,0,0,0,0,False,False,False,0,4,2021-10-04T15:57:34.94,0,False,
2021,4,3113,720,5,8409,2,48,10,-5,11,16,2,9,2,0,False,False,False,0,1,2021-10-04T15:57:51.08,11,False,9.0
2021,4,3113,725,5,8195,2,28,4,3,4,1,4,0,4,0,False,False,False,0,1,2021-10-04T14:31:01.597,4,False,0.0
2021,4,3113,730,5,8195,2,28,4,3,7,4,6,1,6,0,False,False,False,0,1,2021-10-04T14:32:34.663,7,False,1.0
2021,4,3113,735,5,3477,2,3,10,12,13,1,13,0,13,0,False,False,False,0,2,2021-10-04T14:34:18.697,13,False,0.0
2021,4,3113,740,5,6372,2,6,3,4,8,4,4,4,4,0,False,False,False,0,2,2021-10-04T14:37:22.96,8,False,4.0
2021,4,3113,745,5,5220,2,12,3,6,6,0,6,0,6,6,False,False,False,0,2,2021-10-07T22:23:07.713,6,True,0.0
2021,4,3113,775,9,7816,13,19,6,33,0,0,0,0,0,0,False,False,False,0,2,2021-10-07T22:24:49.8,0,False,0.0
2021,4,3113,790,5,8195,2,46,3,4,5,1,5,0,5,0,False,False,False,0,1,2021-10-04T14:53:49.307,5,False,0.0
2021,4,3113,795,5,6425,2,32,3,1,5,4,5,0,5,0,False,False,False,0,3,2021-10-07T22:37:11.483,5,False,0.0
2021,4,3113,800,5,3477,13,3,3,14,0,0,0,0,0,0,False,False,False,0,2,2021-10-04T15:02:36.183,0,False,0.0
2021,4,3113,815,5,3477,13,21,6,30,0,0,0,0,0,0,False,False,False,0,2,2021-10-07T22:26:00.97,0,False,0.0
2021,4,3113,820,5,6372,2,4,9,14,55,41,50,5,50,0,False,False,False,1,2,2021-10-07T22:28:00.33,55,False,5.0
2021,4,3113,830,5,5220,2,17,10,8,8,0,8,0,8,6,False,False,False,0,1,2021-10-04T15:17:25.423,8,True,0.0
2021,4,3113,865,9,6446,2,13,10,8,8,0,8,0,8,0,False,False,False,0,4,2021-10-04T15:32:10.91,8,False,0.0
2021,4,3114,20,21,8518,13,13,10,5,0,0,0,0,0,0,False,False,False,0,3,2021-10-08T15:47:02.183,0,False,0.0
2021,4,3114,40,20,8126,13,28,10,3,0,0,0,0,0,0,False,False,False,0,1,2021-10-08T15:09:45.81,0,False,0.0
2021,4,3114,45,20,8126,2,53,10,-3,-3,0,-3,0,-3,0,True,False,False,0,4,2022-01-05T18:21:24.73,-3,False,0.0
2021,4,3114,50,20,8127,13,13,10,4,0,0,0,0,0,0,False,False,False,0,4,2022-01-05T18:21:49.277,0,False,0.0
2021,4,3114,65,21,4492,2,2,9,10,13,3,10,3,10,0,False,False,False,0,2,2021-10-04T09:54:42.907,13,False,3.0
2021,4,3114,75,21,8518,13,19,2,35,0,0,0,0,0,0,False,False,False,0,2,2021-10-08T15:09:55.117,0,False,0.0
2021,4,3114,105,20,4535,2,30,5,-1,11,12,9,2,9,0,False,False,False,0,4,2021-10-04T10:13:10.173,11,False,2.0
2021,4,3114,115,20,7353,2,50,9,-5,9,14,5,4,5,0,False,False,False,0,3,2021-10-08T15:13:21.637,9,False,4.0
2021,4,3114,130,20,8126,13,12,4,4,0,0,0,0,0,0,False,False,False,0,1,2022-02-07T20:07:39.18,0,False,0.0
2021,4,3114,145,21,4492,2,5,3,14,18,4,18,0,18,0,False,False,False,0,2,2021-10-04T10:30:34.597,18,True,
2021,4,3114,150,21,6228,2,32,5,-6,-4,2,-5,1,-5,0,False,False,False,1,1,2022-02-25T22:57:54.443,-4,False,1.0
2021,4,3114,155,21,3957,2,48,9,-5,6,11,4,2,4,0,False,False,False,0,1,2021-10-04T10:36:07.513,6,False,2.0
2021,4,3114,160,21,8518,2,50,10,1,18,17,12,6,12,0,False,False,False,2,3,2021-10-08T15:13:33.727,18,False,6.0
2021,4,3114,165,21,8518,2,30,10,-2,4,6,3,1,3,0,True,False,False,0,4,2021-10-05T13:59:37.793,4,False,1.0
2021,4,3114,185,21,4492,2,6,1,17,27,10,26,1,26,0,False,False,False,0,2,2021-10-04T10:44:55.993,27,False,1.0
2021,4,3114,210,20,7353,2,5,5,6,6,0,6,0,6,0,False,False,False,0,3,2021-10-04T10:54:06.393,6,False,0.0
2021,4,3114,220,20,7353,13,12,5,9,0,0,0,0,0,0,True,False,False,0,1,2021-10-08T15:10:18.257,0,False,0.0
2021,4,3114,225,20,7353,2,50,3,-5,18,23,17,1,17,0,True,False,False,0,3,2021-10-05T15:46:44.183,18,False,1.0
2021,4,3114,240,20,2408,2,2,10,2,2,0,2,0,2,0,False,False,False,0,2,2021-10-08T16:23:31.513,2,False,0.0
2021,4,3114,250,21,4674,2,19,8,43,51,8,43,8,43,0,False,True,False,0,3,2022-02-25T22:58:07.773,52,False,8.0
2021,4,3114,280,20,7353,2,5,3,6,11,5,8,3,8,0,False,False,False,0,2,2021-10-04T11:23:27.22,11,False,3.0
2021,4,3114,285,20,1361,2,4,3,6,6,0,6,0,6,0,True,False,False,0,2,2022-01-05T18:23:38.277,6,False,0.0
2021,4,3114,295,20,8127,2,13,5,3,5,2,4,1,4,0,False,False,False,0,3,2021-10-04T11:30:13.263,5,False,1.0
2021,4,3114,305,20,3360,2,4,10,3,6,3,5,1,5,0,False,False,False,0,1,2021-10-08T15:43:34.467,6,False,1.0
2021,4,3114,315,20,2408,2,35,2,17,19,2,17,2,17,0,False,False,False,0,3,2021-10-04T11:40:30.153,19,False,2.0
2021,4,3114,345,20,8127,2,36,7,15,15,0,15,0,15,6,False,False,False,0,2,2021-10-08T16:23:31.513,15,True,0.0
2021,4,3114,360,21,8518,3,6,8,17,0,0,0,0,0,0,False,False,False,0,2,2021-10-04T11:52:55.753,0,False,
2021,4,3114,385,21,4492,13,19,2,46,0,0,0,0,0,0,False,False,False,0,2,2022-02-07T20:08:16.533,0,False,0.0
2021,4,3114,400,20,8131,2,8,7,54,58,4,54,4,54,0,False,False,False,0,2,2021-10-08T15:54:11.92,58,False,4.0
2021,4,3114,405,20,1361,2,5,5,5,9,4,6,3,6,0,False,False,False,0,2,2022-01-05T18:24:31.187,9,False,3.0
2021,4,3114,425,21,8518,2,6,8,17,19,2,18,1,18,0,False,False,False,0,3,2021-10-04T12:30:57.033,19,False,1.0
2021,4,3114,435,21,4422,2,5,3,5,7,2,6,1,6,0,False,False,False,0,3,2021-10-04T12:35:22.833,7,False,1.0
2021,4,3114,440,21,4492,2,4,10,5,8,3,6,2,6,0,False,False,False,0,3,2021-10-04T12:37:31.353,8,False,2.0
2021,4,3114,445,21,4492,2,5,3,14,17,3,17,0,17,0,False,False,False,0,2,2021-10-04T12:40:42.2,17,True,0.0
2021,4,3114,450,21,813,2,9,6,15,20,5,20,0,20,0,False,False,False,0,4,2021-10-08T15:57:25.803,20,False,0.0
2021,4,3114,465,21,813,13,17,9,5,0,0,0,0,0,0,False,False,False,0,3,2021-10-04T12:52:04.39,0,False,0.0
2021,4,3114,490,20,2408,2,12,5,11,21,10,19,2,19,0,False,False,False,0,3,2021-10-08T15:43:46.227,21,False,2.0
2021,4,3114,495,20,2136,2,8,1,46,46,0,46,0,46,6,False,False,False,0,3,2021-10-04T13:02:08.75,46,True,
2021,4,3114,500,20,7353,13,23,7,44,0,0,0,0,0,0,False,False,False,0,3,2021-10-08T16:01:42.353,0,False,0.0
2021,4,3114,505,21,4422,2,38,9,4,8,4,5,3,5,0,False,False,False,0,4,2022-02-18T19:29:45.373,8,False,3.0
2021,4,3114,515,21,813,2,53,9,-5,4,9,2,2,2,0,False,False,False,0,4,2021-10-04T13:15:06.29,4,False,2.0
2021,4,3114,525,21,4422,3,13,9,3,0,0,0,0,0,0,False,False,False,0,3,2021-10-04T13:22:48.31,0,False,0.0
2021,4,3114,535,20,4535,2,30,3,0,15,15,15,0,15,0,False,False,False,0,4,2021-10-04T13:24:58.453,15,True,0.0
2021,4,3114,580,20,7888,2,30,10,2,3,1,3,0,3,0,False,False,False,0,4,2021-10-04T13:39:47.423,3,False,0.0
2021,4,3114,610,21,6228,2,47,10,2,5,3,3,2,3,0,False,False,False,0,1,2021-10-04T13:53:00.633,5,False,2.0
2021,4,3114,615,21,8518,2,2,10,6,21,15,14,7,14,0,False,False,False,5,2,2021-10-08T15:15:35.707,21,False,7.0
2021,4,3114,625,21,8518,3,2,4,7,0,0,0,0,0,0,False,False,False,0,3,2021-10-08T16:23:31.513,0,False,0.0
2021,4,3114,630,21,4422,2,32,3,0,1,1,-1,2,-1,0,False,False,False,0,4,2021-10-08T15:43:56.053,1,False,2.0
2021,4,3114,665,21,6228,2,19,6,25,54,29,35,19,35,6,False,False,False,1,2,2022-02-18T19:31:34.18,54,False,19.0
2021,4,3114,685,20,8131,2,4,9,14,16,2,16,0,16,0,False,False,False,0,3,2021-10-04T14:18:42.21,16,False,0.0
2021,4,3114,710,20,2136,13,35,9,4,0,0,0,0,0,0,False,False,False,0,2,2022-01-05T18:25:00.063,0,False,0.0
2021,4,3114,715,20,7353,2,51,5,-6,8,14,6,2,6,0,True,False,False,0,3,2021-10-04T14:29:57.73,8,False,2.0
2021,4,3114,730,21,4422,2,2,9,7,8,1,7,1,7,0,False,False,False,0,3,2021-10-04T14:33:16.267,8,False,1.0
2021,4,3114,735,21,8518,2,51,10,-3,5,8,4,1,4,0,False,False,False,0,3,2022-02-16T15:18:34.787,5,False,1.0
2021,4,3114,745,21,4492,13,19,2,26,0,0,0,0,0,0,False,False,False,0,2,2021-10-04T14:37:21.317,0,False,0.0
2021,4,3114,750,21,8518,2,2,9,7,11,4,9,2,9,0,False,False,False,0,3,2021-10-04T14:38:57.737,11,False,2.0
2021,4,3114,755,21,4422,2,5,3,3,3,0,3,0,3,0,False,False,False,0,3,2021-10-04T14:40:25.957,3,False,0.0
2021,4,3114,765,21,4492,2,2,10,5,28,23,6,22,6,0,False,False,False,2,2,2021-10-08T15:14:38.847,28,False,22.0
2021,4,3114,775,21,6228,13,11,5,6,0,0,0,0,0,0,False,False,False,0,1,2021-10-04T14:45:30.037,0,False,0.0
2021,4,3114,780,21,4674,13,2,9,6,0,0,0,0,0,0,False,False,False,0,2,2021-10-04T14:47:02.56,0,False,0.0
2021,4,3114,805,20,7353,13,5,2,20,0,0,0,0,0,0,False,False,False,0,2,2021-10-04T14:51:26.137,0,False,0.0
2021,4,3114,825,21,4674,2,3,2,16,17,1,16,1,16,0,False,False,False,0,2,2021-10-04T14:55:39.493,17,False,1.0
2021,4,3114,835,21,4674,2,2,5,6,8,2,7,1,7,0,False,False,False,0,2,2021-10-04T14:58:53.117,8,False,1.0
2021,4,3114,845,21,7592,2,4,5,4,6,2,5,1,5,0,False,False,False,0,2,2021-10-04T15:07:23.72,6,False,
2021,4,3114,850,21,6228,2,48,10,-4,18,22,12,6,12,0,False,False,False,1,1,2021-10-04T15:10:37.353,18,False,6.0
2021,4,3114,855,21,6228,2,12,5,-2,1,3,2,-1,2,0,False,True,False,2,1,2021-10-04T15:37:36.067,1,False,-1.0
2021,4,3114,865,21,4492,2,5,6,15,23,8,22,1,22,0,False,False,False,0,3,2021-10-04T15:16:59.373,23,False,1.0
2021,4,3115,15,18,7711,2,49,5,-4,9,13,6,3,6,0,True,False,False,0,3,2021-10-08T20:03:27.137,9,False,3.0
2021,4,3115,25,18,6361,2,46,3,3,1,-2,1,0,1,0,False,False,False,0,4,2021-10-05T14:29:53.68,1,False,0.0
2021,4,3115,35,18,7711,2,7,5,11,11,0,11,0,11,0,False,False,False,0,3,2021-10-05T14:30:21.87,11,True,0.0
2021,4,3115,40,18,1381,2,4,6,15,22,7,20,2,20,0,False,False,False,0,2,2021-10-27T21:53:59.007,22,False,2.0
2021,4,3115,50,18,4572,2,5,5,3,4,1,4,0,4,0,False,False,False,0,1,2021-10-08T19:54:23.203,4,False,0.0
2021,4,3115,75,18,7711,2,4,10,12,12,0,12,0,12,6,False,False,False,0,3,2021-10-05T14:31:09.42,12,True,0.0
2021,4,3115,95,8,8354,2,45,10,-5,3,8,2,1,2,0,True,False,False,0,3,2021-10-06T00:01:16.72,3,False,1.0
2021,4,3115,100,8,3883,2,53,9,-3,11,14,4,7,4,0,True,False,False,0,4,2021-10-06T00:02:44.387,11,False,7.0
2021,4,3115,110,8,3883,13,2,4,4,0,0,0,0,0,0,False,False,False,0,3,2021-10-06T00:03:14.9,0,False,0.0
2021,4,3115,115,8,3606,2,5,8,20,21,1,21,0,21,0,False,False,False,0,3,2021-10-06T00:03:35.627,21,False,0.0
2021,4,3115,135,8,4976,2,53,10,-5,8,13,3,5,3,0,False,False,False,0,4,2021-10-06T00:03:48.503,8,False,5.0
2021,4,3115,165,8,5053,13,12,10,6,0,0,0,0,0,0,False,False,False,0,1,2022-02-07T20:02:57.96,0,False,0.0
2021,4,3115,175,18,4572,13,48,10,-5,0,0,0,0,0,0,False,False,False,0,1,2021-10-08T18:50:00.29,0,False,0.0
2021,4,3115,185,18,4572,13,48,9,-4,0,0,0,0,0,0,False,False,False,0,1,2022-02-16T14:59:37.957,0,False,0.0
2021,4,3115,195,8,7652,2,32,5,2,3,1,2,1,2,0,True,False,False,0,1,2021-10-06T00:04:38.537,3,False,1.0
2021,4,3115,200,8,1067,2,49,9,-3,3,6,2,1,2,0,False,False,False,0,3,2022-02-18T18:43:28.18,3,False,1.0
2021,4,3115,205,8,3606,13,2,10,5,0,0,0,0,0,0,False,False,False,0,3,2021-10-08T18:50:29.24,0,False,0.0
2021,4,3115,220,18,4572,13,5,10,3,0,0,0,0,0,0,False,False,False,0,1,2021-10-08T20:46:01.417,0,False,0.0
2021,4,3115,225,18,7712,2,29,6,18,20,2,20,0,20,0,False,False,False,0,2,2021-10-05T14:34:52.767,20,False,0.0
2021,4,3115,240,18,1381,13,2,9,5,0,0,0,0,0,0,False,False,False,0,2,2021-10-05T14:36:29.823,0,False,0.0
2021,4,3115,245,18,1381,13,13,10,5,0,0,0,0,0,0,False,False,False,0,3,2022-02-16T15:01:17.03,0,False,0.0
2021,4,3115,270,8,8354,2,12,3,1,9,8,5,4,5,0,True,False,False,0,3,2022-02-07T20:03:55.853,9,False,4.0
2021,4,3115,280,8,5053,2,47,5,0,8,8,5,3,5,0,False,False,False,0,1,2021-10-06T00:07:50.957,8,False,3.0
2021,4,3115,300,8,5053,2,48,9,-3,9,12,5,4,5,0,False,False,False,0,1,2021-10-06T00:08:11.607,9,False,4.0
2021,4,3115,325,8,3606,2,8,4,12,12,0,12,0,12,0,False,False,False,0,3,2021-10-06T00:09:48.067,12,False,0.0
2021,4,3115,335,8,1067,13,26,5,3,0,0,0,0,0,0,False,False,False,0,2,2021-10-06T00:10:06.05,0,False,0.0
2021,4,3115,350,8,4976,13,12,5,2,0,0,0,0,0,0,False,False,False,0,3,2021-10-06T00:11:07.32,0,False,
2021,4,3115,355,8,3883,13,24,9,1,0,0,0,0,0,0,False,False,False,0,4,2021-10-06T00:11:18.353,0,False,0.0
2021,4,3115,390,18,7712,13,5,5,6,0,0,0,0,0,0,False,False,False,0,3,2021-10-08T20:46:32.8,0,False,0.0
2021,4,3115,395,18,566,2,44,3,-4,2,6,2,0,2,0,False,False,False,0,1,2021-10-05T14:38:26.53,2,True,0.0
2021,4,3115,405,18,7712,2,31,3,3,3,0,3,0,3,0,False,False,False,0,3,2021-10-08T20:46:52.5,3,False,0.0
2021,4,3115,440,8,3606,2,5,3,11,11,0,11,0,11,0,False,False,False,0,2,2021-10-06T00:13:36.873,11,False,0.0
2021,4,3115,445,8,1067,13,20,7,30,0,0,0,0,0,0,False,False,False,0,2,2021-10-08T20:09:09.203,0,False,0.0
2021,4,3115,450,8,3606,13,7,6,21,0,0,0,0,0,0,False,False,False,0,3,2021-10-08T18:52:33.68,0,False,0.0
2021,4,3115,455,8,3883,13,46,3,7,0,0,0,0,0,0,False,False,False,0,3,2021-10-08T20:19:37.39,0,False,0.0
2021,4,3115,490,8,6439,2,4,4,4,5,1,4,1,4,0,False,False,False,0,1,2021-10-08T18:52:45.12,5,False,1.0
2021,4,3115,505,18,7711,2,49,10,-2,1,3,0,1,0,0,False,False,False,0,2,2021-10-05T14:43:02.577,1,False,1.0
2021,4,3115,510,18,4572,2,48,10,-6,6,12,-2,8,-2,0,False,False,False,2,1,2022-02-16T15:04:41.37,6,False,8.0
2021,4,3115,535,8,4976,2,6,4,4,9,5,8,1,8,0,False,False,False,0,3,2021-10-06T00:15:23.597,9,False,1.0
2021,4,3115,555,8,1067,13,19,2,35,0,0,0,0,0,0,False,False,False,0,3,2021-10-06T00:15:50.75,0,False,0.0
2021,4,3115,565,18,1381,13,35,2,18,0,0,0,0,0,0,False,False,False,0,3,2021-10-05T14:44:01.257,0,False,
2021,4,3115,575,18,6361,13,5,10,3,0,0,0,0,0,0,False,False,False,0,4,2021-10-05T14:44:25.033,0,False,0.0
2021,4,3115,580,18,7711,2,35,7,22,37,15,33,4,33,0,False,False,False,0,3,2021-10-05T14:46:16.063,37,False,
2021,4,3115,630,18,7711,2,9,2,19,20,1,19,1,19,0,False,False,False,0,2,2021-10-05T14:46:50.073,20,False,1.0
2021,4,3115,650,18,4940,2,4,1,15,17,2,15,2,15,0,False,False,False,0,3,2021-10-05T14:47:19.983,17,False,2.0
2021,4,3115,655,18,6361,2,46,3,2,14,12,13,1,13,0,True,False,False,0,4,2021-10-05T14:47:36.7,14,False,1.0
2021,4,3115,665,18,6361,3,30,9,-3,0,0,0,0,0,0,False,False,False,0,4,2021-10-05T14:47:57.807,0,False,0.0
2021,4,3115,670,18,7712,13,19,6,20,0,0,0,0,0,0,False,False,False,0,3,2021-10-08T20:19:37.39,0,False,
2021,4,3115,675,18,6361,2,32,3,-2,-3,-1,-3,0,-3,0,False,False,False,0,3,2021-10-08T20:10:49.297,-3,False,0.0
2021,4,3115,690,8,7652,13,7,6,20,0,0,0,0,0,0,False,False,False,0,4,2022-02-18T18:44:51.393,0,False,0.0
2021,4,3115,695,8,5053,13,48,9,0,0,0,0,0,0,0,False,False,False,0,1,2021-10-06T00:16:44.18,0,False,0.0
2021,4,3115,715,18,7712,13,6,9,6,0,0,0,0,0,0,False,False,False,0,3,2022-02-16T15:05:40.773,0,False,0.0
2021,4,3115,725,8,1067,2,8,1,19,24,5,21,3,21,0,False,False,False,0,2,2021-10-06T00:17:02.25,24,False,3.0
2021,4,3115,750,8,3606,13,2,10,6,0,0,0,0,0,0,False,False,False,0,2,2021-10-06T00:17:24.42,0,False,0.0
2021,4,3115,765,18,1381,13,8,7,54,0,0,0,0,0,0,False,False,False,0,3,2021-10-08T19:57:48.573,0,False,0.0
2021,4,3115,775,8,3606,2,8,1,19,19,0,19,0,19,0,False,False,False,0,3,2021-10-06T00:17:39.577,19,False,0.0
2021,4,3115,785,8,1067,13,9,2,27,0,0,0,0,0,0,False,False,False,0,2,2021-10-08T18:54:15.6,0,False,0.0
2021,4,3115,790,8,8349,13,19,7,33,0,0,0,0,0,0,False,False,False,0,3,2021-10-08T18:54:24.6,0,False,0.0
2021,4,3115,815,18,7711,2,9,2,27,31,4,31,0,31,0,False,False,False,0,2,2021-10-05T14:50:59.847,31,False,0.0
2021,4,3115,830,18,1381,2,6,9,4,5,1,5,0,5,0,False,False,False,0,2,2021-10-05T14:51:15.47,5,False,0.0
2021,4,3115,835,18,1381,13,2,10,4,0,0,0,0,0,0,False,False,False,0,2,2021-10-05T14:51:32.463,0,False,0.0
2021,4,3115,870,8,1067,13,24,2,28,0,0,0,0,0,0,False,False,False,0,3,2021-10-08T20:19:37.39,0,False,0.0
2021,4,3115,880,18,4572,13,44,3,-5,0,0,0,0,0,0,False,False,False,0,1,2021-10-05T14:52:14.007,0,False,0.0
2021,4,3115,885,18,7712,13,8,9,12,0,0,0,0,0,0,False,False,False,0,3,2021-10-08T18:54:35.5,0,False,0.0
2021,4,3115,890,18,7712,2,32,3,3,3,0,3,0,3,0,False,False,False,0,4,2021-10-08T18:54:44.13,3,False,0.0
2021,4,3115,895,18,7712,13,8,8,22,0,0,0,0,0,0,False,False,False,0,3,2021-10-08T18:57:10.72,0,False,
2021,4,3115,900,18,7711,13,19,2,28,0,0,0,0,0,0,False,False,False,0,2,2021-10-08T20:19:37.39,0,False,0.0
2021,4,3115,905,18,7712,13,8,7,27,0,0,0,0,0,0,False,False,False,0,3,2021-10-05T14:54:14.453,0,False,0.0
2021,4,3115,915,18,1381,2,8,8,17,19,2,19,0,19,0,False,False,False,0,2,2021-10-08T20:19:37.39,19,False,0.0
2021,4,3115,925,18,1381,13,7,2,20,0,0,0,0,0,0,False,False,False,0,3,2021-10-08T20:13:57.587,0,False,0.0
2021,4,3115,930,18,6361,2,32,5,3,6,3,6,0,6,0,False,False,False,0,3,2021-10-05T14:55:18.047,6,False,0.0
2021,4,3115,940,18,1381,13,19,7,26,0,0,0,0,0,0,False,False,False,0,2,2021-10-08T20:19:37.39,0,False,0.0
2021,4,3116,20,6,7725,2,4,9,4,4,0,4,0,4,0,False,False,False,0,2,2021-10-04T09:34:47.117,4,False,0.0
2021,4,3116,30,6,7725,2,4,5,4,4,0,4,0,4,0,False,False,False,0,2,2021-10-04T09:39:19.227,4,False,0.0
2021,4,3116,45,6,7725,2,35,6,17,21,4,21,0,21,0,False,False,False,0,3,2021-10-04T09:47:55.227,21,False,0.0
2021,4,3116,90,11,6810,2,31,10,1,7,6,4,3,4,0,False,False,False,0,4,2021-10-04T16:40:04.817,7,False,3.0
2021,4,3116,105,11,7733,2,4,2,15,21,6,20,1,20,0,False,False,False,0,2,2021-10-04T17:02:07.02,21,False,1.0
2021,4,3116,130,11,4037,13,12,10,14,0,0,0,0,0,0,False,False,False,0,3,2022-02-07T20:11:48.187,0,False,0.0
2021,4,3116,150,6,7725,2,24,8,40,64,24,45,19,45,0,False,False,False,1,3,2021-10-04T10:44:16.117,64,False,19.0
2021,4,3116,200,11,7732,2,44,3,-3,5,8,4,1,4,0,False,False,False,0,1,2021-10-04T10:59:32.377,5,False,1.0
2021,4,3116,210,11,6810,13,2,10,10,0,0,0,0,0,0,False,False,False,0,2,2021-10-08T14:40:15.007,0,False,
2021,4,3116,220,11,8359,2,44,3,-4,6,10,4,2,4,0,True,False,False,0,2,2021-10-04T11:11:29.76,6,False,2.0
2021,4,3116,230,11,7733,2,12,9,13,33,20,28,5,28,0,False,False,False,0,2,2022-02-07T20:12:20.167,33,False,5.0
2021,4,3116,250,11,7732,13,8,10,5,0,0,0,0,0,0,False,False,False,0,1,2021-10-04T11:24:58.74,0,False,0.0
2021,4,3116,275,6,7725,13,21,5,8,0,0,0,0,0,0,False,False,False,0,2,2021-10-04T11:34:07.647,0,False,0.0
2021,4,3116,305,11,7733,13,35,6,16,0,0,0,0,0,0,False,False,False,0,3,2021-10-04T11:45:57.597,0,False,0.0
2021,4,3116,310,11,4037,13,5,3,11,0,0,0,0,0,0,False,False,False,0,3,2021-10-04T11:48:42.093,0,False,
2021,4,3116,320,11,4037,13,8,8,21,0,0,0,0,0,0,False,False,False,0,3,2021-10-04T11:55:43.497,0,False,0.0
2021,4,3116,325,11,8359,2,12,6,17,17,0,17,0,17,0,False,False,False,0,3,2021-10-08T14:44:02.827,17,False,0.0
2021,4,3116,350,6,7728,13,12,2,32,0,0,0,0,0,0,False,False,False,0,4,2022-02-07T20:12:44.157,0,False,0.0
2021,4,3116,365,6,464,2,2,4,7,8,1,7,1,7,0,False,False,False,0,3,2021-10-04T12:30:54.007,8,False,1.0
2021,4,3116,380,6,1378,13,4,5,7,0,0,0,0,0,0,False,False,False,0,2,2021-10-04T12:35:49.09,0,False,0.0
2021,4,3116,385,6,1400,2,51,9,-6,8,14,2,6,2,0,True,False,False,0,1,2021-10-04T12:38:06.53,8,False,6.0
2021,4,3116,390,6,7725,13,2,9,10,0,0,0,0,0,0,False,False,False,0,2,2021-10-08T14:58:12.743,0,False,0.0
2021,4,3116,395,11,6810,13,5,3,12,0,0,0,0,0,0,True,False,False,0,3,2022-02-16T13:23:50.387,0,False,0.0
2021,4,3116,415,11,8359,13,5,6,16,0,0,0,0,0,0,True,False,False,0,3,2021-10-05T23:06:37.247,0,False,0.0
2021,4,3116,445,11,6810,2,53,10,-6,2,8,0,2,0,0,False,False,False,0,4,2021-10-04T13:04:33.69,2,False,2.0
2021,4,3116,450,11,6810,13,17,7,17,0,0,0,0,0,0,False,False,False,0,3,2021-10-04T13:07:22.683,0,False,0.0
2021,4,3116,475,6,464,2,8,2,20,28,8,26,2,26,0,False,False,False,0,2,2021-10-08T13:55:16.62,28,False,2.0
2021,4,3116,485,6,7725,2,9,2,30,32,2,31,1,31,0,False,False,False,0,2,2021-10-04T13:25:01.25,32,False,1.0
2021,4,3116,505,11,7733,2,6,4,12,20,8,18,2,18,0,False,False,False,1,3,2021-10-08T15:04:13.1,20,False,2.0
2021,4,3116,510,11,7732,3,11,3,11,0,0,0,0,0,0,True,False,False,0,1,2021-10-05T23:08:01.263,0,False,
2021,4,3116,515,11,7732,13,48,10,-8,0,0,0,0,0,0,False,False,False,0,1,2021-10-05T23:09:09.3,0,False,0.0
2021,4,3116,520,11,6810,2,2,10,8,11,3,10,1,10,0,False,False,False,0,2,2021-10-05T22:59:22.027,11,False,1.0
2021,4,3116,550,6,1378,13,13,9,0,0,0,0,0,0,0,False,False,False,0,3,2021-10-08T14:45:51.45,0,False,0.0
2021,4,3116,560,11,6810,2,2,4,9,22,13,14,8,14,0,False,False,False,1,3,2021-10-08T15:06:53.897,22,False,8.0
2021,4,3116,565,11,8359,2,5,5,4,5,1,4,1,4,0,False,False,False,0,3,2021-10-05T23:00:04.843,5,False,1.0
2021,4,3116,570,11,7733,2,26,10,2,9,7,1,8,1,0,False,False,False,1,3,2021-10-04T14:07:49.807,9,False,8.0
2021,4,3116,585,11,4037,2,47,10,2,4,2,3,1,3,6,True,False,False,0,2,2021-10-08T14:36:30.633,4,False,1.0
2021,4,3116,605,6,7728,2,28,5,6,6,0,6,0,6,0,False,False,False,0,4,2022-02-07T20:13:02.747,6,True,0.0
2021,4,3116,615,6,464,2,7,2,27,27,0,27,0,27,0,False,False,False,0,3,2021-10-04T14:26:51.217,27,False,0.0
2021,4,3116,630,6,7728,13,7,2,15,0,0,0,0,0,0,True,False,False,0,3,2021-10-05T19:25:21.21,0,False,0.0
2021,4,3116,650,11,6810,13,9,6,17,0,0,0,0,0,0,False,False,False,0,2,2021-10-04T14:38:42.657,0,False,0.0
2021,4,3116,660,11,7732,2,4,3,4,11,7,9,2,9,0,False,False,False,0,1,2021-10-04T16:42:09.33,11,False,2.0
2021,4,3116,670,11,7732,2,46,3,1,9,8,7,2,7,0,False,False,False,0,1,2021-10-04T14:46:47.8,9,False,2.0
2021,4,3116,680,11,8359,2,5,2,23,24,1,24,0,24,0,False,False,False,0,2,2021-10-04T14:54:26.177,24,True,0.0
2021,4,3116,685,11,6633,2,6,4,11,13,2,12,1,12,0,False,False,False,0,2,2021-10-05T23:01:02.297,13,False,1.0
2021,4,3116,690,11,4037,2,17,8,24,25,1,25,0,25,6,False,False,False,0,3,2021-10-05T23:00:40.143,25,True,0.0
2021,4,3116,740,6,1400,2,48,10,-5,7,12,5,2,5,0,True,False,False,2,1,2021-10-04T15:21:35.937,7,False,2.0
2021,4,3116,755,11,4037,2,50,5,-3,17,20,17,0,17,0,False,False,False,0,2,2021-10-04T15:29:53.263,17,True,0.0
2021,4,3116,760,11,8359,13,12,6,35,0,0,0,0,0,0,False,False,False,0,3,2022-02-07T20:13:21.227,0,False,
2021,4,3116,770,11,6831,2,5,3,3,3,0,3,0,3,0,False,False,False,0,3,2022-02-16T13:26:28.173,3,False,0.0
2021,4,3116,775,11,4037,13,8,1,28,0,0,0,0,0,0,False,False,False,0,3,2022-02-16T13:26:58.3,0,False,0.0
2021,4,3116,780,11,8359,2,12,3,2,9,7,5,4,5,0,False,False,False,0,3,2022-02-07T20:13:35.863,9,False,4.0
2021,4,3116,785,11,7732,2,16,9,6,8,2,8,0,8,0,False,False,False,0,1,2021-10-04T15:54:10.68,8,False,0.0
2021,4,3116,790,11,6831,2,50,10,-1,9,10,9,0,9,0,False,False,False,0,2,2021-10-04T15:56:21.61,9,False,0.0
2021,4,3116,795,11,6831,13,19,2,17,0,0,0,0,0,0,False,False,False,0,2,2021-10-04T15:58:57.197,0,False,0.0
2021,4,3116,800,11,6810,13,32,9,1,0,0,0,0,0,0,False,False,False,0,4,2021-10-04T16:02:11,0,False,0.0
2021,4,3116,805,11,8359,2,39,4,9,9,0,9,0,9,0,False,False,False,0,3,2021-10-04T16:05:48.497,9,False,0.0
2021,4,3116,810,11,8359,13,46,3,2,0,0,0,0,0,0,False,False,False,0,3,2021-10-08T14:57:24.093,0,False,0.0
2021,4,3116,835,6,464,2,4,5,6,6,0,6,0,6,0,False,False,False,0,2,2021-10-04T17:00:45.963,6,False,
2021,4,3117,35,4,2853,13,6,10,11,0,0,0,0,0,0,True,False,False,0,3,2021-10-08T17:44:54.277,0,False,0.0
2021,4,3117,55,13,2455,13,47,5,-1,0,0,0,0,0,0,False,False,False,0,1,2022-02-16T13:14:08.03,0,False,0.0
2021,4,3117,70,4,2853,13,4,3,8,0,0,0,0,0,0,False,False,False,0,2,2021-10-04T11:48:47.49,0,False,0.0
2021,4,3117,90,13,2407,13,7,2,19,0,0,0,0,0,0,False,False,False,0,3,2021-10-04T11:56:37.263,0,False,0.0
2021,4,3117,95,13,6328,13,4,4,10,0,0,0,0,0,0,False,False,False,0,3,2021-10-08T18:14:53.787,0,False,0.0
2021,4,3117,105,4,6983,2,31,10,1,7,6,6,1,6,0,False,False,False,0,1,2021-10-04T12:04:01.107,7,False,1.0
2021,4,3117,120,4,2853,2,5,3,5,5,0,5,0,5,0,False,False,False,0,2,2021-10-04T18:10:58.883,5,False,0.0
2021,4,3117,145,4,6953,2,35,4,11,25,14,16,9,16,6,False,False,False,1,3,2021-10-08T17:54:24.67,25,False,9.0
2021,4,3117,160,13,876,2,49,10,-3,3,6,2,1,2,0,False,False,False,0,2,2021-10-04T12:34:08.16,3,False,1.0
2021,4,3117,170,13,6328,2,50,10,-3,13,16,6,7,6,0,False,False,False,0,3,2021-10-04T12:39:15.227,13,False,
2021,4,3117,175,13,6328,13,50,3,-3,0,0,0,0,0,0,False,False,False,0,2,2021-10-04T12:43:21.697,0,False,0.0
2021,4,3117,195,4,2853,2,12,2,31,31,0,31,0,31,0,False,False,False,0,3,2022-02-07T20:14:47.647,31,False,0.0
2021,4,3117,205,4,213,2,4,4,9,9,0,9,0,9,0,False,False,False,0,3,2021-10-04T13:14:45.897,9,False,0.0
2021,4,3117,210,4,6953,13,29,5,14,0,0,0,0,0,0,False,False,False,0,3,2021-10-04T13:24:34.763,0,False,0.0
2021,4,3117,245,4,6953,13,17,8,16,0,0,0,0,0,0,False,False,False,0,4,2021-10-08T17:40:58.48,0,False,0.0
2021,4,3117,255,4,213,2,6,7,20,20,0,20,0,20,0,False,False,False,0,2,2021-10-05T19:03:35.993,20,False,0.0
2021,4,3117,260,4,6953,2,50,3,-1,1,2,-3,4,-3,0,False,False,False,1,2,2021-10-08T18:40:03.97,1,False,4.0
2021,4,3117,290,13,6328,13,4,9,4,0,0,0,0,0,0,False,False,False,0,3,2021-10-04T14:14:08.95,0,False,0.0
2021,4,3117,305,4,213,2,5,6,16,16,0,16,0,16,0,False,False,False,0,2,2022-02-18T16:57:13.94,16,False,0.0
2021,4,3117,340,4,2853,13,2,9,8,0,0,0,0,0,0,False,False,False,0,2,2021-10-04T14:46:03.497,0,False,0.0
2021,4,3117,350,13,876,13,2,10,18,0,0,0,0,0,0,False,False,False,0,3,2021-10-08T18:39:44.15,0,False,0.0
2021,4,3117,365,4,594,2,4,5,4,7,3,6,1,6,0,False,False,False,0,3,2021-10-04T14:58:12.677,7,False,1.0
2021,4,3117,370,4,213,2,4,9,7,8,1,7,1,7,0,False,False,False,0,2,2021-10-04T15:00:42.5,8,False,1.0
2021,4,3117,375,4,7646,3,12,5,7,0,0,0,0,0,0,False,False,False,0,3,2022-02-16T13:17:10.837,0,False,0.0
2021,4,3117,380,4,2853,2,13,9,3,5,2,4,1,4,0,False,False,False,0,3,2021-10-04T18:11:33.21,5,False,1.0
2021,4,3117,390,4,7645,13,46,3,1,0,0,0,0,0,0,True,False,False,0,3,2021-10-15T01:27:54.24,0,False,0.0
2021,4,3117,430,4,2853,2,3,5,12,16,4,11,5,11,0,False,False,False,1,2,2021-10-04T18:11:48.523,16,False,5.0
2021,4,3117,450,4,213,2,4,2,16,21,5,18,3,18,0,False,False,False,0,2,2021-10-08T17:41:21.003,21,False,3.0
2021,4,3117,465,4,2853,13,4,10,9,0,0,0,0,0,0,False,False,False,0,2,2021-10-04T15:42:27.643,0,False,
2021,4,3117,470,4,2853,2,34,4,-3,2,5,1,1,1,0,True,True,False,0,3,2021-10-04T18:32:19.06,1,False,1.0
2021,4,3117,480,4,7646,13,17,4,10,0,0,0,0,0,0,True,False,False,0,3,2021-10-04T15:49:55.22,0,False,0.0
2021,4,3117,500,13,876,2,4,5,8,8,0,8,0,8,0,False,False,False,0,2,2021-10-04T15:58:27.397,8,False,0.0
2021,4,3117,510,13,876,13,35,6,28,0,0,0,0,0,0,False,False,False,0,3,2022-02-07T20:16:11.437,0,False,
2021,4,3117,520,13,2455,2,48,10,-3,7,10,3,4,3,0,False,False,False,0,1,2021-10-04T16:05:45.997,7,False,4.0
2021,4,3117,535,4,2853,2,19,2,32,37,5,34,3,34,0,False,False,False,0,2,2021-10-04T18:13:16.507,37,False,3.0
2021,4,3117,545,4,594,2,51,9,-1,9,10,5,4,5,0,False,False,False,0,3,2021-10-04T16:21:34.387,9,False,4.0
2021,4,3117,570,4,6953,2,51,10,-1,5,6,4,1,4,0,True,False,False,0,3,2021-10-04T16:32:55.853,5,False,1.0
2021,4,3117,585,4,6953,2,30,10,-2,5,7,4,1,4,0,False,False,False,0,4,2021-10-05T19:02:24.723,5,False,1.0
2021,4,3117,595,4,6953,2,47,5,1,1,0,1,0,1,6,True,False,False,0,3,2021-10-05T19:02:44.103,1,True,0.0
2021,4,3117,610,13,876,2,4,3,4,8,4,7,1,7,0,True,False,False,0,2,2021-10-04T16:53:54.347,8,False,1.0
2021,4,3117,615,13,6528,2,4,4,5,5,0,5,0,5,0,False,True,True,0,3,2021-10-04T16:55:51.657,4,False,0.0
2021,4,3117,635,4,2853,2,35,6,16,19,3,18,1,18,0,False,False,False,0,3,2021-10-08T17:43:27.247,19,False,1.0
2021,4,3117,660,13,2455,2,5,5,6,8,2,8,0,8,0,False,False,False,0,3,2021-10-04T17:17:47.987,8,False,0.0
2021,4,3117,670,13,876,2,6,10,12,12,0,12,0,12,0,False,False,False,0,2,2021-10-04T17:19:36.42,12,False,0.0
2021,4,3117,680,13,6328,13,19,8,37,0,0,0,0,0,0,False,False,False,0,2,2021-10-08T17:47:08.92,0,False,0.0
2021,4,3117,705,4,7937,2,46,9,1,8,7,5,3,5,0,False,False,False,0,1,2021-10-04T17:37:07.063,8,False,3.0
2021,4,3117,730,13,6328,2,49,10,-2,3,5,0,3,0,0,False,False,False,0,3,2021-10-04T17:42:33.303,3,False,3.0
2021,4,3117,740,13,4662,2,4,9,4,6,2,5,1,5,0,False,False,False,0,4,2021-10-04T17:51:38.48,6,False,1.0
2021,4,3117,745,13,876,13,7,2,35,0,0,0,0,0,0,False,False,False,0,3,2021-10-04T17:54:38.583,0,False,0.0
2021,4,3117,755,13,876,2,6,4,14,16,2,15,1,15,0,False,False,False,0,3,2021-10-04T17:58:52.84,16,False,1.0
2021,4,3117,765,13,2455,2,31,9,2,12,10,3,9,3,0,False,False,False,1,1,2021-10-08T18:00:09.28,12,False,9.0
2021,4,3117,770,13,4662,3,4,10,4,0,0,0,0,0,0,False,False,False,0,3,2021-10-08T17:47:23.4,0,False,0.0
2021,4,3118,15,17,8483,2,12,5,6,5,-1,5,0,5,0,True,False,False,0,4,2021-10-08T15:10:11.043,5,True,0.0
2021,4,3118,30,17,6276,2,46,9,-2,2,4,-1,3,-1,0,False,False,False,0,4,2021-10-04T09:31:12.7,2,False,3.0
2021,4,3118,35,17,3951,2,7,2,23,28,5,27,1,27,0,False,False,False,0,2,2021-10-08T15:10:27.553,28,False,
2021,4,3118,40,17,364,13,12,2,15,0,0,0,0,0,0,False,False,False,0,3,2021-10-08T14:56:13.437,0,False,0.0
2021,4,3118,50,17,3356,2,47,5,-1,2,3,2,0,2,0,False,False,False,0,1,2021-10-05T19:11:19.42,2,False,
2021,4,3118,55,17,2253,13,12,2,17,0,0,0,0,0,0,False,False,False,0,2,2022-02-18T18:12:08.887,0,False,0.0
2021,4,3118,65,17,4484,13,17,9,9,0,0,0,0,0,0,False,False,False,0,4,2021-10-04T09:52:37.693,0,False,0.0
2021,4,3118,95,14,7582,2,5,9,1,1,0,1,0,1,0,False,False,False,0,1,2021-10-04T10:03:14.07,1,False,0.0
2021,4,3118,115,17,8483,2,5,5,4,18,14,7,11,7,0,False,False,False,1,3,2021-10-04T10:10:54.153,18,False,11.0
2021,4,3118,120,17,7618,2,47,5,2,4,2,4,0,4,0,False,False,False,0,1,2021-10-04T10:13:31.097,4,False,0.0
2021,4,3118,135,17,8483,2,4,3,4,10,6,10,0,10,0,False,False,False,1,3,2021-10-04T10:19:30.35,10,False,0.0
2021,4,3118,140,17,7618,2,47,5,1,8,7,6,2,6,0,False,False,False,0,1,2021-10-04T10:21:43.357,8,False,2.0
2021,4,3118,150,17,3951,2,12,5,4,6,2,4,2,4,0,False,False,False,1,3,2021-10-04T10:25:52.61,6,False,2.0
2021,4,3118,200,14,7582,2,31,10,-1,7,8,0,7,0,0,False,False,False,1,1,2021-10-04T10:40:20.607,7,False,7.0
2021,4,3118,210,14,7584,2,13,9,5,6,1,6,0,6,0,False,False,False,0,3,2021-10-04T10:44:20.05,6,False,0.0
2021,4,3118,230,17,2253,3,4,5,6,0,0,0,0,0,0,False,False,False,0,2,2022-02-18T18:20:35.447,0,False,0.0
2021,4,3118,235,17,3951,13,4,5,6,0,0,0,0,0,0,True,False,False,0,2,2021-10-04T10:52:10.07,0,False,0.0
2021,4,3118,250,14,8400,13,13,4,2,0,0,0,0,0,0,False,False,False,0,3,2021-10-04T10:56:08.197,0,False,0.0
2021,4,3118,255,14,6938,2,5,3,10,12,2,12,0,12,0,False,False,False,0,2,2021-10-04T11:04:57.383,12,False,0.0
2021,4,3118,260,14,5024,2,47,5,0,1,1,0,1,0,0,False,False,False,0,1,2021-10-08T14:54:08.93,1,False,1.0
2021,4,3118,270,14,7584,2,2,9,3,5,2,3,2,3,0,False,False,False,0,2,2021-10-08T15:11:30.95,5,False,2.0
2021,4,3118,280,14,4449,2,13,10,3,4,1,3,1,3,0,False,False,False,0,3,2021-10-04T11:15:25.197,4,False,1.0
2021,4,3118,285,14,5197,2,35,7,17,28,11,22,6,22,0,False,False,False,0,4,2021-10-04T11:17:46.947,28,False,6.0
2021,4,3118,290,14,5197,13,7,6,23,0,0,0,0,0,0,False,False,False,0,4,2022-02-18T18:17:20.193,0,False,0.0
2021,4,3118,310,17,6276,2,30,10,0,4,4,3,1,3,0,True,False,False,0,4,2021-10-05T19:51:50.487,4,False,1.0
2021,4,3118,320,17,2253,13,7,5,14,0,0,0,0,0,0,False,False,False,0,2,2021-10-08T15:11:46.087,0,False,0.0
2021,4,3118,325,17,6274,13,4,4,11,0,0,0,0,0,0,False,False,False,0,3,2021-10-04T11:33:04.037,0,False,0.0
2021,4,3118,335,14,7584,2,12,9,3,6,3,5,1,5,0,False,False,False,0,2,2021-10-08T14:54:22.227,6,False,1.0
2021,4,3118,345,14,7584,13,19,6,28,0,0,0,0,0,0,False,False,False,0,2,2021-10-08T14:54:34.357,0,False,0.0
2021,4,3118,350,14,6543,2,31,4,-1,3,4,2,1,2,0,False,False,False,0,1,2021-10-04T11:41:41.377,3,False,1.0
2021,4,3118,370,14,6543,2,31,4,1,2,1,2,0,2,0,False,False,False,0,1,2021-10-08T15:12:03.87,2,False,0.0
2021,4,3118,375,14,6938,13,19,2,33,0,0,0,0,0,0,False,False,False,0,2,2021-10-04T11:49:33.017,0,False,0.0
2021,4,3118,380,14,7582,2,48,10,-4,3,7,2,1,2,0,False,False,False,0,1,2021-10-08T15:12:17.883,3,False,1.0
2021,4,3118,420,14,7495,2,8,1,16,17,1,16,1,16,0,False,False,False,0,2,2021-10-08T12:40:54.683,17,False,1.0
2021,4,3118,440,14,5197,13,12,5,6,0,0,0,0,0,0,False,False,False,0,4,2021-10-04T12:26:02.847,0,False,0.0
2021,4,3118,450,14,7584,2,26,9,4,8,4,6,2,6,0,False,False,False,0,3,2021-10-04T12:29:23.54,8,False,2.0
2021,4,3118,455,14,4449,2,34,4,-4,-2,2,-2,0,-2,0,True,False,False,0,4,2021-10-04T12:33:27.807,-2,False,0.0
2021,4,3118,465,14,5197,2,47,5,3,3,0,3,0,3,6,False,False,False,0,4,2021-10-04T12:35:14.487,3,True,0.0
2021,4,3118,485,17,4305,2,34,4,-4,-7,-3,-7,0,-7,0,True,False,False,0,3,2021-10-04T12:42:06.027,-7,False,0.0
2021,4,3118,490,17,364,2,4,9,7,11,4,10,1,10,0,False,False,False,1,3,2021-10-04T12:44:17.25,11,False,1.0
2021,4,3118,510,14,5024,13,11,5,13,0,0,0,0,0,0,False,False,False,0,1,2021-10-04T12:53:20.31,0,False,0.0
2021,4,3118,515,14,7584,2,5,5,14,14,0,14,0,14,0,False,False,False,0,2,2021-10-05T19:08:12.683,14,False,0.0
2021,4,3118,540,14,6938,2,2,10,8,10,2,10,0,10,0,False,False,False,0,3,2021-10-08T12:40:54.683,10,False,0.0
2021,4,3118,545,14,4449,2,51,10,1,1,0,1,0,1,0,False,False,False,0,3,2021-10-04T13:05:37.823,1,False,0.0
2021,4,3118,560,17,8483,13,5,5,5,0,0,0,0,0,0,True,False,False,0,3,2021-10-04T13:09:46.683,0,False,0.0
2021,4,3118,565,17,6274,2,5,3,7,8,1,8,0,8,0,False,False,False,0,3,2021-10-08T15:12:48.787,8,False,0.0
2021,4,3118,570,17,2253,2,3,3,6,7,1,7,0,7,0,False,False,False,0,2,2021-10-08T15:13:03.843,7,False,0.0
2021,4,3118,590,14,8400,2,47,10,2,3,1,3,0,3,0,False,False,False,0,4,2021-10-04T13:27:45.46,3,False,0.0
2021,4,3118,595,14,4449,13,13,10,5,0,0,0,0,0,0,False,False,False,0,3,2021-10-08T15:13:21.307,0,False,0.0
2021,4,3118,610,17,6274,2,32,5,3,4,1,3,1,3,0,False,False,False,0,4,2021-10-04T13:32:35.357,4,False,1.0
2021,4,3118,615,17,6274,2,12,9,14,22,8,20,2,20,0,False,False,False,0,3,2021-10-04T13:35:34.387,22,False,2.0
2021,4,3118,620,17,2253,13,9,6,23,0,0,0,0,0,0,False,False,False,0,2,2021-10-04T13:38:33.563,0,False,
2021,4,3118,625,17,2253,3,4,3,4,0,0,0,0,0,0,False,False,False,0,2,2021-10-04T13:40:35.68,0,False,0.0
2021,4,3118,630,17,2253,2,29,6,20,25,5,20,5,20,0,False,False,False,0,2,2021-10-04T13:42:30.91,25,False,5.0
2021,4,3118,650,17,6274,2,13,9,-1,1,2,1,0,1,6,False,False,False,0,3,2021-10-08T15:13:50.353,1,True,0.0
2021,4,3118,665,14,4449,2,35,7,22,41,19,29,12,29,0,False,False,False,1,2,2021-10-08T15:14:04.927,41,False,12.0
2021,4,3118,680,14,6543,13,51,3,2,0,0,0,0,0,0,True,False,False,0,3,2022-02-16T14:52:24.66,0,False,
2021,4,3118,700,14,7584,13,17,9,6,0,0,0,0,0,0,False,False,False,0,3,2021-10-05T19:08:28.173,0,False,0.0
2021,4,3118,715,14,5197,2,7,3,11,11,0,11,0,11,6,False,False,False,0,3,2021-10-04T14:11:42.95,11,True,0.0
2021,4,3118,730,17,2253,2,12,2,40,42,2,42,0,42,0,False,False,False,0,2,2021-10-04T14:16:24.167,42,False,0.0
2021,4,3118,735,17,6274,2,17,8,20,22,2,21,1,21,0,False,False,False,0,3,2021-10-04T14:17:58.037,22,False,1.0
2021,4,3118,740,17,3356,2,47,10,0,4,4,3,1,3,0,False,False,False,0,1,2021-10-04T14:19:14.343,4,False,1.0
2021,4,3118,750,17,2253,3,29,5,3,0,0,0,0,0,0,False,False,False,0,2,2021-10-08T14:55:04.31,0,False,0.0
2021,4,3118,755,17,2253,2,12,4,3,3,0,3,0,3,6,False,False,False,0,2,2021-10-04T14:23:13.727,3,True,0.0
2021,4,3118,790,14,1119,2,7,6,24,24,0,24,0,24,0,False,False,False,0,4,2021-10-08T14:55:32.187,24,False,0.0
2021,4,3118,810,14,7584,2,12,8,17,20,3,19,1,19,0,False,False,False,0,2,2022-02-14T18:56:57.367,20,False,1.0
2021,4,3119,15,2,811,2,4,9,4,4,0,4,0,4,0,False,False,False,0,3,2021-10-08T22:12:33.413,4,False,0.0
2021,4,3119,30,2,5223,2,2,9,9,13,4,12,1,12,0,False,False,False,0,2,2021-10-04T10:15:02.713,13,False,1.0
2021,4,3119,45,2,8389,2,2,9,12,15,3,13,2,13,0,False,False,False,0,2,2021-10-05T20:45:27.963,15,False,2.0
2021,4,3119,55,2,5223,2,21,3,14,16,2,16,0,16,0,False,False,False,0,2,2021-10-04T17:33:13.163,16,True,
2021,4,3119,60,2,3506,2,2,4,6,7,1,6,1,6,0,False,False,False,0,3,2021-10-04T10:29:33.023,7,False,1.0
2021,4,3119,65,2,8389,2,12,5,13,15,2,15,0,15,0,False,False,False,0,3,2021-10-04T10:32:36.263,15,True,0.0
2021,4,3119,80,2,8389,13,21,4,7,0,0,0,0,0,0,True,False,False,0,3,2021-10-08T22:13:16.03,0,False,0.0
2021,4,3119,100,32,7128,13,2,9,5,0,0,0,0,0,0,False,False,False,0,2,2021-10-04T10:49:43.837,0,False,0.0
2021,4,3119,105,32,4803,2,4,10,3,4,1,3,1,3,0,False,False,False,0,2,2021-10-04T10:51:28.94,4,False,1.0
2021,4,3119,115,32,7807,2,48,10,-3,1,4,0,1,0,0,False,False,False,0,1,2021-10-08T22:34:13.083,1,False,1.0
2021,4,3119,120,32,7128,13,9,6,17,0,0,0,0,0,0,False,False,False,0,3,2021-10-04T10:57:41.55,0,False,0.0
2021,4,3119,135,2,811,2,50,10,-2,10,12,8,2,8,0,False,False,False,0,3,2021-10-08T22:08:32.477,10,False,2.0
2021,4,3119,140,2,5223,13,2,10,11,0,0,0,0,0,0,False,False,False,0,2,2021-10-04T11:08:26.547,0,False,0.0
2021,4,3119,150,2,811,13,52,10,2,0,0,0,0,0,0,False,False,False,0,2,2022-02-18T16:45:06.427,0,False,0.0
2021,4,3119,165,32,4803,2,51,9,-2,6,8,5,1,5,0,True,False,False,0,3,2021-10-08T22:11:27.127,6,False,1.0
2021,4,3119,170,32,7128,2,2,4,5,9,4,5,4,5,0,False,False,False,0,3,2021-10-04T11:19:28.017,9,False,4.0
2021,4,3119,210,2,5214,2,30,10,-2,5,7,0,5,0,0,True,True,False,0,4,2022-04-28T16:58:23.01,5,False,5.0
2021,4,3119,225,2,5214,2,46,3,5,12,7,10,2,10,0,False,False,False,0,4,2021-10-04T11:34:18.06,12,False,2.0
2021,4,3119,230,2,811,2,8,7,37,42,5,42,0,42,6,False,False,False,0,3,2021-10-04T11:36:11.843,42,True,0.0
2021,4,3119,245,32,4788,2,47,5,-3,3,6,3,0,3,0,False,False,False,0,4,2021-10-08T22:26:37.83,3,False,0.0
2021,4,3119,250,32,8527,2,4,4,14,19,5,17,2,17,0,False,False,False,0,2,2021-10-04T17:05:17.087,19,False,2.0
2021,4,3119,255,32,4803,2,48,9,-8,-1,7,-4,3,-4,0,True,False,False,0,1,2021-10-04T11:51:19.743,-1,False,3.0
2021,4,3119,260,32,7128,2,8,1,20,21,1,20,1,20,0,False,False,False,0,2,2021-10-04T11:58:55.743,21,False,1.0
2021,4,3119,270,32,4788,13,5,5,13,0,0,0,0,0,0,False,False,False,0,3,2022-02-16T13:04:58.303,0,False,0.0
2021,4,3119,275,32,7128,2,19,6,33,33,0,33,0,33,6,False,False,False,0,2,2021-10-04T12:03:43.253,33,True,0.0
2021,4,3119,295,2,8389,13,2,4,11,0,0,0,0,0,0,False,False,False,0,3,2021-10-15T01:28:48.797,0,False,0.0
2021,4,3119,300,2,3506,2,2,4,7,8,1,7,1,7,0,False,False,False,0,3,2021-10-04T12:09:07.097,8,False,1.0
2021,4,3119,340,32,4788,2,38,9,3,16,13,7,9,7,0,False,False,False,2,4,2021-10-08T22:24:47.197,16,False,9.0
2021,4,3119,375,2,5223,13,2,9,8,0,0,0,0,0,0,False,False,False,0,2,2021-10-04T12:30:22.163,0,False,0.0
2021,4,3119,380,2,5223,13,9,2,28,0,0,0,0,0,0,False,False,False,0,3,2021-10-04T12:32:43.033,0,False,
2021,4,3119,390,2,7303,3,7,2,18,0,0,0,0,0,0,False,False,False,0,3,2021-10-08T19:52:51.857,0,False,0.0
2021,4,3119,395,2,5223,2,2,9,8,8,0,8,0,8,0,False,False,False,0,2,2021-10-04T12:40:00.44,8,False,0.0
2021,4,3119,410,2,8389,13,5,3,7,0,0,0,0,0,0,False,False,False,0,4,2021-10-04T12:48:28.183,0,False,0.0
2021,4,3119,415,2,5223,2,5,5,9,17,8,13,4,13,0,True,False,False,0,2,2021-10-08T22:28:05.827,17,False,4.0
2021,4,3119,420,2,8389,13,5,5,5,0,0,0,0,0,0,False,False,False,0,3,2021-10-05T03:14:05.293,0,False,0.0
2021,4,3119,425,2,5223,2,2,4,3,6,3,4,2,4,0,False,False,False,2,3,2021-10-08T22:23:03.11,6,False,2.0
2021,4,3119,435,2,811,2,46,4,0,12,12,3,9,3,6,False,False,False,1,1,2021-10-04T12:57:04.557,12,False,9.0
2021,4,3119,480,2,7303,2,2,10,14,15,1,14,1,14,0,False,False,False,0,2,2021-10-04T13:12:12.387,15,False,1.0
2021,4,3119,485,2,5223,3,9,2,31,0,0,0,0,0,0,False,False,False,0,2,2021-10-04T17:10:16.367,0,False,
2021,4,3119,495,2,5214,2,4,9,5,5,0,5,0,5,0,False,False,False,0,3,2021-10-04T17:05:39.493,5,False,0.0
2021,4,3119,505,2,5214,2,13,4,5,7,2,6,1,6,0,False,False,False,0,3,2021-10-04T13:20:04.193,7,False,1.0
2021,4,3119,515,2,8389,13,8,9,12,0,0,0,0,0,0,False,False,False,0,3,2021-10-08T22:29:17.877,0,False,0.0
2021,4,3119,520,2,811,2,29,3,14,14,0,14,0,14,6,False,False,False,0,2,2021-10-04T13:25:50.89,14,True,0.0
2021,4,3119,535,32,7128,2,6,7,19,20,1,19,1,19,0,False,False,False,0,2,2021-10-08T22:38:35.25,20,False,1.0
2021,4,3119,540,32,7807,2,48,10,-4,11,15,3,8,3,0,False,False,False,0,1,2021-10-08T22:23:53.977,11,False,8.0
2021,4,3119,545,32,7128,13,23,2,31,0,0,0,0,0,0,False,False,False,0,2,2022-02-16T13:06:35.143,0,False,0.0
2021,4,3119,555,32,4788,13,9,2,16,0,0,0,0,0,0,False,False,False,0,3,2021-10-04T13:43:09.27,0,False,0.0
2021,4,3119,560,32,4803,2,26,3,1,10,9,7,3,7,0,False,False,False,1,2,2021-10-08T22:24:06.91,10,False,3.0
2021,4,3119,575,32,8527,13,8,4,14,0,0,0,0,0,0,False,False,False,0,2,2021-10-04T17:05:57.217,0,False,0.0
2021,4,3119,595,32,7128,13,2,9,2,0,0,0,0,0,0,False,False,False,0,3,2021-10-08T22:11:50.207,0,False,0.0
2021,4,3119,610,2,5223,13,20,7,41,0,0,0,0,0,0,False,False,False,0,2,2021-10-08T22:14:02.38,0,False,0.0
2021,4,3119,620,2,8389,2,2,4,9,14,5,9,5,9,0,True,False,False,0,3,2021-10-05T20:48:12.42,14,False,5.0
2021,4,3119,630,2,8389,2,4,3,4,6,2,4,2,4,0,False,False,False,0,2,2021-10-04T14:07:36.503,6,False,2.0
2021,4,3119,635,2,5223,2,26,10,5,7,2,6,1,6,0,False,False,False,0,2,2021-10-08T22:40:06.457,7,False,1.0
2021,4,3119,645,2,5223,2,5,5,8,8,0,8,0,8,0,True,False,False,0,3,2021-10-04T14:13:59.25,8,True,0.0
2021,4,3119,650,2,5223,3,19,2,37,0,0,0,0,0,0,False,False,False,0,2,2021-10-04T14:16:50.087,0,False,0.0
2021,4,3119,680,2,2554,2,44,3,-5,7,12,-5,12,-5,6,False,False,False,3,1,2021-10-08T22:14:16.123,7,False,12.0
2021,4,3119,695,32,3885,2,45,5,-3,2,5,1,1,1,0,True,False,False,0,1,2021-10-04T15:22:14.747,2,False,1.0
2021,4,3119,705,32,3885,2,46,9,-2,-2,0,-2,0,-2,0,False,False,False,0,1,2021-10-04T15:24:32.697,-2,False,0.0
2021,4,3119,735,2,5223,13,7,6,20,0,0,0,0,0,0,False,False,False,0,3,2021-10-08T22:14:38.197,0,False,0.0
2021,4,3119,755,32,7807,13,47,5,3,0,0,0,0,0,0,False,False,False,0,1,2021-10-04T17:11:05.37,0,False,
2021,4,3119,760,32,8659,2,46,9,2,11,9,8,3,8,0,False,False,False,0,1,2021-10-04T15:40:27.53,11,False,3.0
2021,4,3119,785,32,7128,2,6,1,21,23,2,23,0,23,0,False,False,False,0,2,2021-10-04T15:47:46.917,23,False,0.0
2021,4,3119,790,32,7128,13,19,6,23,0,0,0,0,0,0,False,False,False,0,2,2021-10-04T15:49:20.2,0,False,0.0
2021,4,3119,800,32,3885,2,13,10,5,10,5,7,3,7,0,False,False,False,0,2,2021-10-04T15:55:12.267,10,False,3.0
2021,4,3119,805,32,7128,2,12,7,17,17,0,17,0,17,6,False,False,False,0,2,2021-10-04T15:54:59.57,17,True,0.0
2021,4,3119,840,2,2554,2,48,9,-2,5,7,2,3,2,0,False,False,False,1,1,2022-02-18T16:47:29.84,5,False,3.0
2021,4,3119,855,32,7128,13,6,9,6,0,0,0,0,0,0,False,False,False,0,2,2021-10-04T16:07:55.667,0,False,0.0
2021,4,3119,860,32,3562,2,6,1,18,24,6,24,0,24,0,False,False,False,0,3,2022-02-16T13:09:32.28,24,False,0.0
2021,4,3119,865,32,7128,13,4,9,12,0,0,0,0,0,0,False,False,False,0,2,2021-10-05T03:15:23.803,0,False,0.0
2021,4,3119,870,32,2675,2,5,3,12,19,7,18,1,18,0,False,False,False,0,3,2021-10-04T16:12:43.963,19,False,1.0
2021,4,3119,875,32,3885,2,50,3,-1,4,5,0,4,0,0,True,False,False,0,2,2021-10-04T16:14:16.063,4,False,4.0
2021,4,3119,895,32,3885,2,12,10,0,30,30,29,1,29,6,False,False,False,1,1,2022-02-07T20:18:52.837,30,False,1.0
2021,4,3119,910,2,5223,2,6,7,20,21,1,21,0,21,0,False,False,False,0,2,2021-10-04T16:22:52.283,21,False,0.0
2021,4,3119,920,2,5223,13,4,9,11,0,0,0,0,0,0,False,False,False,0,2,2021-10-04T16:25:18.88,0,False,0.0
2021,4,3119,945,2,5214,13,19,1,37,0,0,0,0,0,0,False,False,False,0,3,2021-10-06T14:54:40.027,0,False,0.0
2021,4,3120,20,27,7408,13,5,3,3,0,0,0,0,0,0,False,False,False,0,3,2022-02-25T15:03:08.94,0,False,0.0
2021,4,3120,30,28,262,2,4,9,6,9,3,7,2,7,0,True,False,False,0,4,2021-10-05T16:52:54.66,9,False,2.0
2021,4,3120,40,28,4922,2,6,4,8,8,0,8,0,8,0,False,False,False,0,4,2021-10-08T15:14:55.253,8,False,0.0
2021,4,3120,45,28,7224,2,50,9,0,21,21,10,11,10,0,False,False,False,1,3,2021-10-08T16:50:00.16,5,False,11.0
2021,4,3120,55,28,917,2,4,10,6,9,3,7,2,7,0,False,False,False,0,3,2021-10-04T10:16:02.523,9,False,2.0
2021,4,3120,60,28,4922,2,17,2,16,18,2,17,1,17,0,False,False,False,0,4,2021-10-08T15:14:55.253,18,False,1.0
2021,4,3120,70,28,6627,2,11,2,21,21,0,21,0,21,6,True,False,False,0,3,2022-02-16T15:44:14.37,21,False,0.0
2021,4,3120,85,27,650,2,30,5,-3,-2,1,-2,0,-2,0,False,False,False,0,3,2021-10-08T17:50:50.843,-2,False,0.0
2021,4,3120,90,27,650,2,5,3,5,5,0,5,0,5,0,False,False,False,0,2,2021-10-08T17:52:18.923,5,False,0.0
2021,4,3120,115,28,7224,13,39,4,14,0,0,0,0,0,0,False,False,False,0,3,2021-10-04T18:50:30.62,0,False,0.0
2021,4,3120,125,28,4922,13,39,4,7,0,0,0,0,0,0,True,False,False,0,3,2021-10-08T17:53:51.837,0,False,0.0
2021,4,3120,130,27,650,13,4,10,9,0,0,0,0,0,0,False,False,False,0,2,2021-10-04T11:02:41.097,0,False,0.0
2021,4,3120,135,27,6397,2,53,10,-5,3,8,1,2,1,0,False,True,False,1,3,2021-10-08T17:55:16.68,3,False,2.0
2021,4,3120,155,28,4922,2,50,9,-4,7,11,5,2,5,0,False,False,False,0,3,2021-10-08T16:50:00.16,7,False,2.0
2021,4,3120,160,28,7619,2,13,10,7,15,8,12,3,12,0,False,False,False,0,2,2021-10-08T17:41:11.273,15,False,3.0
2021,4,3120,165,28,7753,2,39,4,13,14,1,14,0,14,0,False,False,False,0,3,2021-10-04T18:42:38.91,14,False,0.0
2021,4,3120,170,28,7224,2,35,6,16,26,10,26,0,26,0,False,False,False,0,4,2021-10-08T17:57:33.283,26,False,0.0
2021,4,3120,195,28,4922,2,53,9,-3,7,10,5,2,5,0,False,False,False,1,4,2021-10-05T16:57:36.393,7,False,2.0
2021,4,3120,230,28,7619,3,12,2,29,0,0,0,0,0,0,False,False,False,0,3,2022-02-18T20:12:19.76,0,False,0.0
2021,4,3120,235,28,4922,13,4,10,8,0,0,0,0,0,0,False,False,False,0,4,2021-10-08T19:01:22.54,0,False,0.0
2021,4,3120,240,28,7224,2,2,10,8,10,2,9,1,9,0,False,False,False,0,2,2021-10-04T12:30:25.077,10,False,1.0
2021,4,3120,255,28,4922,13,7,7,36,0,0,0,0,0,0,False,False,False,0,4,2021-10-08T19:02:42.933,0,False,0.0
2021,4,3120,265,28,7619,13,2,10,7,0,0,0,0,0,0,False,False,False,0,2,2021-10-04T12:57:06.16,0,False,0.0
2021,4,3120,280,27,7852,2,50,3,-2,2,4,0,2,0,0,False,False,False,0,2,2021-10-08T16:50:00.16,2,False,2.0
2021,4,3120,285,27,7408,13,2,9,5,0,0,0,0,0,0,False,False,False,0,2,2021-10-04T13:10:28.207,0,False,0.0
2021,4,3120,305,28,4922,13,26,9,6,0,0,0,0,0,0,False,False,False,0,3,2021-10-04T13:21:42.123,0,False,0.0
2021,4,3120,315,27,3656,2,46,3,5,28,23,26,2,26,0,False,False,False,1,1,2021-10-04T13:29:27.967,28,False,2.0
2021,4,3120,330,27,7408,2,35,7,17,28,11,25,3,25,0,False,False,False,0,3,2022-02-18T20:09:58.387,28,False,3.0
2021,4,3120,345,27,7408,2,26,9,5,12,7,2,10,2,6,False,False,False,0,3,2021-10-05T16:33:02.66,12,False,10.0
2021,4,3120,360,28,7224,2,5,10,7,8,1,7,1,7,0,False,False,False,0,3,2021-10-04T13:50:30.243,8,False,1.0
2021,4,3120,375,28,6410,3,2,4,12,0,0,0,0,0,0,False,False,False,0,3,2021-10-04T13:57:09.793,0,False,0.0
2021,4,3120,380,28,262,2,26,10,4,8,4,6,2,6,0,False,False,False,0,1,2021-10-04T13:59:46.013,8,False,2.0
2021,4,3120,450,27,5050,2,51,10,-5,1,6,-3,4,-3,0,False,False,False,1,1,2021-10-08T17:28:01.56,1,False,4.0
2021,4,3120,455,27,7408,13,21,2,35,0,0,0,0,0,0,False,False,False,0,2,2021-10-08T18:01:12.45,0,False,0.0
2021,4,3120,470,28,4922,13,47,10,-2,0,0,0,0,0,0,True,False,False,0,4,2022-02-16T15:47:01.563,0,False,0.0
2021,4,3120,480,28,7224,13,2,10,6,0,0,0,0,0,0,False,False,False,0,2,2021-10-04T18:48:20.17,0,False,0.0
2021,4,3120,490,27,650,2,3,2,19,19,0,19,0,19,0,False,False,False,0,3,2021-10-04T18:36:57.373,19,False,0.0
2021,4,3120,505,27,7408,2,50,9,-2,9,11,-2,11,-2,0,False,False,False,1,2,2021-10-08T16:50:00.16,9,False,11.0
2021,4,3120,515,27,650,2,49,5,-2,2,4,0,2,0,0,False,False,False,0,2,2021-10-08T16:50:00.16,2,False,2.0
2021,4,3120,540,27,7852,2,11,5,13,13,0,13,0,13,6,True,False,False,0,3,2021-10-08T17:28:24.4,13,True,0.0
2021,4,3120,570,28,7224,2,21,2,24,76,52,76,0,76,6,False,False,False,0,3,2021-10-08T15:14:55.253,76,True,0.0
2021,4,3120,590,27,7408,2,3,6,16,16,0,16,0,16,0,False,False,False,0,2,2021-10-04T15:57:24.237,16,False,0.0
2021,4,3120,595,27,3656,2,4,4,2,6,4,4,2,4,0,False,False,False,0,1,2021-10-04T16:00:01.183,6,False,2.0
2021,4,3120,615,27,7408,3,5,5,5,0,0,0,0,0,0,False,False,False,0,3,2021-10-04T16:07:14.647,0,False,0.0
2021,4,3120,625,27,7408,13,29,2,16,0,0,0,0,0,0,True,False,False,0,2,2021-10-05T16:36:15.837,0,False,
2021,4,3120,635,27,6397,2,47,4,0,2,2,0,2,0,0,False,False,False,0,4,2021-10-08T17:46:58.373,2,False,2.0
2021,4,3120,645,27,650,13,24,2,26,0,0,0,0,0,0,False,False,False,0,2,2021-10-04T16:24:44.36,0,False,
2021,4,3120,675,28,4922,13,31,4,1,0,0,0,0,0,0,False,False,False,0,4,2021-10-04T16:44:50.46,0,False,0.0
2021,4,3120,700,27,7852,2,50,5,-1,5,6,2,3,2,0,False,False,False,0,2,2021-10-08T16:50:00.16,5,False,3.0
2021,4,3120,705,27,7852,13,46,3,3,0,0,0,0,0,0,False,False,False,0,3,2021-10-04T16:58:14.833,0,False,0.0
2021,4,3120,720,28,6410,13,4,10,11,0,0,0,0,0,0,False,False,False,0,3,2021-10-08T18:06:19.617,0,False,0.0
2021,4,3120,735,28,7224,2,13,9,7,11,4,6,5,6,0,False,False,False,1,3,2021-10-08T17:49:16.007,11,False,5.0
2021,4,3120,745,28,917,13,12,2,27,0,0,0,0,0,0,False,False,False,0,3,2022-02-16T15:50:28.23,0,False,0.0
2021,4,3120,785,28,7619,13,12,10,12,0,0,0,0,0,0,False,False,False,0,2,2021-10-08T15:12:59.957,0,False,
2021,4,3120,790,28,262,2,47,10,1,14,13,14,0,14,0,False,False,False,0,1,2021-10-08T16:59:45.463,14,False,0.0
2021,4,3120,795,28,262,2,48,5,-3,10,13,9,1,9,0,False,False,False,0,1,2021-10-04T17:44:35.123,10,False,1.0
2021,4,3120,805,28,917,2,12,9,4,12,8,12,0,12,0,False,False,False,0,3,2021-10-08T15:13:49.497,12,False,0.0
2021,4,3120,815,28,7224,13,6,1,18,0,0,0,0,0,0,False,False,False,0,2,2021-10-08T16:58:39.59,0,False,0.0
2021,4,3120,820,28,7224,2,4,10,12,12,0,12,0,12,0,False,False,False,0,3,2021-10-08T14:13:22.3,12,False,0.0
2021,4,3120,825,28,917,2,4,9,5,7,2,6,1,6,0,False,False,False,0,3,2021-10-04T18:44:24.487,7,False,1.0
2021,4,3120,835,28,917,2,6,4,7,7,0,7,0,7,0,False,False,False,0,3,2021-10-04T18:44:42.61,7,False,0.0
2021,4,3120,850,28,4922,13,17,1,21,0,0,0,0,0,0,True,False,False,0,3,2021-10-05T16:51:19.087,0,False,0.0
2021,4,3120,855,28,7224,13,2,9,7,0,0,0,0,0,0,False,False,False,0,2,2021-10-04T18:46:05.663,0,False,0.0
2021,4,3120,870,28,7224,2,51,3,-4,8,12,2,6,2,6,True,False,False,0,1,2021-10-04T18:45:46.307,8,False,6.0
2021,4,3121,15,29,7828,2,5,6,20,20,0,20,0,20,0,False,False,False,0,3,2021-10-08T18:12:43.01,20,False,0.0
2021,4,3121,30,29,4866,2,6,4,5,5,0,5,0,5,0,True,False,False,0,3,2021-10-05T23:20:12.983,5,False,0.0
2021,4,3121,35,29,1958,2,35,10,9,18,9,17,1,17,0,False,False,False,0,3,2021-10-04T09:33:17.66,18,False,1.0
2021,4,3121,40,29,3398,2,51,10,-3,5,8,3,2,3,0,False,False,False,0,3,2021-10-04T09:35:23.033,5,False,2.0
2021,4,3121,45,29,4866,3,5,5,5,0,0,0,0,0,0,False,False,False,0,3,2021-10-04T09:36:51.787,0,False,0.0
2021,4,3121,50,29,3398,13,21,6,23,0,0,0,0,0,0,False,False,False,0,2,2021-10-08T16:37:56.35,0,False,0.0
2021,4,3121,65,1,910,3,4,10,6,0,0,0,0,0,0,False,False,False,0,2,2022-02-16T14:30:11.65,0,False,0.0
2021,4,3121,70,1,6405,2,26,5,3,5,2,5,0,5,0,False,False,False,0,3,2021-10-04T09:45:50.973,5,False,0.0
2021,4,3121,90,29,967,13,8,7,43,0,0,0,0,0,0,False,False,False,0,3,2022-02-16T14:30:47.65,0,False,0.0
2021,4,3121,100,1,2416,2,39,4,4,8,4,6,2,6,0,False,False,False,0,3,2021-10-04T10:04:47.973,8,False,2.0
2021,4,3121,110,1,245,2,5,2,22,25,3,25,0,25,0,False,False,False,0,2,2021-10-04T10:13:06.203,25,False,0.0
2021,4,3121,115,1,8439,2,51,10,-5,5,10,5,0,5,0,False,False,False,0,1,2021-10-04T10:12:31.78,5,False,0.0
2021,4,3121,125,1,910,2,19,2,35,41,6,35,6,35,6,False,False,False,0,3,2021-10-08T18:11:27.507,41,False,6.0
2021,4,3121,145,29,7378,2,32,3,0,2,2,2,0,2,0,False,False,False,0,4,2021-10-04T10:25:08.937,2,False,0.0
2021,4,3121,150,29,3398,2,5,3,4,7,3,6,1,6,0,True,False,False,0,3,2021-10-08T16:37:56.35,7,False,1.0
2021,4,3121,180,29,7828,2,12,9,14,14,0,14,0,14,6,False,False,False,0,3,2021-10-04T10:37:57.813,14,False,0.0
2021,4,3121,195,1,910,2,4,10,4,6,2,5,1,5,0,False,False,False,0,2,2021-10-04T10:41:41.807,6,False,1.0
2021,4,3121,220,1,245,2,4,9,3,14,11,4,10,4,0,False,False,False,1,3,2021-10-04T10:51:16.417,14,False,10.0
2021,4,3121,230,1,245,2,4,3,7,10,3,8,2,8,0,False,False,False,0,3,2021-10-08T18:08:39.667,10,False,2.0
2021,4,3121,240,1,6406,2,12,10,7,7,0,7,0,7,0,False,False,False,0,1,2021-10-04T10:59:42.973,7,False,0.0
2021,4,3121,245,1,6406,2,12,4,7,9,2,8,1,8,0,False,False,False,0,1,2021-10-04T11:03:55.997,9,False,1.0
2021,4,3121,255,1,6406,2,44,3,-6,-3,3,-3,0,-3,0,False,False,False,0,1,2021-10-04T11:10:13.337,-3,False,0.0
2021,4,3121,260,1,2416,2,17,4,14,14,0,14,0,14,6,False,False,False,0,3,2021-10-04T11:16:20.537,14,False,0.0
2021,4,3121,290,1,6406,13,11,2,16,0,0,0,0,0,0,False,False,False,0,1,2022-02-16T14:32:20.75,0,False,0.0
2021,4,3121,320,29,4866,13,5,3,8,0,0,0,0,0,0,True,False,False,0,3,2021-10-05T23:20:41.297,0,False,0.0
2021,4,3121,325,29,1958,13,5,5,11,0,0,0,0,0,0,True,False,False,0,2,2021-10-05T23:21:03.477,0,False,0.0
2021,4,3121,330,29,7828,2,4,10,14,14,0,14,0,14,0,False,False,False,0,2,2021-10-04T11:44:18.207,14,False,0.0
2021,4,3121,335,29,4866,13,24,6,28,0,0,0,0,0,0,False,False,False,0,3,2021-10-15T01:29:48.903,0,False,
2021,4,3121,340,29,7378,3,16,4,2,0,0,0,0,0,0,False,False,False,0,1,2022-02-16T14:36:46.303,0,False,0.0
2021,4,3121,345,29,7378,2,48,4,-6,7,13,5,2,5,0,False,False,False,0,1,2021-10-08T16:37:56.35,7,False,2.0
2021,4,3121,350,29,4866,13,2,9,5,0,0,0,0,0,0,False,False,False,0,3,2021-10-04T11:56:06.513,0,False,0.0
2021,4,3121,370,1,245,13,7,6,27,0,0,0,0,0,0,False,False,False,0,2,2021-10-08T16:37:56.35,0,False,0.0
2021,4,3121,390,29,967,13,3,6,21,0,0,0,0,0,0,False,False,False,0,3,2021-10-08T18:13:25.307,0,False,0.0
2021,4,3121,395,29,4866,2,8,1,32,35,3,33,2,33,0,False,False,False,0,3,2021-10-04T12:16:44.903,35,False,2.0
2021,4,3121,405,29,3398,2,4,9,14,18,4,15,3,15,0,False,False,False,0,4,2021-10-04T12:19:48.037,18,False,3.0
2021,4,3121,415,29,4866,13,2,9,3,0,0,0,0,0,0,False,False,False,0,3,2021-10-04T12:25:09.097,0,False,0.0
2021,4,3121,420,29,4866,13,46,3,3,0,0,0,0,0,0,False,False,False,0,3,2021-10-04T12:24:54.127,0,False,0.0
2021,4,3121,440,1,4587,2,44,3,-4,7,11,6,1,6,0,False,False,False,0,1,2021-10-04T12:30:32.68,7,False,1.0
2021,4,3121,445,1,2416,2,39,4,4,10,6,7,3,7,0,False,False,False,0,3,2021-10-04T12:32:38.627,10,False,3.0
2021,4,3121,470,1,910,2,50,5,0,3,3,3,0,3,0,False,False,False,0,2,2021-10-08T18:06:36.253,3,False,0.0
2021,4,3121,490,1,910,3,4,5,5,0,0,0,0,0,0,False,False,False,0,2,2021-10-08T18:09:09.577,0,False,
2021,4,3121,495,1,8439,2,12,5,3,16,13,11,5,11,0,False,False,False,1,3,2022-02-07T20:22:19.303,16,False,5.0
2021,4,3121,500,1,4587,2,17,5,8,9,1,8,1,8,0,False,False,False,0,1,2022-02-16T14:39:53.637,9,False,1.0
2021,4,3121,520,1,245,13,12,10,8,0,0,0,0,0,0,False,False,False,0,3,2021-10-04T12:57:35.173,0,False,0.0
2021,4,3121,545,1,245,13,29,3,5,0,0,0,0,0,0,False,False,False,0,2,2021-10-04T13:03:49.74,0,False,0.0
2021,4,3121,580,1,8439,2,50,9,-1,7,8,5,2,5,0,False,False,False,0,3,2021-10-04T13:37:59.297,7,False,2.0
2021,4,3121,590,1,2416,2,46,3,3,9,6,8,1,8,0,False,False,False,0,4,2021-10-04T13:41:19.21,9,False,1.0
2021,4,3121,605,1,245,2,35,8,16,18,2,18,0,18,0,False,False,False,0,3,2021-10-04T13:45:14.79,18,False,0.0
2021,4,3121,640,29,4866,13,6,7,31,0,0,0,0,0,0,False,False,False,0,2,2021-10-08T18:10:46.433,0,False,
2021,4,3121,650,29,4866,2,32,10,-2,9,11,3,6,3,0,False,False,False,0,4,2021-10-08T18:11:56.897,9,False,6.0
2021,4,3121,660,29,7378,2,50,3,0,0,0,0,0,0,0,False,False,False,0,2,2021-10-08T18:06:54.69,0,False,0.0
2021,4,3121,665,29,967,2,50,5,0,6,6,5,1,5,0,False,False,False,0,2,2021-10-08T18:07:11.323,6,False,1.0
2021,4,3121,670,29,4866,13,17,6,17,0,0,0,0,0,0,True,False,False,0,3,2022-02-18T18:06:07.32,0,False,0.0
2021,4,3121,680,1,6406,2,50,10,-3,6,9,4,2,4,0,True,False,False,0,2,2021-10-04T14:19:02.14,6,False,2.0
2021,4,3121,705,1,910,2,4,5,8,12,4,12,0,12,0,False,False,False,0,2,2021-10-04T14:36:46.297,12,False,0.0
2021,4,3121,710,1,2416,2,53,10,-5,25,30,22,3,22,0,False,False,False,0,4,2021-10-04T14:38:54.997,25,False,3.0
2021,4,3121,715,1,910,2,51,5,-2,5,7,1,4,1,0,False,False,False,0,2,2021-10-04T14:40:23.41,5,False,4.0
2021,4,3121,740,29,7828,2,4,3,5,8,3,6,2,6,0,False,False,False,1,2,2021-10-04T14:58:10.65,8,False,2.0
2021,4,3121,745,29,4866,2,5,3,6,7,1,7,0,7,0,False,False,False,0,3,2021-10-04T15:00:30.06,7,False,0.0
2021,4,3121,750,29,7828,13,19,6,19,0,0,0,0,0,0,False,False,False,0,2,2021-10-04T15:02:48.243,0,False,
2021,4,3121,755,29,4866,13,13,3,1,0,0,0,0,0,0,False,False,False,0,3,2021-10-04T15:05:06.513,0,False,0.0
2021,4,3121,760,29,7828,2,12,7,17,22,5,20,2,20,0,False,False,False,0,3,2022-02-07T20:22:37.893,22,False,2.0
2021,4,3121,765,29,1958,13,6,10,13,0,0,0,0,0,0,False,False,False,0,2,2021-10-08T16:37:56.35,0,False,
2021,4,3121,770,29,4866,2,5,5,5,8,3,7,1,7,0,False,False,False,0,3,2021-10-04T15:12:44.83,8,False,1.0
2021,4,3121,780,29,4866,13,7,2,19,0,0,0,0,0,0,False,False,False,0,3,2021-10-08T18:22:38.937,0,False,0.0
2021,4,3121,790,29,3398,2,13,9,6,6,0,6,0,6,0,False,False,False,0,4,2021-10-04T15:21:57.9,6,False,0.0
2021,4,3121,800,29,1958,13,8,4,8,0,0,0,0,0,0,False,False,False,0,3,2021-10-04T15:26:52.93,0,False,0.0
2021,4,3121,815,29,3398,13,47,5,1,0,0,0,0,0,0,False,False,False,0,3,2021-10-08T18:14:31.8,0,False,0.0
2021,4,3121,890,29,1958,2,4,10,5,7,2,7,0,7,0,False,False,False,0,3,2021-10-04T15:59:00.37,7,False,0.0
2021,4,3121,895,29,7378,2,4,10,2,13,11,11,2,11,0,False,False,False,0,1,2021-10-08T18:14:46.187,13,False,2.0
2021,4,3121,905,29,1958,2,5,5,8,9,1,9,0,9,0,False,False,False,0,3,2021-10-08T18:11:09.85,9,False,0.0
2021,4,3121,910,29,7828,2,50,3,0,12,12,11,1,11,0,False,False,False,0,2,2021-10-04T16:06:51.87,12,False,1.0
2021,4,3121,915,29,7378,2,48,9,-5,5,10,2,3,2,0,False,False,False,0,1,2021-10-04T16:09:45.653,5,False,3.0
2021,4,3121,930,29,4906,2,26,10,7,9,2,8,1,8,0,False,False,False,0,4,2021-10-08T16:37:56.35,9,False,1.0
2021,4,3121,935,29,1958,2,5,5,14,14,0,14,0,14,6,False,False,False,0,3,2021-10-08T18:10:13.787,14,False,0.0
2021,4,3122,10,25,7060,2,5,3,3,3,0,3,0,3,0,False,False,False,0,3,2021-10-04T09:44:36.693,3,False,0.0
2021,4,3122,25,25,4583,2,5,3,9,9,0,9,0,9,0,False,False,False,0,3,2021-10-04T09:50:00.693,9,False,0.0
2021,4,3122,40,25,6259,2,50,5,-2,2,4,-1,3,-1,0,False,False,False,0,2,2021-10-05T17:47:51.767,2,False,3.0
2021,4,3122,45,25,7060,2,19,2,35,45,10,45,0,45,6,False,False,False,0,2,2021-10-04T09:59:05.583,45,True,0.0
2021,4,3122,60,12,6691,2,46,3,1,5,4,3,2,3,0,False,False,False,0,3,2021-10-04T10:03:45.683,5,False,2.0
2021,4,3122,80,12,556,2,29,3,14,21,7,21,0,21,0,False,False,False,0,2,2021-10-04T10:11:38.443,21,True,0.0
2021,4,3122,85,12,556,2,26,10,4,7,3,6,1,6,0,False,False,False,0,3,2021-10-04T10:13:04.347,7,False,1.0
2021,4,3122,115,25,7060,13,4,3,4,0,0,0,0,0,0,False,False,False,0,2,2021-10-04T10:23:52.923,0,False,0.0
2021,4,3122,120,25,4583,13,5,3,7,0,0,0,0,0,0,True,False,False,0,3,2021-10-05T17:49:03.27,0,False,0.0
2021,4,3122,135,12,4511,13,32,10,1,0,0,0,0,0,0,False,False,False,0,4,2021-10-04T10:31:07.023,0,False,0.0
2021,4,3122,145,12,496,13,23,7,18,0,0,0,0,0,0,False,False,False,0,3,2021-10-04T10:35:31.807,0,False,0.0
2021,4,3122,150,12,7742,2,46,3,3,16,13,9,7,9,0,False,False,False,0,1,2021-10-08T20:23:41.953,16,False,7.0
2021,4,3122,155,12,556,2,51,10,-2,4,6,4,0,4,0,False,False,False,0,3,2021-10-04T10:38:54.813,4,False,0.0
2021,4,3122,160,12,467,13,9,2,26,0,0,0,0,0,0,True,False,False,0,4,2021-10-05T19:02:19.827,0,False,0.0
2021,4,3122,165,12,496,2,2,4,5,8,3,6,2,6,0,False,False,False,0,3,2021-10-05T18:47:05.607,8,False,2.0
2021,4,3122,170,12,6356,13,5,5,5,0,0,0,0,0,0,False,False,False,0,3,2022-02-16T14:13:37.357,0,False,0.0
2021,4,3122,190,12,496,2,2,4,8,12,4,10,2,10,0,False,False,False,0,3,2021-10-04T10:52:45.593,12,False,2.0
2021,4,3122,220,25,4583,13,6,9,10,0,0,0,0,0,0,False,False,False,0,3,2021-10-04T11:00:34.13,0,False,0.0
2021,4,3122,230,12,4537,2,51,3,-4,6,10,6,0,6,0,True,False,False,0,1,2022-02-16T14:15:37.287,6,False,0.0
2021,4,3122,235,12,4511,2,12,9,3,6,3,3,3,3,0,False,False,False,0,4,2022-02-07T20:24:04.23,6,False,3.0
2021,4,3122,250,12,496,2,6,9,12,23,11,22,1,22,6,False,False,False,0,3,2021-10-04T11:11:14.397,23,False,1.0
2021,4,3122,270,25,7060,2,5,3,5,6,1,6,0,6,0,False,False,False,0,2,2021-10-08T19:16:31.997,6,False,0.0
2021,4,3122,280,25,7060,2,5,3,4,8,4,8,0,8,0,False,False,False,0,2,2021-10-04T11:20:02.51,8,False,0.0
2021,4,3122,285,25,7053,2,4,9,5,10,5,6,4,6,0,False,False,False,0,4,2021-10-04T11:21:46.89,10,False,4.0
2021,4,3122,290,25,609,2,13,9,2,4,2,3,1,3,0,False,False,False,0,4,2021-10-04T11:29:08.9,4,False,1.0
2021,4,3122,295,25,6486,2,5,3,4,17,13,17,0,17,0,False,False,False,1,2,2021-10-05T17:48:14.43,17,False,0.0
2021,4,3122,300,25,4583,13,17,8,24,0,0,0,0,0,0,False,False,False,0,3,2021-10-04T11:33:34.383,0,False,0.0
2021,4,3122,310,25,6486,13,5,5,8,0,0,0,0,0,0,False,False,False,0,3,2021-10-04T11:37:06.943,0,False,0.0
2021,4,3122,330,12,467,2,27,10,1,7,6,5,2,5,0,False,False,False,0,4,2021-10-04T11:41:22.38,7,False,2.0
2021,4,3122,355,12,4511,13,17,8,29,0,0,0,0,0,0,False,False,False,0,3,2021-10-08T20:19:28.993,0,False,0.0
2021,4,3122,365,12,4537,2,2,9,6,19,13,13,6,13,0,False,False,False,0,2,2021-10-04T11:50:14.063,19,False,6.0
2021,4,3122,370,12,556,13,4,3,8,0,0,0,0,0,0,False,False,False,0,2,2021-10-04T11:54:09.873,0,False,0.0
2021,4,3122,375,12,556,2,51,10,0,10,10,8,2,8,0,False,False,False,0,3,2021-10-08T20:21:46.91,10,False,2.0
2021,4,3122,380,12,556,13,4,3,7,0,0,0,0,0,0,False,False,False,0,2,2021-10-04T11:56:04.433,0,False,0.0
2021,4,3122,385,12,4511,13,8,10,13,0,0,0,0,0,0,False,False,False,0,3,2021-10-04T11:57:57.06,0,False,0.0
2021,4,3122,395,12,4537,13,9,3,13,0,0,0,0,0,0,False,False,False,0,2,2021-10-04T11:59:23.003,0,False,0.0
2021,4,3122,440,12,496,2,8,1,20,25,5,25,0,25,0,False,False,False,0,3,2021-10-06T15:59:40.267,25,False,0.0
2021,4,3122,460,12,556,13,13,4,0,0,0,0,0,0,0,False,False,False,0,3,2021-10-08T20:36:21.67,0,False,0.0
2021,4,3122,465,12,4537,2,13,10,3,26,23,20,6,20,0,False,False,False,0,2,2021-10-08T20:24:35.993,26,False,6.0
2021,4,3122,480,12,6691,13,17,9,11,0,0,0,0,0,0,True,False,False,0,2,2021-10-06T16:00:30.427,0,False,0.0
2021,4,3122,495,25,8421,2,18,3,-1,4,5,2,2,2,0,False,False,False,0,2,2021-10-04T12:33:09.74,4,False,2.0
2021,4,3122,500,25,8421,2,44,3,-4,6,10,-1,7,-1,0,False,False,False,1,1,2021-10-05T17:48:28.983,6,False,7.0
2021,4,3122,510,25,4583,13,19,7,25,0,0,0,0,0,0,False,False,False,0,3,2021-10-04T12:38:11.69,0,False,0.0
2021,4,3122,515,25,7081,3,28,9,-1,0,0,0,0,0,0,False,False,False,0,1,2021-10-04T12:39:55.48,0,False,0.0
2021,4,3122,525,12,556,2,18,5,0,11,11,10,1,10,0,False,False,False,1,2,2021-10-06T16:00:46.36,11,False,1.0
2021,4,3122,540,12,496,2,26,5,1,1,0,1,0,1,6,False,False,False,0,2,2021-10-08T20:18:50.22,1,True,0.0
2021,4,3122,565,25,7060,2,5,3,5,12,7,12,0,12,0,False,False,False,1,2,2022-02-16T14:17:58.027,12,True,0.0
2021,4,3122,575,25,7060,13,24,3,14,0,0,0,0,0,0,False,False,False,0,2,2021-10-04T13:09:42.523,0,False,0.0
2021,4,3122,580,25,7060,13,9,2,30,0,0,0,0,0,0,False,False,False,0,2,2021-10-04T13:11:01.987,0,False,0.0
2021,4,3122,590,25,8421,2,47,10,-2,-1,1,-2,1,-2,0,False,False,False,1,1,2021-10-04T13:12:55.633,-1,False,1.0
2021,4,3122,595,12,6691,2,6,9,14,28,14,20,8,20,0,False,False,False,1,3,2021-10-04T14:43:47.753,28,False,8.0
2021,4,3122,605,25,8421,13,28,9,1,0,0,0,0,0,0,False,False,False,0,1,2021-10-04T13:19:59.547,0,False,0.0
2021,4,3122,610,25,8422,2,4,4,9,11,2,10,1,10,0,False,False,False,0,4,2021-10-08T19:16:31.997,11,False,1.0
2021,4,3122,615,25,6486,2,2,5,5,11,6,8,3,8,0,False,False,False,0,2,2021-10-08T19:16:31.997,11,False,3.0
2021,4,3122,625,25,7060,2,2,10,2,5,3,5,0,5,0,False,False,False,0,2,2022-02-16T14:18:39.52,5,False,0.0
2021,4,3122,635,25,7060,2,2,5,2,0,-2,2,-2,2,0,False,False,False,2,2,2021-10-08T20:25:07.863,0,False,-2.0
2021,4,3122,655,12,4511,2,47,5,1,2,1,2,0,2,0,False,False,False,0,4,2021-10-04T13:36:08.03,2,False,0.0
2021,4,3122,660,12,556,13,29,6,17,0,0,0,0,0,0,False,False,False,0,2,2021-10-05T18:55:49.633,0,False,0.0
2021,4,3122,670,25,609,2,13,4,3,4,1,3,1,3,0,True,False,False,0,4,2021-10-08T20:19:57.99,4,False,1.0
2021,4,3122,690,25,6486,2,4,5,4,11,7,7,4,7,0,False,False,False,0,2,2021-10-04T14:39:45.4,11,False,4.0
2021,4,3122,695,25,4583,13,2,10,5,0,0,0,0,0,0,False,False,False,0,3,2021-10-08T19:16:31.997,0,False,0.0
2021,4,3122,700,25,4583,2,13,9,1,2,1,2,0,2,0,False,False,False,0,3,2021-10-08T19:16:31.997,2,False,0.0
2021,4,3122,725,12,4511,13,7,8,24,0,0,0,0,0,0,False,False,False,0,4,2021-10-04T13:56:19.283,0,False,0.0
2021,4,3122,730,12,496,13,17,10,11,0,0,0,0,0,0,False,False,False,0,3,2021-10-04T13:58:29.507,0,False,0.0
2021,4,3122,740,12,496,13,17,9,11,0,0,0,0,0,0,False,False,False,0,3,2022-02-16T14:19:13.833,0,False,0.0
2021,4,3122,745,25,7060,2,4,3,10,10,0,10,0,10,0,False,False,False,0,3,2021-10-08T20:34:26.893,10,False,0.0
2021,4,3122,750,25,8421,2,48,4,-3,7,10,6,1,6,0,False,False,False,1,1,2021-10-04T14:05:06.517,7,False,1.0
2021,4,3122,755,25,8421,2,28,4,1,9,8,8,1,8,0,False,False,False,0,1,2021-10-04T14:06:24.003,9,False,1.0
2021,4,3122,760,25,4583,13,6,5,11,0,0,0,0,0,0,False,False,False,0,3,2021-10-04T14:09:21.36,0,False,0.0
2021,4,3122,765,25,6486,2,8,8,26,30,4,25,5,25,0,False,False,False,0,2,2021-10-04T14:12:57.65,30,False,5.0
2021,4,3122,770,25,7060,2,18,3,1,3,2,2,1,2,0,False,False,False,0,2,2021-10-08T19:16:31.997,3,False,1.0
2021,4,3122,780,25,7060,13,26,3,5,0,0,0,0,0,0,False,False,False,0,2,2021-10-04T14:19:09.933,0,False,
2021,4,3122,820,12,556,2,3,3,11,11,0,11,0,11,0,False,False,False,0,2,2021-10-08T20:35:37.323,11,True,0.0
2021,4,3122,850,25,8421,2,28,10,-7,4,11,3,1,3,0,False,False,False,0,1,2021-10-04T14:33:18.807,4,False,1.0
2021,4,3122,855,25,7060,13,9,6,25,0,0,0,0,0,0,False,False,False,0,2,2021-10-08T20:20:23.187,0,False,0.0
2021,4,3123,10,10,4930,2,2,4,7,11,4,7,4,7,0,True,False,False,0,3,2021-10-05T20:41:33.577,11,False,4.0
2021,4,3123,25,10,6840,13,7,6,19,0,0,0,0,0,0,True,False,False,0,3,2021-10-07T17:15:33.533,0,False,0.0
2021,4,3123,30,10,7703,3,19,2,31,0,0,0,0,0,0,False,False,False,0,2,2022-02-16T14:01:04.973,0,False,0.0
2021,4,3123,65,3,6936,13,8,1,32,0,0,0,0,0,0,False,False,False,0,3,2021-10-04T10:24:46.517,0,False,0.0
2021,4,3123,70,3,121,3,5,3,4,0,0,0,0,0,0,False,False,False,0,2,2021-10-04T10:28:48.51,0,False,0.0
2021,4,3123,80,10,4930,2,4,4,5,19,14,18,1,18,0,False,False,False,1,3,2021-10-05T20:40:30.94,19,False,1.0
2021,4,3123,90,10,6281,13,2,9,11,0,0,0,0,0,0,False,False,False,0,3,2022-02-16T14:02:02.797,0,False,0.0
2021,4,3123,95,10,6840,13,29,3,10,0,0,0,0,0,0,False,False,False,0,3,2021-10-04T10:42:39.94,0,False,0.0
2021,4,3123,105,3,121,2,2,1,16,20,4,19,1,19,0,False,False,False,0,2,2021-10-04T17:28:22.22,20,False,1.0
2021,4,3123,110,3,6936,2,46,3,-1,6,7,5,1,5,0,True,False,False,0,3,2021-10-07T21:28:01.123,6,False,1.0
2021,4,3123,145,10,4930,13,19,6,27,0,0,0,0,0,0,False,False,False,0,2,2021-10-04T11:04:39.2,0,False,0.0
2021,4,3123,155,10,282,2,46,9,1,3,2,2,1,2,0,False,False,False,1,1,2021-10-07T21:13:50.993,3,False,1.0
2021,4,3123,170,3,34,13,44,9,-3,0,0,0,0,0,0,False,False,False,0,1,2021-10-06T00:25:38.667,0,False,0.0
2021,4,3123,175,3,7672,13,4,10,7,0,0,0,0,0,0,False,False,False,0,3,2021-10-07T21:28:01.123,0,False,0.0
2021,4,3123,215,10,6840,2,5,3,3,3,0,3,0,3,6,True,False,False,0,4,2021-10-05T20:42:01.187,3,True,0.0
2021,4,3123,235,3,7673,2,39,4,7,12,5,12,0,12,0,False,False,False,0,3,2021-10-04T11:38:22.267,12,False,0.0
2021,4,3123,245,3,6816,13,35,7,19,0,0,0,0,0,0,False,False,False,0,4,2021-10-07T21:28:01.123,0,False,0.0
2021,4,3123,255,3,6454,2,35,6,20,24,4,20,4,20,0,False,False,False,0,3,2021-10-04T11:54:16.66,24,False,4.0
2021,4,3123,260,3,6454,2,5,5,12,12,0,12,0,12,0,False,False,False,0,3,2021-10-07T21:28:01.123,12,False,0.0
2021,4,3123,280,10,282,13,6,3,5,0,0,0,0,0,0,True,False,False,0,2,2021-10-07T21:15:10.113,0,False,0.0
2021,4,3123,300,3,121,2,13,4,4,9,5,8,1,8,0,False,False,False,0,2,2021-10-07T21:28:01.123,9,False,1.0
2021,4,3123,310,3,121,13,4,3,12,0,0,0,0,0,0,False,False,False,0,2,2022-02-18T17:12:57.54,0,False,0.0
2021,4,3123,315,3,6936,2,8,7,49,49,0,49,0,49,6,False,False,False,0,3,2021-11-02T13:53:05.6,49,True,0.0
2021,4,3123,330,10,6281,2,2,10,8,12,4,11,1,11,0,False,False,False,0,2,2021-10-04T17:42:23.753,12,False,1.0
2021,4,3123,335,10,6840,2,2,4,7,14,7,12,2,12,0,False,False,False,0,4,2021-10-04T12:24:17.627,14,False,2.0
2021,4,3123,350,10,6281,2,50,5,-2,3,5,2,1,2,0,False,False,False,0,2,2021-10-04T12:32:07.277,3,False,1.0
2021,4,3123,360,3,6936,2,8,1,20,32,12,30,2,30,0,False,False,False,0,2,2022-02-07T20:26:42.333,32,False,2.0
2021,4,3123,370,3,7672,2,3,3,7,7,0,7,0,7,0,True,False,False,0,3,2021-10-07T21:28:01.123,7,False,0.0
2021,4,3123,395,10,282,13,48,4,-4,0,0,0,0,0,0,False,False,False,0,1,2021-10-07T21:44:18.867,0,False,0.0
2021,4,3123,400,10,7082,3,13,5,1,0,0,0,0,0,0,False,False,False,0,3,2021-10-07T21:44:31.38,0,False,0.0
2021,4,3123,405,10,7938,13,6,1,16,0,0,0,0,0,0,True,False,False,0,3,2021-10-04T13:24:07.183,0,False,0.0
2021,4,3123,420,3,6454,2,35,9,11,13,2,13,0,13,0,False,False,False,0,3,2021-10-07T20:06:25.177,13,False,0.0
2021,4,3123,430,3,6454,13,26,10,6,0,0,0,0,0,0,False,False,False,0,3,2021-10-07T17:54:14.513,0,False,0.0
2021,4,3123,435,3,6454,13,4,10,3,0,0,0,0,0,0,False,False,False,0,3,2021-10-04T13:16:58.863,0,False,0.0
2021,4,3123,485,3,121,13,12,2,42,0,0,0,0,0,0,False,False,False,0,3,2021-10-07T21:17:13.363,0,False,0.0
2021,4,3123,505,10,6840,2,2,9,4,11,7,8,3,8,0,False,False,False,0,3,2021-10-04T13:45:28.177,11,False,3.0
2021,4,3123,510,10,6840,13,32,5,-1,0,0,0,0,0,0,False,False,False,0,4,2021-10-07T20:07:07.297,0,False,0.0
2021,4,3123,515,10,7703,2,6,4,8,11,3,9,2,9,0,False,False,False,0,4,2021-10-04T17:20:49.723,11,False,2.0
2021,4,3123,525,10,282,2,48,10,-5,8,13,4,4,4,0,False,False,False,1,1,2021-10-04T13:56:21.93,8,False,4.0
2021,4,3123,530,10,6840,13,12,5,3,0,0,0,0,0,0,False,False,False,0,4,2022-02-16T14:07:33.373,0,False,0.0
2021,4,3123,540,3,6454,2,4,4,13,14,1,14,0,14,0,False,False,False,0,2,2021-10-07T20:07:38.47,14,False,0.0
2021,4,3123,545,3,6936,2,47,5,-2,4,6,3,1,3,0,True,False,False,0,3,2021-10-07T21:28:01.123,4,False,1.0
2021,4,3123,550,3,7673,13,12,5,12,0,0,0,0,0,0,False,False,False,0,3,2021-10-04T14:25:04.307,0,False,0.0
2021,4,3123,570,10,6281,13,23,8,38,0,0,0,0,0,0,False,False,False,0,2,2021-10-04T17:20:34.483,0,False,0.0
2021,4,3123,585,10,4930,13,5,3,3,0,0,0,0,0,0,True,False,False,0,3,2021-10-04T17:19:24.72,0,False,0.0
2021,4,3123,590,10,6840,2,53,10,-7,3,10,3,0,3,0,False,False,False,0,4,2021-10-04T17:19:51.137,3,False,0.0
2021,4,3123,595,10,8541,2,38,10,4,5,1,5,0,5,0,False,False,False,0,1,2021-10-04T17:19:37.46,5,False,0.0
2021,4,3123,610,3,7672,13,19,7,40,0,0,0,0,0,0,False,False,False,0,2,2021-10-07T21:18:08.233,0,False,0.0
2021,4,3123,615,3,7673,2,47,5,5,8,3,6,2,6,0,False,False,False,0,3,2021-10-04T14:59:10.083,8,False,2.0
2021,4,3123,620,3,121,2,26,3,13,13,0,13,0,13,0,False,False,False,0,2,2021-10-04T15:01:40.827,13,False,0.0
2021,4,3123,635,3,7672,2,2,9,5,7,2,6,1,6,0,False,False,False,0,2,2021-10-04T15:13:13.827,7,False,1.0
2021,4,3123,640,3,7673,2,4,10,4,8,4,5,3,5,0,False,False,False,0,2,2021-10-04T15:13:03.18,8,False,3.0
2021,4,3123,655,3,6454,2,7,2,30,30,0,30,0,30,6,False,False,False,0,3,2022-02-18T17:19:29.517,30,True,
2021,4,3123,665,3,6454,13,2,4,8,0,0,0,0,0,0,False,False,False,0,3,2021-10-04T15:23:29.287,0,False,0.0
2021,4,3123,670,3,7672,2,4,4,4,17,13,17,0,17,0,False,False,False,0,3,2021-10-04T15:25:43.73,17,False,0.0
2021,4,3123,690,10,6840,2,5,5,4,6,2,6,0,6,0,False,False,False,0,4,2021-10-04T17:18:42.257,6,False,0.0
2021,4,3123,695,10,6281,13,7,6,25,0,0,0,0,0,0,False,False,False,0,2,2022-02-25T15:06:40.72,0,False,0.0
2021,4,3123,725,10,7938,2,39,10,5,13,8,10,3,10,0,False,False,False,0,3,2021-10-04T17:18:08.753,13,False,3.0
2021,4,3123,730,10,4930,13,19,2,22,0,0,0,0,0,0,False,False,False,0,2,2022-02-18T17:19:03.83,0,False,0.0
2021,4,3123,735,10,8541,2,44,9,-3,-3,0,-3,0,-3,0,True,False,False,0,1,2021-10-07T21:18:21.44,-3,False,0.0
2021,4,3123,740,10,7938,2,12,2,22,22,0,22,0,22,0,False,False,False,0,3,2022-02-18T17:17:20.01,22,False,
2021,4,3123,745,10,6281,13,8,7,43,0,0,0,0,0,0,False,False,False,0,3,2021-10-07T21:28:01.123,0,False,0.0
2021,4,3123,760,3,5017,2,31,9,4,4,0,4,0,4,0,False,False,False,0,4,2021-10-07T20:09:19.523,4,False,0.0
2021,4,3123,765,3,121,2,5,3,4,7,3,2,5,2,0,False,False,False,1,2,2021-10-07T18:53:16.66,7,False,5.0
2021,4,3123,775,3,7673,2,4,9,6,14,8,13,1,13,0,False,False,False,0,2,2021-10-07T20:09:35.26,14,False,1.0
2021,4,3123,785,3,7673,2,13,3,9,32,23,32,0,32,0,False,False,False,0,3,2021-10-04T16:33:41.547,32,False,0.0
2021,4,3123,800,3,6454,2,5,5,3,4,1,3,1,3,0,False,False,False,0,3,2022-02-16T14:10:13.467,4,False,1.0
2021,4,3123,815,3,7672,13,2,4,6,0,0,0,0,0,0,False,False,False,0,3,2021-10-07T21:28:01.123,0,False,0.0
2021,4,3123,850,10,4930,2,4,5,8,9,1,8,1,8,0,False,False,False,0,2,2021-10-04T17:16:33.81,9,False,1.0
2021,4,3123,860,10,6840,2,31,4,-1,9,10,7,2,7,0,False,False,False,0,4,2022-02-18T17:15:26.46,9,False,2.0
2021,4,3123,870,10,6281,2,29,6,26,32,6,26,6,26,0,False,False,False,0,2,2021-10-07T21:18:42.327,32,False,6.0
2021,4,3123,880,10,8541,2,6,10,5,9,4,4,5,4,0,True,False,False,0,2,2021-10-07T21:18:51.547,9,False,5.0
2021,4,3123,890,10,7938,13,2,4,5,0,0,0,0,0,0,False,False,False,0,3,2021-10-07T18:01:25.197,0,False,0.0
2021,4,3123,895,10,6281,13,9,3,6,0,0,0,0,0,0,False,False,False,0,2,2021-10-07T21:19:06.12,0,False,0.0
2021,4,3124,10,19,4282,2,4,10,7,7,0,7,0,7,0,False,False,False,0,3,2021-10-04T10:23:04.52,7,False,0.0
2021,4,3124,15,19,4912,2,5,5,4,4,0,4,0,4,0,False,False,False,0,3,2021-10-04T10:24:19.313,4,False,0.0
2021,4,3124,20,19,4282,2,32,10,3,5,2,4,1,4,0,True,False,False,0,4,2021-10-04T10:26:19.543,5,False,1.0
2021,4,3124,30,19,2256,13,6,10,9,0,0,0,0,0,0,False,False,False,0,2,2021-10-08T19:50:32.427,0,False,0.0
2021,4,3124,40,30,793,13,8,10,14,0,0,0,0,0,0,False,False,False,0,3,2021-10-04T10:32:52.703,0,False,0.0
2021,4,3124,45,30,793,2,4,5,8,8,0,8,0,8,0,False,False,False,0,2,2021-10-04T10:34:04.11,8,False,0.0
2021,4,3124,60,30,37,2,18,10,-2,6,8,5,1,5,0,False,False,False,0,2,2021-10-04T10:39:39.057,6,False,1.0
2021,4,3124,65,30,2290,13,35,2,20,0,0,0,0,0,0,False,False,False,0,4,2021-10-04T10:41:19.403,0,False,0.0
2021,4,3124,80,19,7175,13,4,4,5,0,0,0,0,0,0,True,False,False,0,3,2021-10-04T10:48:11.907,0,False,0.0
2021,4,3124,85,19,1212,2,31,4,3,7,4,6,1,6,0,False,False,False,1,1,2021-10-04T10:50:19.48,7,False,1.0
2021,4,3124,100,30,793,13,4,7,19,0,0,0,0,0,0,False,False,False,0,3,2022-02-16T15:08:52.14,0,False,0.0
2021,4,3124,105,30,4937,2,50,9,-1,13,14,8,5,8,0,True,False,False,0,2,2021-10-05T16:39:27.9,13,False,5.0
2021,4,3124,115,30,793,2,2,4,9,13,4,13,0,13,0,False,False,False,0,3,2021-10-04T10:59:45.333,13,False,0.0
2021,4,3124,120,30,793,2,35,8,17,28,11,24,4,24,0,False,False,False,0,2,2021-10-04T11:07:08.567,28,False,4.0
2021,4,3124,130,30,37,2,49,9,-2,3,5,1,2,1,0,False,False,False,0,2,2021-10-08T21:29:43.53,3,False,2.0
2021,4,3124,135,30,7454,13,17,9,11,0,0,0,0,0,0,False,False,False,0,4,2021-10-05T16:39:14.357,0,False,0.0
2021,4,3124,140,30,2290,13,7,3,11,0,0,0,0,0,0,False,False,False,0,3,2021-10-08T19:50:32.427,0,False,0.0
2021,4,3124,155,19,4912,2,39,4,7,17,10,13,4,13,0,True,False,False,0,3,2021-10-04T11:14:44.02,17,False,4.0
2021,4,3124,165,19,4282,13,4,10,7,0,0,0,0,0,0,False,False,False,0,4,2021-10-04T11:18:24.037,0,False,0.0
2021,4,3124,170,19,2256,13,17,1,24,0,0,0,0,0,0,False,False,False,0,3,2021-10-08T21:30:53.24,0,False,0.0
2021,4,3124,180,30,7893,13,17,2,27,0,0,0,0,0,0,False,False,False,0,4,2022-02-16T15:09:29.573,0,False,0.0
2021,4,3124,195,30,793,2,4,5,4,6,2,5,1,5,0,False,False,False,0,2,2021-10-04T11:28:26.453,6,False,1.0
2021,4,3124,200,30,793,2,50,5,-1,0,1,-3,3,-3,0,False,False,False,0,2,2022-02-16T15:09:51.477,0,False,3.0
2021,4,3124,205,30,37,2,24,6,25,27,2,27,0,27,0,False,False,False,0,4,2021-10-04T11:31:49.81,27,False,0.0
2021,4,3124,225,30,793,3,2,9,8,0,0,0,0,0,0,False,False,False,0,2,2021-10-04T11:36:24.763,0,False,0.0
2021,4,3124,230,30,4937,3,46,9,2,0,0,0,0,0,0,False,False,False,0,1,2021-10-04T11:38:57.107,0,False,0.0
2021,4,3124,245,19,5096,2,53,10,-3,1,4,-2,3,-2,0,True,False,False,0,4,2021-10-04T11:45:12.74,1,False,3.0
2021,4,3124,250,19,4912,2,6,1,16,16,0,16,0,16,0,False,False,False,0,2,2021-10-08T21:31:58.047,16,False,0.0
2021,4,3124,255,19,7175,2,2,10,5,15,10,15,0,15,0,True,False,False,0,2,2021-10-04T11:48:19.17,15,False,0.0
2021,4,3124,260,19,7175,13,6,10,5,0,0,0,0,0,0,False,False,False,0,3,2022-02-18T18:47:22.363,0,False,0.0
2021,4,3124,265,19,4912,2,13,10,3,5,2,4,1,4,0,True,False,False,0,2,2021-10-04T11:52:00.493,5,False,1.0
2021,4,3124,270,19,7173,13,4,5,9,0,0,0,0,0,0,False,False,False,0,2,2021-10-04T11:54:00.023,0,False,
2021,4,3124,285,19,4912,2,6,8,15,16,1,16,0,16,0,False,False,False,0,2,2021-10-04T12:00:35.38,16,False,0.0
2021,4,3124,290,19,1212,2,30,9,-4,7,11,6,1,6,0,True,False,False,0,1,2021-10-04T12:03:13.337,7,False,1.0
2021,4,3124,300,19,2256,13,2,4,10,0,0,0,0,0,0,False,False,False,0,2,2021-10-04T12:05:57.38,0,False,
2021,4,3124,305,19,7175,2,39,4,3,3,0,3,0,3,0,True,False,False,0,3,2021-10-04T12:08:21.483,3,False,0.0
2021,4,3124,310,19,4282,2,35,9,10,11,1,10,1,10,6,False,False,False,1,4,2021-10-04T12:09:46.53,11,False,1.0
2021,4,3124,335,30,37,2,4,3,5,8,3,7,1,7,0,False,False,False,0,2,2021-10-04T12:14:17.903,8,False,1.0
2021,4,3124,350,30,2290,13,12,2,17,0,0,0,0,0,0,False,False,False,0,4,2022-02-07T20:27:58.287,0,False,0.0
2021,4,3124,355,30,4516,2,50,9,-3,1,4,-2,3,-2,0,True,False,False,0,2,2022-02-25T17:15:09.353,1,False,3.0
2021,4,3124,365,19,7175,2,4,10,3,4,1,3,1,3,0,True,False,False,0,3,2021-10-04T12:23:16.283,4,False,1.0
2021,4,3124,370,19,7175,2,5,9,4,12,8,9,3,9,0,False,False,False,0,3,2021-10-04T12:24:38.777,12,False,3.0
2021,4,3124,385,19,1212,2,51,9,-9,15,24,12,3,12,0,False,False,False,1,1,2021-10-04T12:32:58.643,15,False,3.0
2021,4,3124,405,30,37,2,4,3,5,4,-1,4,0,4,0,False,False,False,0,2,2021-10-04T12:37:13.687,4,False,0.0
2021,4,3124,410,30,4516,2,12,2,21,28,7,28,0,28,0,False,False,False,0,2,2022-02-07T20:28:13.54,28,False,0.0
2021,4,3124,420,30,4516,2,19,6,21,26,5,23,3,23,0,False,False,False,0,3,2021-10-04T12:40:16.793,26,False,3.0
2021,4,3124,425,30,2290,2,5,10,9,11,2,11,0,11,0,False,False,False,0,3,2021-10-04T12:41:20.59,11,False,0.0
2021,4,3124,430,30,4516,13,19,6,16,0,0,0,0,0,0,False,False,False,0,3,2021-10-04T12:43:00.207,0,False,0.0
2021,4,3124,435,30,37,13,4,5,7,0,0,0,0,0,0,False,False,False,0,2,2021-10-04T12:44:10.817,0,False,0.0
2021,4,3124,440,30,37,13,4,5,6,0,0,0,0,0,0,False,False,False,0,2,2021-10-04T12:45:14.723,0,False,0.0
2021,4,3124,480,30,2290,3,17,10,8,0,0,0,0,0,0,True,False,False,0,3,2021-10-04T12:58:27.507,0,False,0.0
2021,4,3124,485,30,37,2,19,2,36,44,8,40,4,40,0,False,False,False,0,3,2021-10-08T21:45:14.993,44,False,
2021,4,3124,500,19,7172,2,31,4,5,9,4,6,3,6,0,False,False,False,0,1,2021-10-04T13:01:55.55,9,False,3.0
2021,4,3124,510,19,8001,2,45,5,-3,0,3,0,0,0,0,False,True,True,0,1,2021-10-04T13:04:47.377,0,False,0.0
2021,4,3124,525,30,4523,13,5,9,5,0,0,0,0,0,0,False,False,False,0,4,2021-10-04T13:12:45.78,0,False,0.0
2021,4,3124,560,30,4937,2,48,10,-2,11,13,10,1,10,0,False,False,False,1,1,2022-02-16T15:11:59.267,11,False,1.0
2021,4,3124,585,30,793,2,5,5,7,9,2,9,0,9,0,False,False,False,0,2,2021-10-04T13:31:08.91,9,False,0.0
2021,4,3124,610,19,7172,2,4,10,1,21,20,3,18,3,0,False,False,False,2,1,2021-10-04T15:27:54.08,21,False,18.0
2021,4,3124,615,19,2256,2,4,3,9,13,4,11,2,11,0,False,False,False,0,2,2021-10-04T13:39:12.877,13,False,2.0
2021,4,3124,620,19,7175,2,4,9,4,5,1,5,0,5,0,False,False,False,0,3,2021-10-04T13:41:47.23,5,False,0.0
2021,4,3124,625,19,7173,2,4,3,10,10,0,10,0,10,0,False,False,False,0,2,2021-10-04T13:43:39.513,10,False,0.0
2021,4,3124,630,19,5096,2,30,9,-5,12,17,12,0,12,0,True,False,False,0,1,2021-10-08T21:46:31.507,12,False,0.0
2021,4,3124,635,19,1212,2,48,9,-2,15,17,11,4,11,0,False,False,False,0,1,2021-10-04T13:46:32.187,15,False,4.0
2021,4,3124,645,19,5096,2,17,4,1,1,0,1,0,1,6,False,False,False,0,4,2021-10-04T13:50:12.413,1,True,0.0
2021,4,3124,670,30,37,2,5,3,6,7,1,7,0,7,0,False,False,False,0,2,2021-10-04T13:57:14.19,7,False,0.0
2021,4,3124,680,30,793,13,8,9,14,0,0,0,0,0,0,False,False,False,0,2,2021-10-04T14:00:07.753,0,False,0.0
2021,4,3124,700,30,4937,2,48,10,-2,23,25,0,23,0,0,False,False,False,1,1,2021-10-04T14:07:03.637,23,False,23.0
2021,4,3124,710,30,793,13,9,6,16,0,0,0,0,0,0,False,False,False,0,2,2022-02-25T15:09:56.853,0,False,0.0
2021,4,3124,715,30,2290,2,2,9,11,18,7,15,3,15,0,False,False,False,0,3,2021-10-04T14:14:25.96,18,False,3.0
2021,4,3124,725,30,4937,3,45,10,-6,0,0,0,0,0,0,False,False,False,0,1,2022-02-16T15:14:11.993,0,False,0.0
2021,4,3124,730,30,7893,13,12,5,8,0,0,0,0,0,0,False,False,False,0,2,2021-10-04T14:18:30.19,0,False,0.0
2021,4,3124,745,19,2256,2,4,3,10,12,2,10,2,10,0,False,False,False,0,2,2021-10-08T21:32:15.047,12,False,2.0
2021,4,3124,750,19,7175,2,4,10,3,3,0,3,0,3,0,True,False,False,0,3,2021-10-08T21:30:16.097,3,False,0.0
2021,4,3124,755,19,7175,2,29,5,14,21,7,17,4,17,0,False,False,False,0,3,2021-10-08T19:50:32.427,21,False,4.0
2021,4,3124,760,19,2256,2,11,2,17,30,13,30,0,30,0,True,False,False,0,2,2021-10-04T14:29:39.377,30,False,0.0
2021,4,3124,765,19,5096,13,35,3,9,0,0,0,0,0,0,False,False,False,0,4,2021-10-04T14:31:38.547,0,False,0.0
2021,4,3124,770,19,5096,13,31,10,3,0,0,0,0,0,0,False,False,False,0,4,2021-10-04T14:33:19.383,0,False,0.0
2021,4,3124,775,19,1212,2,48,10,-2,0,2,-2,2,-2,0,False,False,False,2,1,2021-10-04T14:35:58.017,0,False,2.0
2021,4,3124,790,30,4937,13,19,2,32,0,0,0,0,0,0,True,False,False,0,2,2021-10-05T16:39:39.853,0,False,
2021,4,3124,800,30,793,2,4,3,4,4,0,4,0,4,0,False,False,False,0,2,2021-10-04T14:53:43.173,4,False,
2021,4,3124,805,30,793,2,35,5,10,11,1,11,0,11,0,False,False,False,0,3,2021-10-04T14:58:22.043,11,False,0.0
2021,4,3124,810,30,37,2,5,3,8,8,0,8,0,8,0,False,False,False,0,3,2021-10-04T15:00:06.927,8,False,0.0
2021,4,3124,825,30,37,13,19,2,30,0,0,0,0,0,0,False,False,False,0,2,2021-10-04T15:02:52.377,0,False,0.0
2021,4,3124,835,30,37,3,19,2,30,0,0,0,0,0,0,False,False,False,0,2,2021-10-04T15:04:13.647,0,False,0.0
2021,4,3124,855,19,4282,13,17,8,20,0,0,0,0,0,0,False,False,False,0,4,2021-10-04T15:10:41.847,0,False,
2021,4,3124,860,19,4282,2,4,10,5,9,4,7,2,7,0,True,False,False,0,4,2021-10-04T15:12:47.82,9,False,2.0
2021,4,3124,870,19,1212,2,45,5,-3,7,10,7,0,7,0,False,False,False,0,1,2021-10-04T15:14:56.857,7,True,0.0
2021,4,3124,875,19,7175,13,5,3,11,0,0,0,0,0,0,False,False,False,0,3,2021-10-08T21:30:25.44,0,False,0.0
2021,4,3124,880,19,7175,2,5,5,7,7,0,7,0,7,0,False,False,False,0,3,2021-10-08T21:30:33.67,7,True,0.0
2021,4,3124,885,19,7175,13,2,10,3,0,0,0,0,0,0,True,False,False,0,3,2021-10-04T15:19:28.83,0,False,0.0
2021,4,3125,25,26,309,2,4,9,5,5,0,5,0,5,0,False,False,False,0,4,2021-10-05T12:21:14.097,5,False,0.0
2021,4,3125,40,26,309,2,5,5,4,4,0,4,0,4,0,False,False,False,0,3,2021-10-05T12:26:33.487,4,False,0.0
2021,4,3125,50,26,958,2,36,7,19,22,3,21,1,21,0,False,False,False,0,4,2021-10-05T18:34:11.927,22,False,1.0
2021,4,3125,65,26,6301,2,47,5,0,7,7,6,1,6,0,False,False,False,0,1,2021-10-05T12:44:39.9,7,False,1.0
2021,4,3125,75,26,6301,2,44,3,0,7,7,6,1,6,0,False,False,False,0,1,2021-10-09T02:05:01.773,7,False,1.0
2021,4,3125,90,26,7491,2,35,4,4,4,0,4,0,4,6,False,False,False,0,4,2021-10-05T12:53:39.56,4,True,0.0
2021,4,3125,115,23,7250,3,26,9,4,0,0,0,0,0,0,False,False,False,0,3,2021-10-05T12:58:47.66,0,False,0.0
2021,4,3125,135,26,309,13,5,9,5,0,0,0,0,0,0,False,False,False,0,3,2021-10-09T02:09:27.59,0,False,0.0
2021,4,3125,150,23,7250,13,6,4,13,0,0,0,0,0,0,False,False,False,0,3,2021-10-05T13:08:43.46,0,False,0.0
2021,4,3125,155,23,7688,2,47,5,3,4,1,4,0,4,0,True,False,False,0,4,2021-10-05T13:11:47.283,4,False,0.0
2021,4,3125,185,26,7453,13,29,2,15,0,0,0,0,0,0,False,False,False,0,2,2021-10-08T23:47:26.14,0,False,0.0
2021,4,3125,190,26,6301,2,32,9,-1,3,4,3,0,3,0,False,False,False,0,1,2021-10-05T13:21:38.793,3,False,0.0
2021,4,3125,195,26,7440,13,4,3,10,0,0,0,0,0,0,False,False,False,0,2,2021-10-05T13:24:09.95,0,False,0.0
2021,4,3125,210,23,7241,2,48,10,-2,3,5,2,1,2,0,False,False,False,0,1,2021-10-06T14:36:42.247,3,False,1.0
2021,4,3125,215,23,7250,2,46,3,3,12,9,10,2,10,0,False,False,False,0,3,2021-10-06T14:36:52.693,12,False,2.0
2021,4,3125,240,26,4619,13,19,2,26,0,0,0,0,0,0,False,False,False,0,2,2021-10-05T18:42:33.38,0,False,0.0
2021,4,3125,265,23,7241,2,32,10,-5,0,5,-1,1,-1,0,False,False,False,0,1,2021-10-05T13:49:42.303,0,False,1.0
2021,4,3125,270,26,4616,2,5,3,1,5,4,3,2,3,0,False,False,False,0,1,2021-10-05T18:42:53.023,5,False,2.0
2021,4,3125,285,26,309,2,13,9,4,5,1,4,1,4,0,False,False,False,0,3,2021-10-05T18:43:10.607,5,False,1.0
2021,4,3125,295,23,7688,2,5,3,5,5,0,5,0,5,0,False,False,False,0,3,2021-10-05T14:01:18.42,5,False,0.0
2021,4,3125,300,23,7688,13,6,6,21,0,0,0,0,0,0,False,False,False,0,3,2022-02-18T18:02:48.427,0,False,0.0
2021,4,3125,305,23,2994,2,5,6,16,21,5,20,1,20,0,False,False,False,0,3,2022-02-18T18:01:59.283,21,False,1.0
2021,4,3125,310,23,2994,13,5,3,4,0,0,0,0,0,0,False,False,False,0,3,2022-02-16T14:21:51.697,0,False,0.0
2021,4,3125,320,23,7250,2,6,10,4,7,3,6,1,6,0,False,False,False,0,3,2021-10-06T14:37:25.58,7,False,1.0
2021,4,3125,330,26,4619,2,4,3,11,11,0,11,0,11,0,False,False,False,0,2,2021-10-05T14:19:59.223,11,False,0.0
2021,4,3125,345,26,4050,2,11,3,11,34,23,33,1,33,0,False,False,False,0,1,2021-10-09T02:14:04.677,34,False,1.0
2021,4,3125,355,26,6301,2,45,5,-5,0,5,0,0,0,0,False,False,False,0,1,2021-10-05T14:36:14.38,0,False,0.0
2021,4,3125,360,26,958,2,17,10,10,10,0,10,0,10,6,False,False,False,0,3,2021-10-09T01:38:39.36,10,True,0.0
2021,4,3125,395,26,309,2,51,3,-1,2,3,2,0,2,0,False,False,False,0,3,2021-10-05T14:53:41.037,2,False,0.0
2021,4,3125,400,26,4616,2,4,9,4,9,5,7,2,7,0,False,False,False,0,1,2021-10-05T14:55:57.297,9,False,2.0
2021,4,3125,415,26,4616,13,6,10,3,0,0,0,0,0,0,False,False,False,0,1,2021-10-09T01:40:00.547,0,False,0.0
2021,4,3125,420,26,958,2,47,5,4,4,0,4,0,4,0,False,False,False,0,3,2021-10-05T15:03:30.333,4,False,0.0
2021,4,3125,425,26,309,2,2,10,5,7,2,5,2,5,0,False,False,False,0,2,2021-10-05T15:05:15.77,7,False,2.0
2021,4,3125,430,26,7491,2,32,5,2,13,11,10,3,10,0,False,False,False,1,4,2021-10-05T18:36:11.48,13,False,3.0
2021,4,3125,435,26,7453,2,3,5,9,9,0,9,0,9,0,False,False,False,0,2,2021-10-05T15:09:59.047,9,False,0.0
2021,4,3125,445,26,4616,2,11,5,12,14,2,14,0,14,6,False,False,False,0,1,2021-10-05T15:12:41.903,14,True,0.0
2021,4,3125,460,23,7689,13,50,3,0,0,0,0,0,0,0,False,False,False,0,2,2021-10-05T15:15:55.077,0,False,0.0
2021,4,3125,485,23,7241,2,47,5,0,0,0,0,0,0,0,False,False,False,0,1,2021-10-05T15:23:01.247,0,False,0.0
2021,4,3125,490,23,2688,2,12,7,15,15,0,15,0,15,0,False,False,False,0,3,2021-10-09T01:40:47.1,15,False,0.0
2021,4,3125,505,23,2994,2,12,5,6,8,2,8,0,8,0,False,False,False,0,4,2022-02-07T20:29:17.15,8,True,0.0
2021,4,3125,520,23,7250,2,5,5,3,8,5,4,4,4,0,False,False,False,0,3,2021-10-09T01:50:00.067,8,False,4.0
2021,4,3125,535,23,7241,2,46,3,1,5,4,4,1,4,0,False,False,False,0,1,2021-10-05T15:41:45.843,5,False,1.0
2021,4,3125,540,23,7250,2,16,10,10,10,0,10,0,10,6,True,False,False,0,3,2021-10-05T15:44:45.3,10,True,0.0
2021,4,3125,565,26,309,13,35,8,27,0,0,0,0,0,0,False,False,False,0,3,2021-10-05T15:53:26.517,0,False,0.0
2021,4,3125,580,26,958,2,46,9,1,6,5,4,2,4,0,False,False,False,0,4,2021-10-05T15:58:28.38,6,False,2.0
2021,4,3125,585,26,7491,13,13,3,4,0,0,0,0,0,0,False,False,False,0,4,2022-02-16T14:25:12.457,0,False,0.0
2021,4,3125,590,26,4619,13,2,10,6,0,0,0,0,0,0,False,False,False,0,2,2021-10-05T16:03:14.853,0,False,0.0
2021,4,3125,605,23,7241,2,18,3,-1,9,10,0,9,0,0,False,False,False,1,2,2021-10-05T16:09:11.997,9,False,9.0
2021,4,3125,610,23,7688,13,19,2,47,0,0,0,0,0,0,False,False,False,0,2,2021-10-05T16:13:29.247,0,False,
2021,4,3125,620,23,2994,2,35,8,16,18,2,18,0,18,0,False,False,False,0,4,2021-10-08T23:47:26.17,18,False,0.0
2021,4,3125,635,23,2994,2,5,3,3,3,0,3,0,3,6,False,False,False,0,3,2021-10-09T02:17:27.73,3,True,0.0
2021,4,3125,650,26,309,2,4,3,5,9,4,8,1,8,0,False,False,False,0,3,2021-10-05T18:44:59.96,9,False,1.0
2021,4,3125,660,26,309,13,3,2,49,0,0,0,0,0,0,False,False,False,0,3,2022-02-16T14:25:45.273,0,False,0.0
2021,4,3125,665,26,958,2,46,3,4,15,11,9,6,9,0,False,False,False,0,4,2021-10-05T16:39:58.973,15,False,6.0
2021,4,3125,690,26,4619,13,19,2,37,0,0,0,0,0,0,False,False,False,0,2,2021-10-05T18:41:16.047,0,False,0.0
2021,4,3125,695,26,4616,13,47,5,1,0,0,0,0,0,0,False,False,False,0,1,2021-10-05T16:50:38.65,0,False,0.0
2021,4,3125,700,26,958,13,35,10,14,0,0,0,0,0,0,False,False,False,0,3,2021-10-09T01:42:39.677,0,False,0.0
2021,4,3125,710,23,7688,2,8,6,49,51,2,49,2,49,0,False,False,False,0,3,2022-02-16T14:26:26.467,51,False,2.0
2021,4,3125,715,23,4949,2,51,10,-5,5,10,5,0,5,0,True,False,False,0,2,2021-10-05T16:58:53.977,5,False,0.0
2021,4,3125,750,26,309,3,4,9,2,0,0,0,0,0,0,False,False,False,0,3,2021-10-05T17:10:12.887,0,False,0.0
2021,4,3125,755,26,958,2,11,3,10,13,3,10,3,10,0,False,False,False,0,3,2021-10-05T17:12:38.417,13,False,3.0
2021,4,3125,760,26,309,2,4,10,3,4,1,4,0,4,0,False,False,False,0,3,2021-10-09T01:44:58.523,4,False,0.0
2021,4,3125,800,23,7250,2,26,9,4,5,1,4,1,4,0,False,False,False,0,3,2021-10-06T14:37:51.453,5,False,1.0
2021,4,3125,805,23,7689,13,4,3,3,0,0,0,0,0,0,False,False,False,0,2,2021-10-06T14:38:01.663,0,False,0.0
2021,4,3125,810,23,7689,2,6,10,4,4,0,4,0,4,0,False,False,False,0,2,2021-10-08T23:47:26.17,4,False,0.0
2021,4,3125,815,23,7250,2,32,10,1,3,2,3,0,3,0,False,False,False,0,4,2022-02-16T14:28:23.6,3,False,0.0
2021,4,3125,820,23,7688,13,8,2,49,0,0,0,0,0,0,False,False,False,0,3,2021-10-05T17:42:17.423,0,False,0.0
2021,4,3125,830,23,2994,13,7,6,18,0,0,0,0,0,0,False,False,False,0,3,2021-10-09T02:19:10.423,0,False,0.0
2021,4,3125,880,23,2994,13,32,5,6,0,0,0,0,0,0,False,False,False,0,4,2021-10-05T18:00:25.75,0,False,0.0
2021,4,3125,890,23,7689,13,21,6,35,0,0,0,0,0,0,False,False,False,0,2,2021-10-08T23:47:26.17,0,False,0.0
2021,4,3125,895,23,7688,13,3,5,12,0,0,0,0,0,0,False,False,False,0,3,2021-10-05T18:06:46.043,0,False,0.0
2021,5,3126,10,29,1958,2,50,9,-1,-1,0,-1,0,-1,0,False,False,False,0,2,2021-10-08T11:23:21.723,-1,False,0.0
2021,5,3126,15,29,7828,2,4,3,12,16,4,14,2,14,0,False,False,False,0,3,2021-10-08T11:23:39.323,16,False,2.0
2021,5,3126,30,29,4866,13,7,6,27,0,0,0,0,0,0,False,False,False,0,3,2021-10-14T19:26:12.94,0,False,0.0
2021,5,3126,40,27,650,2,35,6,24,25,1,25,0,25,0,False,False,False,0,3,2021-10-08T11:23:07.983,25,True,0.0
2021,5,3126,50,27,650,2,5,5,4,4,0,4,0,4,0,False,False,False,0,3,2021-10-08T11:26:42.493,4,True,0.0
2021,5,3126,55,27,3656,13,12,3,10,0,0,0,0,0,0,False,False,False,0,3,2021-10-08T11:29:56.5,0,False,0.0
2021,5,3126,65,29,1958,2,17,9,4,11,7,11,0,11,0,True,False,False,0,3,2022-02-14T19:16:32.483,11,False,0.0
2021,5,3126,70,29,4866,2,39,4,7,9,2,8,1,8,0,False,False,False,0,3,2021-10-08T11:35:31.22,9,False,1.0
2021,5,3126,80,29,4866,2,5,5,4,4,0,4,0,4,0,False,False,False,0,3,2021-10-08T11:39:16.107,4,False,0.0
2021,5,3126,90,29,7828,13,5,6,16,0,0,0,0,0,0,False,False,False,0,3,2021-10-08T11:57:20.39,0,False,0.0
2021,5,3126,105,27,6397,3,47,5,2,0,0,0,0,0,0,True,False,False,0,4,2022-02-16T17:59:40.66,0,False,0.0
2021,5,3126,110,27,6397,13,35,4,11,0,0,0,0,0,0,False,False,False,0,4,2021-10-14T20:06:02.313,0,False,
2021,5,3126,120,27,7408,2,12,6,25,25,0,25,0,25,0,False,False,False,0,2,2021-10-08T12:09:19.103,25,False,0.0
2021,5,3126,150,29,967,13,4,7,15,0,0,0,0,0,0,False,False,False,0,3,2021-10-08T12:26:35.343,0,False,0.0
2021,5,3126,155,29,7378,2,48,9,-6,17,23,14,3,14,0,False,False,False,0,1,2021-10-08T12:25:37.133,17,False,3.0
2021,5,3126,165,29,1958,2,6,1,16,17,1,17,0,17,0,False,False,False,0,2,2021-10-08T12:29:46.897,17,False,0.0
2021,5,3126,170,29,1958,2,13,9,5,25,20,23,2,23,0,False,False,False,0,3,2021-10-08T12:31:39.237,25,False,2.0
2021,5,3126,185,29,7828,3,2,9,4,0,0,0,0,0,0,False,False,False,0,3,2021-10-08T12:34:13.567,0,False,0.0
2021,5,3126,190,29,7828,13,12,5,8,0,0,0,0,0,0,False,False,False,0,3,2021-10-08T17:07:57.527,0,False,0.0
2021,5,3126,210,27,650,13,4,8,19,0,0,0,0,0,0,False,False,False,0,3,2021-10-08T12:49:38.217,0,False,0.0
2021,5,3126,215,29,7828,13,19,7,47,0,0,0,0,0,0,False,False,False,0,2,2021-10-08T17:09:54.433,0,False,0.0
2021,5,3126,220,29,4866,2,5,9,5,5,0,5,0,5,0,False,False,False,0,3,2021-10-08T12:54:28.067,5,False,0.0
2021,5,3126,240,27,7496,2,34,4,-4,14,18,11,3,11,0,True,False,False,0,3,2021-10-14T19:11:48.72,14,False,3.0
2021,5,3126,245,27,650,13,21,2,51,0,0,0,0,0,0,False,False,False,0,3,2021-10-08T13:02:46.58,0,False,
2021,5,3126,255,27,7408,2,8,8,16,19,3,17,2,17,6,False,False,False,0,2,2021-10-08T13:08:41.597,19,False,2.0
2021,5,3126,285,29,1958,2,4,9,10,9,-1,9,0,9,0,False,False,False,0,3,2021-10-08T13:18:38.047,9,False,0.0
2021,5,3126,295,29,4866,2,4,3,5,5,0,5,0,5,0,False,False,False,0,3,2021-10-08T13:25:46.243,5,False,0.0
2021,5,3126,300,29,6266,2,4,3,6,8,2,6,2,6,0,False,False,False,0,2,2021-10-08T13:27:35.163,8,False,2.0
2021,5,3126,320,29,1958,2,5,5,6,6,0,6,0,6,0,False,False,False,0,3,2021-10-14T19:42:22,6,False,0.0
2021,5,3126,355,27,7850,2,11,6,21,29,8,28,1,28,0,False,False,False,0,1,2021-10-08T13:48:26.73,29,False,1.0
2021,5,3126,370,27,650,13,24,2,29,0,0,0,0,0,0,False,False,False,0,2,2022-02-25T15:12:59.28,0,False,
2021,5,3126,375,27,7852,2,2,4,8,9,1,9,0,9,0,False,False,False,0,3,2021-10-08T13:56:49.143,9,False,0.0
2021,5,3126,385,27,650,2,6,1,15,15,0,15,0,15,6,False,False,False,0,2,2021-10-08T13:59:45.883,15,True,
2021,5,3126,395,27,650,2,5,5,8,8,0,8,0,8,0,False,False,False,0,2,2021-10-08T14:01:47.233,8,True,0.0
2021,5,3126,420,27,650,2,3,3,13,13,0,13,0,13,0,False,False,False,0,2,2021-10-14T20:01:47.823,13,False,0.0
2021,5,3126,430,27,7496,2,4,3,6,5,-1,5,0,5,0,False,False,False,0,2,2021-10-14T19:17:49.047,5,True,0.0
2021,5,3126,440,27,7849,13,17,4,5,0,0,0,0,0,0,False,False,False,0,4,2021-10-08T14:18:27.91,0,False,0.0
2021,5,3126,460,29,1958,2,5,5,6,7,1,7,0,7,0,True,False,False,0,3,2021-10-08T14:27:08.217,7,False,0.0
2021,5,3126,465,29,1958,13,24,2,19,0,0,0,0,0,0,True,False,False,0,3,2021-10-08T14:28:53.47,0,False,0.0
2021,5,3126,470,29,1958,2,26,5,5,9,4,9,0,9,0,False,False,False,0,2,2021-10-14T20:01:57.663,9,False,0.0
2021,5,3126,475,29,1958,13,8,4,14,0,0,0,0,0,0,False,False,False,0,3,2021-10-14T20:16:18.483,0,False,0.0
2021,5,3126,480,29,4866,13,7,6,19,0,0,0,0,0,0,True,False,False,0,3,2021-10-08T14:35:41.617,0,False,0.0
2021,5,3126,485,29,967,2,19,2,40,68,28,68,0,68,0,False,False,False,0,3,2021-10-14T20:02:06.83,68,True,0.0
2021,5,3126,515,27,650,13,21,2,37,0,0,0,0,0,0,True,False,False,0,3,2021-10-08T14:47:46.74,0,False,0.0
2021,5,3126,535,29,1958,2,6,4,14,20,6,18,2,18,0,False,False,False,0,2,2021-10-08T14:58:26.72,20,False,2.0
2021,5,3126,540,29,1958,2,6,1,19,20,1,20,0,20,0,False,False,False,0,2,2021-10-08T14:57:58.863,20,False,0.0
2021,5,3126,550,29,3398,2,7,5,13,13,0,13,0,13,6,False,False,False,0,3,2021-10-08T15:02:22.71,13,True,0.0
2021,5,3126,570,27,7849,2,18,3,-2,1,3,0,1,0,0,False,False,False,0,2,2021-10-08T15:07:12.02,1,False,1.0
2021,5,3126,585,29,1958,2,18,5,-3,3,6,1,2,1,0,False,False,False,0,3,2021-10-14T20:16:18.483,3,False,2.0
2021,5,3126,590,29,4866,2,21,5,12,23,11,22,1,22,0,False,False,False,0,3,2021-10-08T15:24:34.2,23,False,1.0
2021,5,3126,610,29,967,13,19,2,33,0,0,0,0,0,0,False,False,False,0,3,2021-10-14T20:16:18.483,0,False,0.0
2021,5,3126,625,27,7408,13,6,10,13,0,0,0,0,0,0,False,False,False,0,2,2021-10-08T15:32:33.547,0,False,
2021,5,3126,630,27,7408,2,6,4,5,17,12,15,2,15,0,False,False,False,2,3,2021-10-08T15:36:33.163,17,False,2.0
2021,5,3126,635,27,6397,2,12,5,9,8,-1,9,-1,9,0,False,False,False,0,2,2021-10-08T15:36:16.423,8,False,-1.0
2021,5,3126,650,27,7850,2,47,5,-2,3,5,0,3,0,0,False,False,False,1,1,2021-10-08T15:47:49.767,3,False,3.0
2021,5,3126,665,27,6397,2,12,4,10,21,11,19,2,19,0,False,False,False,0,4,2021-10-08T15:47:36.04,21,False,2.0
2021,5,3126,670,27,7408,2,9,6,23,23,0,23,0,23,6,False,False,False,0,2,2021-10-08T15:47:23.563,23,True,0.0
2021,5,3126,685,29,3398,2,53,9,-2,1,3,0,1,0,0,False,False,False,0,4,2021-10-08T15:51:29.997,1,False,1.0
2021,5,3126,690,29,1958,2,6,4,13,24,11,21,3,21,0,False,False,False,0,3,2021-10-14T20:02:21.123,24,False,3.0
2021,5,3126,695,29,4866,2,8,7,31,33,2,33,0,33,0,False,False,False,0,3,2021-10-08T16:01:04.373,33,False,0.0
2021,5,3126,705,29,4866,2,35,9,12,13,1,13,0,13,0,False,False,False,0,3,2021-10-14T19:23:09.83,13,False,0.0
2021,5,3126,730,27,650,2,5,3,6,7,1,7,0,7,0,False,False,False,0,3,2021-10-14T20:02:54.583,7,True,0.0
2021,5,3126,745,27,3656,2,28,3,-5,5,10,5,0,5,0,False,False,False,1,1,2021-10-08T16:15:51.513,5,False,0.0
2021,5,3126,750,27,7408,2,2,10,9,14,5,12,2,12,0,False,False,False,0,2,2021-10-08T16:15:37.31,14,False,2.0
2021,5,3126,755,27,650,13,3,5,14,0,0,0,0,0,0,False,False,False,0,2,2021-10-08T16:18:49.433,0,False,0.0
2021,5,3126,765,27,3656,2,48,9,-7,20,27,18,2,18,0,False,False,False,0,1,2021-10-08T16:21:26.343,20,False,2.0
2021,5,3126,770,27,650,13,20,2,16,0,0,0,0,0,0,False,False,False,0,2,2021-10-08T16:27:18.45,0,False,0.0
2021,5,3126,775,27,6397,13,4,9,12,0,0,0,0,0,0,False,False,False,0,3,2022-02-18T23:29:55.847,0,False,0.0
2021,5,3126,780,27,7852,13,12,3,14,0,0,0,0,0,0,False,False,False,0,3,2021-10-14T20:04:01.913,0,False,0.0
2021,5,3126,830,29,4866,13,5,5,10,0,0,0,0,0,0,False,False,False,0,2,2021-10-08T16:42:50.03,0,False,0.0
2021,5,3126,840,27,650,13,35,2,19,0,0,0,0,0,0,False,False,False,0,3,2021-10-08T16:46:06.987,0,False,0.0
2021,5,3126,895,27,7404,2,4,10,4,13,9,6,7,6,0,False,False,False,1,1,2021-10-08T17:11:50.27,13,False,7.0
2021,5,3127,10,2,8389,2,30,5,0,0,0,0,0,0,0,False,False,False,0,4,2021-10-10T18:22:30.34,0,False,0.0
2021,5,3127,25,2,5214,13,17,7,44,0,0,0,0,0,0,True,False,False,0,4,2021-10-15T15:52:34.563,0,False,0.0
2021,5,3127,30,2,3506,13,8,7,20,0,0,0,0,0,0,False,False,False,0,3,2021-10-15T13:12:23.06,0,False,
2021,5,3127,40,2,3506,13,2,10,5,0,0,0,0,0,0,False,False,False,0,2,2022-02-16T16:27:27.137,0,False,0.0
2021,5,3127,45,2,1377,2,47,5,2,3,1,2,1,2,0,False,False,False,0,4,2021-10-10T18:44:02.923,3,False,1.0
2021,5,3127,65,2,8389,2,2,10,10,16,6,12,4,12,0,False,False,False,0,3,2021-10-10T19:39:08.503,16,False,4.0
2021,5,3127,75,2,8389,13,4,10,6,0,0,0,0,0,0,False,False,False,0,3,2021-10-10T19:42:15.11,0,False,0.0
2021,5,3127,80,2,2554,2,48,10,-3,-2,1,-2,0,-2,0,False,False,False,0,1,2021-10-10T19:43:51.543,-2,False,0.0
2021,5,3127,105,22,3170,3,12,3,9,0,0,0,0,0,0,False,False,False,0,3,2021-10-11T03:48:35.187,0,False,0.0
2021,5,3127,120,2,2554,13,48,10,-6,0,0,0,0,0,0,False,False,False,0,1,2021-12-09T18:11:04.687,0,False,0.0
2021,5,3127,130,2,3506,2,4,9,7,14,7,10,4,10,0,False,False,False,0,2,2021-10-15T16:06:14.857,14,False,4.0
2021,5,3127,140,2,8389,2,8,10,14,18,4,18,0,18,0,False,False,False,0,3,2021-10-12T19:57:45.287,18,False,0.0
2021,5,3127,150,2,1377,2,35,10,10,22,12,22,0,22,0,False,False,False,0,4,2021-10-15T13:12:23.06,22,False,0.0
2021,5,3127,155,2,811,2,35,10,13,16,3,16,0,16,0,False,False,False,0,3,2021-10-10T20:25:02.517,16,False,0.0
2021,5,3127,160,2,8389,2,5,5,2,2,0,2,0,2,6,False,False,False,0,4,2021-10-10T20:27:42.29,2,True,0.0
2021,5,3127,175,22,5080,13,35,8,15,0,0,0,0,0,0,False,False,False,0,3,2021-10-10T20:30:55.073,0,False,0.0
2021,5,3127,190,22,6812,2,46,9,5,11,6,10,1,10,0,False,False,False,0,1,2021-10-12T15:08:14.92,11,False,1.0
2021,5,3127,210,2,811,2,8,10,13,13,0,13,0,13,0,False,False,False,0,2,2021-10-12T20:03:17.583,13,False,0.0
2021,5,3127,220,2,811,2,50,3,-2,5,7,5,0,5,0,False,False,False,0,3,2021-10-15T15:55:48.36,5,False,0.0
2021,5,3127,225,2,8389,2,35,6,15,22,7,22,0,22,0,False,False,False,0,4,2021-10-15T16:07:01.173,22,False,0.0
2021,5,3127,235,2,811,13,30,10,-1,0,0,0,0,0,0,False,False,False,0,4,2021-10-10T21:05:54.713,0,False,0.0
2021,5,3127,240,2,5214,2,4,4,10,17,7,17,0,17,6,False,False,False,0,3,2021-10-10T21:08:10.137,17,True,0.0
2021,5,3127,255,22,2391,13,13,5,5,0,0,0,0,0,0,True,False,False,0,4,2022-02-18T20:49:14.757,0,False,0.0
2021,5,3127,260,22,4997,13,5,6,20,0,0,0,0,0,0,False,False,False,0,2,2021-10-15T15:55:26.49,0,False,0.0
2021,5,3127,265,2,1377,2,47,5,5,5,0,5,0,5,0,False,False,False,0,4,2021-10-10T21:30:09.687,5,True,0.0
2021,5,3127,270,2,5214,2,11,5,12,17,5,17,0,17,0,False,True,True,0,4,2021-10-10T21:31:59,16,False,0.0
2021,5,3127,280,22,5080,2,2,3,9,14,5,9,5,9,0,False,False,False,0,2,2021-10-10T21:35:43.487,14,False,5.0
2021,5,3127,290,22,7610,13,35,6,19,0,0,0,0,0,0,False,False,False,0,3,2021-10-13T13:26:39.41,0,False,0.0
2021,5,3127,295,22,5080,13,6,9,10,0,0,0,0,0,0,False,False,False,0,3,2021-10-13T12:36:31.037,0,False,
2021,5,3127,315,22,8451,2,47,5,1,1,0,1,0,1,0,False,False,False,0,1,2021-10-15T16:11:39.533,1,False,0.0
2021,5,3127,320,22,8454,13,12,6,26,0,0,0,0,0,0,False,False,False,0,3,2022-02-07T20:30:39.493,0,False,0.0
2021,5,3127,325,22,3170,2,5,3,11,13,2,13,0,13,0,False,False,False,0,3,2021-10-10T22:15:35.83,13,False,0.0
2021,5,3127,340,22,3170,13,51,5,-1,0,0,0,0,0,0,False,False,False,0,3,2021-10-15T15:52:54.707,0,False,0.0
2021,5,3127,350,22,743,13,48,10,-3,0,0,0,0,0,0,False,False,False,0,1,2021-10-10T22:24:53.837,0,False,0.0
2021,5,3127,355,22,5080,2,13,10,3,3,0,3,0,3,0,False,False,False,0,3,2021-10-10T22:49:48.967,3,False,0.0
2021,5,3127,380,2,811,13,5,3,6,0,0,0,0,0,0,False,False,False,0,3,2021-10-15T15:53:10.147,0,False,0.0
2021,5,3127,385,2,6240,2,46,3,6,6,0,6,0,6,0,True,False,False,0,3,2021-10-10T23:00:16.733,6,False,0.0
2021,5,3127,390,2,2554,2,4,9,1,10,9,8,2,8,0,False,False,False,0,1,2021-10-13T12:40:31.22,10,False,2.0
2021,5,3127,400,2,6240,13,4,5,3,0,0,0,0,0,0,False,False,False,0,2,2021-10-15T15:53:32.317,0,False,0.0
2021,5,3127,405,2,8389,13,2,10,8,0,0,0,0,0,0,False,False,False,0,3,2021-10-11T03:49:27.3,0,False,
2021,5,3127,410,2,2554,13,16,4,5,0,0,0,0,0,0,False,False,False,0,1,2021-10-10T23:15:25.1,0,False,0.0
2021,5,3127,415,2,6240,13,7,2,20,0,0,0,0,0,0,False,False,False,0,2,2021-10-10T23:17:12.037,0,False,0.0
2021,5,3127,420,2,8389,2,2,4,2,6,4,2,4,2,0,False,False,False,0,3,2021-10-10T23:18:58.157,6,False,4.0
2021,5,3127,460,22,6270,2,34,4,-4,6,10,6,0,6,0,True,False,False,0,2,2021-10-15T16:13:19.013,6,False,0.0
2021,5,3127,495,2,811,2,6,9,12,12,0,12,0,12,0,False,False,False,0,2,2021-10-11T00:02:57.383,12,False,0.0
2021,5,3127,500,2,5214,2,30,10,-1,0,1,0,0,0,0,False,True,False,1,4,2021-10-11T00:05:41.13,0,False,0.0
2021,5,3127,505,2,7303,3,4,9,3,0,0,0,0,0,0,False,False,False,0,2,2021-10-11T00:07:36.423,0,False,0.0
2021,5,3127,510,2,7303,13,8,1,17,0,0,0,0,0,0,False,False,False,0,2,2021-10-11T00:09:41.263,0,False,0.0
2021,5,3127,520,22,8451,2,47,5,0,14,14,3,11,3,0,False,False,False,1,1,2021-10-15T15:56:18.853,14,False,11.0
2021,5,3127,530,22,5080,13,19,2,51,0,0,0,0,0,0,False,False,False,0,2,2022-02-07T20:31:21.443,0,False,0.0
2021,5,3127,535,22,2391,2,28,5,-1,4,5,4,0,4,0,False,True,False,0,1,2021-10-11T00:37:26.837,4,False,0.0
2021,5,3127,555,2,2554,13,12,9,-5,0,0,0,0,0,0,False,False,False,0,1,2022-02-16T16:28:35.97,0,False,0.0
2021,5,3127,560,2,3506,2,12,5,13,13,0,13,0,13,0,False,False,False,0,3,2022-02-07T20:31:37.11,13,False,0.0
2021,5,3127,570,2,3506,2,4,9,6,17,11,10,7,10,0,False,False,False,1,3,2021-10-15T15:57:48.573,17,False,7.0
2021,5,3127,580,2,6240,2,5,5,6,6,0,6,0,6,0,False,False,False,0,3,2021-10-11T01:00:08.1,6,False,0.0
2021,5,3127,585,2,5214,2,47,5,2,7,5,7,0,7,0,False,False,False,0,4,2021-10-15T16:16:46.907,7,False,0.0
2021,5,3127,595,22,8451,2,48,9,-3,5,8,5,0,5,0,False,False,False,0,1,2021-10-11T01:04:48.187,5,False,0.0
2021,5,3127,600,22,3170,2,51,3,-6,-6,0,-6,0,-6,0,True,False,False,0,3,2022-02-16T16:29:14.203,-6,False,0.0
2021,5,3127,605,22,8454,13,24,2,20,0,0,0,0,0,0,False,False,False,0,2,2021-10-15T15:54:12.103,0,False,0.0
2021,5,3127,625,2,7303,2,13,5,3,5,2,5,0,5,0,False,False,False,0,3,2021-10-12T20:05:10.53,5,False,0.0
2021,5,3127,640,2,8389,2,6,10,12,12,0,12,0,12,0,False,False,False,0,3,2021-10-11T01:48:37.4,12,False,0.0
2021,5,3127,650,2,8389,2,12,6,18,29,11,24,5,24,0,False,False,False,0,3,2022-02-18T20:55:51.78,29,False,
2021,5,3127,655,2,3506,2,2,3,7,9,2,9,0,9,0,False,False,False,0,2,2021-10-11T02:04:54.36,9,False,0.0
2021,5,3127,660,2,811,2,13,4,2,2,0,2,0,2,0,False,False,False,0,2,2021-10-11T02:06:14.057,2,False,0.0
2021,5,3127,670,22,3170,2,39,4,5,7,2,7,0,7,0,False,False,False,0,3,2021-10-11T02:23:42.853,7,False,0.0
2021,5,3127,675,22,4997,2,5,6,21,23,2,23,0,23,0,False,False,False,0,3,2021-10-11T02:25:23.027,23,False,0.0
2021,5,3127,680,22,2391,2,38,3,5,6,1,6,0,6,0,False,False,False,0,4,2021-10-11T03:50:18.643,6,False,
2021,5,3127,685,22,7610,2,8,1,18,27,9,24,3,24,0,False,False,False,0,3,2021-10-11T02:32:11.153,27,False,3.0
2021,5,3127,690,22,8454,13,35,6,43,0,0,0,0,0,0,False,False,False,0,3,2022-02-07T20:34:28.383,0,False,
2021,5,3127,710,2,8389,2,8,8,38,39,1,39,0,39,0,False,False,False,0,3,2021-10-15T16:23:43.7,39,False,0.0
2021,5,3127,720,2,8389,2,5,3,4,4,0,4,0,4,0,False,False,False,0,3,2021-10-11T02:53:48.783,4,False,0.0
2021,5,3127,730,2,7303,2,2,10,7,15,8,13,2,13,0,False,False,False,0,2,2021-10-11T02:55:50.857,15,False,2.0
2021,5,3127,740,2,811,2,28,9,4,5,1,5,0,5,0,False,False,False,0,1,2022-02-07T20:34:51.033,5,False,0.0
2021,5,3127,745,2,811,2,50,3,-3,7,10,5,2,5,0,False,False,False,0,3,2021-10-15T15:56:59.877,7,False,2.0
2021,5,3127,775,22,5080,2,5,3,5,8,3,8,0,8,0,False,False,False,0,3,2021-10-11T03:06:37.013,8,False,0.0
2021,5,3127,790,22,4997,2,4,3,14,15,1,15,0,15,0,False,False,False,0,3,2021-10-11T03:11:44.757,15,False,0.0
2021,5,3127,795,22,6812,2,4,9,5,11,6,9,2,9,0,False,False,False,0,1,2021-10-11T03:21:18.397,11,False,2.0
2021,5,3127,800,22,6812,13,47,5,1,0,0,0,0,0,0,False,False,False,0,1,2021-10-15T16:26:36.083,0,False,0.0
2021,5,3127,805,22,7610,2,4,5,4,6,2,6,0,6,0,False,False,False,0,2,2021-10-15T16:27:53.503,6,False,0.0
2021,5,3127,810,22,3170,2,4,3,5,10,5,10,0,10,0,False,False,False,0,3,2021-10-11T03:25:18.28,10,False,0.0
2021,5,3127,820,22,5080,2,6,8,20,20,0,20,0,20,0,False,False,False,0,2,2021-10-11T03:28:12.963,20,False,0.0
2021,5,3127,830,22,5080,3,4,5,5,0,0,0,0,0,0,False,False,False,0,2,2022-02-18T20:56:21.617,0,False,0.0
2021,5,3128,15,11,7732,2,48,9,-4,10,14,10,0,10,0,False,False,False,0,1,2021-10-11T10:22:08.543,10,False,0.0
2021,5,3128,20,11,6810,2,4,9,4,8,4,6,2,6,0,True,False,False,0,3,2021-10-11T10:21:33.47,8,False,2.0
2021,5,3128,40,11,7733,2,5,10,4,13,9,13,0,13,0,False,False,False,0,3,2021-10-15T19:54:53.263,13,False,0.0
2021,5,3128,45,11,8359,13,9,6,19,0,0,0,0,0,0,False,False,False,0,3,2021-10-11T10:37:50.417,0,False,0.0
2021,5,3128,55,11,6633,13,5,3,9,0,0,0,0,0,0,False,False,False,0,2,2021-10-11T10:42:10.583,0,False,0.0
2021,5,3128,70,18,6361,3,32,10,3,0,0,0,0,0,0,False,False,False,0,4,2022-02-16T17:40:04.46,0,False,0.0
2021,5,3128,80,18,7711,2,19,6,31,37,6,32,5,32,0,False,False,False,0,2,2021-10-15T17:30:27.523,37,False,5.0
2021,5,3128,85,18,8114,3,39,4,5,0,0,0,0,0,0,False,False,False,0,4,2021-10-11T17:41:57.653,0,False,0.0
2021,5,3128,95,18,7711,2,5,5,14,14,0,14,0,14,0,False,False,False,0,3,2021-10-11T17:47:26.487,14,False,0.0
2021,5,3128,105,18,6900,2,46,3,2,4,2,3,1,3,0,False,False,False,0,1,2021-10-11T11:08:10.623,4,False,1.0
2021,5,3128,110,18,4940,13,17,1,20,0,0,0,0,0,0,False,False,False,0,3,2021-10-15T20:01:24.753,0,False,0.0
2021,5,3128,125,11,4561,2,47,10,2,4,2,2,2,2,0,False,False,False,0,1,2021-10-11T17:25:04.223,4,False,2.0
2021,5,3128,135,11,6810,13,6,9,12,0,0,0,0,0,0,False,False,False,0,3,2021-10-11T11:22:20.897,0,False,
2021,5,3128,165,11,8359,2,49,10,-2,13,15,13,0,13,0,False,False,False,0,2,2021-10-11T11:37:14.37,13,False,0.0
2021,5,3128,200,18,7711,3,2,10,6,0,0,0,0,0,0,False,False,False,0,2,2022-02-18T23:21:51.963,0,False,0.0
2021,5,3128,205,18,7711,2,4,3,14,17,3,17,0,17,0,False,False,False,0,2,2021-10-11T12:01:14.073,17,False,0.0
2021,5,3128,210,18,6900,2,6,9,3,6,3,4,2,4,0,False,False,False,0,1,2021-10-11T11:58:53.53,6,False,2.0
2021,5,3128,220,18,1381,2,50,3,-2,20,22,17,3,17,0,False,False,False,0,2,2021-10-15T17:30:27.523,20,False,
2021,5,3128,225,18,6900,2,31,4,3,3,0,3,0,3,0,False,False,False,0,1,2021-10-11T12:06:50.637,3,False,0.0
2021,5,3128,240,18,4940,2,13,5,6,6,0,6,0,6,0,False,False,False,0,3,2021-10-15T19:32:59.83,6,False,0.0
2021,5,3128,260,11,8359,2,30,3,1,8,7,8,0,8,0,False,False,False,0,3,2021-10-11T12:21:05.867,8,False,0.0
2021,5,3128,275,11,7733,2,4,5,4,4,0,4,0,4,0,False,False,False,0,2,2021-10-11T12:28:18.88,4,False,0.0
2021,5,3128,295,18,7711,2,5,5,13,14,1,14,0,14,0,False,False,False,0,3,2021-10-11T12:36:11.593,14,False,0.0
2021,5,3128,305,18,7711,2,35,10,13,22,9,18,4,18,0,False,False,False,0,3,2021-10-15T20:12:19.74,22,False,4.0
2021,5,3128,310,18,7712,2,32,9,-1,2,3,1,1,1,0,False,False,False,0,4,2021-10-15T19:28:36.993,2,False,1.0
2021,5,3128,320,18,6900,2,16,10,4,15,11,8,7,8,6,False,False,False,2,1,2021-10-15T19:35:14.103,15,False,7.0
2021,5,3128,335,11,4561,2,44,3,-5,4,9,2,2,2,0,False,False,False,0,1,2021-10-11T12:57:47.177,4,False,2.0
2021,5,3128,345,11,8359,2,5,3,6,6,0,6,0,6,0,True,False,False,0,3,2021-10-15T20:13:48.013,6,False,0.0
2021,5,3128,350,11,6831,3,13,9,4,0,0,0,0,0,0,False,False,False,0,3,2021-10-15T19:33:17.603,0,False,0.0
2021,5,3128,365,11,7733,2,2,9,7,21,14,7,14,7,0,False,False,False,1,2,2021-10-11T13:16:54.04,21,False,14.0
2021,5,3128,370,11,6633,13,9,2,23,0,0,0,0,0,0,False,False,False,0,2,2021-10-11T13:13:44.82,0,False,0.0
2021,5,3128,380,11,8359,2,30,5,0,8,8,8,0,8,0,True,False,False,0,4,2021-10-12T20:25:09.643,8,False,0.0
2021,5,3128,425,18,7712,2,50,5,1,4,3,3,1,3,0,False,False,False,1,2,2021-10-15T17:30:27.523,4,False,1.0
2021,5,3128,440,11,6810,2,5,3,14,14,0,14,0,14,0,False,False,False,0,4,2021-10-15T19:33:32.71,14,False,0.0
2021,5,3128,455,11,6633,13,2,9,13,0,0,0,0,0,0,False,False,False,0,2,2022-02-16T17:45:13.22,0,False,0.0
2021,5,3128,465,18,6361,2,26,4,5,9,4,8,1,8,0,False,False,False,0,4,2021-10-11T14:00:07.657,9,False,1.0
2021,5,3128,475,18,6900,2,48,9,-3,2,5,1,1,1,0,False,False,False,0,1,2021-10-11T14:07:55.737,2,False,1.0
2021,5,3128,505,11,4037,13,23,7,50,0,0,0,0,0,0,False,False,False,0,4,2022-02-16T17:46:36.17,0,False,0.0
2021,5,3128,510,11,6831,13,2,9,5,0,0,0,0,0,0,False,False,False,0,2,2021-10-11T14:23:53.087,0,False,0.0
2021,5,3128,520,18,7711,2,3,3,11,11,0,9,2,9,0,False,False,False,0,2,2021-10-12T13:10:05.727,11,False,2.0
2021,5,3128,530,18,1381,13,6,5,13,0,0,0,0,0,0,False,False,False,0,3,2022-02-07T20:36:25.18,0,False,0.0
2021,5,3128,535,18,4940,2,13,10,4,6,2,4,2,4,0,True,False,False,0,3,2021-10-15T20:18:18.987,6,False,2.0
2021,5,3128,550,18,7712,13,35,4,2,0,0,0,0,0,0,False,False,False,0,3,2021-10-15T20:19:08.31,0,False,0.0
2021,5,3128,560,11,7732,2,51,9,-3,5,8,4,1,4,0,False,False,False,0,2,2021-10-11T15:02:37.87,5,False,1.0
2021,5,3128,570,11,7732,2,47,5,-1,2,3,0,2,0,0,False,False,False,0,1,2021-10-11T15:06:28.96,2,False,2.0
2021,5,3128,585,18,6900,2,4,4,2,3,1,2,1,2,0,False,False,False,0,1,2021-10-11T15:13:28.007,3,False,1.0
2021,5,3128,600,11,6633,13,5,2,15,0,0,0,0,0,0,False,False,False,0,2,2021-10-11T15:28:04.9,0,False,
2021,5,3128,605,11,6633,2,8,1,15,17,2,17,0,17,0,False,False,False,0,3,2021-10-12T20:24:11.653,17,False,0.0
2021,5,3128,620,11,8359,2,49,9,-3,2,5,0,2,0,0,False,False,False,0,2,2021-10-11T15:38:32.143,2,False,2.0
2021,5,3128,635,18,4152,2,46,3,5,14,9,11,3,11,0,False,False,False,0,1,2021-10-15T19:31:45.367,14,False,3.0
2021,5,3128,640,18,7711,2,50,3,-1,9,10,8,1,8,0,False,False,False,0,2,2021-10-15T17:30:27.523,9,False,1.0
2021,5,3128,645,18,6900,2,5,3,5,7,2,7,0,7,0,False,False,False,0,1,2021-10-15T20:21:09.3,7,False,0.0
2021,5,3128,655,18,6361,2,7,6,15,16,1,16,0,16,0,False,False,False,0,4,2021-10-15T17:30:27.523,16,False,0.0
2021,5,3128,680,18,7712,2,2,10,7,8,1,8,0,8,0,False,False,False,0,3,2021-10-11T16:11:43.65,8,False,0.0
2021,5,3128,695,11,7732,2,2,3,2,8,6,7,1,7,0,False,False,False,0,2,2022-02-07T20:37:11.593,8,False,1.0
2021,5,3128,700,11,7732,2,6,4,3,7,4,6,1,6,0,False,False,False,0,1,2021-10-11T16:19:41.093,7,False,1.0
2021,5,3128,705,11,6633,13,9,2,15,0,0,0,0,0,0,False,False,False,0,2,2021-10-11T16:22:20.303,0,False,0.0
2021,5,3128,710,11,6633,2,13,3,7,18,11,14,4,14,0,False,False,False,1,3,2021-10-15T20:23:07.44,18,False,
2021,5,3128,755,11,8359,2,2,10,7,18,11,11,7,11,0,False,False,False,1,3,2021-10-15T19:41:34.817,18,False,7.0
2021,5,3128,760,11,7732,2,28,10,1,21,20,12,9,12,0,False,False,False,1,1,2021-10-15T20:23:41.64,21,False,9.0
2021,5,3128,765,11,6810,13,16,10,7,0,0,0,0,0,0,True,False,False,0,3,2021-10-15T20:24:26.63,0,False,0.0
2021,5,3128,770,11,4037,13,19,2,22,0,0,0,0,0,0,False,False,False,0,2,2021-10-11T16:49:47.007,0,False,0.0
2021,5,3128,825,11,8359,2,2,9,6,10,4,10,0,10,0,False,False,False,0,3,2021-10-11T17:09:00.85,10,False,0.0
2021,5,3128,845,18,1381,2,8,1,20,21,1,21,0,21,0,False,False,False,0,2,2021-10-11T17:15:06.553,21,False,0.0
2021,5,3128,855,18,4940,2,5,3,5,6,1,6,0,6,0,False,False,False,0,3,2021-10-15T17:30:27.523,6,False,0.0
2021,5,3128,865,18,1381,2,8,7,18,19,1,19,0,19,0,False,False,False,0,2,2021-10-11T17:20:13.84,19,False,0.0
2021,5,3129,15,20,5140,2,4,9,3,4,1,3,1,3,0,False,False,False,0,1,2021-10-11T09:07:38.033,4,False,1.0
2021,5,3129,20,20,2136,2,16,4,5,11,6,8,3,8,0,False,False,False,0,3,2021-10-11T09:11:48.463,11,False,3.0
2021,5,3129,25,20,2136,13,5,7,16,0,0,0,0,0,0,False,False,False,0,3,2021-10-15T17:08:20.96,0,False,0.0
2021,5,3129,30,20,4535,13,6,4,15,0,0,0,0,0,0,False,False,False,0,3,2021-10-15T14:28:45.71,0,False,0.0
2021,5,3129,35,32,2675,13,38,10,2,0,0,0,0,0,0,False,False,False,0,3,2022-02-16T18:09:04.857,0,False,0.0
2021,5,3129,45,32,3562,13,12,2,16,0,0,0,0,0,0,False,False,False,0,3,2022-02-07T20:39:23.113,0,False,0.0
2021,5,3129,70,20,7353,2,8,8,46,72,26,72,0,72,6,False,False,False,0,3,2021-10-11T16:07:15.967,72,True,0.0
2021,5,3129,85,32,2675,2,13,3,4,20,16,12,8,12,0,True,False,False,1,3,2021-10-12T18:58:02.873,20,False,8.0
2021,5,3129,100,32,7807,2,46,3,2,9,7,7,2,7,0,False,False,False,0,1,2021-10-11T16:16:59.033,9,False,2.0
2021,5,3129,120,32,7128,2,35,2,18,18,0,18,0,18,0,False,False,False,0,2,2021-10-15T17:49:26.353,18,False,0.0
2021,5,3129,130,32,4788,13,12,4,5,0,0,0,0,0,0,False,False,False,0,3,2021-10-15T13:53:51.377,0,False,0.0
2021,5,3129,135,32,4788,13,2,9,5,0,0,0,0,0,0,False,False,False,0,2,2021-10-11T10:25:06.51,0,False,0.0
2021,5,3129,150,20,5140,2,48,5,-7,20,27,17,3,17,0,False,False,False,0,1,2021-10-15T13:02:44.213,20,False,3.0
2021,5,3129,180,32,3885,2,28,10,0,8,8,6,2,6,0,False,False,False,0,1,2021-10-11T10:47:36.993,8,False,2.0
2021,5,3129,190,32,8533,13,24,2,24,0,0,0,0,0,0,False,False,False,0,3,2021-10-11T10:57:40.133,0,False,
2021,5,3129,210,32,4788,2,39,4,4,7,3,5,2,5,0,False,False,False,0,3,2021-10-11T11:05:22.447,7,False,2.0
2021,5,3129,230,20,4535,2,47,5,1,11,10,1,10,1,0,False,False,False,1,4,2021-10-11T11:14:52.767,11,False,10.0
2021,5,3129,240,20,8131,2,2,10,6,10,4,9,1,9,0,False,False,False,0,3,2021-10-11T11:21:41.723,10,False,1.0
2021,5,3129,250,20,4535,13,35,2,26,0,0,0,0,0,0,False,False,False,0,3,2021-10-11T11:31:01.74,0,False,
2021,5,3129,260,20,5140,2,48,5,-4,12,16,11,1,11,0,False,False,False,0,1,2021-10-11T11:34:07.337,12,False,1.0
2021,5,3129,280,32,3562,2,7,6,16,17,1,17,0,17,0,True,False,False,0,2,2021-10-12T18:58:18.103,17,True,0.0
2021,5,3129,285,32,7128,2,5,3,13,13,0,13,0,13,0,False,False,False,0,3,2021-10-11T11:44:04.847,13,True,0.0
2021,5,3129,300,32,4788,2,4,10,6,7,1,7,0,7,0,False,False,False,0,3,2021-10-11T11:52:05.103,7,False,0.0
2021,5,3129,305,32,4788,2,5,6,16,16,0,16,0,16,0,False,False,False,0,3,2021-10-11T11:55:03.13,16,True,0.0
2021,5,3129,310,32,3562,2,4,10,10,10,0,10,0,10,0,False,False,False,0,3,2021-10-11T11:57:33.07,10,False,0.0
2021,5,3129,320,32,4803,13,9,5,14,0,0,0,0,0,0,False,False,False,0,2,2021-10-15T14:29:01.62,0,False,0.0
2021,5,3129,330,20,8131,13,30,3,-1,0,0,0,0,0,0,True,False,False,0,4,2021-10-12T15:27:32.217,0,False,0.0
2021,5,3129,340,20,2136,13,19,2,36,0,0,0,0,0,0,False,False,False,0,2,2021-10-11T12:18:01.397,0,False,0.0
2021,5,3129,345,20,8131,13,9,6,22,0,0,0,0,0,0,False,False,False,0,2,2021-10-11T12:21:07.073,0,False,0.0
2021,5,3129,355,32,4788,2,53,9,-3,7,10,1,6,1,0,False,False,False,1,4,2022-02-16T18:09:38.81,7,False,6.0
2021,5,3129,370,32,3562,13,50,5,-5,0,0,0,0,0,0,False,False,False,0,2,2021-10-11T12:33:45.03,0,False,0.0
2021,5,3129,375,32,2675,13,5,5,11,0,0,0,0,0,0,True,False,False,0,2,2021-10-15T17:16:17.453,0,False,0.0
2021,5,3129,380,32,7128,13,5,2,22,0,0,0,0,0,0,False,False,False,0,3,2021-10-11T12:38:32.22,0,False,0.0
2021,5,3129,385,32,7128,13,5,3,14,0,0,0,0,0,0,False,False,False,0,2,2021-10-11T12:41:19.007,0,False,0.0
2021,5,3129,405,20,8131,13,3,9,13,0,0,0,0,0,0,False,False,False,0,2,2021-10-11T16:17:59.907,0,False,0.0
2021,5,3129,410,20,5140,3,50,3,-3,0,0,0,0,0,0,False,False,False,0,2,2022-01-05T15:28:09.543,0,False,0.0
2021,5,3129,460,20,8131,2,19,2,49,49,0,49,0,49,6,False,False,False,0,3,2022-02-07T20:40:11.963,49,True,0.0
2021,5,3129,480,32,4788,13,32,5,1,0,0,0,0,0,0,False,False,False,0,4,2021-10-11T13:14:28.997,0,False,0.0
2021,5,3129,490,32,7128,13,35,7,19,0,0,0,0,0,0,False,False,False,0,3,2021-10-11T13:18:13.133,0,False,0.0
2021,5,3129,500,20,8127,13,2,4,5,0,0,0,0,0,0,False,False,False,0,3,2021-10-11T13:20:50.083,0,False,0.0
2021,5,3129,510,20,1361,13,12,3,8,0,0,0,0,0,0,False,False,False,0,3,2022-02-07T20:41:52.577,0,False,0.0
2021,5,3129,520,32,4788,2,12,5,7,44,37,45,-1,45,0,False,False,False,0,4,2021-10-11T13:35:07.873,44,False,
2021,5,3129,525,32,7128,2,13,9,3,9,6,4,5,4,0,False,False,False,0,3,2021-10-11T13:39:40.62,9,False,5.0
2021,5,3129,530,32,7807,2,28,10,1,3,2,1,2,1,0,False,False,False,0,1,2021-10-11T13:41:31.53,3,False,2.0
2021,5,3129,540,32,8533,2,12,5,7,6,-1,6,0,6,0,False,False,False,0,2,2022-02-07T20:42:25.843,6,True,0.0
2021,5,3129,545,32,7128,13,2,8,15,0,0,0,0,0,0,False,False,False,0,2,2021-10-11T13:47:18.03,0,False,0.0
2021,5,3129,555,20,5140,3,11,2,22,0,0,0,0,0,0,False,False,False,0,1,2021-10-11T13:51:09.417,0,False,0.0
2021,5,3129,560,20,2136,13,35,9,13,0,0,0,0,0,0,False,False,False,0,3,2021-10-11T13:53:52.037,0,False,0.0
2021,5,3129,565,20,8131,13,9,2,21,0,0,0,0,0,0,False,False,False,0,2,2021-10-11T16:21:08.23,0,False,0.0
2021,5,3129,575,32,4788,2,32,5,0,4,4,2,2,2,0,False,False,False,0,4,2021-10-11T14:01:11.46,4,False,2.0
2021,5,3129,590,32,7128,2,30,5,-3,6,9,6,0,6,0,False,False,False,0,3,2021-10-11T14:05:39.69,6,True,0.0
2021,5,3129,600,32,3562,2,34,4,-3,9,12,5,4,5,0,True,False,False,0,2,2021-10-11T14:10:20.73,9,False,4.0
2021,5,3129,635,32,4788,13,13,9,6,0,0,0,0,0,0,False,False,False,0,4,2022-02-16T18:10:32.14,0,False,0.0
2021,5,3129,655,20,8131,2,3,3,14,14,0,14,0,14,0,False,False,False,0,3,2021-10-11T14:26:36.683,14,False,0.0
2021,5,3129,660,20,5140,13,16,9,3,0,0,0,0,0,0,False,False,False,0,1,2021-10-15T17:24:08.82,0,False,0.0
2021,5,3129,665,20,5140,2,48,3,-4,-4,0,-4,0,-4,0,False,False,False,0,1,2022-02-16T18:10:49.943,-4,False,0.0
2021,5,3129,690,32,3885,13,2,4,5,0,0,0,0,0,0,True,False,False,0,3,2021-10-12T18:59:59.38,0,False,0.0
2021,5,3129,695,32,3885,13,28,4,1,0,0,0,0,0,0,False,False,False,0,1,2021-10-11T14:41:33.863,0,False,0.0
2021,5,3129,700,32,3562,13,35,6,24,0,0,0,0,0,0,False,False,False,0,3,2021-10-15T14:29:19.24,0,False,0.0
2021,5,3129,705,20,7888,2,6,10,6,11,5,8,3,8,0,False,False,False,0,4,2021-10-11T14:45:18.613,11,False,3.0
2021,5,3129,720,20,8131,2,11,3,11,12,1,12,0,12,6,False,False,False,0,3,2022-01-05T17:22:13.377,12,True,0.0
2021,5,3129,735,32,3885,13,39,4,5,0,0,0,0,0,0,False,False,False,0,3,2021-10-11T14:56:30.607,0,False,
2021,5,3129,740,32,2675,2,35,6,20,26,6,23,3,23,0,False,False,False,0,3,2021-10-15T17:47:44.79,26,False,3.0
2021,5,3129,750,32,3885,13,26,3,4,0,0,0,0,0,0,False,False,False,0,2,2021-10-11T15:02:12.55,0,False,0.0
2021,5,3129,760,32,3562,2,6,8,25,26,1,26,0,26,0,False,False,False,0,3,2021-10-11T15:05:51.32,26,False,0.0
2021,5,3129,775,32,7128,13,12,5,5,0,0,0,0,0,0,False,False,False,0,2,2022-02-07T20:43:29.597,0,False,
2021,5,3129,805,20,2136,2,39,9,5,6,1,6,0,6,0,False,False,False,0,3,2021-10-11T15:23:47.597,6,False,0.0
2021,5,3129,825,20,7888,2,43,7,19,32,13,30,2,30,0,False,False,False,1,4,2021-10-15T15:29:29.3,32,False,2.0
2021,5,3129,840,20,5140,2,47,5,0,19,19,19,0,19,6,False,False,False,0,1,2021-10-11T15:38:08.06,19,True,0.0
2021,5,3129,855,32,2675,2,13,5,6,27,21,24,3,24,0,False,False,False,0,2,2021-10-11T15:41:42.897,27,False,3.0
2021,5,3129,860,32,3562,13,17,7,28,0,0,0,0,0,0,False,False,False,0,3,2021-10-11T15:43:32.4,0,False,0.0
2021,5,3129,865,32,7128,13,5,3,12,0,0,0,0,0,0,False,False,False,0,3,2022-02-16T18:12:05,0,False,0.0
2021,5,3129,870,32,7128,13,19,6,32,0,0,0,0,0,0,False,False,False,0,2,2021-12-09T17:42:02.98,0,False,0.0
2021,5,3129,875,32,7128,13,3,5,10,0,0,0,0,0,0,False,False,False,0,2,2021-10-11T15:50:30.97,0,False,0.0
2021,5,3130,30,13,4662,3,46,3,0,0,0,0,0,0,0,False,False,False,0,4,2021-10-11T09:15:44.59,0,False,0.0
2021,5,3130,35,13,876,13,5,5,13,0,0,0,0,0,0,False,False,False,0,2,2021-10-15T15:09:13.507,0,False,
2021,5,3130,50,13,6528,2,50,10,-4,8,12,2,6,2,0,False,False,False,0,3,2021-10-15T15:08:30.447,8,False,6.0
2021,5,3130,60,13,876,13,7,6,33,0,0,0,0,0,0,False,False,False,0,3,2021-10-11T09:37:46.32,0,False,0.0
2021,5,3130,80,13,2455,2,2,9,6,8,2,6,2,6,0,False,False,False,0,2,2021-10-11T09:45:20.05,8,False,2.0
2021,5,3130,90,13,2455,2,48,10,-3,10,13,-1,11,-1,0,False,False,False,0,1,2021-10-11T09:48:11.973,10,False,11.0
2021,5,3130,100,13,3586,2,34,4,-4,7,11,-3,10,-3,0,True,False,False,1,3,2021-10-15T16:09:52.347,7,False,10.0
2021,5,3130,105,13,4498,2,17,10,11,11,0,11,0,11,6,False,False,False,0,4,2022-03-11T19:08:47.893,11,True,0.0
2021,5,3130,130,19,4912,2,2,10,7,15,8,14,1,14,0,False,False,False,0,3,2021-10-11T10:05:14.83,15,False,1.0
2021,5,3130,150,19,2256,2,2,10,11,11,0,11,0,11,0,False,False,False,0,2,2021-10-11T10:11:04.997,11,False,0.0
2021,5,3130,165,19,7175,2,49,9,0,6,6,4,2,4,0,True,False,False,0,2,2021-10-15T15:20:04.717,6,False,2.0
2021,5,3130,185,13,2455,2,3,5,7,7,0,7,0,7,0,False,False,False,0,2,2021-10-11T11:01:52.95,7,False,0.0
2021,5,3130,195,13,3586,2,12,2,25,67,42,67,0,67,6,False,False,False,0,3,2022-02-18T22:39:45.35,67,True,0.0
2021,5,3130,220,19,7173,2,2,10,8,9,1,8,1,8,0,False,False,False,0,2,2021-10-11T11:13:23.76,9,False,1.0
2021,5,3130,230,19,7175,2,2,4,10,17,7,17,0,17,0,False,False,False,0,3,2022-03-11T19:11:10.087,17,False,0.0
2021,5,3130,235,19,5096,2,17,8,15,23,8,22,1,22,0,False,False,False,0,4,2021-10-11T16:02:50.917,23,False,1.0
2021,5,3130,240,19,5096,2,47,5,2,4,2,4,0,4,0,False,False,False,0,1,2021-10-11T16:00:16.72,4,False,0.0
2021,5,3130,260,13,6528,2,5,3,7,9,2,8,1,8,0,False,False,False,0,4,2021-10-11T11:31:34.08,9,False,1.0
2021,5,3130,280,13,2455,2,48,10,-4,16,20,13,3,13,0,False,False,False,0,1,2021-10-11T16:29:05.71,16,False,3.0
2021,5,3130,290,13,876,2,2,9,5,6,1,5,1,5,0,False,False,False,0,2,2021-10-15T15:08:59.757,6,False,1.0
2021,5,3130,295,13,4662,13,12,9,-3,0,0,0,0,0,0,True,False,False,0,4,2022-02-07T21:04:52.947,0,False,0.0
2021,5,3130,305,13,2455,13,19,2,31,0,0,0,0,0,0,False,False,False,0,2,2021-10-15T16:12:23.187,0,False,0.0
2021,5,3130,310,13,3586,2,17,10,9,13,4,9,4,9,0,False,False,False,0,3,2021-10-11T11:48:53.17,13,False,4.0
2021,5,3130,315,13,2407,2,7,2,22,40,18,22,18,22,0,False,False,False,0,3,2021-10-15T16:13:24.54,40,False,18.0
2021,5,3130,325,13,3586,3,13,5,4,0,0,0,0,0,0,True,False,False,0,2,2021-10-15T14:10:37.867,0,False,
2021,5,3130,375,19,4282,2,32,5,0,5,5,2,3,2,0,False,False,False,0,3,2021-10-11T12:05:38.283,5,False,3.0
2021,5,3130,380,19,4912,2,12,5,7,7,0,7,0,7,0,False,False,False,0,2,2021-10-12T18:28:54.527,7,False,0.0
2021,5,3130,385,19,4282,13,4,10,7,0,0,0,0,0,0,False,False,False,0,4,2021-10-11T12:10:44.967,0,False,0.0
2021,5,3130,390,19,7175,3,19,6,28,0,0,0,0,0,0,False,False,False,0,2,2021-10-15T16:15:27.2,0,False,
2021,5,3130,395,19,4282,13,17,1,18,0,0,0,0,0,0,False,False,False,0,3,2021-10-11T12:14:45.893,0,False,0.0
2021,5,3130,400,19,4282,2,12,3,6,16,10,13,3,13,0,False,False,False,0,3,2022-02-07T21:05:30.797,16,False,3.0
2021,5,3130,405,19,7175,2,4,10,9,9,0,9,0,9,0,False,False,False,0,3,2022-03-11T19:14:36.053,9,False,0.0
2021,5,3130,445,19,2256,13,4,7,17,0,0,0,0,0,0,False,False,False,0,3,2021-10-11T12:36:40.99,0,False,0.0
2021,5,3130,455,13,2407,2,19,2,28,37,9,37,0,37,6,False,False,False,0,3,2021-10-15T16:16:33.17,37,True,0.0
2021,5,3130,475,19,1212,2,38,10,3,3,0,3,0,3,0,False,False,False,0,1,2021-10-11T12:53:33.223,3,False,0.0
2021,5,3130,480,19,7175,13,12,6,21,0,0,0,0,0,0,False,False,False,0,3,2021-10-11T12:57:46.72,0,False,0.0
2021,5,3130,490,13,4662,2,51,5,-2,7,9,2,5,2,0,True,False,False,0,3,2021-10-15T16:17:12.03,7,False,5.0
2021,5,3130,500,13,876,13,2,9,5,0,0,0,0,0,0,False,False,False,0,2,2021-10-11T13:15:19.157,0,False,0.0
2021,5,3130,520,19,1212,2,48,9,-3,3,6,-2,5,-2,0,False,False,False,1,1,2021-10-11T13:25:42.237,3,False,5.0
2021,5,3130,535,13,4662,2,17,4,13,15,2,13,2,13,0,False,False,False,0,3,2021-10-11T16:12:26.927,15,False,2.0
2021,5,3130,545,13,2455,2,5,5,3,5,2,5,0,5,0,True,False,False,0,3,2021-10-11T13:36:10.987,5,False,0.0
2021,5,3130,555,13,3586,2,50,9,-5,-5,0,-5,0,-5,0,False,False,False,0,3,2021-10-15T15:08:44.797,-5,False,0.0
2021,5,3130,565,19,4282,2,35,9,13,21,8,16,5,16,0,True,False,False,0,3,2021-10-11T13:50:49.037,21,False,5.0
2021,5,3130,575,19,2256,2,2,9,11,20,9,20,0,20,0,False,False,False,0,3,2021-10-15T14:10:37.867,20,False,0.0
2021,5,3130,580,19,2256,2,50,3,-1,1,2,-1,2,-1,0,False,False,False,0,2,2021-10-15T14:10:37.867,1,False,2.0
2021,5,3130,585,19,1212,2,48,10,-3,-3,0,-3,0,-3,0,False,False,False,0,1,2021-10-11T14:04:34.783,-3,False,0.0
2021,5,3130,590,19,4912,2,50,9,-2,4,6,1,3,1,0,False,False,False,0,3,2021-10-15T14:10:37.867,4,False,3.0
2021,5,3130,615,13,3586,2,2,4,10,27,17,21,6,21,0,False,False,False,0,2,2021-10-15T16:18:30.71,27,False,6.0
2021,5,3130,630,13,2407,13,4,6,16,0,0,0,0,0,0,False,False,False,0,2,2021-10-11T14:24:57.63,0,False,0.0
2021,5,3130,635,13,876,2,26,5,3,3,0,3,0,3,0,False,False,False,0,3,2021-10-15T16:19:00.603,3,False,0.0
2021,5,3130,655,19,4282,2,4,10,5,10,5,7,3,7,0,False,False,False,0,4,2021-10-11T14:32:59.14,10,False,3.0
2021,5,3130,680,19,4282,2,7,3,13,13,0,13,0,13,6,False,False,False,0,2,2022-03-11T19:21:15.253,13,True,0.0
2021,5,3130,705,13,876,2,4,10,12,14,2,12,2,12,0,False,False,False,0,2,2021-10-11T14:53:59.283,14,False,2.0
2021,5,3130,715,19,7175,2,6,4,12,24,12,24,0,24,0,False,False,False,0,3,2021-10-11T14:56:30.433,24,True,0.0
2021,5,3130,730,19,1212,2,28,5,0,3,3,3,0,3,0,False,False,False,0,1,2021-10-15T15:09:41.307,3,False,0.0
2021,5,3130,735,19,7173,13,17,1,33,0,0,0,0,0,0,False,False,False,0,3,2021-10-11T16:35:07.783,0,False,
2021,5,3130,750,19,4282,2,6,9,10,10,0,10,0,10,0,False,False,False,0,3,2021-10-11T15:21:24.46,10,False,0.0
2021,5,3130,755,19,7173,13,4,9,10,0,0,0,0,0,0,False,False,False,0,2,2021-10-11T15:23:50.257,0,False,0.0
2021,5,3130,835,13,2407,2,4,10,8,8,0,8,0,8,0,False,True,True,0,2,2021-10-11T15:54:53.73,7,False,0.0
2021,5,3131,15,17,7087,2,12,6,21,21,0,21,0,21,0,False,False,False,0,2,2021-10-15T16:04:04.103,21,False,0.0
2021,5,3131,20,17,4716,13,19,2,20,0,0,0,0,0,0,False,False,False,0,2,2021-10-15T14:14:44.907,0,False,
2021,5,3131,25,17,7024,2,44,3,-4,4,8,4,0,4,0,False,False,False,0,1,2021-10-11T09:22:07.89,4,False,0.0
2021,5,3131,30,17,7087,2,4,5,6,34,28,24,10,24,0,False,False,False,1,2,2021-10-15T15:06:38.503,34,False,10.0
2021,5,3131,45,17,8483,3,2,9,5,0,0,0,0,0,0,False,False,False,0,2,2022-02-16T18:03:21.13,0,False,0.0
2021,5,3131,65,30,4523,2,26,9,6,9,3,7,2,7,0,False,False,False,0,3,2021-10-11T14:03:06.32,9,False,2.0
2021,5,3131,70,30,793,2,3,2,23,26,3,25,1,25,0,False,False,False,0,2,2022-02-16T18:03:59.71,26,False,1.0
2021,5,3131,80,30,4516,2,5,3,14,13,-1,13,0,13,0,True,False,False,0,3,2021-10-11T09:39:03.267,13,False,0.0
2021,5,3131,90,30,4516,13,8,9,10,0,0,0,0,0,0,False,False,False,0,3,2021-10-11T09:42:10.84,0,False,0.0
2021,5,3131,95,30,931,2,16,9,3,10,7,8,2,8,6,False,False,False,0,1,2021-10-12T14:56:14.767,10,False,2.0
2021,5,3131,110,17,7024,2,32,5,1,9,8,6,3,6,0,False,False,False,0,1,2021-10-15T15:12:00.62,9,False,3.0
2021,5,3131,120,17,7024,2,48,10,-5,12,17,9,3,9,0,False,False,False,1,1,2021-10-11T09:48:52.77,12,False,3.0
2021,5,3131,125,17,7618,13,47,5,1,0,0,0,0,0,0,False,False,False,0,1,2022-02-16T18:04:40.353,0,False,0.0
2021,5,3131,130,17,4383,2,4,9,5,10,5,9,1,9,0,False,False,False,0,3,2021-10-11T09:52:02.07,10,False,1.0
2021,5,3131,140,17,8483,13,11,6,26,0,0,0,0,0,0,True,False,False,0,2,2022-01-05T21:51:57.893,0,False,
2021,5,3131,145,17,4484,2,39,4,5,5,0,5,0,5,0,False,False,False,0,4,2021-10-11T09:56:49.533,5,False,0.0
2021,5,3131,150,17,7024,2,11,6,18,24,6,24,0,24,6,True,False,False,0,1,2022-01-05T21:52:14.75,24,True,0.0
2021,5,3131,170,30,37,2,2,9,5,10,5,7,3,7,0,False,False,False,1,2,2021-10-11T10:03:55.483,10,False,3.0
2021,5,3131,180,30,4516,2,50,9,-3,18,21,15,3,15,0,False,False,False,0,2,2021-10-15T14:56:31.57,18,False,3.0
2021,5,3131,185,30,4937,13,11,6,29,0,0,0,0,0,0,False,False,False,0,1,2021-10-15T01:31:09.623,0,False,0.0
2021,5,3131,190,30,4937,2,5,3,6,6,0,6,0,6,0,False,False,False,0,2,2021-10-11T10:12:10.71,6,True,0.0
2021,5,3131,195,30,793,2,35,9,13,15,2,13,2,13,0,False,False,False,0,3,2021-10-11T13:57:30.997,15,False,2.0
2021,5,3131,210,30,4516,13,8,9,9,0,0,0,0,0,0,True,False,False,0,3,2021-10-12T14:57:44.053,0,False,0.0
2021,5,3131,230,17,7024,2,31,9,-2,5,7,3,2,3,0,False,False,False,0,1,2021-10-15T15:12:57.857,5,False,2.0
2021,5,3131,240,17,7087,13,29,3,9,0,0,0,0,0,0,False,False,False,0,2,2021-10-15T17:02:32.467,0,False,0.0
2021,5,3131,260,30,37,2,13,9,7,62,55,62,0,62,6,False,False,False,0,3,2021-10-15T15:15:18.31,62,True,0.0
2021,5,3131,275,17,4752,2,5,5,2,3,1,3,0,3,0,False,False,False,0,3,2022-01-05T21:52:29.943,3,False,0.0
2021,5,3131,280,17,6274,13,17,1,36,0,0,0,0,0,0,False,False,False,0,3,2021-10-11T10:33:49.81,0,False,0.0
2021,5,3131,285,17,6274,2,5,3,7,12,5,11,1,11,0,True,False,False,0,3,2021-10-15T17:05:54.643,12,False,1.0
2021,5,3131,290,17,7087,2,4,10,4,5,1,5,0,5,0,False,False,False,0,3,2022-02-16T18:05:32.487,5,False,0.0
2021,5,3131,295,17,6276,2,46,3,0,2,2,2,0,2,0,True,False,False,0,4,2022-01-05T21:52:49.347,2,False,0.0
2021,5,3131,300,17,8483,13,47,5,3,0,0,0,0,0,0,True,False,False,0,3,2021-10-15T17:09:29.777,0,False,0.0
2021,5,3131,325,30,37,2,18,3,0,6,6,6,0,6,0,False,False,False,0,2,2021-10-11T10:44:30.88,6,False,0.0
2021,5,3131,330,30,793,3,29,2,40,0,0,0,0,0,0,False,False,False,0,2,2021-10-11T10:46:19.767,0,False,0.0
2021,5,3131,335,30,4523,2,39,4,4,10,6,7,3,7,0,False,False,False,0,3,2021-10-11T10:47:52.747,10,False,3.0
2021,5,3131,340,30,37,13,9,6,36,0,0,0,0,0,0,False,False,False,0,2,2021-10-11T10:49:55.707,0,False,0.0
2021,5,3131,345,30,4937,2,16,9,4,10,6,7,3,7,0,False,False,False,0,1,2021-10-11T10:51:23.373,10,False,3.0
2021,5,3131,350,30,4516,13,8,1,45,0,0,0,0,0,0,False,False,False,0,2,2021-10-11T10:54:08.147,0,False,0.0
2021,5,3131,360,30,4937,2,47,5,1,11,10,3,8,3,0,True,False,False,2,4,2021-10-15T17:17:33.673,11,False,8.0
2021,5,3131,365,30,2290,2,8,4,9,12,3,10,2,10,0,False,False,False,0,4,2021-10-15T15:15:47.143,12,False,2.0
2021,5,3131,375,30,4516,2,50,10,-4,3,7,-2,5,-2,0,True,False,False,0,3,2021-10-15T17:19:54.54,3,False,5.0
2021,5,3131,385,30,37,13,2,4,5,0,0,0,0,0,0,False,False,False,0,2,2021-10-15T01:31:56.59,0,False,
2021,5,3131,400,30,37,2,2,10,4,4,0,4,0,4,6,False,False,False,0,3,2021-10-11T11:09:57.477,4,True,0.0
2021,5,3131,415,17,8483,2,26,5,7,21,14,14,7,14,0,False,False,False,1,3,2021-10-15T17:32:39.113,21,False,7.0
2021,5,3131,420,17,7024,2,28,4,-1,6,7,6,0,6,0,False,False,False,0,1,2021-10-11T11:13:51.277,6,False,0.0
2021,5,3131,430,17,4484,2,5,10,6,10,4,8,2,8,0,True,False,False,1,4,2022-01-05T21:50:38.337,10,False,2.0
2021,5,3131,435,17,6274,2,5,3,7,8,1,7,1,7,0,False,False,False,0,3,2021-10-11T11:18:36.27,8,False,1.0
2021,5,3131,450,30,793,2,3,3,12,11,-1,11,0,11,0,False,False,False,0,2,2021-10-11T11:22:20.65,11,False,0.0
2021,5,3131,490,30,793,2,4,4,5,5,0,5,0,5,0,False,False,False,0,3,2021-10-11T11:51:57.19,5,False,0.0
2021,5,3131,505,17,7024,2,45,5,-3,4,7,4,0,4,0,False,False,False,0,1,2021-10-11T11:55:58.01,4,False,0.0
2021,5,3131,520,17,6274,2,35,9,10,23,13,10,13,10,0,False,False,False,1,3,2021-10-15T16:09:37.07,23,False,13.0
2021,5,3131,525,17,4383,13,6,9,13,0,0,0,0,0,0,False,False,False,0,3,2022-02-25T15:15:56.597,0,False,0.0
2021,5,3131,535,17,8483,2,5,5,8,10,2,9,1,9,0,False,False,False,0,3,2022-01-05T21:53:19.643,10,False,1.0
2021,5,3131,540,17,7024,2,47,5,1,2,1,2,0,2,0,False,False,False,0,1,2021-10-15T15:17:01.487,2,False,0.0
2021,5,3131,545,17,7024,2,12,5,1,7,6,5,2,5,0,True,False,False,0,1,2022-02-07T21:06:36.8,7,False,2.0
2021,5,3131,550,17,7087,13,12,2,17,0,0,0,0,0,0,False,False,False,0,3,2022-02-16T18:06:31.427,0,False,
2021,5,3131,555,17,6276,13,12,5,1,0,0,0,0,0,0,False,False,False,0,4,2021-10-11T15:43:09.783,0,False,0.0
2021,5,3131,560,17,7024,2,46,9,0,1,1,1,0,1,6,False,False,False,0,1,2021-10-13T00:50:38.717,1,True,0.0
2021,5,3131,575,30,4523,13,17,1,15,0,0,0,0,0,0,False,False,False,0,4,2021-10-11T12:23:40.187,0,False,0.0
2021,5,3131,580,30,793,13,7,2,25,0,0,0,0,0,0,False,False,False,0,3,2021-10-11T12:26:48.273,0,False,0.0
2021,5,3131,585,30,37,2,2,4,10,12,2,11,1,11,0,False,False,False,0,2,2021-10-11T12:28:47.077,12,False,1.0
2021,5,3131,595,30,4516,2,34,4,-5,6,11,2,4,2,0,True,False,False,0,3,2021-10-11T12:31:39.583,6,False,4.0
2021,5,3131,605,30,4516,2,50,10,-2,14,16,8,6,8,0,False,False,False,1,2,2021-10-11T12:34:24.837,14,False,6.0
2021,5,3131,610,30,4516,2,5,5,9,12,3,11,1,11,0,True,False,False,0,4,2021-10-11T12:36:17.967,12,False,1.0
2021,5,3131,620,30,4937,2,47,10,-1,16,17,3,13,3,0,False,False,False,1,1,2021-10-15T16:10:38.51,16,False,13.0
2021,5,3131,630,30,4516,2,49,9,-2,4,6,2,2,2,0,False,False,False,0,2,2021-10-15T15:09:29.543,4,False,2.0
2021,5,3131,655,17,6274,2,13,10,2,0,-2,0,0,0,0,False,False,False,1,3,2021-10-15T16:11:23.543,0,False,0.0
2021,5,3131,660,17,8483,13,5,5,2,0,0,0,0,0,0,True,False,False,0,3,2021-10-11T13:04:33.023,0,False,0.0
2021,5,3131,665,17,7087,13,19,2,47,0,0,0,0,0,0,False,False,False,0,3,2022-01-05T21:53:48.53,0,False,0.0
2021,5,3131,675,30,6414,2,48,9,-2,15,17,15,0,15,0,False,False,False,0,1,2021-10-11T13:09:01.443,15,False,0.0
2021,5,3131,685,30,37,2,18,3,0,7,7,4,3,4,0,False,False,False,1,2,2021-10-11T13:11:17.3,7,False,3.0
2021,5,3131,690,30,793,2,19,2,33,34,1,33,1,33,6,False,False,False,0,2,2021-10-15T14:14:44.907,34,False,1.0
2021,5,3131,705,17,7618,2,4,9,4,11,7,5,6,5,0,True,False,False,1,1,2022-01-05T21:51:01.82,11,False,6.0
2021,5,3131,710,17,7618,2,44,3,-2,5,7,2,3,2,0,False,False,False,1,1,2021-10-11T13:17:33.237,5,False,3.0
2021,5,3131,715,17,8483,3,4,3,6,0,0,0,0,0,0,False,False,False,0,2,2021-10-15T15:22:09.647,0,False,0.0
2021,5,3131,720,30,7893,2,35,8,19,19,0,19,0,19,0,True,False,False,0,2,2021-10-11T13:21:00.073,19,False,0.0
2021,5,3131,725,30,7893,2,51,9,-2,9,11,7,2,7,0,False,False,False,0,3,2021-10-15T15:09:48.793,9,False,2.0
2021,5,3131,740,30,793,2,17,8,15,22,7,22,0,22,6,False,False,False,1,3,2021-10-15T16:12:28.8,22,True,0.0
2021,5,3131,760,17,6276,2,8,7,18,21,3,20,1,20,0,False,False,False,0,3,2021-10-11T13:57:15.237,21,False,1.0
2021,5,3131,765,17,6274,13,13,4,4,0,0,0,0,0,0,False,False,False,0,3,2021-10-11T13:29:39.54,0,False,0.0
2021,5,3131,785,30,7454,2,51,5,-2,0,2,-1,1,-1,0,False,False,False,0,3,2021-10-15T15:10:22.25,0,False,
2021,5,3131,795,30,931,2,34,4,-5,4,9,3,1,3,0,True,False,False,0,2,2021-10-11T13:37:48.513,4,False,1.0
2021,5,3131,805,30,37,2,29,6,21,23,2,23,0,23,0,False,False,False,0,2,2021-10-15T17:49:19.943,23,False,0.0
2021,5,3131,815,30,7454,3,53,10,-5,0,0,0,0,0,0,False,False,False,0,4,2022-02-16T18:07:26.32,0,False,
2021,5,3131,825,30,7893,2,17,10,10,14,4,12,2,12,0,True,False,False,0,3,2021-10-15T17:52:06.01,14,False,2.0
2021,5,3132,15,12,8377,2,48,4,-2,5,7,2,3,2,0,False,False,False,0,1,2021-10-11T16:08:28.187,5,False,3.0
2021,5,3132,35,12,4537,13,12,5,14,0,0,0,0,0,0,False,False,False,0,1,2021-10-11T16:09:20.75,0,False,0.0
2021,5,3132,45,7,7659,2,4,5,2,2,0,2,0,2,0,False,False,False,0,2,2021-10-11T16:10:03.85,2,False,0.0
2021,5,3132,50,7,8317,2,6,10,3,7,4,6,1,6,0,False,False,False,0,3,2021-10-11T16:10:29.663,7,False,1.0
2021,5,3132,65,12,496,2,35,9,12,15,3,14,1,14,0,False,False,False,0,3,2021-10-11T16:11:15.03,15,False,1.0
2021,5,3132,70,12,556,13,12,2,31,0,0,0,0,0,0,False,False,False,0,2,2021-10-15T18:19:24.543,0,False,0.0
2021,5,3132,75,7,6975,13,4,3,4,0,0,0,0,0,0,False,False,False,0,4,2021-10-11T09:54:28.123,0,False,0.0
2021,5,3132,85,7,2631,2,32,10,2,9,7,7,2,7,0,False,False,False,0,4,2021-10-11T16:12:12.463,9,False,2.0
2021,5,3132,100,12,556,13,5,5,5,0,0,0,0,0,0,False,False,False,0,3,2021-10-11T16:13:32.457,0,False,0.0
2021,5,3132,105,12,4511,13,12,6,33,0,0,0,0,0,0,False,False,False,0,2,2022-02-16T16:50:06.11,0,False,0.0
2021,5,3132,120,7,8317,3,4,2,15,0,0,0,0,0,0,False,False,False,0,2,2021-10-11T16:14:35.793,0,False,0.0
2021,5,3132,125,7,8317,13,9,2,34,0,0,0,0,0,0,False,False,False,0,2,2021-10-15T18:19:04.573,0,False,0.0
2021,5,3132,130,7,4455,2,28,10,2,5,3,3,2,3,0,False,False,False,0,1,2021-10-11T16:15:36.407,5,False,2.0
2021,5,3132,140,7,6975,2,13,3,4,6,2,6,0,6,0,False,False,False,0,4,2021-10-11T16:16:08.697,6,False,0.0
2021,5,3132,145,7,2631,2,31,4,2,7,5,5,2,5,0,False,False,False,0,4,2021-10-11T16:16:32.35,7,False,2.0
2021,5,3132,150,7,4679,2,4,5,2,2,0,2,0,2,0,False,False,False,0,2,2021-10-11T16:16:55.593,2,False,0.0
2021,5,3132,155,7,4455,2,16,10,2,10,8,6,4,6,0,False,False,False,0,1,2021-10-15T19:14:38.863,10,False,4.0
2021,5,3132,160,7,4455,2,47,5,1,4,3,4,0,4,6,False,False,False,0,1,2021-10-11T10:37:12.047,4,True,0.0
2021,5,3132,175,12,556,2,2,9,12,17,5,16,1,16,0,False,False,False,0,2,2021-10-11T10:40:50.263,17,False,1.0
2021,5,3132,190,12,4537,2,51,3,-5,-4,1,-4,0,-4,0,True,False,False,0,1,2021-10-15T18:17:37.493,-4,False,0.0
2021,5,3132,195,12,556,2,6,8,20,34,14,34,0,34,0,False,False,False,1,2,2021-10-11T10:53:00.28,34,False,0.0
2021,5,3132,200,12,467,2,35,5,11,14,3,14,0,14,0,False,False,False,0,4,2021-10-15T19:18:18.337,14,False,0.0
2021,5,3132,205,12,7742,2,48,4,-4,0,4,0,0,0,0,False,False,False,0,1,2022-02-18T21:57:12.78,0,False,0.0
2021,5,3132,210,12,7742,2,46,3,3,12,9,12,0,12,6,False,False,False,0,1,2021-10-11T10:59:31.773,12,False,0.0
2021,5,3132,225,7,7659,2,30,3,2,7,5,5,2,5,0,True,False,False,0,3,2021-10-11T11:03:09.373,7,False,2.0
2021,5,3132,245,12,7742,2,28,9,-3,13,16,9,4,9,0,False,False,False,1,1,2022-02-16T16:50:27.417,13,False,4.0
2021,5,3132,250,12,556,2,35,10,11,24,13,24,0,24,0,False,False,False,0,3,2022-02-16T16:50:47.633,24,False,0.0
2021,5,3132,260,12,6691,2,51,9,-2,-1,1,-1,0,-1,0,False,False,False,0,3,2022-02-16T16:51:10.697,-1,False,0.0
2021,5,3132,270,12,556,13,6,6,17,0,0,0,0,0,0,False,False,False,0,3,2022-02-18T21:56:36.86,0,False,0.0
2021,5,3132,290,7,8317,13,4,5,10,0,0,0,0,0,0,False,False,False,0,2,2021-10-11T11:26:46.687,0,False,0.0
2021,5,3132,310,12,4537,2,47,5,1,3,2,2,1,2,0,False,False,False,0,1,2021-10-11T11:37:15.037,3,False,1.0
2021,5,3132,315,12,556,2,6,4,12,15,3,13,2,13,0,False,False,False,0,2,2021-10-15T19:31:36.683,15,False,2.0
2021,5,3132,325,12,7742,2,46,3,3,24,21,19,5,19,0,False,False,False,0,1,2021-10-11T11:44:38.877,24,False,5.0
2021,5,3132,335,12,4537,2,46,3,0,5,5,4,1,4,0,False,False,False,0,1,2021-10-11T11:46:53.51,5,False,1.0
2021,5,3132,345,12,556,2,8,7,16,22,6,22,0,22,0,False,False,False,0,3,2021-10-11T11:49:17.73,22,False,0.0
2021,5,3132,360,12,556,2,29,3,5,5,0,5,0,5,6,False,False,False,0,2,2022-02-16T16:51:31.743,5,True,0.0
2021,5,3132,375,7,7659,2,4,5,5,5,0,5,0,5,0,False,False,False,0,2,2021-10-11T11:56:56.227,5,False,0.0
2021,5,3132,380,7,8317,2,12,2,44,70,26,70,0,70,6,False,False,False,0,2,2021-10-11T11:59:26.05,70,True,0.0
2021,5,3132,420,7,8317,2,4,10,5,28,23,5,23,5,0,False,False,False,1,2,2021-10-15T18:39:53.713,28,False,23.0
2021,5,3132,425,7,6383,13,12,2,27,0,0,0,0,0,0,False,False,False,0,3,2021-10-15T18:19:45.783,0,False,0.0
2021,5,3132,430,12,6691,2,30,5,1,7,6,5,2,5,0,True,False,False,0,3,2022-02-16T16:51:53.157,7,False,2.0
2021,5,3132,435,12,556,2,45,10,-1,0,1,0,0,0,0,False,False,False,0,3,2022-02-16T16:52:24.107,0,False,0.0
2021,5,3132,440,12,556,2,5,3,5,8,3,7,1,7,0,True,False,False,0,3,2021-10-11T12:42:23.477,8,False,1.0
2021,5,3132,455,12,4511,2,12,5,5,8,3,5,3,5,0,True,False,False,0,3,2022-02-07T21:08:01.703,8,False,3.0
2021,5,3132,475,12,4537,2,44,3,-7,2,9,1,1,1,0,False,False,False,0,1,2021-10-11T13:03:32.613,2,False,1.0
2021,5,3132,480,12,556,2,13,9,2,2,0,2,0,2,0,False,False,False,0,2,2021-10-11T13:05:51.61,2,False,0.0
2021,5,3132,500,7,8317,2,2,9,7,14,7,14,0,14,0,False,False,False,0,2,2021-10-11T13:12:34.523,14,False,0.0
2021,5,3132,510,7,4455,13,5,10,3,0,0,0,0,0,0,False,False,False,0,1,2021-10-11T13:16:19.24,0,False,0.0
2021,5,3132,515,7,3521,2,26,10,2,5,3,4,1,4,0,False,False,False,0,3,2021-10-11T13:17:58.57,5,False,1.0
2021,5,3132,530,7,8317,13,21,2,38,0,0,0,0,0,0,False,False,False,0,2,2021-10-11T13:47:40.92,0,False,0.0
2021,5,3132,535,7,7659,2,5,3,6,8,2,6,2,6,0,False,False,False,0,3,2021-10-15T18:18:48.433,8,False,2.0
2021,5,3132,540,7,7659,3,12,5,10,0,0,0,0,0,0,True,False,False,0,3,2022-02-07T21:08:16.117,0,False,0.0
2021,5,3132,580,12,556,2,21,8,48,59,11,53,6,53,0,False,False,False,0,3,2021-10-11T14:14:47.96,59,False,6.0
2021,5,3132,600,12,496,13,5,3,4,0,0,0,0,0,0,False,False,False,0,3,2021-10-11T14:19:44.91,0,False,0.0
2021,5,3132,620,7,6975,2,53,9,-3,3,6,3,0,3,0,False,False,False,0,4,2021-10-15T18:17:18.623,3,False,0.0
2021,5,3132,630,7,7659,2,5,3,10,10,0,10,0,10,0,False,False,False,0,2,2021-10-11T14:27:43.16,10,False,0.0
2021,5,3132,635,7,3521,2,34,4,-4,2,6,1,1,1,0,True,False,False,0,4,2021-10-11T14:30:14.813,2,False,1.0
2021,5,3132,640,7,8325,2,16,10,4,7,3,5,2,5,0,False,False,False,0,1,2021-10-11T14:32:26.543,7,False,2.0
2021,5,3132,660,7,6975,3,39,4,6,0,0,0,0,0,0,False,False,False,0,4,2021-10-11T15:59:48.5,0,False,0.0
2021,5,3132,665,7,8317,2,29,6,17,19,2,19,0,19,0,False,False,False,0,2,2021-10-11T14:42:30.087,19,False,0.0
2021,5,3132,715,12,556,13,7,2,18,0,0,0,0,0,0,False,False,False,0,3,2021-10-15T17:19:58.923,0,False,0.0
2021,5,3132,725,7,3521,2,39,4,4,9,5,7,2,7,0,False,False,False,0,4,2021-10-11T14:58:43.827,9,False,2.0
2021,5,3132,740,7,8325,2,16,9,4,8,4,8,0,8,0,False,False,False,0,1,2021-10-11T15:02:12.527,8,False,0.0
2021,5,3132,745,7,7659,3,4,5,12,0,0,0,0,0,0,False,False,False,0,2,2021-10-11T15:03:50.61,0,False,0.0
2021,5,3132,750,7,3521,2,4,9,5,8,3,6,2,6,0,False,False,False,0,3,2021-10-11T15:05:51.463,8,False,2.0
2021,5,3132,760,7,4455,2,44,3,-4,5,9,3,2,3,0,False,False,False,0,1,2021-10-11T15:09:23.567,5,False,2.0
2021,5,3132,780,12,556,2,6,4,12,20,8,20,0,20,0,False,False,False,0,2,2021-10-15T19:28:43.963,20,False,0.0
2021,5,3132,805,7,3521,13,4,4,5,0,0,0,0,0,0,False,False,False,0,3,2021-10-11T15:22:35.69,0,False,0.0
2021,5,3132,840,7,8317,2,29,2,20,21,1,21,0,21,0,False,False,False,0,2,2021-10-11T15:31:29.527,21,True,0.0
2021,5,3132,865,12,556,13,2,10,10,0,0,0,0,0,0,False,False,False,0,2,2021-10-11T15:39:06.75,0,False,0.0
2021,5,3132,870,12,467,2,53,10,-1,20,21,9,11,9,0,False,False,False,2,4,2021-10-11T15:41:22.553,20,False,11.0
2021,5,3132,890,12,496,2,6,7,15,15,0,15,0,15,0,False,False,False,0,2,2021-10-11T15:47:19.543,15,False,0.0
2021,5,3133,20,25,7666,2,5,5,9,23,14,10,13,10,0,False,False,False,0,3,2021-10-15T16:12:04.013,23,False,13.0
2021,5,3133,30,25,7081,3,5,10,3,0,0,0,0,0,0,False,False,False,0,1,2021-10-15T13:59:03.597,0,False,0.0
2021,5,3133,35,25,7060,2,19,2,35,50,15,50,0,50,6,False,False,False,0,2,2021-10-15T13:59:03.597,50,True,0.0
2021,5,3133,65,10,4930,2,4,10,4,5,1,5,0,5,0,False,False,False,0,3,2021-10-15T16:12:29.88,5,False,0.0
2021,5,3133,85,25,8422,2,4,10,3,4,1,3,1,3,0,True,False,False,0,3,2021-10-11T12:44:20.473,4,False,1.0
2021,5,3133,90,25,7053,13,11,9,1,0,0,0,0,0,0,True,False,False,0,3,2022-02-16T17:52:18.633,0,False,0.0
2021,5,3133,100,25,609,2,5,3,5,5,0,5,0,5,0,False,False,False,0,3,2021-10-12T15:23:41.36,5,False,0.0
2021,5,3133,140,10,8541,2,17,10,3,10,7,9,1,9,0,False,False,False,0,1,2021-10-15T13:59:03.597,10,False,1.0
2021,5,3133,155,25,7053,2,53,9,-4,13,17,12,1,12,0,False,False,False,0,4,2021-10-11T13:15:49.593,13,False,1.0
2021,5,3133,165,25,8421,2,46,3,1,6,5,5,1,5,0,True,False,False,0,3,2021-10-11T13:18:39.917,6,False,1.0
2021,5,3133,190,25,6277,13,46,9,-1,0,0,0,0,0,0,False,False,False,0,1,2021-10-11T13:25:04.387,0,False,0.0
2021,5,3133,195,25,4583,13,4,9,9,0,0,0,0,0,0,False,False,False,0,2,2021-10-11T13:26:34.427,0,False,0.0
2021,5,3133,215,10,6281,13,6,9,2,0,0,0,0,0,0,False,False,False,0,2,2021-10-11T17:26:36.213,0,False,0.0
2021,5,3133,220,10,6281,3,13,10,2,0,0,0,0,0,0,False,False,False,0,3,2021-10-11T13:32:52.86,0,False,0.0
2021,5,3133,240,25,7666,13,29,6,23,0,0,0,0,0,0,False,False,False,0,2,2021-10-12T15:29:26.523,0,False,0.0
2021,5,3133,255,10,6281,2,3,5,10,9,-1,9,0,9,0,False,False,False,0,2,2021-10-11T17:30:44.32,9,True,0.0
2021,5,3133,285,10,8541,2,50,3,-1,6,7,5,1,5,0,False,False,False,0,2,2021-10-11T13:51:34.24,6,False,1.0
2021,5,3133,305,25,7666,2,2,10,5,59,54,26,33,26,0,True,False,False,1,3,2021-10-15T16:04:10.953,59,False,33.0
2021,5,3133,325,25,8421,13,4,10,3,0,0,0,0,0,0,False,False,False,0,1,2021-10-11T14:07:21.89,0,False,0.0
2021,5,3133,330,25,7060,13,9,2,18,0,0,0,0,0,0,False,False,False,0,2,2021-10-15T15:58:10.643,0,False,
2021,5,3133,355,10,6281,2,4,3,12,14,2,13,1,13,0,False,False,False,0,2,2021-10-11T14:18:47.913,14,False,1.0
2021,5,3133,365,10,6281,2,4,3,6,12,6,11,1,11,0,False,False,False,0,2,2021-10-15T15:51:43.593,12,False,1.0
2021,5,3133,375,10,5069,13,8,1,16,0,0,0,0,0,0,False,False,False,0,3,2021-10-15T16:12:55.703,0,False,0.0
2021,5,3133,380,10,5069,13,2,4,8,0,0,0,0,0,0,False,False,False,0,3,2021-10-15T13:59:03.597,0,False,0.0
2021,5,3133,405,25,7060,2,5,3,4,8,4,7,1,7,0,False,False,False,0,2,2021-10-15T15:52:07.377,8,False,
2021,5,3133,415,25,609,2,4,4,3,5,2,4,1,4,0,False,False,False,0,4,2021-10-11T14:45:16.943,5,False,1.0
2021,5,3133,440,10,6281,2,5,5,13,12,-1,12,0,12,0,False,False,False,0,3,2021-10-11T14:58:13.15,12,True,0.0
2021,5,3133,450,10,282,2,16,4,3,3,0,3,0,3,0,False,False,False,0,1,2021-10-11T15:03:19.547,3,False,0.0
2021,5,3133,460,10,4930,2,6,10,10,12,2,10,2,10,0,False,False,False,0,2,2021-10-15T15:54:04.487,12,False,2.0
2021,5,3133,475,10,7938,13,4,10,6,0,0,0,0,0,0,False,False,False,0,3,2021-10-15T13:59:03.597,0,False,0.0
2021,5,3133,505,25,8421,2,16,10,4,14,10,10,4,10,0,False,False,False,0,1,2021-10-11T15:26:59.637,14,False,4.0
2021,5,3133,510,25,7666,2,2,10,11,14,3,13,1,13,0,False,False,False,0,2,2021-10-12T15:27:43.947,14,False,1.0
2021,5,3133,520,25,7984,3,35,6,19,0,0,0,0,0,0,True,False,False,0,3,2021-10-12T15:27:29.4,0,False,0.0
2021,5,3133,525,25,8422,2,5,3,3,3,0,3,0,3,0,True,False,False,0,3,2021-10-12T15:33:54.81,3,False,0.0
2021,5,3133,545,25,6259,13,35,7,23,0,0,0,0,0,0,False,False,False,0,3,2021-10-11T15:40:37.02,0,False,0.0
2021,5,3133,555,25,8421,13,5,3,3,0,0,0,0,0,0,False,False,False,0,1,2021-10-15T13:59:03.597,0,False,0.0
2021,5,3133,560,25,8421,13,16,9,2,0,0,0,0,0,0,False,False,False,0,1,2021-10-11T15:49:32.2,0,False,0.0
2021,5,3133,570,25,7666,2,17,1,18,18,0,18,0,18,6,False,False,False,0,3,2021-10-11T15:52:02.553,18,True,0.0
2021,5,3133,585,10,4930,2,3,5,12,19,7,14,5,14,0,False,False,False,0,2,2021-10-11T15:54:39.013,19,False,5.0
2021,5,3133,600,10,4930,2,26,10,5,10,5,9,1,9,0,False,False,False,0,3,2021-10-15T13:59:03.597,10,False,1.0
2021,5,3133,610,10,4930,2,26,5,3,5,2,4,1,4,0,False,False,False,0,3,2021-10-15T15:54:20.933,5,False,1.0
2021,5,3133,625,10,6840,13,4,9,5,0,0,0,0,0,0,False,False,False,0,4,2021-10-11T16:11:44.32,0,False,0.0
2021,5,3133,630,10,6840,2,31,9,6,9,3,8,1,8,0,False,False,False,0,4,2021-10-11T16:13:34.173,9,False,1.0
2021,5,3133,635,10,6281,2,7,6,19,25,6,25,0,25,0,False,False,False,0,3,2021-10-11T16:15:03.12,25,False,0.0
2021,5,3133,640,10,4930,13,26,3,3,0,0,0,0,0,0,False,False,False,0,2,2021-10-11T16:16:36.977,0,False,0.0
2021,5,3133,660,10,7938,2,30,5,2,2,0,2,0,2,6,False,False,False,0,3,2021-10-11T16:24:39.787,2,True,0.0
2021,5,3133,690,25,6259,2,13,10,2,1,-1,1,0,1,0,False,False,False,0,3,2021-10-11T16:33:03.67,1,False,0.0
2021,5,3133,705,10,4930,2,6,4,13,15,2,13,2,13,0,False,False,False,0,3,2021-10-15T15:54:59.357,15,False,2.0
2021,5,3133,710,10,6281,2,4,10,9,9,0,9,0,9,0,False,False,False,0,2,2021-10-11T16:44:51.827,9,False,0.0
2021,5,3133,720,10,6281,2,19,6,37,39,2,39,0,39,6,False,False,False,0,2,2021-10-11T16:47:45.58,39,True,0.0
2021,5,3133,740,25,7060,2,2,10,3,22,19,20,2,20,0,False,False,False,1,2,2022-02-16T17:54:56.3,22,False,2.0
2021,5,3133,745,25,7666,2,5,3,3,16,13,4,12,4,0,False,False,False,1,2,2022-02-16T17:55:19.937,16,False,12.0
2021,5,3133,795,10,4930,2,8,10,12,23,11,18,5,18,0,False,False,False,0,3,2021-10-11T17:04:11.52,23,False,5.0
2021,5,3133,800,10,6840,2,4,4,6,6,0,6,0,6,0,False,False,False,0,4,2021-10-11T17:05:31.86,6,False,0.0
2021,5,3133,810,10,8541,2,12,4,3,9,6,8,1,8,0,False,False,False,0,1,2021-10-11T17:07:31.4,9,False,1.0
2021,5,3133,815,10,6840,2,4,10,5,5,0,5,0,5,0,False,False,False,0,3,2021-10-11T17:09:02.863,5,False,0.0
2021,5,3133,820,10,6281,13,19,6,30,0,0,0,0,0,0,False,False,False,0,2,2022-02-18T23:26:21.39,0,False,0.0
2021,5,3133,825,10,7938,2,7,6,23,23,0,23,0,23,0,False,False,False,0,2,2021-10-11T17:13:05.46,23,True,0.0
2021,5,3133,830,10,4930,13,7,5,9,0,0,0,0,0,0,False,False,False,0,3,2021-10-11T17:14:41.907,0,False,0.0
2021,5,3133,835,10,282,2,46,3,4,6,2,6,0,6,0,False,False,False,0,1,2021-10-11T17:16:21.103,6,False,0.0
2021,5,3133,840,10,7082,13,7,5,3,0,0,0,0,0,0,False,False,False,0,3,2021-10-15T13:59:03.597,0,False,0.0
2021,5,3133,845,10,6281,13,5,3,3,0,0,0,0,0,0,False,False,False,0,2,2021-10-11T17:19:37.49,0,False,0.0
2021,5,3134,10,24,7798,3,4,5,7,0,0,0,0,0,0,False,False,False,0,2,2021-10-11T09:13:50.117,0,False,0.0
2021,5,3134,15,24,6937,2,48,10,-9,-7,2,-7,0,-7,0,False,False,False,0,1,2021-10-11T09:15:39.153,-7,False,0.0
2021,5,3134,20,24,6937,2,51,9,-6,6,12,4,2,4,0,True,False,False,0,1,2021-10-11T09:17:29.5,6,False,2.0
2021,5,3134,35,5,6282,2,46,3,4,6,2,6,0,6,0,False,False,False,0,3,2021-10-11T09:25:59.083,6,True,0.0
2021,5,3134,60,5,8409,3,6,10,3,0,0,0,0,0,0,False,False,False,0,1,2021-10-11T09:34:06.117,0,False,0.0
2021,5,3134,80,24,894,13,16,9,5,0,0,0,0,0,0,False,False,False,0,4,2022-02-18T21:49:31.98,0,False,0.0
2021,5,3134,90,24,7798,13,13,9,3,0,0,0,0,0,0,False,False,False,0,3,2021-10-11T09:42:14.34,0,False,0.0
2021,5,3134,110,5,5220,13,9,2,23,0,0,0,0,0,0,False,False,False,0,2,2021-10-15T19:55:32.097,0,False,0.0
2021,5,3134,115,24,7800,2,50,10,-3,-5,-2,-5,0,-5,0,False,False,False,1,3,2022-02-16T16:41:41.943,-5,False,0.0
2021,5,3134,120,24,6937,2,48,9,-6,3,9,-3,6,-3,0,False,False,False,0,1,2021-10-15T20:01:41.493,3,False,6.0
2021,5,3134,125,24,8509,2,12,10,10,10,0,10,0,10,0,False,False,False,0,2,2021-10-11T09:54:27.88,10,False,0.0
2021,5,3134,130,24,8509,2,2,9,2,2,0,2,0,2,0,False,False,False,0,2,2021-10-15T19:20:27.05,2,True,
2021,5,3134,150,5,6425,2,8,4,12,13,1,13,0,13,0,False,False,False,0,4,2021-10-15T18:54:12.84,13,False,0.0
2021,5,3134,170,5,5220,2,2,4,6,14,8,13,1,13,0,True,False,False,0,3,2021-10-11T10:08:08.873,14,False,1.0
2021,5,3134,180,5,3477,13,13,9,5,0,0,0,0,0,0,True,False,False,0,2,2021-10-11T10:12:08.287,0,False,0.0
2021,5,3134,185,5,8408,2,4,9,5,5,0,5,0,5,6,False,False,False,0,3,2021-10-15T20:39:48.763,5,True,0.0
2021,5,3134,200,24,8509,3,2,4,7,0,0,0,0,0,0,False,False,False,0,3,2021-10-11T10:19:27.737,0,False,0.0
2021,5,3134,205,24,7798,2,4,9,9,8,-1,8,0,8,0,False,False,False,0,3,2021-10-11T10:20:55.453,8,False,0.0
2021,5,3134,210,24,8513,2,5,10,3,8,5,5,3,5,0,False,False,False,0,3,2021-10-11T10:22:50.043,8,False,3.0
2021,5,3134,225,24,894,13,4,10,5,0,0,0,0,0,0,False,False,False,0,4,2021-10-11T10:26:57.223,0,False,0.0
2021,5,3134,245,5,8406,2,51,10,-3,6,9,4,2,4,0,False,False,False,0,3,2021-10-11T10:31:50.653,6,False,2.0
2021,5,3134,250,5,5220,2,6,10,12,12,0,12,0,12,0,False,False,False,0,3,2021-10-11T10:33:31.947,12,False,0.0
2021,5,3134,260,5,3477,13,23,8,47,0,0,0,0,0,0,False,False,False,0,3,2021-10-15T18:54:12.84,0,False,0.0
2021,5,3134,265,5,8406,13,7,6,16,0,0,0,0,0,0,False,False,False,0,3,2021-10-11T10:38:47.63,0,False,0.0
2021,5,3134,280,24,6937,2,45,5,-6,2,8,0,2,0,0,False,False,False,1,1,2021-10-11T10:41:57.613,2,False,2.0
2021,5,3134,290,24,894,2,4,10,3,7,4,5,2,5,0,False,False,False,0,3,2021-10-11T10:44:12.19,7,False,2.0
2021,5,3134,300,24,6937,2,51,9,-6,2,8,-2,4,-2,0,False,False,False,0,1,2021-10-15T18:54:12.84,2,False,4.0
2021,5,3134,305,24,8513,3,12,3,4,0,0,0,0,0,0,False,False,False,0,1,2022-02-07T21:10:40.507,0,False,0.0
2021,5,3134,340,24,7800,2,51,9,-4,0,4,-1,1,-1,0,False,False,False,0,3,2022-02-25T17:21:56.903,0,False,1.0
2021,5,3134,345,24,6373,2,12,5,10,10,0,10,0,10,0,False,False,False,0,4,2021-10-11T11:02:15.257,10,True,
2021,5,3134,350,24,7798,2,50,10,-2,1,3,0,1,0,0,False,False,False,0,2,2022-02-16T16:43:00.973,1,False,1.0
2021,5,3134,360,5,8409,2,28,4,2,11,9,8,3,8,0,False,False,False,0,1,2021-10-11T11:08:34.47,11,False,3.0
2021,5,3134,375,5,6425,2,53,10,-4,-1,3,-3,2,-3,0,False,False,False,0,4,2021-10-11T11:14:28.9,-1,False,2.0
2021,5,3134,420,5,8409,2,6,10,3,8,5,6,2,6,0,False,False,False,0,1,2021-10-11T11:30:38.7,8,False,2.0
2021,5,3134,430,5,3477,2,5,3,5,5,0,5,0,5,0,False,False,False,0,2,2021-10-11T15:03:12.567,5,False,0.0
2021,5,3134,445,24,7798,2,4,5,10,15,5,15,0,15,0,False,False,False,1,2,2021-10-15T20:03:29.743,15,True,0.0
2021,5,3134,450,24,8509,2,6,1,17,17,0,17,0,17,0,False,False,False,0,2,2021-10-11T11:38:19.717,17,False,0.0
2021,5,3134,460,24,7798,13,12,2,52,0,0,0,0,0,0,False,False,False,0,2,2022-02-07T21:12:22.937,0,False,
2021,5,3134,465,24,8509,2,6,10,5,7,2,5,2,5,0,False,False,False,0,2,2021-10-11T11:42:15.35,7,False,2.0
2021,5,3134,475,24,894,13,5,5,12,0,0,0,0,0,0,False,False,False,0,3,2021-10-15T20:43:02.783,0,False,0.0
2021,5,3134,495,5,8408,2,5,3,4,7,3,5,2,5,0,True,False,False,0,3,2021-10-11T11:58:16.547,7,False,2.0
2021,5,3134,505,5,8409,2,46,3,0,0,0,0,0,0,0,False,False,False,0,1,2021-10-11T12:01:15.83,0,False,0.0
2021,5,3134,510,5,6282,13,32,3,-6,0,0,0,0,0,0,False,False,False,0,1,2021-10-15T18:54:12.84,0,False,0.0
2021,5,3134,515,5,3477,13,4,10,9,0,0,0,0,0,0,False,False,False,0,2,2021-10-11T12:05:50.38,0,False,0.0
2021,5,3134,535,24,8509,2,2,4,8,11,3,10,1,10,0,True,True,True,0,2,2021-10-15T20:46:05.21,11,False,1.0
2021,5,3134,560,24,894,13,11,6,39,0,0,0,0,0,0,False,False,False,0,4,2021-10-15T20:46:51.3,0,False,0.0
2021,5,3134,565,5,5220,2,50,9,1,7,6,6,1,6,0,False,False,False,0,2,2021-10-15T19:57:33.447,7,False,1.0
2021,5,3134,575,5,5220,13,4,8,16,0,0,0,0,0,0,False,False,False,0,2,2021-10-15T19:56:00.4,0,False,0.0
2021,5,3134,580,24,6373,2,46,3,2,8,6,2,6,2,0,False,False,False,2,4,2021-10-15T20:07:00.147,8,False,6.0
2021,5,3134,600,5,8409,2,28,4,2,5,3,2,3,2,0,False,False,False,0,1,2021-10-15T18:54:12.84,5,False,3.0
2021,5,3134,605,5,6425,2,8,1,21,24,3,22,2,22,0,False,False,False,0,4,2021-10-11T12:38:54.917,24,False,2.0
2021,5,3134,615,5,5220,2,46,3,1,2,1,1,1,1,0,False,False,False,0,1,2021-10-15T18:54:12.84,2,False,1.0
2021,5,3134,620,5,8408,13,12,10,9,0,0,0,0,0,0,False,False,False,0,4,2021-10-15T20:48:19.42,0,False,0.0
2021,5,3134,635,24,8509,2,2,9,4,13,9,8,5,8,0,False,False,False,0,2,2021-10-11T12:50:35.283,13,False,5.0
2021,5,3134,640,24,8509,2,49,3,-2,5,7,1,4,1,0,False,False,False,0,2,2021-10-11T12:57:21.39,5,False,4.0
2021,5,3134,650,24,8509,13,19,6,20,0,0,0,0,0,0,False,False,False,0,2,2022-02-16T16:44:33.12,0,False,0.0
2021,5,3134,655,24,7800,2,8,6,41,53,12,49,4,49,0,False,False,False,0,3,2021-10-15T18:54:12.84,53,False,4.0
2021,5,3134,660,24,8509,13,2,9,10,0,0,0,0,0,0,False,False,False,0,3,2021-10-11T15:01:39.42,0,False,
2021,5,3134,695,5,8406,2,6,4,8,8,0,8,0,8,0,False,False,False,0,2,2021-10-20T16:06:10.227,8,True,0.0
2021,5,3134,700,5,8409,2,48,3,-5,9,14,2,7,2,0,True,False,False,2,1,2021-10-12T16:28:41.36,9,False,7.0
2021,5,3134,710,5,6425,2,13,10,1,4,3,3,1,3,0,False,False,False,0,4,2021-10-11T13:27:13.807,4,False,1.0
2021,5,3134,715,5,5220,2,2,10,6,7,1,6,1,6,0,False,False,False,0,2,2021-10-11T13:29:32.857,7,False,1.0
2021,5,3134,760,24,7800,13,12,2,23,0,0,0,0,0,0,False,False,False,0,3,2022-02-07T21:12:41.793,0,False,
2021,5,3134,765,24,8509,2,3,5,12,14,2,11,3,11,0,False,False,False,2,2,2021-10-15T20:05:58.843,14,False,3.0
2021,5,3134,785,24,8513,13,11,6,18,0,0,0,0,0,0,False,False,False,0,1,2021-10-11T13:58:58.26,0,False,0.0
2021,5,3134,790,24,894,13,6,4,6,0,0,0,0,0,0,True,False,False,0,3,2021-10-11T14:00:48.517,0,False,0.0
2021,5,3134,805,5,3477,13,5,5,4,0,0,0,0,0,0,False,False,False,0,3,2021-10-11T15:03:30.077,0,False,0.0
2021,5,3134,820,24,6373,2,6,8,16,20,4,19,1,19,0,False,False,False,0,3,2021-10-11T14:20:15.343,20,False,1.0
2021,5,3134,825,24,6373,3,46,3,3,0,0,0,0,0,0,False,False,False,0,4,2021-10-11T14:22:58.927,0,False,0.0
2021,5,3134,845,5,8408,3,2,9,6,0,0,0,0,0,0,True,False,False,0,3,2021-10-15T19:55:15.92,0,False,0.0
2021,5,3134,850,5,6425,13,4,9,5,0,0,0,0,0,0,False,False,False,0,4,2021-10-11T14:30:25.957,0,False,0.0
2021,5,3134,860,5,3477,2,8,8,22,25,3,23,2,23,0,False,False,False,0,2,2021-10-11T14:32:38.293,25,False,2.0
2021,5,3134,865,5,3477,13,3,5,10,0,0,0,0,0,0,False,False,False,0,2,2021-10-11T14:33:59.37,0,False,
2021,5,3134,870,5,3477,13,3,3,12,0,0,0,0,0,0,False,False,False,0,2,2021-10-15T19:56:13.117,0,False,0.0
2021,5,3135,15,15,914,13,19,6,21,0,0,0,0,0,0,False,False,False,0,2,2021-10-15T13:59:46.57,0,False,0.0
2021,5,3135,20,15,5152,2,31,10,4,5,1,5,0,5,0,False,True,True,0,3,2021-10-15T15:31:16.1,5,False,0.0
2021,5,3135,75,31,6793,2,2,9,6,10,4,9,1,9,0,False,False,False,0,2,2021-10-12T18:51:53.91,10,False,1.0
2021,5,3135,90,31,6793,13,6,10,11,0,0,0,0,0,0,True,False,False,0,2,2021-10-12T18:53:45.39,0,False,0.0
2021,5,3135,100,31,6724,2,2,9,7,12,5,11,1,11,0,False,False,False,0,3,2021-10-11T03:24:37.787,12,False,1.0
2021,5,3135,110,15,5152,2,22,6,16,18,2,17,1,17,0,False,False,False,0,4,2021-10-15T15:31:24.053,18,False,1.0
2021,5,3135,115,15,8099,2,46,3,0,6,6,0,6,0,0,False,False,False,2,1,2021-10-15T15:04:23.293,6,False,
2021,5,3135,120,15,957,2,4,3,5,5,0,5,0,5,0,False,False,False,0,2,2022-02-16T17:08:50.867,5,False,0.0
2021,5,3135,130,15,8099,2,44,3,-4,-2,2,-3,1,-3,0,False,False,False,0,1,2021-10-11T03:38:08.74,-2,False,1.0
2021,5,3135,150,31,6793,13,13,5,6,0,0,0,0,0,0,False,False,False,0,2,2021-10-11T03:45:10.43,0,False,0.0
2021,5,3135,155,31,4545,2,38,4,3,25,22,25,0,25,0,False,False,False,0,3,2021-10-11T03:49:08.433,25,False,0.0
2021,5,3135,160,31,6793,13,6,7,17,0,0,0,0,0,0,False,False,False,0,2,2021-10-11T03:51:02.243,0,False,0.0
2021,5,3135,170,31,4875,13,13,4,9,0,0,0,0,0,0,False,False,False,0,3,2021-10-15T15:31:32.47,0,False,
2021,5,3135,185,31,4070,2,5,3,10,10,0,10,0,10,0,True,False,False,0,2,2021-10-12T18:53:57.743,10,False,0.0
2021,5,3135,190,31,6793,2,13,9,3,22,19,22,0,22,0,False,False,False,0,2,2021-10-15T15:05:44.043,22,False,0.0
2021,5,3135,230,15,914,2,7,2,23,25,2,25,0,25,0,False,False,False,0,2,2021-10-15T15:31:42.26,25,False,0.0
2021,5,3135,235,15,4487,2,30,5,0,7,7,7,0,7,0,False,False,False,0,3,2021-10-11T04:13:54.887,7,False,0.0
2021,5,3135,240,15,957,2,4,3,10,22,12,10,12,10,0,False,False,False,1,2,2021-10-15T14:00:51.203,22,False,12.0
2021,5,3135,260,15,4835,2,7,3,1,1,0,1,0,1,6,False,False,False,0,3,2021-10-15T13:44:45.213,1,True,0.0
2021,5,3135,275,31,4070,2,6,1,17,22,5,19,3,19,0,False,False,False,0,3,2022-02-18T22:45:34.163,22,False,3.0
2021,5,3135,285,31,4875,2,46,3,2,8,6,8,0,8,0,True,False,False,0,2,2021-10-15T15:06:56.12,8,False,0.0
2021,5,3135,310,31,2901,2,4,10,8,14,6,14,0,14,6,False,False,False,0,3,2021-10-15T15:07:52.47,14,True,0.0
2021,5,3135,335,15,8343,2,46,3,3,13,10,8,5,8,0,True,False,False,0,4,2021-10-12T21:48:09.81,13,False,5.0
2021,5,3135,345,15,4487,13,19,1,18,0,0,0,0,0,0,False,False,False,0,3,2021-10-15T15:32:05.877,0,False,0.0
2021,5,3135,355,15,4487,13,13,3,6,0,0,0,0,0,0,False,False,False,0,2,2021-10-11T11:39:32.727,0,False,0.0
2021,5,3135,380,31,3911,2,7,2,19,26,7,24,2,24,0,False,False,False,0,3,2021-10-11T11:45:46.253,26,False,2.0
2021,5,3135,385,31,6724,13,7,2,16,0,0,0,0,0,0,False,False,False,0,3,2021-10-11T11:47:09.93,0,False,0.0
2021,5,3135,415,15,5152,2,32,5,5,7,2,6,1,6,0,False,False,False,0,3,2021-10-11T11:51:56.947,7,False,1.0
2021,5,3135,430,15,957,2,4,4,12,13,1,12,1,12,0,False,False,False,0,3,2021-10-11T11:56:06.2,13,False,1.0
2021,5,3135,470,31,4070,2,13,9,3,20,17,5,15,5,0,False,False,False,0,3,2021-10-15T14:08:45.4,20,False,15.0
2021,5,3135,490,31,6793,2,47,5,6,6,0,6,0,6,0,False,False,False,0,2,2021-10-11T12:19:36.897,6,False,0.0
2021,5,3135,500,31,2865,13,43,4,8,0,0,0,0,0,0,True,False,False,0,4,2021-10-15T15:32:40.2,0,False,0.0
2021,5,3135,530,15,4487,2,50,5,-3,7,10,6,1,6,0,False,False,False,0,2,2021-10-15T13:44:45.213,7,False,1.0
2021,5,3135,555,31,4070,13,4,10,5,0,0,0,0,0,0,False,False,False,0,2,2022-02-14T19:27:54.267,0,False,0.0
2021,5,3135,560,31,6724,2,38,4,1,7,6,6,1,6,0,False,False,False,0,3,2021-10-15T15:46:16.437,7,False,1.0
2021,5,3135,610,15,914,13,19,6,38,0,0,0,0,0,0,False,False,False,0,3,2022-02-18T22:44:48.79,0,False,0.0
2021,5,3135,615,15,5152,2,53,4,-3,18,21,3,15,3,0,False,False,False,0,4,2021-10-11T13:08:53.74,18,False,15.0
2021,5,3135,645,15,5152,13,13,9,5,0,0,0,0,0,0,True,False,False,0,3,2021-10-12T21:55:00.22,0,False,
2021,5,3135,665,31,4070,13,13,3,2,0,0,0,0,0,0,False,False,False,0,2,2021-10-11T13:46:18.367,0,False,0.0
2021,5,3135,675,31,4545,2,48,10,-5,1,6,1,0,1,0,False,False,False,0,1,2021-10-15T14:09:08.92,1,False,0.0
2021,5,3135,685,15,7591,2,22,7,19,58,39,23,35,23,0,False,False,False,5,2,2021-10-15T14:36:01.54,58,False,35.0
2021,5,3135,690,15,5152,13,35,5,12,0,0,0,0,0,0,False,False,False,0,4,2021-10-11T13:56:53.923,0,False,0.0
2021,5,3135,700,15,4487,13,7,3,9,0,0,0,0,0,0,False,False,False,0,3,2021-10-11T14:01:17.083,0,False,
2021,5,3135,705,15,7591,13,26,3,3,0,0,0,0,0,0,False,False,False,0,2,2021-10-11T14:03:23.613,0,False,0.0
2021,5,3135,710,15,914,13,5,10,5,0,0,0,0,0,0,False,False,False,0,2,2021-10-15T15:13:43.703,0,False,0.0
2021,5,3135,750,31,6724,2,2,9,8,14,6,12,2,12,0,False,False,False,0,3,2021-10-11T14:23:11.063,14,False,2.0
2021,5,3135,760,15,8099,13,47,10,0,0,0,0,0,0,0,False,False,False,0,1,2021-10-11T14:32:17.77,0,False,
2021,5,3135,765,15,957,2,4,10,9,9,0,9,0,9,0,False,False,False,0,3,2021-10-15T13:44:45.213,9,False,0.0
2021,5,3135,780,15,5152,2,13,3,4,4,0,4,0,4,0,True,False,False,0,3,2021-10-11T14:39:21.63,4,False,0.0
2021,5,3135,785,15,5152,13,35,3,13,0,0,0,0,0,0,False,False,False,0,3,2021-10-15T15:33:09.907,0,False,0.0
2021,5,3135,835,15,4487,2,2,4,7,8,1,8,0,8,0,False,False,False,0,3,2021-10-11T15:16:54.493,8,False,0.0
2021,5,3135,840,15,4487,2,13,3,4,4,0,4,0,4,0,False,False,False,0,3,2021-10-11T14:54:09.263,4,False,0.0
2021,5,3135,845,15,957,2,6,9,5,5,0,5,0,5,0,False,False,False,0,2,2021-10-11T14:55:57.92,5,False,0.0
2021,5,3135,850,15,5152,2,2,4,6,12,6,10,2,10,0,False,False,False,0,3,2021-10-11T14:57:02.723,12,False,2.0
2021,5,3135,860,15,4886,2,31,4,1,19,18,17,2,17,0,False,False,False,0,1,2021-10-15T15:33:19.81,19,False,2.0
2021,5,3135,870,15,4487,2,5,3,3,7,4,7,0,7,0,False,False,False,0,3,2021-10-15T13:44:45.213,7,True,0.0
2021,5,3135,880,15,4487,2,5,3,5,8,3,8,0,8,0,False,False,False,0,3,2021-10-11T15:16:37.157,8,False,0.0
2021,5,3135,885,15,7591,13,9,3,6,0,0,0,0,0,0,False,False,False,0,2,2021-10-11T15:02:56.87,0,False,0.0
2021,5,3135,890,15,914,13,2,4,6,0,0,0,0,0,0,False,False,False,0,2,2021-10-11T15:04:29.253,0,False,0.0
2021,5,3136,10,26,309,2,18,5,-2,4,6,4,0,4,0,False,False,False,0,2,2021-10-15T22:19:52.843,4,False,0.0
2021,5,3136,15,26,4619,13,5,5,14,0,0,0,0,0,0,False,False,False,0,3,2021-10-15T22:20:36.527,0,False,0.0
2021,5,3136,20,26,7453,13,13,9,4,0,0,0,0,0,0,False,False,False,0,3,2022-02-18T23:01:36.277,0,False,0.0
2021,5,3136,30,8,4976,2,47,5,2,9,7,5,4,5,0,True,False,False,0,4,2021-10-15T21:56:32.87,9,False,4.0
2021,5,3136,50,8,4976,2,5,2,19,22,3,22,0,22,0,False,False,False,0,3,2021-10-12T14:59:25.95,22,False,0.0
2021,5,3136,100,26,4616,2,48,5,-3,18,21,18,0,18,0,False,False,False,0,1,2022-02-16T17:25:28.213,18,False,0.0
2021,5,3136,105,26,4619,2,2,9,6,6,0,6,0,6,0,False,False,False,0,2,2021-10-12T02:10:04.757,6,False,0.0
2021,5,3136,110,26,4619,2,4,3,4,8,4,6,2,6,0,False,False,False,0,2,2021-10-11T14:24:23.62,8,False,2.0
2021,5,3136,120,26,8552,13,6,9,12,0,0,0,0,0,0,False,False,False,0,2,2021-10-11T14:28:32.947,0,False,0.0
2021,5,3136,140,26,7491,2,32,5,2,22,20,20,2,20,6,False,False,False,0,4,2021-10-11T14:38:58.497,22,False,2.0
2021,5,3136,155,8,4976,2,53,10,-3,31,34,31,0,31,0,False,False,False,0,4,2022-02-16T17:25:47.983,31,False,0.0
2021,5,3136,170,8,7651,2,30,3,0,12,12,12,0,12,0,False,False,False,0,3,2021-10-11T15:04:19.003,12,True,0.0
2021,5,3136,190,8,3883,13,5,3,12,0,0,0,0,0,0,False,False,False,0,3,2021-10-11T15:15:18.757,0,False,
2021,5,3136,200,8,3606,2,5,5,6,7,1,7,0,7,6,False,False,False,0,3,2021-10-11T15:38:51.953,7,True,0.0
2021,5,3136,220,26,4619,13,2,9,4,0,0,0,0,0,0,False,False,False,0,2,2022-02-16T17:26:21.623,0,False,0.0
2021,5,3136,225,26,309,13,5,3,4,0,0,0,0,0,0,False,False,False,0,2,2021-10-15T23:03:56.633,0,False,0.0
2021,5,3136,230,26,4619,2,8,1,37,72,35,72,0,72,6,False,False,False,0,2,2022-02-18T23:04:43.553,72,True,0.0
2021,5,3136,245,8,7651,2,5,2,15,42,27,15,27,15,0,False,False,False,1,3,2021-10-15T19:58:36.967,42,False,27.0
2021,5,3136,260,8,4976,2,12,4,-3,1,4,1,0,1,0,False,False,False,0,4,2021-10-11T16:08:07.133,1,False,0.0
2021,5,3136,265,8,7651,2,6,9,2,2,0,2,0,2,0,False,False,False,0,2,2021-10-11T16:09:58.133,2,False,0.0
2021,5,3136,270,8,4976,2,38,9,2,5,3,5,0,5,0,False,False,False,0,3,2021-10-15T23:04:17.98,5,False,0.0
2021,5,3136,280,8,1067,3,13,9,2,0,0,0,0,0,0,True,False,False,0,3,2021-10-12T15:06:22.33,0,False,0.0
2021,5,3136,290,26,4619,13,19,6,39,0,0,0,0,0,0,False,False,False,0,2,2022-02-16T17:26:40.52,0,False,0.0
2021,5,3136,340,8,3606,2,9,2,15,16,1,14,2,14,0,False,False,False,0,2,2021-10-11T16:35:27.623,16,False,2.0
2021,5,3136,385,26,4616,2,48,9,-6,8,14,-5,13,-5,0,False,True,True,2,1,2021-10-15T22:02:06.997,7,False,13.0
2021,5,3136,390,8,6439,2,48,9,-3,9,12,7,2,7,0,False,False,False,0,1,2021-10-11T17:06:02.65,9,False,2.0
2021,5,3136,405,8,5053,3,28,10,1,0,0,0,0,0,0,False,False,False,0,1,2022-02-16T17:27:32.457,0,False,0.0
2021,5,3136,430,8,7651,2,5,3,5,6,1,6,0,6,0,False,False,False,0,3,2021-10-11T17:28:34.57,6,False,0.0
2021,5,3136,435,8,7651,2,4,5,8,8,0,8,0,8,0,False,False,False,0,2,2021-10-15T19:58:36.967,8,False,0.0
2021,5,3136,465,26,309,2,49,9,-3,-1,2,-1,0,-1,0,False,False,False,0,2,2021-10-15T23:04:35.477,-1,False,0.0
2021,5,3136,470,26,7491,2,47,5,3,7,4,7,0,7,0,False,False,False,0,4,2021-10-15T22:25:26.93,7,False,0.0
2021,5,3136,480,26,4619,2,3,3,7,7,0,7,0,7,0,False,False,False,0,2,2021-10-15T22:25:47.703,7,False,0.0
2021,5,3136,495,26,8552,2,5,3,7,7,0,7,0,7,0,False,False,False,0,3,2022-02-16T17:27:52.177,7,False,0.0
2021,5,3136,500,26,7491,13,11,5,10,0,0,0,0,0,0,False,False,False,0,4,2021-10-15T22:26:15.233,0,False,
2021,5,3136,510,26,4619,13,24,6,22,0,0,0,0,0,0,False,False,False,0,2,2021-10-15T23:05:07.7,0,False,0.0
2021,5,3136,515,26,309,3,29,5,14,0,0,0,0,0,0,False,False,False,0,2,2021-10-11T18:24:42.75,0,False,0.0
2021,5,3136,520,26,309,2,5,3,12,12,0,12,0,12,0,False,False,False,0,3,2021-10-15T22:27:04.363,12,True,0.0
2021,5,3136,550,8,1067,2,29,5,13,13,0,13,0,13,0,False,False,False,0,2,2021-10-12T15:04:35.46,13,False,0.0
2021,5,3136,570,8,5053,2,32,5,0,11,11,11,0,11,0,True,False,False,0,3,2021-10-15T23:07:22.213,11,False,0.0
2021,5,3136,580,26,4619,2,18,5,-1,7,8,7,0,7,0,False,False,False,0,3,2021-10-15T21:51:33.927,7,False,0.0
2021,5,3136,590,26,4619,2,4,9,5,13,8,10,3,10,0,False,False,False,0,3,2021-10-15T23:07:59.213,13,False,3.0
2021,5,3136,600,26,4619,13,5,5,12,0,0,0,0,0,0,False,False,False,0,2,2021-10-15T22:29:53.897,0,False,0.0
2021,5,3136,605,26,4619,13,6,7,18,0,0,0,0,0,0,False,False,False,0,2,2022-02-16T17:29:18.673,0,False,0.0
2021,5,3136,630,8,5053,2,48,10,-3,-1,2,-1,0,-1,0,True,False,False,0,1,2021-10-12T15:07:15.153,-1,False,0.0
2021,5,3136,635,8,8349,13,19,2,40,0,0,0,0,0,0,False,False,False,0,3,2021-10-15T23:09:30.96,0,False,0.0
2021,5,3136,645,26,4619,13,21,2,27,0,0,0,0,0,0,False,False,False,0,2,2021-10-15T23:10:22.697,0,False,0.0
2021,5,3136,650,26,8552,2,5,3,5,5,0,5,0,5,0,False,False,False,0,3,2022-02-16T17:30:01.057,5,False,0.0
2021,5,3136,655,26,7453,2,12,3,14,14,0,14,0,14,0,False,False,False,0,3,2022-02-07T21:16:31.007,14,False,0.0
2021,5,3136,660,26,4619,2,8,6,37,42,5,42,0,42,6,False,False,False,0,3,2022-02-18T23:10:26.477,42,True,0.0
2021,5,3136,675,8,1067,2,4,5,5,7,2,7,0,7,0,False,False,False,0,3,2021-10-11T19:34:08.99,7,False,0.0
2021,5,3136,680,8,4976,2,35,1,15,71,56,12,59,12,6,False,False,False,1,3,2022-02-18T23:09:29.807,71,False,59.0
2021,5,3136,695,26,4050,13,32,4,0,0,0,0,0,0,0,False,False,False,0,4,2022-02-16T17:30:32.527,0,False,0.0
2021,5,3136,700,26,309,13,4,9,5,0,0,0,0,0,0,False,False,False,0,3,2022-02-16T17:30:53.637,0,False,0.0
2021,5,3136,705,26,4619,2,4,3,9,10,1,9,1,9,0,False,False,False,0,2,2021-10-11T19:43:28.303,10,False,1.0
2021,5,3136,710,26,4619,13,18,3,-2,0,0,0,0,0,0,False,False,False,0,3,2022-02-16T17:31:14.867,0,False,0.0
2021,5,3136,720,26,958,13,2,3,6,0,0,0,0,0,0,False,False,False,0,3,2022-02-16T17:31:37.71,0,False,0.0
2021,5,3136,725,26,4619,13,19,2,33,0,0,0,0,0,0,False,False,False,0,3,2021-10-12T01:56:38.24,0,False,
2021,5,3136,740,26,4616,2,44,3,-5,5,10,5,0,5,0,False,False,False,0,1,2022-02-18T23:08:44.177,5,False,0.0
2021,5,3136,745,26,958,13,12,6,24,0,0,0,0,0,0,False,False,False,0,3,2021-10-12T18:55:37.337,0,False,0.0
2021,5,3136,750,26,309,2,6,4,13,20,7,18,2,18,0,False,False,False,0,2,2021-10-15T19:58:36.967,20,False,2.0
2021,5,3136,770,8,5053,2,48,9,-4,13,17,7,6,7,0,False,False,False,1,1,2021-10-15T22:02:28.75,13,False,6.0
2021,5,3136,805,26,4616,2,5,3,4,4,0,4,0,4,0,False,True,False,0,1,2022-02-18T23:06:16.297,4,False,0.0
2021,5,3136,815,26,309,2,7,2,35,37,2,37,0,37,0,False,False,False,0,3,2021-10-15T22:35:13.59,37,True,0.0
2021,5,3136,820,26,7453,2,4,5,7,21,14,16,5,16,0,False,False,False,0,2,2021-10-15T22:01:42.547,21,False,5.0
2021,5,3136,825,26,309,2,18,5,0,3,3,3,0,3,0,False,False,False,0,3,2021-10-15T22:35:43.037,3,False,0.0
2021,5,3136,835,26,4616,2,48,9,-5,19,24,12,7,12,6,False,False,False,1,1,2021-10-15T22:52:56.957,19,False,7.0
2021,5,3136,860,8,3606,13,17,7,27,0,0,0,0,0,0,True,False,False,0,3,2021-10-15T19:58:36.967,0,False,0.0
2021,5,3136,875,26,958,2,46,3,1,29,28,29,0,29,0,False,False,False,0,4,2022-02-16T17:33:30.57,29,False,0.0
2021,5,3136,930,8,3606,2,4,5,6,6,0,6,0,6,0,False,False,False,0,3,2021-10-11T20:48:52.367,6,False,0.0
2021,5,3136,935,8,5053,2,16,4,0,3,3,3,0,3,0,False,False,False,0,1,2021-10-11T20:50:15.65,3,False,0.0
2021,5,3136,940,8,5053,2,46,3,0,2,2,2,0,2,0,False,False,False,0,1,2021-10-11T20:52:17.177,2,False,0.0
2021,5,3136,950,8,4976,2,5,10,9,10,1,9,1,9,0,False,False,False,0,3,2021-10-11T20:54:32.063,10,False,1.0
2021,5,3136,960,8,7651,13,19,8,45,0,0,0,0,0,0,False,False,False,0,3,2021-10-11T20:57:19.237,0,False,0.0
2021,5,3136,965,8,3606,13,24,6,25,0,0,0,0,0,0,False,False,False,0,3,2021-10-15T23:13:05.15,0,False,0.0
2021,5,3136,970,8,4976,13,19,8,46,0,0,0,0,0,0,False,False,False,0,3,2021-10-11T21:00:33.56,0,False,0.0
2021,5,3137,25,6,1400,13,51,10,-5,0,0,0,0,0,0,False,False,False,0,1,2021-10-15T19:56:01.777,0,False,0.0
2021,5,3137,40,23,7250,13,6,4,10,0,0,0,0,0,0,False,False,False,0,3,2021-10-11T11:15:41.297,0,False,0.0
2021,5,3137,45,23,7250,2,4,10,1,3,2,2,1,2,0,False,False,False,0,3,2021-10-11T17:53:15.247,3,False,1.0
2021,5,3137,60,6,7728,13,9,6,26,0,0,0,0,0,0,False,False,False,0,4,2021-10-11T11:08:36.027,0,False,0.0
2021,5,3137,80,23,7689,2,50,3,-2,12,14,9,3,9,0,False,False,False,0,2,2021-10-11T11:15:24.38,12,False,3.0
2021,5,3137,90,23,4307,2,12,4,3,6,3,4,2,4,0,False,False,False,0,2,2021-10-15T20:02:39.993,6,False,
2021,5,3137,95,23,7241,2,48,9,-3,8,11,1,7,1,0,False,False,False,1,1,2021-10-15T21:08:48.967,8,False,7.0
2021,5,3137,100,23,2994,2,32,5,5,29,24,26,3,26,0,False,False,False,0,4,2021-10-11T11:31:38.46,29,False,3.0
2021,5,3137,110,23,7250,2,26,9,3,9,6,7,2,7,0,False,False,False,2,3,2022-02-16T17:36:11.34,9,False,2.0
2021,5,3137,120,23,7689,13,17,8,17,0,0,0,0,0,0,False,False,False,0,3,2021-10-11T11:45:27.257,0,False,0.0
2021,5,3137,150,23,7241,13,4,10,-2,0,0,0,0,0,0,False,False,False,0,1,2021-10-15T19:56:01.807,0,False,0.0
2021,5,3137,155,23,7689,13,5,3,12,0,0,0,0,0,0,False,False,False,0,2,2021-10-11T12:07:57.397,0,False,0.0
2021,5,3137,180,6,464,2,4,10,4,4,0,4,0,4,0,False,False,False,0,3,2021-10-15T20:03:58.68,4,False,0.0
2021,5,3137,185,6,1400,2,28,4,4,18,14,15,3,15,0,False,False,False,0,1,2021-10-11T12:40:02.533,18,False,3.0
2021,5,3137,200,6,464,2,4,3,6,7,1,6,1,6,0,False,False,False,0,2,2021-10-11T12:51:09.493,7,False,1.0
2021,5,3137,215,6,464,13,2,9,10,0,0,0,0,0,0,False,False,False,0,3,2021-10-11T17:58:24.88,0,False,
2021,5,3137,235,6,6782,2,7,10,2,2,0,2,0,2,6,False,False,False,0,4,2021-10-11T13:14:12.367,2,True,0.0
2021,5,3137,250,23,7688,2,12,6,27,29,2,26,3,26,0,False,False,False,1,2,2022-02-07T21:17:36.317,29,False,3.0
2021,5,3137,255,23,7246,13,17,8,17,0,0,0,0,0,0,False,False,False,0,4,2021-10-11T13:26:06.337,0,False,
2021,5,3137,260,23,7241,2,45,5,-2,4,6,2,2,2,0,True,False,False,0,1,2021-10-15T21:42:45.827,4,False,2.0
2021,5,3137,285,6,1400,2,48,9,-4,2,6,2,0,2,0,False,False,False,0,1,2021-10-11T13:42:13.573,2,False,0.0
2021,5,3137,295,6,1378,13,19,6,30,0,0,0,0,0,0,False,False,False,0,2,2021-10-11T13:46:37.317,0,False,0.0
2021,5,3137,305,6,7725,2,5,5,2,15,13,9,6,9,0,False,False,False,1,3,2022-02-16T17:37:39.607,15,False,6.0
2021,5,3137,320,6,1378,2,4,9,6,8,2,7,1,7,0,True,False,False,0,2,2021-10-12T15:27:08.14,8,False,1.0
2021,5,3137,330,6,7728,13,11,6,24,0,0,0,0,0,0,False,False,False,0,4,2021-10-15T19:56:01.807,0,False,0.0
2021,5,3137,335,6,464,2,5,5,5,12,7,8,4,8,0,True,False,False,0,3,2021-10-15T20:07:29.423,12,False,4.0
2021,5,3137,385,23,3843,2,32,10,-6,4,10,-2,6,-2,0,False,False,False,0,1,2021-10-15T19:56:01.807,4,False,6.0
2021,5,3137,400,23,2994,13,21,6,42,0,0,0,0,0,0,False,False,False,0,3,2021-10-15T19:56:01.807,0,False,0.0
2021,5,3137,410,6,7728,2,4,10,6,8,2,7,1,7,0,False,False,False,0,4,2021-10-11T17:53:32.26,8,False,1.0
2021,5,3137,415,6,7725,13,5,5,12,0,0,0,0,0,0,False,False,False,0,2,2021-10-15T21:44:02.117,0,False,0.0
2021,5,3137,445,23,7250,2,5,3,3,9,6,7,2,7,0,False,False,False,1,3,2021-10-15T21:10:36.187,9,False,2.0
2021,5,3137,455,23,7689,3,12,6,40,0,0,0,0,0,0,False,False,False,0,3,2022-02-07T21:17:48.797,0,False,0.0
2021,5,3137,485,23,2994,3,32,10,3,0,0,0,0,0,0,False,False,False,0,3,2021-10-15T20:14:43.54,0,False,0.0
2021,5,3137,490,23,4949,2,5,5,5,6,1,6,0,6,0,False,False,False,0,3,2022-02-18T23:13:17.96,6,False,0.0
2021,5,3137,495,23,4949,13,8,2,28,0,0,0,0,0,0,False,False,False,0,3,2021-10-15T21:48:50.017,0,False,0.0
2021,5,3137,500,6,7725,13,4,10,10,0,0,0,0,0,0,False,False,False,0,2,2021-10-11T15:29:14.707,0,False,0.0
2021,5,3137,510,6,464,13,12,6,21,0,0,0,0,0,0,False,False,False,0,2,2021-10-15T20:16:10.237,0,False,0.0
2021,5,3137,525,23,4307,13,19,2,25,0,0,0,0,0,0,False,False,False,0,2,2021-10-11T15:39:54.99,0,False,0.0
2021,5,3137,535,23,7250,2,7,6,16,17,1,15,2,15,0,False,False,False,1,3,2021-10-11T15:43:20.3,17,False,2.0
2021,5,3137,540,23,7241,2,28,10,-2,5,7,4,1,4,0,False,False,False,0,1,2021-10-11T15:45:48.087,5,False,1.0
2021,5,3137,555,23,2994,3,6,9,12,0,0,0,0,0,0,False,False,False,0,3,2021-10-15T19:56:01.807,0,False,0.0
2021,5,3137,560,23,2994,2,32,5,4,6,2,5,1,5,0,False,False,False,0,4,2021-10-11T15:52:39.307,6,False,1.0
2021,5,3137,575,6,464,2,4,5,6,9,3,5,4,5,0,False,False,False,0,2,2021-10-11T15:57:22.213,9,False,4.0
2021,5,3137,585,6,7725,2,4,4,6,7,1,7,0,7,0,False,False,False,0,3,2021-10-15T21:50:37.707,7,False,0.0
2021,5,3137,605,23,7688,2,6,4,14,18,4,17,1,17,0,False,False,False,0,3,2021-10-15T20:17:54.883,18,False,1.0
2021,5,3137,610,23,2994,2,51,10,-3,3,6,2,1,2,0,True,False,False,0,3,2021-10-12T16:38:29.223,3,False,1.0
2021,5,3137,615,23,7241,2,18,5,0,2,2,0,2,0,0,True,False,False,0,2,2021-10-12T16:38:48.01,2,False,2.0
2021,5,3137,655,23,7688,2,5,5,4,4,0,4,0,4,0,False,False,False,0,3,2021-10-11T16:33:29.463,4,False,0.0
2021,5,3137,665,23,7250,2,30,5,-2,6,8,3,3,3,0,False,False,False,3,3,2021-10-15T21:10:54.867,6,False,3.0
2021,5,3137,675,23,2688,2,39,4,3,3,0,3,0,3,0,False,False,False,0,3,2021-10-11T16:41:32.727,3,False,0.0
2021,5,3137,680,23,2994,13,29,5,3,0,0,0,0,0,0,False,False,False,0,2,2022-02-16T17:38:19.777,0,False,0.0
2021,5,3137,685,23,2688,13,26,10,2,0,0,0,0,0,0,False,False,False,0,3,2021-10-11T18:01:13.163,0,False,
2021,5,3137,705,6,464,13,9,6,22,0,0,0,0,0,0,False,False,False,0,2,2021-10-11T16:53:38.913,0,False,
2021,5,3137,715,6,7728,13,35,10,14,0,0,0,0,0,0,False,False,False,0,4,2022-02-07T21:18:15.953,0,False,
2021,5,3137,725,6,7725,2,4,4,12,13,1,13,0,13,0,False,False,False,0,3,2021-10-11T17:03:06.14,13,False,0.0
2021,5,3137,730,6,7728,2,6,9,10,14,4,10,4,10,0,False,False,False,1,3,2021-10-15T21:11:09.173,14,False,4.0
2021,5,3137,780,23,7250,13,5,5,3,0,0,0,0,0,0,False,False,False,0,3,2021-10-11T17:20:08.927,0,False,0.0
2021,5,3137,790,23,7250,2,4,9,12,12,0,12,0,12,0,False,False,False,0,3,2021-10-11T17:22:40.627,12,False,0.0
2021,5,3137,800,23,7689,13,7,8,18,0,0,0,0,0,0,False,False,False,0,3,2021-10-15T19:56:01.807,0,False,0.0
2021,5,3137,845,23,2994,2,32,10,5,7,2,7,0,7,0,False,False,False,0,4,2021-10-11T17:33:30.973,7,False,0.0
2021,5,3137,850,23,7689,2,4,10,10,10,0,10,0,10,0,False,False,False,0,3,2021-10-15T20:22:24.94,10,False,0.0
2021,5,3138,15,28,262,2,47,5,8,16,8,15,1,15,0,True,False,False,0,3,2021-10-12T19:35:59.03,16,False,1.0
2021,5,3138,25,28,408,13,12,7,28,0,0,0,0,0,0,False,False,False,0,2,2022-02-07T21:19:21.283,0,False,0.0
2021,5,3138,30,1,6405,2,5,9,5,7,2,6,1,6,0,False,False,False,0,3,2021-10-11T09:22:59.16,7,False,1.0
2021,5,3138,45,1,6405,2,4,10,6,8,2,7,1,7,0,True,False,False,0,3,2021-10-12T20:19:15.673,8,False,1.0
2021,5,3138,55,1,910,2,2,10,11,13,2,12,1,12,0,False,False,False,0,2,2021-10-15T16:18:18.683,13,False,1.0
2021,5,3138,90,28,408,13,5,2,17,0,0,0,0,0,0,False,False,False,0,3,2021-10-11T14:55:06.867,0,False,
2021,5,3138,95,28,7224,13,35,4,-5,0,0,0,0,0,0,False,False,False,0,3,2021-10-15T15:48:33.23,0,False,0.0
2021,5,3138,105,28,8471,2,51,9,-5,14,19,11,3,11,0,False,False,False,1,1,2021-10-15T16:12:06.04,14,False,3.0
2021,5,3138,140,1,6406,2,51,10,-5,10,15,7,3,7,0,False,False,False,0,1,2021-10-15T16:19:09.043,10,False,3.0
2021,5,3138,145,1,6405,2,2,4,8,9,1,9,0,9,0,False,False,False,0,3,2021-10-11T09:59:41.8,9,False,0.0
2021,5,3138,170,28,7224,2,6,6,20,26,6,26,0,26,0,False,False,False,0,3,2022-02-07T21:19:50.77,26,False,0.0
2021,5,3138,180,28,7224,3,13,10,3,0,0,0,0,0,0,False,False,False,0,2,2021-10-11T10:26:21.513,0,False,0.0
2021,5,3138,190,28,7619,2,4,3,6,6,0,6,0,6,0,False,False,False,0,2,2021-10-11T14:31:53.54,6,False,0.0
2021,5,3138,205,28,7224,3,51,5,-4,0,0,0,0,0,0,False,False,False,0,3,2021-10-11T10:36:48.99,0,False,0.0
2021,5,3138,230,1,4587,13,4,9,5,0,0,0,0,0,0,False,False,False,0,1,2021-10-11T10:43:54.923,0,False,0.0
2021,5,3138,235,1,245,2,29,6,21,23,2,21,2,21,0,False,False,False,0,2,2021-10-15T18:03:16.42,23,False,2.0
2021,5,3138,255,1,910,13,7,2,23,0,0,0,0,0,0,False,False,False,0,3,2022-02-16T15:56:47.227,0,False,
2021,5,3138,265,1,8439,2,11,6,33,33,0,33,0,33,0,False,False,False,0,3,2021-10-11T10:57:19.253,33,True,0.0
2021,5,3138,275,1,8439,2,49,9,-2,3,5,2,1,2,0,True,False,False,0,3,2021-10-15T16:19:29.773,3,False,1.0
2021,5,3138,280,1,6405,2,51,9,1,6,5,4,2,4,0,False,False,False,0,3,2021-10-15T15:42:14.037,6,False,2.0
2021,5,3138,285,1,910,13,12,5,3,0,0,0,0,0,0,False,False,False,0,2,2022-02-16T16:00:42.56,0,False,0.0
2021,5,3138,290,1,245,13,13,10,3,0,0,0,0,0,0,False,False,False,0,3,2021-10-11T11:21:01.17,0,False,0.0
2021,5,3138,310,28,262,2,45,5,-5,1,6,-1,2,-1,0,True,False,False,0,3,2022-02-18T20:27:22.117,1,False,2.0
2021,5,3138,315,28,917,3,6,7,21,0,0,0,0,0,0,False,False,False,0,3,2021-10-11T11:26:36.917,0,False,0.0
2021,5,3138,325,1,8439,2,50,3,-3,2,5,-1,3,-1,0,False,False,False,1,2,2021-10-15T16:15:34.373,2,False,3.0
2021,5,3138,330,1,245,2,4,3,5,9,4,5,4,5,0,False,False,False,0,2,2021-10-11T11:31:10.617,9,False,4.0
2021,5,3138,335,1,6406,13,5,3,3,0,0,0,0,0,0,False,False,False,0,1,2022-02-16T16:01:20.313,0,False,0.0
2021,5,3138,340,1,2416,2,32,5,-1,14,15,4,10,4,0,False,False,False,1,1,2021-10-15T15:42:14.037,14,False,10.0
2021,5,3138,345,1,4587,2,48,9,-3,8,11,7,1,7,0,False,False,False,0,1,2021-10-11T11:37:08.013,8,False,1.0
2021,5,3138,365,1,245,2,2,9,3,5,2,3,2,3,0,False,False,False,0,2,2021-10-11T11:40:40.22,5,False,2.0
2021,5,3138,385,1,245,13,4,6,22,0,0,0,0,0,0,False,False,False,0,3,2022-02-16T16:02:46.207,0,False,0.0
2021,5,3138,390,1,8439,2,4,4,3,8,5,8,0,8,0,False,False,False,0,3,2021-10-15T15:42:14.037,8,False,0.0
2021,5,3138,420,1,8439,2,50,9,-4,13,17,10,3,10,0,False,False,False,0,3,2021-10-15T15:42:14.037,13,False,3.0
2021,5,3138,430,28,408,13,12,6,15,0,0,0,0,0,0,False,False,False,0,3,2021-10-11T12:03:56.65,0,False,0.0
2021,5,3138,440,28,262,2,46,3,4,18,14,17,1,17,0,False,False,False,1,1,2021-10-11T12:06:35.05,18,False,1.0
2021,5,3138,445,28,7224,2,12,5,7,13,6,11,2,11,0,False,False,False,1,3,2022-02-07T21:20:42.733,13,False,
2021,5,3138,455,28,7224,2,50,10,-5,6,11,4,2,4,0,False,False,False,0,3,2021-10-15T15:42:14.037,6,False,2.0
2021,5,3138,465,28,6627,2,4,10,11,12,1,11,1,11,0,True,False,False,0,3,2021-10-15T15:42:14.037,12,False,1.0
2021,5,3138,475,28,917,2,5,3,6,6,0,6,0,6,0,False,False,False,0,3,2021-10-15T16:26:36.25,6,False,0.0
2021,5,3138,485,28,7760,2,4,9,3,4,1,3,1,3,0,False,False,False,0,4,2021-10-11T12:22:37.38,4,False,1.0
2021,5,3138,495,28,262,13,12,6,41,0,0,0,0,0,0,False,False,False,0,1,2022-02-07T21:20:56.133,0,False,0.0
2021,5,3138,510,1,8439,13,44,3,0,0,0,0,0,0,0,True,False,False,0,3,2021-10-11T12:30:19.283,0,False,0.0
2021,5,3138,515,1,6406,2,32,5,-3,7,10,6,1,6,0,False,False,False,0,1,2021-10-11T12:32:04.347,7,False,1.0
2021,5,3138,530,28,408,13,3,6,17,0,0,0,0,0,0,False,False,False,0,2,2021-10-11T12:37:56.273,0,False,0.0
2021,5,3138,540,28,7619,2,4,10,11,26,15,11,15,11,0,False,False,False,3,3,2021-10-15T17:35:08.54,26,False,15.0
2021,5,3138,585,1,6405,2,6,4,6,9,3,7,2,7,0,False,False,False,0,3,2021-10-11T12:54:59.81,9,False,2.0
2021,5,3138,590,1,245,13,19,6,41,0,0,0,0,0,0,False,False,False,0,2,2022-02-18T20:28:47.653,0,False,0.0
2021,5,3138,620,28,8471,2,5,3,2,5,3,3,2,3,0,False,False,False,0,1,2021-10-11T13:03:57.853,5,False,2.0
2021,5,3138,650,28,6627,2,4,10,10,13,3,11,2,11,0,True,False,False,0,3,2021-10-15T15:42:14.037,13,False,2.0
2021,5,3138,665,1,6406,2,51,10,-4,2,6,1,1,1,0,False,True,True,0,1,2021-10-15T15:42:14.037,2,False,1.0
2021,5,3138,670,28,7619,13,4,3,3,0,0,0,0,0,0,False,False,False,0,2,2021-10-15T16:39:21.983,0,False,0.0
2021,5,3138,680,28,7619,13,2,4,7,0,0,0,0,0,0,False,False,False,0,3,2021-10-15T01:39:01.157,0,False,0.0
2021,5,3138,685,28,7224,13,2,10,-4,0,0,0,0,0,0,False,False,False,0,3,2021-10-15T15:42:14.037,0,False,0.0
2021,5,3138,705,1,245,2,12,2,27,30,3,27,3,27,0,False,False,False,0,3,2022-02-07T21:21:18.953,30,False,3.0
2021,5,3138,710,1,245,2,29,3,9,9,0,9,0,9,6,False,False,False,0,2,2021-10-15T16:19:56.763,9,False,0.0
2021,5,3138,725,28,7224,2,35,2,22,26,4,23,3,23,0,False,False,False,0,3,2021-10-15T15:42:14.037,26,False,3.0
2021,5,3138,730,28,917,2,5,3,6,13,7,12,1,12,0,False,False,False,0,3,2021-10-15T16:30:23.767,13,False,1.0
2021,5,3138,740,28,7224,13,19,2,26,0,0,0,0,0,0,False,False,False,0,2,2021-10-11T13:45:55.91,0,False,0.0
2021,5,3138,745,28,7224,13,5,5,4,0,0,0,0,0,0,False,False,False,0,3,2022-02-18T20:45:56.8,0,False,0.0
2021,5,3138,765,1,245,2,3,5,11,11,0,11,0,11,0,False,False,False,0,2,2021-10-12T20:24:08.247,11,False,0.0
2021,5,3139,10,9,7816,2,50,3,-4,6,10,4,2,4,0,False,False,False,0,2,2021-10-11T09:47:04.563,6,False,2.0
2021,5,3139,25,9,6446,13,38,4,4,0,0,0,0,0,0,False,False,False,0,4,2021-10-11T09:57:16.8,0,False,0.0
2021,5,3139,40,9,4202,13,46,3,-4,0,0,0,0,0,0,False,False,False,0,1,2021-10-15T20:39:20.317,0,False,0.0
2021,5,3139,60,21,4674,13,21,2,27,0,0,0,0,0,0,False,False,False,0,2,2021-10-11T10:12:57.043,0,False,0.0
2021,5,3139,65,21,8518,3,12,2,15,0,0,0,0,0,0,False,False,False,0,2,2021-10-15T20:41:17.097,0,False,0.0
2021,5,3139,85,9,4202,2,12,3,8,10,2,10,0,10,0,False,False,False,0,1,2022-02-16T16:56:25.523,10,False,
2021,5,3139,105,9,6446,2,6,4,5,8,3,6,2,6,0,False,False,False,0,3,2021-10-11T10:33:22.257,8,False,2.0
2021,5,3139,110,9,322,13,5,5,8,0,0,0,0,0,0,False,False,False,0,3,2022-02-18T22:19:40.613,0,False,0.0
2021,5,3139,120,9,6446,3,36,4,12,0,0,0,0,0,0,False,False,False,0,3,2021-10-11T10:44:24.86,0,False,0.0
2021,5,3139,135,21,6228,13,2,9,8,0,0,0,0,0,0,True,False,False,0,2,2021-10-11T10:58:17.21,0,False,0.0
2021,5,3139,145,21,4492,13,13,10,4,0,0,0,0,0,0,False,False,False,0,2,2022-02-16T16:57:43.66,0,False,0.0
2021,5,3139,175,9,4446,2,13,3,4,6,2,5,1,5,0,False,False,False,0,3,2021-10-11T11:17:50.627,6,False,1.0
2021,5,3139,220,21,4674,13,19,2,27,0,0,0,0,0,0,False,False,False,0,2,2021-10-15T20:58:06.867,0,False,0.0
2021,5,3139,240,9,7183,2,30,5,-3,2,5,0,2,0,0,True,False,False,0,3,2021-10-11T11:49:11.093,2,False,2.0
2021,5,3139,245,9,7816,2,19,2,35,49,14,49,0,49,6,False,False,False,0,2,2021-10-11T15:30:06.697,49,True,0.0
2021,5,3139,260,21,4492,13,5,5,14,0,0,0,0,0,0,False,False,False,0,2,2021-10-11T11:57:07.997,0,False,0.0
2021,5,3139,265,21,3957,3,48,5,-4,0,0,0,0,0,0,False,False,False,0,1,2021-10-15T20:27:23.84,0,False,0.0
2021,5,3139,270,21,8518,2,24,2,36,38,2,36,2,36,0,False,False,False,0,2,2021-10-11T12:03:20.407,38,False,2.0
2021,5,3139,275,21,4492,13,24,2,23,0,0,0,0,0,0,False,False,False,0,3,2021-10-11T13:51:44.307,0,False,0.0
2021,5,3139,285,21,7592,13,6,5,3,0,0,0,0,0,0,False,False,False,0,2,2021-10-11T12:12:37.23,0,False,0.0
2021,5,3139,305,9,7183,2,5,3,4,6,2,6,0,6,0,False,False,False,0,3,2021-10-11T12:15:43.713,6,False,0.0
2021,5,3139,310,9,7816,13,2,9,7,0,0,0,0,0,0,False,False,False,0,2,2021-10-11T12:19:40.69,0,False,0.0
2021,5,3139,315,9,6446,2,4,10,8,8,0,8,0,8,0,False,False,False,0,3,2021-10-11T12:21:13.727,8,False,0.0
2021,5,3139,335,21,8518,2,4,10,5,5,0,5,0,5,0,False,False,False,0,3,2021-10-15T20:59:33.917,5,False,0.0
2021,5,3139,340,21,8518,2,13,5,4,9,5,8,1,8,0,False,False,False,0,3,2021-10-11T12:29:01.527,9,False,1.0
2021,5,3139,350,21,4422,2,2,4,9,18,9,15,3,15,0,False,False,False,0,3,2021-10-11T12:32:32.047,18,False,3.0
2021,5,3139,370,21,8518,2,26,3,5,28,23,22,6,22,0,False,False,False,1,3,2021-10-12T20:54:08.747,28,False,6.0
2021,5,3139,410,9,4202,2,51,5,-5,-2,3,-2,0,-2,0,False,False,False,0,1,2022-02-16T17:00:15.623,-2,False,0.0
2021,5,3139,415,9,6446,2,13,4,5,11,6,9,2,9,0,False,False,False,0,3,2021-10-15T19:56:34.26,11,False,2.0
2021,5,3139,420,9,322,2,29,6,20,21,1,21,0,21,0,False,False,False,0,3,2021-10-11T12:57:36.3,21,False,0.0
2021,5,3139,435,9,6446,2,4,4,5,7,2,7,0,7,0,False,False,False,0,3,2021-10-15T19:56:34.26,7,False,0.0
2021,5,3139,440,9,6446,2,8,4,13,15,2,14,1,14,0,False,False,False,0,3,2021-10-11T13:05:26.457,15,False,1.0
2021,5,3139,445,9,4446,13,6,10,14,0,0,0,0,0,0,False,False,False,0,2,2021-10-11T13:06:57.85,0,False,0.0
2021,5,3139,450,9,322,2,8,7,23,24,1,24,0,24,6,False,False,False,0,2,2021-10-15T19:56:34.26,24,True,0.0
2021,5,3139,465,21,3957,2,48,9,-5,6,11,5,1,5,0,False,False,False,0,1,2021-10-15T22:05:27.553,6,False,1.0
2021,5,3139,480,21,8518,2,26,6,16,35,19,30,5,30,0,False,False,False,0,2,2022-02-16T17:00:36.76,35,False,5.0
2021,5,3139,485,21,8518,2,49,5,-2,6,8,5,1,5,0,False,False,False,0,2,2021-10-11T17:07:41.027,6,False,1.0
2021,5,3139,500,21,5015,2,49,3,-2,2,4,1,1,1,0,False,False,False,0,2,2021-10-15T20:30:54.257,2,False,1.0
2021,5,3139,525,9,7816,2,50,5,-2,11,13,9,2,9,0,False,False,False,0,2,2021-10-11T13:35:49.563,11,False,2.0
2021,5,3139,535,9,322,13,5,6,16,0,0,0,0,0,0,False,False,False,0,3,2022-02-25T15:18:00.387,0,False,0.0
2021,5,3139,540,9,6446,2,12,2,20,30,10,26,4,26,0,False,False,False,0,3,2021-10-11T13:41:25.437,30,False,4.0
2021,5,3139,550,9,322,2,2,10,13,15,2,15,0,15,0,False,False,False,0,3,2022-02-14T19:29:55.987,15,False,0.0
2021,5,3139,560,9,7816,13,35,5,6,0,0,0,0,0,0,False,False,False,0,3,2021-10-15T19:56:34.26,0,False,0.0
2021,5,3139,565,9,7816,13,2,5,3,0,0,0,0,0,0,False,False,False,0,2,2021-10-15T21:00:57.253,0,False,
2021,5,3139,575,9,4202,2,45,5,-3,4,7,4,0,4,6,False,False,False,0,1,2021-10-15T19:56:34.26,4,True,0.0
2021,5,3139,590,21,5015,13,8,1,52,0,0,0,0,0,0,False,False,False,0,2,2021-10-15T20:39:50.237,0,False,0.0
2021,5,3139,605,9,4446,2,4,4,5,8,3,5,3,5,0,False,False,False,1,3,2021-10-15T19:56:34.26,8,False,3.0
2021,5,3139,610,9,4447,13,13,5,5,0,0,0,0,0,0,False,False,False,0,3,2021-10-11T14:29:18.647,0,False,
2021,5,3139,635,9,7183,2,52,9,0,14,14,12,2,12,0,False,True,False,1,1,2021-10-15T21:02:24.573,13,False,2.0
2021,5,3139,655,21,8518,2,9,2,24,26,2,26,0,26,0,False,False,False,0,3,2021-10-11T17:09:25.853,26,False,0.0
2021,5,3139,665,21,5015,2,18,3,-1,5,6,3,2,3,0,False,False,False,0,2,2021-10-15T20:28:43.587,5,False,2.0
2021,5,3139,680,21,8518,2,18,5,-2,13,15,12,1,12,0,True,False,False,0,2,2021-10-12T20:52:03.423,13,False,1.0
2021,5,3139,685,21,4422,2,11,5,13,13,0,13,0,13,0,False,False,False,0,4,2021-10-11T17:10:46.523,13,True,0.0
2021,5,3139,695,21,8518,13,12,3,9,0,0,0,0,0,0,False,False,False,0,3,2021-10-11T15:05:37.463,0,False,0.0
2021,5,3139,710,21,8518,13,29,5,2,0,0,0,0,0,0,False,False,False,0,2,2021-10-11T15:10:20.68,0,False,0.0
2021,5,3139,725,9,7816,2,4,3,11,18,7,17,1,17,0,False,False,False,0,2,2021-10-11T15:17:53.05,18,False,1.0
2021,5,3139,730,9,4446,2,8,1,21,22,1,22,0,22,0,False,False,False,0,3,2022-02-16T17:01:52.31,22,False,0.0
2021,5,3139,745,9,6441,2,19,6,35,35,0,35,0,35,0,False,False,False,0,2,2022-02-16T17:02:17.277,35,False,0.0
2021,5,3139,775,21,8518,2,6,3,4,16,12,12,4,12,0,False,False,False,0,2,2021-10-11T15:42:14.993,16,False,4.0
2021,5,3139,780,21,813,2,8,4,13,14,1,12,2,12,0,False,False,False,0,3,2021-10-11T15:41:49.59,14,False,2.0
2021,5,3139,785,21,8518,2,6,9,7,13,6,10,3,10,0,False,False,False,2,2,2021-10-15T20:47:07.897,13,False,3.0
2021,5,3139,790,21,3957,2,31,9,-5,10,15,8,2,8,0,False,False,False,0,1,2021-10-11T16:00:24.52,10,False,
2021,5,3139,795,21,7592,13,4,5,11,0,0,0,0,0,0,False,False,False,0,2,2022-02-18T22:22:16.417,0,False,0.0
2021,5,3139,800,21,4674,2,4,5,12,13,1,13,0,13,0,False,False,False,0,2,2021-10-12T20:55:15.367,13,False,0.0
2021,5,3139,805,21,4422,2,4,4,8,11,3,8,3,8,0,False,False,False,0,3,2021-10-15T19:56:34.26,11,False,3.0
2021,5,3139,810,21,813,13,17,10,11,0,0,0,0,0,0,False,False,False,0,3,2021-10-11T16:08:15.647,0,False,
2021,5,3139,815,21,3957,2,5,5,5,7,2,6,1,6,0,False,False,False,0,1,2021-10-11T16:10:59.25,7,False,1.0
2021,5,3139,825,21,4674,13,7,3,3,0,0,0,0,0,0,True,False,False,0,3,2021-10-15T19:56:34.26,0,True,0.0
2021,5,3139,830,21,3957,2,46,3,-1,3,4,1,2,1,6,True,False,False,0,3,2021-10-11T16:26:21.873,3,False,2.0
2021,5,3139,865,9,7183,2,44,3,-1,7,8,3,4,3,0,False,False,False,1,1,2021-10-15T20:47:47.917,7,False,4.0
2021,5,3139,895,9,322,13,2,5,9,0,0,0,0,0,0,False,False,False,0,2,2021-10-11T16:45:05.393,0,False,0.0
2021,5,3139,915,21,4674,13,5,5,14,0,0,0,0,0,0,False,False,False,0,2,2021-10-11T16:49:38.43,0,False,0.0
2021,5,3139,920,21,4422,2,5,3,11,13,2,13,0,13,0,False,False,False,0,3,2021-10-11T17:11:50.4,13,False,0.0
2021,5,3139,925,21,7592,13,4,5,7,0,0,0,0,0,0,False,False,False,0,2,2021-10-15T20:40:17.983,0,False,0.0
2021,5,3140,20,16,3938,2,13,4,3,12,9,12,0,12,0,True,False,False,0,2,2021-10-11T08:51:39.267,12,True,0.0
2021,5,3140,25,16,374,13,9,2,32,0,0,0,0,0,0,True,False,False,0,3,2021-10-11T08:53:23.887,0,False,0.0
2021,5,3140,30,16,7176,13,6,4,14,0,0,0,0,0,0,False,False,False,0,3,2021-10-12T20:47:03.393,0,False,0.0
2021,5,3140,50,16,374,13,7,2,21,0,0,0,0,0,0,False,False,False,0,3,2022-02-16T17:13:23.943,0,False,
2021,5,3140,65,16,3938,3,5,3,7,0,0,0,0,0,0,False,False,False,0,2,2022-02-16T17:16:33.817,0,False,0.0
2021,5,3140,80,16,6500,2,4,4,3,6,3,5,1,5,0,True,False,False,0,3,2021-10-11T09:14:01.327,6,False,1.0
2021,5,3140,95,16,7681,13,48,9,-5,0,0,0,0,0,0,False,False,False,0,1,2022-02-16T17:16:57.19,0,False,0.0
2021,5,3140,100,16,3938,3,4,4,14,0,0,0,0,0,0,False,False,False,0,3,2021-10-15T18:16:50.593,0,False,0.0
2021,5,3140,130,4,6953,2,35,8,20,23,3,23,0,23,0,False,False,False,0,3,2021-10-12T17:51:59.21,23,False,0.0
2021,5,3140,145,4,6953,13,9,3,9,0,0,0,0,0,0,False,False,False,0,3,2021-10-15T18:51:55.677,0,False,0.0
2021,5,3140,165,4,6983,3,48,9,-1,0,0,0,0,0,0,False,False,False,0,1,2021-10-11T09:34:11.577,0,False,0.0
2021,5,3140,205,16,374,2,12,10,14,15,1,13,2,13,0,False,False,False,1,3,2021-10-15T19:42:33.607,15,False,2.0
2021,5,3140,230,16,6499,13,12,10,0,0,0,0,0,0,0,False,False,False,0,1,2021-10-11T09:46:29.443,0,False,
2021,5,3140,235,16,1989,2,12,5,11,11,0,11,0,11,0,False,False,False,0,2,2021-10-11T09:47:53.707,11,False,0.0
2021,5,3140,240,16,797,2,28,10,-1,9,10,8,1,8,0,False,False,False,0,1,2021-10-11T09:49:12.45,9,False,1.0
2021,5,3140,245,16,3938,2,50,5,-2,7,9,7,0,7,0,False,False,False,1,2,2022-02-16T17:22:09.367,7,False,0.0
2021,5,3140,250,16,7176,2,4,3,2,8,6,6,2,6,0,False,False,False,1,2,2021-10-11T09:51:15.82,8,False,2.0
2021,5,3140,270,16,6500,2,12,5,5,5,0,5,0,5,6,False,False,False,0,2,2021-10-11T09:54:17.107,5,True,0.0
2021,5,3140,285,4,7645,3,5,9,3,0,0,0,0,0,0,False,False,False,0,1,2021-10-15T17:52:39.863,0,False,0.0
2021,5,3140,295,4,2853,2,13,9,3,8,5,7,1,7,0,True,False,False,0,3,2021-10-11T09:59:20.763,8,False,1.0
2021,5,3140,300,4,7645,2,4,4,4,24,20,23,1,23,0,False,False,False,0,1,2021-10-12T17:52:28.593,24,False,1.0
2021,5,3140,305,4,213,2,24,7,35,35,0,35,0,35,6,False,False,False,0,3,2021-10-15T19:05:45.703,35,True,0.0
2021,5,3140,325,16,7176,2,5,3,8,8,0,8,0,8,0,False,False,False,0,3,2021-10-11T10:09:17.02,8,False,0.0
2021,5,3140,350,4,2853,2,23,1,47,61,14,56,5,56,0,False,False,False,0,3,2021-10-11T17:44:56.733,61,False,5.0
2021,5,3140,360,4,2853,13,29,5,11,0,0,0,0,0,0,False,False,False,0,2,2021-10-12T18:03:32.34,0,False,0.0
2021,5,3140,365,4,213,13,4,9,12,0,0,0,0,0,0,False,False,False,0,3,2021-10-11T10:17:37.277,0,False,0.0
2021,5,3140,385,16,6499,3,46,3,0,0,0,0,0,0,0,False,False,False,0,1,2021-10-11T10:20:04.75,0,False,0.0
2021,5,3140,390,16,3938,13,35,7,17,0,0,0,0,0,0,False,False,False,0,3,2021-10-11T10:21:00.34,0,False,0.0
2021,5,3140,400,16,374,2,12,10,10,10,0,10,0,10,0,False,False,False,0,2,2021-10-11T10:22:37.08,10,False,0.0
2021,5,3140,410,16,374,13,12,1,19,0,0,0,0,0,0,False,False,False,0,2,2021-10-15T19:37:50.617,0,False,0.0
2021,5,3140,415,4,7645,2,51,10,-5,15,20,10,5,10,0,True,False,False,1,1,2021-10-11T10:26:45.12,15,False,5.0
2021,5,3140,420,4,6953,2,12,2,37,53,16,53,0,53,6,False,False,False,0,3,2021-10-11T10:27:39.943,53,True,0.0
2021,5,3140,435,16,7176,2,18,3,0,6,6,4,2,4,0,False,False,False,0,2,2021-10-15T18:57:50.45,6,False,2.0
2021,5,3140,445,16,3938,13,4,10,7,0,0,0,0,0,0,False,False,False,0,3,2021-10-11T10:31:23.543,0,False,0.0
2021,5,3140,455,16,7176,2,11,2,22,26,4,26,0,26,0,False,False,False,0,3,2021-10-15T17:46:02.433,26,False,0.0
2021,5,3140,460,16,374,2,2,10,7,17,10,15,2,15,0,True,False,False,0,3,2021-10-11T10:35:58.857,17,False,
2021,5,3140,465,16,374,13,31,9,7,0,0,0,0,0,0,False,False,False,0,3,2022-02-07T21:26:40.143,0,False,0.0
2021,5,3140,470,16,374,2,5,9,12,8,-4,10,-2,10,0,False,False,False,1,3,2021-10-15T19:44:32.823,8,False,-2.0
2021,5,3140,520,4,2853,13,4,3,6,0,0,0,0,0,0,False,False,False,0,2,2021-10-11T10:49:20.82,0,False,0.0
2021,5,3140,535,16,374,2,13,4,3,12,9,10,2,10,0,False,False,False,0,3,2021-10-11T10:58:34.553,12,False,2.0
2021,5,3140,540,16,4143,2,5,10,3,8,5,6,2,6,0,False,False,False,0,3,2021-10-15T18:59:18.92,8,False,2.0
2021,5,3140,550,16,374,13,12,3,2,0,0,0,0,0,0,False,False,False,0,3,2021-10-11T11:01:36.253,0,False,0.0
2021,5,3140,560,4,6953,2,12,2,39,41,2,41,0,41,0,False,False,False,0,3,2021-10-12T17:53:01.96,41,False,0.0
2021,5,3140,570,4,6990,2,32,5,0,1,1,1,0,1,0,False,False,False,0,4,2021-10-11T11:07:29.933,1,False,0.0
2021,5,3140,575,4,594,13,9,3,14,0,0,0,0,0,0,False,False,False,0,3,2021-10-11T23:38:53.127,0,False,0.0
2021,5,3140,590,16,7681,2,48,9,-5,11,16,6,5,6,0,False,False,False,1,1,2021-10-11T11:17:14.573,11,False,5.0
2021,5,3140,595,16,7176,2,6,5,5,5,0,5,0,5,0,False,False,False,0,2,2021-10-11T11:16:42.72,5,False,0.0
2021,5,3140,600,16,7176,13,6,4,12,0,0,0,0,0,0,False,False,False,0,3,2021-10-11T11:18:15.643,0,False,0.0
2021,5,3140,605,16,3938,3,13,4,2,0,0,0,0,0,0,True,False,False,0,2,2021-10-11T17:44:16.773,0,False,0.0
2021,5,3140,625,16,2568,2,5,10,4,4,0,4,0,4,0,False,False,False,0,4,2021-10-11T11:21:58.273,4,False,0.0
2021,5,3140,630,16,3938,2,26,10,1,3,2,2,1,2,0,True,False,False,0,2,2021-10-11T11:24:51.667,3,False,1.0
2021,5,3140,635,16,7176,3,13,9,4,0,0,0,0,0,0,True,False,False,0,2,2021-10-11T11:26:55.513,0,False,
2021,5,3140,640,16,374,2,12,5,5,11,6,4,7,4,0,False,False,False,1,3,2021-10-15T19:44:22.373,11,False,7.0
2021,5,3140,650,16,7176,2,12,5,3,8,5,7,1,7,0,True,False,False,0,3,2021-10-11T11:31:34.24,8,False,1.0
2021,5,3140,660,16,3938,2,7,3,13,17,4,16,1,16,0,False,False,False,0,3,2021-10-11T11:33:49.657,17,False,1.0
2021,5,3140,665,16,7176,13,4,5,-6,0,0,0,0,0,0,False,False,False,0,2,2021-10-15T18:56:55.633,0,False,0.0
2021,5,3140,680,4,2853,13,29,2,22,0,0,0,0,0,0,False,False,False,0,2,2021-10-15T18:17:48.05,0,False,0.0
2021,5,3140,690,16,6499,2,47,5,1,6,5,5,1,5,0,False,False,False,0,1,2022-02-07T21:23:43.42,6,False,1.0
2021,5,3140,695,16,6499,2,47,5,2,8,6,6,2,6,0,False,False,False,0,1,2021-10-11T11:41:04.32,8,False,2.0
2021,5,3140,700,16,7176,2,4,4,3,5,2,3,2,3,0,False,False,False,1,3,2021-10-11T11:41:53.427,5,False,2.0
2021,5,3140,705,16,374,13,24,2,24,0,0,0,0,0,0,False,False,False,0,3,2021-10-11T11:44:49.443,0,False,
2021,5,3140,710,16,3938,2,30,10,-5,5,10,5,0,5,0,True,False,False,0,4,2021-10-11T11:46:04.437,5,True,0.0
2021,5,3140,730,16,6499,2,12,3,1,4,3,4,0,4,0,False,False,False,0,1,2021-10-11T11:47:52.953,4,False,0.0
2021,5,3140,740,16,374,2,55,10,-2,1,3,1,0,1,6,False,False,False,0,3,2021-10-11T11:49:38.817,1,True,0.0
2021,5,3140,760,4,6983,2,51,9,-5,-2,3,-2,0,-2,0,False,False,False,0,1,2021-10-12T17:53:28.713,-2,False,0.0
2021,5,3140,770,4,2853,13,12,8,51,0,0,0,0,0,0,False,False,False,0,3,2021-10-15T19:39:10.51,0,False,
2021,5,3140,775,4,213,2,17,10,9,11,2,10,1,10,0,False,False,False,0,3,2021-10-11T12:02:54.587,11,False,1.0
2021,5,3140,785,4,594,2,50,10,-4,5,9,4,1,4,0,False,False,False,0,3,2021-10-11T12:08:19.307,5,False,1.0
2021,5,3140,800,4,213,13,35,10,14,0,0,0,0,0,0,False,False,False,0,3,2021-10-12T17:53:39.113,0,False,0.0
2021,5,3140,805,4,7645,2,44,3,-2,16,18,3,13,3,0,False,False,False,2,1,2022-02-18T22:55:21.383,16,False,13.0
2021,5,3140,810,4,7646,2,6,4,12,16,4,16,0,16,0,False,False,False,0,2,2021-10-12T17:53:50.313,16,False,0.0
2021,5,3140,825,4,213,2,7,9,8,8,0,8,0,8,6,False,False,False,0,3,2021-10-12T18:05:04.563,8,True,0.0
2021,5,3140,840,16,6499,13,31,10,5,0,0,0,0,0,0,False,False,False,0,1,2021-10-15T18:53:23.98,0,False,0.0
2021,5,3140,845,16,3938,2,26,10,2,8,6,8,0,8,0,False,False,False,0,3,2021-10-15T19:01:08.76,8,False,0.0
2021,5,3140,850,16,7176,2,13,4,3,6,3,6,0,6,0,True,False,False,0,3,2021-10-11T13:46:40.83,6,False,0.0
2021,5,3140,855,16,7176,2,4,4,3,4,1,4,0,4,0,False,False,False,0,3,2021-10-11T13:47:30.593,4,False,0.0
2021,5,3140,865,16,3938,13,7,10,13,0,0,0,0,0,0,False,False,False,0,3,2021-10-11T13:49:18.473,0,False,0.0
2021,5,3140,870,16,797,2,44,3,-4,4,8,4,0,4,0,False,False,False,0,1,2021-10-11T13:51:33.053,4,False,0.0
2021,5,3140,875,16,374,13,7,6,16,0,0,0,0,0,0,False,False,False,0,3,2022-02-16T17:23:48.483,0,False,
2021,5,3140,885,16,3938,2,2,9,8,11,3,11,0,11,0,False,False,False,0,2,2021-10-11T13:54:17.813,11,False,0.0
2021,5,3141,10,3,7672,2,44,9,-5,5,10,4,1,4,0,True,False,False,1,3,2021-10-15T17:59:16.787,5,False,1.0
2021,5,3141,20,3,121,13,3,3,5,0,0,0,0,0,0,False,False,False,0,2,2021-10-15T18:45:16.09,0,False,0.0
2021,5,3141,35,14,5197,13,12,5,5,0,0,0,0,0,0,False,False,False,0,4,2021-10-12T09:27:38.567,0,False,0.0
2021,5,3141,40,14,7582,3,11,5,-1,0,0,0,0,0,0,False,False,False,0,1,2021-10-12T09:29:26.15,0,False,0.0
2021,5,3141,45,14,7582,2,48,9,-5,76,81,76,0,76,6,False,False,False,1,1,2021-10-15T18:13:14.467,76,True,0.0
2021,5,3141,60,3,6454,2,5,5,5,5,0,5,0,5,0,False,False,False,0,3,2021-10-12T09:35:04.99,5,False,0.0
2021,5,3141,70,3,6454,13,4,3,7,0,0,0,0,0,0,False,False,False,0,3,2021-10-12T09:39:26.83,0,False,0.0
2021,5,3141,80,14,7582,2,13,10,6,11,5,8,3,8,0,True,False,False,1,2,2021-10-12T09:42:19.15,11,False,3.0
2021,5,3141,95,14,7495,2,5,6,15,15,0,15,0,15,0,False,False,False,0,3,2021-10-15T18:46:16.317,15,False,0.0
2021,5,3141,110,14,6938,2,4,4,5,6,1,6,0,6,0,False,False,False,0,2,2021-10-12T09:54:24.397,6,False,0.0
2021,5,3141,115,14,5197,2,13,10,4,8,4,6,2,6,0,False,False,False,0,4,2021-10-12T09:57:17.06,8,False,2.0
2021,5,3141,125,14,7582,2,48,10,-5,2,7,-1,3,-1,0,False,False,False,1,1,2022-02-16T16:32:36.66,2,False,
2021,5,3141,130,14,8400,2,2,10,7,15,8,12,3,12,0,False,False,False,0,3,2021-10-15T17:48:11.513,15,False,3.0
2021,5,3141,145,3,6454,2,4,10,9,17,8,15,2,15,0,False,False,False,0,3,2021-10-15T18:46:23.907,17,False,2.0
2021,5,3141,180,14,4449,13,2,4,5,0,0,0,0,0,0,False,False,False,0,3,2021-10-12T10:45:04.853,0,False,0.0
2021,5,3141,185,14,5024,13,48,4,-3,0,0,0,0,0,0,False,False,False,0,1,2021-10-15T18:29:17.37,0,False,0.0
2021,5,3141,190,14,6938,2,3,3,11,11,0,11,0,11,0,False,False,False,0,2,2022-02-16T16:34:56.087,11,False,0.0
2021,5,3141,195,14,5024,2,4,9,4,7,3,5,2,5,0,False,False,False,0,1,2021-10-15T18:46:33.177,7,False,2.0
2021,5,3141,240,3,7672,2,35,7,15,15,0,15,0,15,0,False,False,False,0,3,2021-10-12T11:17:39.58,15,False,0.0
2021,5,3141,270,14,7495,2,34,4,-4,-2,2,-2,0,-2,0,True,False,False,0,3,2021-10-12T11:27:03.59,-2,False,0.0
2021,5,3141,275,14,7584,2,50,10,-4,5,9,2,3,2,0,False,False,False,0,3,2021-10-15T17:39:05.847,5,False,3.0
2021,5,3141,285,3,121,2,6,4,13,28,15,22,6,22,0,False,False,False,0,3,2021-10-12T11:41:31.223,28,False,6.0
2021,5,3141,300,3,121,2,5,9,11,7,-4,12,-5,12,0,False,False,False,1,3,2021-10-15T18:13:38.603,7,False,-5.0
2021,5,3141,310,3,6454,2,11,2,22,28,6,28,0,28,0,False,False,False,0,3,2021-10-12T16:11:30.763,28,False,0.0
2021,5,3141,315,3,6454,2,38,9,2,2,0,2,0,2,0,False,False,False,0,4,2021-10-15T17:35:44.877,2,False,0.0
2021,5,3141,335,3,6936,13,35,3,5,0,0,0,0,0,0,False,False,False,0,3,2021-10-15T18:30:49.387,0,False,0.0
2021,5,3141,350,14,6543,2,5,3,5,6,1,6,0,6,0,False,False,False,0,3,2021-10-12T12:11:53.987,6,False,
2021,5,3141,355,14,7584,2,6,3,4,9,5,5,4,5,0,False,False,False,0,2,2021-10-12T12:17:20.61,9,False,4.0
2021,5,3141,360,14,6938,13,3,5,8,0,0,0,0,0,0,False,False,False,0,2,2021-10-12T12:19:29.497,0,False,0.0
2021,5,3141,365,14,6938,13,3,3,9,0,0,0,0,0,0,False,False,False,0,2,2021-10-15T18:46:42.867,0,False,
2021,5,3141,370,14,6938,2,3,3,13,16,3,16,0,16,0,False,False,False,0,2,2021-10-12T12:23:35.967,16,False,0.0
2021,5,3141,375,14,4449,13,46,9,4,0,0,0,0,0,0,False,False,False,0,3,2021-10-15T17:35:44.877,0,False,0.0
2021,5,3141,380,14,7584,2,50,10,-4,-1,3,-3,2,-3,0,False,False,False,0,3,2022-02-18T21:43:04.657,-1,False,2.0
2021,5,3141,385,14,6938,13,2,10,5,0,0,0,0,0,0,False,False,False,0,2,2021-10-15T18:45:27.177,0,False,0.0
2021,5,3141,390,14,7584,2,4,3,13,13,0,13,0,13,0,False,False,False,0,2,2021-10-15T18:49:17.147,13,False,0.0
2021,5,3141,420,14,4449,2,22,3,13,31,18,27,4,27,0,True,False,False,0,2,2021-10-15T18:31:14.37,31,False,4.0
2021,5,3141,425,14,7584,2,7,6,30,42,12,30,12,30,6,False,False,False,0,3,2021-10-15T18:14:04.797,42,False,12.0
2021,5,3141,440,3,306,2,38,5,1,6,5,5,1,5,0,False,False,False,0,1,2021-10-12T12:54:02.73,6,False,1.0
2021,5,3141,450,3,7673,2,2,4,7,11,4,11,0,11,0,False,False,False,0,3,2021-10-12T12:57:12.98,11,False,0.0
2021,5,3141,460,3,6936,2,35,10,8,12,4,12,0,12,0,False,False,False,1,3,2021-10-15T18:31:34.14,12,False,0.0
2021,5,3141,475,3,7672,2,5,3,6,8,2,8,0,8,0,False,False,False,0,2,2021-10-15T17:35:44.877,8,False,0.0
2021,5,3141,480,3,6454,2,39,4,8,8,0,8,0,8,0,False,False,False,0,3,2022-02-16T16:37:17.133,8,False,0.0
2021,5,3141,485,3,306,3,5,3,3,0,0,0,0,0,0,False,False,False,0,1,2021-10-12T13:13:13.793,0,False,0.0
2021,5,3141,490,3,6936,2,4,5,4,7,3,7,0,7,0,False,False,False,0,4,2021-10-12T13:14:49.363,7,False,0.0
2021,5,3141,500,3,7672,2,2,4,9,17,8,15,2,15,0,False,False,False,0,2,2021-10-12T13:18:06.023,17,False,2.0
2021,5,3141,510,14,7584,2,50,9,0,21,21,20,1,20,0,False,False,False,0,2,2021-10-12T13:30:25.79,21,False,1.0
2021,5,3141,530,14,5197,2,7,6,18,24,6,24,0,24,0,False,False,False,0,3,2021-10-15T18:47:15.477,24,False,0.0
2021,5,3141,550,3,6936,2,4,5,3,3,0,3,0,3,0,False,False,False,0,2,2021-10-12T13:45:08.187,3,False,0.0
2021,5,3141,555,3,6454,2,4,10,14,19,5,17,2,17,0,False,False,False,0,4,2021-10-15T18:32:39.003,19,False,2.0
2021,5,3141,565,3,8274,2,5,4,4,7,3,7,0,7,0,False,False,False,0,1,2022-02-16T16:37:37.27,7,False,0.0
2021,5,3141,570,3,6936,2,20,2,40,43,3,43,0,43,6,False,False,False,0,2,2021-10-15T17:35:44.877,43,True,0.0
2021,5,3141,610,14,5197,2,35,10,14,18,4,14,4,14,0,True,False,False,0,4,2021-10-13T22:02:00.757,18,False,4.0
2021,5,3141,620,14,1119,2,5,3,4,4,0,4,0,4,0,False,False,False,0,3,2021-10-12T14:09:19.593,4,False,0.0
2021,5,3141,625,14,7584,13,2,9,4,0,0,0,0,0,0,False,False,False,0,2,2021-10-12T14:10:39.36,0,False,0.0
2021,5,3141,640,3,6454,2,35,7,20,27,7,25,2,25,0,False,False,False,0,3,2021-10-15T17:35:44.877,27,False,2.0
2021,5,3141,645,3,6454,2,32,5,0,18,18,11,7,11,0,False,False,False,1,4,2021-10-12T14:19:00.243,18,False,7.0
2021,5,3141,650,3,6936,2,4,5,7,7,0,7,0,7,0,False,False,False,0,2,2021-10-15T18:47:33.227,7,False,0.0
2021,5,3141,655,3,6816,2,4,5,3,6,3,6,0,6,0,False,False,False,0,3,2021-10-12T14:22:11.753,6,False,0.0
2021,5,3141,660,3,713,2,4,4,3,15,12,13,2,13,0,False,False,False,0,1,2021-10-12T14:23:44.413,15,False,2.0
2021,5,3141,665,3,6454,2,12,9,5,5,0,5,0,5,6,False,False,False,0,3,2022-02-07T21:24:34.547,5,True,0.0
2021,5,3141,680,14,8400,2,46,9,1,4,3,4,0,4,0,False,False,False,0,4,2021-10-12T14:27:53.92,4,False,0.0
2021,5,3141,685,14,7582,2,28,5,0,29,29,5,24,5,0,False,False,False,2,1,2021-10-12T14:29:54.553,29,False,24.0
2021,5,3141,745,3,713,13,28,10,4,0,0,0,0,0,0,True,False,False,0,1,2021-10-15T17:35:44.877,0,False,0.0
2021,5,3141,750,3,6936,2,4,10,6,17,11,10,7,10,0,False,False,False,0,3,2021-10-12T14:48:23.113,17,False,7.0
2021,5,3141,755,3,713,2,44,3,-2,10,12,2,8,2,0,False,False,False,1,1,2021-10-12T14:48:13.37,10,False,8.0
2021,5,3141,760,3,713,2,5,4,3,9,6,8,1,8,0,False,False,False,0,1,2021-10-15T17:51:01.253,9,False,1.0
2021,5,3141,770,3,6454,13,4,10,4,0,0,0,0,0,0,False,False,False,0,3,2021-10-12T14:54:47.453,0,False,0.0
2021,5,3141,775,3,6936,2,6,8,16,20,4,16,4,16,0,False,False,False,1,2,2021-10-15T18:47:41.437,20,False,4.0
2021,5,3141,780,3,8274,2,28,10,2,8,6,5,3,5,0,False,False,False,0,1,2021-10-12T15:01:11.107,8,False,3.0
2021,5,3141,800,3,6454,2,12,10,4,4,0,4,0,4,6,False,False,False,0,3,2021-10-12T15:07:05.237,4,True,0.0
2021,5,3141,815,14,6938,2,5,6,22,23,1,23,0,23,0,False,False,False,0,2,2021-10-15T18:47:50.153,23,False,0.0
2021,5,3141,820,14,6543,13,12,4,-1,0,0,0,0,0,0,False,False,False,0,1,2022-02-07T21:25:03.083,0,False,0.0
2021,5,3141,825,14,6938,13,12,2,45,0,0,0,0,0,0,False,False,False,0,2,2022-02-07T21:25:21.66,0,False,
2021,5,3141,830,14,4449,2,50,10,-4,2,6,1,1,1,0,False,False,False,0,3,2021-10-12T15:18:37.4,2,False,1.0
2021,5,3141,835,14,4449,2,7,9,11,15,4,14,1,14,0,False,False,False,0,3,2022-02-16T16:37:57,15,False,1.0
2021,5,3141,875,3,6454,2,4,4,7,14,7,11,3,11,0,False,False,False,0,3,2021-10-12T15:35:13.51,14,False,3.0
2021,5,3141,880,3,7673,2,12,10,4,4,0,4,0,4,0,False,False,False,0,3,2021-10-12T15:36:48.31,4,False,0.0
2021,5,3141,885,3,6936,2,4,5,7,11,4,9,2,9,0,False,False,False,0,2,2021-10-15T18:48:01.217,11,False,2.0
2021,5,3141,890,3,6816,2,13,9,2,7,5,6,1,6,0,True,False,False,0,4,2021-10-13T23:16:17.923,7,False,1.0
2021,5,3141,900,3,306,2,47,5,0,7,7,5,2,5,0,False,False,False,0,1,2021-10-15T18:35:01.02,7,False,2.0
2021,5,3141,920,3,6936,2,5,5,5,5,0,5,0,5,6,False,False,False,0,3,2021-10-12T15:55:34.753,5,True,0.0
2021,6,3142,15,30,37,2,4,5,6,9,3,8,1,8,0,False,False,False,0,2,2021-10-15T12:08:46.647,9,False,1.0
2021,6,3142,20,30,793,2,6,7,18,22,4,20,2,20,0,False,False,False,0,2,2021-10-15T12:12:34.103,22,False,2.0
2021,6,3142,30,30,4516,2,6,9,12,16,4,12,4,12,0,True,False,False,0,3,2021-10-16T15:51:32.573,16,False,4.0
2021,6,3142,35,30,37,13,5,6,15,0,0,0,0,0,0,False,False,False,0,3,2021-10-15T16:37:49.67,0,False,0.0
2021,6,3142,45,30,4516,2,50,9,0,10,10,6,4,6,0,False,False,False,0,3,2021-10-15T12:19:12.437,10,False,4.0
2021,6,3142,55,30,4523,2,38,9,2,2,0,2,0,2,6,False,False,False,0,4,2021-10-15T12:28:29.873,2,True,0.0
2021,6,3142,75,24,8509,13,7,2,33,0,0,0,0,0,0,False,False,False,0,2,2021-10-21T13:32:43.857,0,False,0.0
2021,6,3142,95,24,7798,13,4,3,12,0,0,0,0,0,0,False,False,False,0,2,2021-10-15T12:40:19.02,0,False,0.0
2021,6,3142,100,24,7800,2,12,2,23,23,0,23,0,23,0,False,False,False,0,3,2021-10-21T14:08:52.877,23,False,0.0
2021,6,3142,105,24,894,2,46,3,3,3,0,3,0,3,0,False,False,False,0,3,2021-10-21T14:11:24.903,3,False,
2021,6,3142,115,24,7798,13,19,6,45,0,0,0,0,0,0,False,False,False,0,2,2021-10-21T13:00:38.31,0,False,
2021,6,3142,120,24,894,2,47,5,4,5,1,5,0,5,6,False,False,False,0,4,2021-10-15T12:50:43.25,5,True,0.0
2021,6,3142,140,30,4937,2,4,9,2,8,6,4,4,4,0,False,False,False,0,1,2021-10-15T12:54:06.18,8,False,4.0
2021,6,3142,145,30,4516,2,5,5,6,8,2,8,0,8,0,False,False,False,0,2,2021-10-15T12:55:55.39,8,False,0.0
2021,6,3142,150,30,4937,2,4,4,1,11,10,8,3,8,0,False,False,False,0,1,2021-10-15T16:44:38.25,11,False,3.0
2021,6,3142,155,30,4937,2,48,10,-6,3,9,2,1,2,0,False,False,False,0,1,2021-10-21T15:51:59.203,3,False,1.0
2021,6,3142,170,30,6414,2,51,10,-6,9,15,7,2,7,0,False,False,False,0,1,2021-10-15T13:03:45.187,9,False,2.0
2021,6,3142,175,30,37,2,12,7,18,23,5,19,4,19,6,False,False,False,1,2,2022-02-24T13:28:31.433,23,False,4.0
2021,6,3142,200,24,8509,2,4,9,4,6,2,5,1,5,0,False,False,False,0,3,2021-10-21T16:12:25.74,6,False,1.0
2021,6,3142,205,24,7798,13,4,9,4,0,0,0,0,0,0,False,False,False,0,3,2021-10-21T16:19:52.1,0,False,0.0
2021,6,3142,220,30,37,2,51,10,-8,-4,4,-6,2,-6,0,False,False,False,0,4,2021-10-21T16:12:53.1,-4,False,2.0
2021,6,3142,225,30,37,2,35,9,9,10,1,9,1,9,0,False,False,False,0,3,2021-10-21T16:23:05.123,10,False,1.0
2021,6,3142,240,24,6937,2,51,3,-4,4,8,-4,8,-4,0,False,False,False,1,1,2021-10-21T14:19:13.723,4,False,8.0
2021,6,3142,250,24,894,13,5,5,14,0,0,0,0,0,0,False,False,False,0,3,2021-10-15T13:24:33.453,0,False,0.0
2021,6,3142,270,30,2290,13,6,4,5,0,0,0,0,0,0,False,False,False,0,4,2021-10-21T14:24:43.263,0,False,0.0
2021,6,3142,285,24,894,2,5,2,15,16,1,16,0,16,0,False,False,False,0,4,2021-10-15T13:34:50.937,16,False,0.0
2021,6,3142,290,24,7800,13,19,6,46,0,0,0,0,0,0,False,False,False,0,2,2021-10-15T16:27:41.637,0,False,0.0
2021,6,3142,295,30,793,13,8,8,36,0,0,0,0,0,0,False,False,False,0,2,2021-10-15T13:38:33.643,0,False,0.0
2021,6,3142,300,30,2290,2,39,4,5,12,7,11,1,11,0,False,False,False,0,3,2021-10-15T13:40:32.44,12,False,1.0
2021,6,3142,310,30,37,2,50,5,-2,14,16,12,2,12,0,False,False,False,0,2,2021-10-15T13:43:01.163,14,False,2.0
2021,6,3142,315,30,4937,2,47,5,3,18,15,2,16,2,0,False,False,False,2,1,2021-10-15T13:45:26.2,18,False,16.0
2021,6,3142,325,30,4523,2,53,10,-5,10,15,-2,12,-2,0,False,False,False,1,4,2021-10-21T15:22:37.107,10,False,12.0
2021,6,3142,330,30,4516,2,50,5,-3,3,6,2,1,2,0,True,False,False,0,3,2021-10-21T14:16:30.703,3,False,1.0
2021,6,3142,335,30,4516,2,4,9,7,6,-1,7,-1,7,0,False,False,False,0,3,2021-10-15T13:52:59.293,6,False,-1.0
2021,6,3142,365,24,894,13,12,5,2,0,0,0,0,0,0,False,False,False,0,4,2021-10-15T13:59:33.383,0,False,0.0
2021,6,3142,375,24,8513,13,12,7,35,0,0,0,0,0,0,False,False,False,0,1,2022-02-24T13:29:06.127,0,False,0.0
2021,6,3142,390,30,793,13,5,6,17,0,0,0,0,0,0,False,False,False,0,3,2021-10-21T16:00:09.58,0,False,0.0
2021,6,3142,395,30,37,13,4,3,13,0,0,0,0,0,0,False,False,False,0,2,2021-10-21T16:00:42.343,0,False,0.0
2021,6,3142,400,30,37,13,8,7,44,0,0,0,0,0,0,False,False,False,0,3,2021-10-21T16:14:55.357,0,False,0.0
2021,6,3142,405,24,7798,13,3,3,13,0,0,0,0,0,0,False,False,False,0,2,2021-10-21T13:32:43.857,0,False,0.0
2021,6,3142,425,30,931,2,48,10,-7,-4,3,-5,1,-5,0,False,False,False,1,1,2021-10-15T14:15:46.053,-4,False,1.0
2021,6,3142,440,24,894,2,30,10,-4,2,6,2,0,2,0,False,False,False,0,4,2022-02-14T19:31:29.397,2,False,0.0
2021,6,3142,450,24,8509,13,4,3,12,0,0,0,0,0,0,False,False,False,0,2,2021-10-15T14:26:52.863,0,False,0.0
2021,6,3142,460,30,4523,2,39,4,5,5,0,5,0,5,0,False,False,False,0,4,2021-10-16T15:50:47.707,5,False,0.0
2021,6,3142,465,30,37,2,4,9,5,4,-1,4,0,4,0,False,False,False,0,2,2021-10-15T14:30:45.863,4,False,0.0
2021,6,3142,480,30,4937,2,5,10,4,4,0,4,0,4,0,False,False,False,0,1,2021-10-15T14:36:15.073,4,False,0.0
2021,6,3142,495,30,4523,2,53,10,-6,9,15,2,7,2,0,False,False,False,1,4,2021-10-21T15:23:00.407,9,False,7.0
2021,6,3142,505,30,4523,2,2,10,12,15,3,13,2,13,0,False,False,False,0,4,2021-10-21T14:20:23.483,15,False,2.0
2021,6,3142,515,30,793,13,29,3,1,0,0,0,0,0,0,False,False,False,0,2,2021-10-21T14:20:50.607,0,False,
2021,6,3142,540,24,7798,13,11,2,50,0,0,0,0,0,0,True,False,False,0,3,2021-10-21T13:02:42.573,0,False,
2021,6,3142,545,24,8513,2,44,3,0,1,1,1,0,1,0,True,False,False,0,2,2021-10-16T16:31:36.007,1,False,0.0
2021,6,3142,550,24,894,2,53,9,-5,6,11,5,1,5,0,False,False,False,0,4,2021-10-15T14:56:18.8,6,False,1.0
2021,6,3142,570,24,7800,13,35,3,3,0,0,0,0,0,0,False,False,False,0,2,2021-10-15T16:39:37.21,0,False,0.0
2021,6,3142,590,30,37,13,20,2,28,0,0,0,0,0,0,False,False,False,0,2,2021-10-15T15:06:12.95,0,False,0.0
2021,6,3142,595,30,37,2,50,5,-1,0,1,0,0,0,0,False,False,False,0,2,2021-10-21T14:16:57.627,0,False,0.0
2021,6,3142,600,30,931,2,16,10,1,8,7,5,3,5,0,False,False,False,0,1,2021-10-16T15:51:19.407,8,False,3.0
2021,6,3142,610,24,7800,2,50,9,-1,-3,-2,-4,1,-4,0,False,False,False,0,2,2021-10-21T13:32:43.857,-3,False,1.0
2021,6,3142,620,24,7800,2,12,2,24,24,0,24,0,24,0,False,False,False,0,3,2022-02-24T13:30:16.743,24,False,0.0
2021,6,3142,630,24,8509,2,6,1,20,25,5,20,5,20,0,False,False,False,0,3,2021-10-21T16:15:21.333,25,False,5.0
2021,6,3142,645,24,6937,13,51,9,-7,0,0,0,0,0,0,False,False,False,0,1,2021-10-21T13:32:43.857,0,False,0.0
2021,6,3142,650,24,6937,13,12,2,16,0,0,0,0,0,0,False,False,False,0,1,2021-10-21T15:20:38.22,0,False,0.0
2021,6,3142,675,30,793,2,4,3,2,5,3,2,3,2,0,False,False,False,0,2,2021-10-15T15:38:11.68,5,False,3.0
2021,6,3142,680,30,2290,2,16,4,4,4,0,4,0,4,0,False,False,False,0,4,2021-10-15T15:39:57.387,4,False,0.0
2021,6,3142,685,30,4523,2,32,10,-3,8,11,4,4,4,0,False,False,False,0,4,2021-10-15T15:41:50.547,8,False,4.0
2021,6,3142,695,30,4523,13,5,2,20,0,0,0,0,0,0,False,False,False,0,4,2021-10-15T15:43:54.057,0,False,0.0
2021,6,3142,700,24,6937,2,47,5,0,6,6,4,2,4,0,False,False,False,0,1,2021-10-21T16:09:28.887,6,False,2.0
2021,6,3142,760,30,37,2,6,9,3,10,7,10,0,10,0,False,False,False,0,2,2021-10-15T16:11:31.16,10,False,0.0
2021,6,3142,770,30,4937,2,51,10,-6,2,8,0,2,0,0,False,False,False,0,1,2021-10-15T16:13:56.4,2,False,2.0
2021,6,3142,780,30,37,2,6,2,20,27,7,20,7,20,0,False,False,False,0,3,2022-02-22T21:35:49.833,27,False,7.0
2021,6,3142,795,30,2290,2,6,4,4,10,6,9,1,9,0,False,False,False,0,3,2021-10-21T16:10:30.947,10,False,1.0
2021,6,3143,15,17,8483,2,4,10,5,7,2,5,2,5,0,False,False,False,0,3,2021-10-17T18:06:54.997,7,False,2.0
2021,6,3143,25,17,8483,2,12,9,9,10,1,9,1,9,0,True,False,False,0,3,2021-10-17T18:10:43.1,10,False,1.0
2021,6,3143,35,17,4383,2,2,9,12,17,5,17,0,17,0,False,False,False,0,3,2021-10-17T18:13:41.093,17,False,0.0
2021,6,3143,40,17,4752,13,12,5,5,0,0,0,0,0,0,False,False,False,0,3,2021-10-17T18:16:33.25,0,False,0.0
2021,6,3143,45,17,4383,2,4,9,3,4,1,3,1,3,0,False,False,False,0,2,2021-10-21T20:14:18.067,4,False,1.0
2021,6,3143,50,17,6274,2,35,9,13,20,7,18,2,18,0,False,False,False,0,3,2021-10-21T17:48:21.477,20,False,2.0
2021,6,3143,55,17,7024,13,46,3,1,0,0,0,0,0,0,False,False,False,0,1,2021-10-17T18:25:50.147,0,False,0.0
2021,6,3143,60,17,6276,2,5,10,5,6,1,6,0,6,0,False,False,False,0,3,2021-10-17T18:29:17.377,6,False,0.0
2021,6,3143,65,17,8483,2,5,3,4,6,2,5,1,5,0,False,False,False,0,2,2021-10-17T18:31:45.327,6,False,1.0
2021,6,3143,80,17,8483,2,2,9,4,6,2,5,1,5,6,False,False,False,0,2,2021-10-17T18:40:21.667,6,False,1.0
2021,6,3143,95,15,4487,2,51,10,-2,24,26,17,7,17,0,False,False,False,1,2,2021-10-21T20:14:54.24,24,False,7.0
2021,6,3143,100,15,4487,2,45,5,-8,1,9,-2,3,-2,0,True,False,False,1,2,2021-10-17T18:50:51.447,1,False,3.0
2021,6,3143,110,15,5152,2,5,5,7,19,12,16,3,16,0,True,False,False,0,3,2021-10-18T01:00:48.853,19,False,3.0
2021,6,3143,130,15,5152,3,2,9,6,0,0,0,0,0,0,True,False,False,0,3,2021-10-17T19:02:21.447,0,False,0.0
2021,6,3143,145,17,6274,2,35,8,17,22,5,22,0,22,0,False,False,False,0,3,2021-10-21T17:48:21.477,22,False,0.0
2021,6,3143,160,17,6276,2,7,7,23,25,2,25,0,25,0,False,False,False,0,4,2021-10-18T00:58:16.747,25,False,0.0
2021,6,3143,165,17,7618,2,28,10,-1,15,16,11,4,11,0,False,False,False,0,1,2022-02-16T19:30:34.987,15,False,4.0
2021,6,3143,175,17,6274,2,5,5,3,3,0,3,0,3,0,False,False,False,0,3,2021-10-17T19:23:27.703,3,False,0.0
2021,6,3143,190,17,7024,3,48,10,-4,0,0,0,0,0,0,False,False,False,0,1,2021-10-21T19:52:21.727,0,False,0.0
2021,6,3143,205,15,7591,13,35,8,21,0,0,0,0,0,0,False,False,False,0,3,2021-10-18T00:59:17.18,0,False,
2021,6,3143,215,15,914,2,13,9,4,4,0,4,0,4,0,False,False,False,0,3,2021-10-17T19:39:17.023,4,False,0.0
2021,6,3143,220,15,957,13,4,4,14,0,0,0,0,0,0,False,False,False,0,3,2021-10-18T01:01:31.31,0,False,0.0
2021,6,3143,240,17,364,2,4,9,4,2,-2,1,1,1,0,False,False,False,0,3,2021-10-17T19:50:33.223,2,False,1.0
2021,6,3143,245,17,6274,13,5,5,9,0,0,0,0,0,0,False,False,False,0,3,2021-10-17T19:53:44.86,0,False,0.0
2021,6,3143,270,15,7591,13,50,5,0,0,0,0,0,0,0,False,False,False,0,2,2021-10-17T20:03:04.89,0,False,0.0
2021,6,3143,280,17,4383,13,8,7,33,0,0,0,0,0,0,False,False,False,0,3,2021-10-21T19:53:00.183,0,False,0.0
2021,6,3143,285,17,4716,2,47,5,1,8,7,7,1,7,0,True,False,False,0,4,2021-10-21T18:59:18.477,8,False,1.0
2021,6,3143,290,17,8483,13,12,6,18,0,0,0,0,0,0,False,False,False,0,3,2021-10-17T20:12:48.113,0,False,0.0
2021,6,3143,300,17,4383,2,6,7,18,20,2,19,1,19,0,False,False,False,0,3,2021-10-17T20:16:13.547,20,False,1.0
2021,6,3143,305,17,6276,2,32,9,0,1,1,1,0,1,0,False,False,False,0,4,2021-10-21T18:59:29.427,1,False,0.0
2021,6,3143,315,17,7024,13,4,10,4,0,0,0,0,0,0,False,False,False,0,1,2021-10-18T23:54:07.017,0,False,0.0
2021,6,3143,330,15,914,2,5,5,6,6,0,6,0,6,0,True,False,False,0,3,2021-10-17T20:29:38.523,6,True,0.0
2021,6,3143,335,15,5152,2,47,5,2,8,6,7,1,7,0,False,False,False,0,3,2021-10-21T19:56:31.567,8,False,1.0
2021,6,3143,340,15,7591,2,30,10,-3,9,12,5,4,5,0,False,False,False,0,3,2021-10-21T17:48:21.477,9,False,4.0
2021,6,3143,350,15,8099,2,5,3,7,11,4,9,2,9,0,False,False,False,0,2,2021-10-17T20:43:41.507,11,False,2.0
2021,6,3143,355,15,914,2,8,4,14,20,6,17,3,17,0,False,False,False,0,2,2021-10-21T19:58:07.75,20,False,3.0
2021,6,3143,365,15,153,13,12,5,8,0,0,0,0,0,0,False,False,False,0,4,2021-10-21T19:58:36.283,0,False,0.0
2021,6,3143,370,15,7591,13,12,3,13,0,0,0,0,0,0,False,False,False,0,3,2021-10-17T20:54:05.543,0,False,0.0
2021,6,3143,375,15,7591,3,5,5,13,0,0,0,0,0,0,False,False,False,0,2,2021-10-21T20:00:00.667,0,False,0.0
2021,6,3143,385,17,8487,13,46,3,2,0,0,0,0,0,0,True,False,False,0,4,2021-10-17T21:00:14.84,0,False,0.0
2021,6,3143,405,17,6274,2,5,5,3,5,2,4,1,4,0,True,False,False,0,3,2021-10-17T21:05:44.247,5,False,1.0
2021,6,3143,415,15,7591,2,5,10,3,10,7,6,4,6,0,False,False,False,0,3,2021-10-21T20:01:51.163,10,False,4.0
2021,6,3143,435,15,7591,13,26,9,4,0,0,0,0,0,0,False,False,False,0,2,2021-10-17T21:20:11.587,0,False,0.0
2021,6,3143,440,15,7591,2,4,9,5,7,2,5,2,5,0,True,False,False,0,3,2021-10-17T21:22:24.367,7,False,2.0
2021,6,3143,450,15,914,2,29,2,28,28,0,28,0,28,6,False,False,False,0,2,2021-10-17T21:25:25.97,28,True,0.0
2021,6,3143,465,17,6276,13,17,1,21,0,0,0,0,0,0,False,False,False,0,3,2021-10-21T17:48:21.477,0,False,0.0
2021,6,3143,470,17,4383,2,6,8,19,20,1,20,0,20,0,False,False,False,0,2,2021-10-17T21:31:41.583,20,False,0.0
2021,6,3143,475,17,3356,2,4,10,3,7,4,5,2,5,0,False,False,False,0,1,2021-10-17T21:33:19.56,7,False,2.0
2021,6,3143,485,17,6274,2,5,5,8,8,0,8,0,8,0,False,False,False,0,3,2021-10-21T20:05:01.04,8,True,0.0
2021,6,3143,505,15,3750,2,4,4,10,11,1,10,1,10,0,False,False,False,0,4,2021-10-21T17:48:21.477,11,False,1.0
2021,6,3143,515,15,4835,13,46,3,1,0,0,0,0,0,0,True,False,False,0,3,2021-10-17T21:44:21.37,0,False,0.0
2021,6,3143,520,15,4487,2,17,8,23,29,6,25,4,25,0,False,False,False,0,3,2021-10-17T21:47:05.847,29,False,4.0
2021,6,3143,525,15,5152,13,12,2,20,0,0,0,0,0,0,False,False,False,0,3,2021-10-17T21:49:31.77,0,False,
2021,6,3143,555,17,7024,2,4,10,5,5,0,5,0,5,0,False,False,False,0,1,2021-10-17T22:02:36.273,5,False,0.0
2021,6,3143,580,17,8483,2,35,4,14,14,0,14,0,14,0,False,False,False,0,2,2021-10-17T22:12:35.667,14,False,0.0
2021,6,3143,585,17,4383,2,9,6,20,25,5,21,4,21,0,False,False,False,0,2,2021-10-21T17:48:21.477,25,False,
2021,6,3143,590,17,7024,2,46,3,1,0,-1,-1,1,-1,0,False,False,False,0,1,2021-10-17T22:17:07.307,0,False,1.0
2021,6,3143,595,17,8483,2,50,10,-5,6,11,2,4,2,0,True,False,False,0,2,2022-02-16T19:31:36.33,6,False,4.0
2021,6,3143,600,17,8483,13,9,2,35,0,0,0,0,0,0,True,False,False,0,3,2021-10-21T17:48:21.477,0,False,0.0
2021,6,3143,625,15,914,2,5,5,5,11,6,8,3,8,0,False,False,False,0,3,2021-10-17T22:32:38.397,11,False,3.0
2021,6,3143,635,15,914,2,6,9,13,11,-2,12,-1,12,0,False,False,False,0,3,2021-10-17T22:37:18.443,11,False,-1.0
2021,6,3143,650,17,8483,13,9,6,16,0,0,0,0,0,0,False,False,False,0,2,2022-02-16T19:32:35.913,0,False,0.0
2021,6,3143,655,15,8343,2,12,3,12,21,9,17,4,17,0,False,False,False,0,4,2021-10-17T22:50:44.827,21,False,4.0
2021,6,3143,670,15,8099,2,32,3,-2,7,9,4,3,4,0,False,False,False,0,1,2021-10-21T20:06:45.453,7,False,3.0
2021,6,3143,675,15,4179,13,35,5,9,0,0,0,0,0,0,False,False,False,0,3,2022-02-16T19:33:14.153,0,False,0.0
2021,6,3143,685,17,6274,2,35,2,20,32,12,32,0,32,0,False,False,False,0,3,2022-02-16T19:34:37.673,32,False,0.0
2021,6,3143,690,17,6274,2,2,4,9,20,11,18,2,18,0,False,False,False,0,3,2021-10-21T17:25:05.71,20,False,2.0
2021,6,3143,695,17,8483,2,51,3,-3,-1,2,-2,1,-2,0,False,False,False,0,3,2021-10-17T23:11:24.47,-1,False,1.0
2021,6,3143,705,17,364,2,4,3,6,12,6,10,2,10,0,False,False,False,0,2,2021-10-17T23:16:37.23,12,False,2.0
2021,6,3143,710,17,6276,2,17,4,14,18,4,17,1,17,0,False,False,False,0,4,2021-10-21T17:48:21.477,18,False,1.0
2021,6,3143,715,17,8483,2,46,3,1,2,1,2,0,2,6,True,False,False,0,1,2021-10-18T23:54:45.23,2,False,0.0
2021,6,3143,730,15,5152,13,30,3,1,0,0,0,0,0,0,False,False,False,0,4,2021-10-21T20:07:55.227,0,False,0.0
2021,6,3143,735,15,4487,2,12,10,14,14,0,14,0,14,0,False,False,False,0,3,2021-10-17T23:33:34.25,14,False,0.0
2021,6,3143,745,15,914,13,4,3,8,0,0,0,0,0,0,False,False,False,0,2,2021-10-17T23:39:49.733,0,False,0.0
2021,6,3143,750,15,4487,2,3,5,8,10,2,7,3,7,0,False,False,False,0,2,2021-10-21T17:48:21.477,10,False,3.0
2021,6,3143,755,15,5152,13,13,4,5,0,0,0,0,0,0,False,False,False,0,3,2021-10-21T20:15:24.75,0,False,0.0
2021,6,3143,765,17,8483,2,51,5,0,12,12,2,10,2,0,True,False,False,1,3,2021-10-21T20:08:24.343,12,False,10.0
2021,6,3143,775,17,6276,2,2,4,5,9,4,8,1,8,0,False,False,False,0,3,2021-10-17T23:52:19.677,9,False,1.0
2021,6,3143,780,17,7024,13,4,9,4,0,0,0,0,0,0,False,False,False,0,1,2021-10-21T20:09:18.53,0,False,0.0
2021,6,3143,795,15,7591,2,5,3,5,7,2,6,1,6,0,False,False,False,0,3,2021-10-17T23:59:57.593,7,False,1.0
2021,6,3143,800,15,8099,2,44,3,-1,10,11,7,3,7,0,False,False,False,0,1,2022-02-16T19:35:45.257,10,False,3.0
2021,6,3143,810,15,8099,3,5,10,2,0,0,0,0,0,0,False,False,False,0,1,2021-10-18T00:06:53.807,0,False,0.0
2021,6,3143,815,15,914,2,29,2,17,20,3,19,1,19,0,False,False,False,0,2,2021-10-18T00:13:51.07,20,False,1.0
2021,6,3143,820,15,914,13,5,5,6,0,0,0,0,0,0,False,False,False,0,2,2021-10-18T00:11:09.063,0,False,0.0
2021,6,3143,830,15,914,13,12,6,23,0,0,0,0,0,0,False,False,False,0,2,2021-10-21T20:10:01.5,0,False,0.0
2021,6,3143,845,17,8483,2,5,3,8,8,0,8,0,8,0,True,False,False,0,2,2021-10-18T00:21:52.713,8,True,0.0
2021,6,3143,870,17,7618,3,5,3,4,0,0,0,0,0,0,False,False,False,0,1,2021-10-21T19:00:30.697,0,False,0.0
2021,6,3143,875,17,6274,2,5,3,5,5,0,5,0,5,0,False,False,False,0,3,2021-10-21T20:11:43.787,5,False,0.0
2021,6,3143,900,15,7591,2,4,5,8,12,4,10,2,10,0,False,False,False,0,2,2021-10-18T00:40:18.89,12,False,2.0
2021,6,3143,915,15,7591,2,2,10,6,9,3,9,0,9,0,False,False,False,0,3,2021-10-18T00:42:35.987,9,False,0.0
2021,6,3144,10,32,8527,13,6,1,17,0,0,0,0,0,0,False,False,False,0,2,2021-10-18T17:03:51.96,0,False,0.0
2021,6,3144,20,32,7128,13,19,6,37,0,0,0,0,0,0,False,False,False,0,2,2021-10-18T09:42:55.663,0,False,0.0
2021,6,3144,35,16,3938,2,46,3,0,6,6,4,2,4,0,False,False,False,0,3,2021-10-21T19:44:18.323,6,False,2.0
2021,6,3144,40,16,374,2,35,4,10,20,10,16,4,16,0,False,False,False,0,4,2021-10-18T09:52:32.783,20,False,4.0
2021,6,3144,45,16,3938,13,2,9,8,0,0,0,0,0,0,False,False,False,0,2,2021-10-21T20:19:30.11,0,False,0.0
2021,6,3144,50,16,6499,2,46,3,0,9,9,7,2,7,0,False,False,False,0,1,2021-10-18T09:57:14.29,9,False,2.0
2021,6,3144,65,16,3938,2,5,7,19,19,0,19,0,19,0,False,False,False,0,3,2021-10-18T16:36:10.07,19,False,0.0
2021,6,3144,70,16,7170,2,11,6,22,27,5,25,2,25,0,False,False,False,0,4,2021-10-18T10:07:01.38,27,False,2.0
2021,6,3144,105,32,3885,2,11,3,1,9,8,7,2,7,0,False,False,False,0,1,2021-10-18T10:21:38.707,9,False,2.0
2021,6,3144,115,32,3562,13,12,5,-2,0,0,0,0,0,0,True,False,False,0,3,2022-02-24T13:34:03.353,0,False,0.0
2021,6,3144,125,32,8527,2,13,9,5,13,8,12,1,12,0,False,False,False,0,3,2021-10-18T10:30:14.167,13,False,1.0
2021,6,3144,135,32,3885,13,13,5,4,0,0,0,0,0,0,False,False,False,0,3,2021-10-18T10:35:58.793,0,False,0.0
2021,6,3144,140,32,3885,2,46,3,0,6,6,5,1,5,0,False,False,False,0,1,2021-10-18T10:35:45.773,6,False,1.0
2021,6,3144,145,32,8527,13,29,2,32,0,0,0,0,0,0,False,False,False,0,2,2021-10-18T10:38:07.11,0,False,0.0
2021,6,3144,170,16,7176,2,19,2,26,49,23,29,20,29,0,False,False,False,0,2,2021-10-21T20:20:00.217,49,False,20.0
2021,6,3144,180,16,7176,2,4,10,2,3,1,3,0,3,0,False,False,False,0,2,2021-10-21T19:25:29.927,3,False,0.0
2021,6,3144,185,16,797,2,44,3,-5,5,10,0,5,0,0,False,False,False,1,1,2021-10-18T11:08:14.487,5,False,5.0
2021,6,3144,195,16,3938,3,26,5,3,0,0,0,0,0,0,False,False,False,0,2,2021-10-18T11:10:35.75,0,False,0.0
2021,6,3144,205,32,4788,2,47,5,-2,3,5,1,2,1,0,True,False,False,0,4,2021-10-18T11:14:58.217,3,False,2.0
2021,6,3144,210,32,8527,13,6,4,5,0,0,0,0,0,0,False,False,False,0,3,2021-10-18T11:16:58.173,0,False,0.0
2021,6,3144,220,16,6499,13,46,3,-1,0,0,0,0,0,0,False,False,False,0,1,2021-10-21T19:25:46.147,0,False,0.0
2021,6,3144,225,16,4143,13,9,2,17,0,0,0,0,0,0,False,False,False,0,2,2021-10-18T11:21:28.45,0,False,0.0
2021,6,3144,230,16,6500,2,46,3,-1,7,8,4,3,4,0,False,False,False,0,3,2021-10-18T16:37:35.267,7,False,3.0
2021,6,3144,245,32,8528,2,47,10,2,7,5,5,2,5,0,False,False,False,0,4,2021-10-21T16:23:47.847,7,False,2.0
2021,6,3144,250,32,7128,2,2,9,7,12,5,9,3,9,0,False,False,False,0,2,2021-10-18T11:30:35.997,12,False,3.0
2021,6,3144,255,32,4788,2,30,3,0,2,2,2,0,2,0,False,False,False,0,4,2021-10-21T20:00:01.753,2,False,0.0
2021,6,3144,260,32,7128,2,2,10,6,7,1,6,1,6,0,False,False,False,0,2,2021-10-18T11:33:54.133,7,False,1.0
2021,6,3144,270,32,7128,13,9,6,29,0,0,0,0,0,0,False,False,False,0,2,2021-10-18T11:36:50.977,0,False,0.0
2021,6,3144,280,32,7128,2,13,4,3,3,0,3,0,3,0,False,False,False,0,2,2021-12-15T00:34:59.233,3,False,0.0
2021,6,3144,300,16,797,13,4,10,3,0,0,0,0,0,0,False,False,False,0,1,2021-10-21T19:25:56.363,0,False,0.0
2021,6,3144,315,16,797,13,48,10,-3,0,0,0,0,0,0,False,False,False,0,1,2021-10-21T20:17:38.223,0,False,0.0
2021,6,3144,320,16,797,13,32,9,-3,0,0,0,0,0,0,False,False,False,0,1,2021-10-21T19:26:07.497,0,False,0.0
2021,6,3144,330,32,2675,13,8,1,22,0,0,0,0,0,0,False,False,False,0,3,2021-10-18T11:56:19.413,0,False,0.0
2021,6,3144,345,16,7176,13,35,7,34,0,0,0,0,0,0,False,False,False,0,3,2021-10-18T16:59:34.09,0,False,0.0
2021,6,3144,350,16,374,13,5,3,12,0,0,0,0,0,0,False,False,False,0,4,2021-10-21T20:01:33.447,0,False,
2021,6,3144,360,32,7807,3,32,10,-2,0,0,0,0,0,0,False,False,False,0,1,2021-10-21T20:02:19.52,0,False,0.0
2021,6,3144,365,32,8527,2,6,4,4,5,1,4,1,4,0,False,False,False,0,3,2021-10-18T12:33:29.04,5,False,1.0
2021,6,3144,370,32,7128,2,12,5,6,6,0,6,0,6,0,False,False,False,0,3,2022-02-24T13:34:57.663,6,False,0.0
2021,6,3144,375,32,4788,2,38,9,2,6,4,5,1,5,0,False,False,False,0,4,2021-10-21T16:33:48.127,6,False,
2021,6,3144,380,32,3885,2,45,5,-3,4,7,2,2,2,0,False,False,False,0,1,2021-10-18T12:40:11.95,4,False,2.0
2021,6,3144,385,32,7128,3,6,1,18,0,0,0,0,0,0,False,False,False,0,2,2021-10-18T12:41:55.783,0,False,0.0
2021,6,3144,390,32,3885,2,48,10,-5,16,21,13,3,13,0,False,False,False,0,1,2021-10-18T12:43:42.04,16,False,3.0
2021,6,3144,405,32,4788,2,19,7,19,39,20,39,0,39,6,True,False,False,0,4,2021-10-18T12:46:43.943,39,True,0.0
2021,6,3144,420,16,6500,2,7,2,27,27,0,27,0,27,0,False,False,False,0,3,2021-10-21T20:04:35.72,27,False,0.0
2021,6,3144,425,16,374,2,5,5,8,19,11,15,4,15,0,False,False,False,0,3,2021-10-18T12:53:29.397,19,False,4.0
2021,6,3144,430,16,374,2,6,4,12,17,5,17,0,17,0,False,False,False,0,3,2021-10-21T20:04:58.783,17,False,0.0
2021,6,3144,445,16,4143,13,5,5,7,0,0,0,0,0,0,False,False,False,0,2,2021-10-18T12:57:18.643,0,False,0.0
2021,6,3144,450,16,374,2,31,9,5,14,9,10,4,10,0,False,False,False,1,3,2021-10-18T12:59:34.753,14,False,4.0
2021,6,3144,455,16,374,13,4,5,4,0,0,0,0,0,0,True,False,False,0,4,2022-04-27T19:23:10.617,0,False,0.0
2021,6,3144,460,32,4788,13,12,2,16,0,0,0,0,0,0,False,False,False,0,3,2022-02-24T13:35:26.693,0,False,0.0
2021,6,3144,495,16,374,2,4,9,4,9,5,7,2,7,0,False,False,False,0,3,2021-10-18T13:14:37.373,9,False,2.0
2021,6,3144,500,16,4143,2,4,3,8,10,2,9,1,9,0,False,False,False,0,2,2021-10-19T20:22:16.37,10,False,1.0
2021,6,3144,515,16,4143,13,6,9,12,0,0,0,0,0,0,False,False,False,0,3,2021-10-18T13:22:04.3,0,False,0.0
2021,6,3144,520,16,7176,2,51,5,-2,5,7,4,1,4,0,True,False,False,0,4,2021-10-21T20:20:34.04,5,False,1.0
2021,6,3144,530,32,3885,2,47,5,-1,10,11,10,0,10,0,False,False,False,0,1,2021-10-18T13:27:48.297,10,True,0.0
2021,6,3144,540,32,4788,2,30,5,-3,14,17,14,0,14,0,True,False,False,0,4,2021-10-19T18:16:12.987,14,False,0.0
2021,6,3144,545,32,7807,2,50,5,0,4,4,2,2,2,0,False,False,False,0,2,2022-02-25T19:55:47,4,False,2.0
2021,6,3144,555,32,2675,2,51,3,-4,-4,0,-4,0,-4,0,False,False,False,0,3,2021-10-21T20:20:49.2,-4,True,0.0
2021,6,3144,565,16,6499,2,47,5,-2,13,15,0,13,0,0,False,False,False,2,1,2022-02-16T20:14:08.82,13,False,13.0
2021,6,3144,570,16,3938,2,51,3,-1,9,10,9,0,9,0,False,False,False,0,3,2021-10-21T19:23:48.25,9,False,0.0
2021,6,3144,580,16,6499,2,44,3,-2,5,7,5,0,5,0,False,False,False,1,1,2021-10-18T14:08:15.857,5,False,0.0
2021,6,3144,585,16,3938,2,6,9,12,12,0,12,0,12,0,False,False,False,0,3,2021-10-18T16:40:27.073,12,False,0.0
2021,6,3144,595,16,374,13,5,3,6,0,0,0,0,0,0,False,False,False,0,3,2022-02-16T20:14:45.393,0,False,0.0
2021,6,3144,600,16,3938,13,3,3,11,0,0,0,0,0,0,False,False,False,0,2,2021-10-18T14:13:53.277,0,False,
2021,6,3144,605,16,3938,2,4,5,13,13,0,13,0,13,0,False,False,False,0,3,2021-10-21T19:26:54.32,13,False,0.0
2021,6,3144,615,16,3938,2,2,4,2,2,0,2,0,2,6,False,False,False,0,3,2021-10-18T14:19:50.9,2,True,0.0
2021,6,3144,630,32,7807,2,48,3,-7,-4,3,-5,1,-5,0,False,False,False,0,1,2021-10-19T18:14:56.437,-4,False,1.0
2021,6,3144,635,32,3885,2,5,3,6,9,3,8,1,8,0,False,False,False,0,3,2021-10-18T14:26:11.9,9,False,1.0
2021,6,3144,640,32,4788,13,4,10,1,0,0,0,0,0,0,False,False,False,0,3,2021-10-18T14:30:17.803,0,False,0.0
2021,6,3144,655,16,3938,2,5,5,7,9,2,6,3,6,0,False,False,False,1,2,2021-10-21T20:14:14.2,9,False,3.0
2021,6,3144,660,16,3938,2,51,3,-2,0,2,0,0,0,0,False,False,False,0,3,2021-10-18T14:37:59.817,0,False,0.0
2021,6,3144,665,16,374,2,47,5,2,3,1,2,1,2,0,True,False,False,0,3,2021-10-21T20:21:12.297,3,False,1.0
2021,6,3144,685,16,374,2,5,3,5,11,6,9,2,9,0,True,False,False,0,3,2021-10-21T19:27:05.503,11,False,2.0
2021,6,3144,715,32,7128,13,19,2,49,0,0,0,0,0,0,False,False,False,0,3,2021-10-21T20:21:36.487,0,False,0.0
2021,6,3144,725,32,8527,2,6,4,13,12,-1,12,0,12,0,False,False,False,0,2,2021-10-18T15:14:28.127,12,False,0.0
2021,6,3144,730,32,3885,2,47,5,-2,4,6,4,0,4,0,False,False,False,0,1,2021-10-18T15:18:17.99,4,False,0.0
2021,6,3144,735,32,8659,2,48,9,-4,-2,2,-2,0,-2,0,False,False,False,0,1,2021-10-18T15:20:32.83,-2,False,0.0
2021,6,3144,765,16,7176,2,51,9,-2,5,7,3,2,3,0,True,False,False,0,3,2021-10-21T19:24:01.333,5,False,2.0
2021,6,3144,770,16,3938,13,6,9,8,0,0,0,0,0,0,False,False,False,0,3,2021-10-21T17:11:24.523,0,False,0.0
2021,6,3144,775,16,6500,2,12,8,22,21,-1,21,0,21,0,True,False,False,0,2,2022-02-24T13:36:14.097,21,False,0.0
2021,6,3144,785,16,374,13,5,3,5,0,0,0,0,0,0,True,False,False,0,2,2022-02-16T20:15:10.717,0,False,0.0
2021,6,3144,790,16,3938,2,12,4,14,19,5,16,3,16,0,False,False,False,1,3,2022-02-24T13:36:30.437,19,False,
2021,6,3144,795,16,3938,2,26,10,1,6,5,6,0,6,0,True,False,False,1,3,2021-10-21T20:12:04.823,6,False,0.0
2021,6,3144,810,16,4143,2,12,5,11,12,1,12,0,12,0,False,False,False,0,2,2022-02-24T13:37:17.273,12,False,0.0
2021,6,3144,830,16,374,2,4,3,2,6,4,4,2,4,0,True,False,False,0,3,2021-10-18T16:09:00.107,6,False,2.0
2021,6,3144,840,16,4143,2,19,2,24,24,0,24,0,24,6,False,False,False,0,2,2021-10-21T20:13:24.28,24,True,0.0
2021,6,3144,855,32,3885,2,12,5,4,7,3,5,2,5,0,False,False,False,0,1,2022-02-24T13:37:35.8,7,False,2.0
2021,6,3144,860,32,3885,13,45,5,-8,0,0,0,0,0,0,False,False,False,0,1,2021-10-21T19:28:36.84,0,False,0.0
2021,6,3145,20,21,8518,2,5,6,17,17,0,17,0,17,0,False,False,False,0,2,2021-10-18T09:25:00.08,17,False,0.0
2021,6,3145,25,21,3680,2,5,3,4,8,4,7,1,7,0,False,False,False,0,3,2021-10-19T20:30:18.127,8,False,1.0
2021,6,3145,30,21,4674,13,4,10,5,0,0,0,0,0,0,False,False,False,0,3,2021-10-18T09:36:48.323,0,False,
2021,6,3145,40,21,8518,2,49,3,-2,3,5,1,2,1,0,False,False,False,0,2,2021-10-18T09:42:42.187,3,False,2.0
2021,6,3145,45,21,8518,2,4,5,6,16,10,6,10,6,0,False,False,False,1,2,2021-10-18T09:46:17.057,16,False,10.0
2021,6,3145,55,21,6365,13,5,3,5,0,0,0,0,0,0,False,False,False,0,3,2022-02-16T20:00:52.937,0,False,0.0
2021,6,3145,65,21,3680,3,50,10,0,0,0,0,0,0,0,False,False,False,0,3,2021-10-18T10:00:56.05,0,False,0.0
2021,6,3145,75,21,7592,13,9,5,8,0,0,0,0,0,0,False,False,False,0,2,2021-10-18T10:05:48.883,0,False,0.0
2021,6,3145,90,29,7828,13,35,3,13,0,0,0,0,0,0,False,False,False,0,3,2021-10-18T10:14:47.527,0,False,0.0
2021,6,3145,95,29,4866,2,5,2,18,30,12,27,3,27,0,False,False,False,0,3,2021-10-18T10:18:52.88,30,False,3.0
2021,6,3145,105,29,1958,2,4,10,13,16,3,15,1,15,0,False,False,False,0,2,2021-10-21T22:56:51.683,16,False,1.0
2021,6,3145,110,29,4866,3,6,7,16,0,0,0,0,0,0,False,False,False,0,2,2021-10-21T21:48:33.2,0,False,0.0
2021,6,3145,130,21,3957,2,12,10,2,2,0,2,0,2,0,False,False,False,0,1,2022-02-24T13:39:07.567,2,False,0.0
2021,6,3145,140,21,3680,2,4,9,9,9,0,9,0,9,0,False,False,False,0,3,2021-10-21T22:57:21.29,9,False,0.0
2021,6,3145,145,21,3957,2,48,10,-2,4,6,2,2,2,0,False,False,False,0,1,2022-02-16T20:02:00.127,4,False,2.0
2021,6,3145,150,21,6365,13,5,3,7,0,0,0,0,0,0,False,False,False,0,3,2021-10-18T10:50:21.977,0,False,0.0
2021,6,3145,165,21,7592,13,6,10,6,0,0,0,0,0,0,False,False,False,0,2,2021-10-18T11:02:55.977,0,False,0.0
2021,6,3145,175,21,6365,2,12,5,11,14,3,14,0,14,0,False,False,False,0,2,2022-02-24T13:39:21.9,14,False,0.0
2021,6,3145,185,29,1958,13,2,9,10,0,0,0,0,0,0,False,False,False,0,3,2022-02-14T19:39:37.497,0,False,0.0
2021,6,3145,190,29,4866,2,4,9,6,6,0,6,0,6,0,False,False,False,0,3,2021-10-18T17:19:48.937,6,False,0.0
2021,6,3145,200,29,8455,2,4,3,10,15,5,10,5,10,0,False,False,False,0,2,2021-10-21T23:18:11.793,15,False,
2021,6,3145,220,21,4422,2,5,9,5,7,2,6,1,6,0,False,False,False,0,3,2021-10-18T11:33:17.743,7,False,1.0
2021,6,3145,250,29,4866,2,7,2,26,28,2,27,1,27,0,False,False,False,0,3,2021-10-18T11:47:33.687,28,False,1.0
2021,6,3145,255,29,3398,2,30,9,0,10,10,7,3,7,0,True,False,False,1,4,2021-10-19T23:56:08.813,10,False,3.0
2021,6,3145,265,29,1958,2,39,4,4,15,11,15,0,15,6,False,False,False,0,3,2021-10-18T11:54:44.07,15,True,0.0
2021,6,3145,280,21,4422,13,4,9,5,0,0,0,0,0,0,False,False,False,0,3,2021-10-18T12:02:22.677,0,False,0.0
2021,6,3145,300,29,7378,3,12,3,2,0,0,0,0,0,0,False,False,False,0,1,2022-02-24T13:39:43.773,0,False,0.0
2021,6,3145,305,29,3398,2,2,10,8,9,1,9,0,9,0,False,False,False,0,3,2021-10-18T12:17:00.013,9,False,0.0
2021,6,3145,320,29,4866,2,47,5,2,3,1,3,0,3,6,False,False,False,0,3,2021-10-18T12:21:00.06,3,True,0.0
2021,6,3145,335,21,6365,13,4,3,8,0,0,0,0,0,0,False,False,False,0,2,2021-10-18T12:24:44.787,0,False,0.0
2021,6,3145,345,21,4674,13,5,5,10,0,0,0,0,0,0,False,False,False,0,3,2021-10-18T12:28:47.617,0,False,0.0
2021,6,3145,360,29,1958,13,4,10,13,0,0,0,0,0,0,False,False,False,0,3,2022-02-16T20:02:44.64,0,False,0.0
2021,6,3145,380,21,4422,13,6,4,10,0,0,0,0,0,0,False,False,False,0,3,2021-10-21T22:52:11.6,0,False,0.0
2021,6,3145,390,29,3398,2,5,3,4,4,0,4,0,4,0,False,False,False,0,3,2021-10-21T21:59:19.01,4,False,0.0
2021,6,3145,395,29,3398,2,47,10,3,4,1,4,0,4,0,False,False,False,0,3,2021-10-21T21:59:50.237,4,False,0.0
2021,6,3145,420,21,813,2,32,5,0,8,8,3,5,3,0,False,False,False,1,4,2021-10-18T13:10:47.63,8,False,5.0
2021,6,3145,430,21,3680,13,4,10,4,0,0,0,0,0,0,False,False,False,0,3,2021-10-18T13:15:15.607,0,False,0.0
2021,6,3145,435,21,3680,2,5,5,3,3,0,3,0,3,0,False,False,False,0,3,2021-10-18T13:17:47.507,3,False,0.0
2021,6,3145,445,21,6365,13,4,9,10,0,0,0,0,0,0,False,False,False,0,3,2021-10-18T13:20:20.75,0,False,0.0
2021,6,3145,455,29,4866,2,51,9,-4,25,29,25,0,25,0,False,False,False,0,3,2021-10-21T22:15:53.02,25,False,0.0
2021,6,3145,470,29,3398,2,5,5,5,9,4,8,1,8,0,False,False,False,0,3,2021-10-18T13:31:09.69,9,False,1.0
2021,6,3145,475,29,7828,2,50,3,-3,-4,-1,-4,0,-4,0,False,False,False,0,2,2021-10-18T13:35:07.083,-4,False,0.0
2021,6,3145,480,29,4866,2,35,7,15,16,1,16,0,16,0,False,False,False,0,3,2021-10-18T13:38:57.953,16,False,0.0
2021,6,3145,485,29,7378,2,20,6,23,25,2,25,0,25,6,False,False,False,0,2,2021-10-18T13:42:15.48,25,True,0.0
2021,6,3145,500,21,3680,13,6,8,25,0,0,0,0,0,0,False,False,False,0,2,2021-10-21T22:52:24.257,0,False,0.0
2021,6,3145,505,29,7378,2,4,4,3,4,1,4,0,4,0,False,False,False,0,1,2021-10-18T13:51:36.953,4,False,0.0
2021,6,3145,515,29,4866,3,6,7,21,0,0,0,0,0,0,False,False,False,0,2,2021-10-21T22:52:40.84,0,False,0.0
2021,6,3145,535,29,4866,2,5,5,5,4,-1,4,0,4,0,False,False,False,0,3,2021-10-21T22:58:57.487,4,False,0.0
2021,6,3145,545,29,4866,2,51,3,-5,5,10,0,5,0,0,True,False,False,0,1,2021-10-21T22:16:22.48,5,False,5.0
2021,6,3145,555,29,7828,2,50,5,-2,18,20,18,0,18,0,False,False,False,0,2,2021-10-18T14:08:45.977,18,False,0.0
2021,6,3145,565,29,7828,2,4,3,5,5,0,5,0,5,0,False,False,False,0,2,2021-10-18T14:14:23.103,5,False,0.0
2021,6,3145,610,21,3680,2,4,9,9,10,1,10,0,10,0,False,False,False,0,3,2021-10-19T20:30:44.463,10,False,0.0
2021,6,3145,620,21,3680,2,4,10,6,10,4,7,3,7,0,False,False,False,0,2,2021-10-18T17:25:37.19,10,False,3.0
2021,6,3145,635,21,3957,2,48,9,-6,11,17,8,3,8,0,False,False,False,1,1,2021-10-21T22:53:34.227,11,False,3.0
2021,6,3145,640,21,6365,2,2,9,7,15,8,13,2,13,0,False,False,False,0,2,2021-10-18T14:53:24.577,15,False,2.0
2021,6,3145,645,21,6365,13,4,3,6,0,0,0,0,0,0,False,False,False,0,2,2021-10-21T22:52:55.223,0,False,0.0
2021,6,3145,655,29,967,2,4,5,5,6,1,6,0,6,0,False,False,False,0,2,2021-10-18T15:01:39.243,6,False,0.0
2021,6,3145,695,29,4866,2,30,3,-1,13,14,13,0,13,6,False,False,False,0,4,2021-10-21T22:06:43.88,13,True,0.0
2021,6,3145,710,21,4674,13,3,6,16,0,0,0,0,0,0,False,False,False,0,2,2021-10-18T15:25:01.15,0,False,0.0
2021,6,3145,720,21,3680,3,12,10,17,0,0,0,0,0,0,False,False,False,0,3,2022-02-22T21:25:20.39,0,False,0.0
2021,6,3145,735,29,1958,13,5,5,4,0,0,0,0,0,0,False,False,False,0,3,2021-10-21T22:07:49.43,0,False,0.0
2021,6,3145,740,29,4866,13,39,1,16,0,0,0,0,0,0,False,False,False,0,3,2021-10-21T22:51:41.037,0,False,0.0
2021,6,3145,750,21,4422,2,53,3,-6,6,12,4,2,4,0,False,False,False,0,4,2022-02-16T20:03:20.287,6,False,2.0
2021,6,3145,755,21,3680,13,21,6,17,0,0,0,0,0,0,False,False,False,0,2,2021-10-18T15:57:23.303,0,False,0.0
2021,6,3145,760,21,7592,2,2,10,6,10,4,10,0,10,0,False,False,False,0,2,2021-10-18T16:01:03.247,10,False,0.0
2021,6,3145,765,21,4180,13,32,9,-2,0,0,0,0,0,0,False,False,False,0,1,2021-10-19T20:31:14.13,0,False,0.0
2021,6,3145,775,21,6365,2,4,10,4,3,-1,3,0,3,0,False,False,False,0,3,2021-10-18T16:08:50.447,3,False,0.0
2021,6,3145,780,21,6365,2,2,10,6,10,4,7,3,7,0,False,False,False,0,2,2021-10-18T16:12:29.987,10,False,3.0
2021,6,3145,785,21,4180,2,28,10,0,1,1,1,0,1,0,False,False,False,0,1,2022-02-14T19:39:47.99,1,False,0.0
2021,6,3145,795,21,813,13,4,5,12,0,0,0,0,0,0,False,False,False,0,3,2021-10-21T22:59:15.317,0,False,0.0
2021,6,3145,800,21,3680,2,2,4,6,14,8,8,6,8,0,False,False,False,1,3,2021-10-18T16:22:01.35,14,False,6.0
2021,6,3145,875,21,3957,2,6,9,1,11,10,7,4,7,0,False,False,False,0,1,2021-10-21T22:53:51.133,11,False,4.0
2021,6,3145,880,21,3680,2,4,10,6,12,6,11,1,11,0,False,False,False,1,3,2021-10-18T16:54:08.093,12,False,1.0
2021,6,3145,885,21,4422,2,4,9,7,11,4,8,3,8,0,False,False,False,0,3,2021-10-21T21:41:48.363,11,False,3.0
2021,6,3145,890,21,7592,2,5,5,11,11,0,11,0,11,0,False,False,False,0,2,2021-10-18T16:56:30.827,11,False,0.0
2021,6,3145,900,21,3680,2,4,5,4,7,3,6,1,6,0,False,False,False,0,2,2021-10-18T16:59:46.18,7,False,1.0
2021,6,3145,905,21,6365,2,4,9,5,6,1,6,0,6,0,False,False,False,0,3,2021-10-18T17:01:40.893,6,False,0.0
2021,6,3145,910,21,7592,13,5,3,7,0,0,0,0,0,0,False,False,False,0,2,2021-10-18T17:03:17.647,0,False,0.0
2021,6,3145,915,21,3680,2,4,10,2,2,0,2,0,2,0,False,False,False,0,3,2021-10-18T17:05:07.76,2,False,0.0
2021,6,3145,925,21,3680,2,4,4,1,1,0,1,0,1,0,False,False,False,0,3,2021-10-18T17:07:20.477,1,False,0.0
2021,6,3146,20,13,2455,13,11,5,2,0,0,0,0,0,0,False,False,False,0,1,2021-10-21T16:15:45.177,0,False,0.0
2021,6,3146,25,13,3586,2,50,3,-4,6,10,6,0,6,0,True,False,False,0,2,2021-10-21T17:11:03.447,6,False,0.0
2021,6,3146,35,14,1114,2,4,5,8,12,4,12,0,12,0,False,False,False,1,2,2021-10-18T09:34:36.44,12,False,0.0
2021,6,3146,45,14,6543,13,2,3,7,0,0,0,0,0,0,False,False,False,0,2,2021-10-18T09:39:16.587,0,False,0.0
2021,6,3146,50,14,6543,2,50,3,-3,9,12,5,4,5,0,False,False,False,2,3,2021-10-21T17:22:52.583,9,False,4.0
2021,6,3146,60,13,876,2,50,3,-2,3,5,3,0,3,0,False,False,False,0,2,2021-10-18T09:45:53.52,3,False,0.0
2021,6,3146,70,13,876,2,3,3,9,9,0,9,0,9,0,False,False,False,0,2,2021-10-18T09:49:56.96,9,False,0.0
2021,6,3146,75,13,2407,2,5,5,7,10,3,10,0,10,0,False,False,False,0,3,2021-10-18T09:52:25.373,10,False,0.0
2021,6,3146,90,13,8417,2,12,10,14,14,0,14,0,14,0,False,False,False,0,2,2021-10-21T17:16:26.707,14,False,0.0
2021,6,3146,95,13,4662,2,53,10,-3,5,8,3,2,3,0,False,False,False,0,4,2021-10-18T10:04:02.587,5,False,2.0
2021,6,3146,105,13,876,2,2,9,6,8,2,8,0,8,0,False,False,False,0,2,2021-10-18T10:10:49.913,8,False,0.0
2021,6,3146,125,14,7584,2,7,2,17,17,0,17,0,17,0,False,False,False,0,4,2021-10-18T10:17:41.107,17,False,0.0
2021,6,3146,135,14,7582,2,50,5,-1,13,14,11,2,11,0,False,False,False,0,2,2021-10-18T10:22:47.213,13,False,2.0
2021,6,3146,140,14,7582,3,4,4,2,0,0,0,0,0,0,False,False,False,0,1,2021-10-18T10:25:16.64,0,False,0.0
2021,6,3146,145,14,7495,2,4,9,5,7,2,7,0,7,0,False,False,False,0,3,2021-10-21T17:12:29.553,7,False,0.0
2021,6,3146,150,14,6938,2,7,7,48,51,3,49,2,49,6,False,False,False,0,3,2021-10-21T17:40:32.667,51,False,2.0
2021,6,3146,170,13,876,13,5,6,15,0,0,0,0,0,0,False,False,False,0,3,2022-02-16T19:27:02.81,0,False,0.0
2021,6,3146,180,13,3586,2,50,5,-4,-4,0,-4,0,-4,0,True,False,False,0,2,2022-02-25T17:25:28.223,-4,False,0.0
2021,6,3146,200,14,1114,2,8,2,52,52,0,52,0,52,0,False,False,False,0,3,2021-10-21T17:43:21.613,52,False,0.0
2021,6,3146,205,14,1119,3,2,4,4,0,0,0,0,0,0,True,False,False,0,3,2022-02-22T20:25:04.237,0,False,0.0
2021,6,3146,210,14,5197,3,24,2,28,0,0,0,0,0,0,False,False,False,0,4,2021-10-21T17:47:15.673,0,False,0.0
2021,6,3146,235,13,8417,2,8,9,13,18,5,15,3,15,0,False,False,False,0,2,2021-10-18T11:11:07.93,18,False,3.0
2021,6,3146,245,13,6528,2,35,5,13,13,0,13,0,13,0,False,False,False,0,4,2021-10-18T11:14:46.453,13,False,0.0
2021,6,3146,250,13,6481,2,28,4,1,9,8,9,0,9,0,False,False,False,0,1,2021-10-21T17:19:18.457,9,False,0.0
2021,6,3146,255,13,876,13,7,2,30,0,0,0,0,0,0,False,False,False,0,3,2021-10-18T11:19:56.3,0,False,0.0
2021,6,3146,260,13,876,2,4,3,4,4,0,4,0,4,0,False,False,False,0,2,2021-10-18T11:21:41.023,4,False,0.0
2021,6,3146,275,13,8417,2,4,5,5,5,0,5,0,5,0,False,False,False,0,2,2021-10-21T17:29:54.07,5,False,0.0
2021,6,3146,280,13,902,2,51,3,-4,5,9,-2,7,-2,0,True,False,False,1,1,2021-10-19T20:54:19.277,5,False,7.0
2021,6,3146,290,13,6528,13,7,5,12,0,0,0,0,0,0,False,False,False,0,4,2021-10-18T11:37:14.903,0,False,0.0
2021,6,3146,315,14,1114,2,5,5,6,6,0,6,0,6,0,False,False,False,0,2,2021-10-21T17:30:23.243,6,True,0.0
2021,6,3146,325,14,7584,2,29,2,18,18,0,18,0,18,0,False,False,False,0,2,2021-10-18T11:46:55.083,18,True,0.0
2021,6,3146,350,14,5197,3,38,9,5,0,0,0,0,0,0,False,False,False,0,3,2022-02-16T19:27:27.673,0,False,0.0
2021,6,3146,370,13,4662,2,5,3,3,3,0,3,0,3,0,False,False,False,0,4,2021-10-18T12:01:54.243,3,False,0.0
2021,6,3146,385,13,876,2,7,2,16,20,4,20,0,20,0,False,False,False,0,3,2021-10-18T12:07:20.177,20,True,0.0
2021,6,3146,390,13,2455,13,4,4,3,0,0,0,0,0,0,False,False,False,0,1,2021-10-18T12:11:49.01,0,False,
2021,6,3146,395,13,3586,2,35,5,11,11,0,11,0,11,0,False,False,False,0,3,2021-10-18T12:14:30.337,11,False,0.0
2021,6,3146,405,13,3586,13,19,3,14,0,0,0,0,0,0,False,False,False,0,3,2021-10-18T12:17:20.88,0,False,0.0
2021,6,3146,460,13,8417,13,6,4,11,0,0,0,0,0,0,False,False,False,0,2,2021-10-18T12:35:35.883,0,False,0.0
2021,6,3146,470,14,5197,2,7,6,23,28,5,28,0,28,6,False,False,False,0,4,2021-10-21T17:44:41.44,28,True,0.0
2021,6,3146,490,13,4662,13,7,5,13,0,0,0,0,0,0,False,False,False,0,4,2021-10-18T12:44:37.353,0,False,0.0
2021,6,3146,495,13,876,2,12,2,17,17,0,17,0,17,0,False,False,False,0,2,2022-02-24T13:41:30.587,17,False,0.0
2021,6,3146,505,13,6528,2,51,3,-2,8,10,6,2,6,0,False,False,False,0,4,2021-10-21T17:11:41.617,8,False,2.0
2021,6,3146,510,13,8417,13,2,10,6,0,0,0,0,0,0,False,False,False,0,2,2021-10-21T17:48:15.393,0,False,0.0
2021,6,3146,550,13,3586,2,50,10,-4,1,5,0,1,0,0,False,False,False,0,2,2021-10-21T17:33:33.927,1,False,1.0
2021,6,3146,560,13,876,2,4,5,9,9,0,9,0,9,0,False,False,False,0,2,2021-10-18T13:13:05.127,9,False,0.0
2021,6,3146,580,13,876,2,5,5,9,13,4,9,4,9,0,False,False,False,1,2,2021-10-21T17:19:31.673,13,False,4.0
2021,6,3146,590,13,6528,2,5,5,6,8,2,6,2,6,0,False,False,False,0,4,2021-10-18T13:29:18.48,8,False,2.0
2021,6,3146,600,13,876,13,9,2,24,0,0,0,0,0,0,False,False,False,0,3,2021-10-18T13:33:42.343,0,False,0.0
2021,6,3146,615,13,2407,3,13,10,2,0,0,0,0,0,0,False,False,False,0,2,2021-10-18T13:38:29.493,0,False,0.0
2021,6,3146,620,13,6528,13,38,4,6,0,0,0,0,0,0,True,False,False,0,3,2021-10-21T17:48:28.003,0,False,0.0
2021,6,3146,635,14,7584,13,4,5,13,0,0,0,0,0,0,False,False,False,0,2,2021-10-18T13:49:05.823,0,False,0.0
2021,6,3146,645,13,876,2,4,5,5,6,1,6,0,6,0,False,False,False,0,2,2021-10-18T13:52:13.573,6,False,0.0
2021,6,3146,650,13,902,2,47,5,-4,3,7,3,0,3,0,False,False,False,0,1,2022-02-22T20:26:11.227,3,False,0.0
2021,6,3146,670,13,2455,2,16,10,4,14,10,12,2,12,0,False,False,False,0,1,2021-10-18T14:01:19.897,14,False,2.0
2021,6,3146,675,13,8417,2,4,5,6,7,1,6,1,6,0,False,False,False,0,2,2021-10-18T14:04:17.47,7,False,1.0
2021,6,3146,705,14,4449,13,2,4,5,0,0,0,0,0,0,False,False,False,0,3,2021-10-21T17:14:49.513,0,False,0.0
2021,6,3146,710,14,1114,2,13,9,3,10,7,10,0,10,0,False,False,False,0,3,2021-10-18T14:21:06.89,10,False,0.0
2021,6,3146,740,13,6481,2,46,3,-3,6,9,6,0,6,0,False,False,False,0,1,2021-10-19T20:53:15.14,6,False,0.0
2021,6,3146,755,13,1510,13,47,5,0,0,0,0,0,0,0,False,False,False,0,1,2021-10-19T20:53:53.043,0,False,0.0
2021,6,3146,760,13,6528,2,4,5,8,12,4,12,0,12,0,False,False,False,0,4,2021-10-21T17:21:20.733,12,False,0.0
2021,6,3146,765,13,876,13,19,2,20,0,0,0,0,0,0,False,False,False,0,2,2021-10-21T17:19:04.343,0,False,0.0
2021,6,3147,15,11,6810,2,32,3,0,11,11,8,3,8,0,False,False,False,0,4,2021-10-18T16:17:02.393,11,False,
2021,6,3147,30,11,7732,13,28,9,0,0,0,0,0,0,0,False,False,False,0,1,2021-10-18T09:31:04.603,0,False,0.0
2021,6,3147,50,7,7659,2,6,10,10,14,4,12,2,12,0,False,False,False,0,2,2021-10-18T16:26:45.583,14,False,2.0
2021,6,3147,65,7,8317,13,4,10,10,0,0,0,0,0,0,False,False,False,0,2,2021-10-18T09:50:36.113,0,False,0.0
2021,6,3147,75,7,8325,2,9,6,22,24,2,24,0,24,6,False,False,False,0,2,2021-10-18T16:44:26.553,24,True,0.0
2021,6,3147,95,11,6810,2,50,9,-2,0,2,-2,2,-2,0,True,False,False,0,3,2021-10-18T10:01:04.013,0,False,2.0
2021,6,3147,100,11,6810,2,13,10,4,7,3,5,2,5,0,False,False,False,0,3,2021-10-18T10:03:20.967,7,False,2.0
2021,6,3147,110,7,4679,2,32,9,-5,5,10,4,1,4,0,False,False,False,0,1,2022-01-05T15:08:04.633,5,False,1.0
2021,6,3147,130,7,7659,2,35,3,14,18,4,14,4,14,0,False,False,False,0,3,2021-10-21T22:52:52.577,18,False,
2021,6,3147,140,7,2631,2,4,10,5,5,0,5,0,5,0,False,False,False,0,4,2021-10-18T10:21:43.117,5,False,0.0
2021,6,3147,145,7,8317,3,4,8,18,0,0,0,0,0,0,False,False,False,0,3,2022-01-05T18:36:44.023,0,True,0.0
2021,6,3147,155,11,8359,13,17,1,22,0,0,22,-1021,22,0,False,False,False,0,3,2021-10-21T22:53:39.93,0,False,0.0
2021,6,3147,165,7,8317,2,50,10,-2,1,3,1,0,1,0,False,False,False,0,2,2021-10-18T10:40:34.313,1,False,0.0
2021,6,3147,170,7,3521,2,4,9,5,11,6,6,5,6,0,False,False,False,0,3,2021-10-21T22:55:22.743,11,False,
2021,6,3147,175,7,8317,2,4,5,4,9,5,7,2,7,0,False,False,False,0,2,2021-10-18T10:45:59.3,9,False,2.0
2021,6,3147,195,11,6810,2,32,9,2,10,8,6,4,6,0,False,False,False,0,4,2021-10-18T10:52:55.373,10,False,4.0
2021,6,3147,215,11,4037,2,5,3,4,4,0,4,0,4,0,False,False,False,0,3,2021-10-18T11:01:36.48,4,False,0.0
2021,6,3147,225,11,6810,13,11,3,8,0,0,0,0,0,0,False,False,False,0,1,2021-10-18T16:18:05.413,0,True,0.0
2021,6,3147,240,7,4679,2,46,9,-1,4,5,1,3,1,0,False,False,False,1,1,2022-01-05T15:51:32.643,4,False,3.0
2021,6,3147,255,11,4037,2,18,3,-1,6,7,2,4,2,0,False,False,False,1,2,2021-10-18T11:27:24.143,6,False,4.0
2021,6,3147,260,11,4037,2,5,3,5,5,0,5,0,5,0,False,False,False,0,3,2021-10-18T11:29:10.267,5,False,0.0
2021,6,3147,265,11,7732,2,51,10,-4,3,7,1,2,1,0,True,False,False,0,1,2021-10-18T16:10:42.203,3,False,2.0
2021,6,3147,275,11,4037,2,13,10,3,5,2,4,1,4,0,False,False,False,0,3,2021-10-18T11:34:21.39,5,False,1.0
2021,6,3147,295,11,4561,2,47,5,-3,-2,1,-2,0,-2,0,False,False,False,0,1,2021-10-18T11:39:32.013,-2,False,0.0
2021,6,3147,300,11,6810,13,35,10,8,0,0,0,0,0,0,True,False,False,0,2,2021-10-18T11:42:09.293,0,True,0.0
2021,6,3147,315,7,4679,2,44,9,-5,3,8,3,0,3,0,False,True,False,0,1,2022-02-22T20:18:02.25,1,False,0.0
2021,6,3147,325,7,7659,13,51,5,2,0,0,0,0,0,0,False,False,False,0,3,2022-01-05T16:07:03.287,0,True,0.0
2021,6,3147,335,11,4037,13,9,6,16,0,0,0,0,0,0,False,False,False,0,2,2021-10-21T21:57:20.413,0,False,0.0
2021,6,3147,360,7,3521,2,26,9,5,7,2,6,1,6,0,False,False,False,0,3,2021-10-18T12:08:52.2,7,False,1.0
2021,6,3147,370,7,4679,2,47,10,0,9,9,7,2,7,0,True,False,False,0,1,2022-01-05T16:14:53.87,9,False,2.0
2021,6,3147,375,7,7659,13,5,5,10,0,0,0,0,0,0,False,False,False,0,2,2022-01-05T16:16:12.71,0,False,0.0
2021,6,3147,380,7,7659,13,6,10,12,0,0,0,0,0,0,False,False,False,0,2,2022-01-05T16:17:25.927,0,True,0.0
2021,6,3147,385,7,8317,2,19,2,31,34,3,32,2,32,0,False,False,False,0,2,2021-10-21T22:56:51.463,34,False,2.0
2021,6,3147,440,7,2631,2,32,3,4,8,4,6,2,6,0,False,False,False,0,3,2022-01-05T16:35:43.65,8,False,2.0
2021,6,3147,445,7,4679,13,48,10,-4,0,0,0,0,0,0,False,False,False,0,1,2021-10-18T12:43:42.417,0,False,0.0
2021,6,3147,455,7,4679,2,47,10,2,40,38,40,0,40,6,False,False,False,0,1,2021-10-18T12:50:42.383,40,True,0.0
2021,6,3147,470,11,6810,2,4,4,5,5,0,5,0,5,0,True,False,False,0,3,2021-10-18T12:54:58.997,5,False,0.0
2021,6,3147,475,11,6810,2,4,10,4,4,0,4,0,4,0,False,False,False,0,3,2021-10-18T12:56:39.573,4,False,0.0
2021,6,3147,495,7,7659,2,6,10,4,7,3,6,1,6,0,False,False,False,0,2,2021-10-18T13:03:52.533,7,False,1.0
2021,6,3147,530,7,7659,2,6,1,15,23,8,20,3,20,0,False,False,False,0,2,2021-10-21T23:25:59.523,23,False,3.0
2021,6,3147,540,7,6975,13,17,7,17,0,0,0,0,0,0,False,False,False,0,4,2021-10-18T13:18:47.84,0,False,0.0
2021,6,3147,545,7,3521,13,6,10,7,0,0,0,0,0,0,False,False,False,0,3,2022-02-16T19:22:09.11,0,False,0.0
2021,6,3147,565,11,6810,2,17,7,22,33,11,33,0,33,0,True,False,False,0,4,2022-02-22T20:18:47.037,33,False,0.0
2021,6,3147,570,11,6633,2,50,5,-1,2,3,1,1,1,0,False,False,False,0,2,2021-10-18T13:26:15.333,2,False,1.0
2021,6,3147,575,11,4561,3,16,4,4,0,0,0,0,0,0,False,False,False,0,1,2021-10-18T13:28:11.247,0,False,0.0
2021,6,3147,580,11,8359,13,7,6,18,0,0,0,0,0,0,False,False,False,0,3,2021-10-18T13:31:08.977,0,False,0.0
2021,6,3147,600,7,8325,2,4,9,1,11,10,5,6,5,0,False,False,False,1,1,2022-01-05T16:54:17.16,11,False,6.0
2021,6,3147,610,7,8317,2,8,8,41,53,12,51,2,51,0,False,False,False,0,2,2021-10-21T21:32:42.373,53,False,2.0
2021,6,3147,630,7,8325,2,16,9,4,14,10,6,8,6,0,False,False,False,1,1,2021-10-21T22:57:54.737,14,False,8.0
2021,6,3147,635,7,2631,2,13,3,2,2,0,2,0,2,6,False,False,False,0,4,2021-10-18T14:04:54.143,2,True,0.0
2021,6,3147,650,11,8359,2,39,4,5,9,4,9,0,9,0,False,False,False,0,3,2021-10-18T14:08:13.977,9,False,0.0
2021,6,3147,655,11,6810,2,4,10,5,5,0,5,0,5,0,False,False,False,0,3,2021-10-18T14:10:19.697,5,False,0.0
2021,6,3147,665,11,8359,2,5,3,3,3,0,3,0,3,0,False,False,False,0,3,2021-10-18T14:14:10.237,3,False,0.0
2021,6,3147,675,11,6815,2,6,4,4,15,11,12,3,12,0,False,False,False,0,3,2021-10-18T14:18:00.92,15,False,3.0
2021,6,3147,680,11,6633,13,9,6,26,0,0,0,0,0,0,False,False,False,0,2,2021-10-18T16:26:21.513,0,False,0.0
2021,6,3147,685,11,8359,2,4,10,6,7,1,7,0,7,0,False,False,False,0,4,2021-10-18T14:24:15.96,7,False,0.0
2021,6,3147,690,11,8359,2,2,4,4,4,0,4,0,4,0,False,False,False,0,3,2021-10-18T14:26:47.043,4,False,0.0
2021,6,3147,700,11,7732,2,28,10,2,3,1,3,0,3,0,False,False,False,0,1,2021-10-18T14:32:02.373,3,False,0.0
2021,6,3147,710,11,7732,3,12,5,4,0,0,0,0,0,0,False,False,False,0,1,2022-02-16T19:22:59.337,0,False,0.0
2021,6,3147,735,7,7659,13,9,6,23,0,0,0,0,0,0,False,False,False,0,3,2022-02-16T19:23:32.98,0,False,
2021,6,3147,750,7,6383,13,29,3,14,0,0,0,0,0,0,False,False,False,0,2,2021-10-18T16:55:04.64,0,False,
2021,6,3147,755,7,6383,2,30,3,-1,7,8,7,0,7,6,True,False,False,0,4,2021-10-19T16:41:20.573,7,True,0.0
2021,6,3147,770,11,6633,2,13,4,6,7,1,7,0,7,0,False,False,False,0,3,2022-02-22T20:19:21.803,7,False,0.0
2021,6,3147,775,11,6810,2,5,5,8,10,2,6,4,6,0,False,False,False,0,3,2021-10-18T15:12:03.573,10,False,4.0
2021,6,3147,785,11,8359,2,13,10,2,3,1,3,0,3,0,False,False,False,0,3,2021-10-18T15:16:22.747,3,False,0.0
2021,6,3147,790,11,4037,2,13,4,4,7,3,6,1,6,0,False,False,False,0,3,2021-10-18T15:18:47.387,7,False,1.0
2021,6,3147,795,11,6810,13,17,1,18,0,0,0,0,0,0,False,False,False,0,3,2022-02-16T19:24:39.117,0,False,0.0
2021,6,3147,800,11,7732,2,16,9,6,8,2,8,0,8,0,False,False,False,0,1,2021-10-21T23:36:14.89,8,False,0.0
2021,6,3147,805,11,4037,2,39,4,5,10,5,8,2,8,0,False,False,False,0,3,2021-10-21T21:32:42.373,10,False,2.0
2021,6,3147,810,11,7732,2,4,4,2,14,12,12,2,12,0,False,False,False,0,1,2021-10-21T21:32:42.373,14,False,2.0
2021,6,3147,825,11,6633,13,46,3,3,0,0,0,0,0,0,False,False,False,0,4,2021-10-18T16:20:31.173,0,False,0.0
2021,6,3147,830,11,7732,2,16,10,5,15,10,12,3,12,0,False,False,False,1,1,2021-10-21T22:58:07.423,15,False,3.0
2021,6,3148,25,12,6691,2,2,10,6,13,7,9,4,9,0,False,False,False,0,3,2021-10-18T09:21:31.353,13,False,4.0
2021,6,3148,40,12,556,13,19,6,15,0,0,0,0,0,0,False,False,False,0,2,2021-10-18T09:30:08.89,0,False,0.0
2021,6,3148,70,6,7728,2,32,5,1,15,14,6,9,6,0,False,False,False,0,4,2021-10-18T09:43:34.753,15,False,9.0
2021,6,3148,80,6,7725,2,5,3,11,11,0,11,0,11,0,False,False,False,0,3,2021-10-18T09:56:30.247,11,False,0.0
2021,6,3148,85,6,464,2,9,6,18,20,2,20,0,20,0,False,False,False,0,2,2021-10-18T16:17:26.34,20,False,0.0
2021,6,3148,90,6,1378,13,8,8,27,0,0,0,0,0,0,False,False,False,0,2,2021-10-18T10:03:15.413,0,False,
2021,6,3148,130,12,4511,2,12,3,3,4,1,3,1,3,0,False,False,False,0,3,2022-02-24T13:42:46.7,4,False,1.0
2021,6,3148,155,6,7725,13,5,5,6,0,0,0,0,0,0,False,False,False,0,2,2021-10-18T10:36:45.917,0,False,0.0
2021,6,3148,170,6,7725,13,35,6,20,0,0,0,0,0,0,False,False,False,0,3,2021-10-19T16:15:54.217,0,False,0.0
2021,6,3148,175,6,7725,2,51,3,-3,3,6,2,1,2,0,True,False,False,0,2,2021-10-21T14:22:46.247,3,False,1.0
2021,6,3148,180,6,464,13,12,7,53,0,0,0,0,0,0,False,False,False,0,3,2022-02-24T13:43:07.813,0,False,0.0
2021,6,3148,190,12,4537,2,34,4,-5,0,5,-2,2,-2,0,True,False,False,0,2,2021-10-18T10:58:38.66,0,False,2.0
2021,6,3148,205,12,4511,2,2,4,5,6,1,5,1,5,0,False,False,False,0,3,2021-10-18T11:06:52.767,6,False,1.0
2021,6,3148,225,12,556,2,2,10,6,32,26,29,3,29,0,False,False,False,0,3,2021-10-18T11:13:40.39,32,False,3.0
2021,6,3148,250,12,6691,2,55,9,-2,1,3,1,0,1,6,False,False,False,0,4,2021-10-18T11:29:18.19,1,False,0.0
2021,6,3148,270,6,7728,13,4,10,5,0,0,0,0,0,0,False,False,False,0,4,2021-10-18T11:33:48.98,0,False,0.0
2021,6,3148,310,12,4537,2,48,9,-3,12,15,9,3,9,0,False,False,False,0,1,2021-10-18T11:47:33.27,12,False,3.0
2021,6,3148,320,12,6691,13,9,2,15,0,0,0,0,0,0,False,False,False,0,3,2021-10-18T11:53:55.417,0,False,0.0
2021,6,3148,325,12,6356,2,24,2,15,15,0,15,0,15,6,False,False,False,0,3,2021-10-19T18:10:54.737,15,True,
2021,6,3148,335,12,556,2,49,10,1,5,4,4,1,4,0,False,False,False,1,2,2021-10-18T12:04:58.427,5,False,1.0
2021,6,3148,360,6,464,2,5,5,5,5,0,5,0,5,0,False,False,False,0,3,2021-10-21T15:28:15.267,5,False,0.0
2021,6,3148,375,6,7728,2,38,9,1,3,2,1,2,1,0,False,False,False,0,4,2021-10-18T12:23:23.037,3,False,2.0
2021,6,3148,380,6,1378,2,5,3,11,12,1,10,2,10,0,False,False,False,0,3,2021-10-18T12:24:59.83,12,False,2.0
2021,6,3148,395,6,464,13,19,2,33,0,0,0,0,0,0,False,False,False,0,3,2021-10-18T16:12:51.607,0,False,0.0
2021,6,3148,445,6,8365,3,28,10,-5,0,0,0,0,0,0,False,False,False,0,1,2021-10-18T12:59:06.01,0,False,0.0
2021,6,3148,465,12,556,2,4,3,7,11,4,8,3,8,0,False,False,False,0,2,2021-10-18T13:06:44.72,11,False,3.0
2021,6,3148,485,12,556,13,6,10,3,0,0,0,0,0,0,False,False,False,0,2,2021-10-18T13:21:53.83,0,False,
2021,6,3148,490,12,467,2,13,5,1,9,8,3,6,3,0,False,False,False,0,4,2021-10-18T13:26:25.49,9,False,6.0
2021,6,3148,500,12,7743,2,47,5,2,4,2,2,2,2,0,True,False,False,0,4,2021-10-21T15:00:00.38,4,False,2.0
2021,6,3148,510,12,4537,2,46,3,0,10,10,8,2,8,0,False,False,False,0,1,2021-10-18T13:37:58.907,10,False,2.0
2021,6,3148,515,12,4537,2,28,9,-3,12,15,-2,14,-2,6,False,False,False,1,1,2021-10-21T15:01:00.053,12,False,14.0
2021,6,3148,540,6,8365,2,46,3,0,8,8,8,0,8,0,False,False,False,1,1,2021-10-18T13:47:16.283,8,False,0.0
2021,6,3148,545,6,3233,3,49,10,-2,0,0,0,0,0,0,False,False,False,0,2,2021-10-18T13:49:23.923,0,False,0.0
2021,6,3148,550,6,7725,2,6,9,9,11,2,10,1,10,0,False,False,False,0,2,2021-10-18T13:51:43.477,11,False,1.0
2021,6,3148,565,6,464,13,24,2,25,0,0,0,0,0,0,True,False,False,0,3,2021-10-19T16:15:01.403,0,False,0.0
2021,6,3148,585,12,6691,13,19,7,26,0,0,0,0,0,0,True,False,False,0,3,2021-10-19T18:12:12.817,0,False,0.0
2021,6,3148,590,12,8371,2,51,3,1,14,13,6,8,6,0,True,False,False,0,3,2021-10-18T14:18:30.907,14,False,8.0
2021,6,3148,600,12,4511,13,17,1,20,0,0,0,0,0,0,False,False,False,0,4,2021-10-18T14:23:30.543,0,False,0.0
2021,6,3148,630,6,464,2,12,7,19,20,1,20,0,20,0,True,False,False,0,3,2021-10-18T16:19:45.78,20,False,0.0
2021,6,3148,635,6,7728,2,35,1,15,21,6,20,1,20,0,False,False,False,0,3,2021-10-18T14:41:26.563,21,False,1.0
2021,6,3148,655,6,464,2,5,3,5,8,3,6,2,6,0,False,False,False,0,3,2021-10-21T14:28:53.517,8,False,2.0
2021,6,3148,660,6,7728,2,6,9,10,10,0,10,0,10,0,False,False,False,0,3,2021-10-18T14:59:31.557,10,False,0.0
2021,6,3148,670,6,7725,2,35,10,5,5,0,5,0,5,6,False,False,False,0,3,2021-10-18T15:03:45.66,5,True,0.0
2021,6,3148,695,12,6691,2,6,4,10,13,3,11,2,11,0,False,False,False,0,3,2021-10-18T15:08:25.3,13,False,2.0
2021,6,3148,705,12,556,2,7,2,24,41,17,30,11,30,0,False,False,False,0,3,2021-10-21T14:33:58.067,41,False,11.0
2021,6,3148,715,12,467,2,32,3,4,8,4,8,0,8,0,False,False,False,1,4,2021-10-18T15:17:38.053,8,False,0.0
2021,6,3148,745,6,7725,3,4,3,2,0,0,0,0,0,0,True,False,False,0,2,2021-10-18T15:33:21.65,0,False,0.0
2021,6,3148,755,6,1378,2,5,3,7,9,2,9,0,9,0,False,False,False,0,3,2022-02-16T19:09:39.897,9,True,
2021,6,3148,760,6,7725,2,4,6,15,15,0,15,0,15,0,False,False,False,0,2,2021-10-18T15:40:25.14,15,False,0.0
2021,6,3148,775,6,8365,2,48,10,-6,7,13,-2,9,-2,0,False,False,False,2,1,2021-10-18T15:46:06.46,7,False,9.0
2021,6,3148,790,6,464,13,12,2,48,0,0,0,0,0,0,False,False,False,0,2,2022-02-24T13:43:51.983,0,False,0.0
2021,6,3149,10,26,309,2,13,10,3,11,8,8,3,8,0,False,False,False,0,2,2021-10-18T09:33:58.79,11,False,3.0
2021,6,3149,25,26,958,2,5,5,11,11,0,11,0,11,0,False,False,False,0,3,2021-10-18T09:34:41.92,11,False,0.0
2021,6,3149,30,26,958,2,5,10,3,8,5,6,2,6,0,False,False,False,0,3,2021-10-18T09:34:47.833,8,False,2.0
2021,6,3149,40,26,4619,13,8,7,46,0,0,0,0,0,0,False,False,False,0,2,2021-12-15T01:23:38.35,0,False,0.0
2021,6,3149,45,26,7453,13,44,3,-1,0,0,0,0,0,0,True,False,False,0,3,2022-02-16T18:44:52.853,0,False,0.0
2021,6,3149,50,26,4616,13,51,10,-2,0,0,0,0,0,0,False,False,False,0,2,2021-10-22T20:01:11.457,0,False,0.0
2021,6,3149,65,3,7672,2,4,9,5,7,2,7,0,7,0,False,False,False,0,2,2021-10-18T09:55:03.31,7,False,0.0
2021,6,3149,70,3,713,13,45,5,-1,0,0,0,0,0,0,False,False,False,0,1,2021-10-22T23:50:26.953,0,False,0.0
2021,6,3149,80,3,6936,2,2,4,4,4,0,4,0,4,0,False,False,False,0,2,2021-10-18T09:56:34.387,4,False,0.0
2021,6,3149,85,3,306,2,32,9,-4,4,8,2,2,2,0,False,False,False,0,1,2021-10-22T21:09:07.79,4,False,2.0
2021,6,3149,95,3,306,2,4,4,0,8,8,7,1,7,0,False,False,False,0,1,2021-10-22T21:11:09.987,8,False,1.0
2021,6,3149,135,26,309,2,30,10,-2,3,5,2,1,2,0,False,False,False,0,4,2021-10-22T23:41:58.373,3,False,1.0
2021,6,3149,150,3,6454,2,2,4,11,16,5,15,1,15,0,False,False,False,0,4,2021-10-22T23:51:34.753,16,False,1.0
2021,6,3149,155,3,7672,2,34,4,-4,8,12,4,4,4,0,True,False,False,0,3,2021-10-19T16:21:48.66,8,False,4.0
2021,6,3149,170,3,6454,2,5,5,9,9,0,9,0,9,0,False,False,False,0,3,2021-12-15T01:24:26.967,9,True,0.0
2021,6,3149,190,3,6454,2,35,7,15,21,6,17,4,17,0,False,False,False,0,4,2021-10-22T21:24:13.67,21,False,4.0
2021,6,3149,220,26,4619,3,13,4,4,0,0,0,0,0,0,False,False,False,0,3,2021-10-22T22:09:36.483,0,False,0.0
2021,6,3149,235,3,7672,13,5,3,4,0,0,0,0,0,0,False,False,False,0,3,2021-10-18T10:54:24.177,0,False,0.0
2021,6,3149,240,3,6816,2,38,4,1,1,0,1,0,1,0,False,True,False,0,3,2021-10-18T10:57:04.577,2,False,0.0
2021,6,3149,250,26,4616,2,16,10,3,18,15,17,1,17,0,False,False,False,0,1,2021-10-22T22:12:27.763,18,False,1.0
2021,6,3149,255,26,7453,13,3,3,5,0,0,0,0,0,0,True,False,False,0,3,2021-10-22T23:43:41.347,0,False,0.0
2021,6,3149,260,26,6301,2,4,4,2,7,5,6,1,6,0,False,False,False,0,1,2021-10-18T11:03:48.057,7,False,1.0
2021,6,3149,265,26,4616,13,6,3,4,0,0,0,0,0,0,True,False,False,0,2,2021-10-22T21:30:39.377,0,False,0.0
2021,6,3149,270,26,4619,13,4,3,7,0,0,0,0,0,0,False,False,False,0,2,2021-10-22T23:43:57.73,0,False,0.0
2021,6,3149,285,3,6936,2,51,9,-1,10,11,2,8,2,0,False,True,False,1,3,2021-10-22T20:02:07.433,10,False,8.0
2021,6,3149,310,26,7491,2,53,9,-2,5,7,3,2,3,0,False,False,False,0,4,2021-10-18T11:17:20.473,5,False,2.0
2021,6,3149,315,26,8552,2,4,3,8,8,0,8,0,8,0,False,False,False,0,2,2021-10-18T11:19:14.283,8,False,0.0
2021,6,3149,320,26,958,13,17,7,21,0,0,0,0,0,0,False,False,False,0,3,2021-10-22T20:11:55.627,0,False,0.0
2021,6,3149,325,3,8430,13,6,1,12,0,0,0,0,0,0,False,False,False,0,2,2021-10-22T20:13:04.49,0,False,0.0
2021,6,3149,330,26,4619,2,8,8,21,26,5,25,1,25,0,False,False,False,0,3,2021-10-22T20:02:21.85,26,False,1.0
2021,6,3149,335,26,958,2,7,5,1,1,0,1,0,1,6,False,False,False,0,4,2021-10-18T11:32:18.743,1,True,0.0
2021,6,3149,355,3,8430,2,4,9,6,6,0,6,0,6,0,False,False,False,0,2,2021-10-22T21:38:28.533,6,False,0.0
2021,6,3149,380,3,7673,13,35,8,21,0,0,0,0,0,0,False,False,False,0,3,2021-10-18T11:41:03.05,0,False,0.0
2021,6,3149,400,26,4616,2,48,10,-5,16,21,4,12,4,0,False,False,False,0,1,2021-10-18T11:44:25.917,16,False,12.0
2021,6,3149,425,3,8430,2,5,5,4,4,0,4,0,4,0,False,False,False,0,3,2021-10-22T20:17:23.723,4,False,0.0
2021,6,3149,445,3,8430,2,4,3,5,11,6,5,6,5,0,False,False,False,1,2,2021-10-18T12:16:41.127,11,False,6.0
2021,6,3149,470,3,6454,2,35,9,8,9,1,9,0,9,6,False,False,False,0,4,2021-10-22T22:38:14.117,9,True,0.0
2021,6,3149,490,26,4619,2,50,9,-2,1,3,-1,2,-1,0,False,False,False,0,2,2021-10-18T12:31:05.02,1,False,2.0
2021,6,3149,495,26,4619,13,6,4,14,0,0,0,0,0,0,False,False,False,0,3,2021-10-22T23:47:28.863,0,False,
2021,6,3149,505,26,8552,13,4,3,6,0,0,0,0,0,0,False,False,False,0,2,2021-10-18T12:35:39.537,0,False,0.0
2021,6,3149,515,3,6454,13,35,7,18,0,0,0,0,0,0,False,False,False,0,4,2021-10-22T23:44:23.79,0,False,0.0
2021,6,3149,520,3,6936,3,7,6,20,0,0,0,0,0,0,False,False,False,0,3,2021-10-22T21:54:33.567,0,False,0.0
2021,6,3149,535,26,958,13,13,9,5,0,0,0,0,0,0,False,False,False,0,4,2021-10-22T20:04:44.84,0,False,0.0
2021,6,3149,540,26,4050,13,30,3,0,0,0,0,0,0,0,False,False,False,0,4,2021-10-22T23:44:58.483,0,False,0.0
2021,6,3149,545,26,958,3,4,4,11,0,0,0,0,0,0,False,False,False,0,3,2021-10-22T21:57:41.017,0,False,0.0
2021,6,3149,560,3,8430,2,4,10,5,8,3,8,0,8,0,False,False,False,0,2,2021-10-23T00:01:19.283,8,False,0.0
2021,6,3149,575,3,6936,2,6,7,20,20,0,20,0,20,0,False,False,False,1,3,2021-10-22T21:59:45.943,20,False,0.0
2021,6,3149,585,3,713,13,12,9,-1,0,0,0,0,0,0,False,False,False,0,1,2021-10-22T23:53:00.583,0,False,0.0
2021,6,3149,595,3,6454,2,4,4,10,13,3,13,0,13,0,False,False,False,0,4,2021-10-22T20:19:26.937,13,False,0.0
2021,6,3149,620,26,958,2,46,9,2,5,3,4,1,4,0,False,False,False,0,4,2021-10-22T22:18:02.22,5,False,1.0
2021,6,3149,625,26,309,2,5,5,6,10,4,6,4,6,0,False,False,False,0,2,2021-10-18T13:39:57.66,10,False,4.0
2021,6,3149,630,26,309,2,7,6,21,21,0,21,0,21,0,True,False,False,0,2,2021-10-18T13:42:04.3,21,False,0.0
2021,6,3149,640,26,8552,13,2,9,6,0,0,0,0,0,0,False,False,False,0,2,2021-10-22T22:19:33.023,0,False,0.0
2021,6,3149,645,26,7453,2,4,5,11,15,4,13,2,13,0,False,False,False,0,2,2021-10-18T13:46:53.593,15,False,2.0
2021,6,3149,650,26,4050,2,54,4,-3,-1,2,-3,2,-3,0,False,False,False,0,4,2021-10-22T22:23:08.52,-1,False,2.0
2021,6,3149,655,26,309,13,29,5,13,0,0,0,0,0,0,False,False,False,0,2,2021-10-22T22:24:08.04,0,False,
2021,6,3149,660,26,7491,2,32,5,3,5,2,3,2,3,0,False,False,False,0,4,2021-10-22T22:25:58.067,5,False,2.0
2021,6,3149,665,26,309,2,12,1,15,13,-2,15,-2,15,0,False,False,False,0,3,2021-10-18T13:54:58.22,13,False,
2021,6,3149,670,26,7453,13,19,2,36,0,0,0,0,0,0,False,False,False,0,2,2021-10-22T23:45:28.307,0,False,0.0
2021,6,3149,685,3,6935,2,4,9,6,6,0,6,0,6,0,False,False,False,0,2,2021-10-22T22:29:00.523,6,False,0.0
2021,6,3149,700,3,6936,2,47,10,-2,1,3,-1,2,-1,0,True,False,False,0,4,2022-02-16T18:45:21.407,1,False,2.0
2021,6,3149,705,3,8430,3,2,9,8,0,0,0,0,0,0,True,False,False,0,3,2021-10-22T20:14:11.513,0,False,0.0
2021,6,3149,710,26,4616,2,51,3,-4,4,8,4,0,4,0,True,False,False,0,1,2021-10-22T22:29:22.88,4,False,0.0
2021,6,3149,715,26,8552,13,29,3,9,0,0,0,0,0,0,False,False,False,0,2,2021-10-18T14:13:13.223,0,False,0.0
2021,6,3149,720,26,309,2,50,10,-1,5,6,3,2,3,0,False,False,False,0,2,2021-10-18T14:14:52.177,5,False,2.0
2021,6,3149,735,26,4616,2,47,5,1,10,9,8,2,8,0,False,False,False,0,1,2021-10-22T22:30:14.29,10,False,2.0
2021,6,3149,740,26,8177,2,6,4,5,6,1,6,0,6,0,False,False,False,0,1,2021-10-22T23:45:40.123,6,False,0.0
2021,6,3149,755,26,7453,13,4,5,13,0,0,0,0,0,0,False,False,False,0,2,2021-10-18T14:22:08.943,0,False,0.0
2021,6,3150,10,5,3477,13,12,5,5,0,0,0,0,0,0,False,False,False,0,2,2021-10-21T18:45:03.52,0,False,0.0
2021,6,3150,25,18,1381,2,5,5,11,11,0,11,0,11,0,False,False,False,0,2,2021-10-18T11:22:23.373,11,False,0.0
2021,6,3150,35,18,7712,2,26,9,5,9,4,6,3,6,0,False,False,False,0,3,2021-10-21T18:27:19.523,9,False,3.0
2021,6,3150,40,18,6361,13,5,9,4,0,0,0,0,0,0,False,False,False,0,4,2021-10-21T21:28:53.187,0,False,0.0
2021,6,3150,55,5,8406,2,4,9,5,9,4,8,1,8,0,False,False,False,0,3,2021-10-21T16:00:59.197,9,False,1.0
2021,6,3150,70,5,3477,2,50,5,-4,0,4,-4,4,-4,0,True,False,False,0,3,2021-10-21T18:27:32.333,0,False,4.0
2021,6,3150,75,5,5220,13,12,2,16,0,0,0,0,0,0,False,False,False,0,3,2022-02-16T18:50:13.977,0,False,0.0
2021,6,3150,90,18,7711,13,24,2,30,0,0,0,0,0,0,False,False,False,0,2,2021-10-21T21:29:37.83,0,False,0.0
2021,6,3150,95,18,7711,2,50,5,-1,6,7,4,2,4,0,False,True,True,0,2,2021-10-21T21:29:51.087,5,False,2.0
2021,6,3150,100,5,8413,2,34,4,-4,16,20,16,0,16,0,True,False,False,0,3,2021-10-21T19:10:36.313,16,False,0.0
2021,6,3150,125,18,7711,13,23,7,40,0,0,0,0,0,0,False,False,False,0,3,2021-10-21T22:10:12.363,0,False,0.0
2021,6,3150,130,18,4940,2,6,5,6,7,1,6,1,6,0,False,False,False,0,2,2021-10-21T22:11:48.85,7,False,1.0
2021,6,3150,135,18,7711,2,26,9,5,7,2,6,1,6,0,False,False,False,0,3,2021-10-19T17:05:00.523,7,False,1.0
2021,6,3150,145,18,1381,2,4,10,3,3,0,3,0,3,0,False,False,False,0,2,2021-10-19T17:05:13.123,3,False,0.0
2021,6,3150,165,18,1381,2,2,10,3,3,0,3,0,3,0,False,False,False,0,2,2021-10-18T12:10:02,3,False,0.0
2021,6,3150,205,5,5220,3,2,9,9,0,0,0,0,0,0,False,False,False,0,2,2021-10-19T18:01:22.147,0,False,0.0
2021,6,3150,235,18,1381,2,6,1,20,20,0,20,0,20,0,False,False,False,0,2,2021-10-21T22:13:06.84,20,False,0.0
2021,6,3150,240,18,7711,2,18,5,-3,7,10,2,5,2,0,False,False,False,0,2,2021-10-21T15:44:45.993,7,False,5.0
2021,6,3150,245,18,1381,2,18,3,0,24,24,20,4,20,0,False,False,False,1,2,2021-10-21T15:45:43.493,24,False,4.0
2021,6,3150,255,18,7712,2,6,10,6,13,7,9,4,9,0,False,False,False,0,2,2021-10-21T22:14:15.207,13,False,4.0
2021,6,3150,265,18,6262,2,30,9,-1,2,3,2,0,2,6,False,False,False,0,4,2021-10-21T16:06:53.127,2,True,0.0
2021,6,3150,280,5,3477,13,19,2,35,0,0,0,0,0,0,False,False,False,0,2,2022-02-16T18:54:36.433,0,False,0.0
2021,6,3150,290,5,3477,3,13,3,4,0,0,0,0,0,0,False,False,False,0,2,2021-10-18T13:01:54.493,0,False,0.0
2021,6,3150,305,18,4572,2,48,3,-6,-6,0,-6,0,-6,0,False,False,False,0,1,2021-10-21T19:27:28.383,-6,False,0.0
2021,6,3150,340,5,3477,13,5,5,2,0,0,0,0,0,0,True,False,False,0,3,2021-10-21T16:09:05.01,0,False,0.0
2021,6,3150,345,5,8406,13,2,4,10,0,0,0,0,0,0,False,False,False,0,3,2021-10-21T15:46:57.523,0,False,0.0
2021,6,3150,350,5,5220,2,13,10,5,18,13,14,4,14,0,False,False,False,0,3,2021-10-21T22:15:02.357,18,False,4.0
2021,6,3150,365,5,3477,3,8,1,16,0,0,0,0,0,0,False,False,False,0,3,2022-02-16T18:55:25.713,0,False,0.0
2021,6,3150,380,18,1381,2,4,5,4,8,4,4,4,4,0,False,False,False,1,3,2021-10-18T13:29:56.49,8,False,4.0
2021,6,3150,415,5,8406,13,2,4,10,0,0,0,0,0,0,False,False,False,0,3,2021-10-21T22:16:15.183,0,False,
2021,6,3150,425,5,4341,2,39,4,6,17,11,15,2,15,0,False,False,False,0,3,2021-10-21T22:16:55.377,17,False,2.0
2021,6,3150,430,5,8409,3,5,9,1,0,0,0,0,0,0,False,False,False,0,1,2021-10-21T22:18:17.563,0,False,0.0
2021,6,3150,435,5,3477,13,6,4,12,0,0,0,0,0,0,False,False,False,0,2,2021-10-21T21:34:20.143,0,False,0.0
2021,6,3150,455,5,5220,13,19,6,40,0,0,0,0,0,0,False,False,False,0,2,2021-10-21T21:36:35.503,0,False,0.0
2021,6,3150,465,18,7711,13,4,5,11,0,0,0,0,0,0,False,False,False,0,2,2021-10-21T21:37:28.303,0,False,0.0
2021,6,3150,480,18,7711,2,2,4,9,14,5,13,1,13,0,True,False,False,0,3,2021-10-19T17:11:48.13,14,False,1.0
2021,6,3150,495,18,7712,13,32,3,4,0,0,0,0,0,0,False,False,False,0,4,2021-10-21T19:37:09.32,0,False,
2021,6,3150,515,18,7711,13,2,9,10,0,0,0,0,0,0,False,False,False,0,2,2021-10-21T15:31:47.96,0,False,0.0
2021,6,3150,530,18,6361,2,31,10,7,7,0,7,0,7,0,False,False,False,0,4,2021-10-19T17:07:17.44,7,False,0.0
2021,6,3150,550,5,3477,13,22,2,15,0,0,0,0,0,0,True,False,False,0,3,2021-10-21T19:40:22.12,0,False,
2021,6,3150,570,5,5220,13,6,2,20,0,0,0,0,0,0,False,False,False,0,3,2021-10-21T19:43:28.37,0,False,
2021,6,3150,580,5,6425,13,12,3,4,0,0,0,0,0,0,True,False,False,0,4,2021-10-21T19:46:23.22,0,False,0.0
2021,6,3150,585,5,6372,2,13,4,4,5,1,4,1,4,0,False,False,False,0,3,2021-10-21T20:38:54.723,5,False,1.0
2021,6,3150,605,18,7712,13,4,3,7,0,0,0,0,0,0,False,False,False,0,2,2021-10-18T15:08:35.503,0,False,0.0
2021,6,3150,610,18,4940,13,2,5,5,0,0,0,0,0,0,False,False,False,0,2,2021-10-21T22:20:04.79,0,False,0.0
2021,6,3150,635,18,4572,2,51,3,-7,9,16,7,2,7,0,False,False,False,1,1,2021-10-21T22:20:53.6,9,False,2.0
2021,6,3150,645,18,6361,2,35,3,11,24,13,20,4,20,0,False,False,False,0,4,2022-02-16T18:56:55.273,24,False,4.0
2021,6,3150,665,5,5220,2,8,4,13,15,2,15,0,15,0,False,True,True,0,2,2022-03-11T20:25:45.267,15,False,0.0
2021,6,3150,670,18,1381,2,35,6,29,35,6,35,0,35,0,False,False,False,0,3,2021-10-18T15:46:14.803,35,False,0.0
2021,6,3150,680,18,7711,13,4,10,4,0,0,0,0,0,0,False,False,False,0,3,2021-10-21T22:02:24.21,0,False,0.0
2021,6,3150,685,18,1381,2,3,5,5,5,0,5,0,5,6,False,False,False,0,2,2021-10-21T20:10:36.013,5,True,0.0
2021,6,3150,705,5,5220,2,50,9,-1,14,15,1,13,1,0,False,False,False,0,2,2022-02-16T18:58:56.803,14,False,13.0
2021,6,3150,715,5,8408,13,35,2,16,0,0,0,0,0,0,True,False,False,0,4,2021-10-21T15:32:37.85,0,False,0.0
2021,6,3150,720,5,5220,2,50,5,-1,1,2,1,0,1,0,False,False,False,0,2,2021-10-19T18:02:20.827,1,False,0.0
2021,6,3150,740,18,7711,2,50,5,0,17,17,7,10,7,0,False,False,False,0,2,2021-10-21T20:13:29.143,17,False,10.0
2021,6,3150,755,18,7711,2,19,2,22,26,4,22,4,22,0,False,False,False,0,2,2022-02-22T19:42:31.087,26,False,4.0
2021,6,3150,775,18,7711,13,21,6,20,0,0,0,0,0,0,False,False,False,0,2,2021-10-21T22:23:09.517,0,False,0.0
2021,6,3150,790,5,8413,2,51,9,-5,4,9,3,1,3,0,False,False,False,0,1,2021-10-21T15:37:21.193,4,False,1.0
2021,6,3150,800,5,5220,13,19,2,15,0,0,0,0,0,0,False,False,False,0,2,2021-10-21T22:03:53.437,0,False,0.0
2021,6,3150,810,5,5220,13,19,6,33,0,0,0,0,0,0,False,False,False,0,2,2021-10-21T22:05:43.997,0,False,0.0
2021,6,3150,830,18,1381,13,19,6,22,0,0,0,0,0,0,False,False,False,0,3,2021-10-18T19:04:34.15,0,False,0.0
2021,6,3150,845,5,8409,2,4,4,4,4,0,4,0,4,0,False,False,False,0,1,2021-10-21T22:24:56.44,4,False,0.0
2021,6,3150,850,5,6372,2,17,1,16,21,5,17,4,17,0,False,False,False,0,3,2021-10-18T17:04:11.01,21,False,4.0
2021,6,3150,855,5,5220,13,12,5,5,0,0,0,0,0,0,False,False,False,0,2,2022-02-16T19:01:31.087,0,False,0.0
2021,6,3150,865,5,3477,13,12,5,5,0,0,0,0,0,0,True,False,False,0,3,2021-10-21T20:16:24.697,0,False,0.0
2021,6,3150,880,18,6361,2,35,5,13,40,27,36,4,36,0,False,False,False,0,4,2021-10-18T17:12:56.877,40,False,4.0
2021,6,3150,890,18,1381,2,18,5,-1,3,4,2,1,2,0,False,False,False,0,2,2021-10-21T15:50:13.223,3,False,1.0
2021,6,3150,915,5,5220,13,19,6,39,0,0,0,0,0,0,False,False,False,0,2,2022-02-16T19:03:16.533,0,False,0.0
2021,6,3150,920,5,8409,3,4,4,2,0,0,0,0,0,0,False,False,False,0,1,2021-10-18T17:24:36.857,0,False,0.0
2021,6,3150,930,5,3477,3,13,10,4,0,0,0,0,0,0,False,False,False,0,2,2021-10-18T17:26:08.633,0,False,0.0
2021,6,3150,935,5,6425,2,17,1,32,41,9,36,5,36,0,False,False,False,0,3,2021-10-18T17:28:09.99,41,False,5.0
2021,6,3150,940,5,6372,2,6,9,5,6,1,5,1,5,0,False,False,False,0,3,2021-10-21T22:26:31.633,6,False,1.0
2021,6,3150,950,5,8408,13,5,5,10,0,0,0,0,0,0,False,False,False,0,3,2021-10-21T15:33:26.117,0,False,0.0
2021,6,3150,955,5,3477,2,13,3,4,4,0,4,0,4,0,False,False,False,1,3,2021-10-21T18:28:59.123,4,False,0.0
2021,6,3150,960,5,5220,3,2,5,7,0,0,0,0,0,0,False,False,False,0,2,2022-02-22T19:44:03.407,0,False,0.0
2021,6,3150,970,5,5220,2,19,6,22,25,3,22,3,22,0,False,False,False,0,2,2021-10-18T17:40:42.337,25,False,3.0
2021,6,3150,975,5,3477,2,17,4,7,7,0,7,0,7,6,False,False,False,0,3,2021-10-21T22:27:08.243,7,True,0.0
2021,6,3150,990,18,7712,2,4,3,1,4,3,4,0,4,0,False,False,False,0,2,2021-10-21T20:20:39.86,4,True,0.0
2021,6,3150,1000,18,7712,2,42,4,5,12,7,9,3,9,0,False,False,False,0,3,2021-10-21T22:07:19.007,12,False,3.0
2021,6,3150,1010,18,4940,2,50,5,1,6,5,4,2,4,0,False,False,False,0,2,2021-10-19T17:10:37.58,6,False,2.0
2021,6,3150,1020,18,1381,2,2,4,6,8,2,7,1,7,0,False,False,False,0,2,2021-10-18T17:59:07.25,8,False,1.0
2021,6,3150,1055,18,1381,2,26,5,5,6,1,5,1,5,0,False,False,False,1,2,2021-10-21T22:29:16.673,6,False,1.0
2021,6,3150,1065,18,1381,13,3,3,10,0,0,0,0,0,0,False,False,False,0,3,2021-10-21T22:29:42.99,0,False,0.0
2021,6,3150,1070,18,7711,2,49,9,-3,7,10,2,5,2,0,True,False,False,0,2,2021-10-21T15:41:39.12,7,False,5.0
2021,6,3150,1075,18,7712,2,35,5,12,13,1,12,1,12,0,False,False,False,0,3,2021-10-21T20:29:24.543,13,False,1.0
2021,6,3150,1090,18,7711,2,18,5,-3,-3,0,-3,0,-3,0,False,False,False,0,2,2021-10-21T15:50:42.953,-3,False,0.0
2021,6,3150,1095,18,7712,2,7,6,27,27,0,27,0,27,6,False,False,False,0,3,2021-10-18T18:16:55.083,27,True,0.0
2021,6,3151,10,8,3883,3,5,3,4,0,0,0,0,0,0,False,False,False,0,3,2021-10-21T16:01:06.367,0,False,0.0
2021,6,3151,15,8,8354,2,51,5,-4,4,8,4,0,4,0,True,False,False,0,1,2021-10-18T09:34:33.95,4,False,0.0
2021,6,3151,20,8,3883,2,8,4,12,17,5,14,3,14,0,False,False,False,0,3,2022-03-08T19:01:41.08,17,False,
2021,6,3151,25,8,1067,13,4,9,11,0,0,0,0,0,0,False,False,False,0,3,2021-10-21T15:46:31.13,0,False,0.0
2021,6,3151,50,1,4587,2,45,5,-1,0,1,-1,1,-1,0,True,False,False,0,1,2021-10-18T10:10:22.6,0,False,1.0
2021,6,3151,60,1,6405,2,6,4,13,15,2,15,0,15,0,False,False,False,0,3,2021-10-18T10:14:54.73,15,False,0.0
2021,6,3151,75,1,6405,2,7,6,21,21,0,21,0,21,6,False,False,False,0,3,2021-10-18T10:22:42.697,21,True,0.0
2021,6,3151,90,8,7651,13,5,5,4,0,0,0,0,0,0,False,False,False,0,3,2021-10-18T10:29:14.58,0,False,0.0
2021,6,3151,95,8,1067,2,12,6,22,25,3,25,0,25,0,False,False,False,0,3,2021-10-18T10:33:07.723,25,False,0.0
2021,6,3151,115,8,7651,2,4,7,18,20,2,18,2,18,0,False,False,False,0,3,2021-10-19T20:03:55.48,20,False,2.0
2021,6,3151,120,8,3883,13,31,4,2,0,0,0,0,0,0,False,False,False,0,4,2021-10-18T10:48:28.853,0,False,0.0
2021,6,3151,155,1,910,2,4,10,9,10,1,10,0,10,0,False,False,False,0,3,2022-02-16T19:13:52.913,10,False,0.0
2021,6,3151,165,1,245,13,2,9,9,0,0,0,0,0,0,False,False,False,0,2,2021-10-18T11:13:41.62,0,False,
2021,6,3151,170,1,910,13,35,6,32,0,0,0,0,0,0,False,False,False,0,3,2021-10-21T15:43:19.61,0,False,0.0
2021,6,3151,180,1,6405,2,4,10,4,8,4,7,1,7,0,False,False,False,0,3,2021-10-18T11:22:45.02,8,False,1.0
2021,6,3151,185,1,245,13,19,6,27,0,0,0,0,0,0,False,False,False,0,2,2021-10-18T11:27:24.137,0,False,
2021,6,3151,220,1,6406,2,16,10,0,5,5,3,2,3,0,False,False,False,0,1,2022-03-08T19:02:08.487,5,False,2.0
2021,6,3151,235,1,245,2,51,9,2,13,11,10,3,10,6,False,False,False,3,3,2022-03-08T19:02:26.83,13,False,3.0
2021,6,3151,260,1,5032,13,32,10,1,0,0,0,0,0,0,False,False,False,0,4,2021-10-18T11:58:51.15,0,False,0.0
2021,6,3151,270,1,6406,13,48,10,-2,0,0,0,0,0,0,False,False,False,0,1,2021-10-18T12:03:03.427,0,False,0.0
2021,6,3151,290,8,5053,2,45,10,-7,4,11,4,0,4,0,False,False,False,0,1,2022-03-08T19:03:36.327,4,False,0.0
2021,6,3151,300,8,3606,13,8,8,18,0,0,0,0,0,0,False,False,False,0,2,2021-10-21T13:44:43.59,0,False,0.0
2021,6,3151,330,8,1067,2,2,9,11,17,6,15,2,15,0,False,False,False,0,3,2021-10-18T12:35:53.85,17,False,2.0
2021,6,3151,340,8,8354,2,50,10,-4,10,14,10,0,10,0,False,False,False,0,2,2022-03-08T19:03:54.67,10,False,0.0
2021,6,3151,360,8,5053,2,4,10,5,5,0,5,0,5,0,False,False,False,0,3,2021-10-18T13:00:07.327,5,False,0.0
2021,6,3151,365,8,7651,2,5,5,7,11,4,9,2,9,6,False,False,False,1,3,2022-03-08T19:04:14.15,11,False,2.0
2021,6,3151,390,1,6406,2,45,5,-4,-1,3,-2,1,-2,0,False,False,False,0,1,2021-10-18T13:12:36.277,-1,False,1.0
2021,6,3151,395,1,8439,2,32,9,-2,10,12,9,1,9,0,False,False,False,0,3,2021-10-18T13:18:16.507,10,False,1.0
2021,6,3151,405,1,245,2,35,2,25,33,8,28,5,28,0,False,False,False,0,3,2022-03-08T19:05:04.733,33,False,5.0
2021,6,3151,415,1,8439,2,50,9,-4,5,9,3,2,3,0,False,False,False,0,2,2021-10-18T13:35:36.257,5,False,2.0
2021,6,3151,455,1,6406,2,48,9,-5,0,5,0,0,0,0,False,False,False,0,1,2021-10-18T13:51:09.44,0,False,0.0
2021,6,3151,470,8,4976,3,31,10,5,0,0,0,0,0,0,False,False,False,0,4,2021-10-18T13:57:25.64,0,False,0.0
2021,6,3151,475,8,8349,2,13,4,5,5,0,5,0,5,0,False,False,False,0,3,2021-10-18T13:59:26.493,5,False,0.0
2021,6,3151,480,8,7009,2,32,9,4,7,3,7,0,7,0,False,False,False,0,1,2021-10-18T14:02:20.693,7,True,0.0
2021,6,3151,485,8,8349,2,5,3,6,6,0,6,0,6,0,False,False,False,0,2,2021-10-18T14:03:59.483,6,False,0.0
2021,6,3151,490,8,7651,2,19,7,57,57,0,57,0,57,6,False,False,False,0,2,2021-10-18T14:06:40.897,57,True,0.0
2021,6,3151,515,1,910,2,3,5,10,13,3,12,1,12,0,False,False,False,0,2,2021-10-18T17:29:36.873,13,False,1.0
2021,6,3151,520,1,8439,2,26,9,1,1,0,1,0,1,0,True,False,False,0,2,2021-10-19T20:04:23.097,1,False,0.0
2021,6,3151,565,1,6405,3,35,2,23,0,0,0,0,0,0,False,False,False,0,3,2022-02-16T19:16:18.507,0,False,0.0
2021,6,3151,570,1,6405,13,29,2,18,0,0,0,0,0,0,False,False,False,0,3,2022-02-22T19:54:22.82,0,False,0.0
2021,6,3151,585,8,1067,2,22,2,22,24,2,24,0,24,0,False,False,False,0,3,2022-03-08T19:05:38.317,24,False,0.0
2021,6,3151,595,8,7651,2,12,5,14,13,-1,13,0,13,0,False,False,False,0,3,2022-02-24T13:50:47.317,13,False,0.0
2021,6,3151,615,1,6405,13,2,9,7,0,0,0,0,0,0,False,False,False,0,3,2021-10-18T15:51:46.44,0,False,0.0
2021,6,3151,620,1,8439,13,6,10,5,0,0,0,0,0,0,False,False,False,0,3,2022-02-22T19:54:36.44,0,False,0.0
2021,6,3151,625,1,910,2,8,8,20,34,14,22,12,22,0,True,False,False,1,3,2021-10-21T15:49:48.76,34,False,12.0
2021,6,3151,635,1,910,2,2,10,5,8,3,8,0,8,0,False,False,False,0,2,2021-10-18T17:30:20.187,8,False,0.0
2021,6,3151,650,1,245,2,6,9,9,9,0,9,0,9,6,False,False,False,0,2,2021-10-18T16:10:53.857,9,True,0.0
2021,6,3151,670,8,1067,13,29,3,13,0,0,0,0,0,0,False,False,False,0,2,2021-10-18T16:14:51.43,0,False,0.0
2021,6,3151,675,8,5053,2,5,9,2,3,1,2,1,2,0,False,False,False,0,1,2021-10-18T16:17:03.423,3,False,1.0
2021,6,3151,680,8,6703,2,28,9,2,6,4,6,0,6,0,False,False,False,0,1,2021-10-21T15:45:03.067,6,False,0.0
2021,6,3151,685,8,3883,2,32,3,3,4,1,4,0,4,0,False,False,False,0,4,2021-10-18T16:20:57.577,4,False,0.0
2021,6,3151,710,8,1067,2,49,5,-1,6,7,1,5,1,0,False,False,False,0,2,2022-03-08T19:06:10.45,6,False,5.0
2021,6,3151,715,8,1067,2,50,9,-2,7,9,7,0,7,0,False,False,False,0,2,2021-10-21T16:12:43.64,7,True,0.0
2021,6,3151,735,8,3606,13,26,10,10,0,0,0,0,0,0,False,False,False,0,3,2021-10-18T16:37:58.393,0,False,0.0
2021,6,3151,740,8,1067,13,2,10,4,0,0,0,0,0,0,False,False,False,0,2,2021-10-18T16:39:30.947,0,False,0.0
2021,6,3151,755,1,6405,2,5,6,18,20,2,20,0,20,0,False,False,False,0,3,2021-10-21T13:47:45.637,20,True,0.0
2021,6,3151,760,1,245,13,29,3,14,0,0,0,0,0,0,False,False,False,0,2,2021-10-21T14:39:42.7,0,False,
2021,6,3151,775,1,245,13,4,3,13,0,0,0,0,0,0,False,False,False,0,2,2021-10-18T16:52:53.26,0,False,
2021,6,3151,785,1,6405,2,4,3,11,11,0,11,0,11,0,False,False,False,0,2,2021-10-18T16:58:36.713,11,False,0.0
2021,6,3151,815,1,910,2,9,5,14,14,0,14,0,14,6,False,False,False,0,2,2022-02-16T19:17:25.413,14,True,0.0
2021,6,3151,840,8,4976,2,47,5,1,6,5,0,6,0,0,False,False,False,1,3,2021-10-21T15:55:45.913,6,False,6.0
2021,6,3151,845,8,3606,13,13,10,2,0,0,0,0,0,0,False,False,False,0,3,2021-10-21T15:45:18.04,0,False,0.0
2021,6,3151,855,8,8349,13,29,5,7,0,0,0,0,0,0,False,False,False,0,2,2021-10-18T17:15:28.997,0,False,0.0
2021,6,3152,10,23,7688,2,5,5,4,9,5,7,2,7,0,False,False,False,0,3,2021-10-21T19:04:37.527,9,False,2.0
2021,6,3152,25,23,7688,13,21,2,24,0,0,0,0,0,0,False,False,False,0,3,2021-10-21T21:44:17.79,0,False,
2021,6,3152,40,23,7688,2,17,7,35,48,13,43,5,43,6,False,False,False,1,2,2021-10-18T09:25:27.363,48,False,5.0
2021,6,3152,55,10,4930,2,12,5,7,7,0,7,0,7,0,False,False,False,0,2,2021-10-18T09:29:34.86,7,False,0.0
2021,6,3152,75,10,6281,2,4,5,14,14,0,14,0,14,0,False,False,False,0,3,2021-10-18T09:39:37.78,14,False,0.0
2021,6,3152,80,10,7938,13,35,6,20,0,0,0,0,0,0,False,False,False,0,4,2021-10-21T21:35:47.19,0,False,
2021,6,3152,95,10,4930,2,5,5,10,23,13,20,3,20,6,False,False,False,0,2,2021-10-19T18:53:40.02,23,False,3.0
2021,6,3152,110,23,2994,2,30,5,1,2,1,2,0,2,0,True,False,False,0,4,2021-10-19T16:42:49.25,2,False,0.0
2021,6,3152,120,23,3843,2,46,3,1,3,2,2,1,2,0,False,False,False,0,1,2021-10-21T21:37:05.59,3,False,1.0
2021,6,3152,125,23,7250,2,2,9,10,25,15,23,2,23,0,False,False,False,0,4,2021-10-21T19:04:37.527,25,False,2.0
2021,6,3152,170,10,6281,13,35,2,27,0,0,0,0,0,0,False,False,False,0,3,2021-10-21T21:21:42.903,0,False,0.0
2021,6,3152,175,10,6840,2,13,9,1,5,4,4,1,4,0,False,False,False,0,4,2021-10-18T10:13:54.613,5,False,1.0
2021,6,3152,180,10,4702,13,4,9,12,0,0,0,0,0,0,False,False,False,0,4,2021-10-18T10:15:50.787,0,False,0.0
2021,6,3152,185,23,7246,2,6,4,10,11,1,11,0,11,0,False,False,False,0,4,2021-10-18T10:17:18.18,11,False,0.0
2021,6,3152,210,23,7250,13,42,9,5,0,0,0,0,0,0,False,False,False,0,3,2021-10-18T10:31:37.373,0,False,0.0
2021,6,3152,225,10,6840,2,30,3,-1,1,2,1,0,1,0,False,False,False,0,4,2021-10-21T21:38:27.537,1,False,0.0
2021,6,3152,235,10,6281,13,19,6,36,0,0,0,0,0,0,False,False,False,0,2,2021-10-18T10:44:17.96,0,False,0.0
2021,6,3152,245,23,7689,2,6,9,14,16,2,14,2,14,0,False,False,False,0,3,2021-10-18T10:46:47.41,16,False,2.0
2021,6,3152,250,23,2688,3,2,4,5,0,0,0,0,0,0,False,False,False,0,3,2021-10-18T10:48:20,0,False,0.0
2021,6,3152,260,23,7688,13,3,5,13,0,0,0,0,0,0,False,False,False,0,3,2021-10-21T19:04:37.527,0,False,0.0
2021,6,3152,285,10,6840,2,13,9,3,3,0,3,0,3,0,False,False,False,0,4,2021-10-19T18:54:30.13,3,False,0.0
2021,6,3152,290,10,4702,2,4,4,5,6,1,6,0,6,0,False,False,False,0,4,2021-10-18T11:02:13.64,6,False,0.0
2021,6,3152,315,10,282,2,50,3,1,11,10,9,2,9,0,False,False,False,0,2,2021-10-18T11:11:45.943,11,False,2.0
2021,6,3152,330,23,2994,2,4,3,6,6,0,6,0,6,0,False,False,False,0,2,2021-10-18T11:19:31.1,6,False,0.0
2021,6,3152,340,23,7250,2,39,9,6,8,2,8,0,8,0,False,False,False,0,3,2021-10-18T15:16:57.387,8,False,0.0
2021,6,3152,350,10,7938,2,39,4,5,7,2,5,2,5,0,False,False,False,0,3,2021-10-18T11:28:28.34,7,False,2.0
2021,6,3152,355,10,282,2,44,9,-5,5,10,5,0,5,0,False,False,False,0,1,2021-10-18T11:30:35.743,5,False,0.0
2021,6,3152,370,10,282,2,4,10,4,7,3,5,2,5,0,False,False,False,1,1,2021-10-21T21:28:10.167,7,False,2.0
2021,6,3152,375,10,4930,13,4,10,11,0,0,0,0,0,0,False,False,False,0,2,2021-10-18T11:36:01.887,0,False,0.0
2021,6,3152,380,10,6281,2,6,7,17,17,0,17,0,17,0,False,False,False,0,2,2021-10-18T15:14:30.043,17,False,
2021,6,3152,385,10,8541,2,5,10,4,10,6,6,4,6,0,False,False,False,1,1,2021-10-21T21:30:46.003,10,False,4.0
2021,6,3152,400,23,4307,2,46,3,3,8,5,8,0,8,0,False,False,False,0,1,2021-10-18T15:06:29.453,8,False,0.0
2021,6,3152,405,23,2994,2,12,5,10,10,0,10,0,10,0,False,False,False,0,3,2022-02-24T13:52:05.713,10,False,0.0
2021,6,3152,410,23,7689,13,21,2,27,0,0,0,0,0,0,False,False,False,0,2,2021-10-18T15:14:43.133,0,False,0.0
2021,6,3152,415,23,2994,2,35,2,29,33,4,31,2,31,0,False,False,False,0,3,2021-10-18T11:56:24.45,33,False,2.0
2021,6,3152,425,23,4307,2,24,6,23,31,8,31,0,31,6,False,False,False,0,1,2021-10-21T19:39:52.323,31,False,0.0
2021,6,3152,460,10,4702,2,39,10,7,8,1,7,1,7,0,False,False,False,0,4,2021-10-18T12:23:48.03,8,False,
2021,6,3152,470,10,6281,13,4,10,12,0,0,0,0,0,0,False,False,False,0,3,2021-10-21T21:22:17.507,0,False,0.0
2021,6,3152,475,10,4930,13,8,7,40,0,0,0,0,0,0,False,False,False,0,2,2022-02-22T19:58:01.147,0,False,0.0
2021,6,3152,490,23,7241,2,48,10,-3,29,32,17,12,17,0,False,False,False,1,1,2021-10-21T21:41:12.477,29,False,12.0
2021,6,3152,495,23,7250,2,46,3,0,3,3,2,1,2,0,False,False,False,0,3,2021-10-21T19:04:37.527,3,False,1.0
2021,6,3152,520,10,6840,2,6,10,14,14,0,14,0,14,0,False,False,False,0,4,2021-10-18T12:39:51.227,14,False,0.0
2021,6,3152,525,10,6358,2,34,4,-4,3,7,2,1,2,0,True,False,False,0,3,2021-10-18T12:41:21.757,3,False,1.0
2021,6,3152,530,10,6281,2,4,9,11,14,3,12,2,12,0,False,False,False,0,2,2021-10-18T12:43:08.953,14,False,2.0
2021,6,3152,550,10,6840,13,17,10,14,0,0,0,0,0,0,False,False,False,0,3,2021-10-18T12:52:12.77,0,False,0.0
2021,6,3152,575,23,7250,13,7,10,14,0,0,0,0,0,0,False,False,False,0,3,2021-10-21T21:41:41.52,0,False,0.0
2021,6,3152,585,10,6281,13,8,7,44,0,0,0,0,0,0,False,False,False,0,2,2021-10-18T13:01:16.55,0,False,0.0
2021,6,3152,590,10,4702,2,13,9,6,11,5,9,2,9,0,False,False,False,0,4,2021-10-21T19:04:37.527,11,False,2.0
2021,6,3152,600,10,7938,2,4,10,5,6,1,6,0,6,0,False,False,False,0,3,2021-10-21T19:04:37.527,6,False,0.0
2021,6,3152,620,23,7689,13,3,5,14,0,0,0,0,0,0,False,False,False,0,3,2021-10-18T13:17:49.35,0,False,0.0
2021,6,3152,625,23,7688,2,8,1,38,40,2,39,1,39,0,False,False,False,0,3,2022-02-22T19:59:17.57,40,False,1.0
2021,6,3152,650,10,6281,2,2,9,7,10,3,10,0,10,0,False,False,False,0,2,2021-10-18T13:25:56.533,10,False,0.0
2021,6,3152,660,10,7938,2,39,4,4,5,1,3,2,3,0,False,False,False,1,3,2021-10-21T21:31:03.83,5,False,2.0
2021,6,3152,670,10,7938,2,4,9,4,7,3,6,1,6,0,False,False,False,0,3,2021-10-18T13:33:45.363,7,False,1.0
2021,6,3152,675,10,6840,2,35,7,18,26,8,23,3,23,0,False,False,False,0,3,2021-10-18T13:35:41.04,26,False,3.0
2021,6,3152,685,10,8541,2,45,5,-2,13,15,10,3,10,0,False,False,False,0,1,2021-10-18T13:40:40.723,4,False,3.0
2021,6,3152,690,10,4702,13,4,10,11,0,0,0,0,0,0,False,False,False,0,3,2021-10-18T13:43:18.98,0,False,0.0
2021,6,3152,695,10,6840,2,31,5,5,12,7,10,2,10,0,False,False,False,0,4,2021-10-18T13:44:50.36,12,False,2.0
2021,6,3152,700,10,7938,2,5,9,12,12,0,12,0,12,0,False,False,False,0,3,2021-10-18T13:46:49.46,12,False,0.0
2021,6,3152,705,10,6281,13,35,9,12,0,0,0,0,0,0,False,False,False,0,3,2021-10-18T13:48:32.017,0,False,0.0
2021,6,3152,710,10,6281,2,6,5,6,12,6,5,7,5,6,False,False,False,1,2,2021-10-18T13:50:20.383,12,False,7.0
2021,6,3152,730,23,2994,2,5,5,5,8,3,6,2,6,0,False,False,False,0,3,2021-10-18T13:54:33.68,8,False,2.0
2021,6,3152,740,23,7689,2,9,6,18,51,33,48,3,48,0,False,False,False,0,3,2021-10-18T13:56:58.293,51,False,3.0
2021,6,3152,755,23,7240,3,47,5,1,0,0,0,0,0,0,False,False,False,0,1,2021-10-18T14:00:52.71,0,False,0.0
2021,6,3152,770,10,4930,2,5,5,12,12,0,12,0,12,0,False,False,False,0,3,2021-10-18T14:20:03.26,12,False,0.0
2021,6,3152,780,10,6840,13,4,10,10,0,0,0,0,0,0,False,False,False,0,3,2021-10-21T19:04:37.527,0,False,0.0
2021,6,3152,785,10,6281,13,24,8,43,0,0,0,0,0,0,False,False,False,0,3,2021-10-18T14:24:58.35,0,False,0.0
2021,6,3152,815,10,6840,2,29,2,23,26,3,23,3,23,0,False,False,False,0,4,2021-10-18T14:36:51.05,26,False,3.0
2021,6,3152,820,10,4702,2,4,10,5,6,1,6,0,6,0,False,False,False,0,4,2021-10-18T14:34:12.103,6,False,0.0
2021,6,3152,825,10,6281,2,4,9,10,18,8,16,2,16,0,False,False,False,0,2,2021-10-18T14:36:09.393,18,False,2.0
2021,6,3152,830,10,6281,2,6,9,11,16,5,15,1,15,0,False,False,False,0,2,2021-10-18T14:39:25.023,16,False,1.0
2021,6,3152,845,10,6281,2,6,10,6,6,0,6,0,6,0,False,False,False,0,2,2021-10-21T19:04:37.527,6,False,0.0
2021,6,3152,850,10,6281,2,4,10,3,4,1,3,1,3,0,False,False,False,0,3,2021-10-18T14:43:00.123,4,False,1.0
2021,6,3152,855,10,6840,2,7,10,4,4,0,4,0,4,6,False,False,False,0,4,2021-10-18T14:44:01.297,4,False,0.0
2021,6,3152,870,10,8541,2,44,3,-4,1,5,0,1,0,0,False,False,False,0,1,2021-10-18T14:46:27.087,1,False,1.0
2021,6,3152,885,10,6840,2,32,5,1,6,5,4,2,4,0,False,False,False,0,4,2021-10-18T14:49:46.853,6,False,2.0
2021,6,3152,890,10,4930,13,4,5,11,0,0,0,0,0,0,False,False,False,0,2,2021-10-18T14:51:05.77,0,False,0.0
2021,6,3153,15,9,7816,2,2,9,6,11,5,8,3,8,0,False,False,False,0,2,2021-10-18T09:16:15.62,11,False,3.0
2021,6,3153,20,9,4202,2,6,9,3,7,4,6,1,6,0,False,False,False,0,1,2021-10-18T09:18:15.823,7,False,
2021,6,3153,30,9,322,2,3,3,14,14,0,14,0,14,0,True,False,False,0,3,2021-10-21T15:46:49.27,14,False,0.0
2021,6,3153,50,19,5096,2,18,3,0,9,9,5,4,5,0,False,False,False,0,2,2021-10-21T15:06:36.5,9,False,4.0
2021,6,3153,70,9,7816,2,4,5,8,11,3,11,0,11,0,False,False,False,0,2,2021-10-18T09:43:10.453,11,False,0.0
2021,6,3153,75,9,6446,2,12,9,10,18,8,14,4,14,0,True,False,False,0,4,2022-02-16T19:40:33.44,18,False,4.0
2021,6,3153,85,9,322,2,12,5,6,17,11,6,11,6,0,False,False,False,1,2,2021-10-21T15:08:54.82,17,False,11.0
2021,6,3153,90,9,7183,2,51,9,-5,3,8,1,2,1,0,True,False,False,0,1,2021-10-18T09:54:31.823,3,False,2.0
2021,6,3153,95,9,6446,2,17,7,17,23,6,20,3,20,0,False,False,False,0,4,2021-10-18T09:56:17.707,23,False,3.0
2021,6,3153,100,9,4447,2,7,10,1,1,0,1,0,1,6,False,False,False,0,4,2021-10-18T09:58:25.89,1,True,0.0
2021,6,3153,115,19,8493,2,44,9,-7,14,21,3,11,3,0,False,False,False,1,1,2021-10-18T10:01:35.14,14,False,11.0
2021,6,3153,120,19,8493,2,11,8,19,22,3,22,0,22,0,False,False,False,0,1,2021-10-18T10:03:14.05,22,False,0.0
2021,6,3153,130,19,4282,2,17,7,19,20,1,20,0,20,6,True,False,False,0,3,2022-02-16T19:54:04.44,20,True,0.0
2021,6,3153,145,9,7183,2,5,9,4,13,9,8,5,8,0,False,False,False,1,1,2021-10-18T10:12:04.82,13,False,5.0
2021,6,3153,155,9,7183,2,4,9,5,6,1,6,0,6,0,False,False,False,0,2,2021-10-18T10:15:08.68,6,False,0.0
2021,6,3153,165,9,6441,2,13,9,3,13,10,11,2,11,0,False,False,False,0,3,2021-10-18T10:18:27.27,13,False,2.0
2021,6,3153,175,9,6441,2,17,1,40,44,4,44,0,44,0,False,False,False,0,3,2021-10-18T10:25:06.367,44,False,
2021,6,3153,180,9,4446,2,12,8,16,20,4,18,2,18,0,False,False,False,0,2,2021-10-18T10:24:45.357,20,False,2.0
2021,6,3153,190,9,322,2,5,9,13,11,-2,11,0,11,0,False,False,False,0,3,2021-10-18T10:28:03.883,11,False,0.0
2021,6,3153,215,9,4447,13,17,7,16,0,0,0,0,0,0,True,False,False,0,3,2021-10-21T14:01:52.733,0,False,0.0
2021,6,3153,225,9,6441,13,17,7,16,0,0,0,0,0,0,True,False,False,0,3,2021-10-18T10:34:46.427,0,False,0.0
2021,6,3153,230,19,5096,2,30,10,-4,-2,2,-4,2,-4,0,True,False,False,0,2,2021-10-21T15:23:12.743,-2,False,
2021,6,3153,240,19,2256,2,22,2,25,27,2,27,0,27,0,False,False,False,0,3,2021-10-18T10:43:38.18,27,False,0.0
2021,6,3153,250,19,7175,2,6,10,14,25,11,20,5,20,6,False,False,False,0,3,2021-10-18T10:45:54.983,25,False,
2021,6,3153,260,9,4202,2,5,5,3,3,0,3,0,3,0,False,False,False,0,1,2021-10-18T10:49:22.17,3,False,0.0
2021,6,3153,270,9,4202,3,48,10,-4,0,0,0,0,0,0,False,False,False,0,1,2022-02-16T19:55:09.177,0,False,0.0
2021,6,3153,275,9,4202,2,45,10,-4,11,15,9,2,9,0,False,False,False,0,1,2021-10-18T10:53:48.407,11,False,2.0
2021,6,3153,300,9,6441,13,7,2,12,0,0,0,0,0,0,False,False,False,0,2,2022-02-22T21:04:27.16,0,False,0.0
2021,6,3153,320,19,7175,2,46,3,0,0,0,0,0,0,0,False,False,False,0,3,2021-10-21T16:04:30.803,0,False,0.0
2021,6,3153,330,19,7175,2,5,10,9,8,-1,8,0,8,0,False,False,False,0,3,2021-10-18T11:07:08.043,8,False,0.0
2021,6,3153,345,9,4202,2,46,3,3,4,1,4,0,4,0,False,False,False,0,1,2021-10-18T11:11:22.02,4,False,0.0
2021,6,3153,350,9,6441,2,35,9,9,13,4,13,0,13,0,True,False,False,0,3,2021-10-18T11:13:01.65,13,False,0.0
2021,6,3153,425,19,7172,2,47,10,-4,7,11,5,2,5,0,False,False,False,0,1,2021-10-21T16:04:46.107,7,False,2.0
2021,6,3153,445,9,4202,2,13,9,1,0,-1,1,-1,1,0,False,False,False,0,1,2021-10-21T13:12:05.557,0,False,-1.0
2021,6,3153,450,9,7816,13,6,9,13,0,0,0,0,0,0,False,False,False,0,2,2021-10-18T11:39:31.44,0,False,0.0
2021,6,3153,470,19,8493,2,45,5,-5,3,8,0,3,0,0,False,False,False,0,1,2021-10-21T15:26:48.347,3,False,3.0
2021,6,3153,485,9,4202,2,12,3,9,14,5,14,0,14,0,False,False,False,0,1,2021-10-18T11:49:13.227,14,True,
2021,6,3153,490,9,4202,2,13,10,8,18,10,10,8,10,0,False,False,False,0,3,2021-10-18T11:51:16.523,18,False,8.0
2021,6,3153,500,9,4446,2,12,5,4,27,23,19,8,19,0,False,False,False,1,2,2021-10-18T11:54:29.963,27,False,8.0
2021,6,3153,510,9,6446,2,32,9,3,20,17,15,5,15,0,False,False,False,1,4,2021-10-18T11:57:09.687,20,False,5.0
2021,6,3153,530,9,7816,13,7,7,16,0,0,0,0,0,0,False,False,False,0,3,2022-02-16T19:55:39.617,0,False,
2021,6,3153,535,9,7816,2,9,5,1,1,0,1,0,1,6,False,False,False,0,2,2021-10-18T12:06:06.453,1,True,0.0
2021,6,3153,565,19,4282,2,5,10,4,5,1,4,1,4,0,True,False,False,0,4,2021-10-18T12:16:07.263,5,False,1.0
2021,6,3153,570,19,7175,13,2,9,6,0,0,0,0,0,0,False,False,False,0,3,2021-10-18T12:17:22.417,0,False,0.0
2021,6,3153,585,9,7816,2,26,3,2,13,11,2,11,2,0,False,False,False,2,3,2021-10-18T12:22:50.307,13,False,11.0
2021,6,3153,590,9,4202,2,45,5,0,12,12,12,0,12,0,False,False,False,0,1,2021-10-18T12:24:14.61,12,False,0.0
2021,6,3153,610,9,7816,2,12,8,26,33,7,29,4,29,0,False,False,False,0,3,2021-10-18T12:30:54.84,33,False,4.0
2021,6,3153,615,9,6446,13,51,9,0,0,0,0,0,0,0,False,False,False,0,3,2022-02-16T19:56:53.197,0,False,0.0
2021,6,3153,620,9,4202,3,44,3,-3,0,0,0,0,0,0,False,False,False,0,1,2021-10-18T12:34:25.3,0,False,0.0
2021,6,3153,625,9,322,13,9,2,26,0,0,0,0,0,0,False,False,False,0,2,2021-10-18T12:36:13.583,0,False,0.0
2021,6,3153,645,19,7175,2,2,9,8,11,3,11,0,11,0,False,False,False,0,3,2021-10-18T12:41:27.1,11,False,0.0
2021,6,3153,665,19,1212,2,4,10,4,3,-1,3,0,3,0,False,False,False,1,1,2021-10-21T15:07:19.18,3,False,0.0
2021,6,3153,670,19,2256,13,21,9,7,0,0,0,0,0,0,False,False,False,0,2,2021-10-18T12:53:04.67,0,False,0.0
2021,6,3153,680,19,7175,2,6,9,10,11,1,11,0,11,0,False,False,False,0,3,2021-10-18T12:57:01.733,11,False,0.0
2021,6,3153,695,19,5096,13,18,3,0,0,0,0,0,0,0,False,False,False,0,2,2021-10-18T13:03:35.85,0,False,0.0
2021,6,3153,730,9,322,13,19,2,27,0,0,0,0,0,0,False,False,False,0,3,2021-10-18T13:16:05.797,0,False,0.0
2021,6,3153,740,9,6441,2,51,5,-1,3,4,1,2,1,0,False,False,False,0,3,2021-10-21T15:38:25.933,3,False,2.0
2021,6,3153,755,9,322,13,19,2,29,0,0,0,0,0,0,False,False,False,0,2,2021-10-18T13:28:27.473,0,False,0.0
2021,6,3153,785,19,4912,13,2,4,6,0,0,0,0,0,0,False,False,False,0,3,2021-10-21T13:57:32.357,0,False,0.0
2021,6,3153,800,19,4912,2,24,7,30,75,45,75,0,75,6,False,False,False,0,3,2021-10-18T13:45:13.8,75,True,0.0
2021,6,3153,815,9,7816,13,4,3,8,0,0,0,0,0,0,False,False,False,0,2,2021-10-18T13:49:17.503,0,False,0.0
2021,6,3153,820,9,4202,2,13,9,3,2,-1,2,0,2,0,False,False,False,0,3,2021-10-18T13:50:42.217,2,False,0.0
2021,6,3153,830,9,322,2,5,10,4,4,0,4,0,4,0,False,False,False,0,3,2021-10-21T15:48:06.38,4,False,0.0
2021,6,3153,835,9,6441,2,5,3,12,13,1,13,0,13,0,False,False,False,0,3,2021-10-21T16:05:00.763,13,False,0.0
2021,6,3153,840,9,6446,2,6,9,10,12,2,10,2,10,0,False,False,False,0,3,2021-10-18T14:00:36.623,12,False,2.0
2021,6,3153,845,9,6441,13,2,9,7,0,0,0,0,0,0,False,False,False,0,2,2021-10-21T13:12:05.557,0,False,0.0
2021,6,3153,850,9,6712,13,11,2,33,0,0,0,0,0,0,True,False,False,0,3,2021-10-21T13:57:18.473,0,False,0.0
2021,6,3153,855,9,7816,2,6,1,22,24,2,24,0,24,0,False,False,False,0,2,2021-10-18T14:13:11.517,24,False,0.0
2021,6,3153,890,19,2256,3,2,9,7,0,0,0,0,0,0,False,False,False,0,3,2021-10-18T14:19:19.36,0,False,0.0
2021,6,3153,895,19,7175,2,6,10,14,14,0,14,0,14,0,False,False,False,0,3,2021-10-18T14:21:12.353,14,False,0.0
2021,6,3153,910,19,2256,13,29,5,14,0,0,0,0,0,0,False,False,False,0,2,2021-10-18T14:28:38.667,0,False,0.0
2021,6,3153,925,9,7816,2,12,2,15,14,-1,14,0,14,0,False,False,False,0,3,2021-10-21T13:57:44.253,14,False,0.0
2021,6,3153,935,9,6446,2,47,5,3,6,3,3,3,3,0,False,False,False,0,4,2021-10-18T14:38:53.813,6,False,3.0
2021,6,3153,940,9,322,2,2,10,6,9,3,8,1,8,0,False,False,False,0,2,2021-10-18T14:41:02.237,9,False,1.0
2021,6,3153,950,9,7816,2,49,5,-3,7,10,3,4,3,0,False,False,False,0,2,2021-10-18T14:43:29.72,7,False,4.0
2021,6,3153,955,9,7816,2,35,2,21,35,14,35,0,35,6,False,False,False,0,3,2021-10-19T10:09:19.277,35,True,0.0
2021,6,3154,25,25,8421,2,13,4,3,7,4,4,3,4,0,False,False,False,0,2,2021-10-18T09:50:25.923,7,False,3.0
2021,6,3154,35,27,4850,2,34,4,-4,-1,3,-1,0,-1,0,True,False,False,0,3,2021-10-18T09:56:05.133,-1,False,0.0
2021,6,3154,50,27,7408,2,13,10,1,2,1,2,0,2,0,False,False,False,0,3,2021-10-18T10:03:14.287,2,False,0.0
2021,6,3154,60,25,6486,2,4,9,6,9,3,7,2,7,0,False,False,False,0,3,2021-10-18T10:05:52.96,9,False,2.0
2021,6,3154,65,25,7060,2,51,10,-3,2,5,0,2,0,0,False,False,False,0,3,2021-10-21T19:44:32.783,2,False,2.0
2021,6,3154,70,25,7060,13,19,6,40,0,0,0,0,0,0,False,False,False,0,2,2021-10-18T10:13:02.12,0,False,0.0
2021,6,3154,80,25,8422,2,12,3,6,7,1,6,1,6,0,False,False,False,0,3,2021-10-18T10:18:29.577,7,False,1.0
2021,6,3154,100,27,7408,13,20,2,20,0,0,0,0,0,0,False,False,False,0,2,2021-10-18T10:24:22.993,0,False,0.0
2021,6,3154,105,27,7404,2,28,10,2,27,25,3,24,3,0,False,False,False,4,1,2021-10-18T10:36:33.663,27,False,24.0
2021,6,3154,110,27,7496,2,12,5,12,12,0,12,0,12,0,False,False,False,0,3,2021-10-18T10:36:20.983,12,True,0.0
2021,6,3154,125,27,650,13,13,9,3,0,0,0,0,0,0,False,False,False,0,2,2021-10-21T19:52:52.47,0,False,0.0
2021,6,3154,140,25,8422,2,47,5,3,9,6,6,3,6,0,False,False,False,0,3,2021-10-18T10:49:56.813,9,False,3.0
2021,6,3154,145,25,7666,2,51,3,-2,7,9,4,3,4,0,False,False,False,0,3,2021-10-18T10:52:43.973,7,False,
2021,6,3154,155,25,7060,2,5,3,11,12,1,12,0,12,0,False,False,False,0,3,2021-10-18T10:59:31.803,12,False,0.0
2021,6,3154,165,25,7060,2,4,5,3,6,3,5,1,5,0,False,False,False,0,2,2021-10-18T11:03:32.39,6,False,1.0
2021,6,3154,170,25,7060,13,19,2,25,0,0,0,0,0,0,False,False,False,0,2,2021-10-18T11:05:14.99,0,False,0.0
2021,6,3154,180,27,3656,2,48,9,-7,-3,4,6,-9,6,0,False,False,False,1,1,2021-10-21T19:54:57.533,-3,False,-9.0
2021,6,3154,190,27,7408,2,4,10,4,12,8,6,6,6,0,False,False,False,1,3,2022-02-22T21:52:22.503,12,False,6.0
2021,6,3154,195,27,4850,13,6,10,5,0,0,0,0,0,0,False,False,False,0,3,2021-10-21T19:56:37.813,0,False,0.0
2021,6,3154,215,25,609,2,39,9,3,4,1,3,1,3,0,False,False,False,0,3,2021-10-18T11:39:51.803,4,False,1.0
2021,6,3154,230,25,8422,2,4,9,5,12,7,9,3,9,0,False,False,False,0,3,2021-10-18T11:47:26.74,12,False,3.0
2021,6,3154,235,25,7666,13,4,9,5,0,0,0,0,0,0,False,False,False,0,3,2021-10-18T11:49:29.173,0,False,0.0
2021,6,3154,245,25,8421,2,5,3,3,5,2,5,0,5,6,False,False,False,0,3,2021-10-18T11:51:08.783,5,False,0.0
2021,6,3154,260,27,7408,2,6,4,14,14,0,14,0,14,0,False,False,False,0,3,2021-10-18T11:55:00.093,14,False,0.0
2021,6,3154,270,27,7852,13,2,9,6,0,0,0,0,0,0,False,False,False,0,2,2021-10-18T12:00:32.717,0,False,0.0
2021,6,3154,275,27,7852,2,44,3,-7,0,7,-2,2,-2,0,False,False,False,1,3,2021-10-18T12:04:15.843,0,False,2.0
2021,6,3154,285,25,7060,2,50,9,-3,6,9,5,1,5,0,False,False,False,1,2,2021-10-18T12:19:15.443,6,False,1.0
2021,6,3154,290,25,7060,2,2,10,5,5,0,5,0,5,0,False,False,False,0,2,2021-10-21T19:48:24.52,5,False,0.0
2021,6,3154,295,25,8421,2,32,9,-4,12,16,10,2,10,0,False,False,False,0,1,2021-10-18T12:21:44.99,12,False,2.0
2021,6,3154,305,25,8422,2,4,10,7,9,2,8,1,8,0,True,False,False,0,4,2021-10-18T12:24:19.093,9,False,1.0
2021,6,3154,315,25,8421,2,47,5,-1,6,7,-1,7,-1,0,False,False,False,2,1,2021-10-21T19:49:12.087,6,False,7.0
2021,6,3154,325,25,7060,13,9,6,24,0,0,0,0,0,0,False,False,False,0,2,2021-10-18T12:33:50.063,0,False,
2021,6,3154,345,25,7666,2,2,4,1,5,4,3,2,3,0,False,False,False,0,3,2022-02-22T21:53:07.543,5,False,2.0
2021,6,3154,385,27,650,13,4,10,5,0,0,0,0,0,0,False,False,False,0,3,2021-10-18T12:44:30.597,0,False,0.0
2021,6,3154,390,27,650,13,12,7,20,0,0,0,0,0,0,False,False,False,0,2,2021-10-21T19:51:50.127,0,False,0.0
2021,6,3154,410,25,7060,2,18,5,-2,2,4,2,0,2,0,False,False,False,0,2,2022-02-22T21:53:19.223,2,False,0.0
2021,6,3154,415,25,8421,13,28,5,-3,0,0,0,0,0,0,False,False,False,0,1,2022-02-16T20:08:08.147,0,False,0.0
2021,6,3154,420,25,7060,2,13,9,0,1,1,1,0,1,0,False,False,False,0,2,2021-10-18T17:02:45.797,1,False,0.0
2021,6,3154,460,27,7408,2,18,5,-2,9,11,-1,10,-1,0,False,False,False,1,2,2021-10-21T19:49:58.52,9,False,10.0
2021,6,3154,505,25,6259,2,5,10,4,15,11,10,5,10,0,False,False,False,1,3,2021-10-18T13:35:40.967,15,False,5.0
2021,6,3154,515,25,7666,13,29,3,10,0,0,0,0,0,0,False,False,False,0,2,2021-10-18T13:39:54.76,0,False,0.0
2021,6,3154,520,25,7060,2,6,9,12,14,2,13,1,13,0,False,False,False,0,3,2021-10-18T13:49:20.56,14,False,1.0
2021,6,3154,525,25,7060,2,9,6,21,23,2,22,1,22,0,False,False,False,0,2,2021-10-18T13:55:09.797,23,False,1.0
2021,6,3154,530,25,7666,3,29,5,11,0,0,0,0,0,0,False,False,False,0,2,2021-10-18T14:02:43.1,0,False,0.0
2021,6,3154,535,25,7060,2,50,5,-5,-3,2,-5,2,-5,0,False,False,False,0,2,2021-10-18T14:04:36.257,-3,False,
2021,6,3154,540,25,609,2,4,4,5,6,1,6,0,6,0,False,False,False,0,4,2021-10-18T14:06:55.633,6,False,0.0
2021,6,3154,545,25,8422,2,5,5,10,12,2,11,1,11,0,False,False,False,0,4,2021-10-18T14:08:11.153,12,False,1.0
2021,6,3154,565,27,650,2,44,3,2,14,12,14,0,14,0,False,False,False,0,3,2021-10-18T14:13:43.727,14,True,0.0
2021,6,3154,575,27,4850,2,7,6,18,41,23,20,21,20,0,False,False,False,3,4,2021-10-21T19:50:16.767,41,False,21.0
2021,6,3154,585,27,6397,2,47,5,0,1,1,1,0,1,6,False,False,False,0,4,2021-10-18T14:34:22.993,1,False,0.0
2021,6,3154,605,25,8421,2,5,4,1,4,3,1,3,1,0,False,False,False,0,1,2021-10-18T14:43:40.783,4,False,3.0
2021,6,3154,610,25,7666,13,29,3,12,0,0,0,0,0,0,False,False,False,0,2,2021-10-18T14:45:34.317,0,False,0.0
2021,6,3154,630,27,650,13,5,5,4,0,0,0,0,0,0,False,False,False,0,3,2021-10-18T15:04:46.953,0,False,0.0
2021,6,3154,650,27,1116,2,18,9,-2,3,5,0,3,0,0,False,False,False,0,2,2021-10-18T15:10:42.033,3,False,3.0
2021,6,3154,695,27,650,13,5,5,7,0,0,0,0,0,0,False,False,False,0,3,2021-10-18T15:28:44.963,0,False,0.0
2021,6,3154,700,27,7852,2,50,3,-4,-4,0,-4,0,-4,0,False,False,False,0,2,2021-10-18T15:30:01.997,-4,False,0.0
2021,6,3154,715,25,7666,2,4,3,4,12,8,5,7,5,0,False,False,False,1,2,2021-10-18T15:35:11.1,12,False,7.0
2021,6,3154,725,25,7060,13,12,6,22,0,0,0,0,0,0,False,False,False,0,2,2021-10-18T15:40:37.717,0,False,0.0
2021,6,3154,730,25,7666,13,9,2,22,0,0,0,0,0,0,False,False,False,0,2,2021-10-18T15:41:49.38,0,False,0.0
2021,6,3154,750,27,7850,2,48,9,-4,7,11,3,4,3,0,False,False,False,0,1,2021-10-18T15:49:26.167,7,False,4.0
2021,6,3154,765,25,8422,2,5,5,4,7,3,5,2,5,0,False,False,False,0,3,2021-10-18T15:52:58.573,7,False,2.0
2021,6,3154,795,25,7666,13,9,6,30,0,0,0,0,0,0,False,False,False,0,2,2021-10-18T16:05:14.917,0,False,
2021,6,3154,800,25,7060,13,6,9,11,0,0,0,0,0,0,False,False,False,0,2,2021-10-18T16:08:02.633,0,False,0.0
2021,6,3154,805,25,8421,2,32,3,6,12,6,6,6,6,0,False,False,False,1,3,2021-10-21T19:47:22.19,12,False,6.0
2021,6,3154,825,27,6397,2,4,5,3,7,4,5,2,5,0,False,False,False,0,2,2021-10-21T19:47:58.95,7,False,2.0
2021,6,3154,835,27,7850,2,4,10,3,7,4,5,2,5,0,False,False,False,0,1,2021-10-18T16:16:48.907,7,False,2.0
2021,6,3154,845,27,7850,2,28,9,0,2,2,2,0,2,0,False,False,False,0,1,2021-10-19T15:47:45.377,2,False,0.0
2021,6,3154,850,27,7408,2,5,5,11,11,0,11,0,11,0,False,False,False,0,2,2021-10-18T16:22:15.913,11,False,0.0
2021,6,3154,855,27,7850,2,4,4,4,7,3,6,1,6,0,False,True,False,0,1,2021-10-18T17:00:30.77,7,False,1.0
2021,6,3154,870,27,7408,2,5,3,8,12,4,12,0,12,0,False,True,False,0,2,2021-10-18T16:29:03.703,10,False,0.0
2021,6,3154,900,27,650,2,36,7,20,21,1,20,1,20,0,False,False,False,0,3,2021-10-18T16:37:37.147,21,False,1.0
2021,6,3154,910,27,7850,2,4,4,3,10,7,8,2,8,0,False,False,False,0,1,2021-10-18T16:40:26.507,10,False,2.0
2021,6,3154,930,25,8422,2,47,5,0,2,2,1,1,1,0,False,False,False,0,4,2021-10-18T16:46:52.16,2,False,1.0
2021,6,3154,935,25,6259,2,47,5,1,3,2,3,0,3,0,False,False,False,0,3,2021-10-18T16:48:29.77,3,False,0.0
2021,6,3155,20,31,6724,2,38,4,2,11,9,9,2,9,0,False,False,False,0,4,2021-10-19T08:51:52.39,11,False,2.0
2021,6,3155,30,31,6793,13,6,7,17,0,0,0,0,0,0,False,False,False,0,3,2021-10-21T21:29:00.67,0,False,0.0
2021,6,3155,35,31,4070,13,6,10,11,0,0,0,0,0,0,False,False,False,0,2,2021-10-19T08:57:49.81,0,False,0.0
2021,6,3155,45,4,594,2,4,10,2,9,7,8,1,8,0,False,False,False,0,3,2021-10-19T09:00:35.45,9,False,1.0
2021,6,3155,55,4,2853,2,13,9,3,12,9,6,6,6,0,False,False,False,1,3,2021-10-21T21:30:25.04,12,False,6.0
2021,6,3155,75,4,594,2,46,9,0,12,12,7,5,7,0,False,False,False,1,3,2021-10-19T09:12:53.09,12,False,5.0
2021,6,3155,85,4,2853,2,5,3,4,6,2,6,0,6,0,False,False,False,0,3,2021-10-19T09:15:59.37,6,True,0.0
2021,6,3155,90,4,6983,2,47,10,1,4,3,4,0,4,0,True,False,False,0,1,2022-02-16T20:10:40.72,4,False,0.0
2021,6,3155,120,31,3504,13,48,10,-1,0,0,0,0,0,0,False,False,False,0,1,2021-10-19T09:28:04.303,0,False,0.0
2021,6,3155,135,4,7645,2,44,3,-3,3,6,3,0,3,0,False,True,False,0,1,2021-10-19T09:40:55.257,3,False,0.0
2021,6,3155,155,31,3504,2,4,4,6,8,2,7,1,7,0,False,False,False,0,1,2021-10-19T09:46:38.533,8,False,
2021,6,3155,165,31,661,2,4,9,5,5,0,5,0,5,0,False,False,False,0,2,2021-10-19T09:51:09.59,5,False,0.0
2021,6,3155,170,31,661,13,8,7,23,0,0,0,0,0,0,False,False,False,0,3,2021-10-21T21:23:41.393,0,False,0.0
2021,6,3155,175,4,6953,2,28,3,1,11,10,8,3,8,0,True,False,False,1,1,2021-10-19T09:58:19.84,11,False,3.0
2021,6,3155,190,4,6983,2,4,4,4,6,2,6,0,6,0,False,False,False,0,1,2021-10-19T10:08:47.02,6,False,0.0
2021,6,3155,195,4,2853,13,5,3,13,0,0,0,0,0,0,False,False,False,0,2,2021-10-19T10:06:28.187,0,False,0.0
2021,6,3155,205,4,2853,2,2,10,7,7,0,7,0,7,0,False,False,False,0,2,2021-10-21T21:13:30.573,7,False,0.0
2021,6,3155,210,4,7646,13,36,10,12,0,0,0,0,0,0,False,False,False,0,3,2021-10-20T15:46:06.1,0,False,
2021,6,3155,220,4,5119,2,30,9,1,3,2,3,0,3,0,True,False,False,0,3,2021-10-21T21:17:00.873,3,False,0.0
2021,6,3155,230,4,2853,13,4,10,10,0,0,0,0,0,0,False,False,False,0,3,2021-10-19T10:26:05.16,0,False,0.0
2021,6,3155,270,4,6983,2,45,5,-4,3,7,3,0,3,0,False,False,False,0,1,2021-10-19T10:40:10.877,3,False,0.0
2021,6,3155,275,4,213,2,8,7,16,21,5,18,3,18,0,False,False,False,0,2,2021-10-19T10:42:55.13,21,False,3.0
2021,6,3155,280,4,213,2,12,10,13,19,6,18,1,18,0,False,False,False,0,2,2021-10-19T10:45:01.157,19,False,1.0
2021,6,3155,285,4,6983,2,47,10,-1,2,3,0,2,0,0,False,False,False,1,1,2021-10-19T10:46:50.22,2,False,2.0
2021,6,3155,290,4,2853,2,2,10,13,14,1,14,0,14,6,False,False,False,0,2,2021-10-19T10:48:18.763,14,True,0.0
2021,6,3155,315,31,661,2,12,2,39,48,9,48,0,48,0,False,False,False,0,3,2022-02-22T22:10:08.31,48,True,0.0
2021,6,3155,325,31,3911,2,50,10,-4,7,11,4,3,4,0,False,False,False,0,3,2021-10-19T11:01:07.737,7,False,3.0
2021,6,3155,330,31,661,13,13,9,5,0,0,0,0,0,0,False,False,False,0,3,2021-10-21T22:03:01.16,0,False,0.0
2021,6,3155,345,4,7645,13,28,9,2,0,0,0,0,0,0,False,False,False,0,1,2021-10-19T11:06:22.727,0,False,0.0
2021,6,3155,385,4,7646,2,50,3,-2,5,7,3,2,3,0,False,False,False,0,2,2021-10-19T11:18:45.387,5,False,2.0
2021,6,3155,390,4,2853,2,6,9,14,17,3,16,1,16,0,False,False,False,0,3,2021-10-19T14:35:40.87,17,False,1.0
2021,6,3155,405,4,2853,2,3,3,12,12,0,12,0,12,0,False,False,False,0,2,2021-10-19T11:27:53.977,12,False,0.0
2021,6,3155,420,4,7645,13,4,4,5,0,0,0,0,0,0,False,False,False,0,1,2021-10-19T11:30:47.637,0,False,0.0
2021,6,3155,430,4,594,2,12,2,29,29,0,29,0,29,6,True,False,False,0,3,2022-02-24T13:55:23.913,29,True,0.0
2021,6,3155,460,4,6983,2,48,9,-4,1,5,0,1,0,0,True,False,False,1,1,2021-10-20T15:46:43.373,1,False,1.0
2021,6,3155,465,4,213,2,4,9,5,5,0,5,0,5,0,False,False,False,0,3,2021-10-19T11:51:16.537,5,False,0.0
2021,6,3155,470,4,2853,2,4,3,6,9,3,6,3,6,0,False,False,False,1,2,2021-10-19T11:53:02.933,9,False,3.0
2021,6,3155,475,4,6953,2,28,9,2,11,9,5,6,5,0,False,False,False,1,1,2021-10-19T11:54:32.74,11,False,6.0
2021,6,3155,480,4,594,2,6,4,13,18,5,16,2,16,0,False,False,False,0,3,2021-10-19T11:56:23.743,18,False,2.0
2021,6,3155,495,4,594,13,4,10,5,0,0,0,0,0,0,False,False,False,0,3,2022-02-16T20:12:15.917,0,False,0.0
2021,6,3155,510,31,6793,2,35,9,9,8,-1,8,0,8,0,False,False,False,0,2,2021-10-19T12:06:35.7,8,False,0.0
2021,6,3155,520,31,2901,13,30,9,1,0,0,0,0,0,0,True,False,False,0,4,2021-10-19T12:10:26.943,0,False,0.0
2021,6,3155,550,31,6793,2,13,9,3,8,5,4,4,4,0,False,False,False,0,2,2021-10-19T12:19:37.357,8,False,4.0
2021,6,3155,555,31,6793,2,2,4,9,14,5,13,1,13,0,False,False,False,0,3,2021-10-21T21:31:35.023,14,False,1.0
2021,6,3155,565,31,2865,2,5,3,5,8,3,8,0,8,0,False,False,False,0,4,2021-10-19T12:25:03.493,8,False,0.0
2021,6,3155,570,31,6793,13,9,5,3,0,0,0,0,0,0,False,False,False,0,3,2021-10-19T12:26:25.847,0,False,0.0
2021,6,3155,605,4,594,2,4,10,6,9,3,9,0,9,0,False,False,False,0,3,2021-10-19T12:33:55.503,9,False,0.0
2021,6,3155,610,4,213,2,4,6,15,15,0,15,0,15,0,False,False,False,0,2,2021-10-20T15:47:32.353,15,True,0.0
2021,6,3155,615,4,213,13,19,6,32,0,0,0,0,0,0,False,False,False,0,2,2021-10-19T12:39:39.337,0,False,0.0
2021,6,3155,620,4,6953,2,46,3,-1,3,4,3,0,3,0,False,False,False,0,4,2021-10-21T21:15:44.03,3,False,0.0
2021,6,3155,625,4,2853,13,19,2,43,0,0,0,0,0,0,False,False,False,0,3,2021-10-20T15:47:47.847,0,False,
2021,6,3155,630,4,594,2,46,9,0,4,4,4,0,4,0,False,False,False,1,3,2021-10-20T15:48:03.303,4,False,0.0
2021,6,3155,640,4,6990,2,35,10,1,1,0,1,0,1,6,False,False,False,0,4,2021-10-19T12:53:13.043,1,True,0.0
2021,6,3155,655,31,3504,2,48,9,-6,4,10,0,4,0,0,False,False,False,0,1,2021-10-19T13:02:21.637,4,False,4.0
2021,6,3155,670,31,6793,2,6,4,11,13,2,11,2,11,0,False,False,False,0,2,2021-10-19T13:10:12.223,13,False,2.0
2021,6,3155,680,31,6793,2,6,9,11,20,9,18,2,18,0,True,False,False,0,2,2021-10-19T13:13:22.953,20,False,2.0
2021,6,3155,690,31,3504,2,51,9,-6,7,13,2,5,2,0,False,False,False,0,1,2021-10-19T13:17:43.983,7,False,
2021,6,3155,695,31,6793,2,4,9,6,6,0,6,0,6,0,False,False,False,0,3,2021-10-19T13:19:42.413,6,False,0.0
2021,6,3155,700,31,661,2,13,4,4,6,2,6,0,6,0,False,False,False,0,2,2021-10-19T13:22:26.877,6,False,0.0
2021,6,3155,715,4,2853,2,5,3,7,6,-1,7,-1,7,0,False,False,False,0,3,2021-10-19T13:28:31.79,6,False,-1.0
2021,6,3155,720,4,594,13,47,10,1,0,0,0,0,0,0,False,False,False,0,3,2021-10-19T13:31:01.407,0,False,0.0
2021,6,3155,725,4,2853,2,4,3,6,6,0,6,0,6,0,False,False,False,0,2,2021-10-19T13:33:15.117,6,False,0.0
2021,6,3155,735,4,213,13,8,1,51,0,0,0,0,0,0,False,False,False,0,2,2021-10-19T13:38:17.517,0,False,0.0
2021,6,3155,740,4,2630,13,29,2,29,0,0,0,0,0,0,False,False,False,0,2,2021-10-19T13:41:31.023,0,False,0.0
2021,6,3155,755,31,7913,2,26,10,5,14,9,11,3,11,0,False,False,False,0,3,2021-10-21T21:15:57.75,14,False,3.0
2021,6,3155,760,31,6793,2,8,8,15,22,7,19,3,19,0,False,False,False,0,3,2021-10-19T13:55:47.927,22,False,3.0
2021,6,3155,770,31,7913,2,13,9,5,5,0,5,0,5,0,False,False,False,0,3,2021-10-21T22:03:14.03,5,False,0.0
2021,6,3155,775,31,7913,2,39,9,5,8,3,7,1,7,0,False,False,False,0,3,2021-10-19T13:58:00.613,8,False,1.0
2021,6,3155,780,31,3504,2,51,10,-7,9,16,8,1,8,0,False,False,False,0,1,2021-10-19T13:59:20.643,9,False,1.0
2021,6,3155,800,4,213,2,19,2,29,31,2,31,0,31,0,False,False,False,0,2,2021-10-20T15:46:06.1,31,False,0.0
2021,6,3155,805,4,7645,2,28,4,3,12,9,10,2,10,0,False,False,False,0,1,2021-10-19T14:08:07.333,12,False,2.0
2021,6,3155,815,4,594,2,4,10,4,7,3,7,0,7,0,False,False,False,0,3,2021-10-19T14:15:20.003,7,False,0.0
2021,6,3155,820,4,7646,2,12,10,14,20,6,15,5,15,0,False,False,False,0,3,2021-10-19T14:35:58.583,20,False,5.0
2021,6,3155,835,4,213,13,5,3,8,0,0,0,0,0,0,False,False,False,0,2,2021-10-21T21:16:16.47,0,False,0.0
2021,7,3156,10,8,232,2,30,3,-2,7,9,5,2,5,0,False,False,False,0,3,2021-10-22T10:12:29.147,7,False,2.0
2021,7,3156,15,8,3883,2,53,9,-3,34,37,29,5,29,0,False,False,False,0,4,2021-10-22T10:18:07.06,34,False,5.0
2021,7,3156,60,10,6840,2,13,4,3,6,3,5,1,5,0,False,False,False,0,4,2021-10-22T10:34:42.583,6,False,1.0
2021,7,3156,85,8,232,2,46,3,1,4,3,3,1,3,0,False,False,False,0,3,2021-10-22T10:38:37.53,4,False,1.0
2021,7,3156,90,8,232,2,2,10,4,5,1,4,1,4,0,False,False,False,0,3,2021-10-22T10:40:10.557,5,False,1.0
2021,7,3156,100,8,232,2,5,5,14,14,0,14,0,14,0,False,False,False,0,3,2021-10-22T10:46:28.05,14,False,0.0
2021,7,3156,110,8,1067,13,24,6,32,0,0,0,0,0,0,False,False,False,0,2,2021-10-22T10:50:38.533,0,False,0.0
2021,7,3156,130,8,8354,2,46,3,-1,8,9,5,3,5,0,True,False,False,1,1,2021-10-23T13:39:34.733,8,False,3.0
2021,7,3156,160,10,8541,2,48,9,-4,8,12,5,3,5,0,False,False,False,0,1,2021-10-22T11:01:55.293,8,False,3.0
2021,7,3156,170,10,6281,2,19,2,26,31,5,26,5,26,0,False,False,False,0,2,2021-10-22T11:08:36.91,31,False,5.0
2021,7,3156,175,10,8541,2,48,4,-4,1,5,-1,2,-1,0,False,False,False,0,1,2021-10-22T11:10:42.967,1,False,2.0
2021,7,3156,190,10,1412,13,8,8,31,0,0,0,0,0,0,False,False,False,0,2,2021-10-22T11:13:51.343,0,False,0.0
2021,7,3156,195,8,7009,2,48,9,-5,4,9,-4,8,-4,0,False,False,False,3,1,2021-10-22T11:22:02.363,4,False,8.0
2021,7,3156,225,8,1067,3,2,9,3,0,0,0,0,0,0,False,False,False,0,2,2021-10-23T13:40:38.49,0,False,0.0
2021,7,3156,230,8,8349,13,8,8,45,0,0,0,0,0,0,False,False,False,0,3,2021-10-22T11:35:04.903,0,False,0.0
2021,7,3156,250,10,8541,2,50,3,-3,0,3,-1,1,-1,0,False,False,False,0,2,2021-10-22T11:38:49.197,0,False,1.0
2021,7,3156,255,10,282,2,48,9,-1,6,7,4,2,4,0,False,False,False,0,1,2021-10-22T11:40:11.933,6,False,2.0
2021,7,3156,260,10,6840,2,32,5,2,6,4,5,1,5,0,False,False,False,0,4,2021-10-28T16:19:14.927,6,False,1.0
2021,7,3156,280,8,4976,2,13,9,5,6,1,5,1,5,0,False,False,False,0,3,2021-10-22T11:53:49.547,6,False,1.0
2021,7,3156,290,8,3606,13,5,5,13,0,0,0,0,0,0,True,False,False,0,3,2021-10-28T16:07:22.003,0,False,0.0
2021,7,3156,295,8,8354,2,50,9,-4,9,13,4,5,4,0,True,False,False,1,3,2021-10-22T12:02:38.277,9,False,5.0
2021,7,3156,300,8,7652,2,7,4,13,15,2,15,0,15,0,True,False,False,0,4,2021-10-22T15:22:45.133,15,False,0.0
2021,7,3156,310,8,232,13,29,2,15,0,0,0,0,0,0,True,False,False,0,2,2021-10-22T12:09:00.77,0,False,0.0
2021,7,3156,315,8,8349,2,5,5,6,6,0,6,0,6,0,False,False,False,0,2,2021-10-22T12:11:37.897,6,True,0.0
2021,7,3156,320,8,4976,2,53,10,-5,12,17,7,5,7,0,False,False,False,0,4,2021-10-22T12:13:30.657,12,False,5.0
2021,7,3156,340,8,1067,13,5,3,11,0,0,0,0,0,0,False,False,False,0,2,2021-10-22T12:18:22.167,0,False,0.0
2021,7,3156,380,8,3606,2,32,10,-2,-2,0,-2,0,-2,0,False,False,False,0,3,2021-10-22T12:43:50.5,-2,False,0.0
2021,7,3156,390,8,1067,13,5,5,11,0,0,0,0,0,0,False,False,False,0,2,2022-02-16T14:56:27.883,0,False,0.0
2021,7,3156,395,8,3883,13,12,5,2,0,0,0,0,0,0,False,False,False,0,4,2022-02-24T13:57:00.263,0,False,0.0
2021,7,3156,405,10,6281,13,19,6,32,0,0,0,0,0,0,False,False,False,0,2,2021-10-22T12:32:30.897,0,False,
2021,7,3156,425,10,6840,2,32,5,2,9,7,4,5,4,0,False,False,False,1,4,2021-10-22T12:43:09.333,9,False,5.0
2021,7,3156,435,10,6281,2,2,9,9,12,3,9,3,9,0,False,False,False,0,2,2021-10-28T16:22:33.207,12,False,3.0
2021,7,3156,440,10,6281,2,3,5,13,13,0,13,0,13,0,False,False,False,0,2,2022-02-16T15:01:14.29,13,True,0.0
2021,7,3156,455,10,7938,2,12,5,2,4,2,4,0,4,0,False,False,False,0,3,2021-10-22T12:54:47.053,4,False,0.0
2021,7,3156,460,10,7938,2,4,9,7,11,4,9,2,9,0,False,False,False,1,3,2021-10-28T16:10:23.91,11,False,2.0
2021,7,3156,470,10,6840,2,46,3,3,9,6,6,3,6,0,False,False,False,0,4,2021-10-22T12:59:04.893,9,False,3.0
2021,7,3156,475,10,6840,13,24,5,8,0,0,0,0,0,0,False,False,False,0,4,2021-10-22T13:02:43.657,0,False,0.0
2021,7,3156,485,10,282,2,46,3,4,8,4,4,4,4,6,False,False,False,1,1,2021-10-22T15:09:48.987,8,False,4.0
2021,7,3156,510,8,1067,2,4,10,5,6,1,6,0,6,0,False,False,False,0,2,2021-10-22T13:33:18.61,6,False,0.0
2021,7,3156,515,8,1067,2,5,6,17,17,0,17,0,17,0,False,False,False,0,3,2021-10-22T13:34:56.493,17,False,0.0
2021,7,3156,520,8,8349,2,6,4,14,16,2,15,1,15,0,False,False,False,0,2,2021-10-22T13:36:50.957,16,False,1.0
2021,7,3156,530,8,7009,2,5,9,3,18,15,8,10,8,0,False,False,False,0,1,2021-10-28T13:22:47.767,18,False,10.0
2021,7,3156,535,8,7652,13,4,9,2,0,0,0,0,0,0,False,False,False,0,4,2021-10-22T13:44:59.627,0,False,0.0
2021,7,3156,560,8,232,13,2,10,6,0,0,0,0,0,0,True,False,False,0,2,2021-10-22T13:53:17.347,0,False,0.0
2021,7,3156,570,8,6703,2,46,3,1,1,0,1,0,1,6,False,False,False,0,1,2021-10-22T13:56:58.29,1,True,0.0
2021,7,3156,590,10,4930,13,2,9,7,0,0,0,0,0,0,False,False,False,0,3,2021-10-22T13:59:34.717,0,False,0.0
2021,7,3156,595,10,8541,2,44,3,-5,8,13,4,4,4,0,False,False,False,0,1,2021-10-22T14:01:05.497,8,False,4.0
2021,7,3156,630,8,8354,2,34,4,-4,4,8,1,3,1,0,True,False,False,0,2,2021-10-22T14:16:39.22,4,False,3.0
2021,7,3156,645,8,232,13,29,2,16,0,0,0,0,0,0,False,False,False,0,2,2021-10-22T14:22:17.64,0,False,0.0
2021,7,3156,655,10,8541,3,44,3,0,0,0,0,0,0,0,False,False,False,0,1,2021-10-22T14:24:53.343,0,False,0.0
2021,7,3156,660,10,8541,2,46,3,-2,5,7,1,4,1,0,False,False,False,0,1,2021-10-22T14:26:21.757,5,False,4.0
2021,7,3156,670,10,6281,2,4,10,2,2,0,2,0,2,0,False,False,False,0,2,2021-10-22T14:29:13.46,2,False,0.0
2021,7,3156,680,10,4930,13,43,6,24,0,0,0,0,0,0,False,False,False,0,3,2021-10-28T13:04:27.53,0,False,0.0
2021,7,3156,685,10,4930,2,5,5,9,9,0,9,0,9,0,False,False,False,0,3,2021-10-22T14:34:53.027,9,True,0.0
2021,7,3156,695,10,6281,2,35,5,10,10,0,10,0,10,0,False,False,False,0,4,2021-10-22T14:36:48.397,10,False,0.0
2021,7,3156,700,10,4702,2,32,5,1,3,2,2,1,2,0,False,False,False,0,4,2021-10-22T14:38:14.157,3,False,1.0
2021,7,3156,710,10,4930,2,12,9,7,7,0,7,0,7,0,False,False,False,0,3,2021-10-22T14:40:02.283,7,False,0.0
2021,7,3156,715,10,282,13,46,3,1,0,0,0,0,0,0,False,False,False,0,1,2021-10-22T14:41:27.17,0,False,0.0
2021,7,3156,720,10,7702,13,6,10,5,0,0,0,0,0,0,False,False,False,0,2,2021-10-22T14:42:37.08,0,False,0.0
2021,7,3156,725,10,6840,2,5,3,4,9,5,8,1,8,0,False,False,False,0,4,2021-10-22T14:45:03.18,9,False,1.0
2021,7,3156,735,10,4930,13,5,3,10,0,0,0,0,0,0,False,False,False,0,3,2021-10-22T14:47:32.477,0,False,0.0
2021,7,3156,745,10,8541,2,48,9,-4,10,14,6,4,6,6,False,False,False,0,1,2021-10-22T14:49:29.91,10,False,4.0
2021,7,3156,765,8,3883,2,32,3,5,8,3,5,3,5,0,False,False,False,2,4,2021-10-28T16:11:03.973,8,False,3.0
2021,7,3156,785,8,232,2,2,9,6,7,1,6,1,6,0,False,False,False,0,2,2021-10-22T14:56:23.497,7,False,1.0
2021,7,3157,10,5,3477,2,49,10,-2,4,6,3,1,3,0,True,False,False,0,3,2021-10-28T14:29:09.087,4,False,1.0
2021,7,3157,20,5,8409,2,12,5,-1,2,3,1,1,1,0,False,False,False,0,1,2022-02-24T13:57:59.24,2,False,1.0
2021,7,3157,50,5,8408,2,39,9,4,9,5,4,5,4,0,False,False,False,1,4,2021-10-28T14:29:34.297,9,False,5.0
2021,7,3157,55,5,5220,3,4,3,5,0,0,0,0,0,0,False,False,False,0,2,2021-10-25T10:14:55.36,0,False,0.0
2021,7,3157,65,5,6282,2,28,5,-7,1,8,0,1,0,0,False,False,False,1,1,2021-10-28T13:21:07.833,1,False,1.0
2021,7,3157,85,21,7090,2,2,10,9,15,6,11,4,11,0,False,False,False,0,2,2021-10-25T10:26:57.4,15,False,4.0
2021,7,3157,95,21,4422,2,53,9,-3,-2,1,-2,0,-2,0,False,False,False,0,4,2022-02-16T16:42:08.07,-2,False,0.0
2021,7,3157,105,21,4422,2,50,10,0,6,6,4,2,4,0,True,False,False,0,3,2021-10-25T10:33:48.21,6,False,2.0
2021,7,3157,120,5,8408,2,46,3,2,3,1,3,0,3,0,False,False,False,0,3,2021-10-25T10:39:28.473,3,False,0.0
2021,7,3157,125,5,3477,3,26,10,3,0,0,0,0,0,0,True,False,False,0,2,2021-10-28T13:35:23.157,0,False,0.0
2021,7,3157,135,21,4422,2,32,5,3,18,15,15,3,15,0,False,False,False,0,4,2021-10-25T10:44:34.497,18,False,3.0
2021,7,3157,155,21,813,2,32,5,0,7,7,1,6,1,0,False,False,False,1,4,2021-10-25T10:51:42.767,7,False,6.0
2021,7,3157,160,21,813,2,32,5,-1,1,2,-1,2,-1,0,False,False,False,0,4,2021-10-25T11:00:05.803,1,False,2.0
2021,7,3157,170,21,4422,13,33,5,1,0,0,0,0,0,0,False,False,False,0,4,2021-10-25T11:00:27.197,0,False,0.0
2021,7,3157,195,5,8409,3,4,4,2,0,0,0,0,0,0,False,False,False,0,1,2021-10-25T11:06:19.63,0,False,0.0
2021,7,3157,215,21,6365,2,2,4,5,27,22,23,4,23,0,False,False,False,0,3,2021-10-26T19:37:57.55,27,False,4.0
2021,7,3157,230,21,6981,3,2,9,8,0,0,0,0,0,0,False,False,False,0,2,2021-10-25T11:22:45.103,0,False,0.0
2021,7,3157,235,21,7090,13,19,2,26,0,0,0,0,0,0,False,False,False,0,2,2021-10-28T14:18:25.867,0,False,0.0
2021,7,3157,255,5,3477,2,51,3,0,5,5,3,2,3,0,False,False,False,0,3,2021-10-25T11:30:42.55,5,False,2.0
2021,7,3157,260,5,3477,13,39,4,6,0,0,0,0,0,0,False,False,False,0,3,2021-10-25T11:32:30.39,0,False,0.0
2021,7,3157,270,21,7090,2,8,8,15,15,0,15,0,15,0,False,False,False,0,3,2021-10-28T13:43:30.793,15,True,0.0
2021,7,3157,280,21,7090,2,3,5,10,10,0,10,0,10,0,False,False,False,0,3,2021-10-25T11:39:33.02,10,False,
2021,7,3157,285,21,7592,2,4,5,7,7,0,7,0,7,0,False,False,False,0,2,2021-10-28T14:27:58.53,7,False,0.0
2021,7,3157,305,5,6562,2,30,5,-3,5,8,1,4,1,0,False,False,False,1,3,2022-02-16T16:44:47.597,5,False,4.0
2021,7,3157,315,5,5220,2,35,3,10,12,2,12,0,12,0,False,False,False,0,3,2021-10-25T12:00:31.083,12,False,0.0
2021,7,3157,320,5,5220,2,2,9,10,21,11,12,9,12,0,False,False,False,1,3,2021-10-25T12:04:21.527,21,False,9.0
2021,7,3157,330,5,6562,2,51,3,-2,5,7,3,2,3,0,False,False,False,0,3,2021-10-25T12:07:31.847,5,False,2.0
2021,7,3157,335,5,8409,2,47,10,1,12,11,9,3,9,0,False,False,False,0,1,2021-10-28T13:43:42.62,12,False,3.0
2021,7,3157,350,5,6425,13,35,2,20,0,0,0,0,0,0,False,False,False,0,4,2021-10-28T14:21:26.453,0,False,0.0
2021,7,3157,360,21,7090,2,2,9,8,16,8,12,4,12,0,False,False,False,0,2,2021-10-25T16:07:51.407,16,False,4.0
2021,7,3157,365,21,4422,13,39,4,5,0,0,0,0,0,0,False,False,False,0,3,2021-10-28T13:35:45.06,0,False,
2021,7,3157,370,21,4674,2,2,10,14,15,1,13,2,13,0,False,False,False,1,3,2021-10-28T13:17:10.847,15,False,2.0
2021,7,3157,380,21,3957,2,47,10,-1,1,2,1,0,1,0,False,False,False,0,1,2021-10-25T12:28:27.927,1,False,0.0
2021,7,3157,390,21,4422,2,53,9,-7,6,13,4,2,4,0,False,False,False,0,4,2021-10-28T14:30:20.32,6,False,2.0
2021,7,3157,415,5,6562,2,39,4,5,7,2,6,1,6,0,False,False,False,0,4,2021-10-28T11:52:31.723,7,False,1.0
2021,7,3157,420,5,6562,13,12,2,26,0,0,0,0,0,0,False,False,False,0,3,2021-10-28T12:17:01.073,0,False,0.0
2021,7,3157,445,21,7090,13,6,10,14,0,0,0,0,0,0,False,False,False,0,2,2021-10-28T13:43:54.22,0,False,0.0
2021,7,3157,470,5,5220,2,2,9,7,13,6,8,5,8,0,False,False,False,0,3,2021-10-25T13:18:17.677,13,False,5.0
2021,7,3157,475,5,8409,2,47,5,2,7,5,5,2,5,0,False,False,False,0,1,2021-10-25T13:22:11.42,7,False,2.0
2021,7,3157,500,21,3957,3,5,3,4,0,0,0,0,0,0,False,False,False,0,3,2021-10-25T13:32:58.137,0,False,0.0
2021,7,3157,505,21,4422,2,32,5,0,8,8,5,3,5,0,False,False,False,2,3,2021-10-28T13:18:02.813,8,False,3.0
2021,7,3157,515,5,3477,2,5,3,5,5,0,5,0,5,0,False,False,False,0,3,2021-10-25T13:39:15.047,5,False,0.0
2021,7,3157,525,5,4419,13,31,9,4,0,0,0,0,0,0,False,False,False,0,4,2021-10-25T13:43:11.113,0,False,0.0
2021,7,3157,535,21,7090,2,12,2,15,15,0,15,0,15,0,False,False,False,0,2,2022-02-24T13:58:33.493,15,True,0.0
2021,7,3157,540,21,6365,2,50,9,-4,-4,0,-4,0,-4,0,False,False,False,0,2,2021-10-25T13:49:56.287,-4,False,0.0
2021,7,3157,545,21,6365,2,47,5,3,2,-1,2,0,2,0,False,False,False,0,3,2022-02-23T18:51:26.437,2,False,0.0
2021,7,3157,550,21,3957,2,12,5,3,14,11,14,0,14,0,False,False,False,0,1,2022-02-24T13:58:55.803,14,False,0.0
2021,7,3157,555,21,7026,2,9,5,11,16,5,16,0,16,0,False,False,False,0,6,2022-02-16T16:49:12.163,16,False,0.0
2021,7,3157,560,21,7090,2,18,5,0,2,2,2,0,2,0,False,False,False,0,2,2021-10-25T14:00:09.213,2,False,0.0
2021,7,3157,585,21,6365,2,5,10,2,5,3,3,2,3,6,False,False,False,0,3,2021-10-25T14:09:10.593,5,False,2.0
2021,7,3157,600,5,5220,13,35,8,20,0,0,0,0,0,0,False,False,False,0,3,2021-10-28T14:23:27.67,0,False,0.0
2021,7,3157,605,5,5220,2,34,4,-3,1,4,0,1,0,0,True,False,False,0,3,2021-10-25T14:16:01.79,1,False,1.0
2021,7,3157,625,21,4422,2,32,9,2,8,6,6,2,6,0,False,False,False,0,4,2022-02-16T16:49:58.19,8,False,2.0
2021,7,3157,635,21,7090,13,3,5,10,0,0,0,0,0,0,False,False,False,0,3,2021-10-25T14:27:54.263,0,False,0.0
2021,7,3157,640,21,7090,13,8,7,27,0,0,0,0,0,0,False,False,False,0,2,2021-10-25T14:31:21.113,0,False,0.0
2021,7,3157,650,21,6365,2,5,5,6,9,3,9,0,9,0,True,False,False,0,3,2021-10-28T14:32:00.847,9,True,0.0
2021,7,3157,665,5,6282,13,51,10,-5,0,0,0,0,0,0,False,False,False,0,1,2021-10-25T15:57:16.333,0,False,0.0
2021,7,3157,670,5,5220,2,12,2,21,21,0,21,0,21,0,False,False,False,0,2,2021-10-28T13:36:05.463,21,False,
2021,7,3157,675,5,3477,13,5,2,17,0,0,0,0,0,0,False,False,False,0,2,2021-10-28T12:15:47.543,0,False,0.0
2021,7,3157,690,21,7592,2,32,10,-1,0,1,0,0,0,0,False,False,False,0,3,2021-10-25T14:49:14.943,0,False,
2021,7,3157,710,21,4422,13,5,5,2,0,0,0,0,0,0,False,False,False,0,4,2022-02-16T16:50:34.893,0,False,0.0
2021,7,3157,720,21,4674,2,5,3,5,12,7,8,4,8,0,True,False,False,0,2,2021-10-28T13:37:27.313,12,False,4.0
2021,7,3157,730,21,7592,13,5,3,5,0,0,0,0,0,0,False,False,False,0,3,2021-10-28T13:36:17.787,0,False,0.0
2021,7,3157,750,5,5220,13,5,2,18,0,0,0,0,0,0,False,False,False,0,2,2021-10-28T14:32:41.837,0,False,0.0
2021,7,3157,755,5,5220,13,3,3,11,0,0,0,0,0,0,False,False,False,0,2,2021-10-28T13:36:27.913,0,False,0.0
2021,7,3157,765,5,3477,13,12,7,22,0,0,0,0,0,0,False,False,False,0,3,2022-02-24T13:59:28.49,0,False,0.0
2021,7,3157,785,5,8409,2,51,9,-4,7,11,3,4,3,0,False,False,False,0,1,2021-10-25T15:59:18.823,7,False,4.0
2021,7,3157,790,5,5220,2,2,10,7,7,0,7,0,7,0,False,False,False,0,2,2021-10-25T15:59:26.53,7,False,0.0
2021,7,3157,795,5,3477,13,6,7,21,0,0,0,0,0,0,False,False,False,0,2,2021-10-28T14:26:00.85,0,False,0.0
2021,7,3157,800,5,3477,13,13,10,4,0,0,0,0,0,0,False,False,False,0,3,2021-10-25T15:59:40.693,0,False,0.0
2021,7,3157,805,5,8413,13,5,6,20,0,0,0,0,0,0,False,False,False,0,3,2021-10-28T12:15:47.543,0,False,0.0
2021,7,3157,815,5,5220,2,4,2,17,19,2,19,0,19,0,False,False,False,0,2,2021-10-25T15:35:51.85,19,True,0.0
2021,7,3157,820,5,6562,13,9,6,20,0,0,0,0,0,0,False,False,False,0,3,2021-10-25T15:37:37.543,0,False,0.0
2021,7,3157,825,5,8413,13,39,4,7,0,0,0,0,0,0,False,False,False,0,3,2021-10-25T15:39:18.72,0,False,0.0
2021,7,3157,830,5,6425,13,4,4,13,0,0,0,0,0,0,False,False,False,0,3,2021-10-28T13:36:40.187,0,False,0.0
2021,7,3158,15,19,5096,2,46,3,1,1,0,1,0,1,0,False,False,False,0,4,2021-10-28T12:56:01.587,1,False,
2021,7,3158,25,19,5096,2,53,9,-4,28,32,-1,29,-1,0,False,False,False,1,4,2021-10-25T09:12:27.093,28,False,29.0
2021,7,3158,30,19,2256,2,21,2,22,25,3,25,0,25,6,False,False,False,0,2,2021-10-25T09:27:14.05,25,True,0.0
2021,7,3158,70,19,5096,13,7,2,22,0,0,0,0,0,0,True,False,False,0,4,2021-10-25T19:18:59.687,0,False,0.0
2021,7,3158,80,19,7172,2,48,9,-4,3,7,2,1,2,0,False,False,False,0,1,2021-10-25T10:04:14.617,3,False,1.0
2021,7,3158,110,22,5080,13,12,5,7,0,0,0,0,0,0,False,False,False,0,2,2022-02-23T18:47:28.513,0,False,0.0
2021,7,3158,115,22,3170,13,12,5,5,0,0,0,0,0,0,False,False,False,0,3,2021-11-09T18:23:02.19,0,False,0.0
2021,7,3158,120,22,6812,2,12,10,4,12,8,4,8,4,0,False,False,False,1,1,2021-10-25T18:12:35.623,12,False,8.0
2021,7,3158,130,22,8454,2,18,9,-1,13,14,-1,14,-1,0,False,False,False,1,2,2021-10-25T10:47:07.707,13,False,14.0
2021,7,3158,145,22,6812,2,5,3,5,7,2,7,0,7,0,True,False,False,0,2,2021-12-09T20:22:15.46,7,False,0.0
2021,7,3158,155,22,3170,2,51,9,-2,-2,0,-2,0,-2,0,False,False,False,0,2,2021-10-25T18:19:50.433,-2,False,0.0
2021,7,3158,160,22,8454,13,5,3,5,0,0,0,0,0,0,False,False,False,0,3,2021-10-25T18:00:14.927,0,False,0.0
2021,7,3158,170,19,5096,13,4,10,7,0,0,0,0,0,0,False,False,False,0,4,2021-10-25T11:15:21.037,0,False,0.0
2021,7,3158,175,19,5096,2,5,5,8,24,16,24,0,24,0,False,False,False,0,1,2021-10-26T18:35:12.24,24,False,0.0
2021,7,3158,185,19,8001,2,48,9,-2,5,7,-1,6,-1,0,False,False,False,0,1,2021-10-28T12:54:21.95,5,False,6.0
2021,7,3158,200,19,5096,13,35,9,14,0,0,0,0,0,0,False,False,False,0,4,2022-02-16T16:34:55.207,0,False,0.0
2021,7,3158,205,19,4912,2,13,9,0,4,4,2,2,2,0,False,False,False,0,3,2021-10-25T11:35:55.993,4,False,2.0
2021,7,3158,210,19,4282,13,5,10,6,0,0,0,0,0,0,False,False,False,0,3,2021-10-28T13:06:23.1,0,False,0.0
2021,7,3158,225,22,4997,2,4,5,5,6,1,6,0,6,0,False,False,False,0,2,2021-10-28T12:54:33.437,6,False,0.0
2021,7,3158,235,22,2391,2,12,6,15,15,0,15,0,15,0,False,False,False,0,3,2021-10-28T13:54:11.173,15,False,0.0
2021,7,3158,240,22,4997,13,19,7,48,0,0,0,0,0,0,False,False,False,0,3,2021-10-26T18:47:09.987,0,False,
2021,7,3158,260,22,5080,2,7,3,3,3,0,3,0,3,6,False,False,False,0,3,2021-10-28T13:53:18.87,3,True,0.0
2021,7,3158,275,19,7175,13,9,6,21,0,0,0,0,0,0,False,False,False,0,3,2021-10-28T12:56:29.417,0,False,0.0
2021,7,3158,280,19,2256,13,19,6,26,0,0,0,0,0,0,False,False,False,0,2,2021-10-28T12:56:46.11,0,False,0.0
2021,7,3158,285,19,7175,2,6,9,14,19,5,16,3,16,0,False,False,False,0,3,2021-10-28T12:56:58.753,19,False,3.0
2021,7,3158,295,19,7456,2,32,3,2,3,1,3,0,3,0,False,False,False,0,4,2021-10-25T12:51:00.467,3,False,0.0
2021,7,3158,305,19,2256,13,19,6,31,0,0,0,0,0,0,False,False,False,0,2,2021-10-28T12:57:23.93,0,False,0.0
2021,7,3158,325,19,2256,13,29,2,13,0,0,0,0,0,0,False,False,False,0,2,2022-02-23T18:47:13.433,0,False,0.0
2021,7,3158,330,19,1212,2,48,9,-4,15,19,8,7,8,6,False,False,False,1,1,2022-02-16T16:35:31.423,15,False,7.0
2021,7,3158,355,22,8451,2,32,10,-2,7,9,4,3,4,0,False,False,False,0,1,2021-10-25T19:16:23.763,7,False,3.0
2021,7,3158,360,22,5080,2,5,2,22,22,0,22,0,22,0,False,False,False,0,3,2021-10-28T13:57:50.503,22,True,0.0
2021,7,3158,370,22,5080,2,4,10,5,5,0,5,0,5,0,False,False,False,0,3,2021-10-25T18:01:01.2,5,False,0.0
2021,7,3158,390,19,1212,2,5,10,0,28,28,24,4,24,0,False,False,False,0,1,2021-10-28T12:57:37.943,28,False,4.0
2021,7,3158,395,19,1212,13,45,5,-5,0,0,0,0,0,0,False,False,False,0,1,2021-10-28T11:15:55.177,0,False,0.0
2021,7,3158,400,19,4912,2,5,5,8,9,1,9,0,9,0,False,False,False,0,3,2021-10-28T13:06:45.43,9,False,0.0
2021,7,3158,405,19,7175,13,12,5,11,0,0,0,0,0,0,False,False,False,0,3,2021-10-28T12:55:12.283,0,False,0.0
2021,7,3158,410,19,7175,2,47,5,1,3,2,3,0,3,0,False,False,False,0,3,2021-10-25T19:11:22.843,3,True,0.0
2021,7,3158,415,19,7175,2,5,3,5,11,6,7,4,7,0,False,False,False,0,3,2021-10-25T14:04:13.937,11,False,4.0
2021,7,3158,425,19,1212,2,34,4,-4,4,8,3,1,3,0,True,False,False,0,2,2021-10-28T12:57:50.717,4,False,1.0
2021,7,3158,430,19,1212,2,45,10,3,8,5,5,3,5,0,False,False,False,0,1,2021-10-25T14:08:19.243,8,False,3.0
2021,7,3158,445,19,1212,2,46,3,3,4,1,3,1,3,0,False,False,False,0,1,2021-10-25T19:17:20.4,4,False,1.0
2021,7,3158,450,19,7175,13,6,4,5,0,0,0,0,0,0,True,False,False,0,2,2021-10-25T14:14:45.973,0,False,
2021,7,3158,455,19,4282,2,36,10,1,1,0,1,0,1,6,True,False,False,0,4,2021-10-28T12:53:50.353,1,True,0.0
2021,7,3158,470,22,6812,3,4,4,4,0,0,0,0,0,0,False,False,False,0,1,2021-10-25T17:45:10.017,0,False,0.0
2021,7,3158,490,22,8454,13,5,5,10,0,0,0,0,0,0,False,False,False,0,3,2021-10-28T13:51:41.65,0,False,0.0
2021,7,3158,500,22,5080,2,8,10,13,17,4,15,2,15,0,False,False,False,0,3,2021-10-28T13:53:35.197,17,False,2.0
2021,7,3158,505,22,6812,2,4,10,5,21,16,14,7,14,0,False,False,False,0,1,2021-10-28T13:51:53.777,21,False,7.0
2021,7,3158,510,22,3170,2,32,5,3,8,5,8,0,8,0,False,False,False,0,3,2021-10-28T13:52:03.677,8,False,0.0
2021,7,3158,520,22,4997,13,9,6,23,0,0,0,0,0,0,False,False,False,0,2,2021-10-28T13:58:13.31,0,False,
2021,7,3158,540,19,4912,2,30,5,-4,9,13,9,0,9,0,True,False,False,0,1,2022-02-16T16:38:19.02,9,False,0.0
2021,7,3158,550,19,1212,2,45,5,0,20,20,8,12,8,0,False,False,False,1,1,2021-10-25T15:02:28.37,20,False,12.0
2021,7,3158,555,19,7172,2,4,10,3,4,1,4,0,4,0,False,False,False,0,1,2021-10-25T15:04:50.263,4,False,0.0
2021,7,3158,595,22,8451,2,28,9,-1,7,8,5,2,5,0,False,False,False,0,1,2022-02-24T18:53:04.75,7,False,2.0
2021,7,3158,600,22,5080,13,5,5,14,0,0,0,0,0,0,False,False,False,0,2,2021-10-27T00:10:44.003,0,False,0.0
2021,7,3158,605,22,3170,2,11,2,16,21,5,18,3,18,0,False,False,False,0,3,2021-10-27T00:08:12.457,21,False,3.0
2021,7,3158,610,22,8451,2,4,4,4,8,4,5,3,5,0,False,False,False,0,1,2021-10-25T19:11:58.457,8,False,3.0
2021,7,3158,620,22,2391,13,35,1,24,0,0,0,0,0,0,False,False,False,0,4,2021-10-28T12:52:49.103,0,False,0.0
2021,7,3158,625,19,2256,2,2,9,14,26,12,16,10,16,0,False,False,False,1,2,2021-10-28T12:52:01.023,26,False,10.0
2021,7,3158,640,19,4282,13,24,2,21,0,0,0,0,0,0,False,False,False,0,3,2021-10-28T13:07:43.15,0,False,0.0
2021,7,3158,650,22,8451,2,4,3,6,8,2,6,2,6,0,True,False,False,0,2,2021-10-27T00:08:33.483,8,False,2.0
2021,7,3158,655,22,5080,13,19,2,24,0,0,0,0,0,0,False,False,False,0,2,2021-10-25T17:48:05.353,0,False,
2021,7,3158,660,22,7610,13,12,6,27,0,0,0,0,0,0,False,False,False,0,3,2021-10-28T13:54:23.047,0,False,0.0
2021,7,3158,665,22,8454,13,3,5,12,0,0,0,0,0,0,False,False,False,0,2,2021-10-28T13:52:16.487,0,False,0.0
2021,7,3158,685,19,7175,2,46,3,2,3,1,2,1,2,0,False,False,False,0,3,2021-10-25T16:12:14.237,3,False,1.0
2021,7,3158,690,19,4282,2,35,3,14,22,8,19,3,19,0,False,False,False,0,4,2021-10-25T16:14:50.42,22,False,3.0
2021,7,3158,710,22,8451,2,46,3,1,12,11,12,0,12,0,False,False,False,0,1,2021-10-25T17:48:45.437,12,True,0.0
2021,7,3158,715,22,3170,13,5,5,2,0,0,0,0,0,0,False,False,False,0,3,2021-10-25T17:49:01.713,0,False,0.0
2021,7,3158,720,22,8454,13,19,6,31,0,0,0,0,0,0,False,False,False,0,2,2021-10-25T16:24:38.3,0,False,0.0
2021,7,3158,725,22,6812,2,12,3,-3,15,18,5,10,5,0,False,False,False,1,1,2021-10-28T13:54:35.087,15,False,10.0
2021,7,3158,730,22,4997,13,5,3,5,0,0,0,0,0,0,False,False,False,0,3,2021-10-25T17:49:35.257,0,False,0.0
2021,7,3158,735,22,6812,2,47,5,1,6,5,6,0,6,0,False,False,False,0,4,2021-10-25T18:38:00.537,6,False,0.0
2021,7,3158,740,22,8454,13,5,3,7,0,0,0,0,0,0,False,False,False,0,3,2021-10-25T17:49:52.593,0,False,0.0
2021,7,3158,745,22,7121,13,13,10,3,0,0,0,0,0,0,True,False,False,0,4,2021-10-25T17:50:10.823,0,False,0.0
2021,7,3158,755,19,7175,2,3,5,8,8,0,8,0,8,0,False,False,False,0,3,2021-10-25T16:41:02.41,8,True,0.0
2021,7,3158,760,19,4912,2,19,6,38,46,8,42,4,42,0,False,False,False,0,2,2021-10-26T18:46:04.22,46,False,4.0
2021,7,3158,780,22,3170,2,39,4,5,7,2,6,1,6,0,False,False,False,0,3,2021-10-25T18:20:45.32,7,False,1.0
2021,7,3158,790,22,8451,2,5,3,1,3,2,1,2,1,0,False,False,False,0,1,2021-10-28T13:10:47.053,3,False,2.0
2021,7,3158,795,22,8451,13,46,3,2,0,0,0,0,0,0,False,False,False,0,1,2021-10-28T13:52:27.983,0,False,0.0
2021,7,3158,800,22,6812,2,44,3,-6,4,10,1,3,1,0,False,False,False,0,1,2022-02-24T18:53:16.733,4,False,3.0
2021,7,3158,810,19,7173,13,2,9,6,0,0,0,0,0,0,False,False,False,0,2,2021-10-25T17:52:25.277,0,False,0.0
2021,7,3158,820,19,7177,2,5,10,13,22,9,13,9,13,0,False,False,False,1,3,2021-10-26T18:36:42.11,22,False,9.0
2021,7,3158,835,19,7456,2,47,5,2,29,27,11,18,11,0,False,False,False,1,1,2021-10-28T12:58:52.05,29,False,18.0
2021,7,3158,845,19,7173,2,21,6,26,28,2,26,2,26,0,False,False,False,0,2,2021-10-28T11:15:55.193,28,False,2.0
2021,7,3158,870,22,7610,2,2,10,5,6,1,6,0,6,0,False,False,False,0,2,2021-10-28T12:52:36.017,6,False,0.0
2021,7,3158,875,22,8451,2,28,9,3,6,3,5,1,5,0,False,False,False,0,1,2021-10-25T17:53:56,6,False,1.0
2021,7,3158,880,22,8451,2,48,9,-3,16,19,6,10,6,0,False,True,True,2,1,2021-10-25T18:05:09.943,16,False,10.0
2021,7,3159,10,31,6793,2,2,4,8,10,2,9,1,9,0,False,False,False,0,2,2021-10-25T09:12:52.99,10,False,1.0
2021,7,3159,20,31,661,2,35,10,12,18,6,15,3,15,0,False,False,False,0,3,2021-10-25T09:17:27.69,18,False,3.0
2021,7,3159,30,31,4070,13,5,6,17,0,0,0,0,0,0,False,False,False,0,2,2021-10-25T09:21:07.653,0,False,
2021,7,3159,35,31,3504,2,45,10,-6,3,9,1,2,1,0,False,False,False,0,1,2021-10-25T09:24:43.133,3,False,2.0
2021,7,3159,55,31,2901,2,7,10,5,5,0,5,0,5,6,False,False,False,0,4,2022-02-16T17:12:28.117,5,True,0.0
2021,7,3159,75,16,6500,2,47,5,1,7,6,4,3,4,0,False,False,False,0,3,2021-10-25T09:39:22.603,7,False,3.0
2021,7,3159,80,16,7176,2,4,3,6,8,2,8,0,8,0,False,False,False,0,2,2021-10-28T15:28:05.923,8,False,0.0
2021,7,3159,95,16,374,2,4,10,4,6,2,6,0,6,0,False,False,False,0,3,2021-10-25T09:44:48.233,6,False,0.0
2021,7,3159,125,31,661,2,13,9,3,19,16,1,18,1,0,False,False,False,1,2,2021-10-25T10:00:30.517,19,False,
2021,7,3159,130,31,4545,2,48,4,-2,10,12,6,4,6,0,False,False,False,0,1,2021-10-25T10:03:42.04,10,False,4.0
2021,7,3159,135,31,6793,2,19,6,39,46,7,43,3,43,0,False,False,False,0,2,2021-10-25T10:08:09.75,46,False,3.0
2021,7,3159,155,31,6793,2,34,4,-4,3,7,2,1,2,0,True,False,False,0,3,2021-10-25T10:14:57.29,3,False,1.0
2021,7,3159,160,31,6793,2,29,6,24,24,0,24,0,24,6,False,False,False,0,2,2021-10-25T10:16:48.987,24,True,0.0
2021,7,3159,195,16,7176,13,12,4,5,0,0,0,0,0,0,False,False,False,0,3,2021-10-25T10:31:49.077,0,False,0.0
2021,7,3159,215,31,2865,2,4,9,4,8,4,7,1,7,0,False,False,False,0,3,2021-10-25T10:37:31.233,8,False,1.0
2021,7,3159,235,31,3504,2,48,9,-3,13,16,10,3,10,0,False,False,False,1,1,2021-10-25T10:44:56.617,13,False,3.0
2021,7,3159,245,31,2901,2,17,1,20,22,2,22,0,22,0,False,False,False,0,4,2021-10-25T10:51:04.213,22,False,0.0
2021,7,3159,250,31,4875,2,51,3,-2,10,12,7,3,7,0,False,False,False,0,3,2021-10-25T10:50:49.207,10,False,3.0
2021,7,3159,255,31,661,13,2,10,7,0,0,0,0,0,0,False,False,False,0,2,2021-10-25T10:52:13.847,0,False,0.0
2021,7,3159,265,31,661,13,9,6,16,0,0,0,0,0,0,False,False,False,0,2,2021-10-25T10:55:12.397,0,False,0.0
2021,7,3159,280,16,1989,13,12,6,21,0,0,0,0,0,0,False,False,False,0,3,2021-10-25T11:04:33.457,0,False,0.0
2021,7,3159,290,31,4875,2,46,3,2,2,0,2,0,2,0,False,False,False,0,3,2021-10-25T11:09:07.853,2,False,0.0
2021,7,3159,295,31,6793,13,7,8,17,0,0,0,0,0,0,False,False,False,0,2,2021-12-02T17:48:19.04,0,False,
2021,7,3159,310,31,661,2,4,10,5,20,15,7,13,7,0,False,False,False,2,3,2021-10-25T11:19:00.203,20,False,13.0
2021,7,3159,315,31,6793,2,13,10,4,6,2,6,0,6,0,True,False,False,0,3,2021-10-25T11:20:37.773,6,False,0.0
2021,7,3159,340,16,797,2,48,10,-4,6,10,4,2,4,0,False,False,False,0,1,2021-10-25T11:26:37.85,6,False,2.0
2021,7,3159,345,16,3938,2,4,9,3,9,6,9,0,9,0,False,False,False,0,3,2021-10-25T11:27:51,9,False,
2021,7,3159,350,16,374,2,13,9,4,5,1,5,0,5,0,False,False,False,0,3,2021-10-25T11:34:53.827,5,False,0.0
2021,7,3159,360,16,4143,13,26,10,3,0,0,0,0,0,0,False,False,False,0,3,2021-10-25T11:42:38.27,0,False,0.0
2021,7,3159,375,31,6793,2,5,5,12,12,0,12,0,12,0,False,False,False,0,3,2021-10-25T11:49:01.627,12,False,0.0
2021,7,3159,385,31,6724,2,4,9,8,9,1,8,1,8,0,False,False,False,0,3,2021-10-25T11:52:24.977,9,False,1.0
2021,7,3159,390,31,6793,13,29,2,21,0,0,0,0,0,0,False,False,False,0,2,2021-10-28T15:27:53.213,0,False,0.0
2021,7,3159,440,16,374,2,4,10,5,10,5,9,1,9,0,False,False,False,0,3,2021-10-25T12:14:34.417,10,False,1.0
2021,7,3159,455,16,7176,2,51,10,-2,9,11,7,2,7,0,False,False,False,0,3,2021-10-25T12:18:52.657,3,False,2.0
2021,7,3159,460,16,6500,2,12,7,23,23,0,23,0,23,0,False,False,False,0,3,2021-10-25T12:21:48.977,23,False,0.0
2021,7,3159,465,16,3938,2,4,9,8,8,0,8,0,8,0,False,False,False,0,2,2021-10-25T12:26:45.743,8,False,0.0
2021,7,3159,480,16,374,13,5,9,12,0,0,0,0,0,0,False,False,False,0,3,2021-10-28T15:26:50.95,0,False,0.0
2021,7,3159,500,31,4875,2,2,10,5,11,6,8,3,8,0,False,False,False,0,3,2021-10-25T12:43:42.307,11,False,3.0
2021,7,3159,520,31,7603,2,48,10,-4,6,10,3,3,3,0,False,False,False,0,1,2021-10-25T12:55:00.967,6,False,3.0
2021,7,3159,525,31,7603,2,46,9,0,5,5,4,1,4,0,False,False,False,0,1,2021-10-25T12:56:54.993,5,False,1.0
2021,7,3159,530,31,6793,2,4,10,4,8,4,6,2,6,0,True,False,False,0,2,2021-10-25T13:00:34.977,8,False,2.0
2021,7,3159,540,31,6793,2,35,9,10,24,14,20,4,20,0,False,False,False,0,2,2021-10-25T13:04:24.543,24,False,4.0
2021,7,3159,550,31,4070,13,6,10,9,0,0,0,0,0,0,False,False,False,0,3,2021-10-25T13:08:00.573,0,False,0.0
2021,7,3159,555,31,2901,13,38,9,0,0,0,0,0,0,0,False,False,False,0,4,2021-10-28T15:27:02.543,0,False,0.0
2021,7,3159,560,16,374,2,53,10,-2,11,13,9,2,9,0,False,False,False,0,4,2021-10-25T13:12:24.72,11,False,2.0
2021,7,3159,565,16,7176,2,4,5,3,3,0,3,0,3,0,False,False,False,0,2,2021-10-25T13:13:51.713,3,False,
2021,7,3159,570,16,3938,3,4,5,3,0,0,0,0,0,0,False,False,False,0,2,2021-10-25T13:15:49.18,0,False,0.0
2021,7,3159,575,16,374,2,5,5,11,24,13,10,14,10,0,False,False,False,2,3,2021-10-25T13:17:37.027,24,False,14.0
2021,7,3159,580,16,6500,2,4,10,12,12,0,12,0,12,0,False,False,False,0,2,2021-10-25T13:19:12.453,12,False,0.0
2021,7,3159,595,16,6499,2,48,10,-4,14,18,10,4,10,0,False,False,False,0,1,2021-10-25T13:23:49.72,14,False,4.0
2021,7,3159,600,16,6499,13,12,5,3,0,0,0,0,0,0,False,False,False,0,1,2021-10-28T15:27:14.007,0,False,0.0
2021,7,3159,645,16,3938,13,4,10,5,0,0,0,0,0,0,False,False,False,0,3,2021-10-25T13:42:24.77,0,False,0.0
2021,7,3159,650,16,6500,2,4,4,4,6,2,5,1,5,0,False,False,False,0,3,2021-10-25T13:43:34.21,6,False,1.0
2021,7,3159,655,16,3938,2,4,5,4,4,0,4,0,4,0,True,False,False,0,2,2021-10-26T18:02:43.147,4,False,0.0
2021,7,3159,660,16,7176,2,4,9,3,9,6,8,1,8,0,False,False,False,0,3,2021-10-25T13:46:12.89,9,False,1.0
2021,7,3159,665,16,6499,2,46,3,-1,10,11,8,2,8,0,False,False,False,0,1,2021-10-25T13:47:23.907,10,False,2.0
2021,7,3159,670,16,3938,2,18,5,0,4,4,1,3,1,0,False,False,False,1,2,2021-10-25T13:48:32.29,4,False,3.0
2021,7,3159,675,16,6500,13,19,2,54,0,0,0,0,0,0,False,False,False,0,2,2021-10-25T13:49:53.21,0,False,0.0
2021,7,3159,685,16,374,13,29,2,17,0,0,0,0,0,0,False,False,False,0,4,2022-02-16T17:21:06.373,0,False,0.0
2021,7,3159,695,16,797,13,44,3,0,0,0,0,0,0,0,True,False,False,0,1,2021-10-25T13:57:33.613,0,False,0.0
2021,7,3159,700,16,374,2,4,10,4,2,-2,2,0,2,0,False,False,False,0,3,2021-10-25T13:59:06.503,2,False,0.0
2021,7,3159,705,16,797,13,32,5,0,0,0,0,0,0,0,False,False,False,0,1,2021-10-25T14:00:29.567,0,False,0.0
2021,7,3159,710,16,6500,2,8,1,23,25,2,24,1,24,0,False,False,False,0,3,2021-10-25T14:03:29.017,25,False,1.0
2021,7,3159,720,16,4143,3,13,9,4,0,0,0,0,0,0,False,False,False,0,2,2021-10-25T14:05:47.263,0,False,0.0
2021,7,3159,730,16,374,13,5,5,14,0,0,0,0,0,0,False,False,False,0,3,2021-10-25T14:07:54.863,0,False,0.0
2021,7,3159,775,16,6499,2,46,3,1,6,5,6,0,6,0,False,False,False,0,1,2021-10-25T14:22:18.353,6,False,0.0
2021,7,3159,780,16,374,2,4,10,4,7,3,6,1,6,0,False,False,False,0,3,2021-10-25T14:23:08.547,7,False,1.0
2021,7,3159,785,16,3938,3,5,5,11,0,0,0,0,0,0,False,False,False,0,2,2021-10-25T14:24:26.377,0,False,0.0
2021,7,3159,790,16,8537,2,4,10,3,4,1,4,0,4,0,False,False,False,0,3,2021-10-25T14:25:44.97,4,False,0.0
2021,7,3159,795,16,374,13,5,8,15,0,0,0,0,0,0,False,False,False,0,3,2021-10-25T14:27:17.217,0,False,0.0
2021,7,3159,800,16,3938,2,35,8,15,17,2,15,2,15,0,False,False,False,0,3,2021-10-25T14:29:27.823,17,False,2.0
2021,7,3159,805,16,4143,13,5,3,10,0,0,0,0,0,0,False,False,False,0,2,2021-10-25T14:30:33.423,0,False,0.0
2021,7,3159,810,16,5039,2,4,9,5,8,3,8,0,8,0,False,False,False,0,3,2021-10-25T14:32:29.21,8,False,0.0
2021,7,3159,815,16,797,2,46,3,1,2,1,2,0,2,0,False,False,False,0,1,2021-10-28T15:27:37.56,2,False,0.0
2021,7,3159,825,16,3938,2,4,4,12,9,-3,6,3,6,0,False,False,False,1,3,2021-10-25T14:35:30.13,9,False,3.0
2021,7,3159,830,16,374,13,6,10,11,0,0,0,0,0,0,False,False,False,0,3,2021-10-25T14:36:47.153,0,False,0.0
2021,7,3159,835,16,7417,2,45,10,-2,7,9,4,3,4,0,False,False,False,0,1,2021-10-28T15:29:29.09,7,False,3.0
2021,7,3159,845,16,3938,2,4,4,5,7,2,5,2,5,0,False,False,False,1,3,2021-10-25T14:40:50.297,7,False,2.0
2021,7,3159,855,16,5039,13,8,7,17,0,0,0,0,0,0,False,False,False,0,2,2021-10-26T18:01:17.297,0,False,
2021,7,3159,865,16,4143,2,4,4,6,7,1,7,0,7,0,False,False,False,0,2,2021-10-25T14:46:09.43,7,False,0.0
2021,7,3159,870,16,7176,2,13,10,3,8,5,8,0,8,0,False,True,True,0,3,2021-10-25T14:48:11.663,8,False,0.0
2021,7,3160,10,12,556,2,6,9,13,15,2,14,1,14,0,False,False,False,0,3,2021-10-25T09:13:00.727,15,False,1.0
2021,7,3160,15,12,496,2,4,10,3,3,0,3,0,3,0,True,False,False,0,3,2021-10-25T09:21:15.273,3,False,0.0
2021,7,3160,25,12,4537,2,44,3,-3,4,7,1,3,1,0,True,False,False,0,2,2021-10-25T09:26:30.29,4,False,3.0
2021,7,3160,30,12,6356,13,19,2,27,0,0,0,0,0,0,False,False,False,0,2,2021-10-25T09:29:29.597,0,False,0.0
2021,7,3160,35,12,467,2,46,3,1,12,11,2,10,2,0,False,False,False,1,4,2021-10-28T20:22:04.757,12,False,10.0
2021,7,3160,55,12,4537,2,51,10,-5,5,10,3,2,3,0,True,False,False,0,1,2021-10-25T09:41:19.24,5,False,2.0
2021,7,3160,65,12,4537,2,46,9,-1,0,1,-1,1,-1,0,False,False,False,0,1,2021-10-25T09:46:25.983,0,False,1.0
2021,7,3160,70,12,556,2,12,10,7,17,10,17,0,17,6,False,False,False,0,3,2021-10-25T15:26:43.653,17,True,0.0
2021,7,3160,90,32,7128,2,5,5,6,6,0,6,0,6,0,False,False,False,0,3,2021-10-25T09:57:09.077,6,False,0.0
2021,7,3160,115,32,7128,2,5,5,12,12,0,12,0,12,0,False,False,False,0,3,2021-10-25T10:09:04.043,12,False,0.0
2021,7,3160,120,32,7128,2,19,7,40,40,0,40,0,40,6,False,False,False,0,3,2021-10-28T20:24:10.77,40,True,0.0
2021,7,3160,140,12,4511,13,53,10,-3,0,0,0,0,0,0,False,False,False,0,3,2021-10-25T10:19:14.703,0,False,0.0
2021,7,3160,160,32,7807,2,48,10,-6,0,6,-5,5,-5,0,False,False,False,0,1,2021-10-25T10:26:45.41,0,False,5.0
2021,7,3160,170,32,7128,13,6,1,19,0,0,0,0,0,0,True,False,False,0,3,2021-10-26T02:42:12.133,0,False,
2021,7,3160,180,32,3885,2,28,4,1,5,4,4,1,4,0,False,False,False,0,1,2021-10-25T10:41:33.047,5,False,1.0
2021,7,3160,200,32,7128,13,8,1,19,0,0,0,0,0,0,False,False,False,0,3,2021-10-28T20:44:13.89,0,False,0.0
2021,7,3160,210,12,4511,2,30,3,3,12,9,8,4,8,0,True,False,False,0,4,2021-10-26T20:10:40.15,12,False,4.0
2021,7,3160,215,12,4537,2,45,5,-4,1,5,0,1,0,0,True,False,False,0,1,2021-10-28T20:10:08.057,1,False,1.0
2021,7,3160,220,12,4537,2,47,5,0,10,10,7,3,7,0,False,False,False,0,3,2021-10-28T20:46:25.797,10,False,3.0
2021,7,3160,225,12,556,2,18,5,1,3,2,2,1,2,0,False,False,False,0,2,2021-10-28T19:55:45.057,3,False,1.0
2021,7,3160,230,12,496,2,6,10,13,15,2,13,2,13,0,False,False,False,0,3,2021-10-25T11:03:54.093,15,False,2.0
2021,7,3160,250,12,556,13,12,5,7,0,0,0,0,0,0,False,False,False,0,2,2021-10-25T15:29:36.927,0,False,0.0
2021,7,3160,270,32,7807,2,48,10,-7,5,12,-1,6,-1,0,False,False,False,1,1,2021-10-28T20:07:07.663,5,False,6.0
2021,7,3160,275,32,3885,13,13,10,2,0,0,0,0,0,0,True,False,False,0,3,2021-10-28T20:04:06.25,0,False,0.0
2021,7,3160,280,32,7128,13,3,3,12,0,0,0,0,0,0,False,False,False,0,2,2021-10-25T11:26:58.013,0,False,0.0
2021,7,3160,285,12,6691,2,5,5,9,11,2,11,0,11,0,True,False,False,0,3,2021-10-28T20:28:58.657,11,False,0.0
2021,7,3160,300,12,6691,2,5,9,5,7,2,6,1,6,0,False,False,False,0,3,2021-10-25T11:34:23.207,7,False,1.0
2021,7,3160,305,12,6691,2,12,9,12,13,1,12,1,12,0,False,False,False,0,2,2022-02-24T14:02:17.49,13,False,1.0
2021,7,3160,310,12,4511,2,51,3,-1,6,7,5,1,5,0,False,False,False,0,3,2021-10-28T17:11:42.617,6,False,1.0
2021,7,3160,320,12,6691,2,50,10,-1,19,20,9,10,9,0,False,False,False,0,3,2021-10-28T19:57:44.333,19,False,10.0
2021,7,3160,330,12,556,2,26,3,5,5,0,5,0,5,0,False,False,False,0,2,2021-10-25T11:44:05.64,5,False,0.0
2021,7,3160,335,12,496,13,2,10,5,0,0,0,0,0,0,False,False,False,0,3,2021-10-25T15:34:23.603,0,False,0.0
2021,7,3160,340,12,6691,2,29,10,10,10,0,10,0,10,6,False,False,False,0,3,2021-10-25T11:47:33.947,10,True,0.0
2021,7,3160,385,12,467,2,53,10,-2,2,4,0,2,0,0,False,False,False,0,4,2021-10-25T12:02:00.05,2,False,2.0
2021,7,3160,390,12,4511,2,7,2,20,20,0,20,0,20,6,False,False,False,0,3,2021-10-25T12:03:52.23,20,True,0.0
2021,7,3160,405,32,4788,2,30,10,3,14,11,11,3,11,0,False,False,False,0,4,2022-02-16T15:21:03.47,14,False,3.0
2021,7,3160,415,32,3562,2,5,5,3,4,1,4,0,4,0,False,False,False,0,3,2021-10-25T12:13:44.627,4,False,0.0
2021,7,3160,420,32,2675,2,12,2,16,17,1,17,0,17,0,False,False,False,0,3,2022-02-24T14:02:46.353,17,True,0.0
2021,7,3160,430,32,7128,2,13,10,3,28,25,3,25,3,0,False,False,False,2,2,2021-10-28T20:03:34.717,28,False,25.0
2021,7,3160,440,32,4788,2,2,4,6,9,3,9,0,9,0,False,False,False,0,3,2021-10-26T02:41:34.467,9,False,0.0
2021,7,3160,475,12,7742,13,6,5,1,0,0,0,0,0,0,False,False,False,0,1,2022-02-16T15:26:51.78,0,False,0.0
2021,7,3160,480,12,7742,2,38,10,1,4,3,4,0,4,0,False,True,False,0,1,2021-10-28T20:37:25.313,2,False,0.0
2021,7,3160,515,32,7128,3,12,5,3,0,0,0,0,0,0,False,False,False,0,3,2022-02-24T14:03:13.227,0,False,0.0
2021,7,3160,520,32,4788,13,2,4,3,0,0,0,0,0,0,True,False,False,0,3,2021-10-28T20:04:23.103,0,False,0.0
2021,7,3160,525,12,556,2,49,3,-1,10,11,5,5,5,0,False,False,False,0,2,2021-10-25T13:08:01.95,10,False,5.0
2021,7,3160,535,12,556,2,19,6,23,26,3,23,3,23,0,False,False,False,0,2,2021-10-25T13:11:59.873,26,False,3.0
2021,7,3160,545,12,496,2,51,10,-2,4,6,4,0,4,0,False,False,False,0,3,2021-10-25T13:14:13.58,4,False,0.0
2021,7,3160,555,12,4511,2,17,1,20,25,5,23,2,23,0,False,False,False,0,3,2021-10-28T17:11:42.617,25,False,2.0
2021,7,3160,560,12,556,13,9,2,26,0,0,0,0,0,0,False,False,False,0,3,2021-10-25T15:31:48.233,0,False,
2021,7,3160,570,12,6691,13,5,5,11,0,0,0,0,0,0,False,False,False,0,3,2021-10-28T17:11:42.617,0,False,0.0
2021,7,3160,580,12,556,2,4,3,5,6,1,5,1,5,0,False,False,False,0,2,2021-10-28T20:12:38.953,6,False,
2021,7,3160,600,32,7128,13,6,4,1,0,0,0,0,0,0,False,False,False,0,2,2022-02-16T15:28:54.987,0,False,0.0
2021,7,3160,605,32,7128,2,5,10,12,12,0,12,0,12,0,False,False,False,0,3,2021-10-25T13:36:41.627,12,False,0.0
2021,7,3160,610,32,7128,2,6,9,5,5,0,5,0,5,0,False,False,False,0,2,2021-10-25T13:38:11.863,5,False,0.0
2021,7,3160,615,32,2675,2,5,10,5,7,2,5,2,5,0,False,False,False,2,3,2021-10-28T20:12:07.307,7,False,2.0
2021,7,3160,625,32,3885,13,16,9,5,0,0,0,0,0,0,False,False,False,0,1,2021-10-28T20:03:05.82,0,False,0.0
2021,7,3160,635,32,4788,2,4,10,10,10,0,10,0,10,0,False,False,False,0,3,2021-10-25T15:09:43.273,10,False,0.0
2021,7,3160,640,32,8533,2,13,9,3,3,0,3,0,3,0,False,False,False,0,3,2021-10-25T13:49:59.09,3,False,0.0
2021,7,3160,645,32,3885,2,51,9,-7,11,18,11,0,11,0,False,False,False,1,1,2021-10-25T13:52:10.293,11,False,0.0
2021,7,3160,650,32,8533,13,8,10,14,0,0,0,0,0,0,False,False,False,0,3,2021-10-28T20:05:01.983,0,False,0.0
2021,7,3160,655,32,4788,2,12,9,1,2,1,2,0,2,0,False,False,False,0,3,2022-02-24T14:03:42.943,2,False,0.0
2021,7,3160,660,32,2675,13,11,5,12,0,0,0,0,0,0,False,False,False,0,3,2021-10-25T13:59:31.547,0,False,0.0
2021,7,3160,665,12,467,2,35,9,12,17,5,15,2,15,0,False,False,False,0,4,2021-10-25T14:02:25.393,17,False,2.0
2021,7,3160,675,32,7128,2,4,10,4,19,15,7,12,7,0,False,False,False,1,3,2021-10-25T14:08:05.897,19,False,12.0
2021,7,3160,680,32,4788,2,5,5,9,10,1,10,0,10,0,False,False,False,0,3,2021-10-25T15:10:41.12,10,True,0.0
2021,7,3160,690,32,3885,2,16,10,2,3,1,3,0,3,0,False,False,False,0,1,2021-10-25T14:12:51.62,3,False,0.0
2021,7,3160,735,12,8377,13,48,9,-3,0,0,0,0,0,0,False,False,False,0,1,2021-10-28T20:38:17.717,0,False,0.0
2021,7,3160,745,32,2675,2,4,10,10,12,2,10,2,10,0,False,False,False,0,3,2021-10-25T14:28:38.683,12,False,2.0
2021,7,3160,755,32,8533,13,6,7,16,0,0,0,0,0,0,False,False,False,0,2,2021-10-25T14:32:15.347,0,False,0.0
2021,7,3160,760,32,8533,2,13,9,5,13,8,13,0,13,0,True,False,False,0,3,2021-10-25T14:34:16.913,13,False,0.0
2021,7,3160,765,32,7128,13,8,6,37,0,0,0,0,0,0,False,False,False,0,2,2021-10-25T14:36:12.983,0,False,0.0
2021,7,3160,770,32,4788,2,32,10,-5,6,11,2,4,2,0,False,False,False,0,4,2021-10-25T14:38:10.467,6,False,4.0
2021,7,3160,790,32,3885,2,32,5,-3,15,18,13,2,13,0,False,False,False,0,4,2021-10-25T14:55:46.127,15,False,2.0
2021,7,3161,15,17,3356,2,48,10,-2,-1,1,-2,1,-2,0,False,False,False,0,1,2021-10-25T09:37:52.52,-1,False,1.0
2021,7,3161,20,17,8483,2,5,3,9,9,0,9,0,9,0,False,False,False,0,3,2021-10-25T09:41:14.277,9,False,0.0
2021,7,3161,35,17,8483,2,5,3,7,17,10,9,8,9,0,True,False,False,1,3,2021-10-25T09:46:39.607,17,False,8.0
2021,7,3161,50,17,4484,2,39,4,4,5,1,5,0,5,0,False,False,False,0,3,2021-10-25T09:53:03.603,5,False,0.0
2021,7,3161,55,17,7024,2,46,3,0,2,2,0,2,0,0,False,False,False,1,1,2021-10-25T09:55:58.423,2,False,2.0
2021,7,3161,60,17,6274,2,2,9,4,10,6,4,6,4,0,False,False,False,0,3,2022-02-16T16:13:01.923,10,False,6.0
2021,7,3161,70,17,7087,13,29,3,10,0,0,0,0,0,0,False,False,False,0,2,2021-10-25T10:02:49.75,0,False,0.0
2021,7,3161,75,17,4752,2,2,9,4,10,6,8,2,8,6,False,False,False,0,2,2021-10-25T10:05:17.39,10,False,2.0
2021,7,3161,95,2,811,2,18,5,-5,-3,2,-4,1,-4,0,False,False,False,0,2,2021-10-28T16:33:09.343,-3,False,1.0
2021,7,3161,100,2,5223,13,12,7,19,0,0,0,0,0,0,False,False,False,0,2,2021-10-25T10:20:40.467,0,False,0.0
2021,7,3161,110,17,4383,13,4,7,18,0,0,0,0,0,0,False,False,False,0,3,2021-10-28T17:59:47.807,0,False,0.0
2021,7,3161,115,17,7024,2,28,10,-5,0,5,0,0,0,0,False,False,False,0,1,2021-10-25T10:29:35.29,0,False,0.0
2021,7,3161,120,17,4484,2,4,9,7,7,0,7,0,7,0,False,False,False,0,3,2021-10-28T16:33:20.303,7,False,0.0
2021,7,3161,130,2,8389,2,2,10,14,23,9,23,0,23,0,False,False,False,0,3,2021-10-28T16:12:18.857,23,False,0.0
2021,7,3161,135,2,5214,2,45,5,1,11,10,9,2,9,0,True,False,False,0,3,2021-10-25T10:40:30.427,11,False,2.0
2021,7,3161,145,2,5223,3,50,3,-1,0,0,0,0,0,0,False,False,False,0,2,2021-10-28T16:57:03.76,0,False,0.0
2021,7,3161,155,2,1377,2,39,4,6,7,1,7,0,7,0,False,False,False,0,4,2021-10-25T10:46:49.237,7,False,0.0
2021,7,3161,170,2,6247,2,50,10,-3,2,5,0,2,0,0,False,False,False,1,3,2021-10-25T10:52:47.007,2,False,2.0
2021,7,3161,180,2,8389,2,2,9,4,13,9,10,3,10,0,False,False,False,1,3,2021-10-26T17:28:17.49,13,False,3.0
2021,7,3161,195,17,6274,2,4,10,2,2,0,2,0,2,0,False,False,False,0,3,2021-10-25T11:19:00.08,2,False,0.0
2021,7,3161,205,17,6274,2,2,9,9,15,6,15,0,15,0,False,False,False,0,2,2021-10-25T11:22:46.97,15,False,0.0
2021,7,3161,215,17,7618,2,32,5,-6,9,15,9,0,9,0,False,False,False,0,1,2021-10-28T17:41:00.847,9,False,0.0
2021,7,3161,225,17,7087,13,2,10,6,0,0,0,0,0,0,False,False,False,0,2,2021-10-25T16:13:32.367,0,False,0.0
2021,7,3161,230,17,6274,13,9,3,8,0,0,0,0,0,0,False,False,False,0,3,2022-02-16T16:25:08.88,0,False,0.0
2021,7,3161,245,2,811,13,4,10,5,0,0,0,0,0,0,False,False,False,0,3,2021-10-28T17:43:01.413,0,False,0.0
2021,7,3161,250,2,6247,2,4,9,12,12,0,12,0,12,0,False,False,False,0,3,2021-10-28T18:00:18.343,12,False,0.0
2021,7,3161,255,2,2835,2,47,10,-1,6,7,5,1,5,0,False,False,False,0,1,2021-10-28T16:32:19.607,6,False,1.0
2021,7,3161,260,2,7303,2,35,10,10,13,3,12,1,12,0,False,False,False,0,3,2021-10-25T11:46:49.08,13,False,1.0
2021,7,3161,270,2,5214,2,17,4,14,15,1,15,0,15,0,True,False,False,0,3,2021-10-26T17:24:29.62,15,False,0.0
2021,7,3161,275,2,5223,13,32,5,3,0,0,0,0,0,0,False,False,False,0,3,2022-02-16T16:26:28.927,0,False,0.0
2021,7,3161,285,2,5223,2,30,5,5,5,0,5,0,5,6,False,False,False,0,3,2021-10-25T11:56:07.95,5,True,0.0
2021,7,3161,305,17,8483,2,51,3,-1,7,8,4,3,4,0,False,False,False,0,3,2021-10-25T12:01:17.177,7,False,3.0
2021,7,3161,310,17,8483,2,2,9,10,19,9,18,1,18,0,False,False,False,0,2,2021-10-25T12:04:15.177,19,False,1.0
2021,7,3161,325,17,7087,2,4,5,3,5,2,5,0,5,0,False,False,False,0,2,2021-10-28T16:13:02.28,5,False,0.0
2021,7,3161,345,17,6276,2,4,10,4,8,4,6,2,6,0,False,False,False,0,4,2021-10-25T16:03:35.157,8,False,2.0
2021,7,3161,355,17,6276,13,7,5,14,0,0,0,0,0,0,False,False,False,0,4,2021-10-25T16:14:30.003,0,False,0.0
2021,7,3161,360,2,8389,2,19,6,34,39,5,34,5,34,0,False,False,False,0,2,2021-10-28T17:46:05.32,39,False,5.0
2021,7,3161,365,2,5214,2,4,4,5,9,4,7,2,7,0,False,False,False,0,3,2021-10-25T12:21:08.473,9,False,2.0
2021,7,3161,375,2,3506,2,26,9,3,6,3,4,2,4,0,False,False,False,0,3,2021-10-25T12:23:01.293,6,False,2.0
2021,7,3161,385,2,5223,2,4,3,4,4,0,4,0,4,0,False,False,False,0,2,2021-10-25T12:24:37.22,4,False,0.0
2021,7,3161,390,2,6247,2,5,3,4,4,0,4,0,4,0,False,False,False,0,3,2021-10-25T12:26:24.713,4,True,0.0
2021,7,3161,415,2,8389,2,9,6,22,26,4,22,4,22,0,False,False,False,0,3,2021-10-27T01:39:44.01,26,False,4.0
2021,7,3161,425,2,6247,2,8,7,46,49,3,49,0,49,6,False,False,False,0,2,2021-10-25T12:35:20.34,49,True,0.0
2021,7,3161,460,17,6276,2,17,9,10,11,1,10,1,10,0,False,False,False,0,4,2021-10-25T16:04:09.907,11,False,1.0
2021,7,3161,475,2,5223,13,5,3,5,0,0,0,0,0,0,False,False,False,0,3,2021-10-25T12:46:36.833,0,False,0.0
2021,7,3161,480,2,811,2,13,4,4,4,0,4,0,4,0,True,False,False,0,3,2021-10-25T12:48:43.343,4,False,0.0
2021,7,3161,490,17,4484,2,4,10,3,5,2,5,0,5,0,False,False,False,0,4,2021-10-25T12:53:33.4,5,False,0.0
2021,7,3161,500,17,7087,3,4,5,5,0,0,0,0,0,0,False,False,False,0,2,2021-10-25T12:56:20.223,0,False,0.0
2021,7,3161,505,17,8483,2,7,3,14,14,0,14,0,14,0,False,False,False,0,3,2021-10-28T15:32:19.933,14,True,0.0
2021,7,3161,515,17,4484,2,31,9,2,6,4,5,1,5,0,False,False,False,0,4,2021-10-25T13:01:00.107,6,False,1.0
2021,7,3161,535,17,6274,2,9,3,6,6,0,6,0,6,6,False,False,False,0,3,2021-10-25T13:16:42.79,6,True,0.0
2021,7,3161,555,2,5214,13,12,10,9,0,0,0,0,0,0,True,False,False,0,3,2021-10-25T13:34:24.417,0,False,0.0
2021,7,3161,560,2,8389,2,4,10,11,11,0,11,0,11,0,False,False,False,0,3,2021-10-25T13:36:16.773,11,False,0.0
2021,7,3161,570,2,3506,2,42,10,6,12,6,9,3,9,0,False,False,False,0,3,2021-10-28T18:02:50.81,12,False,3.0
2021,7,3161,575,2,5223,13,6,1,16,0,0,0,0,0,0,False,False,False,0,2,2021-10-28T15:54:54.39,0,False,0.0
2021,7,3161,580,2,811,13,2,10,6,0,0,0,0,0,0,False,False,False,0,2,2021-10-25T13:46:08.593,0,False,0.0
2021,7,3161,585,2,6247,13,6,4,14,0,0,0,0,0,0,False,False,False,0,3,2021-10-25T13:48:12.547,0,False,0.0
2021,7,3161,595,17,4383,2,4,10,9,9,0,9,0,9,0,False,False,False,0,3,2021-10-25T13:51:38.757,9,False,0.0
2021,7,3161,630,2,8389,13,2,4,11,0,0,0,0,0,0,False,False,False,0,3,2021-10-25T14:03:05.237,0,False,0.0
2021,7,3161,635,2,5223,13,42,4,8,0,0,0,0,0,0,False,False,False,0,3,2022-02-16T16:30:34.663,0,False,0.0
2021,7,3161,640,17,8483,13,39,10,2,0,0,0,0,0,0,False,False,False,0,3,2021-10-28T16:36:59.193,0,False,0.0
2021,7,3161,650,2,5223,2,26,9,3,6,3,5,1,5,0,False,False,False,0,2,2021-10-25T16:13:13.993,6,False,1.0
2021,7,3161,670,17,6276,2,11,2,17,18,1,18,0,18,0,False,False,False,0,3,2021-10-28T17:53:41.48,18,False,0.0
2021,7,3161,675,17,6274,2,35,7,20,27,7,25,2,25,0,False,False,False,0,3,2021-10-25T14:21:21.787,27,False,2.0
2021,7,3161,680,17,6274,2,6,9,9,9,0,9,0,9,0,False,False,False,0,3,2021-10-25T14:22:55.413,9,False,0.0
2021,7,3161,690,17,8483,2,5,3,11,11,0,11,0,11,0,False,False,False,0,3,2021-10-25T14:26:18.103,11,False,0.0
2021,7,3161,700,17,7024,2,44,9,-5,1,6,1,0,1,0,False,False,False,0,1,2021-10-28T17:56:48.223,1,False,0.0
2021,7,3161,710,17,7024,2,45,5,0,7,7,2,5,2,6,False,False,False,1,1,2021-10-25T14:35:10.147,7,False,5.0
2021,7,3161,725,2,1377,13,13,4,4,0,0,0,0,0,0,False,False,False,0,4,2021-10-25T14:39:23.29,0,False,0.0
2021,7,3161,730,2,6247,3,5,3,4,0,0,0,0,0,0,False,False,False,0,2,2021-10-25T14:41:44.543,0,False,0.0
2021,7,3161,735,2,5223,2,39,4,4,11,7,6,5,6,0,False,False,False,0,3,2021-10-28T16:13:17.023,11,False,5.0
2021,7,3161,750,2,811,13,2,10,3,0,0,0,0,0,0,False,False,False,0,2,2021-10-28T16:32:48.157,0,False,0.0
2021,7,3161,765,17,8483,2,50,10,-1,10,11,5,5,5,0,True,False,False,0,3,2021-10-28T17:57:14.97,6,False,5.0
2021,7,3161,770,17,8483,2,5,3,8,8,0,8,0,8,0,False,False,False,0,2,2021-10-25T15:04:31.76,8,False,
2021,7,3161,775,17,7618,2,48,9,-4,17,21,16,1,16,0,False,False,False,0,1,2021-10-25T16:15:16.427,17,False,1.0
2021,7,3161,795,17,4484,3,4,5,3,0,0,0,0,0,0,False,False,False,0,4,2021-10-25T15:15:36.463,0,False,0.0
2021,7,3161,800,17,6274,2,4,4,14,16,2,15,1,15,0,False,False,False,0,3,2021-10-25T15:19:00.063,16,False,1.0
2021,7,3161,810,17,4383,2,35,9,4,4,0,4,0,4,6,False,False,False,0,2,2021-10-28T16:49:44.033,4,True,0.0
2021,7,3161,825,2,8389,2,8,7,20,23,3,23,0,23,0,False,False,False,0,3,2021-10-25T15:34:53.777,23,False,0.0
2021,7,3161,835,2,8389,2,9,2,23,28,5,23,5,23,0,False,False,False,0,2,2021-10-25T15:37:10.13,28,False,5.0
2021,7,3162,15,7,7659,2,5,5,11,11,0,11,0,11,0,False,False,False,0,2,2022-02-16T14:45:00.3,11,False,0.0
2021,7,3162,25,7,7659,13,29,5,12,0,0,0,0,0,0,True,False,False,0,2,2021-10-26T18:35:05.467,0,False,0.0
2021,7,3162,30,7,4455,2,5,10,4,23,19,20,3,20,0,False,False,False,0,1,2021-10-28T17:51:41.987,23,False,3.0
2021,7,3162,35,7,3521,13,5,3,4,0,0,0,0,0,0,False,False,False,0,3,2021-10-25T10:39:29.463,0,False,0.0
2021,7,3162,40,7,7659,13,6,10,5,0,0,0,0,0,0,False,False,False,0,2,2021-10-25T10:40:46.823,0,False,0.0
2021,7,3162,50,7,7659,13,5,5,9,0,0,0,0,0,0,False,False,False,0,3,2021-10-25T10:42:50.303,0,False,0.0
2021,7,3162,65,3,8430,13,5,3,7,0,0,0,0,0,0,False,False,False,0,2,2021-10-25T10:48:30.467,0,False,0.0
2021,7,3162,75,3,6936,13,11,6,38,0,0,0,0,0,0,True,False,False,0,3,2021-10-25T10:52:20.36,0,False,0.0
2021,7,3162,105,7,3521,13,11,3,7,0,0,0,0,0,0,False,False,False,0,3,2021-10-28T17:52:05.34,0,False,0.0
2021,7,3162,110,7,8317,2,3,3,7,9,2,7,2,7,0,False,False,False,0,2,2021-10-25T11:02:15.52,9,False,2.0
2021,7,3162,120,7,7659,2,12,5,4,6,2,5,1,5,0,True,False,False,0,3,2021-10-26T18:36:05.793,6,False,1.0
2021,7,3162,125,7,7659,13,6,4,8,0,0,0,0,0,0,False,False,False,0,2,2021-10-25T11:07:34.063,0,False,0.0
2021,7,3162,145,3,6936,13,5,5,13,0,0,0,0,0,0,False,False,False,0,2,2022-02-25T15:21:23.717,0,False,0.0
2021,7,3162,150,3,8430,13,6,1,16,0,0,0,0,0,0,False,False,False,0,2,2021-10-25T11:12:27.52,0,False,0.0
2021,7,3162,165,7,3521,2,5,5,5,5,0,5,0,5,0,False,False,False,0,3,2021-10-28T18:04:18.163,5,False,0.0
2021,7,3162,170,7,7659,13,19,6,27,0,0,0,0,0,0,False,False,False,0,2,2021-10-25T11:16:48.353,0,False,0.0
2021,7,3162,180,3,6454,2,12,8,18,24,6,20,4,20,0,False,False,False,0,3,2021-10-28T18:06:32.98,24,False,4.0
2021,7,3162,190,3,713,2,44,3,-2,6,8,4,2,4,0,False,False,False,0,1,2021-10-28T18:17:59.577,6,False,2.0
2021,7,3162,195,3,6454,2,8,7,19,23,4,22,1,22,0,False,False,False,0,3,2021-10-25T11:26:25.77,23,False,1.0
2021,7,3162,205,3,6454,13,5,10,9,0,0,0,0,0,0,True,False,False,0,3,2021-10-28T14:01:07.51,0,False,0.0
2021,7,3162,215,3,6454,13,5,5,4,0,0,0,0,0,0,False,False,False,0,3,2021-10-25T11:31:14.017,0,False,0.0
2021,7,3162,260,3,6816,2,35,7,17,19,2,19,0,19,0,False,False,False,0,4,2021-10-25T11:41:29.14,19,False,0.0
2021,7,3162,275,3,6454,2,51,10,0,11,11,2,9,2,0,False,False,False,1,3,2021-10-28T18:07:24.233,11,False,
2021,7,3162,290,7,7659,2,4,3,4,9,5,6,3,6,0,False,False,False,0,2,2021-10-25T11:57:13.013,9,False,3.0
2021,7,3162,295,7,2631,2,23,7,29,55,26,33,22,33,6,False,False,False,1,4,2021-10-28T17:52:17.753,55,False,22.0
2021,7,3162,310,3,8430,2,4,10,7,20,13,19,1,19,0,False,False,False,0,2,2021-10-25T12:02:27.223,20,False,1.0
2021,7,3162,315,3,6936,13,5,2,21,0,0,0,0,0,0,False,False,False,0,3,2021-10-28T18:08:15.73,0,False,0.0
2021,7,3162,330,3,6936,2,6,1,19,18,-1,18,0,18,0,False,False,False,0,2,2021-10-25T12:10:43.247,18,False,0.0
2021,7,3162,335,3,6936,2,4,9,7,7,0,7,0,7,0,False,False,False,0,3,2021-10-25T12:12:04.51,7,False,0.0
2021,7,3162,380,7,7659,2,4,5,7,7,0,7,0,7,0,False,False,False,0,2,2021-10-25T12:19:09.153,7,False,0.0
2021,7,3162,385,7,2631,2,5,5,3,4,1,4,0,4,0,False,False,False,0,3,2021-10-28T18:08:54.82,4,False,0.0
2021,7,3162,390,7,8317,2,6,3,4,6,2,5,1,5,0,False,False,False,0,2,2021-10-25T12:22:00.023,6,False,1.0
2021,7,3162,395,7,8317,2,29,3,12,13,1,13,0,13,0,False,False,False,0,2,2021-10-25T12:23:28.447,13,False,0.0
2021,7,3162,400,7,7659,13,9,2,25,0,0,0,0,0,0,False,False,False,0,3,2021-10-25T12:25:38.99,0,False,0.0
2021,7,3162,410,7,8317,2,6,9,11,26,15,26,0,26,0,False,False,False,0,2,2021-10-25T12:27:03.613,26,True,0.0
2021,7,3162,415,7,3521,2,6,4,6,7,1,7,0,7,0,False,False,False,0,3,2021-10-25T12:28:55.38,7,False,0.0
2021,7,3162,430,7,7659,13,9,3,12,0,0,0,0,0,0,False,False,False,0,2,2021-10-25T12:31:06.583,0,False,0.0
2021,7,3162,455,3,6454,2,46,3,-1,1,2,-1,2,-1,0,False,False,False,0,3,2021-10-25T12:59:02.78,1,False,2.0
2021,7,3162,460,3,8430,2,35,8,24,35,11,30,5,30,0,False,False,False,0,2,2021-10-25T13:05:58.943,35,False,5.0
2021,7,3162,465,3,6936,2,19,2,39,39,0,39,0,39,6,False,False,False,0,2,2021-10-25T13:07:38.22,39,True,0.0
2021,7,3162,480,7,8317,2,6,9,11,17,6,13,4,13,0,False,False,False,0,3,2021-10-25T16:09:00.27,17,False,4.0
2021,7,3162,490,7,8317,2,2,10,9,21,12,12,9,12,0,False,False,False,1,2,2021-10-25T13:11:59.593,21,False,9.0
2021,7,3162,495,7,2631,2,17,8,16,32,16,18,14,18,6,False,False,False,1,3,2021-10-25T13:13:32.963,32,False,14.0
2021,7,3162,510,3,8430,2,35,10,13,25,12,25,0,25,0,False,False,False,0,3,2021-10-28T18:35:55.04,25,True,0.0
2021,7,3162,515,3,6936,13,19,2,46,0,0,0,0,0,0,False,False,False,0,2,2021-10-25T13:19:50.167,0,False,0.0
2021,7,3162,535,3,8430,13,39,4,5,0,0,0,0,0,0,False,False,False,0,3,2021-10-25T16:11:24.333,0,False,0.0
2021,7,3162,555,7,7659,2,4,5,4,7,3,4,3,4,0,False,False,False,0,2,2021-10-25T13:29:35.683,7,False,3.0
2021,7,3162,565,7,8317,2,2,10,6,82,76,9,73,9,6,False,False,False,2,2,2021-10-28T17:56:00.377,82,False,73.0
2021,7,3162,585,3,6454,13,21,2,29,0,0,0,0,0,0,False,False,False,0,3,2021-10-28T14:01:07.51,0,False,0.0
2021,7,3162,595,3,6936,2,44,9,-3,3,6,3,0,3,0,False,False,False,0,3,2021-10-25T13:41:48.903,3,False,0.0
2021,7,3162,605,7,3521,2,35,10,14,25,11,22,3,22,0,True,False,False,0,3,2021-10-26T18:38:44.37,25,False,3.0
2021,7,3162,610,7,8317,13,29,5,14,0,0,0,0,0,0,False,False,False,0,2,2021-10-25T13:46:03.823,0,False,0.0
2021,7,3162,615,7,3521,2,49,9,-4,2,6,-2,4,-2,0,False,False,False,1,2,2021-10-28T18:14:58.873,2,False,4.0
2021,7,3162,620,7,7659,2,5,3,7,11,4,8,3,8,0,False,False,False,1,2,2021-10-28T17:56:17.49,11,False,3.0
2021,7,3162,630,7,3521,13,4,10,6,0,0,0,0,0,0,True,False,False,0,3,2021-10-25T16:11:35.3,0,False,0.0
2021,7,3162,635,7,7659,2,5,5,8,11,3,9,2,9,0,False,False,False,0,2,2021-10-25T13:53:21.013,11,False,2.0
2021,7,3162,640,7,8317,2,29,2,22,27,5,23,4,23,0,False,True,False,0,2,2021-10-25T13:55:35.027,27,False,4.0
2021,7,3162,655,7,7659,13,8,7,16,0,0,0,0,0,0,False,False,False,0,2,2021-10-25T13:59:39.007,0,False,0.0
2021,7,3162,660,7,8317,13,7,2,16,0,0,0,0,0,0,False,False,False,0,3,2021-10-25T14:01:08.64,0,False,0.0
2021,7,3162,675,3,6936,13,19,1,46,0,0,0,0,0,0,False,False,False,0,2,2021-10-25T14:14:33.39,0,False,0.0
2021,7,3162,690,3,6936,2,12,5,14,13,-1,13,0,13,0,False,False,False,0,3,2021-10-25T14:19:25.327,13,False,0.0
2021,7,3162,695,3,7673,13,6,10,4,0,0,0,0,0,0,False,False,False,0,3,2021-10-28T17:53:13.38,0,False,0.0
2021,7,3162,700,3,6454,13,5,9,4,0,0,0,0,0,0,True,False,False,0,3,2021-10-26T22:56:20.397,0,False,0.0
2021,7,3162,705,3,6936,13,4,9,7,0,0,0,0,0,0,False,False,False,0,3,2021-10-28T17:53:28.41,0,False,0.0
2021,7,3162,740,3,8274,2,47,5,0,13,13,10,3,10,0,False,False,False,0,1,2021-10-25T15:03:47.69,13,False,3.0
2021,7,3162,750,3,6936,13,5,5,7,0,0,0,0,0,0,False,False,False,0,3,2021-10-28T17:51:05.643,0,False,0.0
2021,7,3162,775,3,8274,2,12,3,6,11,5,11,0,11,0,True,False,False,0,3,2022-02-24T14:05:41.093,11,False,0.0
2021,7,3162,805,3,34,2,46,9,-1,-1,0,-1,0,-1,0,True,False,False,0,1,2021-10-25T15:20:01.807,-1,False,0.0
2021,7,3162,810,3,34,3,4,9,3,0,0,0,0,0,0,False,False,False,0,1,2021-10-25T15:21:26.253,0,False,0.0
2021,7,3162,815,3,6936,13,12,2,41,0,0,0,0,0,0,False,False,False,0,2,2021-10-28T18:11:06.97,0,False,0.0
2021,7,3162,845,3,6816,2,5,10,3,10,7,9,1,9,0,False,False,False,0,3,2021-10-25T15:39:43.82,10,False,1.0
2021,7,3162,850,3,713,2,4,4,4,12,8,12,0,12,0,False,False,False,0,1,2021-10-25T16:04:05.41,12,False,0.0
2021,7,3162,855,3,713,2,4,9,4,7,3,7,0,7,0,False,False,False,0,1,2021-10-25T16:04:13.903,7,False,0.0
2021,7,3162,860,3,7672,2,12,3,11,11,0,11,0,11,0,False,False,False,0,2,2021-10-28T13:51:38.58,11,False,0.0
2021,7,3162,865,3,6936,13,6,8,18,0,0,0,0,0,0,False,False,False,0,2,2021-10-25T16:01:34.4,0,False,0.0
2021,7,3162,870,3,6816,13,12,5,-1,0,0,0,0,0,0,False,False,False,0,4,2022-02-23T14:42:09.09,0,False,0.0
2021,7,3162,875,3,6816,13,35,7,34,0,0,0,0,0,0,False,False,False,0,3,2021-10-25T16:01:55.71,0,False,0.0
2021,7,3162,880,3,6816,13,6,9,10,0,0,0,0,0,0,False,False,False,0,3,2021-10-25T16:02:03.127,0,False,0.0
2021,7,3163,20,11,7732,2,47,5,0,4,4,3,1,3,0,False,False,False,0,1,2021-10-25T09:20:45.51,4,False,1.0
2021,7,3163,25,11,6810,13,5,5,5,0,0,0,0,0,0,False,False,False,0,2,2021-10-25T09:23:13.757,0,False,0.0
2021,7,3163,35,11,7732,2,48,9,-5,63,68,10,53,10,6,False,False,False,1,1,2021-10-28T22:07:37.943,63,False,53.0
2021,7,3163,60,11,4037,3,50,5,0,0,0,0,0,0,0,False,False,False,0,2,2021-10-28T22:04:35.01,0,False,0.0
2021,7,3163,65,11,6810,13,5,2,15,0,0,0,0,0,0,False,False,False,0,2,2021-10-25T09:47:57.257,0,False,0.0
2021,7,3163,70,11,7908,2,4,3,9,17,8,17,0,17,0,False,False,False,0,2,2021-10-25T09:51:32.24,17,False,0.0
2021,7,3163,85,11,7732,2,34,9,-4,-1,3,-3,2,-3,0,True,False,False,0,3,2021-10-28T22:33:42.833,-1,False,2.0
2021,7,3163,95,11,3528,13,13,10,4,0,0,0,0,0,0,False,False,False,0,3,2021-10-28T19:07:05.23,0,False,0.0
2021,7,3163,110,29,3398,2,47,5,3,16,13,11,5,11,0,False,False,False,0,3,2022-02-23T15:21:23.537,16,False,5.0
2021,7,3163,120,29,4866,2,35,6,22,29,7,29,0,29,0,False,False,False,0,3,2021-10-25T10:11:21.303,29,False,0.0
2021,7,3163,125,29,7378,2,51,5,-4,4,8,4,0,4,0,True,False,False,0,1,2021-10-28T22:02:47.72,4,False,0.0
2021,7,3163,135,29,4866,2,5,3,5,5,0,5,0,5,0,False,False,False,0,3,2021-10-28T22:15:39.7,5,False,0.0
2021,7,3163,140,29,4866,2,31,4,-1,1,2,1,0,1,0,False,False,False,0,4,2021-10-28T22:18:13.553,1,False,0.0
2021,7,3163,145,29,3398,2,5,5,5,5,0,5,0,5,0,False,False,False,0,3,2021-10-25T10:22:02.223,5,False,0.0
2021,7,3163,150,29,7378,13,11,2,15,0,0,0,0,0,0,False,False,False,0,1,2021-10-25T10:24:42.773,0,False,0.0
2021,7,3163,170,11,6810,2,35,9,11,21,10,20,1,20,0,False,False,False,0,4,2021-10-25T10:29:10.453,21,False,1.0
2021,7,3163,200,11,4037,13,5,3,5,0,0,0,0,0,0,False,False,False,0,2,2021-10-25T10:44:04.743,0,False,0.0
2021,7,3163,225,29,4866,13,35,5,14,0,0,0,0,0,0,False,False,False,0,3,2021-10-25T16:23:05.123,0,False,0.0
2021,7,3163,230,29,7828,2,6,9,5,5,0,5,0,5,0,False,False,False,0,2,2021-10-25T11:01:03.33,5,False,0.0
2021,7,3163,235,29,7828,13,19,6,32,0,0,0,0,0,0,False,False,False,0,2,2021-10-28T22:04:58.463,0,False,
2021,7,3163,245,29,7828,13,35,2,36,0,0,0,0,0,0,False,False,False,0,3,2021-10-31T19:39:47.283,0,False,0.0
2021,7,3163,255,29,7378,2,28,9,2,2,0,2,0,2,0,False,False,False,0,1,2021-10-25T16:23:17.153,2,False,0.0
2021,7,3163,270,29,4866,2,5,3,6,11,5,6,5,6,0,True,False,False,1,1,2021-10-25T11:21:34.793,11,False,5.0
2021,7,3163,280,29,7378,13,11,3,11,0,0,0,0,0,0,False,False,False,0,1,2021-10-25T11:26:16.04,0,False,0.0
2021,7,3163,285,29,7828,2,9,3,11,11,0,11,0,11,6,False,False,False,0,2,2021-10-25T11:27:54.163,11,True,0.0
2021,7,3163,300,11,4091,3,31,4,-3,0,0,0,0,0,0,False,False,False,0,5,2021-10-25T11:33:28.243,0,False,
2021,7,3163,315,11,4037,2,52,4,0,12,12,10,2,10,0,False,False,False,0,3,2021-10-25T11:43:35.493,12,False,2.0
2021,7,3163,325,29,3398,13,13,5,4,0,0,0,0,0,0,False,False,False,0,3,2021-10-25T11:49:13.177,0,False,0.0
2021,7,3163,330,29,4866,2,7,6,21,27,6,27,0,27,0,False,False,False,0,3,2021-10-28T22:24:08.78,27,False,0.0
2021,7,3163,340,29,4866,2,51,4,-3,3,6,3,0,3,0,False,False,False,0,3,2021-10-28T22:03:37.61,3,False,0.0
2021,7,3163,345,29,1958,2,35,10,7,22,15,7,15,7,0,False,False,False,1,3,2021-10-28T22:23:56.483,22,False,15.0
2021,7,3163,365,29,1958,2,4,10,10,10,0,10,0,10,0,False,False,False,0,3,2021-10-28T22:38:10.767,10,False,0.0
2021,7,3163,370,29,1958,2,50,9,-3,4,7,3,1,3,0,False,False,False,0,2,2021-10-28T22:39:04.863,4,False,1.0
2021,7,3163,380,29,3398,13,32,3,2,0,0,0,0,0,0,False,False,False,0,4,2021-10-25T12:32:33.633,0,False,0.0
2021,7,3163,385,29,1958,2,26,10,6,9,3,9,0,9,0,False,False,False,0,3,2021-10-25T12:34:23.553,9,False,0.0
2021,7,3163,395,29,4866,2,49,10,0,2,2,2,0,2,6,False,False,False,0,2,2022-02-16T15:48:35.827,2,True,0.0
2021,7,3163,410,11,4037,2,4,10,6,15,9,6,9,6,0,False,False,False,1,3,2021-10-28T22:08:08.367,15,False,9.0
2021,7,3163,415,11,7732,2,6,10,3,8,5,8,0,8,0,False,False,False,0,1,2021-10-28T19:07:05.277,8,False,0.0
2021,7,3163,420,11,4037,2,19,2,18,20,2,20,0,20,0,False,False,False,0,2,2021-10-25T12:44:56.177,20,False,0.0
2021,7,3163,430,11,4037,2,36,4,12,14,2,14,0,14,0,False,False,False,0,3,2021-10-28T19:07:05.277,14,False,0.0
2021,7,3163,445,11,3528,13,9,6,15,0,0,0,0,0,0,False,False,False,0,2,2022-02-16T15:53:40.537,0,False,0.0
2021,7,3163,485,29,7828,13,7,2,30,0,0,0,0,0,0,False,False,False,0,3,2021-10-28T22:05:47.56,0,False,0.0
2021,7,3163,490,29,967,13,12,6,30,0,0,0,0,0,0,False,False,False,0,2,2021-10-28T21:57:28.843,0,False,
2021,7,3163,495,29,1958,2,4,5,6,7,1,7,0,7,0,False,False,False,0,3,2021-10-28T22:26:50.313,7,False,0.0
2021,7,3163,500,29,7378,2,46,3,2,13,11,7,6,7,0,False,False,False,1,1,2021-10-28T22:46:53.517,13,False,6.0
2021,7,3163,505,29,967,13,24,6,35,0,0,0,0,0,0,False,False,False,0,3,2021-10-28T22:47:59.293,0,False,0.0
2021,7,3163,510,29,7378,13,16,9,3,0,0,0,0,0,0,False,False,False,0,1,2021-10-25T13:18:55.887,0,False,0.0
2021,7,3163,540,11,7732,2,48,10,-8,9,17,8,1,8,0,False,False,False,1,1,2021-10-25T13:32:31.193,9,False,1.0
2021,7,3163,560,11,6810,2,39,9,6,7,1,7,0,7,0,True,False,False,0,4,2021-10-28T19:07:05.293,7,False,0.0
2021,7,3163,570,11,6810,2,39,4,5,5,0,5,0,5,0,False,False,False,0,3,2021-10-25T13:44:21.42,5,False,0.0
2021,7,3163,585,29,7828,2,8,7,15,22,7,22,0,22,0,False,False,False,1,3,2021-10-28T22:58:59.553,22,False,0.0
2021,7,3163,590,29,3398,13,17,8,23,0,0,0,0,0,0,False,False,False,0,3,2021-10-25T13:59:43.627,0,False,
2021,7,3163,600,29,3398,2,47,5,3,5,2,5,0,5,0,False,False,False,0,4,2021-10-28T22:53:58.957,5,False,0.0
2021,7,3163,610,29,3398,13,32,3,5,0,0,0,0,0,0,False,False,False,0,4,2021-10-25T14:11:02.673,0,False,0.0
2021,7,3163,620,11,4037,2,13,9,5,37,32,35,2,35,0,False,False,False,0,3,2022-02-23T15:25:28.857,37,False,2.0
2021,7,3163,635,11,7732,13,32,10,2,0,0,0,0,0,0,False,False,False,0,1,2022-02-25T15:24:33.483,0,False,0.0
2021,7,3163,650,29,4866,2,5,10,5,14,9,5,9,5,0,False,False,False,1,3,2021-10-28T22:08:21.537,14,False,9.0
2021,7,3163,660,29,4866,13,5,2,15,0,0,0,0,0,0,False,False,False,0,3,2022-02-25T15:24:56.307,0,False,0.0
2021,7,3163,665,29,4866,2,35,7,37,59,22,56,3,56,0,False,False,False,1,3,2021-10-28T22:08:36.063,59,False,3.0
2021,7,3163,675,29,7828,13,2,3,5,0,0,0,0,0,0,False,False,False,0,2,2021-10-28T22:56:00.163,0,False,0.0
2021,7,3163,680,29,4866,13,12,5,-1,0,0,0,0,0,0,False,False,False,0,4,2021-10-28T22:56:49.5,0,False,0.0
2021,7,3163,685,29,3398,2,6,9,14,14,0,14,0,14,0,False,False,False,0,3,2021-10-25T14:52:34.583,14,False,0.0
2021,7,3163,690,29,4866,2,30,5,2,5,3,4,1,4,6,True,False,False,0,3,2022-02-16T15:55:03.017,5,False,1.0
2021,7,3163,705,11,1430,2,32,9,2,6,4,5,1,5,0,False,False,False,0,4,2021-10-25T15:00:20.927,6,False,1.0
2021,7,3163,715,11,7732,2,16,4,4,6,2,6,0,6,0,False,False,False,0,1,2021-10-25T15:04:07.53,6,False,0.0
2021,7,3163,720,11,6810,2,39,10,3,5,2,3,2,3,0,False,False,False,1,3,2021-10-25T15:10:07.907,5,False,2.0
2021,7,3163,725,11,6810,2,4,9,4,4,0,4,0,4,0,True,False,False,0,3,2021-10-26T19:03:27.593,4,False,0.0
2021,7,3163,740,11,6633,2,18,5,-1,3,4,-1,4,-1,0,False,False,False,1,2,2021-10-25T15:20:19.203,3,False,4.0
2021,7,3163,745,11,6810,2,13,9,5,6,1,6,0,6,0,False,False,False,0,3,2021-10-25T15:22:20.617,6,False,0.0
2021,7,3163,770,11,7732,2,45,10,-5,5,10,0,5,0,0,False,False,False,2,1,2021-10-25T16:25:31.44,5,False,5.0
2021,7,3163,785,11,6810,13,17,10,12,0,0,0,0,0,0,False,False,False,0,4,2021-10-25T15:46:50.383,0,False,0.0
2021,7,3163,795,29,3398,2,53,10,0,6,6,6,0,6,0,False,False,False,0,4,2021-10-28T22:57:21.963,6,False,0.0
2021,7,3163,800,29,1958,2,2,9,7,18,11,18,0,18,0,False,False,False,0,2,2021-10-25T15:54:19.48,18,False,0.0
2021,7,3163,830,29,7828,2,4,9,5,5,0,5,0,5,0,False,False,False,0,3,2021-10-25T16:25:43.04,5,False,0.0
2021,7,3163,860,11,4037,2,6,7,17,17,0,17,0,17,0,False,False,False,0,2,2021-10-25T16:08:56.907,17,False,0.0
2021,7,3163,870,11,7732,2,46,3,2,2,0,2,0,2,0,False,False,False,0,1,2021-10-25T16:26:05.52,2,False,0.0
2021,7,3163,875,11,7732,13,4,9,2,0,0,0,0,0,0,False,False,False,0,1,2021-10-28T22:07:09.793,0,False,0.0
2021,7,3164,10,24,8509,13,4,10,7,0,0,0,0,0,0,False,False,False,0,2,2021-10-25T09:22:03.473,0,True,0.0
2021,7,3164,25,24,6373,2,7,6,23,24,1,24,0,24,0,False,False,False,0,4,2021-10-25T09:35:17.833,24,False,0.0
2021,7,3164,45,24,8513,2,16,9,2,13,11,13,0,13,6,False,False,False,0,1,2021-10-25T09:43:03.66,13,True,0.0
2021,7,3164,65,23,7246,2,4,9,6,12,6,12,0,12,0,False,False,False,0,3,2021-10-25T09:49:36.29,12,False,0.0
2021,7,3164,70,23,7688,2,5,3,4,4,0,4,0,4,0,False,False,False,0,3,2021-10-25T09:49:15.717,4,True,0.0
2021,7,3164,95,23,3843,2,31,10,1,2,1,2,0,2,0,False,False,False,0,1,2021-10-25T15:06:04.45,2,False,
2021,7,3164,100,23,4949,2,21,2,40,43,3,43,0,43,0,False,False,False,0,2,2021-10-25T10:03:29.5,43,True,0.0
2021,7,3164,105,23,7246,2,51,3,-1,-1,0,-1,0,-1,0,False,False,False,0,4,2021-10-25T10:05:13.277,-1,False,0.0
2021,7,3164,110,23,7241,2,5,5,6,5,-1,5,0,5,0,False,False,False,0,1,2021-10-28T14:50:58.43,5,False,
2021,7,3164,115,23,7250,2,6,9,14,16,2,16,0,16,0,False,False,False,0,2,2021-10-25T10:10:54.92,16,False,0.0
2021,7,3164,120,23,3843,13,31,10,4,0,0,0,0,0,0,False,False,False,0,1,2021-10-28T15:13:33.133,0,True,0.0
2021,7,3164,125,24,8509,13,2,10,12,0,0,0,0,0,0,False,False,False,0,2,2021-10-28T15:05:09.19,0,True,0.0
2021,7,3164,130,24,8509,2,5,10,7,8,1,8,0,8,0,False,False,False,0,3,2021-10-25T10:16:59.45,8,False,0.0
2021,7,3164,150,24,6937,2,48,10,-5,-3,2,-3,0,-3,0,False,False,False,0,1,2021-10-25T10:23:26.393,-3,False,0.0
2021,7,3164,155,24,6373,13,5,10,10,0,0,0,0,0,0,False,False,False,0,4,2022-02-16T15:58:11.68,0,True,0.0
2021,7,3164,160,24,8513,13,50,3,0,0,0,0,0,0,0,False,False,False,0,2,2021-10-25T10:30:03.847,0,True,0.0
2021,7,3164,170,23,7688,2,5,5,3,2,-1,2,0,2,0,False,False,False,0,3,2021-10-25T10:33:26.723,2,False,0.0
2021,7,3164,175,23,7250,2,30,5,-1,8,9,7,1,7,0,False,False,False,0,3,2021-10-25T10:35:24.733,8,False,1.0
2021,7,3164,185,23,7241,2,4,4,2,13,11,7,6,7,0,False,False,False,1,1,2021-10-28T15:05:09.19,13,False,6.0
2021,7,3164,190,23,7246,2,54,9,-3,0,3,-1,1,-1,0,True,False,False,0,4,2021-10-28T15:05:09.19,0,False,1.0
2021,7,3164,210,23,7250,2,4,3,3,6,3,6,0,6,0,False,False,False,2,2,2021-10-28T14:57:45.87,6,False,0.0
2021,7,3164,215,23,7246,2,17,8,17,18,1,18,0,18,6,False,False,False,0,4,2021-10-25T10:48:29.76,18,True,0.0
2021,7,3164,235,24,8509,13,2,9,12,0,0,0,0,0,0,False,False,False,0,2,2021-10-28T14:49:38.547,0,True,0.0
2021,7,3164,260,24,8509,2,12,2,20,20,0,20,0,20,0,False,False,False,0,3,2021-10-28T14:51:23.68,20,True,0.0
2021,7,3164,290,23,7689,2,17,7,18,18,0,18,0,18,0,False,False,False,0,3,2021-10-26T15:47:02.227,18,False,0.0
2021,7,3164,300,23,7688,2,4,5,6,8,2,6,2,6,0,False,False,False,0,2,2021-10-25T11:12:54.68,8,False,2.0
2021,7,3164,310,23,7250,2,50,3,-2,10,12,8,2,8,0,False,False,False,0,3,2021-10-28T15:29:21.35,10,False,2.0
2021,7,3164,320,23,7688,2,2,10,8,10,2,10,0,10,0,False,False,False,0,2,2021-10-25T11:21:51.75,10,False,0.0
2021,7,3164,330,23,7241,2,44,3,-7,6,13,6,0,6,0,False,False,False,0,1,2021-10-25T11:24:15.637,6,False,0.0
2021,7,3164,335,23,7241,2,48,10,-2,20,22,17,3,17,0,False,False,False,0,1,2021-10-25T11:25:50.613,20,False,3.0
2021,7,3164,365,23,4307,2,16,9,4,7,3,7,0,7,0,False,False,False,0,1,2021-10-25T11:32:25.293,7,False,0.0
2021,7,3164,380,23,7250,2,4,10,5,6,1,5,1,5,0,False,False,False,0,3,2021-10-25T11:35:29.867,6,False,1.0
2021,7,3164,385,23,3843,2,6,9,3,5,2,4,1,4,0,False,False,False,0,1,2021-10-28T15:21:34.567,5,False,1.0
2021,7,3164,395,23,4307,2,45,5,-5,4,9,4,0,4,0,False,False,False,0,1,2021-10-25T11:38:59.55,4,False,0.0
2021,7,3164,400,23,7250,13,26,10,6,0,0,0,0,0,0,False,False,False,0,3,2021-10-28T15:22:32.597,0,True,0.0
2021,7,3164,440,23,7246,2,17,8,15,21,6,18,3,18,0,True,False,False,0,4,2021-10-28T15:23:36.287,21,False,3.0
2021,7,3164,445,23,7250,2,5,3,4,7,3,7,0,7,0,False,False,False,1,3,2021-10-28T14:49:49.207,7,False,0.0
2021,7,3164,495,24,8513,13,28,5,1,0,0,0,0,0,0,False,False,False,0,1,2021-10-28T15:24:15.447,0,True,0.0
2021,7,3164,505,23,3843,2,46,3,2,9,7,9,0,9,0,False,False,False,0,1,2021-10-25T12:18:04.473,9,False,0.0
2021,7,3164,510,23,7246,2,51,5,-1,10,11,2,8,2,0,False,False,False,0,4,2021-10-25T12:20:43.73,10,False,8.0
2021,7,3164,515,23,7689,2,35,10,14,24,10,21,3,21,0,False,False,False,0,3,2021-10-28T14:50:04.027,24,False,3.0
2021,7,3164,520,23,7689,13,29,5,7,0,0,0,0,0,0,False,False,False,0,2,2021-10-25T12:32:25.137,0,True,0.0
2021,7,3164,530,23,7250,2,5,5,5,5,0,5,0,5,0,False,False,False,0,3,2021-10-25T12:35:42.19,5,False,0.0
2021,7,3164,535,23,7689,2,49,3,0,1,1,1,0,1,6,True,False,False,0,2,2022-02-16T16:02:23.19,1,True,0.0
2021,7,3164,550,24,7800,2,35,2,15,27,12,27,0,27,0,False,False,False,0,3,2022-02-14T19:59:58.623,27,True,0.0
2021,7,3164,565,24,8509,13,19,2,27,0,0,0,0,0,0,False,False,False,0,2,2021-10-25T12:51:33.17,0,True,0.0
2021,7,3164,570,24,8513,3,12,5,7,0,0,0,0,0,0,False,False,False,0,1,2022-02-16T16:06:37.317,0,False,0.0
2021,7,3164,575,24,6373,2,7,6,18,21,3,20,1,20,0,False,False,False,0,3,2021-10-25T12:55:40.14,21,False,1.0
2021,7,3164,605,23,4307,2,48,5,-5,-1,4,-1,0,-1,0,False,False,False,0,1,2021-10-25T13:07:25.74,-1,False,0.0
2021,7,3164,635,24,6373,2,7,2,18,25,7,23,2,23,0,False,False,False,0,4,2021-10-28T14:50:15.81,25,False,2.0
2021,7,3164,680,23,7240,2,11,6,18,29,11,21,8,21,0,False,False,False,1,1,2021-10-28T15:05:09.19,29,False,8.0
2021,7,3164,700,23,3843,2,46,3,0,3,3,2,1,2,0,False,False,False,0,1,2021-10-25T13:39:33.933,3,False,1.0
2021,7,3164,730,24,7800,13,35,6,50,0,0,0,0,0,0,False,False,False,0,3,2021-10-28T15:05:09.22,0,True,0.0
2021,7,3164,735,24,8513,2,16,9,3,15,12,11,4,11,0,False,False,False,0,1,2022-02-24T18:54:01.673,15,False,4.0
2021,7,3164,740,24,8509,2,3,5,12,20,8,12,8,12,0,False,False,False,1,2,2021-10-25T13:50:54.45,20,False,8.0
2021,7,3164,745,24,8513,3,16,10,2,0,0,0,0,0,0,False,False,False,0,1,2021-10-25T13:52:32.747,0,False,0.0
2021,7,3164,750,24,8513,2,28,4,2,7,5,5,2,5,0,False,False,False,0,1,2021-10-25T13:54:38.547,7,False,2.0
2021,7,3164,760,24,6389,13,28,10,2,0,0,0,0,0,0,False,False,False,0,1,2021-10-28T15:08:22.29,0,True,0.0
2021,7,3164,765,24,6389,2,16,9,2,5,3,2,3,2,0,False,False,False,0,1,2021-10-25T14:03:06.27,5,False,3.0
2021,7,3164,770,24,8509,2,3,5,6,6,0,6,0,6,0,False,False,False,0,2,2021-10-28T15:05:09.237,6,False,0.0
2021,7,3164,780,24,7800,13,12,2,17,0,0,0,0,0,0,False,False,False,0,3,2021-10-28T14:53:53.237,0,True,0.0
2021,7,3164,785,24,7798,2,12,10,12,17,5,17,0,17,6,False,False,False,0,2,2021-10-28T14:54:54.78,17,True,0.0
2021,7,3164,830,24,7800,2,4,4,10,10,0,10,0,10,0,False,False,False,0,3,2021-10-25T14:32:21.727,10,False,0.0
2021,7,3164,840,24,7798,2,3,5,10,8,-2,8,0,8,0,False,False,False,0,2,2021-10-25T14:34:02.413,8,False,0.0
2021,7,3164,845,24,6373,13,12,2,34,0,0,0,0,0,0,False,False,False,0,3,2021-10-25T14:36:21.547,0,True,0.0
2021,7,3164,850,24,8509,2,5,5,7,7,0,7,0,7,0,False,False,False,0,3,2021-10-25T14:39:02.8,7,True,0.0
2021,7,3164,860,24,8513,2,47,5,3,6,3,6,0,6,0,False,False,False,0,1,2021-10-25T14:46:00.32,6,True,0.0
2021,7,3165,10,1,910,2,2,10,11,13,2,12,1,12,0,True,False,False,0,3,2022-02-16T14:34:58.48,13,False,1.0
2021,7,3165,15,1,894,2,33,10,6,11,5,8,3,8,0,False,False,False,0,4,2022-02-16T14:35:24.483,11,False,3.0
2021,7,3165,20,1,8439,13,50,10,-4,0,0,0,0,0,0,False,False,False,0,3,2021-10-25T09:20:20.467,0,False,0.0
2021,7,3165,30,1,8439,2,52,4,2,1,-1,1,0,1,0,False,False,False,0,3,2021-10-26T17:57:52.18,1,False,0.0
2021,7,3165,40,13,902,2,4,4,3,3,0,3,0,3,0,False,False,False,0,1,2021-10-25T09:26:59.33,3,False,0.0
2021,7,3165,45,13,100,13,5,5,5,0,0,0,0,0,0,False,False,False,0,3,2021-10-28T19:15:57.37,0,False,0.0
2021,7,3165,90,13,902,2,47,10,-1,10,11,8,2,8,0,False,False,False,0,1,2021-10-25T09:43:22.717,10,False,2.0
2021,7,3165,100,13,100,2,6,10,6,10,4,10,0,10,0,False,False,False,0,3,2021-10-28T19:16:19.05,10,False,0.0
2021,7,3165,120,13,2455,2,48,10,-3,0,3,0,0,0,0,False,False,False,0,1,2021-10-25T09:54:11.303,0,False,0.0
2021,7,3165,140,13,8417,2,39,10,14,22,8,19,3,19,0,False,False,False,0,3,2021-10-25T10:02:23.657,22,False,3.0
2021,7,3165,155,13,6528,2,4,4,5,5,0,5,0,5,0,False,False,False,0,4,2021-10-28T20:05:47.817,5,False,0.0
2021,7,3165,160,13,4662,2,47,5,1,5,4,3,2,3,0,False,False,False,0,4,2021-10-28T20:17:01.563,5,False,2.0
2021,7,3165,185,1,245,13,4,5,11,0,0,0,0,0,0,False,False,False,0,2,2021-10-25T10:17:51.69,0,False,0.0
2021,7,3165,190,1,894,2,13,9,3,8,5,6,2,6,0,False,False,False,0,3,2021-10-25T10:19:46.263,8,False,2.0
2021,7,3165,200,1,245,2,5,3,10,10,0,10,0,10,0,False,False,False,0,2,2021-10-28T19:16:33.39,10,False,0.0
2021,7,3165,205,1,245,2,18,3,0,6,6,4,2,4,0,False,False,False,0,2,2021-10-25T10:23:48.077,6,False,2.0
2021,7,3165,225,1,245,13,7,2,23,0,0,0,0,0,0,False,False,False,0,3,2021-10-28T19:16:42.06,0,False,0.0
2021,7,3165,230,1,6405,2,35,3,13,13,0,13,0,13,0,False,False,False,0,3,2021-10-28T19:59:08.733,13,False,0.0
2021,7,3165,245,1,245,2,42,10,1,1,0,1,0,1,6,False,False,False,0,2,2022-02-16T14:36:21.913,1,True,0.0
2021,7,3165,260,13,876,2,50,10,-2,0,2,0,0,0,0,False,False,False,0,2,2021-10-25T10:41:11.343,0,False,0.0
2021,7,3165,270,13,100,2,50,10,-4,-1,3,-3,2,-3,0,False,False,False,0,3,2021-10-25T10:44:45.387,-1,False,2.0
2021,7,3165,280,13,876,2,5,6,17,18,1,18,0,18,0,False,False,False,0,3,2021-10-28T20:06:20.377,18,True,0.0
2021,7,3165,305,1,6405,13,20,1,19,0,0,0,0,0,0,False,False,False,0,3,2021-10-28T19:17:52.813,0,False,0.0
2021,7,3165,315,1,910,2,19,2,40,41,1,41,0,41,0,False,False,False,0,2,2021-10-25T11:01:10.78,41,False,0.0
2021,7,3165,325,1,6405,2,4,10,5,5,0,5,0,5,6,False,False,False,0,2,2021-10-28T20:00:25.85,5,True,0.0
2021,7,3165,380,1,6405,2,35,9,14,19,5,19,0,19,0,False,False,False,0,3,2021-10-25T14:03:57.367,19,False,0.0
2021,7,3165,385,1,245,2,12,6,15,15,0,15,0,15,0,False,False,False,0,2,2021-10-28T20:00:41.317,15,False,0.0
2021,7,3165,390,1,8439,2,50,10,0,16,16,15,1,15,0,False,False,False,1,3,2021-10-25T11:19:20.913,16,False,1.0
2021,7,3165,425,1,894,13,4,4,12,0,0,0,0,0,0,False,False,False,0,3,2021-10-28T19:19:03.27,0,False,0.0
2021,7,3165,450,13,8417,3,35,10,10,0,0,0,0,0,0,True,False,False,0,3,2021-10-26T15:12:04.023,0,False,0.0
2021,7,3165,460,13,6528,2,4,9,2,8,6,5,3,5,0,False,False,False,2,2,2021-10-28T20:02:42.247,8,False,3.0
2021,7,3165,475,13,8417,2,5,5,5,6,1,5,1,5,0,False,False,False,0,3,2021-10-26T15:10:34.323,6,False,1.0
2021,7,3165,480,13,2455,2,4,4,5,5,0,5,0,5,0,False,False,False,0,1,2021-10-25T11:41:22.58,5,False,0.0
2021,7,3165,490,1,245,2,4,9,2,2,0,2,0,2,0,False,False,False,1,2,2022-02-16T14:39:46.723,2,False,0.0
2021,7,3165,495,1,245,2,4,4,11,11,0,11,0,11,0,False,False,False,0,2,2021-10-25T11:48:06.323,11,False,0.0
2021,7,3165,505,1,910,2,2,10,11,12,1,12,0,12,0,False,False,False,0,2,2021-10-25T11:50:57.507,12,False,0.0
2021,7,3165,515,1,6405,2,2,4,11,13,2,13,0,13,0,False,False,False,0,3,2021-10-28T19:52:19.117,13,False,0.0
2021,7,3165,520,1,894,2,8,7,17,47,30,47,0,47,6,False,False,False,0,4,2022-02-16T14:40:30.193,47,True,0.0
2021,7,3165,535,13,2455,2,47,5,2,2,0,2,0,2,0,False,False,False,0,4,2021-10-25T11:58:12.01,2,False,0.0
2021,7,3165,545,13,2455,13,32,5,-4,0,0,0,0,0,0,False,False,False,0,1,2021-10-26T15:11:32.037,0,False,0.0
2021,7,3165,560,1,6406,3,45,5,-3,0,0,0,0,0,0,False,False,False,0,1,2022-02-16T14:41:18.513,0,False,0.0
2021,7,3165,580,1,894,13,4,4,22,0,0,0,0,0,0,False,False,False,0,3,2021-10-28T19:59:49.93,0,False,0.0
2021,7,3165,585,13,876,2,5,3,4,4,0,4,0,4,0,False,False,False,0,2,2021-10-28T19:19:14.63,4,False,0.0
2021,7,3165,590,13,902,2,4,10,3,5,2,5,0,5,0,False,False,False,0,1,2021-10-25T12:15:08.377,5,False,0.0
2021,7,3165,595,13,902,13,4,5,4,0,0,0,0,0,0,False,False,False,0,2,2021-10-25T16:50:40.23,0,False,
2021,7,3165,600,13,876,2,50,10,-3,-3,0,-3,0,-3,0,False,False,False,0,2,2021-10-25T12:18:56.573,-3,False,0.0
2021,7,3165,620,1,6406,13,32,10,0,0,0,0,0,0,0,False,False,False,0,3,2021-10-25T12:24:44.097,0,False,0.0
2021,7,3165,635,13,4662,2,47,10,-1,1,2,-1,2,-1,0,False,False,False,1,4,2021-10-28T20:09:59.753,1,False,2.0
2021,7,3165,650,13,876,3,5,3,5,0,0,0,0,0,0,True,False,False,0,3,2021-10-25T12:34:50.633,0,False,0.0
2021,7,3165,655,1,6406,2,48,9,-5,9,14,7,2,7,0,False,False,False,0,1,2022-02-16T14:41:50.833,9,False,2.0
2021,7,3165,680,1,245,2,4,3,5,8,3,6,2,6,0,False,False,False,0,2,2022-02-16T14:42:17.21,8,False,2.0
2021,7,3165,700,13,876,2,5,3,2,2,0,2,0,2,0,False,False,False,0,2,2021-10-25T12:49:10.96,2,False,0.0
2021,7,3165,710,13,8417,13,29,2,20,0,0,0,0,0,0,False,False,False,0,2,2021-10-25T13:35:41.693,0,False,0.0
2021,7,3165,755,13,6481,2,51,10,-6,3,9,-1,4,-1,0,False,False,False,0,1,2021-10-26T15:10:57.623,3,False,
2021,7,3165,760,13,2455,2,4,3,6,10,4,7,3,7,0,False,False,False,0,2,2021-10-25T13:08:05.063,10,False,3.0
2021,7,3165,765,13,100,2,5,3,7,8,1,8,0,8,0,False,False,False,0,3,2021-10-25T13:11:31.82,8,True,0.0
2021,7,3165,770,13,2455,2,2,3,8,10,2,9,1,9,0,False,False,False,1,2,2021-10-28T20:10:56.503,10,False,1.0
2021,7,3165,780,13,876,13,8,7,22,0,0,0,0,0,0,False,False,False,0,3,2021-10-25T13:16:38.763,0,False,0.0
2021,7,3165,785,13,4662,2,47,10,1,5,4,4,1,4,0,False,False,False,0,4,2021-10-25T13:18:17.827,5,False,1.0
2021,7,3165,790,13,8417,13,7,6,17,0,0,0,0,0,0,False,False,False,0,2,2021-10-25T13:20:04.64,0,False,0.0
2021,7,3165,795,13,100,13,5,3,5,0,0,0,0,0,0,False,False,False,0,2,2022-02-25T17:35:20.623,0,False,0.0
2021,7,3166,20,6,2714,2,32,3,6,6,0,6,0,6,0,False,False,False,0,4,2021-10-28T18:56:28.57,6,False,0.0
2021,7,3166,30,30,4516,13,7,6,20,0,0,0,0,0,0,False,False,False,0,4,2021-10-25T09:31:57.843,0,False,
2021,7,3166,70,6,7728,3,5,9,7,0,0,0,0,0,0,False,False,False,0,3,2021-10-25T09:53:50.08,0,False,0.0
2021,7,3166,85,30,793,13,6,9,4,0,0,0,0,0,0,False,False,False,0,3,2022-02-25T15:25:59.55,0,False,0.0
2021,7,3166,90,30,931,2,48,10,-6,-4,2,-6,2,-6,0,False,False,False,0,1,2021-10-25T10:03:50.717,-4,False,2.0
2021,7,3166,100,6,7728,2,4,10,5,5,0,5,0,5,0,False,False,False,0,4,2021-10-25T10:07:28.37,5,False,0.0
2021,7,3166,105,6,7725,13,4,5,6,0,0,0,0,0,0,False,False,False,0,2,2021-10-25T10:10:54.943,0,False,0.0
2021,7,3166,110,6,464,13,12,2,26,0,0,0,0,0,0,False,False,False,0,3,2021-10-28T20:44:38.057,0,False,0.0
2021,7,3166,115,30,4516,2,2,9,5,6,1,5,1,5,0,False,False,False,0,3,2021-10-25T10:18:18.39,6,False,1.0
2021,7,3166,120,30,7893,2,49,3,-2,4,6,2,2,2,0,False,False,False,0,2,2022-03-08T19:09:22.553,4,False,2.0
2021,7,3166,125,30,4516,2,17,7,17,21,4,17,4,17,0,False,False,False,0,4,2021-10-25T10:24:43.62,21,False,4.0
2021,7,3166,130,30,2290,13,6,9,9,0,0,0,0,0,0,True,False,False,0,3,2021-10-25T10:26:22.8,0,False,0.0
2021,7,3166,140,30,4516,2,17,9,4,4,0,4,0,4,6,True,False,False,0,3,2021-10-25T10:32:54.763,4,True,0.0
2021,7,3166,165,6,8365,2,47,10,2,5,3,4,1,4,0,False,False,False,0,1,2022-03-08T19:09:43.96,5,False,1.0
2021,7,3166,180,30,793,2,6,9,11,11,0,11,0,11,0,False,False,False,2,3,2021-10-25T10:53:17.043,11,False,0.0
2021,7,3166,195,30,2290,13,5,5,9,0,0,0,0,0,0,False,False,False,0,3,2021-10-25T11:01:46.817,0,False,0.0
2021,7,3166,200,30,793,2,2,10,8,9,1,9,0,9,6,False,False,False,0,3,2021-10-28T20:46:00.95,9,False,0.0
2021,7,3166,215,6,7728,2,53,9,-2,5,7,2,3,2,0,False,False,False,0,4,2021-10-25T11:09:45.993,5,False,3.0
2021,7,3166,225,6,1400,2,46,3,2,3,1,3,0,3,0,True,False,False,0,1,2022-03-08T19:10:01.993,3,False,0.0
2021,7,3166,230,6,7725,3,4,9,9,0,0,0,0,0,0,False,False,False,0,2,2021-10-25T11:17:35.043,0,False,0.0
2021,7,3166,250,30,793,13,29,6,15,0,0,0,0,0,0,False,False,False,0,2,2021-10-28T20:58:26.343,0,False,0.0
2021,7,3166,255,30,793,13,4,5,4,0,0,0,0,0,0,False,False,False,0,2,2021-10-25T11:27:10.373,0,False,0.0
2021,7,3166,260,30,4516,13,6,9,13,0,0,0,0,0,0,False,False,False,0,2,2021-10-25T11:30:11.43,0,False,0.0
2021,7,3166,275,6,2714,2,47,5,1,6,5,2,4,2,0,False,False,False,1,4,2021-10-28T20:58:49.767,6,False,4.0
2021,7,3166,280,6,8365,2,4,10,2,3,1,3,0,3,0,False,False,False,0,1,2021-10-28T20:59:43.853,3,False,0.0
2021,7,3166,290,30,2290,13,17,9,14,0,0,0,0,0,0,False,False,False,0,4,2021-10-28T20:43:43.223,0,False,0.0
2021,7,3166,295,30,4937,13,2,9,3,0,0,0,0,0,0,False,False,False,0,2,2021-10-25T11:51:01.763,0,False,0.0
2021,7,3166,300,30,4523,13,17,10,9,0,0,0,0,0,0,False,False,False,0,4,2021-10-25T11:55:11.68,0,False,0.0
2021,7,3166,310,6,7725,2,7,2,16,17,1,17,0,17,0,False,False,False,0,3,2021-10-25T11:57:42.417,17,False,0.0
2021,7,3166,335,6,464,2,4,3,4,4,0,4,0,4,0,False,False,False,0,2,2021-10-25T12:15:29.9,4,False,0.0
2021,7,3166,355,6,6782,13,9,3,10,0,0,0,0,0,0,False,False,False,0,2,2022-02-16T17:08:35.173,0,False,0.0
2021,7,3166,380,30,4516,2,5,3,10,10,0,10,0,10,0,True,False,False,0,3,2021-10-25T16:43:23.42,10,False,0.0
2021,7,3166,385,30,793,2,19,6,39,46,7,39,7,39,0,False,False,False,0,2,2021-10-25T12:34:38.56,46,False,7.0
2021,7,3166,390,30,793,2,29,3,2,2,0,2,0,2,6,False,False,False,0,2,2021-10-28T20:40:32.783,2,True,0.0
2021,7,3166,410,6,464,2,4,10,4,12,8,10,2,10,0,False,False,False,1,3,2021-10-25T12:43:54.973,12,False,2.0
2021,7,3166,420,6,1378,13,2,9,4,0,0,0,0,0,0,False,False,False,0,2,2021-10-28T20:40:09.39,0,False,0.0
2021,7,3166,440,30,4516,13,24,6,43,0,0,0,0,0,0,False,False,False,0,3,2021-10-28T18:56:28.6,0,False,0.0
2021,7,3166,445,30,931,2,4,10,6,9,3,7,2,7,0,False,False,False,0,1,2021-10-25T13:10:14.093,9,False,2.0
2021,7,3166,455,30,793,13,29,2,22,0,0,0,0,0,0,False,False,False,0,3,2021-10-25T13:15:55.93,0,False,
2021,7,3166,460,30,4516,2,50,9,-3,14,17,12,2,12,0,False,False,False,1,3,2021-10-25T13:18:47.737,14,False,2.0
2021,7,3166,465,30,931,13,5,3,4,0,0,0,0,0,0,False,False,False,0,1,2021-10-25T13:20:14.583,0,False,0.0
2021,7,3166,470,30,4937,2,48,9,-2,0,2,-1,1,-1,0,False,False,False,0,1,2021-10-25T13:21:51.923,0,False,1.0
2021,7,3166,480,30,4937,2,12,10,3,9,6,8,1,8,0,True,False,False,0,1,2022-02-24T14:06:55.257,9,False,1.0
2021,7,3166,495,30,4523,13,7,5,8,0,0,0,0,0,0,False,False,False,0,4,2021-10-25T13:29:05.637,0,False,0.0
2021,7,3166,500,30,793,13,6,9,8,0,0,0,0,0,0,False,False,False,0,2,2021-10-25T13:31:21.673,0,False,0.0
2021,7,3166,505,30,793,2,2,10,8,8,0,8,0,8,6,False,False,False,0,2,2021-10-25T13:38:10.193,8,True,0.0
2021,7,3166,535,30,4523,2,39,10,5,9,4,8,1,8,0,False,False,False,0,3,2022-03-08T19:11:08.28,9,False,1.0
2021,7,3166,555,30,4516,2,6,10,5,7,2,6,1,6,0,False,False,False,0,3,2021-10-25T14:00:22.667,7,False,1.0
2021,7,3166,575,6,1378,2,51,10,-6,4,10,4,0,4,0,True,False,False,0,1,2021-10-26T16:27:26.983,4,False,0.0
2021,7,3166,580,6,3233,2,18,3,0,10,10,10,0,10,0,False,False,False,0,2,2021-10-28T18:56:28.617,10,False,0.0
2021,7,3166,585,6,7725,2,35,6,20,22,2,22,0,22,0,False,False,False,0,3,2021-10-25T14:14:36.267,22,False,0.0
2021,7,3166,590,6,8365,2,34,9,-4,20,24,14,6,14,0,True,False,False,1,2,2021-10-25T14:17:13.33,20,False,6.0
2021,7,3166,600,6,7728,2,5,5,4,6,2,4,2,4,0,False,False,False,0,3,2022-03-08T19:11:32.743,6,False,2.0
2021,7,3166,605,6,1400,13,12,3,8,0,0,0,0,0,0,False,False,False,0,1,2021-10-28T20:44:23.567,0,False,
2021,7,3166,610,6,7725,13,5,9,9,0,0,0,0,0,0,False,False,False,0,3,2021-10-28T20:44:52.813,0,False,0.0
2021,7,3166,620,30,7893,2,18,3,-1,12,13,10,2,10,0,False,False,False,1,2,2021-10-28T18:56:28.63,12,False,2.0
2021,7,3166,660,30,793,2,49,3,-1,0,1,-1,1,-1,0,False,False,False,0,2,2021-10-28T20:40:45.31,0,False,1.0
2021,7,3166,670,30,4516,13,35,9,2,0,0,0,0,0,0,False,False,False,0,4,2021-10-25T15:02:33.17,0,False,0.0
2021,7,3166,695,6,464,13,19,2,36,0,0,0,0,0,0,False,False,False,0,2,2021-10-28T20:45:06.037,0,False,0.0
2021,7,3166,705,30,4516,2,17,7,20,34,14,27,7,27,0,False,False,False,0,3,2021-10-25T15:15:59.657,34,False,7.0
2021,7,3166,715,30,2290,13,16,9,4,0,0,0,0,0,0,True,False,False,0,3,2021-10-28T21:13:47.16,0,False,0.0
2021,7,3166,720,30,4937,13,4,10,3,0,0,0,0,0,0,False,False,False,0,1,2021-10-25T15:21:52.633,0,False,0.0
2021,7,3166,740,6,7728,2,4,10,12,22,10,13,9,13,0,False,False,False,0,3,2021-10-25T15:27:20.5,22,False,9.0
2021,7,3166,750,6,1378,2,4,9,5,12,7,9,3,9,0,False,False,False,0,3,2021-10-28T20:46:44.1,12,False,3.0
2021,7,3166,760,6,8365,2,12,10,-8,-6,2,-7,1,-7,0,False,False,False,0,1,2021-10-25T17:06:38.49,-6,False,1.0
2021,7,3166,780,30,4516,2,50,10,-4,15,19,11,4,11,0,False,False,False,0,2,2021-10-25T16:22:55.367,15,False,4.0
2021,7,3166,805,30,6565,2,32,3,-2,0,2,-2,2,-2,0,False,False,False,0,4,2021-10-28T20:47:07.21,0,False,2.0
2021,7,3166,810,30,8307,13,3,3,13,0,0,0,0,0,0,False,False,False,0,2,2021-10-25T15:59:02.433,0,False,0.0
2021,7,3166,845,6,8365,2,48,10,-6,11,17,5,6,5,0,False,False,False,0,1,2021-10-25T16:08:16.02,11,False,6.0
2021,7,3166,850,6,1378,13,2,8,16,0,0,0,0,0,0,False,False,False,0,3,2021-10-28T21:07:01.05,0,False,0.0
2021,7,3166,860,6,2714,2,32,5,2,8,6,3,5,3,0,False,False,False,1,4,2021-10-25T16:13:49.743,8,False,5.0
2021,7,3166,870,6,7728,2,13,9,2,5,3,3,2,3,0,False,False,False,0,3,2021-10-25T16:15:52.513,5,False,2.0
2021,7,3166,875,6,6337,2,4,10,4,4,0,4,0,4,0,False,False,False,0,1,2021-10-25T16:17:07.24,4,False,0.0
2021,7,3167,10,28,7224,2,13,9,7,9,2,9,0,9,0,False,False,False,0,2,2021-10-25T09:07:09.063,9,False,0.0
2021,7,3167,25,28,6410,2,35,3,9,9,0,9,0,9,0,False,False,False,0,3,2021-10-28T21:30:30.853,9,False,0.0
2021,7,3167,70,28,7224,2,51,3,-5,0,5,-5,5,-5,0,True,False,False,0,1,2021-10-26T18:11:56.087,0,False,5.0
2021,7,3167,75,28,7224,13,35,5,5,0,0,0,0,0,0,False,False,False,0,2,2021-10-25T09:39:49.853,0,False,0.0
2021,7,3167,80,28,7751,13,12,2,16,0,0,0,0,0,0,False,False,False,0,1,2021-10-28T21:53:17.617,0,False,0.0
2021,7,3167,95,14,7582,2,48,9,-4,-1,3,-2,1,-2,0,False,False,False,0,1,2021-10-25T09:44:48.297,-1,False,1.0
2021,7,3167,100,14,4449,13,6,10,8,0,0,0,0,0,0,False,False,False,0,2,2021-10-28T16:19:54.01,0,False,0.0
2021,7,3167,105,14,7584,2,24,6,52,57,5,52,5,52,0,False,False,False,0,2,2021-10-25T11:44:52.193,57,False,5.0
2021,7,3167,120,14,5197,2,46,3,1,11,10,11,0,11,6,False,False,False,0,4,2021-10-25T09:57:14.547,11,True,0.0
2021,7,3167,140,28,7224,2,35,6,15,28,13,15,13,15,0,False,False,False,0,3,2021-10-28T17:20:01.033,28,False,13.0
2021,7,3167,155,28,7751,13,11,6,17,0,0,0,0,0,0,False,False,False,0,1,2021-10-28T21:34:38.42,0,False,0.0
2021,7,3167,170,14,4449,13,3,6,20,0,0,0,0,0,0,False,False,False,0,2,2021-11-24T22:18:06.993,0,False,0.0
2021,7,3167,175,14,6543,13,48,9,-7,0,0,0,0,0,0,False,False,False,0,1,2021-10-25T23:59:38.83,0,False,0.0
2021,7,3167,180,14,6529,13,8,1,42,0,0,0,0,0,0,False,False,False,0,3,2021-10-28T16:19:54.023,0,False,
2021,7,3167,210,28,6410,13,35,8,19,0,0,0,0,0,0,False,False,False,0,3,2021-10-25T10:35:55.473,0,False,0.0
2021,7,3167,220,28,7751,13,26,3,2,0,0,0,0,0,0,False,False,False,0,1,2021-10-26T18:08:01.303,0,False,0.0
2021,7,3167,240,14,8400,13,9,2,19,0,0,0,0,0,0,False,False,False,0,3,2021-10-25T10:48:47.32,0,False,0.0
2021,7,3167,245,14,7495,2,50,9,-1,-2,-1,-2,0,-2,0,False,False,False,0,2,2021-10-25T10:50:08.1,-2,False,0.0
2021,7,3167,250,14,7495,13,12,5,10,0,0,0,0,0,0,False,False,False,0,2,2021-10-28T17:22:48.063,0,False,0.0
2021,7,3167,285,14,4449,2,47,5,2,2,0,2,0,2,0,True,False,False,0,4,2021-10-26T20:15:00.93,2,False,0.0
2021,7,3167,290,14,6543,3,9,2,16,0,0,0,0,0,0,False,False,False,0,3,2021-10-25T11:04:16.167,0,False,0.0
2021,7,3167,305,28,7224,3,50,3,-3,0,0,0,0,0,0,False,False,False,0,2,2021-10-28T21:37:12.51,0,False,0.0
2021,7,3167,310,28,6627,13,5,3,11,0,0,0,0,0,0,True,False,False,0,3,2021-10-26T18:13:01.267,0,False,0.0
2021,7,3167,330,14,7582,2,28,9,-4,-1,3,-1,0,-1,0,False,False,False,0,1,2021-10-28T21:37:37.98,-1,False,0.0
2021,7,3167,350,28,7224,2,35,9,8,10,2,10,0,10,0,False,True,True,0,3,2021-10-25T11:31:42.02,10,False,0.0
2021,7,3167,370,14,7584,13,21,2,20,0,0,0,0,0,0,False,False,False,0,2,2021-10-28T16:19:54.023,0,False,
2021,7,3167,375,14,1119,13,47,5,1,0,0,0,0,0,0,False,False,False,0,1,2021-10-25T11:40:24.693,0,False,0.0
2021,7,3167,445,14,4449,2,49,10,-2,-1,1,-1,0,-1,0,False,False,False,0,3,2021-10-25T11:56:26.93,-1,False,0.0
2021,7,3167,450,14,5197,2,39,4,4,5,1,4,1,4,0,False,False,False,0,4,2021-10-25T11:57:38.177,5,False,1.0
2021,7,3167,455,14,6529,2,13,9,5,5,0,5,0,5,0,False,False,False,0,3,2021-10-28T16:19:54.023,5,False,0.0
2021,7,3167,490,28,7224,2,35,4,10,10,0,10,0,10,0,False,False,False,0,3,2021-11-24T22:21:18.347,10,False,0.0
2021,7,3167,510,28,917,2,6,4,12,16,4,12,4,12,0,False,False,False,0,3,2021-10-28T21:39:38.92,16,False,4.0
2021,7,3167,515,28,7224,13,35,4,8,0,0,0,0,0,0,False,False,False,0,3,2021-10-28T21:40:27.733,0,False,0.0
2021,7,3167,530,14,7584,2,12,10,11,13,2,13,0,13,0,False,False,False,0,3,2022-02-24T14:08:48.183,13,False,
2021,7,3167,535,14,7584,13,21,2,42,0,0,0,0,0,0,False,False,False,0,3,2021-10-28T21:43:28.223,0,False,
2021,7,3167,560,28,7224,2,6,4,12,12,0,12,0,12,0,False,False,False,0,3,2022-01-19T20:14:49.903,12,False,
2021,7,3167,565,28,7224,2,12,4,9,13,4,9,4,9,0,False,False,False,1,2,2022-02-24T14:09:22.337,13,False,
2021,7,3167,570,28,7753,3,50,10,-4,0,0,0,0,0,0,False,False,False,0,2,2021-10-25T12:41:20.66,0,False,0.0
2021,7,3167,575,28,7619,2,4,5,6,6,0,6,0,6,0,False,False,False,0,2,2021-10-25T12:42:20.383,6,False,0.0
2021,7,3167,580,28,7751,2,51,9,-6,1,7,0,1,0,0,False,False,False,0,1,2021-10-25T12:44:01.407,1,False,1.0
2021,7,3167,600,14,6543,2,48,9,-5,-2,3,-4,2,-4,0,False,False,False,0,1,2021-10-25T12:48:01.78,-2,False,2.0
2021,7,3167,620,28,7224,2,35,2,23,29,6,23,6,23,0,False,False,False,0,3,2021-10-26T18:10:14.457,29,False,6.0
2021,7,3167,625,28,7760,2,7,2,25,27,2,25,2,25,0,False,False,False,0,4,2021-10-28T21:46:06.667,27,False,2.0
2021,7,3167,630,28,7224,2,12,10,12,14,2,14,0,14,6,False,False,False,0,3,2021-10-25T12:57:05.59,14,True,0.0
2021,7,3167,650,14,7495,2,49,5,-4,2,6,0,2,0,0,False,False,False,0,2,2021-10-25T13:06:53.217,2,False,2.0
2021,7,3167,655,14,7584,2,12,9,9,14,5,11,3,11,0,False,False,False,0,2,2021-10-28T21:56:44.477,14,False,3.0
2021,7,3167,660,14,4449,2,46,3,4,13,9,13,0,13,0,False,False,False,0,4,2021-10-28T17:15:49.307,13,False,0.0
2021,7,3167,665,14,7495,13,8,8,39,0,0,0,0,0,0,False,False,False,0,2,2021-10-28T21:46:53.707,0,False,0.0
2021,7,3167,685,14,5197,2,13,10,3,9,6,6,3,6,0,False,False,False,0,4,2021-10-25T13:23:15.96,9,False,3.0
2021,7,3167,695,14,7582,2,32,10,-4,5,9,2,3,2,0,False,False,False,0,1,2021-10-28T17:18:14.427,5,False,3.0
2021,7,3167,715,28,7760,2,46,3,2,3,1,3,0,3,0,True,False,False,0,4,2022-01-02T20:27:54.277,3,False,0.0
2021,7,3167,720,28,7224,13,4,3,5,0,0,0,0,0,0,False,False,False,0,2,2021-10-28T21:48:47.577,0,False,0.0
2021,7,3167,735,14,7584,2,6,10,5,6,1,5,1,5,0,True,False,False,0,2,2021-10-28T16:19:54.023,6,False,1.0
2021,7,3167,750,14,4449,13,26,5,8,0,0,0,0,0,0,True,False,False,0,3,2021-10-28T21:49:34.317,0,False,0.0
2021,7,3167,755,14,7584,2,21,2,23,28,5,23,5,23,6,False,False,False,0,2,2021-10-25T13:51:07.147,28,False,5.0
2021,7,3167,770,28,7751,2,4,4,2,9,7,8,1,8,0,False,False,False,0,1,2021-10-26T18:11:15.837,9,False,1.0
2021,7,3167,775,28,6627,2,39,4,5,5,0,4,1,4,0,False,False,False,0,3,2021-10-25T13:58:37.01,5,False,1.0
2021,7,3167,780,28,7751,2,46,3,2,5,3,5,0,5,0,False,False,False,0,1,2021-10-25T14:02:30.917,5,False,0.0
2021,7,3167,790,28,7753,13,17,1,27,0,0,0,0,0,0,False,False,False,0,3,2021-10-28T21:50:50.3,0,False,0.0
2021,7,3168,40,20,6388,13,17,7,32,0,0,0,0,0,0,False,False,False,0,3,2021-10-27T19:23:28.993,0,False,0.0
2021,7,3168,50,20,6388,13,38,4,2,0,0,0,0,0,0,False,False,False,0,3,2022-02-16T16:53:19.907,0,False,0.0
2021,7,3168,65,27,7408,2,19,2,26,84,58,33,51,33,6,False,False,False,1,2,2021-10-26T09:33:30.293,84,False,51.0
2021,7,3168,85,20,7888,2,53,10,-2,13,15,10,3,10,0,False,False,False,0,4,2021-10-26T09:38:15.993,13,False,3.0
2021,7,3168,95,20,8127,2,6,9,7,8,1,7,1,7,0,False,False,False,0,2,2021-10-26T09:47:52.063,8,False,1.0
2021,7,3168,100,20,2136,13,8,6,43,0,0,0,0,0,0,False,False,False,0,4,2022-01-05T15:51:19.417,0,False,0.0
2021,7,3168,110,20,5140,2,50,9,-2,6,8,4,2,4,0,False,False,False,0,2,2021-10-28T18:18:28.73,6,False,2.0
2021,7,3168,125,27,650,2,5,5,5,5,0,5,0,5,0,False,False,False,0,3,2021-10-28T17:46:51.307,5,True,0.0
2021,7,3168,140,27,4850,2,53,5,-8,-4,4,-6,2,-6,0,False,False,False,0,3,2021-10-26T10:05:48.263,-4,False,2.0
2021,7,3168,145,27,4850,2,2,10,5,5,0,5,0,5,0,False,False,False,0,3,2021-10-26T10:07:12.42,5,False,0.0
2021,7,3168,155,20,5140,13,18,5,-3,0,0,0,0,0,0,False,False,False,0,2,2022-02-16T16:54:48.837,0,False,0.0
2021,7,3168,190,27,7496,13,13,5,7,0,0,0,0,0,0,False,False,False,0,3,2021-10-26T10:21:19.79,0,False,0.0
2021,7,3168,215,20,5140,2,48,9,-5,23,28,8,15,8,0,False,False,False,1,1,2021-10-26T14:22:36.643,23,False,15.0
2021,7,3168,230,20,8131,2,2,9,4,4,0,4,0,4,0,False,False,False,0,2,2021-10-26T10:42:19.073,4,False,
2021,7,3168,235,20,5140,2,46,3,1,7,6,5,2,5,0,False,False,False,0,1,2021-10-26T10:44:36.78,7,False,2.0
2021,7,3168,265,20,8131,2,4,10,14,14,0,14,0,14,0,False,False,False,0,2,2021-10-27T19:26:27.303,14,False,0.0
2021,7,3168,270,20,8131,2,5,5,5,5,0,5,0,5,0,False,False,False,0,3,2021-10-28T17:47:28.02,5,True,0.0
2021,7,3168,285,20,5140,2,47,5,3,9,6,7,2,7,0,False,False,False,0,1,2021-10-28T18:05:43.027,9,False,2.0
2021,7,3168,315,20,8131,13,17,4,1,0,0,0,0,0,0,False,False,False,0,3,2021-10-28T16:42:05.293,0,False,0.0
2021,7,3168,335,27,7852,2,4,9,7,10,3,8,2,8,0,False,False,False,0,3,2021-10-26T11:24:20.963,10,False,2.0
2021,7,3168,340,27,650,13,9,6,33,0,0,0,0,0,0,False,False,False,0,2,2021-10-26T11:26:51.49,0,False,0.0
2021,7,3168,345,27,4850,2,5,3,5,10,5,6,4,6,0,False,False,False,0,3,2021-10-27T14:50:43.583,10,False,4.0
2021,7,3168,370,27,7852,13,7,2,35,0,0,0,0,0,0,False,False,False,0,3,2021-10-26T11:39:48.527,0,False,0.0
2021,7,3168,380,20,5140,2,4,10,5,14,9,10,4,10,0,False,False,False,0,3,2021-10-26T11:41:39.927,14,False,4.0
2021,7,3168,385,20,2136,13,6,4,13,0,0,0,0,0,0,False,False,False,0,2,2021-10-28T16:42:05.323,0,False,0.0
2021,7,3168,395,20,5140,2,4,4,3,6,3,4,2,4,0,False,False,False,0,1,2021-10-26T11:45:33.673,6,False,2.0
2021,7,3168,405,20,5140,2,16,9,3,31,28,27,4,27,0,False,False,False,0,1,2021-10-26T11:47:48.723,31,False,4.0
2021,7,3168,410,20,7888,2,5,5,12,15,3,14,1,14,0,False,False,False,0,4,2022-01-05T16:48:55.683,15,False,1.0
2021,7,3168,415,20,5140,2,4,5,3,13,10,9,4,9,6,False,False,False,1,1,2022-04-27T18:20:07,13,False,4.0
2021,7,3168,430,27,4850,3,12,5,13,0,0,0,0,0,0,False,False,False,0,3,2022-02-16T16:59:32.317,0,False,
2021,7,3168,465,20,5140,2,5,5,4,6,2,6,0,6,0,False,False,False,0,1,2021-10-26T12:09:28.79,6,False,0.0
2021,7,3168,470,20,8131,13,4,10,4,0,0,0,0,0,0,False,False,False,0,3,2021-10-26T12:11:27.27,0,False,0.0
2021,7,3168,480,27,7852,2,12,5,-3,1,4,1,0,1,0,False,False,False,0,3,2022-02-24T14:12:57.027,1,False,0.0
2021,7,3168,490,27,650,2,26,9,7,7,0,7,0,7,0,True,False,False,0,2,2021-10-26T12:17:11.27,7,False,0.0
2021,7,3168,535,20,7361,2,46,3,3,7,4,7,0,7,0,False,False,False,0,1,2021-10-26T12:29:18.96,7,False,0.0
2021,7,3168,545,20,255,3,19,2,32,0,0,0,0,0,0,False,False,False,0,2,2021-10-28T16:42:05.357,0,False,0.0
2021,7,3168,550,20,2136,3,9,2,39,0,0,0,0,0,0,False,False,False,0,3,2022-02-23T18:56:50.067,0,False,0.0
2021,7,3168,595,20,5140,2,48,9,-6,13,19,2,11,2,0,False,False,False,0,1,2021-10-26T12:53:22.377,13,False,11.0
2021,7,3168,600,20,7888,2,31,9,0,8,8,7,1,7,0,False,True,True,0,4,2021-10-28T18:09:37.883,8,False,1.0
2021,7,3168,620,27,7852,13,5,3,13,0,0,0,0,0,0,False,False,False,0,3,2021-10-28T17:48:20.66,0,False,0.0
2021,7,3168,660,20,8131,2,12,10,7,30,23,28,2,28,0,False,False,False,0,2,2021-10-26T13:18:24.537,30,False,
2021,7,3168,670,20,8131,13,6,10,7,0,0,0,0,0,0,False,False,False,0,3,2022-01-05T17:12:53.73,0,False,0.0
2021,7,3168,685,27,7408,13,35,2,16,0,0,0,0,0,0,False,False,False,0,3,2021-10-26T13:29:16.097,0,False,0.0
2021,7,3168,690,27,7408,2,2,10,9,12,3,10,2,10,0,False,False,False,0,2,2021-10-26T13:30:48.2,12,False,2.0
2021,7,3168,700,27,3656,2,5,9,1,9,8,6,3,6,0,False,False,False,0,1,2021-10-26T13:38:12.187,9,False,3.0
2021,7,3168,710,27,7852,2,4,10,6,28,22,24,4,24,0,False,False,False,1,3,2021-10-28T17:51:37.2,28,False,4.0
2021,7,3168,720,27,7852,2,5,5,2,0,-2,0,0,0,0,False,False,False,0,3,2021-10-26T13:50:22.62,0,False,0.0
2021,7,3168,740,20,2408,13,45,10,-3,0,0,0,0,0,0,False,False,False,0,1,2021-10-26T13:54:44.307,0,False,0.0
2021,7,3168,750,20,255,13,12,2,33,0,0,0,0,0,0,False,False,False,0,3,2022-02-24T14:13:47.18,0,False,0.0
2021,7,3168,770,20,6388,13,11,5,10,0,0,0,0,0,0,False,False,False,0,3,2021-10-26T14:35:37.603,0,False,
2021,7,3168,775,20,6388,2,5,5,9,11,2,9,2,9,0,False,False,False,0,3,2021-10-28T16:42:05.357,11,False,2.0
2021,7,3168,780,20,8131,13,12,2,18,0,0,0,0,0,0,False,False,False,0,3,2021-10-26T14:13:53.61,0,False,0.0
2021,7,3168,790,20,8131,2,12,5,13,13,0,13,0,13,0,False,False,False,0,3,2022-02-24T14:14:22.263,13,True,0.0
2021,7,3168,830,27,7408,13,2,9,11,0,0,0,0,0,0,False,False,False,0,3,2021-10-26T14:27:05.027,0,False,0.0
2021,7,3168,855,27,7408,13,12,6,17,0,0,0,0,0,0,False,False,False,0,3,2021-10-26T14:30:37.43,0,False,0.0
2021,8,3169,15,12,4537,2,48,10,-2,9,11,7,2,7,0,False,False,False,0,1,2021-10-29T10:30:57.633,9,False,2.0
2021,8,3169,25,12,4537,13,47,10,-2,0,0,0,0,0,0,False,False,False,0,1,2021-10-29T10:37:24.877,0,False,0.0
2021,8,3169,60,12,8371,3,47,5,3,0,0,0,0,0,0,True,False,False,0,4,2021-10-29T10:54:39.817,0,False,0.0
2021,8,3169,65,12,8371,2,44,3,0,7,7,2,5,2,0,True,False,False,1,3,2022-02-16T17:52:35.3,7,False,5.0
2021,8,3169,70,12,4537,13,19,2,31,0,0,0,0,0,0,True,False,False,0,2,2021-11-04T18:58:42.733,0,False,0.0
2021,8,3169,85,1,894,2,31,10,2,4,2,4,0,4,0,False,False,False,0,3,2022-02-16T17:54:06.077,4,False,0.0
2021,8,3169,90,1,910,2,4,10,7,8,1,8,0,8,0,False,False,False,0,3,2021-10-29T11:08:57.503,8,False,0.0
2021,8,3169,95,1,245,2,24,6,35,58,23,50,8,50,0,False,False,False,0,2,2021-10-29T16:38:07.337,55,False,8.0
2021,8,3169,105,1,8439,2,34,4,-4,6,10,6,0,6,0,True,False,False,0,3,2021-10-30T20:54:35.457,6,False,0.0
2021,8,3169,145,12,4537,2,51,10,0,7,7,4,3,4,0,False,False,False,0,3,2021-11-04T18:33:40.483,7,False,3.0
2021,8,3169,155,12,4511,13,11,3,14,0,0,0,0,0,0,False,False,False,0,4,2021-11-04T18:58:51.26,0,False,0.0
2021,8,3169,170,12,6872,2,5,3,7,12,5,10,2,10,0,False,False,False,0,3,2021-11-04T17:25:53.907,12,False,2.0
2021,8,3169,175,12,6356,13,30,10,-1,0,0,0,0,0,0,True,False,False,0,4,2021-11-04T18:58:58.723,0,False,0.0
2021,8,3169,185,12,6872,2,4,9,5,4,-1,4,0,4,0,False,False,False,0,2,2021-11-04T18:19:18.627,4,False,0.0
2021,8,3169,210,12,4511,2,46,9,1,1,0,1,0,1,0,False,False,False,0,4,2022-02-16T17:56:04.317,1,False,0.0
2021,8,3169,235,1,6933,13,19,6,26,0,0,0,0,0,0,False,False,False,0,2,2021-10-29T12:13:27.72,0,False,0.0
2021,8,3169,255,12,4537,2,51,10,-1,4,5,0,4,0,0,True,False,False,0,3,2021-10-29T12:20:42.52,4,False,4.0
2021,8,3169,260,12,4511,2,13,10,6,15,9,11,4,11,0,False,False,False,0,2,2021-10-29T12:24:07.953,15,False,4.0
2021,8,3169,285,12,4537,2,50,9,-4,-2,2,-2,0,-2,0,True,False,False,0,2,2021-10-29T12:32:28.923,-2,False,0.0
2021,8,3169,295,12,467,13,24,10,3,0,0,0,0,0,0,False,False,False,0,4,2021-10-29T12:38:16.123,0,False,0.0
2021,8,3169,300,12,6872,13,35,9,3,0,0,0,0,0,0,False,False,False,0,3,2021-10-29T12:40:51.57,0,False,0.0
2021,8,3169,305,12,496,13,7,3,3,0,0,0,0,0,0,False,False,False,0,3,2021-10-29T12:42:22.83,0,False,0.0
2021,8,3169,325,1,6405,2,5,9,7,6,-1,6,0,6,0,False,False,False,0,3,2021-10-29T12:57:41.727,6,False,
2021,8,3169,335,1,910,13,12,6,16,0,0,0,0,0,0,False,False,False,0,3,2022-02-16T17:56:55.533,0,False,0.0
2021,8,3169,340,1,8439,13,13,4,3,0,0,0,0,0,0,True,False,False,0,3,2021-11-04T18:59:07.773,0,True,0.0
2021,8,3169,355,12,496,2,5,3,4,7,3,4,3,4,0,False,False,False,0,2,2021-11-04T18:33:58.87,7,False,3.0
2021,8,3169,385,12,6872,3,4,3,5,0,0,0,0,0,0,False,False,False,0,2,2021-10-29T13:11:30.77,0,False,0.0
2021,8,3169,395,12,4537,13,12,10,10,0,0,0,0,0,0,False,False,False,1,1,2021-11-04T17:28:30.107,0,False,0.0
2021,8,3169,405,12,496,13,19,1,52,0,0,0,0,0,0,False,False,False,0,3,2021-10-29T13:22:12.143,0,False,0.0
2021,8,3169,430,1,8439,3,50,9,5,0,0,0,0,0,0,False,False,False,0,3,2022-02-16T18:00:00.41,0,False,0.0
2021,8,3169,440,12,8371,13,51,9,0,0,0,0,0,0,0,True,False,False,0,3,2021-10-29T13:40:26.653,0,False,0.0
2021,8,3169,455,12,6356,2,5,3,5,5,0,5,0,5,0,True,False,False,0,3,2021-10-29T13:44:00.33,5,False,0.0
2021,8,3169,460,12,496,2,7,5,2,2,0,2,0,2,6,False,False,False,0,3,2022-02-16T18:03:21.633,2,True,0.0
2021,8,3169,475,1,910,2,5,5,9,9,0,9,0,9,0,False,False,False,0,2,2021-10-29T13:51:36.027,9,False,0.0
2021,8,3169,485,1,6405,2,2,4,6,8,2,8,0,8,0,False,False,False,0,3,2021-10-29T13:54:24.437,8,False,0.0
2021,8,3169,490,1,6405,2,51,10,-3,3,6,1,2,1,0,False,False,False,0,3,2021-10-29T13:56:10.597,3,False,2.0
2021,8,3169,495,1,910,13,19,2,28,0,0,0,0,0,0,False,False,False,0,2,2021-10-29T13:58:19.957,0,False,0.0
2021,8,3169,500,1,910,2,4,5,6,6,0,6,0,6,0,False,False,False,0,2,2021-10-29T14:00:12.877,6,False,0.0
2021,8,3169,505,1,6406,13,12,5,9,0,0,0,0,0,0,False,False,False,0,2,2021-11-04T17:12:20.72,0,False,0.0
2021,8,3169,510,1,6933,2,4,3,7,7,0,7,0,7,0,False,False,False,0,2,2021-10-29T14:04:13.717,7,False,0.0
2021,8,3169,520,1,6406,2,48,10,-3,8,11,1,7,1,0,False,False,False,1,1,2021-10-29T14:07:12.85,8,False,7.0
2021,8,3169,525,1,245,2,2,9,5,11,6,8,3,8,0,False,False,False,0,2,2021-10-29T14:10:33.687,11,False,3.0
2021,8,3169,530,1,894,2,38,4,6,20,14,15,5,15,0,False,False,False,0,4,2021-10-29T14:12:55.877,20,False,5.0
2021,8,3169,555,12,6356,13,5,3,5,0,0,0,0,0,0,False,False,False,0,3,2021-11-04T16:44:24.007,0,False,0.0
2021,8,3169,570,12,4537,2,51,9,-2,19,21,10,9,10,0,True,False,False,0,3,2021-11-04T17:26:47.61,19,False,9.0
2021,8,3169,580,12,4511,2,35,7,18,33,15,32,1,32,0,False,False,False,0,3,2021-10-29T14:39:44.627,33,False,1.0
2021,8,3169,585,12,7743,2,53,4,-6,8,14,6,2,6,0,False,False,False,0,4,2022-02-16T18:04:49.57,8,False,2.0
2021,8,3169,595,12,4537,3,48,4,-3,0,0,0,0,0,0,False,False,False,0,1,2022-02-16T18:07:19.86,0,False,0.0
2021,8,3169,600,12,4537,2,48,10,-1,5,6,3,2,3,0,False,False,False,1,1,2021-11-04T18:59:16.027,5,False,2.0
2021,8,3169,610,12,496,2,2,9,6,6,0,6,0,6,6,False,False,False,0,3,2021-11-04T18:29:36.87,6,True,0.0
2021,8,3169,625,1,8439,13,21,2,25,0,0,0,0,0,0,True,False,False,0,3,2021-11-04T18:59:29.34,0,False,
2021,8,3169,645,1,6933,13,12,3,10,0,0,0,0,0,0,False,False,False,0,2,2021-10-29T15:04:16.027,0,False,0.0
2021,8,3169,650,1,6405,13,17,8,29,0,0,0,0,0,0,False,False,False,0,3,2021-10-29T15:06:19.75,0,False,0.0
2021,8,3169,655,1,6406,2,32,10,-2,9,11,9,0,9,0,False,False,False,1,3,2021-10-30T20:54:54.597,9,False,0.0
2021,8,3169,660,1,894,2,4,10,5,9,4,6,3,6,0,False,False,False,0,3,2021-10-29T15:10:49.547,9,False,3.0
2021,8,3169,665,1,8439,2,50,9,-2,9,11,7,2,7,0,False,False,False,0,3,2022-02-16T18:08:10.81,9,False,2.0
2021,8,3169,670,1,910,2,18,5,-2,4,6,2,2,2,0,False,False,False,0,2,2021-10-29T15:16:43.163,4,False,2.0
2021,8,3169,675,1,894,2,2,10,3,9,6,3,6,3,0,False,False,False,0,3,2021-11-04T18:30:33.5,9,False,6.0
2021,8,3169,700,12,4537,2,47,5,1,9,8,8,1,8,0,False,False,False,0,1,2021-10-29T15:25:31.02,9,False,1.0
2021,8,3169,705,12,7743,2,51,9,-1,12,13,4,8,4,0,True,False,False,1,4,2021-11-04T17:26:58.627,12,False,8.0
2021,8,3169,710,12,6872,2,5,3,5,10,5,9,1,9,0,False,False,False,0,3,2021-10-29T15:30:25.497,10,False,1.0
2021,8,3169,720,12,6872,2,18,3,0,4,4,3,1,3,0,False,True,False,0,2,2021-10-29T15:35:42.953,4,False,1.0
2021,8,3169,745,12,6356,2,51,9,-1,7,8,4,3,4,0,False,False,False,1,3,2021-10-29T16:52:04.357,7,False,3.0
2021,8,3169,750,12,6356,13,42,9,3,0,0,0,0,0,0,False,False,False,0,3,2021-10-29T15:47:57.783,0,False,
2021,8,3169,780,12,496,13,4,10,1,0,0,0,0,0,0,False,False,False,0,3,2022-02-16T18:11:31.96,0,False,0.0
2021,8,3169,790,1,6405,13,6,3,6,0,0,0,0,0,0,False,False,False,0,2,2021-10-29T16:03:15.057,0,False,0.0
2021,8,3169,795,1,910,2,6,8,20,23,3,23,0,23,0,False,False,False,0,2,2021-10-29T16:05:38.707,23,False,0.0
2021,8,3169,800,1,6405,2,17,8,27,29,2,27,2,27,0,False,False,False,0,3,2021-10-29T16:08:40.707,29,False,2.0
2021,8,3169,810,1,8439,2,49,9,-3,9,12,7,2,7,0,False,False,False,0,3,2021-11-04T17:27:08.227,9,False,2.0
2021,8,3169,815,1,6405,2,5,3,6,6,0,6,0,6,0,False,False,False,0,2,2021-10-29T16:11:57.46,6,False,0.0
2021,8,3169,830,1,6406,2,5,3,2,22,20,18,4,18,0,False,False,False,2,1,2021-11-04T17:12:39.027,22,False,4.0
2021,8,3169,855,1,910,13,9,5,5,0,0,0,0,0,0,False,False,False,0,2,2021-11-04T18:59:40.65,0,False,0.0
2021,8,3170,10,22,8451,2,32,10,-3,9,12,7,2,7,0,False,False,False,0,1,2021-11-04T12:02:48.657,9,False,2.0
2021,8,3170,15,22,7610,2,38,10,4,30,26,27,3,27,0,False,False,False,0,3,2021-11-01T15:48:27.653,17,False,3.0
2021,8,3170,20,22,3170,2,4,10,6,8,2,7,1,7,0,False,False,False,0,3,2021-11-01T01:11:24.26,8,False,1.0
2021,8,3170,25,22,2629,2,28,10,6,7,1,6,1,6,0,False,False,False,0,4,2021-11-04T12:02:58.6,7,False,1.0
2021,8,3170,30,22,8451,2,47,5,-2,6,8,4,2,4,0,False,False,False,0,1,2021-11-01T15:50:41.95,6,False,2.0
2021,8,3170,45,22,8451,2,48,10,-8,3,11,2,1,2,0,False,False,False,1,1,2021-11-01T01:25:19.977,3,False,1.0
2021,8,3170,50,22,6812,2,46,9,0,15,15,13,2,13,0,True,False,False,0,1,2021-11-02T19:11:48.07,15,False,2.0
2021,8,3170,80,7,8317,3,4,3,4,0,0,0,0,0,0,False,False,False,0,2,2021-11-01T01:36:08.873,0,False,0.0
2021,8,3170,85,7,2631,2,4,9,6,6,0,6,0,6,0,False,False,False,0,4,2021-11-04T11:55:12.593,6,False,0.0
2021,8,3170,90,7,3521,2,13,9,1,3,2,2,1,2,0,False,False,False,0,3,2021-11-01T01:39:10.64,3,False,1.0
2021,8,3170,100,22,3170,2,12,3,3,3,0,3,0,3,0,True,False,False,0,3,2021-11-04T12:50:53.9,3,False,0.0
2021,8,3170,115,22,3170,2,4,9,4,6,2,4,2,4,0,False,False,False,1,3,2021-11-04T12:51:48.047,6,False,2.0
2021,8,3170,125,22,2391,2,39,4,5,7,2,6,1,6,0,False,False,False,0,4,2021-11-01T01:49:09.683,7,False,1.0
2021,8,3170,130,22,3170,2,35,3,9,12,3,12,0,12,0,False,False,False,0,3,2021-11-01T01:53:49.383,12,True,0.0
2021,8,3170,135,22,3170,13,2,10,11,0,0,0,0,0,0,False,False,False,0,3,2021-11-04T12:51:59.173,0,False,0.0
2021,8,3170,150,7,8317,3,5,3,3,0,0,0,0,0,0,False,False,False,0,2,2021-11-01T15:11:59.68,0,False,0.0
2021,8,3170,160,22,8454,2,34,4,-4,6,10,6,0,6,0,True,False,False,0,3,2021-11-04T12:52:11.607,6,True,0.0
2021,8,3170,165,22,8451,13,31,4,-2,0,0,0,0,0,0,False,False,False,0,1,2022-02-16T21:27:40.893,0,False,0.0
2021,8,3170,175,7,4455,2,5,3,5,13,8,9,4,9,0,False,False,False,0,1,2021-11-01T02:26:22.787,13,False,4.0
2021,8,3170,180,7,7659,13,35,3,3,0,0,0,0,0,0,False,False,False,0,3,2021-11-01T15:31:41.427,0,False,
2021,8,3170,185,7,4679,2,47,5,0,0,0,0,0,0,0,False,False,False,0,3,2021-11-04T12:09:52.807,0,False,0.0
2021,8,3170,210,22,4997,13,4,10,6,0,0,0,0,0,0,False,False,False,0,3,2021-11-04T12:12:26.443,0,False,0.0
2021,8,3170,215,22,8451,2,48,10,-7,20,27,15,5,15,0,False,False,False,0,1,2021-11-01T02:41:46.07,20,False,5.0
2021,8,3170,230,22,8454,2,13,4,6,6,0,6,0,6,0,False,False,False,0,3,2021-11-01T02:47:34.75,6,False,0.0
2021,8,3170,240,22,8451,13,11,3,6,0,0,0,0,0,0,False,False,False,0,1,2022-02-16T21:40:13.963,0,False,0.0
2021,8,3170,265,7,4455,2,48,9,-5,3,8,-5,8,-5,0,False,False,False,0,1,2021-11-01T02:56:42.003,3,False,8.0
2021,8,3170,275,22,8451,3,46,9,0,0,0,0,0,0,0,False,False,False,0,1,2021-11-01T15:15:18.347,0,False,0.0
2021,8,3170,285,22,6270,2,26,9,3,5,2,3,2,3,0,True,False,False,0,3,2021-11-04T12:52:23.767,5,False,2.0
2021,8,3170,295,7,8317,2,4,3,4,9,5,6,3,6,0,False,False,False,0,2,2021-11-01T03:48:31.99,9,False,3.0
2021,8,3170,310,7,3521,2,13,9,2,16,14,14,2,14,0,False,False,False,0,3,2021-11-01T04:01:37.827,16,False,2.0
2021,8,3170,320,7,4679,2,4,4,4,4,0,4,0,4,0,False,False,False,0,1,2021-11-01T03:56:41.833,4,False,0.0
2021,8,3170,325,7,7659,2,9,2,23,26,3,23,3,23,0,False,False,False,0,3,2021-11-01T03:59:04.647,26,False,3.0
2021,8,3170,330,7,7659,13,5,5,2,0,0,0,0,0,0,True,False,False,0,3,2021-11-01T04:01:21.193,0,False,0.0
2021,8,3170,335,7,8317,2,12,3,2,2,0,2,0,2,6,False,False,False,0,2,2021-11-01T04:04:24.243,2,True,0.0
2021,8,3170,350,22,8454,2,34,4,-4,2,6,1,1,1,0,True,False,False,0,3,2021-11-01T04:07:51.85,2,False,1.0
2021,8,3170,355,22,3170,2,17,3,7,26,19,22,4,22,0,False,True,True,0,3,2021-11-01T15:36:46.22,26,False,4.0
2021,8,3170,360,7,4679,2,48,5,-4,46,50,46,0,46,0,False,False,False,0,1,2022-02-16T21:44:41.53,46,False,0.0
2021,8,3170,380,7,4679,13,47,5,1,0,0,0,0,0,0,False,False,False,0,1,2021-11-01T04:16:24.83,0,False,0.0
2021,8,3170,385,7,3521,13,26,5,3,0,0,0,0,0,0,True,False,False,0,3,2021-11-04T10:46:45.857,0,False,0.0
2021,8,3170,400,22,4997,2,6,9,11,11,0,11,0,11,0,False,False,False,0,2,2021-11-04T10:46:45.857,11,False,0.0
2021,8,3170,405,22,8451,2,5,9,2,12,10,11,1,11,0,False,False,False,0,1,2021-11-04T11:56:06.12,12,False,1.0
2021,8,3170,410,22,6812,2,48,10,-6,15,21,12,3,12,0,False,False,False,0,1,2021-11-01T04:25:42.24,15,False,3.0
2021,8,3170,420,22,3170,2,4,9,4,9,5,7,2,7,0,False,False,False,0,3,2021-11-01T04:30:50.853,9,False,2.0
2021,8,3170,430,22,4997,13,29,3,12,0,0,0,0,0,0,False,False,False,0,2,2021-11-01T15:40:27.733,0,True,0.0
2021,8,3170,435,22,8451,2,46,3,2,4,2,2,2,2,0,False,False,False,0,1,2021-11-01T04:37:09.807,4,False,2.0
2021,8,3170,450,22,6270,2,5,3,8,8,0,8,0,8,6,False,False,False,0,3,2021-11-04T11:56:19.623,8,True,0.0
2021,8,3170,485,7,7659,2,2,10,3,9,6,5,4,5,0,False,False,False,1,2,2021-11-04T11:58:44,9,False,4.0
2021,8,3170,490,7,8317,2,4,5,4,21,17,14,7,14,0,False,False,False,1,2,2021-11-04T11:58:56.943,21,False,7.0
2021,8,3170,500,7,7659,2,2,10,4,8,4,7,1,7,0,False,False,False,0,2,2021-11-01T04:52:18.453,8,False,1.0
2021,8,3170,505,7,7659,13,19,6,30,0,0,0,0,0,0,False,False,False,0,2,2021-11-01T15:41:34.82,0,False,0.0
2021,8,3170,520,22,7610,2,2,9,10,13,3,10,3,10,0,False,False,False,0,2,2022-02-16T21:45:18.953,13,False,3.0
2021,8,3170,535,22,6812,2,46,3,2,14,12,12,2,12,0,False,False,False,0,1,2021-11-01T05:04:31.083,14,False,2.0
2021,8,3170,540,22,8454,2,35,7,15,15,0,15,0,15,0,False,False,False,0,3,2021-11-04T12:22:29.443,15,False,0.0
2021,8,3170,550,22,8451,13,32,10,0,0,0,0,0,0,0,False,False,False,0,1,2021-11-04T11:57:02.26,0,False,
2021,8,3170,560,22,8451,2,48,9,-4,9,13,-2,11,-2,0,False,False,False,2,1,2021-11-04T11:50:47.883,9,False,11.0
2021,8,3170,565,22,6812,13,48,10,-5,0,0,0,0,0,0,False,False,False,0,1,2021-11-01T05:20:17.917,0,False,0.0
2021,8,3170,570,22,3170,2,5,3,5,8,3,7,1,7,0,False,False,False,0,3,2021-11-01T05:22:27.053,8,False,1.0
2021,8,3170,575,22,7610,3,35,5,6,0,0,0,0,0,0,False,False,False,0,3,2021-11-04T12:31:29.38,0,False,0.0
2021,8,3170,600,7,7659,2,35,6,41,54,13,47,7,47,0,False,False,False,0,2,2021-11-04T12:52:47.183,54,False,7.0
2021,8,3170,605,7,4679,2,46,3,1,8,7,5,3,5,6,False,False,False,1,1,2021-11-04T12:39:00.193,8,False,3.0
2021,8,3170,625,22,8451,2,2,9,5,9,4,7,2,7,0,True,False,False,0,2,2021-11-02T19:11:58.907,9,False,2.0
2021,8,3170,635,22,7118,2,4,10,10,10,0,10,0,10,0,False,False,False,0,3,2021-11-04T12:39:41.8,10,False,0.0
2021,8,3170,640,22,8454,2,8,4,14,24,10,19,5,19,0,False,False,False,0,3,2021-11-04T12:53:00.757,24,False,5.0
2021,8,3170,680,7,3521,13,2,4,6,0,0,0,0,0,0,False,False,False,0,3,2021-11-04T11:50:11.097,0,False,0.0
2021,8,3170,685,7,8317,13,4,5,6,0,0,0,0,0,0,False,False,False,0,2,2021-11-01T13:58:01.173,0,False,0.0
2021,8,3170,690,7,2631,2,13,4,5,10,5,7,3,7,0,False,False,False,0,3,2021-11-04T11:59:18.96,10,False,3.0
2021,8,3170,695,7,2631,2,53,4,-4,11,15,7,4,7,0,False,False,False,0,4,2021-11-01T14:01:22.31,11,False,4.0
2021,8,3170,710,7,3521,13,35,2,27,0,0,0,0,0,0,False,False,False,0,3,2021-11-01T15:42:17.18,0,False,0.0
2021,8,3170,715,7,2631,2,46,3,1,6,5,1,5,1,0,True,False,False,1,4,2021-11-02T18:55:57.337,6,False,5.0
2021,8,3170,720,7,3521,2,2,9,8,21,13,20,1,20,0,False,False,False,0,3,2021-11-01T14:10:37.137,21,False,1.0
2021,8,3170,730,7,8317,13,2,10,10,0,0,0,0,0,0,False,False,False,0,2,2021-11-01T14:13:19.343,0,False,0.0
2021,8,3170,735,7,3521,2,12,5,10,10,0,10,0,10,6,True,False,False,0,3,2021-11-01T14:15:11.67,10,True,0.0
2021,8,3170,750,22,8454,2,4,10,7,14,7,11,3,11,0,False,False,False,0,3,2021-11-04T12:42:48.303,14,False,3.0
2021,8,3170,755,22,8451,13,6,10,5,0,0,0,0,0,0,False,False,False,0,2,2021-11-01T14:19:23.377,0,False,0.0
2021,8,3170,760,22,8451,2,28,10,0,23,23,11,12,11,0,False,False,False,3,1,2021-11-04T11:59:30.017,23,False,12.0
2021,8,3170,765,22,8454,13,23,7,38,0,0,0,0,0,0,False,False,False,0,2,2021-11-04T10:46:45.857,0,False,
2021,8,3170,770,22,3170,2,4,5,5,12,7,8,4,8,0,False,False,False,0,3,2021-11-01T14:24:22.37,12,False,4.0
2021,8,3170,775,22,4997,2,4,9,6,6,0,6,0,6,0,False,False,False,0,3,2021-11-04T12:53:15.333,6,False,0.0
2021,8,3170,780,22,4997,2,13,4,4,8,4,6,2,6,0,False,False,False,0,3,2021-11-04T12:45:30.39,8,False,2.0
2021,8,3170,785,22,6812,2,48,9,-4,8,12,-2,10,-2,0,False,False,False,1,1,2021-11-01T14:28:49.36,8,False,10.0
2021,8,3170,795,22,6812,2,28,9,2,19,17,6,13,6,6,False,False,False,2,1,2021-11-04T11:59:47.723,19,False,13.0
2021,8,3170,810,7,8317,13,50,5,-10,0,0,0,0,0,0,False,False,False,0,2,2021-11-04T11:58:30.16,0,False,0.0
2021,8,3170,820,22,2629,2,36,4,13,13,0,13,0,13,6,False,False,False,0,4,2021-11-01T14:38:58.92,13,True,0.0
2021,8,3170,840,7,3521,2,12,6,19,19,0,19,0,19,0,False,False,False,0,3,2022-02-24T14:16:59.163,19,True,0.0
2021,8,3170,875,22,8451,13,11,5,9,0,0,0,0,0,0,True,False,False,0,3,2021-11-04T12:48:14.863,0,False,0.0
2021,8,3170,890,22,6812,2,5,10,1,-1,-2,0,-1,0,0,False,False,False,0,1,2021-11-04T12:49:18.757,-1,False,
2021,8,3171,10,14,7582,2,11,5,0,37,37,30,7,30,0,False,False,False,1,1,2021-11-04T13:57:53.407,37,False,7.0
2021,8,3171,15,14,7584,2,4,10,5,5,0,5,0,5,0,False,False,False,0,3,2021-11-04T17:46:58.057,5,False,0.0
2021,8,3171,25,14,7584,13,29,2,21,0,0,0,0,0,0,True,False,False,0,2,2021-11-04T14:51:28.177,0,False,0.0
2021,8,3171,30,14,6543,2,26,9,4,6,2,6,0,6,0,True,False,False,0,2,2021-11-01T09:27:51.25,6,False,0.0
2021,8,3171,35,14,7584,2,5,3,4,8,4,6,2,6,0,False,False,False,0,3,2021-11-04T17:23:13.74,8,False,2.0
2021,8,3171,65,14,8400,2,34,4,-4,0,4,0,0,0,0,True,False,False,0,4,2021-11-01T09:51:26.687,0,False,0.0
2021,8,3171,70,14,7584,13,13,10,2,0,0,0,0,0,0,False,False,False,0,3,2021-11-01T09:53:59.227,0,False,0.0
2021,8,3171,75,14,7584,2,6,10,2,2,0,2,0,2,6,False,False,False,0,3,2021-11-04T17:27:08.973,2,True,0.0
2021,8,3171,95,31,4070,13,6,10,11,0,0,0,0,0,0,False,False,False,0,2,2021-11-04T17:38:30.097,0,False,0.0
2021,8,3171,100,14,7584,2,35,10,7,7,0,7,0,7,6,False,False,False,0,4,2021-11-01T10:13:02.657,7,True,0.0
2021,8,3171,125,31,4070,2,50,10,-2,8,10,4,4,4,0,False,False,False,0,3,2021-11-01T10:21:35.64,8,False,4.0
2021,8,3171,130,31,4070,13,4,5,8,0,0,0,0,0,0,False,False,False,0,2,2021-11-01T10:24:10.21,0,False,0.0
2021,8,3171,150,14,1114,2,4,3,9,10,1,10,0,10,0,False,False,False,0,2,2021-11-01T10:35:55.903,10,False,0.0
2021,8,3171,155,14,7584,3,5,6,18,0,0,0,0,0,0,False,False,False,0,3,2021-11-04T17:27:19.62,0,False,0.0
2021,8,3171,160,14,1119,2,31,4,5,7,2,6,1,6,0,False,False,False,0,3,2021-11-01T10:48:59.14,7,False,1.0
2021,8,3171,165,14,1114,13,19,6,40,0,0,0,0,0,0,False,False,False,0,2,2021-11-01T10:50:57.703,0,False,0.0
2021,8,3171,170,14,7584,13,7,6,17,0,0,0,0,0,0,False,False,False,0,3,2021-11-04T13:57:53.407,0,False,0.0
2021,8,3171,180,31,2865,2,4,9,3,7,4,5,2,5,0,False,False,False,0,4,2021-11-01T10:58:51.073,7,False,2.0
2021,8,3171,185,31,2865,2,31,4,0,3,3,3,0,3,0,True,False,False,0,4,2021-11-02T21:12:46.56,3,False,0.0
2021,8,3171,195,31,6724,2,13,9,4,8,4,6,2,6,0,False,False,False,0,3,2021-11-01T11:05:19.313,8,False,2.0
2021,8,3171,205,31,2901,2,28,3,2,8,6,6,2,6,0,False,False,False,0,4,2021-11-01T11:08:52.637,8,False,2.0
2021,8,3171,230,31,2865,2,13,4,6,6,0,6,0,6,6,False,False,False,0,4,2021-11-01T11:20:41.12,6,True,0.0
2021,8,3171,250,14,7582,2,12,9,6,7,1,7,0,7,0,False,False,False,0,1,2021-11-04T17:28:29.237,7,False,0.0
2021,8,3171,255,14,4449,2,4,4,7,7,0,7,0,7,0,False,False,False,0,3,2021-11-01T11:52:27.807,7,False,0.0
2021,8,3171,280,31,2901,2,47,5,8,14,6,14,0,14,0,False,False,False,0,4,2021-11-01T12:08:07.43,14,False,0.0
2021,8,3171,290,31,2865,2,39,4,6,7,1,7,0,7,0,False,False,False,0,4,2021-11-01T12:13:20.583,7,False,0.0
2021,8,3171,310,31,6724,13,4,4,7,0,0,0,0,0,0,True,False,False,0,3,2021-11-04T17:47:57.14,0,False,0.0
2021,8,3171,315,31,6793,2,5,5,14,57,43,16,41,16,6,False,False,False,1,2,2021-11-01T12:28:47.677,57,False,41.0
2021,8,3171,330,14,7582,2,48,9,-6,8,14,5,3,5,0,False,False,False,0,1,2021-11-01T12:32:22.52,8,False,3.0
2021,8,3171,340,14,4449,2,2,9,7,9,2,8,1,8,0,False,False,False,0,2,2021-11-01T12:38:53.967,9,False,1.0
2021,8,3171,345,14,4449,2,30,10,2,7,5,5,2,5,0,True,False,False,0,4,2021-11-02T20:52:48.237,7,False,2.0
2021,8,3171,360,14,5197,13,7,2,42,0,0,0,0,0,0,False,False,False,0,3,2021-11-01T12:45:35.403,0,False,0.0
2021,8,3171,365,14,7584,2,6,4,12,12,0,12,0,12,0,False,False,False,0,3,2021-11-01T12:48:58.51,12,False,0.0
2021,8,3171,370,14,7495,13,7,6,20,0,0,0,0,0,0,False,False,False,0,2,2021-11-04T13:57:53.407,0,False,
2021,8,3171,375,14,7584,2,4,5,0,5,5,3,2,3,0,False,False,False,0,2,2021-11-01T17:33:24.293,5,False,2.0
2021,8,3171,385,14,6543,2,47,5,3,6,3,5,1,5,0,False,False,False,0,1,2021-12-10T17:36:15.843,6,False,1.0
2021,8,3171,390,14,1114,13,9,6,23,0,0,0,0,0,0,False,False,False,0,3,2021-12-10T17:35:07.27,0,False,0.0
2021,8,3171,410,14,6543,2,50,10,-3,1,4,-1,2,-1,0,True,False,False,0,3,2021-11-02T20:53:55.84,1,False,2.0
2021,8,3171,445,31,6793,2,6,4,13,13,0,13,0,13,0,False,False,False,0,3,2021-11-01T13:22:44.11,13,False,0.0
2021,8,3171,465,31,3911,13,13,10,2,0,0,0,0,0,0,True,False,False,0,3,2021-11-02T21:12:18.707,0,False,0.0
2021,8,3171,480,31,2865,13,4,9,4,0,0,0,0,0,0,False,False,False,0,4,2021-11-01T13:36:01.247,0,False,0.0
2021,8,3171,485,31,6793,2,4,5,10,10,0,10,0,10,0,False,False,False,0,2,2021-11-01T13:38:02.127,10,False,0.0
2021,8,3171,490,31,6793,2,5,3,10,11,1,11,0,11,0,False,False,False,0,3,2021-11-01T13:39:44.9,11,False,0.0
2021,8,3171,500,31,6793,2,13,4,3,7,4,4,3,4,0,False,False,False,0,3,2021-11-01T13:43:18.19,7,False,3.0
2021,8,3171,505,31,7913,2,2,4,5,5,0,5,0,5,6,False,False,False,0,2,2021-11-01T13:45:08.147,5,True,0.0
2021,8,3171,520,14,6543,2,51,10,-4,9,13,7,2,7,0,True,False,False,1,1,2021-11-04T17:23:36.16,9,False,2.0
2021,8,3171,535,14,5197,13,35,9,12,0,0,0,0,0,0,False,False,False,0,4,2021-11-01T14:12:26.483,0,False,0.0
2021,8,3171,540,14,5197,13,6,1,19,0,0,0,0,0,0,False,False,False,0,3,2021-11-01T14:14:33.563,0,False,0.0
2021,8,3171,550,31,3504,2,48,10,-2,3,5,0,3,0,0,False,False,False,0,1,2022-02-16T20:33:59.94,3,False,
2021,8,3171,555,31,4070,13,6,4,13,0,0,0,0,0,0,False,False,False,0,3,2021-11-01T14:21:34.03,0,False,0.0
2021,8,3171,565,31,6793,2,4,10,10,10,0,9,1,9,0,False,False,False,0,2,2021-11-01T14:27:03.98,10,False,1.0
2021,8,3171,580,14,1114,2,18,9,0,6,6,6,0,6,0,False,False,False,0,3,2022-02-16T20:34:51.71,6,False,0.0
2021,8,3171,590,14,4449,13,7,6,43,0,0,0,0,0,0,False,False,False,0,3,2022-02-16T20:35:25.293,0,False,
2021,8,3171,595,14,1119,2,54,9,1,5,4,5,0,5,6,False,False,False,0,4,2021-11-04T17:24:55.28,5,True,0.0
2021,8,3171,615,31,3504,3,4,3,4,0,0,0,0,0,0,True,False,False,0,2,2021-11-02T21:12:04.85,0,False,
2021,8,3171,640,31,4070,13,19,6,38,0,0,0,0,0,0,False,False,False,0,2,2021-11-01T14:54:22.703,0,False,0.0
2021,8,3171,645,31,7913,2,5,3,11,11,0,11,0,11,0,False,False,False,0,3,2021-11-01T14:56:28.897,11,False,0.0
2021,8,3171,660,31,6793,2,5,5,9,10,1,10,0,10,0,True,False,False,0,3,2021-11-04T17:29:36.23,10,False,
2021,8,3171,665,31,6793,2,2,10,6,14,8,12,2,12,0,False,False,False,0,3,2021-11-01T15:05:41.743,14,False,2.0
2021,8,3171,680,14,7495,3,7,7,54,0,0,0,0,0,0,False,False,False,0,3,2021-11-04T13:57:53.407,0,False,0.0
2021,8,3171,685,14,4449,3,4,10,9,0,0,0,0,0,0,False,False,False,0,3,2021-11-01T15:13:04.677,0,False,0.0
2021,8,3171,690,14,7584,2,18,10,-2,-2,0,-3,1,-3,0,False,False,False,0,3,2021-11-01T17:32:15.73,-2,False,1.0
2021,8,3171,700,14,4449,2,4,4,7,11,4,10,1,10,0,True,False,False,0,3,2021-11-01T15:33:59.227,11,False,1.0
2021,8,3171,705,14,7584,2,5,3,2,3,1,3,0,3,0,False,False,False,0,3,2021-11-04T13:57:53.407,3,False,0.0
2021,8,3171,715,14,1114,13,4,6,15,0,0,0,0,0,0,False,False,False,0,2,2021-11-01T15:41:29.29,0,False,0.0
2021,8,3171,720,14,4449,13,4,3,12,0,0,0,0,0,0,False,False,False,0,2,2021-11-01T15:44:25.72,0,False,0.0
2021,8,3171,750,14,6543,13,16,10,4,0,0,0,0,0,0,False,False,False,0,1,2021-11-01T15:57:37.833,0,False,0.0
2021,8,3171,755,14,7495,3,2,9,7,0,0,0,0,0,0,False,False,False,0,2,2022-02-16T20:36:03.743,0,False,0.0
2021,8,3171,765,31,6793,2,3,3,10,9,-1,9,0,9,0,False,False,False,0,3,2021-11-01T16:07:47.323,9,True,0.0
2021,8,3171,785,31,4545,2,12,3,6,10,4,9,1,9,0,False,False,False,0,1,2022-02-24T14:17:59.283,10,False,1.0
2021,8,3171,800,31,4545,2,48,9,-4,10,14,8,2,8,0,True,False,False,0,1,2021-11-02T21:11:46.843,10,False,2.0
2021,8,3171,815,31,4545,2,38,10,1,13,12,12,1,12,0,False,False,False,0,1,2021-11-01T16:26:49.11,13,False,1.0
2021,8,3171,830,14,6543,13,12,4,-6,0,0,0,0,0,0,False,False,False,0,1,2021-11-04T17:30:03.587,0,False,0.0
2021,8,3171,845,14,4449,2,4,4,9,9,0,9,0,9,0,False,False,False,0,3,2021-11-01T16:36:19.323,9,False,0.0
2021,8,3171,850,14,7584,13,5,2,16,0,0,0,0,0,0,False,False,False,0,2,2021-11-04T14:51:46.523,0,False,
2021,8,3171,855,14,7495,13,6,7,21,0,0,0,0,0,0,False,False,False,0,2,2021-11-01T16:41:10.607,0,False,0.0
2021,8,3171,860,14,7584,2,4,3,9,8,-1,8,0,8,0,False,False,False,0,2,2021-11-01T16:43:15.447,8,False,
2021,8,3171,865,14,7584,2,12,1,34,38,4,34,4,34,0,False,False,False,0,2,2021-11-04T17:30:15.117,38,False,4.0
2021,8,3171,875,14,5197,13,5,2,16,0,0,0,0,0,0,False,False,False,0,3,2021-11-01T16:49:04.783,0,False,0.0
2021,8,3171,880,14,7495,13,7,2,43,0,0,0,0,0,0,False,False,False,0,3,2021-11-01T17:31:43.653,0,False,
2021,8,3171,935,14,7582,13,12,9,-3,0,0,0,0,0,0,False,False,False,0,1,2022-02-24T14:18:20.387,0,False,0.0
2021,8,3171,940,14,4449,13,17,1,30,0,0,0,0,0,0,False,False,False,0,3,2021-11-04T13:57:53.407,0,False,0.0
2021,8,3171,950,31,6793,13,5,3,13,0,0,0,0,0,0,False,False,False,0,3,2021-11-01T17:06:42.123,0,False,0.0
2021,8,3171,960,31,6793,2,4,9,12,11,-1,11,0,11,0,False,False,False,0,2,2021-11-02T21:10:57.193,11,False,0.0
2021,8,3171,970,14,7495,13,35,10,12,0,0,0,0,0,0,False,False,False,0,3,2021-11-01T17:12:12.013,0,False,0.0
2021,8,3171,975,14,7584,2,4,9,5,8,3,6,2,6,0,False,False,False,1,2,2021-11-04T17:49:34.207,8,False,2.0
2021,8,3171,985,14,7584,13,35,7,19,0,0,0,0,0,0,False,False,False,0,3,2021-11-04T17:30:33.99,0,False,0.0
2021,8,3171,995,31,7913,3,45,5,-1,0,0,0,0,0,0,True,False,False,0,3,2021-11-01T17:20:59.003,0,False,0.0
2021,8,3171,1000,31,6793,2,2,4,7,13,6,12,1,12,0,False,False,False,0,3,2021-11-01T17:22:36.297,13,False,1.0
2021,8,3172,15,29,3398,2,4,10,5,10,5,5,5,5,0,False,False,False,0,3,2021-11-01T09:05:13.357,10,False,5.0
2021,8,3172,30,29,7828,2,4,3,5,5,0,5,0,5,0,False,False,False,0,2,2021-11-01T09:11:01.583,5,False,0.0
2021,8,3172,35,29,1958,13,8,9,13,0,0,0,0,0,0,False,False,False,0,3,2022-02-16T20:14:33.017,0,False,0.0
2021,8,3172,40,29,4866,2,6,9,8,8,0,8,0,8,0,False,False,False,0,3,2022-02-16T20:15:25.04,8,False,0.0
2021,8,3172,45,29,4866,2,35,9,11,15,4,15,0,15,0,False,False,False,0,3,2021-11-01T09:19:51.613,15,False,0.0
2021,8,3172,50,29,4866,2,5,3,14,14,0,14,0,14,0,False,False,False,0,2,2021-11-07T19:00:39.9,14,True,0.0
2021,8,3172,55,29,1958,13,4,10,3,0,0,0,0,0,0,False,False,False,0,3,2021-11-01T09:23:09.627,0,False,0.0
2021,8,3172,60,29,7378,2,47,5,1,3,2,3,0,3,6,False,False,False,0,1,2021-11-01T09:22:46.413,3,True,0.0
2021,8,3172,85,13,876,2,4,5,6,10,4,10,0,10,0,False,False,False,0,3,2021-11-04T12:22:31.453,10,True,0.0
2021,8,3172,105,13,6528,2,53,4,-4,6,10,2,4,2,0,False,False,False,0,4,2021-11-01T09:49:25.383,6,False,4.0
2021,8,3172,110,13,3586,2,52,9,2,8,6,6,2,6,0,False,False,False,0,2,2021-11-04T14:36:09.973,8,False,2.0
2021,8,3172,125,29,3398,2,30,9,1,4,3,1,3,1,0,False,False,False,0,4,2021-11-01T09:56:07.753,4,False,3.0
2021,8,3172,130,29,7828,2,3,6,15,15,0,15,0,15,0,False,False,False,0,2,2021-11-01T09:57:46.303,15,True,0.0
2021,8,3172,150,29,1958,13,50,9,-1,0,0,0,0,0,0,False,False,False,0,2,2021-11-01T10:11:09.247,0,False,0.0
2021,8,3172,155,29,4866,13,2,5,5,0,0,0,0,0,0,False,False,False,0,2,2021-11-04T15:21:20.07,0,False,0.0
2021,8,3172,160,29,4866,2,4,4,9,9,0,9,0,9,0,True,False,False,0,3,2021-11-01T10:14:53.637,9,False,0.0
2021,8,3172,165,29,7378,3,47,5,2,0,0,0,0,0,0,False,False,False,0,3,2022-02-16T19:22:59.513,0,False,0.0
2021,8,3172,180,13,100,2,51,9,-1,0,1,0,0,0,0,False,True,False,0,3,2021-11-01T10:26:30.5,0,False,0.0
2021,8,3172,185,13,8418,2,53,9,-4,9,13,6,3,6,0,False,False,False,0,4,2021-11-01T10:30:10.277,9,False,3.0
2021,8,3172,195,29,6266,2,47,5,0,3,3,2,1,2,0,False,False,False,0,1,2021-11-01T10:35:27.107,3,False,1.0
2021,8,3172,200,29,6266,2,28,9,-2,11,13,10,1,10,0,False,False,False,0,1,2021-11-01T10:38:49.147,11,False,1.0
2021,8,3172,205,29,1958,13,26,10,2,0,0,0,0,0,0,False,False,False,0,4,2021-11-01T10:40:31.667,0,False,0.0
2021,8,3172,210,29,1958,2,8,9,13,28,15,21,7,21,0,False,False,False,2,2,2022-02-16T20:21:21.68,28,False,7.0
2021,8,3172,235,29,1958,13,39,4,5,0,0,0,0,0,0,False,False,False,0,3,2021-11-01T11:02:44.43,0,False,0.0
2021,8,3172,240,29,4866,13,6,4,9,0,0,0,0,0,0,True,False,False,0,3,2021-11-01T11:04:00.713,0,False,0.0
2021,8,3172,260,13,8227,13,46,3,-1,0,0,0,0,0,0,False,False,False,0,1,2021-11-01T11:11:29.603,0,False,0.0
2021,8,3172,265,13,100,13,35,3,6,0,0,0,0,0,0,False,False,False,0,3,2021-11-01T11:13:09.477,0,False,0.0
2021,8,3172,285,29,7828,13,6,4,5,0,0,0,0,0,0,False,False,False,0,2,2022-02-16T19:24:44.487,0,False,
2021,8,3172,290,29,1958,2,4,10,2,2,0,2,0,2,6,False,False,False,0,3,2021-11-01T11:22:08.773,2,True,0.0
2021,8,3172,305,13,8417,2,35,8,19,26,7,23,3,23,0,False,False,False,0,3,2021-11-01T11:25:11.687,26,False,3.0
2021,8,3172,315,13,6528,2,46,3,-1,-1,0,-1,0,-1,0,False,False,False,0,4,2021-11-04T14:45:08.693,-1,False,0.0
2021,8,3172,335,29,3398,2,53,10,-4,11,15,9,2,9,0,True,False,False,0,4,2021-11-04T15:23:55.403,11,False,2.0
2021,8,3172,345,29,4866,2,35,6,15,52,37,40,12,40,0,False,False,False,1,4,2021-11-04T15:25:06.153,52,False,12.0
2021,8,3172,360,29,1958,2,18,9,-2,5,7,3,2,3,0,False,False,False,0,2,2021-11-01T11:44:41.467,5,False,2.0
2021,8,3172,365,29,7828,13,35,5,1,0,0,0,0,0,0,False,False,False,0,3,2021-11-04T13:38:09.81,0,False,0.0
2021,8,3172,390,13,6528,2,4,10,10,15,5,13,2,13,0,False,False,False,0,4,2021-11-01T11:51:05.457,15,False,2.0
2021,8,3172,400,13,876,13,3,5,13,0,0,0,0,0,0,False,False,False,0,2,2021-11-01T11:53:02.043,0,False,
2021,8,3172,415,13,8417,2,2,10,10,15,5,15,0,15,0,False,False,False,0,2,2021-11-01T11:56:52.94,15,False,0.0
2021,8,3172,440,13,100,13,5,5,6,0,0,0,0,0,0,False,False,False,0,2,2021-11-01T12:03:03.777,0,False,0.0
2021,8,3172,470,29,7828,13,5,5,5,0,0,0,0,0,0,False,False,False,0,3,2021-11-01T12:13:54.82,0,False,0.0
2021,8,3172,475,29,1958,3,35,10,7,0,0,0,0,0,0,False,False,False,0,3,2021-11-01T12:16:08.51,0,False,0.0
2021,8,3172,490,13,100,2,4,9,3,3,0,3,0,3,0,False,False,False,0,3,2021-11-01T15:02:59.783,3,False,0.0
2021,8,3172,510,29,7828,2,8,1,50,68,18,61,7,61,0,False,False,False,0,2,2021-11-04T15:00:08.683,68,False,7.0
2021,8,3172,520,29,4866,2,8,10,11,11,0,11,0,11,6,False,False,False,0,3,2021-11-01T12:35:02.177,11,True,0.0
2021,8,3172,550,13,2455,2,32,10,-1,-1,0,-1,0,-1,0,False,False,False,0,1,2021-11-01T12:51:26.35,-1,False,0.0
2021,8,3172,570,29,8455,2,5,6,19,20,1,20,0,20,0,False,False,False,0,2,2022-02-16T20:19:32.583,20,False,0.0
2021,8,3172,580,29,4866,2,6,10,6,6,0,6,0,6,0,False,False,False,0,2,2021-11-01T13:02:12.437,6,False,0.0
2021,8,3172,585,29,8455,2,30,9,-5,5,10,-3,8,-3,0,False,False,False,1,3,2021-11-04T14:18:12.86,5,False,8.0
2021,8,3172,625,13,8227,2,32,10,0,1,1,1,0,1,0,False,False,False,1,1,2021-11-04T14:19:40.527,1,False,0.0
2021,8,3172,630,13,100,13,5,3,9,0,0,0,0,0,0,False,False,False,0,3,2021-11-01T13:28:54.66,0,False,0.0
2021,8,3172,650,29,8455,2,51,10,-3,5,8,1,4,1,0,False,False,False,0,3,2021-11-01T13:35:20.023,5,False,4.0
2021,8,3172,660,13,876,2,4,9,5,6,1,6,0,6,0,False,False,False,0,3,2021-11-01T13:38:56.653,6,False,0.0
2021,8,3172,665,13,8417,2,5,5,5,7,2,6,1,6,0,False,False,False,0,2,2021-11-01T13:40:23.733,7,False,1.0
2021,8,3172,670,13,1510,13,48,5,-1,0,0,0,0,0,0,False,False,False,0,1,2021-11-04T15:08:03.83,0,False,0.0
2021,8,3172,685,13,876,2,39,4,5,8,3,8,0,8,0,False,False,False,0,3,2021-11-01T13:46:42.173,8,False,0.0
2021,8,3172,695,13,3586,2,12,3,8,8,0,8,0,8,0,False,False,False,0,3,2022-02-24T15:23:30.327,8,True,0.0
2021,8,3172,700,13,1510,2,16,9,1,10,9,4,6,4,0,False,False,False,0,1,2022-02-16T20:21:47.783,10,False,6.0
2021,8,3172,725,29,7828,13,4,5,3,0,0,0,0,0,0,False,False,False,0,2,2021-11-01T13:59:00.243,0,False,0.0
2021,8,3172,740,13,8417,2,4,9,7,7,0,7,0,7,0,False,False,False,0,3,2021-11-01T14:04:33.723,7,False,0.0
2021,8,3172,750,13,876,2,4,9,6,6,0,6,0,6,0,False,False,False,0,3,2021-11-01T14:07:32.34,6,False,0.0
2021,8,3172,755,13,876,2,24,6,31,45,14,45,0,45,6,False,False,False,0,3,2021-11-04T12:22:31.487,45,True,0.0
2021,8,3172,770,13,2407,2,35,6,24,24,0,24,0,24,0,False,False,False,0,3,2021-11-04T14:22:21.023,24,False,0.0
2021,8,3172,775,13,8227,2,28,9,3,8,5,6,2,6,0,False,False,False,0,1,2021-11-01T14:16:18.323,8,False,2.0
2021,8,3172,785,13,876,2,5,3,5,8,3,6,2,6,0,False,False,False,0,3,2021-11-01T14:20:36.443,8,False,2.0
2021,8,3172,795,13,8418,2,17,9,9,9,0,9,0,9,6,False,False,False,0,4,2021-11-01T14:24:07.713,9,True,0.0
2021,8,3172,850,13,1510,2,31,9,5,9,4,9,0,9,0,False,False,False,0,1,2021-11-01T14:39:54.237,9,False,0.0
2021,8,3172,855,13,8418,2,8,6,23,23,0,23,0,23,0,False,False,False,0,4,2021-11-01T14:44:42.703,23,False,0.0
2021,8,3172,860,13,8418,13,5,3,6,0,0,0,0,0,0,False,False,False,0,4,2021-11-01T14:42:54.713,0,False,0.0
2021,8,3172,865,13,6528,2,32,5,1,2,1,1,1,1,0,False,False,False,0,3,2021-11-01T14:44:32.08,2,False,1.0
2021,8,3172,870,13,1510,2,38,10,4,8,4,8,0,8,0,False,False,False,0,1,2021-11-01T14:46:25.77,8,False,0.0
2021,8,3172,875,13,6528,2,12,8,21,31,10,28,3,28,0,False,False,False,0,4,2022-02-24T15:24:06.677,31,False,3.0
2021,8,3172,880,13,2407,13,9,2,25,0,0,0,0,0,0,False,False,False,0,2,2021-11-01T14:50:21.45,0,False,0.0
2021,8,3173,10,8,3883,2,5,3,5,6,1,5,1,5,0,False,False,False,0,4,2021-11-01T09:12:41.46,6,False,1.0
2021,8,3173,20,8,232,13,7,5,11,0,0,0,0,0,0,False,False,False,0,3,2021-11-01T09:16:44.037,0,False,0.0
2021,8,3173,30,8,3606,2,6,1,16,16,0,16,0,16,0,False,False,False,0,3,2021-11-01T09:22:50.597,16,False,0.0
2021,8,3173,40,8,7652,2,4,5,10,12,2,12,0,12,0,False,False,False,0,2,2021-11-01T09:27:54.693,12,False,0.0
2021,8,3173,45,8,3883,2,5,5,4,8,4,7,1,7,0,True,False,False,0,4,2021-11-02T14:56:07.907,8,False,1.0
2021,8,3173,55,8,3883,3,32,3,3,0,0,0,0,0,0,False,False,False,0,4,2022-02-16T19:02:17.043,0,False,0.0
2021,8,3173,90,25,8422,2,2,9,5,11,6,7,4,7,0,False,False,False,0,3,2021-11-01T09:41:29.37,11,False,4.0
2021,8,3173,105,25,8422,13,5,5,9,0,0,0,0,0,0,False,False,False,0,4,2021-11-01T09:45:56.417,0,False,0.0
2021,8,3173,115,25,8422,2,39,4,4,8,4,8,0,8,0,False,False,False,0,3,2021-11-01T09:52:58.68,8,False,
2021,8,3173,120,25,8422,13,4,4,10,0,0,0,0,0,0,False,False,False,0,4,2021-11-01T09:55:13.443,0,False,0.0
2021,8,3173,135,8,8354,2,53,9,-4,14,18,11,3,11,0,False,False,False,0,4,2021-11-01T10:00:27.297,14,False,3.0
2021,8,3173,145,8,1067,2,50,9,-2,6,8,6,0,6,0,False,False,False,0,3,2021-11-03T23:57:51.11,6,False,0.0
2021,8,3173,155,8,232,2,7,2,15,19,4,17,2,17,0,False,False,False,0,3,2021-11-01T10:09:19.973,19,False,2.0
2021,8,3173,160,8,6439,2,44,9,-7,8,15,6,2,6,0,False,False,False,1,1,2021-11-01T15:31:32.993,8,False,2.0
2021,8,3173,185,25,8421,2,48,9,-4,6,10,2,4,2,0,False,False,False,0,1,2021-11-04T00:39:09.19,6,False,4.0
2021,8,3173,195,25,7666,2,4,4,12,12,0,12,0,12,0,False,False,False,0,3,2021-11-01T10:38:01.79,12,False,0.0
2021,8,3173,205,25,7060,2,3,2,15,17,2,17,0,17,0,False,False,False,0,2,2021-11-01T10:44:25.173,17,True,0.0
2021,8,3173,215,25,7053,13,23,1,18,0,0,0,0,0,0,True,False,False,0,3,2021-11-02T16:34:36.853,0,False,0.0
2021,8,3173,230,25,8422,2,5,5,6,9,3,8,1,8,0,False,False,False,1,3,2021-11-01T10:57:20.05,9,False,1.0
2021,8,3173,260,8,232,13,8,1,22,0,0,0,0,0,0,False,False,False,0,3,2021-11-01T11:06:37.183,0,False,0.0
2021,8,3173,265,8,3606,3,5,9,11,0,0,0,0,0,0,False,False,False,0,3,2022-02-16T19:03:49.093,0,False,0.0
2021,8,3173,280,25,7060,13,19,2,23,0,0,0,0,0,0,False,False,False,0,2,2021-11-01T11:10:39.267,0,False,0.0
2021,8,3173,290,25,7666,2,4,9,2,3,1,3,0,3,0,False,False,False,0,2,2022-02-24T15:25:41.88,3,False,0.0
2021,8,3173,310,8,232,13,4,9,10,0,0,0,0,0,0,False,False,False,0,2,2021-11-01T11:19:17.627,0,False,0.0
2021,8,3173,315,8,7009,3,48,9,1,0,0,0,0,0,0,False,False,False,0,1,2021-11-01T11:22:08.647,0,False,0.0
2021,8,3173,330,25,8421,2,48,10,-6,3,9,3,0,3,0,False,False,False,0,1,2021-11-01T11:26:50.583,3,False,0.0
2021,8,3173,345,25,6486,2,47,10,0,4,4,3,1,3,0,False,False,False,0,4,2021-11-01T11:31:20.67,4,False,1.0
2021,8,3173,350,25,7060,2,5,3,9,9,0,9,0,9,0,False,False,False,0,2,2021-11-01T11:33:43.91,9,True,0.0
2021,8,3173,375,25,7060,13,4,4,5,0,0,0,0,0,0,False,False,False,0,3,2021-11-04T00:23:03.147,0,False,0.0
2021,8,3173,400,25,7053,13,7,5,10,0,0,0,0,0,0,False,False,False,0,4,2021-11-04T00:00:46.143,0,False,0.0
2021,8,3173,410,8,7009,2,48,4,0,7,7,6,1,6,0,False,False,False,0,1,2021-11-04T00:23:10.847,7,False,1.0
2021,8,3173,415,8,3606,2,4,5,6,11,5,11,0,11,0,False,False,False,0,2,2021-11-01T11:53:15.637,11,True,0.0
2021,8,3173,425,8,7009,3,48,9,-2,0,0,0,0,0,0,False,False,False,0,1,2021-11-01T11:55:58.483,0,False,0.0
2021,8,3173,465,25,7060,13,4,3,4,0,0,0,0,0,0,False,False,False,0,2,2021-11-01T12:16:15.177,0,False,0.0
2021,8,3173,470,25,7060,13,8,7,15,0,0,0,0,0,0,False,False,False,0,2,2021-11-04T01:24:39.887,0,False,0.0
2021,8,3173,495,8,232,2,6,4,2,15,13,15,0,15,0,False,False,False,0,3,2021-11-01T12:24:54.473,15,False,0.0
2021,8,3173,500,8,7652,2,35,9,9,21,12,21,0,21,0,False,False,False,0,4,2021-11-01T12:27:24.027,21,False,0.0
2021,8,3173,510,8,3883,2,5,10,4,8,4,8,0,8,0,False,False,False,0,4,2021-11-01T12:29:52.387,8,False,0.0
2021,8,3173,540,25,7053,2,53,4,-3,2,5,2,0,2,0,False,False,False,0,4,2021-11-01T12:37:01.913,2,False,0.0
2021,8,3173,550,25,7060,2,4,5,13,12,-1,11,1,11,0,False,False,False,0,2,2021-11-04T01:24:47.733,12,False,1.0
2021,8,3173,560,25,7060,13,19,5,10,0,0,0,0,0,0,False,False,False,0,2,2021-11-01T12:58:39.883,0,False,0.0
2021,8,3173,565,25,7081,2,32,10,-2,7,9,5,2,5,0,False,False,False,0,1,2021-11-01T13:02:51.323,7,False,2.0
2021,8,3173,575,25,7666,2,9,3,12,16,4,12,4,12,0,False,False,False,0,2,2021-11-01T13:05:48.073,16,False,4.0
2021,8,3173,585,25,8422,2,46,3,0,22,22,2,20,2,0,False,False,False,1,3,2021-11-01T13:10:42.15,22,False,20.0
2021,8,3173,590,25,7060,2,5,3,4,4,0,4,0,4,0,False,False,False,0,2,2021-11-01T13:14:38.5,4,False,0.0
2021,8,3173,625,8,3606,13,6,10,6,0,0,0,0,0,0,False,False,False,0,2,2021-11-01T13:26:45.073,0,False,0.0
2021,8,3173,630,8,232,2,4,10,10,11,1,11,0,11,0,False,False,False,0,3,2021-11-04T00:56:49.607,11,False,0.0
2021,8,3173,650,25,7053,2,32,5,0,13,13,13,0,13,0,False,False,False,0,4,2021-11-01T13:38:38.407,13,False,0.0
2021,8,3173,660,25,8421,2,28,4,2,20,18,2,18,2,0,False,False,False,1,1,2021-11-03T23:51:41.437,20,False,18.0
2021,8,3173,695,25,7053,2,6,4,12,24,12,22,2,22,0,False,False,False,0,4,2021-11-01T13:57:27.073,24,False,2.0
2021,8,3173,700,25,7666,2,2,5,5,14,9,7,7,7,0,False,False,False,1,2,2021-11-01T13:59:29.997,14,False,7.0
2021,8,3173,710,25,8422,13,12,10,2,0,0,0,0,0,0,False,False,False,0,4,2021-11-01T14:05:10.11,0,False,0.0
2021,8,3173,715,25,7060,13,46,3,2,0,0,0,0,0,0,True,False,False,0,2,2021-11-01T14:07:20.357,0,False,0.0
2021,8,3173,725,25,8422,2,9,10,2,2,0,2,0,2,6,False,False,False,0,3,2021-11-01T14:09:57.49,2,True,0.0
2021,8,3173,745,8,4976,2,7,6,20,24,4,22,2,22,0,False,False,False,0,4,2021-11-01T14:15:16.3,24,False,2.0
2021,8,3173,750,8,4976,2,53,10,-4,9,13,7,2,7,0,False,False,False,0,4,2021-11-01T14:17:24.937,9,False,2.0
2021,8,3173,765,8,4976,2,39,4,6,6,0,6,0,6,0,False,False,False,0,4,2021-11-01T14:25:29.467,6,False,0.0
2021,8,3173,780,8,232,2,2,9,7,11,4,8,3,8,0,False,True,True,1,2,2021-11-01T14:31:13.877,11,False,3.0
2021,8,3173,790,25,7060,13,29,3,8,0,0,0,0,0,0,False,False,False,0,2,2021-11-01T14:37:25.617,0,False,0.0
2021,8,3173,795,25,7060,2,13,9,1,6,5,5,1,5,0,False,False,False,0,2,2021-11-01T14:44:52.95,6,False,1.0
2021,8,3173,825,8,232,2,46,3,3,9,6,5,4,5,0,False,False,False,0,3,2021-11-01T14:51:37.877,9,False,4.0
2021,8,3173,830,8,232,3,5,5,14,0,0,0,0,0,0,False,False,False,0,3,2021-11-04T01:26:06.593,0,False,0.0
2021,8,3173,840,8,1067,13,8,1,30,0,0,0,0,0,0,False,False,False,0,2,2021-11-02T14:55:30.073,0,False,
2021,8,3173,845,8,3883,13,12,3,13,0,0,0,0,0,0,False,False,False,0,4,2021-11-01T15:00:16.953,0,False,0.0
2021,8,3173,860,8,3883,2,31,10,3,4,1,3,1,3,0,False,False,False,0,4,2021-11-01T15:03:17.687,4,False,1.0
2021,8,3173,870,8,232,13,6,1,15,0,0,0,0,0,0,False,False,False,0,3,2021-11-04T01:24:55.617,0,False,0.0
2021,8,3173,885,25,7060,2,2,10,2,50,48,48,2,48,0,False,False,False,0,2,2021-11-01T15:08:10.777,50,False,2.0
2021,8,3174,10,11,6810,2,17,7,16,18,2,16,2,16,0,False,False,False,0,4,2021-11-01T09:49:13.547,18,False,2.0
2021,8,3174,25,11,6810,13,5,5,6,0,0,0,0,0,0,False,False,False,0,3,2021-11-02T20:48:37.91,0,True,0.0
2021,8,3174,35,24,8509,3,4,10,5,0,0,0,0,0,0,False,False,False,0,3,2021-11-01T10:13:45.643,0,True,0.0
2021,8,3174,45,24,7798,13,12,2,25,0,0,0,0,0,0,False,False,False,0,2,2021-11-01T10:50:51.643,0,True,0.0
2021,8,3174,55,11,6810,2,5,10,5,7,2,5,2,5,0,False,False,False,0,3,2021-11-01T10:53:40.24,7,False,2.0
2021,8,3174,60,11,8361,2,6,9,1,5,4,4,1,4,0,False,False,False,0,1,2021-11-01T10:56:42.853,5,False,1.0
2021,8,3174,75,11,6810,2,53,9,-4,8,12,3,5,3,0,False,False,False,0,4,2022-02-25T17:40:25.347,8,False,5.0
2021,8,3174,85,24,6373,2,53,10,-5,7,12,5,2,5,0,False,False,False,0,4,2021-12-05T18:42:36.163,7,False,2.0
2021,8,3174,115,24,7800,2,35,2,16,16,0,16,0,16,0,False,False,False,0,3,2021-11-01T11:32:42.91,16,False,0.0
2021,8,3174,130,24,7798,2,34,4,-5,0,5,0,0,0,0,True,False,False,0,3,2021-11-05T17:08:34.837,0,False,0.0
2021,8,3174,155,11,7732,2,50,3,-2,-1,1,-1,0,-1,0,True,False,False,0,2,2021-11-01T11:47:20.137,-1,False,0.0
2021,8,3174,205,24,6373,13,12,9,8,0,0,0,0,0,0,False,False,False,0,4,2021-11-01T12:16:34.97,0,True,0.0
2021,8,3174,225,11,8359,2,5,5,5,5,0,5,0,5,0,False,False,False,0,3,2021-11-01T12:25:03.4,5,False,0.0
2021,8,3174,230,11,8359,2,5,3,5,7,2,6,1,6,0,False,False,False,0,3,2021-11-01T12:27:42.417,7,False,1.0
2021,8,3174,250,11,6633,3,6,1,15,0,0,0,0,0,0,False,False,False,0,2,2021-11-01T12:40:56.003,0,True,0.0
2021,8,3174,260,11,7732,2,4,9,2,7,5,6,1,6,0,False,False,False,0,1,2021-11-01T12:43:22.333,7,False,1.0
2021,8,3174,290,24,6373,2,6,2,15,15,0,15,0,15,0,False,False,False,0,4,2021-11-01T13:12:38.2,15,False,0.0
2021,8,3174,295,24,6373,2,47,5,3,13,10,11,2,11,0,False,False,False,0,4,2021-11-02T17:26:51.04,13,False,2.0
2021,8,3174,325,11,6810,2,30,3,1,2,1,2,0,2,0,False,False,False,0,4,2021-11-01T13:47:49.84,2,False,0.0
2021,8,3174,340,11,6810,2,4,10,10,10,0,10,0,10,0,True,False,False,0,3,2021-11-02T20:52:55.22,10,False,0.0
2021,8,3174,355,11,6810,2,26,4,2,5,3,3,2,3,0,False,False,False,0,4,2021-11-01T13:56:07.937,5,False,2.0
2021,8,3174,365,11,6810,2,5,3,9,9,0,9,0,9,0,False,False,False,0,3,2021-11-01T13:58:05.293,9,True,0.0
2021,8,3174,370,11,8359,2,6,4,12,35,23,23,12,23,0,False,False,False,1,3,2021-11-01T14:00:37.277,35,False,
2021,8,3174,375,11,7732,2,5,3,0,2,2,1,1,1,0,False,False,False,0,1,2021-12-05T18:44:02.237,2,False,
2021,8,3174,385,11,6571,2,46,3,2,18,16,18,0,18,0,False,False,False,0,1,2021-11-01T17:37:59.95,18,False,0.0
2021,8,3174,400,11,7732,2,5,3,4,4,0,4,0,4,0,True,False,False,0,3,2021-11-02T20:53:06.967,4,False,0.0
2021,8,3174,440,24,8509,13,12,2,42,0,0,0,0,0,0,False,False,False,0,2,2021-11-05T17:14:20.707,0,True,0.0
2021,8,3174,455,24,6373,2,6,8,17,17,0,17,0,17,0,False,False,False,0,4,2021-11-01T14:41:17.033,17,False,0.0
2021,8,3174,470,24,6373,2,7,2,17,19,2,18,1,18,0,True,False,False,0,4,2021-11-02T17:27:15.23,19,False,1.0
2021,8,3174,505,11,8359,2,35,9,12,34,22,34,0,34,0,False,False,False,0,4,2022-01-06T16:46:44.31,34,False,0.0
2021,8,3174,515,11,8361,2,48,4,-2,0,2,0,0,0,0,False,False,False,0,1,2022-01-06T16:23:21.157,0,False,0.0
2021,8,3174,520,11,6815,2,39,4,7,9,2,9,0,9,0,False,False,False,0,3,2022-01-06T16:52:42.45,9,False,
2021,8,3174,530,11,4037,13,12,2,20,0,0,0,0,0,0,False,False,False,0,3,2022-02-16T19:18:46.633,0,True,0.0
2021,8,3174,535,24,6373,2,53,10,-6,1,7,-1,2,-1,0,False,False,False,0,4,2022-02-25T20:04:33.113,1,False,2.0
2021,8,3174,540,24,6389,3,12,5,1,0,0,0,0,0,0,False,False,False,0,1,2022-02-16T19:19:28.25,0,True,0.0
2021,8,3174,545,24,8509,2,3,2,15,15,0,15,0,15,0,False,False,False,0,2,2021-11-01T15:38:18.207,15,False,0.0
2021,8,3174,595,11,7732,2,5,10,5,8,3,8,0,8,0,False,True,True,0,1,2021-11-01T15:51:55.123,8,False,0.0
2021,8,3174,610,11,7732,2,4,9,4,6,2,6,0,6,0,False,False,False,0,1,2021-11-01T15:55:36.717,6,False,0.0
2021,8,3174,625,11,6810,2,5,5,10,11,1,10,1,10,0,True,False,False,1,3,2021-11-02T20:53:20.29,11,False,1.0
2021,8,3174,630,11,8359,13,6,4,11,0,0,0,0,0,0,False,False,False,0,3,2021-11-01T16:02:14.75,0,True,0.0
2021,8,3174,635,24,7800,2,49,5,-4,2,6,-1,3,-1,0,False,False,False,1,2,2021-11-05T15:55:05.197,2,False,3.0
2021,8,3174,665,24,8666,2,53,9,-5,9,14,6,3,6,0,False,False,False,0,4,2021-12-05T18:46:13.92,9,False,3.0
2021,8,3174,680,11,8361,2,4,4,4,11,7,9,2,9,0,False,False,False,0,1,2021-11-01T16:23:26.583,11,False,2.0
2021,8,3174,685,11,8361,2,28,4,1,7,6,5,2,5,0,False,False,False,0,1,2021-11-01T16:25:58.71,7,False,2.0
2021,8,3174,690,11,6810,2,4,10,5,9,4,7,2,7,0,False,False,False,0,3,2021-11-01T16:27:44.333,9,False,2.0
2021,8,3174,695,11,6571,2,28,4,3,17,14,16,1,16,0,False,False,False,1,1,2021-11-01T16:43:54.187,17,False,1.0
2021,8,3174,700,11,6815,13,19,6,23,0,0,0,0,0,0,False,False,False,0,2,2021-11-01T16:43:42.077,0,True,0.0
2021,8,3174,705,11,6571,2,4,10,3,5,2,3,2,3,0,False,False,False,0,1,2021-11-01T16:45:13.47,5,False,2.0
2021,8,3174,710,11,6633,13,19,2,18,0,0,0,0,0,0,False,False,False,0,2,2022-02-16T19:20:22.697,0,True,0.0
2021,8,3174,715,11,6810,2,11,5,6,10,4,8,2,8,0,True,False,False,0,4,2021-11-01T16:48:42.04,10,False,2.0
2021,8,3174,725,11,8359,13,5,9,5,0,0,0,0,0,0,False,False,False,0,3,2021-11-01T16:51:47.063,0,True,0.0
2021,8,3175,10,28,7224,3,2,5,5,0,0,0,0,0,0,False,False,False,0,2,2021-11-01T09:16:44.723,0,False,0.0
2021,8,3175,15,28,7619,13,9,6,27,0,0,0,0,0,0,False,False,False,0,3,2021-11-01T09:19:30.453,0,False,0.0
2021,8,3175,20,28,917,2,2,4,11,21,10,13,8,13,0,False,False,False,0,3,2021-11-01T09:23:45.367,21,False,8.0
2021,8,3175,45,28,7224,2,44,3,-4,-4,0,-4,0,-4,0,True,False,False,0,1,2021-11-01T09:33:16.75,-4,False,0.0
2021,8,3175,50,28,7224,3,13,10,6,0,0,0,0,0,0,False,False,False,0,2,2021-11-01T09:35:00.753,0,False,0.0
2021,8,3175,60,28,917,2,12,8,19,19,0,19,0,19,0,False,False,False,0,3,2021-11-04T13:40:09.39,19,False,0.0
2021,8,3175,85,6,7725,2,4,5,12,14,2,13,1,13,0,False,False,False,0,2,2021-11-01T09:48:57.13,14,False,1.0
2021,8,3175,100,6,7725,2,5,3,4,6,2,6,0,6,0,False,False,False,0,3,2021-11-01T09:55:05.2,6,False,0.0
2021,8,3175,110,6,8365,2,48,9,-2,15,17,12,3,12,0,False,False,False,0,1,2021-11-01T10:02:49.71,15,False,
2021,8,3175,115,6,2714,2,4,9,7,11,4,10,1,10,0,False,False,False,0,2,2021-11-04T13:16:51.403,11,False,1.0
2021,8,3175,140,28,7224,2,26,10,5,11,6,9,2,9,0,False,False,False,0,3,2021-11-01T10:11:36.53,11,False,2.0
2021,8,3175,150,28,7753,13,5,2,18,0,0,0,0,0,0,False,False,False,0,3,2021-11-04T15:17:11.397,0,False,0.0
2021,8,3175,155,28,7751,2,5,5,2,6,4,6,0,6,0,False,False,False,0,1,2022-02-24T18:54:47.807,6,False,0.0
2021,8,3175,175,6,7728,13,6,9,12,0,0,0,0,0,0,False,False,False,0,3,2021-11-01T10:20:37.83,0,False,0.0
2021,8,3175,190,6,7725,2,39,9,8,11,3,9,2,9,0,False,False,False,0,3,2021-11-04T14:06:31.787,11,False,2.0
2021,8,3175,195,6,7728,2,33,9,4,16,12,13,3,13,0,False,False,False,0,4,2021-11-04T13:16:51.403,16,False,3.0
2021,8,3175,225,6,7728,2,13,9,4,6,2,4,2,4,0,False,False,False,0,4,2021-11-01T10:35:55.977,6,False,2.0
2021,8,3175,235,6,2714,2,7,3,8,8,0,8,0,8,6,False,False,False,0,4,2021-11-01T10:38:36.74,8,True,0.0
2021,8,3175,260,28,7619,2,12,5,12,23,11,16,7,16,0,False,False,False,0,3,2021-11-01T10:45:28.087,23,False,7.0
2021,8,3175,265,28,7224,2,6,1,17,16,-1,16,0,16,0,False,False,False,0,3,2021-11-01T10:47:20.737,16,False,0.0
2021,8,3175,275,28,7753,13,6,10,3,0,0,0,0,0,0,False,False,False,0,3,2021-11-04T15:13:10.57,0,False,0.0
2021,8,3175,285,28,917,13,6,4,8,0,0,0,0,0,0,False,False,False,0,3,2021-11-04T13:16:51.403,0,False,0.0
2021,8,3175,310,6,7725,13,4,7,16,0,0,0,0,0,0,False,False,False,0,3,2021-11-01T15:11:41.42,0,False,0.0
2021,8,3175,315,6,464,2,4,3,6,10,4,10,0,10,0,False,False,False,0,3,2021-11-01T11:04:45.263,10,False,0.0
2021,8,3175,330,6,7725,2,47,5,4,4,0,4,0,4,0,False,False,False,0,3,2021-11-01T11:09:27.03,4,True,0.0
2021,8,3175,340,6,7725,2,4,5,5,6,1,6,0,6,0,False,False,False,0,2,2021-11-04T14:06:06.963,6,False,
2021,8,3175,380,6,7728,2,38,10,2,2,0,2,0,2,0,False,False,False,0,3,2021-11-01T11:28:03.89,2,False,0.0
2021,8,3175,385,6,8365,2,51,3,-7,-6,1,-6,0,-6,0,False,False,False,0,1,2021-11-04T13:16:51.403,-6,False,0.0
2021,8,3175,410,28,7619,13,3,3,14,0,0,0,0,0,0,False,False,False,0,2,2021-11-01T11:32:48.303,0,False,0.0
2021,8,3175,415,28,7619,2,2,9,5,6,1,6,0,6,0,False,False,False,0,2,2021-11-01T11:36:25.133,6,False,0.0
2021,8,3175,420,28,7619,2,2,9,5,15,10,9,6,9,0,False,False,False,0,3,2021-11-01T11:35:54.69,15,False,6.0
2021,8,3175,430,28,7224,2,8,8,46,50,4,46,4,46,0,False,False,False,0,2,2021-11-01T11:38:28.533,50,False,4.0
2021,8,3175,445,28,7224,13,13,5,4,0,0,0,0,0,0,False,False,False,0,3,2021-11-01T11:42:46.543,0,False,0.0
2021,8,3175,465,6,2714,2,27,3,14,19,5,19,0,19,0,False,False,False,0,4,2021-11-04T15:15:37.597,19,False,0.0
2021,8,3175,480,6,464,13,6,9,11,0,0,0,0,0,0,False,False,False,0,3,2022-02-14T20:35:41.867,0,False,0.0
2021,8,3175,490,6,1378,2,2,10,11,22,11,13,9,13,0,False,False,False,0,2,2021-11-01T12:04:01.703,22,False,9.0
2021,8,3175,500,6,464,2,4,9,6,6,0,6,0,6,0,False,False,False,0,3,2021-11-02T15:45:10.83,6,False,0.0
2021,8,3175,515,6,8365,2,47,5,0,2,2,1,1,1,0,False,False,False,0,1,2021-11-01T12:18:05.163,2,False,1.0
2021,8,3175,520,6,7728,13,29,9,7,0,0,0,0,0,0,False,False,False,0,3,2021-11-02T15:45:36.487,0,False,0.0
2021,8,3175,545,28,7619,2,50,5,0,3,3,3,0,3,0,False,False,False,0,2,2021-11-01T12:26:53.593,1,False,0.0
2021,8,3175,550,28,7760,13,5,5,9,0,0,0,0,0,0,False,False,False,0,4,2021-11-01T15:14:29.577,0,False,0.0
2021,8,3175,555,28,7224,2,50,9,-4,83,87,19,64,19,0,False,False,False,0,3,2021-11-04T13:16:51.403,83,False,64.0
2021,8,3175,570,28,7619,13,6,9,2,0,0,0,0,0,0,False,False,False,0,2,2021-11-01T12:38:38.1,0,False,0.0
2021,8,3175,605,6,7725,2,5,5,2,9,7,9,0,9,0,False,False,False,1,3,2021-11-04T13:52:23.523,9,False,0.0
2021,8,3175,630,6,7728,13,32,3,0,0,0,0,0,0,0,False,False,False,0,1,2021-11-01T13:12:21.937,0,False,0.0
2021,8,3175,645,28,7224,2,6,1,18,15,-3,15,0,15,0,False,False,False,0,3,2022-02-16T18:52:53.763,15,False,0.0
2021,8,3175,655,28,7760,2,5,10,5,7,2,6,1,6,0,False,False,False,0,3,2021-11-01T13:19:48.897,7,False,1.0
2021,8,3175,660,28,262,2,5,9,5,11,6,8,3,8,0,False,False,False,0,3,2021-11-01T13:21:06.9,11,False,3.0
2021,8,3175,695,6,1378,2,4,3,4,10,6,7,3,7,0,False,True,False,0,2,2022-01-28T00:07:16.633,10,False,3.0
2021,8,3175,710,6,7725,2,4,2,15,20,5,16,4,16,0,False,False,False,0,2,2021-11-01T14:03:41.953,20,False,4.0
2021,8,3175,715,6,1378,13,6,10,14,0,0,0,0,0,0,False,False,False,0,2,2021-11-01T14:05:20.387,0,False,0.0
2021,8,3175,725,6,464,2,5,3,5,5,0,5,0,5,0,False,False,False,0,3,2021-11-01T14:08:36.12,5,False,0.0
2021,8,3175,750,28,917,2,6,1,15,19,4,19,0,19,0,False,False,False,0,3,2021-11-01T14:18:03.353,19,False,0.0
2021,8,3175,765,28,7751,2,2,10,6,23,17,19,4,19,0,True,False,False,0,3,2021-11-02T15:33:32.577,23,False,4.0
2021,8,3175,795,6,464,13,6,10,13,0,0,0,0,0,0,False,False,False,0,3,2021-11-01T15:04:18.527,0,False,
2021,8,3175,805,6,7725,13,19,2,35,0,0,0,0,0,0,True,False,False,0,3,2021-11-02T15:46:04.917,0,False,0.0
2021,8,3175,880,6,7725,13,8,7,59,0,0,0,0,0,0,False,False,False,0,3,2022-02-16T18:58:47.943,0,False,0.0
2021,8,3176,25,2,8389,13,7,6,17,0,0,0,0,0,0,False,False,False,0,2,2021-11-01T11:56:18.373,0,False,0.0
2021,8,3176,50,5,8408,2,39,4,4,4,0,4,0,4,0,False,False,False,0,3,2021-11-01T12:02:30.653,4,False,0.0
2021,8,3176,75,5,566,2,48,10,-3,17,20,6,11,6,0,False,False,False,1,1,2022-02-16T18:17:26.623,17,False,11.0
2021,8,3176,85,5,8413,2,51,5,-3,-2,1,-2,0,-2,0,False,False,False,0,3,2021-11-02T21:22:21.87,-2,False,0.0
2021,8,3176,90,5,8408,2,4,4,12,13,1,13,0,13,0,False,False,False,0,3,2021-11-04T18:55:16.237,13,False,0.0
2021,8,3176,100,5,5220,13,9,3,11,0,0,0,0,0,0,False,False,False,0,3,2021-11-01T12:23:17.127,0,False,0.0
2021,8,3176,105,5,566,13,48,10,-5,0,0,0,0,0,0,True,False,False,0,1,2021-11-02T21:24:01.957,0,False,0.0
2021,8,3176,120,2,2554,2,47,5,0,4,4,3,1,3,0,False,False,False,0,1,2021-11-01T12:29:00.69,4,False,1.0
2021,8,3176,130,2,2554,13,39,10,2,0,0,0,0,0,0,True,False,False,0,3,2021-11-01T12:33:59.05,0,False,0.0
2021,8,3176,150,5,8409,13,28,4,3,0,0,0,0,0,0,False,False,False,0,1,2021-11-01T12:39:02.077,0,False,0.0
2021,8,3176,155,5,6425,2,4,9,6,10,4,8,2,8,0,False,False,False,0,3,2021-11-01T12:40:58.723,10,False,2.0
2021,8,3176,165,2,7303,2,6,4,12,12,0,12,0,12,0,False,False,False,0,2,2021-11-01T12:43:44.48,12,False,0.0
2021,8,3176,175,2,8389,13,6,10,13,0,0,0,0,0,0,False,False,False,0,2,2021-11-02T22:09:39.803,0,False,
2021,8,3176,185,2,2554,2,48,9,-4,3,7,-1,4,-1,0,False,False,False,1,1,2021-11-01T12:51:39.37,3,False,4.0
2021,8,3176,190,2,5214,2,4,10,4,7,3,5,2,5,0,False,False,False,0,4,2021-11-01T12:54:19.56,7,False,2.0
2021,8,3176,195,2,3506,2,4,9,5,7,2,6,1,6,0,False,False,False,0,2,2021-11-01T12:56:54.85,7,False,1.0
2021,8,3176,215,2,811,2,4,9,2,15,13,3,12,3,6,False,False,False,1,3,2021-11-04T18:58:18.267,15,False,12.0
2021,8,3176,245,5,5220,2,8,8,15,23,8,21,2,21,0,False,False,False,0,3,2021-11-04T17:54:02.953,23,False,2.0
2021,8,3176,250,5,566,2,48,10,-2,7,9,5,2,5,0,False,False,False,0,1,2021-11-01T13:15:00.59,7,False,2.0
2021,8,3176,280,2,8389,2,2,9,7,11,4,7,4,7,0,False,False,False,2,2,2021-11-04T18:58:44.1,11,False,4.0
2021,8,3176,290,2,2554,2,32,5,-7,2,9,2,0,2,0,False,False,False,1,1,2021-11-04T18:58:56.747,2,False,0.0
2021,8,3176,295,2,8389,13,5,10,9,0,0,0,0,0,0,False,False,False,0,3,2021-11-01T14:10:02.627,0,False,
2021,8,3176,310,2,8389,2,5,5,2,2,0,2,0,2,0,False,False,False,0,3,2021-11-01T14:08:41.187,2,False,0.0
2021,8,3176,315,2,811,2,18,9,-2,1,3,0,1,0,0,True,False,False,1,2,2021-11-04T19:05:52.493,1,False,1.0
2021,8,3176,330,2,5214,13,6,10,9,0,0,0,0,0,0,False,False,False,0,3,2021-11-04T18:57:28.65,0,False,0.0
2021,8,3176,340,5,6282,3,28,10,-1,0,0,0,0,0,0,False,False,False,0,1,2021-11-01T14:34:09.797,0,False,0.0
2021,8,3176,360,5,8408,3,7,6,19,0,0,0,0,0,0,False,False,False,0,4,2021-11-01T14:45:16.41,0,False,0.0
2021,8,3176,365,5,566,13,11,3,14,0,0,0,0,0,0,False,False,False,0,1,2021-11-01T14:47:44.657,0,False,0.0
2021,8,3176,405,5,8409,2,31,10,3,9,6,9,0,9,0,False,False,False,0,1,2021-11-01T15:00:00.603,9,True,0.0
2021,8,3176,410,5,5220,2,6,1,20,21,1,21,0,21,0,False,False,False,0,2,2021-11-01T15:01:41.753,21,False,0.0
2021,8,3176,420,5,5220,2,51,5,-3,4,7,4,0,4,0,False,False,False,0,2,2021-11-04T14:54:37.37,4,True,0.0
2021,8,3176,425,5,5220,13,51,5,-3,0,0,0,0,0,0,False,False,False,0,2,2022-02-16T18:23:07.65,0,False,0.0
2021,8,3176,445,2,811,2,2,4,11,18,7,14,4,14,0,False,False,False,0,2,2021-11-01T15:22:29.977,18,False,4.0
2021,8,3176,455,2,811,2,4,9,1,1,0,1,0,1,0,False,False,False,0,1,2021-11-01T15:25:46.033,1,False,0.0
2021,8,3176,495,5,3477,13,35,6,21,0,0,0,0,0,0,False,False,False,0,2,2021-11-01T16:07:01.817,0,False,0.0
2021,8,3176,520,5,5220,2,2,9,9,11,2,10,1,10,0,False,False,False,0,3,2021-11-01T15:55:07.277,11,False,1.0
2021,8,3176,540,5,8408,2,30,5,-1,1,2,1,0,1,0,False,False,False,0,4,2021-11-01T16:02:47.8,1,False,0.0
2021,8,3176,545,5,5220,13,2,4,5,0,0,0,0,0,0,False,False,False,0,3,2022-02-16T18:27:21.947,0,False,0.0
2021,8,3176,565,2,5214,2,30,4,-3,-3,0,-3,0,-3,0,False,False,False,0,4,2022-02-14T20:37:50.847,-3,False,0.0
2021,8,3176,570,2,811,2,16,10,0,2,2,2,0,2,0,False,False,False,0,1,2021-11-01T16:13:56.897,2,False,0.0
2021,8,3176,585,2,3506,2,6,4,7,9,2,7,2,7,0,False,False,False,0,3,2021-11-01T16:29:04.257,9,False,2.0
2021,8,3176,605,2,8389,3,9,6,17,0,0,0,0,0,0,False,False,False,0,3,2021-11-04T18:56:58.677,0,False,0.0
2021,8,3176,650,5,566,2,16,10,4,11,7,10,1,10,0,True,False,False,0,1,2021-11-01T16:57:01.49,11,False,1.0
2021,8,3176,665,5,5220,13,6,10,7,0,0,0,0,0,0,True,False,False,0,3,2021-11-01T17:57:22.293,0,False,0.0
2021,8,3176,685,5,6562,13,12,5,1,0,0,0,0,0,0,False,False,False,0,3,2022-02-24T15:30:12.25,0,False,0.0
2021,8,3176,710,2,8389,13,9,2,25,0,0,0,0,0,0,False,False,False,0,2,2021-11-01T17:27:27.5,0,False,0.0
2021,8,3176,760,2,3506,2,6,1,15,17,2,16,1,16,0,False,False,False,0,3,2021-11-04T19:06:07.003,17,False,1.0
2021,8,3176,765,2,2554,2,4,4,0,5,5,3,2,3,0,False,False,False,0,1,2021-11-01T17:47:30.393,5,False,2.0
2021,8,3176,770,2,2554,2,28,10,-3,8,11,6,2,6,0,False,False,False,0,1,2021-11-01T17:53:16.65,8,False,2.0
2021,8,3176,780,2,3506,13,19,6,32,0,0,0,0,0,0,False,False,False,0,2,2021-11-01T17:54:54.637,0,False,0.0
2021,8,3176,785,2,3506,2,2,9,12,15,3,15,0,15,0,False,False,False,0,2,2021-11-04T18:57:12.293,15,False,0.0
2021,8,3176,795,2,8389,13,35,7,15,0,0,0,0,0,0,False,False,False,0,3,2021-11-04T18:57:45.437,0,False,0.0
2021,8,3176,835,2,3506,2,4,10,10,10,0,10,0,10,0,False,False,False,0,3,2021-11-01T18:06:47.563,10,False,0.0
2021,8,3176,840,2,3506,13,12,5,5,0,0,0,0,0,0,False,False,False,0,2,2021-11-01T18:08:50.963,0,False,
2021,8,3177,10,4,6983,2,44,3,-3,1,4,1,0,1,0,True,False,False,0,1,2021-11-01T09:19:28.593,1,False,0.0
2021,8,3177,20,4,2853,13,13,5,10,0,0,0,0,0,0,False,False,False,0,2,2021-11-01T09:25:42.403,0,False,0.0
2021,8,3177,40,17,2253,2,9,2,18,23,5,23,0,23,0,False,False,False,0,2,2021-11-01T09:54:30.263,23,False,0.0
2021,8,3177,50,17,2253,13,2,5,13,0,0,0,0,0,0,False,False,False,0,2,2021-11-01T09:54:10.603,0,False,0.0
2021,8,3177,55,17,8483,2,5,3,1,7,6,1,6,1,0,False,False,False,1,3,2021-11-04T19:40:20.947,7,False,6.0
2021,8,3177,65,17,2253,2,4,10,8,8,0,8,0,8,0,False,False,False,0,2,2022-02-14T20:39:24.273,8,False,0.0
2021,8,3177,75,17,8483,13,46,3,3,0,0,0,0,0,0,False,False,False,0,3,2021-11-04T19:41:26.37,0,False,0.0
2021,8,3177,80,17,8483,2,13,5,0,0,0,0,0,0,0,False,False,False,0,2,2021-11-04T19:39:12.49,0,False,0.0
2021,8,3177,110,4,213,13,24,6,39,0,0,0,0,0,0,False,False,False,0,3,2021-11-01T10:26:20.927,0,False,0.0
2021,8,3177,140,17,2253,2,2,9,7,14,7,13,1,13,0,False,False,False,0,3,2021-11-01T10:35:31.753,14,False,1.0
2021,8,3177,155,17,8483,13,5,5,3,0,0,0,0,0,0,True,False,False,0,3,2021-11-04T18:50:03.637,0,False,0.0
2021,8,3177,160,17,8483,2,5,3,5,8,3,7,1,7,0,False,False,False,0,3,2021-12-03T21:01:14.197,8,False,
2021,8,3177,165,17,2253,2,2,4,9,15,6,15,0,15,0,False,False,False,0,2,2021-11-04T19:42:12.377,15,False,0.0
2021,8,3177,175,17,4752,13,2,9,4,0,0,0,0,0,0,False,False,False,0,2,2021-11-01T10:56:03.183,0,False,0.0
2021,8,3177,200,4,7646,2,4,9,6,11,5,9,2,9,0,False,False,False,0,3,2021-11-01T11:06:52.153,11,False,2.0
2021,8,3177,205,4,2853,2,50,3,-1,8,9,5,3,5,0,False,False,False,0,2,2021-11-01T11:09:20.543,8,False,3.0
2021,8,3177,210,4,594,2,49,3,-3,1,4,-1,2,-1,0,False,False,False,0,2,2021-11-01T11:11:53.26,1,False,2.0
2021,8,3177,235,17,7024,2,13,4,3,22,19,6,16,6,0,True,False,False,1,2,2021-11-04T17:58:03.287,22,False,16.0
2021,8,3177,265,4,594,2,17,7,19,20,1,20,0,20,0,False,False,False,0,3,2021-11-01T11:30:49.577,20,False,0.0
2021,8,3177,270,4,2853,2,50,5,-2,3,5,1,2,1,0,False,False,False,1,2,2021-11-01T11:33:05.773,3,False,2.0
2021,8,3177,275,4,213,13,20,6,23,0,0,0,0,0,0,False,False,False,0,2,2021-11-04T18:27:51.843,0,False,0.0
2021,8,3177,280,4,2853,13,35,3,12,0,0,0,0,0,0,False,False,False,0,2,2021-11-04T15:13:18.177,0,False,0.0
2021,8,3177,290,17,8483,13,5,3,12,0,0,0,0,0,0,False,False,False,0,2,2021-11-01T11:47:38.657,0,False,0.0
2021,8,3177,300,17,8483,2,4,5,6,12,6,9,3,9,0,False,False,False,0,2,2021-11-01T11:51:40.127,12,False,3.0
2021,8,3177,305,17,2253,2,4,5,4,8,4,3,5,3,0,False,False,False,1,2,2021-11-04T18:28:29.753,8,False,5.0
2021,8,3177,315,17,6274,2,4,9,3,3,0,3,0,3,0,False,False,False,0,3,2021-11-01T11:57:37.23,3,False,0.0
2021,8,3177,325,17,7051,2,46,3,3,11,8,9,2,9,0,False,False,False,0,1,2021-11-04T19:09:27.433,11,False,
2021,8,3177,335,17,4383,13,4,3,13,0,0,0,0,0,0,False,False,False,0,2,2021-11-04T19:11:33.577,0,False,0.0
2021,8,3177,345,4,7645,2,48,10,-3,15,18,12,3,12,0,False,False,False,0,1,2021-11-04T19:12:00.143,15,False,3.0
2021,8,3177,355,4,7646,2,51,9,0,7,7,5,2,5,0,False,False,False,0,3,2021-11-01T12:18:24.55,7,False,2.0
2021,8,3177,360,4,7645,2,44,3,-3,8,11,6,2,6,0,False,False,False,0,1,2021-11-01T12:21:20.403,8,False,2.0
2021,8,3177,365,4,6990,13,9,3,13,0,0,0,0,0,0,False,False,False,0,3,2021-11-01T12:23:50.4,0,False,0.0
2021,8,3177,370,4,7645,13,48,10,-4,0,0,0,0,0,0,False,False,False,0,1,2022-02-16T18:33:29.497,0,False,0.0
2021,8,3177,375,4,6990,2,13,9,4,6,2,5,1,5,0,False,False,False,0,3,2021-11-01T12:28:40.65,6,False,1.0
2021,8,3177,385,17,4484,2,5,10,6,8,2,6,2,6,0,False,False,False,0,4,2021-11-01T12:36:29.193,8,False,2.0
2021,8,3177,400,17,6274,2,2,4,4,5,1,4,1,4,0,False,False,False,0,3,2021-11-01T12:41:57.787,5,False,1.0
2021,8,3177,410,17,8483,13,2,9,4,0,0,0,0,0,0,False,False,False,0,2,2021-11-01T12:44:10.167,0,False,0.0
2021,8,3177,445,17,2253,2,4,3,2,1,-1,1,0,1,0,False,False,False,0,2,2021-11-01T13:10:50.03,1,False,0.0
2021,8,3177,465,4,594,13,4,10,2,0,0,0,0,0,0,False,False,False,0,3,2021-11-01T13:20:50.677,0,False,0.0
2021,8,3177,470,4,594,13,6,9,8,0,0,0,0,0,0,False,False,False,0,2,2021-11-01T13:27:44.71,0,False,0.0
2021,8,3177,480,17,7024,2,47,5,-2,-1,1,-1,0,-1,0,True,False,False,0,1,2021-11-04T19:14:18.563,-1,False,0.0
2021,8,3177,490,17,8483,13,3,5,11,0,0,0,0,0,0,True,False,False,0,2,2021-11-02T22:17:06.437,0,False,0.0
2021,8,3177,500,4,7645,2,4,10,1,7,6,4,3,4,0,False,False,False,0,1,2021-12-03T20:58:32.79,7,False,
2021,8,3177,515,4,594,13,4,9,2,0,0,0,0,0,0,False,False,False,0,3,2021-11-01T13:52:37.54,0,False,0.0
2021,8,3177,520,4,594,2,5,9,11,15,4,15,0,15,0,False,False,False,0,3,2021-11-01T13:56:23.383,15,False,0.0
2021,8,3177,525,4,7645,2,12,3,3,4,1,4,0,4,0,False,False,False,0,1,2022-02-24T15:42:17.697,4,False,0.0
2021,8,3177,530,4,594,2,47,5,0,10,10,8,2,8,0,True,False,False,0,3,2021-11-04T19:15:13.313,10,False,2.0
2021,8,3177,535,4,594,2,5,3,5,6,1,6,0,6,0,False,False,False,0,2,2021-11-01T14:09:14.6,6,False,0.0
2021,8,3177,540,4,594,2,49,5,-3,3,6,3,0,3,0,False,False,False,0,2,2021-11-04T17:56:34.377,3,False,0.0
2021,8,3177,565,4,7646,2,51,10,-1,3,4,2,1,2,0,False,False,False,0,4,2021-11-02T18:33:22.037,3,False,1.0
2021,8,3177,570,4,6990,13,17,4,11,0,0,0,0,0,0,False,False,False,0,4,2021-11-02T18:34:31.537,0,False,
2021,8,3177,575,4,7646,2,12,5,8,8,0,0,8,0,6,False,False,False,0,4,2022-02-24T15:42:41.913,8,False,8.0
2021,8,3177,595,17,7618,2,4,3,0,6,6,4,2,4,0,False,False,False,0,1,2021-11-04T19:18:11.537,6,False,2.0
2021,8,3177,600,17,7024,13,9,3,8,0,0,0,0,0,0,False,False,False,0,3,2022-02-16T18:42:09.493,0,False,0.0
2021,8,3177,610,4,213,2,42,9,5,8,3,7,1,7,0,False,False,False,0,3,2021-11-04T19:54:59.207,8,False,
2021,8,3177,615,4,213,3,4,9,4,0,0,0,0,0,0,False,False,False,0,3,2022-02-16T18:42:41.037,0,False,0.0
2021,8,3177,620,4,594,2,2,10,14,17,3,15,2,15,0,False,False,False,0,3,2021-11-01T15:00:07.983,17,False,2.0
2021,8,3177,630,4,2853,2,50,5,0,11,11,5,6,5,0,False,False,False,0,2,2021-11-01T15:03:31.65,11,False,6.0
2021,8,3177,655,4,594,2,5,3,11,14,3,14,0,14,0,False,False,False,0,3,2021-11-01T15:11:17.55,14,True,0.0
2021,8,3177,660,4,7646,13,19,2,19,0,0,0,0,0,0,False,False,False,0,2,2022-02-16T18:43:16.693,0,False,0.0
2021,8,3177,665,4,2853,2,8,9,14,19,5,18,1,18,6,True,False,False,0,2,2021-11-02T18:36:05.817,19,False,1.0
2021,8,3177,680,17,8483,13,8,7,23,0,0,0,0,0,0,False,False,False,0,2,2021-11-01T15:30:52.713,0,False,0.0
2021,8,3177,685,17,2253,2,4,3,4,12,8,10,2,10,0,False,False,False,0,2,2021-11-04T19:18:44.623,12,False,2.0
2021,8,3177,690,17,6274,13,6,9,6,0,0,0,0,0,0,True,False,False,0,3,2021-11-04T19:19:59.797,0,False,0.0
2021,8,3177,705,17,8483,2,4,5,10,10,0,10,0,10,0,False,False,False,0,3,2021-11-01T15:51:24.963,10,False,0.0
2021,8,3177,710,17,2253,2,4,10,3,4,1,3,1,3,0,False,False,False,0,3,2021-11-01T15:55:00.723,4,False,1.0
2021,8,3177,715,17,7618,13,6,9,2,0,0,0,0,0,0,False,False,False,0,2,2021-11-01T15:56:59.25,0,False,0.0
2021,8,3177,720,17,2253,13,3,5,9,0,0,0,0,0,0,False,False,False,0,2,2021-11-04T19:55:07.5,0,False,0.0
2021,8,3177,725,17,6274,2,35,2,27,40,13,35,5,35,0,False,False,False,0,3,2021-11-04T19:38:09.66,40,False,5.0
2021,8,3177,750,4,6990,2,35,9,12,13,1,13,0,13,0,False,False,False,0,4,2021-11-01T16:09:50.97,13,False,0.0
2021,8,3177,755,4,7645,2,50,5,-1,1,2,1,0,1,0,False,False,False,0,2,2021-11-01T17:40:13.453,1,False,0.0
2021,8,3177,760,4,6990,2,4,10,3,11,8,8,3,8,0,False,False,False,0,1,2021-11-04T17:58:51.923,11,False,3.0
2021,8,3177,765,4,2853,2,51,9,-2,-1,1,-1,0,-1,0,False,False,False,0,3,2021-11-01T16:17:12.657,-1,False,0.0
2021,8,3177,770,4,213,13,19,2,33,0,0,0,0,0,0,False,False,False,0,2,2021-11-01T16:21:28.673,0,False,0.0
2021,8,3177,775,4,594,2,8,1,16,20,4,20,0,20,0,False,False,False,0,3,2021-11-01T16:24:09.823,20,False,0.0
2021,8,3177,785,4,213,13,6,10,12,0,0,0,0,0,0,False,False,False,0,3,2021-11-04T19:38:42.277,0,False,
2021,8,3177,810,4,7645,2,44,9,-6,8,14,8,0,8,0,True,False,False,0,1,2021-11-01T16:48:02.01,8,False,0.0
2021,8,3177,835,4,594,2,50,9,-4,4,8,3,1,3,0,True,False,False,1,2,2021-11-04T19:42:32.68,4,False,1.0
2021,8,3177,845,4,7645,2,51,10,-5,3,8,2,1,2,0,True,False,False,0,1,2022-02-16T18:44:56.467,3,False,1.0
2021,8,3177,865,17,7051,2,32,9,-2,10,12,9,1,9,0,False,False,False,0,1,2021-11-01T17:10:17.827,10,False,1.0
2021,8,3177,870,17,2253,3,6,10,14,0,0,0,0,0,0,False,False,False,0,2,2021-11-04T19:32:17.5,0,False,0.0
2021,8,3177,875,17,8483,13,12,5,5,0,0,0,0,0,0,False,False,False,0,3,2021-11-01T17:15:50.48,0,False,
2021,8,3177,885,17,2253,13,6,8,18,0,0,0,0,0,0,False,False,False,0,2,2021-11-04T19:34:14.933,0,False,0.0
2021,8,3177,920,17,7024,2,50,10,-4,-2,2,-2,0,-2,0,True,False,False,0,3,2021-11-04T17:56:21.003,-2,False,0.0
2021,8,3178,10,26,958,2,26,10,4,12,8,8,4,8,0,False,False,False,0,3,2021-11-04T18:27:43.017,12,False,4.0
2021,8,3178,20,26,309,2,7,2,23,41,18,37,4,37,0,False,False,False,0,3,2021-11-04T18:39:53.557,41,False,4.0
2021,8,3178,25,26,309,13,4,3,6,0,0,0,0,0,0,False,False,False,0,2,2021-11-01T09:13:43.267,0,False,0.0
2021,8,3178,35,26,4616,2,12,5,4,6,2,5,1,5,0,True,False,False,0,3,2022-02-24T15:45:35.73,6,False,1.0
2021,8,3178,65,19,7456,13,47,5,0,0,0,0,0,0,0,False,False,False,0,1,2021-11-01T09:21:18.797,0,False,0.0
2021,8,3178,70,19,4912,2,47,5,6,14,8,11,3,11,0,True,False,False,0,3,2021-11-01T09:22:52.743,14,False,3.0
2021,8,3178,75,19,2256,2,8,2,37,44,7,39,5,39,0,False,False,False,0,3,2021-11-01T09:24:29.527,44,False,5.0
2021,8,3178,85,19,7172,13,44,3,0,0,0,0,0,0,0,False,False,False,0,1,2021-11-04T17:40:47.927,0,False,0.0
2021,8,3178,105,19,7456,2,12,10,0,2,2,1,1,1,0,False,False,False,0,1,2021-11-01T09:30:49.067,2,False,1.0
2021,8,3178,130,26,309,2,50,9,-2,1,3,0,1,0,0,True,False,False,0,3,2021-11-01T09:34:02.167,1,False,1.0
2021,8,3178,135,26,958,2,5,3,12,13,1,13,0,13,0,False,False,False,0,3,2021-11-01T09:35:10.857,13,False,0.0
2021,8,3178,140,26,4619,13,4,5,10,0,0,0,0,0,0,False,False,False,0,2,2021-11-02T18:41:28.243,0,False,0.0
2021,8,3178,160,19,8493,2,45,5,-6,5,11,-1,6,-1,0,False,False,False,0,1,2021-11-04T17:21:33.86,5,False,6.0
2021,8,3178,170,19,8493,13,6,4,3,0,0,0,0,0,0,False,False,False,0,1,2021-11-01T09:42:41.547,0,False,0.0
2021,8,3178,195,26,309,13,47,5,2,0,0,0,0,0,0,False,False,False,0,3,2021-11-01T09:45:43.443,0,False,0.0
2021,8,3178,215,26,309,2,13,10,5,5,0,5,0,5,6,False,False,False,0,3,2021-11-01T09:50:19.623,5,True,0.0
2021,8,3178,230,19,5096,2,44,3,-4,11,15,-3,14,-3,0,True,False,False,1,2,2021-11-01T09:57:34.443,11,False,14.0
2021,8,3178,255,19,4282,2,35,7,17,33,16,32,1,32,0,False,False,False,0,4,2021-11-01T09:59:15.973,33,False,1.0
2021,8,3178,260,19,4912,3,26,10,3,0,0,0,0,0,0,False,False,False,0,3,2022-02-23T19:59:40.99,0,False,0.0
2021,8,3178,280,19,7175,13,29,3,1,0,0,0,0,0,0,False,False,False,0,3,2021-11-01T10:04:07.857,0,False,0.0
2021,8,3178,290,26,4619,2,5,5,5,5,0,5,0,5,0,False,False,False,0,2,2021-11-01T10:47:49.65,5,False,0.0
2021,8,3178,305,19,4912,13,24,2,25,0,0,0,0,0,0,False,False,False,0,3,2021-11-04T17:47:58.937,0,False,0.0
2021,8,3178,310,19,4912,2,4,5,5,7,2,6,1,6,0,True,False,False,0,3,2021-11-01T10:51:12.003,7,False,1.0
2021,8,3178,340,19,4282,13,5,10,4,0,0,0,0,0,0,True,False,False,0,4,2021-11-04T18:40:22.76,0,False,0.0
2021,8,3178,365,26,4619,13,6,4,13,0,0,0,0,0,0,False,False,False,0,3,2021-11-04T17:41:21.897,0,False,0.0
2021,8,3178,385,19,2256,13,5,3,14,0,0,0,0,0,0,False,False,False,0,2,2021-11-04T16:52:03.267,0,False,0.0
2021,8,3178,390,19,7175,13,29,6,26,0,0,0,0,0,0,False,False,False,0,2,2021-11-01T11:05:56.347,0,False,0.0
2021,8,3178,400,26,309,2,13,9,3,9,6,7,2,7,0,False,False,False,0,3,2021-11-04T18:40:46.3,9,False,2.0
2021,8,3178,410,26,4619,13,19,6,30,0,0,0,0,0,0,False,False,False,0,2,2021-11-01T11:08:54.023,0,False,0.0
2021,8,3178,415,26,4616,3,16,4,12,0,0,0,0,0,0,False,False,False,0,1,2021-11-02T10:34:38.297,0,False,0.0
2021,8,3178,420,19,4912,2,3,3,10,10,0,10,0,10,0,False,False,False,0,2,2021-11-01T11:11:34.283,10,False,0.0
2021,8,3178,425,19,2256,13,19,6,29,0,0,0,0,0,0,False,False,False,0,2,2021-11-01T11:12:28.627,0,False,0.0
2021,8,3178,430,19,7175,13,5,5,9,0,0,0,0,0,0,False,False,False,0,3,2021-11-01T11:13:23.213,0,False,0.0
2021,8,3178,435,19,4912,13,13,10,2,0,0,0,0,0,0,True,False,False,0,3,2021-11-01T11:14:13.587,0,False,0.0
2021,8,3178,480,19,7175,2,39,10,4,4,0,4,0,4,0,False,False,False,0,3,2021-11-04T17:41:35.727,4,False,0.0
2021,8,3178,490,19,7173,2,6,1,15,15,0,15,0,15,0,False,False,False,0,2,2021-11-01T11:21:49.193,15,False,0.0
2021,8,3178,505,19,2256,13,19,6,37,0,0,0,0,0,0,False,False,False,0,3,2021-11-04T17:22:18.69,0,False,0.0
2021,8,3178,510,19,4912,2,4,10,6,7,1,6,1,6,0,False,True,True,1,3,2021-11-01T11:27:36.473,7,False,1.0
2021,8,3178,515,26,4616,2,47,5,2,11,9,9,2,9,0,False,False,False,0,1,2021-11-04T18:49:21.627,11,False,2.0
2021,8,3178,525,26,309,13,23,7,38,0,0,0,0,0,0,False,False,False,0,3,2021-11-02T10:35:25.343,0,False,0.0
2021,8,3178,530,26,958,13,12,3,7,0,0,0,0,0,0,False,False,False,0,3,2021-11-01T11:55:21.13,0,False,0.0
2021,8,3178,555,19,7175,2,6,10,13,14,1,14,0,14,0,False,False,False,0,3,2021-11-01T12:00:17.32,14,False,0.0
2021,8,3178,580,19,7175,13,35,5,10,0,0,0,0,0,0,False,False,False,0,3,2021-11-04T17:41:56.977,0,False,0.0
2021,8,3178,590,19,7175,13,35,9,11,0,0,0,0,0,0,False,False,False,0,3,2021-11-04T17:58:55.093,0,False,0.0
2021,8,3178,610,26,4616,2,47,10,3,11,8,11,0,11,0,False,False,False,0,1,2021-11-04T17:42:11.047,11,False,0.0
2021,8,3178,625,26,309,13,4,10,5,0,0,0,0,0,0,False,False,False,0,3,2021-11-01T12:15:10.26,0,False,0.0
2021,8,3178,640,19,5096,2,13,10,2,2,0,2,0,2,0,True,False,False,0,3,2021-11-01T12:16:40.297,2,False,0.0
2021,8,3178,650,19,2256,2,5,3,6,7,1,7,0,7,0,False,False,False,0,2,2021-11-01T12:45:54.12,7,False,0.0
2021,8,3178,670,26,4050,2,47,5,2,14,12,12,2,12,0,True,False,False,0,1,2021-11-01T12:52:23.43,14,False,
2021,8,3178,680,26,309,2,4,10,12,15,3,15,0,15,0,False,False,False,0,3,2021-11-01T12:55:10.757,15,False,0.0
2021,8,3178,690,26,4616,13,13,9,3,0,0,0,0,0,0,True,False,False,0,3,2021-11-01T12:56:31.173,0,False,0.0
2021,8,3178,695,26,958,13,31,5,4,0,0,0,0,0,0,False,False,False,0,3,2022-02-25T15:27:34.21,0,False,0.0
2021,8,3178,715,26,4616,13,17,8,16,0,0,0,0,0,0,False,False,False,0,1,2021-11-02T10:37:20.62,0,False,0.0
2021,8,3178,725,26,4619,2,5,5,10,14,4,13,1,13,0,False,False,False,0,2,2021-11-04T18:35:16.663,14,False,1.0
2021,8,3178,730,26,309,3,2,9,7,0,0,0,0,0,0,False,False,False,0,2,2021-11-04T18:43:15.97,0,False,0.0
2021,8,3178,765,19,7175,2,35,3,10,16,6,16,0,16,0,True,False,False,0,3,2021-11-04T16:36:30.953,16,True,0.0
2021,8,3178,775,19,7173,2,3,6,15,15,0,15,0,15,0,False,False,False,0,2,2021-11-01T13:12:42.427,15,False,0.0
2021,8,3178,785,19,2256,2,5,3,6,9,3,7,2,7,0,False,False,False,1,3,2021-11-04T18:43:39.583,9,False,2.0
2021,8,3178,790,19,7175,2,47,5,1,2,1,2,0,2,0,True,False,False,0,3,2021-11-02T17:53:01.577,2,False,0.0
2021,8,3178,840,26,4616,2,4,4,2,7,5,7,0,7,0,False,False,False,0,1,2021-11-01T13:57:51.417,7,False,0.0
2021,8,3178,850,26,309,2,4,3,5,6,1,5,1,5,0,False,False,False,0,2,2021-11-04T18:44:09.463,6,False,1.0
2021,8,3178,865,26,7453,2,5,2,18,18,0,18,0,18,0,False,False,False,0,2,2021-11-01T14:01:55.467,18,False,0.0
2021,8,3178,875,26,4616,2,46,3,1,11,10,11,0,11,0,False,False,False,0,1,2021-11-01T14:03:27.87,11,True,0.0
2021,8,3178,880,26,4616,2,28,10,2,14,12,8,6,8,0,False,False,False,1,1,2021-11-01T14:04:24.54,14,False,6.0
2021,8,3178,885,26,4616,3,4,4,3,0,0,0,0,0,0,False,False,False,0,1,2021-11-01T14:05:03.32,0,False,0.0
2021,8,3178,890,26,8552,2,9,2,24,24,0,24,0,24,6,False,False,False,0,2,2021-11-01T14:06:04.64,24,True,0.0
2021,8,3179,15,15,4487,2,5,5,3,6,3,4,2,4,0,False,False,False,0,3,2021-11-04T14:17:35.13,6,False,2.0
2021,8,3179,30,15,153,2,47,10,-3,1,4,1,0,1,0,False,False,False,0,1,2021-11-04T14:11:25.247,1,False,0.0
2021,8,3179,35,15,5152,2,5,5,5,7,2,7,0,7,0,False,False,False,0,3,2021-11-01T09:25:10.02,7,False,0.0
2021,8,3179,40,15,8099,13,12,3,-2,0,0,0,0,0,0,False,False,False,0,1,2022-02-24T15:46:36.533,0,False,0.0
2021,8,3179,60,27,650,2,39,4,7,9,2,8,1,8,0,False,False,False,0,3,2021-11-02T16:27:06.033,9,False,1.0
2021,8,3179,70,27,6397,13,13,10,0,0,0,0,0,0,0,False,False,False,0,3,2021-11-02T16:27:34.77,0,False,
2021,8,3179,90,27,650,2,35,6,23,27,4,25,2,25,0,False,False,False,0,3,2021-11-04T14:17:49.21,27,False,2.0
2021,8,3179,130,15,914,2,51,10,-2,5,7,4,1,4,0,False,False,False,1,3,2021-11-01T12:30:07.31,5,False,1.0
2021,8,3179,140,15,7591,3,5,9,3,0,0,0,0,0,0,False,False,False,0,3,2021-11-02T23:26:12.803,0,False,0.0
2021,8,3179,155,27,650,2,30,5,1,1,0,1,0,1,0,False,False,False,0,3,2021-11-01T18:41:51.4,1,True,0.0
2021,8,3179,160,27,7408,2,4,3,5,5,0,5,0,5,0,False,False,False,0,2,2021-11-01T12:47:31.123,5,False,0.0
2021,8,3179,170,15,8099,2,48,9,-2,17,19,15,2,15,0,False,False,False,0,1,2021-11-02T23:26:28.303,17,False,2.0
2021,8,3179,185,15,153,2,48,10,-3,9,12,7,2,7,0,False,False,False,0,1,2021-11-04T14:18:56.33,9,False,2.0
2021,8,3179,190,15,5152,2,54,9,2,10,8,6,4,6,0,True,False,False,0,4,2021-11-04T12:00:18.127,10,False,4.0
2021,8,3179,195,15,957,13,35,6,32,0,0,0,0,0,0,False,False,False,0,3,2021-11-04T14:14:15.51,0,False,0.0
2021,8,3179,200,27,650,2,4,9,6,8,2,7,1,7,0,False,False,False,0,2,2021-11-01T18:32:17.68,8,False,1.0
2021,8,3179,220,27,7408,2,4,9,5,5,0,5,0,5,0,False,False,False,0,3,2021-11-01T13:21:05.39,5,False,0.0
2021,8,3179,225,27,650,2,5,3,8,9,1,8,1,8,0,False,False,False,0,3,2021-11-01T13:23:23.603,9,False,1.0
2021,8,3179,230,27,650,2,51,9,0,5,5,4,1,4,0,False,False,False,0,3,2021-11-01T13:25:23.123,5,False,1.0
2021,8,3179,235,27,7408,2,50,9,-1,8,9,6,2,6,0,False,False,False,1,2,2021-11-04T14:23:09.48,8,False,2.0
2021,8,3179,240,27,7408,2,9,2,16,16,0,16,0,16,6,False,False,False,0,2,2022-02-14T20:45:48.647,16,False,0.0
2021,8,3179,260,15,914,2,35,3,12,13,1,13,0,13,0,False,False,False,0,3,2021-11-01T13:42:12.78,13,False,0.0
2021,8,3179,270,15,4487,2,51,10,-2,7,9,7,0,7,0,False,False,False,0,3,2021-11-04T14:10:31.79,7,False,0.0
2021,8,3179,275,15,4487,13,6,10,8,0,0,0,0,0,0,False,False,False,0,2,2021-11-04T14:19:11.05,0,False,0.0
2021,8,3179,285,15,4487,13,13,4,4,0,0,0,0,0,0,False,False,False,0,2,2021-11-01T13:57:58.7,0,False,0.0
2021,8,3179,290,15,5152,13,12,10,7,0,0,0,0,0,0,False,False,False,0,3,2021-11-01T14:02:06.75,0,False,0.0
2021,8,3179,300,27,4850,2,26,9,6,7,1,7,0,7,0,False,False,False,0,3,2021-11-01T14:09:10.857,7,False,0.0
2021,8,3179,305,27,650,2,7,6,27,28,1,28,0,28,0,True,False,False,0,2,2021-11-02T16:25:53.007,28,False,0.0
2021,8,3179,310,27,650,2,4,10,5,5,0,5,0,5,0,False,False,False,0,3,2021-11-01T14:18:18.773,5,False,0.0
2021,8,3179,335,27,7408,2,5,5,4,4,0,4,0,4,0,False,False,False,0,2,2021-11-02T16:29:38.22,4,True,0.0
2021,8,3179,355,27,7852,13,36,4,14,0,0,0,0,0,0,False,False,False,0,3,2021-11-04T14:12:05.767,0,False,
2021,8,3179,370,27,650,13,6,4,11,0,0,0,0,0,0,False,False,False,0,3,2021-11-04T14:14:30.487,0,False,
2021,8,3179,405,27,650,13,4,7,17,0,0,0,0,0,0,False,False,False,0,3,2022-02-14T20:46:17.553,0,False,0.0
2021,8,3179,425,15,914,13,4,3,10,0,0,0,0,0,0,False,False,False,0,2,2021-11-01T15:21:36.013,0,False,0.0
2021,8,3179,440,15,7591,13,6,4,13,0,0,0,0,0,0,False,False,False,0,2,2021-11-01T15:39:55.78,0,False,0.0
2021,8,3179,450,27,650,2,5,3,7,8,1,8,0,8,0,False,False,False,0,2,2022-02-16T21:50:50.823,8,True,0.0
2021,8,3179,460,27,650,2,4,9,3,5,2,5,0,5,0,False,False,False,0,3,2021-11-02T16:31:00.267,5,False,0.0
2021,8,3179,470,27,650,2,35,6,15,28,13,26,2,26,0,False,False,False,0,3,2021-11-01T15:51:55.66,28,False,2.0
2021,8,3179,475,27,4850,13,9,3,5,0,0,0,0,0,0,False,False,False,0,2,2021-11-02T16:30:38.317,0,False,0.0
2021,8,3179,480,27,7408,2,5,3,5,5,0,5,0,5,6,True,False,False,0,4,2021-11-01T16:09:15.123,5,True,0.0
2021,8,3179,500,15,153,13,48,10,-3,0,0,0,0,0,0,False,False,False,0,1,2021-11-04T14:12:19.527,0,False,0.0
2021,8,3179,540,15,7591,2,50,10,-3,7,10,5,2,5,0,True,False,False,1,2,2021-11-04T14:16:42.14,7,False,2.0
2021,8,3179,550,15,5152,2,54,9,4,10,6,8,2,8,0,True,False,False,0,4,2021-11-04T12:00:18.127,10,False,2.0
2021,8,3179,565,15,8343,2,32,3,-2,3,5,2,1,2,0,True,False,False,0,4,2021-11-02T23:24:56.083,3,False,1.0
2021,8,3179,575,15,153,2,4,4,2,9,7,7,2,7,0,False,False,False,0,1,2021-11-01T16:25:00.35,9,False,2.0
2021,8,3179,580,15,5152,2,46,3,1,7,6,5,2,5,0,True,False,False,0,4,2021-11-02T23:25:07.107,7,False,2.0
2021,8,3179,595,15,914,2,49,5,-1,0,1,0,0,0,0,False,False,False,0,2,2021-11-04T14:10:59.56,0,False,0.0
2021,8,3179,600,15,153,13,4,4,0,0,0,0,0,0,0,False,False,False,0,1,2021-11-04T14:12:53.343,0,False,0.0
2021,8,3179,605,15,5152,13,38,9,0,0,0,0,0,0,0,False,False,False,0,4,2021-11-01T16:36:01.687,0,False,0.0
2021,8,3179,615,27,7496,2,51,3,-1,4,5,4,0,4,0,False,False,False,0,3,2022-02-16T21:51:25.927,4,False,
2021,8,3179,620,27,650,2,6,4,9,9,0,9,0,9,0,True,False,False,0,2,2021-11-02T16:26:12.993,9,False,0.0
2021,8,3179,625,27,7404,2,32,5,0,3,3,3,0,3,0,False,False,False,0,1,2021-11-01T16:46:43.663,3,False,0.0
2021,8,3179,635,15,5152,2,4,10,7,7,0,7,0,7,0,False,False,False,0,3,2021-11-04T14:23:41.873,7,False,0.0
2021,8,3179,640,15,914,2,13,4,4,6,2,6,0,6,0,False,False,False,0,2,2021-11-04T12:00:18.127,6,False,0.0
2021,8,3179,645,15,5152,13,5,5,6,0,0,0,0,0,0,False,False,False,0,3,2021-11-01T16:54:20.073,0,False,0.0
2021,8,3179,650,15,4487,2,5,3,2,3,1,2,1,2,0,False,False,False,0,3,2021-11-01T17:13:09.517,3,False,1.0
2021,8,3179,665,15,7591,2,4,4,4,6,2,4,2,4,0,False,False,False,0,3,2021-11-01T17:19:00.763,6,False,2.0
2021,8,3179,685,15,914,3,6,8,19,0,0,0,0,0,0,False,False,False,0,2,2021-11-04T14:13:18.39,0,False,0.0
2021,8,3179,730,15,4487,3,12,6,37,0,0,0,0,0,0,False,False,False,0,2,2022-02-24T15:47:34.357,0,False,0.0
2021,8,3179,740,15,5152,2,4,4,5,11,6,5,6,5,0,False,False,False,0,3,2022-02-23T20:25:24.287,11,False,6.0
2021,8,3179,745,15,4886,2,4,4,3,9,6,7,2,7,0,False,False,False,0,1,2021-11-01T17:43:29.693,9,False,2.0
2021,8,3179,750,15,4487,2,5,3,1,8,7,6,2,6,0,False,False,False,0,3,2022-02-16T21:52:14.03,8,False,2.0
2021,8,3179,755,15,8343,13,12,2,16,0,0,0,0,0,0,False,False,False,0,3,2021-11-04T14:13:44.007,0,False,0.0
2021,8,3179,760,15,914,2,4,3,9,11,2,9,2,9,0,False,False,False,0,2,2021-11-04T14:21:16.28,11,False,2.0
2021,8,3179,765,15,7514,13,9,2,20,0,0,0,0,0,0,False,False,False,0,2,2021-11-04T14:21:28.82,0,False,0.0
2021,8,3179,770,15,5152,2,4,4,7,7,0,7,0,7,0,False,False,False,0,3,2021-11-01T17:51:59.17,7,False,0.0
2021,8,3179,775,15,153,2,4,9,1,4,3,3,1,3,0,False,False,False,0,1,2021-11-01T17:54:10.317,4,False,1.0
2021,8,3179,780,15,957,2,5,3,4,5,1,5,0,5,0,False,False,False,0,3,2021-11-01T17:55:33.447,5,False,0.0
2021,8,3179,795,15,4487,13,7,5,9,0,0,0,0,0,0,False,False,False,0,3,2021-11-04T14:25:28.593,0,False,0.0
2021,8,3179,800,15,4487,2,4,9,9,9,0,9,0,9,6,False,False,False,0,3,2021-11-02T23:28:25.27,9,True,0.0
2021,8,3179,830,15,5152,2,5,5,6,9,3,7,2,7,0,False,False,False,0,3,2021-11-01T18:05:10.037,9,False,2.0
2021,8,3179,835,15,7514,2,2,10,7,10,3,10,0,10,0,False,False,False,0,2,2021-11-01T18:06:39.463,10,False,0.0
2021,8,3179,840,15,153,2,5,5,2,9,7,8,1,8,0,False,False,False,0,1,2021-11-04T14:21:42.153,9,False,1.0
2021,8,3179,845,15,957,13,2,9,7,0,0,0,0,0,0,False,False,False,0,2,2021-11-01T18:09:34.443,0,False,0.0
2021,8,3179,850,15,4487,2,51,9,-1,5,6,1,4,1,0,False,False,False,0,3,2021-11-01T18:10:43.96,5,False,4.0
2021,8,3179,855,15,4487,13,5,3,6,0,0,0,0,0,0,False,False,False,0,3,2021-11-01T18:12:28.62,0,False,0.0
2021,8,3179,860,15,153,2,31,9,0,8,8,7,1,7,0,False,False,False,0,1,2021-11-01T18:13:53.207,8,False,1.0
2021,8,3180,10,32,3885,2,51,3,-5,8,13,6,2,6,0,True,False,False,0,2,2022-02-16T19:10:42.483,8,False,2.0
2021,8,3180,20,32,3885,2,47,5,-1,27,28,23,4,23,0,False,False,False,1,1,2021-11-01T09:04:22.333,27,False,4.0
2021,8,3180,50,32,4788,13,47,5,-1,0,0,0,0,0,0,True,False,False,0,4,2022-02-16T19:11:27.14,0,False,0.0
2021,8,3180,55,10,6840,2,30,5,0,1,1,1,0,1,0,True,False,False,0,4,2021-11-01T09:25:17.503,1,False,0.0
2021,8,3180,80,10,6840,13,35,7,16,0,0,0,0,0,0,False,False,False,0,4,2021-11-01T09:37:54.35,0,False,0.0
2021,8,3180,85,10,6281,2,19,2,26,31,5,31,0,31,0,False,False,False,0,2,2021-11-04T13:13:52.613,31,False,0.0
2021,8,3180,100,10,8541,3,48,9,-3,0,0,0,0,0,0,False,False,False,0,1,2021-11-01T09:47:33.523,0,False,0.0
2021,8,3180,105,10,7703,2,53,9,-4,11,15,1,10,1,0,False,False,False,2,4,2021-11-04T15:16:08.933,11,False,
2021,8,3180,110,10,6281,13,5,6,16,0,0,0,0,0,0,False,False,False,0,2,2021-11-04T14:15:34.35,0,False,0.0
2021,8,3180,120,32,3562,13,19,6,31,0,0,0,0,0,0,False,False,False,0,2,2021-11-01T09:55:13.243,0,False,0.0
2021,8,3180,125,32,7807,13,12,10,0,0,0,0,0,0,0,False,False,False,0,1,2022-02-24T15:49:27.137,0,False,
2021,8,3180,135,32,7128,2,8,1,18,17,-1,16,1,16,0,False,False,False,0,2,2021-11-01T10:02:36.297,17,False,1.0
2021,8,3180,150,32,3885,2,44,3,0,2,2,1,1,1,0,False,False,False,0,1,2021-11-01T10:08:46.663,2,False,1.0
2021,8,3180,155,32,7807,2,28,10,-3,13,16,9,4,9,0,False,False,False,0,1,2021-11-04T15:13:02.727,13,False,4.0
2021,8,3180,170,32,4788,2,50,5,-2,-2,0,-3,1,-3,0,False,False,False,0,2,2021-11-01T10:15:37.207,-2,False,1.0
2021,8,3180,180,32,7128,13,5,5,13,0,0,0,0,0,0,False,False,False,0,2,2021-11-01T10:18:22.597,0,False,0.0
2021,8,3180,195,10,7700,2,5,3,5,5,0,5,0,5,0,True,False,False,0,3,2021-11-01T10:25:34.61,5,False,0.0
2021,8,3180,200,10,4930,2,35,6,17,31,14,24,7,24,0,True,False,False,0,4,2021-11-01T10:28:16.457,31,False,7.0
2021,8,3180,215,10,6840,13,53,9,-4,0,0,0,0,0,0,False,False,False,0,4,2021-11-01T10:34:08.263,0,False,0.0
2021,8,3180,230,32,6430,2,32,5,-1,20,21,15,5,15,0,False,False,False,0,4,2021-11-04T16:27:46.49,20,False,5.0
2021,8,3180,235,32,7807,2,28,10,0,4,4,2,2,2,0,False,False,False,0,1,2021-11-01T14:28:01.047,4,False,2.0
2021,8,3180,255,32,2675,2,5,5,12,12,0,12,0,12,0,False,False,False,0,3,2021-11-01T10:51:27.167,12,False,0.0
2021,8,3180,260,32,8659,13,28,9,0,0,0,0,0,0,0,False,False,False,0,1,2021-11-01T10:53:36.257,0,False,0.0
2021,8,3180,285,10,7703,2,30,5,0,12,12,10,2,10,0,False,False,False,0,4,2021-11-01T11:01:27.66,12,False,2.0
2021,8,3180,305,10,7703,2,35,9,13,19,6,17,2,17,0,False,False,False,0,4,2021-11-01T11:10:56.073,19,False,2.0
2021,8,3180,315,10,4930,2,4,10,11,19,8,15,4,15,0,False,False,False,0,2,2021-11-01T11:13:43.887,19,False,4.0
2021,8,3180,320,10,282,2,5,5,5,15,10,12,3,12,6,False,False,False,0,1,2021-11-01T11:15:43.063,15,False,3.0
2021,8,3180,335,32,3885,2,44,3,-1,1,2,0,1,0,0,False,False,False,0,1,2021-11-01T11:18:51.157,1,False,1.0
2021,8,3180,340,32,3562,2,6,8,16,17,1,17,0,17,0,False,False,False,0,2,2021-11-01T11:22:09.827,17,False,0.0
2021,8,3180,350,32,4788,2,5,5,13,14,1,14,0,14,0,False,False,False,0,3,2021-11-01T11:24:28.81,14,False,0.0
2021,8,3180,355,32,3885,2,5,5,0,7,7,5,2,5,0,False,False,False,0,1,2021-11-01T11:27:05.117,7,False,2.0
2021,8,3180,380,32,2675,13,19,2,46,0,0,0,0,0,0,False,False,False,0,2,2021-11-01T11:52:06.86,0,False,0.0
2021,8,3180,400,10,6840,2,30,3,-1,7,8,7,0,7,0,False,False,False,0,4,2021-11-01T11:56:44.86,7,False,0.0
2021,8,3180,420,10,7703,2,13,9,3,3,0,3,0,3,0,False,False,False,0,4,2021-11-01T12:04:53.327,3,False,0.0
2021,8,3180,430,32,4788,2,8,8,15,15,0,15,0,15,0,False,False,False,0,3,2021-11-04T16:24:12.517,15,False,
2021,8,3180,435,32,3562,3,5,5,5,0,0,0,0,0,0,False,False,False,0,2,2022-02-16T19:12:07.267,0,False,0.0
2021,8,3180,440,32,7128,2,26,9,5,5,0,5,0,5,0,False,False,False,0,3,2021-11-01T12:15:54.817,5,False,0.0
2021,8,3180,455,10,282,2,28,4,2,4,2,4,0,4,0,False,False,False,0,1,2021-11-01T12:20:24.48,4,False,0.0
2021,8,3180,465,10,282,2,51,10,-5,-4,1,-4,0,-4,0,False,False,False,0,1,2022-02-16T19:12:41.723,-4,False,0.0
2021,8,3180,490,32,3885,2,48,9,-4,14,18,12,2,12,0,False,False,False,1,1,2021-11-01T12:40:38.643,14,False,2.0
2021,8,3180,495,32,8528,2,32,3,3,4,1,3,1,3,0,False,False,False,0,4,2021-11-04T16:24:46.54,4,False,1.0
2021,8,3180,505,32,2675,2,13,3,3,23,20,20,3,20,0,False,False,False,0,3,2021-11-01T12:46:19.907,23,False,3.0
2021,8,3180,520,32,3562,2,9,2,20,20,0,20,0,20,6,False,False,False,0,3,2022-02-16T19:13:36.78,20,True,0.0
2021,8,3180,550,10,7700,2,26,10,6,9,3,6,3,6,0,False,False,False,0,3,2021-11-01T12:57:48.433,9,False,3.0
2021,8,3180,560,10,8541,2,47,5,1,2,1,2,0,2,0,False,False,False,0,1,2021-11-01T13:01:12.35,2,False,0.0
2021,8,3180,565,10,8541,2,45,5,-4,11,15,7,4,7,0,True,False,False,0,1,2021-11-01T13:02:56.163,11,False,4.0
2021,8,3180,580,10,6281,13,4,10,5,0,0,0,0,0,0,False,False,False,0,2,2021-11-01T13:09:00.59,0,False,0.0
2021,8,3180,610,32,7128,13,50,10,-3,0,0,0,0,0,0,False,False,False,0,2,2021-11-01T13:18:56.557,0,False,0.0
2021,8,3180,615,32,7128,13,9,2,24,0,0,0,0,0,0,False,False,False,0,3,2021-11-04T13:13:52.613,0,False,0.0
2021,8,3180,625,10,4930,2,8,10,13,14,1,14,0,14,0,False,False,False,0,2,2021-11-01T13:24:24.42,14,False,0.0
2021,8,3180,635,10,6281,2,4,10,7,9,2,9,0,9,0,False,False,False,0,2,2022-02-16T19:14:00.04,9,False,0.0
2021,8,3180,640,10,7700,2,22,6,17,18,1,18,0,18,0,False,False,False,0,3,2021-11-04T16:29:30.283,18,True,0.0
2021,8,3180,655,10,7700,2,6,4,5,7,2,7,0,7,0,False,False,False,0,3,2021-11-01T13:34:45.713,7,False,0.0
2021,8,3180,675,32,3885,2,26,5,1,19,18,19,0,19,0,True,False,False,0,2,2021-11-01T13:42:48.21,19,False,0.0
2021,8,3180,680,32,3885,2,13,9,1,5,4,5,0,5,0,True,False,False,0,3,2021-11-01T13:44:52.08,5,True,0.0
2021,8,3180,685,32,7128,13,2,9,-2,0,0,0,0,0,0,False,False,False,0,2,2021-11-01T13:46:28.707,0,False,0.0
2021,8,3180,690,32,8533,2,2,4,7,22,15,17,5,17,0,False,False,False,0,3,2021-11-01T13:48:15.647,22,False,5.0
2021,8,3180,700,32,8533,13,17,8,19,0,0,0,0,0,0,False,False,False,0,3,2021-11-01T13:51:36.92,0,False,0.0
2021,8,3180,705,32,3562,2,13,3,4,14,10,10,4,10,0,False,False,False,0,3,2021-11-01T13:53:36.89,14,False,4.0
2021,8,3180,710,32,7807,2,46,3,0,3,3,2,1,2,0,False,False,False,0,1,2021-11-01T13:55:02.72,3,False,1.0
2021,8,3180,720,32,7128,2,51,10,-1,1,2,0,1,0,0,False,False,False,0,3,2021-11-01T13:56:47.223,1,False,1.0
2021,8,3180,735,32,6430,13,19,2,20,0,0,0,0,0,0,False,False,False,0,2,2021-11-01T14:31:41.233,0,False,0.0
2021,8,3180,750,10,8541,13,47,5,9,0,0,0,0,0,0,False,False,False,0,1,2021-11-01T14:09:39.03,0,False,0.0
2021,8,3180,760,32,3562,13,5,5,11,0,0,0,0,0,0,False,False,False,0,2,2021-11-04T15:11:59.503,0,False,0.0
2021,8,3180,780,32,4788,13,47,5,1,0,0,0,0,0,0,False,False,False,0,3,2021-11-01T14:20:47.733,0,False,0.0
2021,8,3180,785,32,2675,13,7,6,30,0,0,0,0,0,0,True,False,False,0,2,2021-11-01T14:29:47.12,0,False,0.0
2021,8,3181,15,30,7893,2,4,9,5,8,3,7,1,7,0,False,False,False,0,3,2021-11-01T09:25:11.447,8,False,1.0
2021,8,3181,20,30,4516,3,50,9,-2,0,0,0,0,0,0,False,False,False,0,3,2021-11-01T09:27:27.763,0,False,0.0
2021,8,3181,30,20,5140,2,5,3,5,6,1,7,-1,7,0,False,False,False,0,3,2021-11-01T09:31:00.763,6,False,-1.0
2021,8,3181,35,20,2408,13,4,9,4,0,0,0,0,0,0,False,False,False,0,3,2021-11-01T09:33:07.093,0,False,0.0
2021,8,3181,50,20,7353,13,49,3,-1,0,0,0,0,0,0,False,False,False,0,2,2021-11-01T09:37:54.08,0,False,0.0
2021,8,3181,55,20,3725,2,46,3,2,4,2,3,1,3,0,False,False,False,0,4,2022-02-16T21:10:18.87,4,False,1.0
2021,8,3181,60,20,8131,2,4,3,4,5,1,4,1,4,0,False,False,False,0,2,2021-11-01T09:43:10.103,5,False,1.0
2021,8,3181,70,30,4937,3,48,9,-2,0,0,0,0,0,0,False,False,False,0,1,2022-02-16T21:10:56.86,0,False,0.0
2021,8,3181,80,30,4516,2,42,9,4,25,21,20,5,20,0,False,False,False,0,3,2021-11-01T09:50:19.277,25,False,5.0
2021,8,3181,85,30,4523,13,12,3,14,0,0,0,0,0,0,False,False,False,0,4,2021-11-04T21:24:05.437,0,False,
2021,8,3181,95,30,63,13,29,3,12,0,0,0,0,0,0,False,False,False,0,2,2021-11-01T09:57:31.883,0,False,0.0
2021,8,3181,100,30,4516,2,2,9,4,12,8,10,2,10,6,False,False,False,0,3,2021-11-01T09:59:14.86,12,False,2.0
2021,8,3181,115,20,7888,13,32,5,2,0,0,0,0,0,0,False,False,False,0,4,2021-11-01T10:02:01.86,0,False,0.0
2021,8,3181,125,20,902,2,48,9,-5,18,23,15,3,15,0,False,False,False,0,1,2021-11-04T21:46:42.327,18,False,3.0
2021,8,3181,130,20,902,2,12,10,-2,7,9,-1,8,-1,0,False,False,False,2,1,2022-02-24T15:52:17.04,7,False,8.0
2021,8,3181,165,20,6388,2,7,6,16,16,0,16,0,16,6,False,False,False,0,3,2021-11-04T20:26:19.99,16,True,0.0
2021,8,3181,185,30,793,2,18,3,0,7,7,6,1,6,0,False,False,False,0,2,2022-02-16T21:14:15.24,7,False,1.0
2021,8,3181,195,30,8307,2,34,4,-4,8,12,6,2,6,0,True,False,False,0,2,2021-11-04T21:28:35.017,8,False,2.0
2021,8,3181,210,30,7893,2,39,9,8,8,0,8,0,8,0,False,False,False,0,3,2021-11-01T10:33:30.7,8,False,0.0
2021,8,3181,215,30,793,13,19,2,41,0,0,0,0,0,0,False,False,False,0,2,2021-11-01T10:35:09.39,0,False,0.0
2021,8,3181,220,30,8307,2,4,5,5,4,-1,4,0,4,0,False,False,False,0,2,2021-11-01T10:36:22.85,4,False,0.0
2021,8,3181,225,30,2290,13,4,10,13,0,0,0,0,0,0,False,False,False,0,3,2021-11-01T10:38:26.707,0,False,0.0
2021,8,3181,245,20,7888,13,35,3,14,0,0,0,0,0,0,False,False,False,0,4,2022-02-16T21:15:05.407,0,False,0.0
2021,8,3181,250,20,7888,2,4,9,5,5,0,5,0,5,0,False,False,False,0,4,2021-11-04T21:29:02.073,5,False,0.0
2021,8,3181,260,20,8131,13,3,3,9,0,0,0,0,0,0,False,False,False,0,2,2021-11-01T10:51:39.89,0,False,0.0
2021,8,3181,275,30,4516,2,29,2,17,20,3,19,1,19,0,False,False,False,0,2,2021-11-01T10:58:54.22,20,False,1.0
2021,8,3181,290,30,7893,2,3,6,15,31,16,13,18,13,0,False,False,False,1,2,2021-11-01T11:03:32.72,31,False,18.0
2021,8,3181,295,30,4523,2,31,3,4,4,0,4,0,4,0,False,False,False,0,4,2021-11-01T11:05:00.323,4,False,0.0
2021,8,3181,315,20,7353,2,4,10,4,14,10,12,2,12,0,False,False,False,0,3,2021-11-01T11:15:34.763,14,False,2.0
2021,8,3181,320,20,3725,2,12,4,2,12,10,3,9,3,0,False,False,False,1,4,2022-02-24T15:52:44.413,12,False,9.0
2021,8,3181,325,20,8127,13,9,2,23,0,0,0,0,0,0,False,False,False,0,3,2021-11-01T11:17:18.91,0,False,0.0
2021,8,3181,330,20,3725,2,4,9,6,14,8,12,2,12,0,False,False,False,0,3,2021-11-04T20:26:45.9,14,False,2.0
2021,8,3181,345,20,5140,13,5,10,2,0,0,0,0,0,0,False,False,False,0,1,2021-11-04T20:26:55.38,0,False,
2021,8,3181,350,20,6388,13,23,9,14,0,0,0,0,0,0,False,False,False,0,3,2021-11-01T11:26:43.693,0,False,
2021,8,3181,365,20,7888,2,50,9,-1,-1,0,-1,0,-1,0,False,False,False,0,2,2021-11-01T11:33:02.043,-1,False,0.0
2021,8,3181,390,30,4516,13,5,10,12,0,0,0,0,0,0,False,False,False,0,3,2021-11-01T11:38:21.367,0,False,0.0
2021,8,3181,400,20,6388,2,5,5,6,15,9,8,7,8,0,False,False,False,1,2,2021-11-01T11:42:32.36,15,False,7.0
2021,8,3181,420,20,4719,2,46,3,0,1,1,1,0,1,6,False,False,False,0,1,2022-02-16T21:16:32.82,1,True,0.0
2021,8,3181,450,20,255,2,19,2,29,38,9,34,4,34,0,False,False,False,0,2,2021-11-01T11:59:18.34,38,False,4.0
2021,8,3181,470,20,7353,2,2,4,7,7,0,7,0,7,0,False,False,False,0,2,2021-11-01T12:05:06.163,7,False,0.0
2021,8,3181,480,20,7888,13,7,5,10,0,0,0,0,0,0,False,False,False,0,4,2022-02-16T21:17:15.917,0,False,0.0
2021,8,3181,495,20,6388,2,49,10,-1,2,3,2,0,2,0,True,False,False,0,3,2021-11-01T12:13:47.433,2,False,0.0
2021,8,3181,515,30,4523,13,2,4,12,0,0,0,0,0,0,False,False,False,0,3,2021-11-01T12:18:36.603,0,False,0.0
2021,8,3181,520,30,2290,2,39,4,5,9,4,7,2,7,0,False,False,False,0,3,2021-11-01T12:20:44.71,9,False,2.0
2021,8,3181,530,30,4937,2,44,3,-2,7,9,5,2,5,0,False,False,False,0,1,2021-11-01T14:29:52.697,7,False,2.0
2021,8,3181,535,30,4516,2,2,4,6,44,38,8,36,8,0,False,False,False,1,3,2021-11-01T12:26:36.23,44,False,36.0
2021,8,3181,540,30,4937,13,16,9,5,0,0,0,0,0,0,False,False,False,0,1,2021-11-01T12:28:57.42,0,False,0.0
2021,8,3181,545,30,2290,2,33,9,4,6,2,5,1,5,0,False,False,False,0,4,2021-11-01T12:31:08.393,6,False,1.0
2021,8,3181,550,30,931,2,2,10,2,7,5,6,1,6,6,True,False,False,0,2,2021-11-01T12:32:35.443,7,False,1.0
2021,8,3181,570,20,7353,13,53,9,-6,0,0,0,0,0,0,True,False,False,0,4,2022-02-16T21:19:04.277,0,False,0.0
2021,8,3181,590,30,4516,2,2,4,6,16,10,9,7,9,0,False,False,False,0,3,2021-11-01T12:42:15.27,16,False,7.0
2021,8,3181,595,30,6414,2,48,9,-2,6,8,0,6,0,0,False,False,False,1,1,2021-11-01T12:44:17.243,6,False,6.0
2021,8,3181,605,30,4516,2,4,9,2,6,4,4,2,4,0,True,False,False,0,3,2021-11-01T12:46:35.41,6,False,2.0
2021,8,3181,610,30,793,2,7,6,39,41,2,39,2,39,6,False,False,False,0,3,2021-11-01T12:48:49.553,41,False,2.0
2021,8,3181,625,20,7353,13,5,5,7,0,0,0,0,0,0,True,False,False,0,3,2021-11-01T12:51:58.92,0,False,0.0
2021,8,3181,645,30,4516,13,12,4,10,0,0,0,0,0,0,True,False,False,0,4,2021-11-04T20:27:33.027,0,False,0.0
2021,8,3181,650,30,4516,2,50,9,-3,9,12,5,4,5,0,False,False,False,0,2,2021-11-01T13:01:12.387,9,False,4.0
2021,8,3181,670,30,7893,2,39,4,6,7,1,7,0,7,0,True,False,False,0,3,2021-11-01T13:14:47.823,7,False,0.0
2021,8,3181,675,30,8307,2,50,5,-3,-1,2,-2,1,-2,0,False,False,False,1,2,2021-11-04T21:16:27.903,-1,False,1.0
2021,8,3181,680,30,4516,2,50,9,1,8,7,3,5,3,0,False,False,False,0,3,2021-11-04T21:16:38.81,8,False,5.0
2021,8,3181,710,20,7353,2,4,5,11,14,3,12,2,12,0,False,False,False,0,2,2022-02-16T21:20:58.113,14,False,2.0
2021,8,3181,715,20,8131,13,9,2,16,0,0,0,0,0,0,False,False,False,0,2,2021-11-01T13:30:52.517,0,False,0.0
2021,8,3181,725,20,7353,13,26,4,6,0,0,0,0,0,0,False,False,False,0,2,2021-11-01T13:34:07.867,0,False,0.0
2021,8,3181,740,30,4937,2,31,9,2,2,0,2,0,2,0,False,False,False,0,1,2021-11-01T13:36:55.903,2,False,0.0
2021,8,3181,745,30,4523,2,47,10,0,12,12,4,8,4,0,False,False,False,0,3,2021-11-04T21:17:23.543,12,False,8.0
2021,8,3181,755,30,4937,2,4,9,3,8,5,6,2,6,0,False,False,False,0,1,2021-11-01T13:43:41.533,8,False,2.0
2021,8,3181,760,30,5056,2,7,2,35,50,15,50,0,50,6,False,False,False,0,3,2021-11-04T21:37:46.24,50,True,0.0
2021,8,3181,780,20,5140,2,5,3,3,5,2,5,0,5,0,True,False,False,0,1,2021-11-03T02:29:30.547,5,False,0.0
2021,8,3181,785,20,8131,2,4,5,9,9,0,9,0,9,0,False,False,False,0,2,2021-11-04T19:29:05.84,9,False,0.0
2021,8,3181,795,20,2408,2,48,5,-5,4,9,4,0,4,0,False,False,False,0,1,2021-11-01T13:56:00.87,4,False,0.0
2021,8,3181,820,20,8131,2,6,4,14,16,2,14,2,14,0,False,False,False,0,2,2021-11-01T14:02:06.58,16,False,2.0
2021,8,3181,835,20,5140,13,30,10,-2,0,0,0,0,0,0,True,False,False,0,1,2021-11-04T19:29:05.84,0,False,0.0
2021,8,3181,840,20,5140,2,5,10,3,4,1,3,1,3,0,False,False,False,0,1,2021-11-01T14:08:47.847,4,False,1.0
2021,8,3181,860,30,793,13,19,6,30,0,0,0,0,0,0,False,False,False,0,3,2021-11-01T14:11:13.487,0,False,0.0
2021,8,3181,865,30,4516,13,35,7,15,0,0,0,0,0,0,False,False,False,0,3,2021-11-04T22:05:09.873,0,False,0.0
2021,8,3181,890,30,7893,2,3,5,11,11,0,11,0,11,0,False,False,False,0,2,2021-11-01T14:17:34.213,11,False,0.0
2021,8,3181,895,30,7893,3,3,6,17,0,0,0,0,0,0,False,False,False,0,2,2021-11-01T14:18:49.943,0,False,0.0
2021,8,3182,20,18,6361,2,19,2,27,31,4,27,4,27,0,False,False,False,0,2,2021-11-01T09:18:22.237,31,False,4.0
2021,8,3182,25,18,7711,2,49,9,-2,3,5,2,1,2,0,True,False,False,0,2,2021-11-04T14:31:20.22,3,False,1.0
2021,8,3182,30,18,1381,13,12,2,30,0,0,0,0,0,0,False,False,False,0,2,2021-11-01T09:22:53.353,0,False,0.0
2021,8,3182,35,18,7711,13,19,6,28,0,0,0,0,0,0,False,False,False,0,2,2021-11-01T09:24:25.877,0,False,
2021,8,3182,45,18,1381,2,21,9,12,20,8,20,0,20,6,False,False,False,0,3,2021-11-01T09:27:43.987,20,True,0.0
2021,8,3182,65,9,322,2,5,3,5,5,0,5,0,5,0,False,False,False,0,3,2021-11-01T09:30:18.17,5,False,0.0
2021,8,3182,75,9,4202,2,48,10,-3,8,11,5,3,5,0,False,False,False,0,1,2021-11-04T13:58:19.013,8,False,3.0
2021,8,3182,80,9,4447,13,17,4,13,0,0,0,0,0,0,False,False,False,0,3,2022-02-16T21:00:29.42,0,False,
2021,8,3182,95,9,7816,2,4,2,16,17,1,17,0,17,0,False,False,False,0,2,2021-11-01T09:39:43.97,17,False,0.0
2021,8,3182,105,9,322,13,2,4,6,0,0,0,0,0,0,False,False,False,0,3,2021-11-01T09:41:45.683,0,False,0.0
2021,8,3182,110,9,7816,2,2,10,6,8,2,7,1,7,0,False,False,False,0,2,2021-11-01T09:43:00.547,8,False,1.0
2021,8,3182,130,18,1381,2,18,5,-1,3,4,3,0,3,0,False,False,False,0,2,2022-02-14T20:50:48.217,3,False,0.0
2021,8,3182,135,18,7711,13,24,2,32,0,0,0,0,0,0,False,False,False,0,3,2021-11-02T15:15:29.427,0,False,0.0
2021,8,3182,145,18,6361,13,28,3,3,0,0,0,0,0,0,False,False,False,0,4,2021-11-01T09:50:52.01,0,False,0.0
2021,8,3182,170,9,7816,2,5,6,15,20,5,19,1,19,0,False,False,False,0,2,2021-11-04T14:40:38.14,20,False,1.0
2021,8,3182,200,9,4447,13,17,1,19,0,0,0,0,0,0,False,False,False,0,3,2021-11-02T23:08:16.763,0,False,0.0
2021,8,3182,205,18,4152,2,53,9,-5,3,8,3,0,3,0,True,False,False,0,4,2021-11-01T16:26:07.58,3,False,
2021,8,3182,215,18,6361,2,42,9,5,5,0,5,0,5,0,False,False,False,0,4,2021-11-01T10:57:00.67,5,False,0.0
2021,8,3182,220,18,7712,13,26,10,5,0,0,0,0,0,0,False,False,False,0,3,2021-11-01T10:58:29.643,0,False,0.0
2021,8,3182,235,9,322,2,20,2,25,29,4,26,3,26,0,True,False,False,1,2,2021-11-04T13:59:08.073,29,False,3.0
2021,8,3182,260,9,6446,2,4,10,4,4,0,4,0,4,0,False,False,False,0,4,2021-11-02T23:02:04.283,4,False,0.0
2021,8,3182,265,9,6441,2,5,3,7,9,2,7,2,7,0,True,False,False,0,3,2021-11-04T13:58:47.693,9,False,2.0
2021,8,3182,275,9,4202,13,4,4,1,0,0,0,0,0,0,False,False,False,0,1,2021-11-01T11:14:10.473,0,False,0.0
2021,8,3182,280,9,322,13,2,10,8,0,0,0,0,0,0,False,False,False,0,3,2021-11-01T11:16:06.27,0,False,0.0
2021,8,3182,305,18,1381,13,2,10,5,0,0,0,0,0,0,False,False,False,0,2,2021-11-01T11:20:44.173,0,False,0.0
2021,8,3182,315,18,2223,2,32,4,1,7,6,3,4,3,0,False,False,False,0,4,2021-11-01T11:23:54.643,7,False,4.0
2021,8,3182,330,18,1381,2,35,10,14,32,18,31,1,31,0,False,False,False,0,2,2021-11-01T11:27:06.923,32,False,1.0
2021,8,3182,345,18,6900,2,4,5,-2,-2,0,-2,0,-2,0,True,False,False,0,2,2021-11-01T11:47:32.947,-2,False,0.0
2021,8,3182,355,18,4572,3,48,10,-4,0,0,0,0,0,0,False,False,False,0,1,2021-11-01T11:49:28.967,0,False,0.0
2021,8,3182,370,9,4202,2,4,9,0,3,3,1,2,1,0,False,False,False,0,1,2021-11-01T11:56:25.847,3,False,2.0
2021,8,3182,375,9,322,2,2,9,7,7,0,7,0,7,0,False,False,False,0,2,2021-11-01T16:38:47.127,7,False,0.0
2021,8,3182,380,9,6446,13,5,3,10,0,0,0,0,0,0,False,False,False,0,3,2021-11-01T11:59:29.257,0,False,0.0
2021,8,3182,385,9,6446,13,4,9,8,0,0,0,0,0,0,False,False,False,0,3,2021-11-01T12:00:54.533,0,False,0.0
2021,8,3182,390,9,4446,13,19,2,28,0,0,0,0,0,0,False,False,False,0,2,2021-11-04T13:55:08.1,0,False,0.0
2021,8,3182,405,18,8386,2,5,3,4,6,2,6,0,6,0,False,False,False,0,4,2021-11-01T12:27:13.933,6,False,0.0
2021,8,3182,415,18,1381,13,5,3,3,0,0,0,0,0,0,False,False,False,0,3,2021-11-01T12:29:45.217,0,False,0.0
2021,8,3182,440,9,6446,13,32,10,3,0,0,0,0,0,0,True,False,False,0,4,2021-11-01T12:36:58.21,0,False,0.0
2021,8,3182,445,9,6441,2,8,1,23,73,50,72,1,72,6,False,False,False,1,3,2021-11-01T12:43:02.197,73,False,1.0
2021,8,3182,460,18,7711,13,22,6,30,0,0,0,0,0,0,False,False,False,0,2,2021-11-01T12:46:35.893,0,False,
2021,8,3182,480,18,6361,2,53,10,-6,11,17,8,3,8,0,False,False,False,0,4,2021-11-01T13:10:19.983,11,False,3.0
2021,8,3182,500,9,322,13,21,6,22,0,0,0,0,0,0,False,False,False,0,3,2021-11-01T13:16:05.487,0,False,0.0
2021,8,3182,515,18,7711,2,4,10,13,18,5,15,3,15,0,False,False,False,0,2,2021-11-01T13:24:12.72,18,False,3.0
2021,8,3182,525,18,6262,2,30,5,-2,7,9,7,0,7,0,False,False,False,0,4,2021-11-01T13:26:47.813,7,False,0.0
2021,8,3182,540,18,6361,2,4,10,5,7,2,6,1,6,0,True,False,False,0,3,2021-11-01T13:30:20.09,7,False,1.0
2021,8,3182,560,9,322,2,4,3,8,10,2,9,1,9,0,False,False,False,0,2,2021-11-01T13:33:18.317,10,False,1.0
2021,8,3182,580,9,6441,2,46,3,-3,2,5,0,2,0,0,False,False,False,0,3,2021-11-04T13:55:18.437,2,False,2.0
2021,8,3182,595,18,4152,2,46,9,-4,-4,0,-4,0,-4,0,True,False,False,0,1,2021-11-01T13:43:57.117,-4,False,0.0
2021,8,3182,600,18,4572,13,28,9,3,0,0,0,0,0,0,False,False,False,0,1,2021-11-01T13:45:32.81,0,False,0.0
2021,8,3182,610,9,6441,13,35,10,13,0,0,0,0,0,0,False,False,False,0,3,2021-11-01T16:35:16.703,0,False,
2021,8,3182,615,9,7816,2,12,2,31,35,4,33,2,33,0,False,False,False,0,3,2021-11-04T13:56:06.733,35,False,2.0
2021,8,3182,625,9,7183,2,47,5,0,1,1,1,0,1,0,True,False,False,0,1,2021-11-04T13:11:07.597,1,False,0.0
2021,8,3182,630,9,322,13,5,3,6,0,0,0,0,0,0,False,False,False,0,2,2021-11-04T14:34:21.447,0,False,0.0
2021,8,3182,645,18,4152,2,30,10,-3,-2,1,-3,1,-3,0,True,False,False,0,4,2021-11-04T13:55:38.26,-2,False,1.0
2021,8,3182,655,18,1381,2,50,9,-3,4,7,2,2,2,0,True,False,False,0,2,2021-11-01T14:07:47.433,4,False,2.0
2021,8,3182,660,18,7712,2,32,5,3,4,1,4,0,4,0,False,False,False,0,3,2021-11-04T13:55:50.807,4,False,0.0
2021,8,3182,670,9,7816,2,4,9,13,13,0,13,0,13,0,False,False,False,0,2,2021-11-01T14:21:51.277,13,False,0.0
2021,8,3182,675,9,322,2,3,5,11,15,4,11,4,11,0,False,False,False,0,2,2021-11-01T14:23:40.98,15,False,4.0
2021,8,3182,680,9,4202,13,32,9,1,0,0,0,0,0,0,False,False,False,0,1,2021-11-01T14:26:21.357,0,False,0.0
2021,8,3182,685,9,4446,2,4,7,15,24,9,20,4,20,0,False,False,False,0,2,2021-11-01T14:30:35.35,24,False,
2021,8,3182,690,9,6446,2,53,10,1,7,6,5,2,5,0,False,False,False,0,4,2021-11-04T14:34:45.187,7,False,2.0
2021,8,3182,695,9,7816,2,4,2,15,19,4,18,1,18,0,False,False,False,1,2,2021-11-01T14:36:09.757,19,False,1.0
2021,8,3182,715,18,7711,3,6,4,13,0,0,0,0,0,0,False,False,False,0,2,2022-02-25T20:10:27.377,0,False,0.0
2021,8,3182,735,9,322,13,19,6,33,0,0,0,0,0,0,False,False,False,0,2,2021-11-01T15:03:47.187,0,False,0.0
2021,8,3182,740,9,7816,3,2,10,5,0,0,0,0,0,0,False,False,False,0,2,2021-11-01T15:04:43.177,0,False,0.0
2021,8,3182,760,18,4152,2,5,3,3,9,6,6,3,6,0,False,False,False,0,1,2021-11-01T15:14:35.317,9,False,3.0
2021,8,3182,790,18,6900,2,45,5,-6,-3,3,-3,0,-3,0,False,False,False,0,1,2021-11-01T15:33:04.123,-3,False,0.0
2021,8,3182,795,18,1381,2,12,5,4,6,2,5,1,5,0,False,False,False,0,3,2022-02-24T15:55:06.703,6,False,1.0
2021,8,3182,810,9,7816,13,4,3,7,0,0,0,0,0,0,False,False,False,0,2,2021-11-01T15:36:23.213,0,False,0.0
2021,8,3182,815,9,322,2,19,2,31,33,2,31,2,31,0,False,False,False,0,2,2021-11-01T15:40:58.427,33,False,2.0
2021,8,3182,820,9,322,2,4,5,3,18,15,18,0,18,0,False,True,False,1,2,2021-11-01T15:42:32.48,18,False,0.0
2021,8,3182,825,9,6446,13,24,5,13,0,0,0,0,0,0,False,False,False,0,4,2021-11-04T14:35:43.933,0,False,0.0
2021,8,3182,835,9,4446,2,13,10,1,1,0,1,0,1,0,False,True,True,0,2,2021-11-04T14:36:03.327,1,False,
2021,8,3182,840,9,4446,2,39,4,6,7,1,7,0,7,0,False,False,False,0,3,2021-11-01T15:59:09.147,7,False,0.0
2021,8,3182,850,9,4202,2,45,5,-4,-3,1,-4,1,-4,0,False,False,False,0,1,2021-11-04T14:36:39.587,-3,False,1.0
2021,8,3182,870,9,4202,2,6,9,1,15,14,5,10,5,0,False,False,False,3,1,2021-11-01T16:09:54.99,15,False,10.0
2021,8,3182,880,9,322,2,9,3,5,5,0,5,0,5,6,False,False,False,0,2,2021-11-01T16:11:00.33,5,True,0.0
2021,8,3182,895,18,1381,2,5,5,13,13,0,13,0,13,0,False,False,False,0,2,2021-11-01T16:14:20.063,13,False,0.0
2021,8,3182,900,18,6361,13,32,9,-7,0,0,0,0,0,0,False,False,False,0,4,2021-11-01T16:15:38.89,0,False,0.0
2021,8,3182,910,18,7712,2,4,9,7,6,-1,6,0,6,0,False,False,False,0,3,2021-11-01T16:19:23.51,6,False,0.0
2021,8,3182,920,18,6361,2,32,5,2,3,1,2,1,2,0,False,False,False,0,4,2021-11-01T16:21:08.827,3,False,1.0
2021,8,3183,10,16,3938,2,18,3,0,10,10,4,6,4,0,False,False,False,1,2,2021-11-02T10:13:03.073,10,False,6.0
2021,8,3183,15,16,374,2,30,10,-3,3,6,3,0,3,0,False,False,False,0,4,2021-11-02T10:15:45.71,3,False,0.0
2021,8,3183,20,16,3938,2,54,9,-1,9,10,9,0,9,0,True,False,False,0,4,2021-11-04T18:41:46.51,9,True,0.0
2021,8,3183,30,16,6500,2,39,4,7,12,5,11,1,11,0,False,False,False,1,3,2021-11-02T10:24:31.987,12,False,1.0
2021,8,3183,35,16,6499,2,46,3,0,7,7,7,0,7,0,False,False,False,0,1,2021-11-02T10:26:41.237,7,False,0.0
2021,8,3183,40,16,3938,2,50,5,-4,0,4,0,0,0,0,False,False,False,0,2,2021-11-02T10:29:35.97,0,True,0.0
2021,8,3183,45,16,7176,2,4,3,5,15,10,13,2,13,0,False,False,False,0,2,2021-11-02T10:31:23.113,15,False,2.0
2021,8,3183,55,16,3938,2,34,4,-4,5,9,2,3,2,0,True,False,False,1,4,2021-11-02T10:38:30.387,5,False,3.0
2021,8,3183,65,16,3938,13,5,5,5,0,0,0,0,0,0,False,False,False,0,3,2021-11-04T18:35:18.49,0,False,0.0
2021,8,3183,75,16,1989,13,12,10,5,0,0,0,0,0,0,False,False,False,0,2,2021-11-04T16:53:47.607,0,False,0.0
2021,8,3183,85,21,7090,13,4,9,4,0,0,0,0,0,0,False,False,False,0,2,2021-11-02T10:50:17.13,0,False,0.0
2021,8,3183,105,16,3938,2,12,4,6,6,0,6,0,6,6,False,False,False,0,3,2021-11-02T10:58:21.81,6,True,0.0
2021,8,3183,120,21,4674,13,4,5,6,0,0,0,0,0,0,False,False,False,0,2,2021-11-02T11:02:15.533,0,False,0.0
2021,8,3183,130,21,3957,2,48,9,-4,5,9,3,2,3,0,False,False,False,0,1,2021-11-02T11:04:47.44,5,False,2.0
2021,8,3183,145,16,2568,13,5,10,3,0,0,0,0,0,0,False,False,False,0,4,2021-11-02T11:08:40.693,0,False,0.0
2021,8,3183,150,16,3938,2,5,3,6,6,0,6,0,6,0,True,False,False,0,4,2021-11-02T11:10:29.583,6,False,0.0
2021,8,3183,160,16,374,13,4,4,12,0,0,0,0,0,0,True,False,False,0,3,2021-11-04T16:54:11.72,0,False,0.0
2021,8,3183,165,16,3938,13,19,2,40,0,0,0,0,0,0,False,False,False,0,3,2021-11-02T11:16:57.76,0,False,0.0
2021,8,3183,190,21,4674,2,23,8,50,50,0,50,0,50,0,False,False,False,0,3,2021-12-05T16:28:07.617,50,False,0.0
2021,8,3183,195,21,3680,2,35,5,12,19,7,16,3,16,0,False,False,False,0,2,2021-11-02T11:29:56.117,19,False,3.0
2021,8,3183,215,21,3680,13,9,5,4,0,0,0,0,0,0,False,False,False,0,2,2021-11-04T18:06:56.2,0,False,0.0
2021,8,3183,220,21,3680,2,49,9,-2,3,5,2,1,2,0,True,False,False,0,2,2021-11-04T18:08:14.313,3,False,1.0
2021,8,3183,225,21,813,2,31,9,1,1,0,1,0,1,6,False,False,False,0,4,2021-11-02T11:39:21.423,1,True,0.0
2021,8,3183,245,16,3938,13,6,9,13,0,0,0,0,0,0,False,False,False,0,3,2021-11-04T18:35:29.63,0,False,0.0
2021,8,3183,265,21,3680,13,5,5,2,0,0,0,0,0,0,False,False,False,0,3,2021-11-04T16:54:27.453,0,False,0.0
2021,8,3183,270,21,3680,3,26,10,1,0,0,0,0,0,0,False,False,False,0,2,2021-11-04T18:35:37.927,0,False,0.0
2021,8,3183,280,16,6499,2,46,3,-1,7,8,6,1,6,0,False,False,False,0,1,2021-11-02T11:59:05,7,False,1.0
2021,8,3183,290,16,3938,2,35,3,10,11,1,11,0,11,0,False,False,False,0,3,2021-11-02T12:02:33.253,11,False,0.0
2021,8,3183,305,16,6500,3,6,4,13,0,0,0,0,0,0,False,False,False,0,3,2022-02-16T20:45:39.173,0,False,0.0
2021,8,3183,310,16,3938,2,5,10,9,9,0,9,0,9,0,False,False,False,1,3,2021-11-02T12:10:02.137,9,False,0.0
2021,8,3183,350,21,813,2,32,10,1,11,10,11,0,11,0,True,False,False,0,4,2021-11-04T19:04:39.723,11,False,0.0
2021,8,3183,355,21,3680,2,49,3,-2,1,3,0,1,0,0,False,False,False,0,2,2022-02-25T17:44:51.133,1,False,1.0
2021,8,3183,360,21,3957,2,48,9,-5,12,17,10,2,10,0,False,False,False,0,1,2021-11-02T12:29:04.663,12,False,2.0
2021,8,3183,365,21,3957,2,28,10,2,41,39,9,32,9,0,False,False,False,1,1,2021-11-04T19:05:41.613,41,False,32.0
2021,8,3183,385,21,3680,2,5,5,2,2,0,2,0,2,0,False,False,False,0,2,2021-11-02T12:39:15.45,2,True,0.0
2021,8,3183,400,16,6499,2,44,9,2,17,15,17,0,17,0,False,False,False,0,1,2021-11-02T12:43:02.953,17,False,0.0
2021,8,3183,405,16,3938,13,5,8,15,0,0,0,0,0,0,False,False,False,0,3,2021-11-02T12:44:58.247,0,False,0.0
2021,8,3183,415,16,4143,13,19,2,52,0,0,0,0,0,0,False,False,False,0,2,2021-11-04T17:53:03.857,0,False,
2021,8,3183,425,16,7176,13,12,2,43,0,0,0,0,0,0,False,False,False,0,3,2021-11-02T12:54:08.213,0,False,0.0
2021,8,3183,435,21,8518,2,6,5,5,5,0,5,0,5,0,False,False,False,0,2,2021-11-02T12:57:14.71,5,False,0.0
2021,8,3183,440,21,3957,2,28,10,0,4,4,3,1,3,0,False,False,False,1,1,2021-11-04T18:36:03.697,4,False,1.0
2021,8,3183,450,21,3680,13,4,9,8,0,0,0,0,0,0,False,False,False,0,3,2021-11-02T13:04:28.07,0,False,
2021,8,3183,510,16,3938,2,51,10,-2,9,11,9,0,9,0,False,False,False,0,3,2021-11-02T13:26:57.9,9,False,0.0
2021,8,3183,530,16,7176,2,4,3,2,3,1,3,0,3,0,False,False,False,0,2,2021-11-04T19:07:19.26,3,False,0.0
2021,8,3183,535,16,374,13,9,6,22,0,0,0,0,0,0,False,False,False,0,3,2021-11-02T13:37:43.497,0,False,0.0
2021,8,3183,545,21,4674,2,4,8,15,22,7,20,2,20,0,False,False,False,0,3,2021-11-02T13:41:10.59,22,False,2.0
2021,8,3183,555,21,8518,2,2,5,4,4,0,4,0,4,0,False,False,False,0,2,2021-11-02T13:44:33.06,4,False,0.0
2021,8,3183,560,21,8518,13,2,10,6,0,0,0,0,0,0,False,False,False,0,2,2022-02-16T20:48:35.55,0,False,0.0
2021,8,3183,570,16,3938,13,8,1,51,0,0,0,0,0,0,False,False,False,0,2,2021-11-04T17:53:18.763,0,False,0.0
2021,8,3183,575,16,6499,2,45,10,-6,11,17,7,4,7,0,False,False,False,0,1,2021-11-02T13:52:55.87,11,False,4.0
2021,8,3183,580,16,7176,2,34,4,-4,12,16,12,0,12,0,True,False,False,0,3,2021-11-02T13:54:30.47,12,False,0.0
2021,8,3183,585,16,7176,2,51,9,-5,9,14,2,7,2,0,True,False,False,0,3,2021-11-02T13:56:14.48,9,False,7.0
2021,8,3183,595,16,4143,2,4,8,16,18,2,18,0,18,0,False,False,False,0,2,2021-11-02T14:01:01.067,18,False,0.0
2021,8,3183,610,16,3938,13,12,6,30,0,0,0,0,0,0,True,False,False,0,3,2021-11-02T14:06:44.627,0,False,0.0
2021,8,3183,615,16,374,2,39,4,8,8,0,8,0,8,0,True,True,True,0,3,2021-11-04T19:08:20.797,8,False,0.0
2021,8,3183,630,21,7592,2,4,5,6,6,0,6,0,6,0,False,False,False,0,2,2021-11-02T16:18:30.833,6,False,0.0
2021,8,3183,640,21,8518,2,45,5,-3,11,14,10,1,10,0,True,False,False,0,2,2021-11-02T14:23:17.233,11,False,1.0
2021,8,3183,650,21,8518,2,5,5,1,6,5,4,2,4,0,False,False,False,0,3,2021-11-04T16:55:28.533,6,False,2.0
2021,8,3183,660,21,813,13,9,5,5,0,0,0,0,0,0,False,False,False,0,2,2021-11-02T14:33:30.513,0,False,0.0
2021,8,3183,665,21,4422,2,5,5,3,5,2,5,0,5,6,False,False,False,0,3,2021-11-02T16:23:16.667,5,True,0.0
2021,8,3183,680,16,3938,2,51,5,-2,4,6,4,0,4,0,False,False,False,0,3,2021-11-02T14:38:31.68,4,True,0.0
2021,8,3183,685,16,6499,2,46,3,-2,9,11,7,2,7,0,False,False,False,0,1,2021-11-02T14:42:03.89,9,False,2.0
2021,8,3183,690,16,3938,2,13,4,4,10,6,10,0,10,0,False,False,False,0,3,2021-11-04T17:51:01.94,10,False,0.0
2021,8,3183,695,16,6499,2,46,3,1,10,9,10,0,10,0,False,False,False,0,1,2021-11-02T14:45:56.37,10,False,0.0
2021,8,3183,715,16,2568,3,35,10,13,0,0,0,0,0,0,False,False,False,0,4,2021-11-04T16:55:41.197,0,False,0.0
2021,8,3183,725,16,3938,2,35,9,13,15,2,15,0,15,0,False,False,False,1,3,2021-11-04T17:51:16.433,15,False,0.0
2021,8,3183,735,16,7176,13,12,3,2,0,0,0,0,0,0,False,False,False,0,3,2021-11-04T19:09:12.837,0,False,0.0
2021,8,3183,760,21,4422,2,53,10,-5,7,12,6,1,6,0,False,False,False,0,4,2021-11-02T15:10:39.54,7,False,1.0
2021,8,3183,770,21,4180,2,47,10,0,16,16,3,13,3,0,False,False,False,1,1,2021-11-02T15:14:42.067,16,False,13.0
2021,8,3183,775,21,7592,2,4,3,4,4,0,4,0,4,0,False,False,False,0,2,2021-11-02T15:18:15.447,4,False,0.0
2021,8,3183,785,21,7090,13,20,2,25,0,0,0,0,0,0,False,False,False,0,2,2021-11-04T18:06:56.23,0,False,
2021,8,3183,790,21,3957,2,31,10,2,3,1,3,0,3,0,False,False,False,0,1,2021-11-02T15:24:38.7,3,False,0.0
2021,8,3183,795,21,7090,3,6,3,4,0,0,0,0,0,0,False,False,False,0,2,2021-11-02T15:27:44.323,0,False,0.0
2021,8,3183,800,21,3957,3,28,4,3,0,0,0,0,0,0,False,False,False,0,1,2022-02-16T20:50:36.277,0,False,0.0
2021,8,3183,810,16,374,3,12,3,12,0,0,0,0,0,0,False,False,False,0,3,2021-11-02T15:38:23.353,0,False,
2021,8,3183,820,16,6500,13,4,8,15,0,0,0,0,0,0,False,False,False,0,3,2021-11-02T15:40:14.977,0,False,
2021,8,3183,825,16,374,2,31,10,5,14,9,9,5,9,0,False,False,False,1,4,2021-11-02T15:44:44.903,14,False,5.0
2021,8,3183,845,16,7176,2,34,4,-4,24,28,22,2,22,0,True,False,False,1,3,2021-11-02T15:49:47.42,24,False,2.0
2021,8,3183,860,16,374,2,55,10,-1,2,3,2,0,2,0,True,False,False,0,4,2021-11-02T15:54:19.11,2,False,0.0
2021,8,3183,885,21,4422,2,38,10,2,3,1,3,0,3,0,False,False,False,0,3,2021-11-04T16:55:54.517,3,False,0.0
2021,8,3183,895,21,4422,13,47,5,2,0,0,0,0,0,0,False,False,False,0,3,2021-11-02T16:02:51.62,0,False,0.0
2021,9,3184,10,22,2629,2,30,3,3,12,9,10,2,10,0,False,False,False,0,4,2021-11-05T11:17:19.83,12,False,2.0
2021,9,3184,15,22,6270,2,51,5,-1,0,1,-1,1,-1,0,False,False,False,0,3,2022-02-25T17:46:05.447,0,False,1.0
2021,9,3184,20,22,3170,2,12,10,4,11,7,9,2,9,0,True,False,False,0,3,2021-11-06T14:39:23.593,11,False,2.0
2021,9,3184,25,22,2391,13,38,3,12,0,0,0,0,0,0,False,False,False,0,4,2022-02-14T20:55:11.217,0,False,0.0
2021,9,3184,35,22,7610,13,2,4,8,0,0,0,0,0,0,False,False,False,0,2,2021-11-05T11:28:49.747,0,False,0.0
2021,9,3184,60,14,7584,13,50,9,-3,0,0,0,0,0,0,False,False,False,0,2,2021-11-11T14:08:23.36,0,False,0.0
2021,9,3184,65,14,7584,2,13,9,6,9,3,8,1,8,0,False,False,False,1,2,2021-11-05T17:22:54.11,9,False,1.0
2021,9,3184,70,14,7582,2,5,9,1,8,7,2,6,2,0,False,False,False,2,1,2021-11-11T14:10:10.607,8,False,6.0
2021,9,3184,75,14,7495,2,4,9,5,6,1,6,0,6,0,False,False,False,0,3,2021-11-05T16:53:20.907,6,False,0.0
2021,9,3184,80,14,6543,2,4,5,7,13,6,12,1,12,0,False,False,False,0,2,2021-11-05T11:44:54.123,13,False,1.0
2021,9,3184,100,22,2629,3,35,4,8,0,0,0,0,0,0,False,False,False,0,4,2021-11-11T15:10:51.013,0,False,0.0
2021,9,3184,105,22,8451,13,12,3,1,0,0,0,0,0,0,True,False,False,0,2,2021-11-06T14:39:34.13,0,False,0.0
2021,9,3184,110,22,4997,2,2,10,10,12,2,11,1,11,0,False,False,False,0,3,2021-11-11T13:28:50.8,12,False,1.0
2021,9,3184,120,22,4997,2,5,5,14,15,1,15,0,15,0,False,False,False,0,3,2021-11-05T11:58:22.44,15,False,0.0
2021,9,3184,130,22,8454,2,6,8,20,26,6,22,4,22,0,False,False,False,0,2,2021-11-05T12:02:18.997,26,False,4.0
2021,9,3184,135,22,8454,2,24,6,19,19,0,19,0,19,6,False,False,False,0,3,2021-11-11T15:10:51.013,19,True,0.0
2021,9,3184,160,14,7584,2,2,10,3,13,10,10,3,10,0,False,False,False,0,2,2021-11-05T17:23:11.283,13,False,3.0
2021,9,3184,165,14,4449,13,22,2,43,0,0,0,0,0,0,False,False,False,0,3,2021-11-11T15:10:51.03,0,False,0.0
2021,9,3184,170,14,6543,2,50,9,-3,9,12,7,2,7,0,False,False,False,0,2,2021-11-05T12:17:33.513,9,False,2.0
2021,9,3184,210,22,2391,13,13,4,5,0,0,0,0,0,0,False,False,False,0,4,2021-11-05T12:48:52.223,0,False,0.0
2021,9,3184,220,22,3170,2,50,3,-3,-5,-2,-5,0,-5,0,False,False,False,0,2,2021-11-05T17:04:01.033,0,False,0.0
2021,9,3184,235,14,7582,2,48,4,-4,20,24,16,4,16,0,False,True,False,0,1,2022-04-28T16:46:44.343,20,False,4.0
2021,9,3184,245,14,7584,2,4,10,9,12,3,10,2,10,0,False,True,False,0,2,2021-11-11T15:10:51.03,12,False,2.0
2021,9,3184,280,14,1119,2,55,4,-1,1,2,1,0,1,6,False,False,False,0,4,2021-11-11T14:06:56.257,1,True,0.0
2021,9,3184,305,22,6812,2,48,9,-6,18,24,13,5,13,0,False,False,False,0,1,2021-11-11T14:28:45.387,18,False,5.0
2021,9,3184,315,22,2629,2,11,2,21,26,5,21,5,21,0,False,False,False,0,4,2021-11-11T14:29:49.14,26,False,5.0
2021,9,3184,330,22,3170,13,30,3,1,0,0,0,0,0,0,True,False,False,0,3,2021-11-11T15:04:09.233,0,False,0.0
2021,9,3184,335,22,4997,13,5,3,14,0,0,0,0,0,0,False,False,False,0,2,2021-11-11T14:33:29.767,0,False,0.0
2021,9,3184,350,14,6543,2,11,3,-1,10,11,10,0,10,0,False,False,False,0,1,2021-11-05T13:12:47.207,10,False,0.0
2021,9,3184,355,14,6543,2,48,9,-5,2,7,1,1,1,0,False,False,False,0,1,2021-11-05T13:13:57.49,2,False,1.0
2021,9,3184,360,14,7495,2,5,6,17,17,0,17,0,17,0,False,False,False,0,2,2021-11-05T13:15:12.867,17,True,0.0
2021,9,3184,365,14,6543,13,32,3,-3,0,0,0,0,0,0,False,False,False,0,1,2021-11-11T14:34:25.503,0,False,0.0
2021,9,3184,380,14,4449,2,46,3,3,3,0,3,0,3,0,False,False,False,0,3,2021-11-05T13:20:33.147,3,True,0.0
2021,9,3184,385,14,4449,2,4,10,11,12,1,12,0,12,0,False,False,False,0,3,2021-11-11T13:29:44.943,12,False,0.0
2021,9,3184,395,14,7584,2,2,4,11,11,0,11,0,11,6,False,False,False,0,3,2021-11-05T17:18:09.147,11,True,0.0
2021,9,3184,425,14,4449,2,5,5,12,12,0,12,0,12,0,False,False,False,0,3,2021-11-05T13:37:22.807,12,False,0.0
2021,9,3184,440,14,8400,2,13,4,2,27,25,26,1,26,0,False,False,False,0,4,2021-11-05T13:43:19.917,27,False,1.0
2021,9,3184,445,14,4449,2,35,6,29,31,2,30,1,30,0,False,False,False,0,3,2021-11-05T13:45:19.213,31,False,1.0
2021,9,3184,480,22,7610,13,2,10,6,0,0,0,0,0,0,False,False,False,0,2,2021-11-05T17:08:26.053,0,False,0.0
2021,9,3184,485,22,3170,2,26,10,4,7,3,5,2,5,0,False,False,False,0,3,2021-11-11T14:35:49.907,7,False,2.0
2021,9,3184,505,14,7585,2,32,3,2,2,0,2,0,2,6,False,False,False,0,4,2021-11-11T14:37:03.717,2,True,0.0
2021,9,3184,525,22,7610,13,6,4,14,0,0,0,0,0,0,False,False,False,0,3,2021-11-05T17:08:52.197,0,False,0.0
2021,9,3184,530,22,2391,3,5,9,5,0,0,0,0,0,0,True,False,False,0,3,2021-11-11T13:30:07.547,0,False,0.0
2021,9,3184,560,22,8451,2,48,4,-4,19,23,14,5,14,0,False,False,False,0,1,2021-11-05T17:09:13.85,19,False,5.0
2021,9,3184,565,22,7610,2,5,2,20,20,0,20,0,20,0,False,False,False,0,3,2021-11-11T14:47:16.04,20,False,0.0
2021,9,3184,575,22,4997,2,4,3,9,10,1,10,0,10,0,False,False,False,0,3,2021-11-11T14:47:42.593,10,False,0.0
2021,9,3184,580,22,8454,2,35,10,14,19,5,16,3,16,6,False,False,False,1,3,2021-11-11T14:10:49.087,19,False,3.0
2021,9,3184,605,14,4449,3,22,6,25,0,0,0,0,0,0,False,False,False,0,2,2021-11-11T13:30:34.663,0,False,0.0
2021,9,3184,615,22,8454,2,34,4,-4,-1,3,-1,0,-1,0,True,False,False,0,4,2021-11-05T17:10:00.527,-1,False,0.0
2021,9,3184,620,22,4997,2,6,1,18,18,0,18,0,18,0,False,False,False,0,3,2021-11-11T14:48:27.17,18,False,0.0
2021,9,3184,635,22,3170,13,5,2,15,0,0,0,0,0,0,False,False,False,0,3,2021-11-11T13:30:50.457,0,False,0.0
2021,9,3184,640,22,8454,2,6,4,12,12,0,12,0,12,0,False,False,False,0,3,2021-11-11T14:49:45.883,12,False,0.0
2021,9,3184,655,22,7118,2,6,4,12,12,0,12,0,12,0,False,False,False,0,3,2021-11-06T14:39:10.883,12,False,0.0
2021,9,3184,660,22,2391,2,53,4,-3,0,3,0,0,0,0,False,False,False,0,4,2021-11-11T14:50:32.163,0,False,0.0
2021,9,3184,670,22,2391,2,36,4,13,13,0,13,0,13,6,False,False,False,0,4,2021-11-05T17:11:10.71,13,True,0.0
2021,9,3184,685,14,5197,2,13,10,3,28,25,28,0,28,0,False,False,False,0,3,2021-11-05T15:33:52.357,28,False,0.0
2021,9,3184,690,14,4449,13,35,2,19,0,0,0,0,0,0,False,False,False,0,3,2021-11-11T13:31:03.29,0,False,0.0
2021,9,3184,695,14,7584,2,50,10,0,19,19,16,3,16,0,False,False,False,0,2,2021-11-05T17:18:29.58,19,False,3.0
2021,9,3184,700,14,6543,13,11,2,23,0,0,0,0,0,0,False,False,False,0,1,2021-11-05T15:40:14.417,0,False,0.0
2021,9,3184,705,14,7583,2,13,9,3,7,4,5,2,5,0,True,False,False,0,3,2021-11-11T13:31:21.753,7,False,2.0
2021,9,3184,710,14,1119,13,7,2,19,0,0,0,0,0,0,False,False,False,0,4,2022-02-21T14:59:24.747,0,False,0.0
2021,9,3184,725,22,8454,2,50,3,-3,-3,0,-3,0,-3,0,False,False,False,0,2,2021-11-05T17:11:44.173,-3,False,0.0
2021,9,3184,735,22,7118,2,2,9,6,14,8,12,2,12,0,False,False,False,0,2,2021-11-05T17:12:04.91,14,False,2.0
2021,9,3184,740,22,4997,13,6,1,19,0,0,0,0,0,0,False,False,False,0,2,2021-11-05T17:12:15.84,0,False,0.0
2021,9,3184,745,22,8454,13,9,6,16,0,0,0,0,0,0,False,False,False,0,3,2021-11-05T17:12:26.493,0,False,0.0
2021,9,3184,760,22,6270,13,5,3,13,0,0,0,0,0,0,False,False,False,0,3,2021-11-11T15:10:51.06,0,False,0.0
2021,9,3184,770,22,8454,2,5,3,12,12,0,12,0,12,0,False,False,False,0,3,2021-11-11T14:53:06.86,12,False,0.0
2021,9,3184,785,22,6270,2,5,5,3,5,2,5,0,5,0,True,False,False,0,3,2021-11-11T14:09:16.693,5,False,0.0
2021,9,3184,790,22,6812,2,16,4,5,22,17,12,10,12,6,False,False,False,2,1,2021-11-11T14:54:26.21,22,False,10.0
2021,9,3184,835,22,7118,13,19,2,37,0,0,0,0,0,0,False,False,False,0,2,2021-11-05T17:13:24.81,0,False,0.0
2021,9,3184,840,22,7610,3,4,10,13,0,0,0,0,0,0,False,False,False,0,3,2021-11-05T17:13:35.87,0,False,0.0
2021,9,3184,845,22,6812,13,9,3,8,0,0,0,0,0,0,True,False,False,0,2,2021-11-11T13:32:15.393,0,False,0.0
2021,9,3184,850,22,2391,2,28,9,1,11,10,9,2,9,0,True,False,False,0,1,2021-11-05T16:25:21.59,11,False,2.0
2021,9,3184,855,22,3170,2,4,5,3,12,9,11,1,11,0,False,False,False,0,3,2021-11-05T16:27:56.59,12,False,1.0
2021,9,3184,860,22,7121,2,32,5,2,10,8,9,1,9,0,False,False,False,0,4,2021-11-05T16:29:40.453,10,False,1.0
2021,9,3184,865,22,7118,2,5,5,14,14,0,14,0,14,0,False,False,False,0,2,2021-11-05T16:31:13.38,14,False,0.0
2021,9,3184,875,22,7121,2,32,5,0,6,6,6,0,6,0,False,False,False,0,4,2021-11-05T17:14:47.703,6,True,0.0
2021,9,3184,880,22,7118,13,6,4,11,0,0,0,0,0,0,False,False,False,0,3,2021-11-11T13:35:07.167,0,False,
2021,9,3184,885,22,3170,2,32,3,3,8,5,7,1,7,0,False,False,False,0,3,2021-11-11T14:55:27.243,8,False,1.0
2021,9,3184,890,22,2391,2,5,5,4,4,0,4,0,4,0,False,False,False,0,3,2021-11-11T15:10:51.06,4,True,0.0
2021,9,3184,895,22,4997,2,13,4,7,11,4,10,1,10,0,False,False,False,0,2,2021-11-11T14:09:25.76,11,False,1.0
2021,9,3184,900,22,4997,13,2,9,0,0,0,0,0,0,0,False,False,False,0,2,2021-11-11T14:09:36.667,0,False,0.0
2021,9,3185,10,2,8389,3,19,6,23,0,0,0,0,0,0,False,False,False,0,2,2021-11-08T13:24:27.19,0,False,0.0
2021,9,3185,20,2,811,2,21,2,24,34,10,31,3,31,0,False,False,False,0,2,2021-11-08T13:28:41.22,34,False,3.0
2021,9,3185,35,2,5214,13,12,5,8,0,0,0,0,0,0,False,False,False,0,3,2021-11-08T13:34:55.353,0,False,
2021,9,3185,40,2,6247,2,2,9,5,7,2,5,2,5,0,False,False,False,0,2,2021-11-08T13:37:35.86,7,False,2.0
2021,9,3185,70,20,902,2,48,9,-4,-1,3,-2,1,-2,0,False,False,False,0,1,2022-02-21T16:17:09.433,-1,False,1.0
2021,9,3185,75,20,7888,13,35,9,10,0,0,0,0,0,0,False,False,False,0,3,2021-11-08T13:57:07.787,0,False,0.0
2021,9,3185,80,20,2136,13,19,6,28,0,0,0,0,0,0,False,False,False,0,2,2021-11-08T13:59:07.407,0,False,0.0
2021,9,3185,90,2,8389,2,2,8,20,39,19,39,0,39,0,False,False,False,0,2,2021-11-08T19:39:36.51,39,False,0.0
2021,9,3185,105,2,811,2,11,3,7,13,6,8,5,8,0,False,False,False,0,1,2021-11-11T16:36:58.163,13,False,5.0
2021,9,3185,115,2,6247,2,2,4,6,6,0,6,0,6,0,False,False,False,0,3,2022-03-11T19:34:35.48,6,False,0.0
2021,9,3185,120,2,5214,13,4,4,6,0,0,0,0,0,0,False,False,False,0,3,2021-11-08T19:39:15.317,0,False,0.0
2021,9,3185,160,20,7353,2,3,3,8,9,1,9,0,9,0,False,False,False,0,3,2021-11-08T14:27:25.767,9,False,0.0
2021,9,3185,175,20,7353,3,5,8,19,0,0,0,0,0,0,False,False,False,0,3,2021-11-08T14:36:48.297,0,False,0.0
2021,9,3185,190,20,7353,2,50,10,-3,2,5,-2,4,-2,0,True,False,False,1,3,2021-11-09T18:58:43.963,2,False,4.0
2021,9,3185,210,2,5214,2,50,4,-4,0,4,-3,3,-3,0,False,False,False,0,3,2021-11-11T15:34:29.05,0,False,3.0
2021,9,3185,225,20,6388,2,35,2,19,19,0,19,0,19,0,False,False,False,0,3,2022-03-11T19:36:04.78,19,False,0.0
2021,9,3185,240,20,6388,13,7,2,17,0,0,0,0,0,0,False,False,False,0,3,2021-11-11T15:08:36.787,0,False,0.0
2021,9,3185,245,20,7888,3,2,4,6,0,0,0,0,0,0,False,False,False,0,3,2021-11-08T19:37:59.883,0,False,0.0
2021,9,3185,250,2,8389,13,32,5,4,0,0,0,0,0,0,False,False,False,0,4,2022-02-21T16:23:32.56,0,False,0.0
2021,9,3185,260,2,6247,2,2,4,5,8,3,5,3,5,0,False,False,False,0,3,2021-11-08T15:03:51.03,8,False,3.0
2021,9,3185,275,20,8131,3,12,2,15,0,0,0,0,0,0,False,False,False,0,2,2021-11-11T16:40:01.607,0,False,
2021,9,3185,280,20,902,2,46,3,2,5,3,5,0,5,0,False,False,False,0,4,2022-03-11T19:38:58.143,5,False,0.0
2021,9,3185,300,2,6247,2,5,3,6,7,1,7,0,7,0,False,False,False,0,3,2021-11-11T16:42:33.68,7,True,0.0
2021,9,3185,310,2,2554,2,5,3,3,5,2,4,1,4,0,False,False,False,0,1,2022-03-11T19:40:42.28,5,False,1.0
2021,9,3185,325,2,2554,13,48,4,-3,0,0,0,0,0,0,False,False,False,0,1,2022-02-21T16:28:27.203,0,False,0.0
2021,9,3185,330,2,8389,2,7,9,13,16,3,15,1,15,0,False,False,False,0,3,2021-11-08T15:29:13.93,16,False,1.0
2021,9,3185,340,2,6247,2,2,4,6,7,1,6,1,6,0,False,False,False,1,3,2021-11-11T15:34:43.41,7,False,1.0
2021,9,3185,345,2,6247,2,6,4,11,20,9,16,4,16,0,False,False,False,0,3,2021-11-11T16:44:09.173,20,False,4.0
2021,9,3185,355,2,8389,2,4,5,7,7,0,7,0,7,0,False,False,False,0,3,2021-11-11T16:45:32.293,7,False,0.0
2021,9,3185,365,2,811,2,12,5,6,6,0,6,0,6,0,True,False,False,0,3,2022-02-24T15:57:51.11,6,False,0.0
2021,9,3185,375,2,8389,13,17,4,3,0,0,0,0,0,0,False,False,False,0,3,2021-11-11T16:50:06.553,0,False,0.0
2021,9,3185,380,2,7303,2,4,10,3,3,0,3,0,3,6,True,False,False,0,3,2021-11-11T16:58:51.857,3,True,0.0
2021,9,3185,400,20,902,2,4,4,2,14,12,9,5,9,0,False,False,False,1,1,2021-11-11T16:51:35.413,14,False,5.0
2021,9,3185,415,20,7353,2,4,9,7,7,0,7,0,7,0,False,False,False,0,3,2021-11-09T19:04:07.803,7,False,0.0
2021,9,3185,420,20,8131,13,3,5,11,0,0,0,0,0,0,False,False,False,0,2,2021-11-11T14:32:00.793,0,False,0.0
2021,9,3185,425,20,5140,2,32,3,3,19,16,11,8,11,0,True,False,False,1,3,2021-11-09T18:57:55.803,19,False,8.0
2021,9,3185,435,20,5140,2,45,5,-5,11,16,-4,15,-4,0,False,False,False,1,1,2021-11-08T16:28:45.053,11,False,15.0
2021,9,3185,445,20,2136,13,7,6,17,0,0,0,0,0,0,False,False,False,0,3,2021-11-08T16:32:32.433,0,False,0.0
2021,9,3185,450,20,8131,13,19,6,16,0,0,0,0,0,0,False,False,False,0,2,2021-11-11T16:52:47.497,0,False,0.0
2021,9,3185,465,2,3506,2,2,9,8,12,4,12,0,12,0,True,False,False,0,3,2021-11-09T23:14:17.713,12,False,0.0
2021,9,3185,475,2,7303,2,19,6,34,49,15,40,9,40,0,False,False,False,0,3,2021-11-09T23:11:06.403,49,False,9.0
2021,9,3185,485,2,5214,2,2,9,5,16,11,12,4,12,0,False,False,False,0,3,2021-11-08T16:44:21.627,16,False,4.0
2021,9,3185,520,20,6388,2,2,10,5,20,15,15,5,15,0,False,False,False,0,3,2021-11-09T19:05:30.667,20,False,5.0
2021,9,3185,525,20,902,2,46,9,2,4,2,2,2,2,0,False,False,False,0,1,2021-11-09T19:05:48.193,4,False,2.0
2021,9,3185,535,20,5140,13,48,9,-4,0,0,0,0,0,0,False,False,False,0,1,2021-11-09T19:06:07.163,0,False,0.0
2021,9,3185,540,20,8131,2,4,6,15,15,0,15,0,15,0,False,False,False,0,2,2021-11-08T17:06:59.793,15,False,0.0
2021,9,3185,550,20,5140,2,18,3,-1,15,16,10,5,10,0,False,False,False,0,2,2021-11-08T17:10:01.637,15,False,5.0
2021,9,3185,560,20,2136,13,19,6,31,0,0,0,0,0,0,False,False,False,0,2,2021-11-11T16:02:42.657,0,False,0.0
2021,9,3185,565,20,8131,13,9,6,24,0,0,0,0,0,0,False,False,False,0,2,2021-11-11T16:02:52.96,0,False,0.0
2021,9,3185,580,2,811,2,13,4,3,13,10,10,3,10,0,False,False,False,0,3,2021-11-11T16:03:06.437,13,False,3.0
2021,9,3185,590,2,6247,13,7,6,24,0,0,0,0,0,0,False,False,False,0,3,2021-11-11T16:53:16.717,0,False,0.0
2021,9,3185,595,2,8389,13,2,8,15,0,0,0,0,0,0,False,False,False,0,3,2021-11-11T16:59:10.847,0,False,0.0
2021,9,3185,605,20,902,2,48,5,-6,-1,5,-3,2,-3,0,False,False,False,0,1,2022-02-21T16:29:01.61,-1,False,2.0
2021,9,3185,610,20,6388,2,4,10,14,14,0,14,0,14,0,False,False,False,0,2,2021-11-09T19:06:34.593,14,False,0.0
2021,9,3185,615,20,7353,2,35,6,19,19,0,19,0,19,0,False,False,False,0,3,2022-03-11T19:45:20.527,19,False,0.0
2021,9,3185,630,2,7303,2,7,10,6,6,0,6,0,6,6,False,False,False,0,2,2022-03-11T19:45:45.503,6,True,0.0
2021,9,3185,645,20,5140,2,4,5,3,9,6,9,0,9,0,False,False,False,0,1,2021-11-08T17:57:58.26,9,True,0.0
2021,9,3185,650,20,7888,2,5,5,6,7,1,7,0,7,0,False,False,False,0,3,2021-11-08T18:16:05.28,7,False,0.0
2021,9,3185,655,20,7888,2,4,10,5,6,1,6,0,6,0,False,False,False,0,3,2021-11-08T18:18:55.253,6,False,0.0
2021,9,3185,660,20,8131,2,2,3,5,5,0,5,0,5,0,False,False,False,0,2,2021-11-08T18:21:31.833,5,False,0.0
2021,9,3185,665,20,5140,13,12,5,3,0,0,0,0,0,0,False,False,False,0,1,2021-11-08T18:23:24.403,0,False,0.0
2021,9,3185,670,20,7888,2,4,4,9,9,0,9,0,9,0,False,False,False,0,3,2021-11-08T19:38:26.203,9,False,0.0
2021,9,3185,675,20,7888,2,17,1,25,25,0,25,0,25,0,False,False,False,0,3,2021-11-08T18:26:31.833,25,False,0.0
2021,9,3185,680,20,8131,2,7,5,5,5,0,5,0,5,6,False,False,False,0,3,2021-11-11T16:03:21.807,5,True,0.0
2021,9,3185,700,2,811,2,48,3,-9,-4,5,-7,3,-7,0,False,False,False,1,1,2022-02-21T16:29:21.37,-4,False,3.0
2021,9,3185,705,2,6247,2,2,5,5,9,4,7,2,7,0,False,False,False,0,3,2022-02-21T16:29:46.073,9,False,2.0
2021,9,3185,715,20,7353,13,19,6,27,0,0,0,0,0,0,False,False,False,0,2,2021-11-08T18:38:58.923,0,False,
2021,9,3185,720,20,5140,3,44,3,-6,0,0,0,0,0,0,False,False,False,0,1,2021-11-08T18:40:52.557,0,False,0.0
2021,9,3185,725,20,7353,13,47,5,1,0,0,0,0,0,0,False,False,False,0,3,2021-11-08T18:43:14.37,0,False,0.0
2021,9,3185,735,20,7353,2,11,3,2,7,5,3,4,3,0,False,False,False,1,1,2021-11-08T18:47:40.903,7,False,4.0
2021,9,3185,750,20,7888,13,2,4,2,0,0,0,0,0,0,False,False,False,0,3,2021-11-11T16:03:38.547,0,False,0.0
2021,9,3185,770,2,2554,13,44,3,-6,0,0,0,0,0,0,False,False,False,0,1,2022-02-21T16:31:09.703,0,False,
2021,9,3185,800,20,2136,2,21,2,19,22,3,19,3,19,0,False,False,False,0,3,2022-01-19T20:26:53.87,22,False,3.0
2021,9,3185,810,20,7353,2,5,5,4,8,4,7,1,7,0,False,False,False,0,3,2021-11-08T19:12:19.21,8,False,1.0
2021,9,3185,825,20,2136,2,7,3,7,8,1,6,2,6,6,False,False,False,0,2,2021-11-08T19:36:09.25,8,False,2.0
2021,9,3185,840,2,811,2,19,2,28,64,36,33,31,33,0,False,False,False,0,2,2021-11-11T16:04:04.507,64,False,31.0
2021,9,3186,10,9,322,13,4,3,4,0,0,0,0,0,0,False,False,False,0,2,2021-11-08T10:59:23.697,0,False,0.0
2021,9,3186,20,9,322,2,2,9,5,5,0,5,0,5,0,True,False,False,0,3,2021-11-08T11:04:10.693,5,False,0.0
2021,9,3186,40,10,7703,13,28,5,4,0,0,0,0,0,0,False,False,False,0,4,2021-11-11T16:57:48.583,0,False,0.0
2021,9,3186,50,9,8243,13,13,9,6,0,0,0,0,0,0,False,False,False,0,4,2021-11-11T15:39:17.08,0,False,0.0
2021,9,3186,60,9,322,13,9,6,24,0,0,0,0,0,0,False,False,False,0,2,2021-11-08T11:24:46.98,0,False,
2021,9,3186,65,9,4202,2,48,5,-4,0,4,-1,1,-1,0,False,False,False,0,1,2021-11-08T11:23:59.527,0,False,1.0
2021,9,3186,75,9,322,2,13,9,5,32,27,26,6,26,0,False,False,False,1,3,2021-11-11T16:58:00.413,32,False,6.0
2021,9,3186,80,9,7816,13,12,2,28,0,0,0,0,0,0,False,False,False,0,3,2021-11-08T11:31:03.303,0,False,0.0
2021,9,3186,95,9,6441,13,13,5,2,0,0,0,0,0,0,True,False,False,0,3,2021-11-08T11:38:04.917,0,False,0.0
2021,9,3186,100,10,7703,2,32,10,-3,-3,0,-3,0,-3,0,True,False,False,0,4,2021-11-09T19:13:28.08,-3,False,0.0
2021,9,3186,120,10,7700,2,35,6,19,25,6,24,1,24,0,False,False,False,0,3,2021-11-08T11:49:28.357,25,False,1.0
2021,9,3186,145,10,7700,2,51,3,-2,5,7,2,3,2,0,False,False,False,0,3,2021-11-08T11:57:10.953,5,False,3.0
2021,9,3186,150,10,6281,13,6,9,9,0,0,0,0,0,0,False,False,False,0,3,2021-11-08T11:58:58.133,0,False,
2021,9,3186,190,9,4446,13,4,2,16,0,0,0,0,0,0,False,False,False,0,2,2021-11-08T12:14:52.723,0,False,0.0
2021,9,3186,205,10,7703,2,30,5,-1,8,9,2,6,2,0,False,False,False,0,4,2021-11-09T19:12:28.207,8,False,6.0
2021,9,3186,225,10,4930,2,35,5,10,11,1,11,0,11,0,False,False,False,0,3,2021-11-08T12:24:36.353,11,True,0.0
2021,9,3186,230,10,4930,2,21,6,42,44,2,44,0,44,6,False,False,False,0,2,2021-11-11T17:14:19.557,44,True,0.0
2021,9,3186,245,9,6446,2,12,4,7,17,10,13,4,13,0,False,False,False,1,4,2021-11-11T17:04:56.427,17,False,4.0
2021,9,3186,255,9,7183,3,6,3,5,0,0,0,0,0,0,False,False,False,0,2,2021-11-08T12:32:49.003,0,False,0.0
2021,9,3186,260,9,7816,13,19,6,48,0,0,0,0,0,0,False,False,False,0,2,2021-11-08T12:34:59.807,0,False,0.0
2021,9,3186,285,10,4930,2,2,9,5,19,14,13,6,13,0,True,False,False,0,3,2021-11-09T19:14:28.083,19,False,6.0
2021,9,3186,290,10,282,2,4,3,6,7,1,6,1,6,0,False,False,False,0,1,2021-11-08T12:52:02.773,7,False,1.0
2021,9,3186,315,10,4702,2,32,10,1,6,5,2,4,2,0,False,False,False,1,4,2021-11-08T16:49:52.293,6,False,4.0
2021,9,3186,340,9,4202,2,45,5,0,21,21,17,4,17,0,False,False,False,0,1,2021-11-08T13:05:05.14,21,False,4.0
2021,9,3186,345,9,6446,13,2,4,5,0,0,0,0,0,0,False,False,False,0,4,2021-11-11T16:55:44.717,0,False,0.0
2021,9,3186,360,9,322,13,12,6,54,0,0,0,0,0,0,False,False,False,0,2,2021-11-08T13:27:22.823,0,False,0.0
2021,9,3186,370,10,6281,2,2,9,5,9,4,9,0,9,0,False,False,False,0,2,2021-11-11T15:39:17.113,9,False,0.0
2021,9,3186,380,10,7703,2,4,3,5,17,12,12,5,12,0,False,False,False,0,4,2021-11-08T13:15:51.03,17,False,5.0
2021,9,3186,390,10,7700,13,6,6,16,0,0,0,0,0,0,False,False,False,0,3,2021-11-08T13:18:39.853,0,False,0.0
2021,9,3186,395,10,7700,2,39,4,3,6,3,3,3,3,0,False,False,False,1,3,2021-11-11T17:05:52.6,6,False,3.0
2021,9,3186,405,10,7700,13,6,10,10,0,0,0,0,0,0,False,False,False,0,3,2021-11-11T17:02:14.897,0,False,
2021,9,3186,435,10,7703,2,30,5,-1,3,4,0,3,0,0,False,False,False,0,4,2021-11-08T13:47:05.923,3,False,3.0
2021,9,3186,450,10,6281,13,6,8,19,0,0,0,0,0,0,False,False,False,0,2,2022-02-16T22:26:14.837,0,False,0.0
2021,9,3186,475,10,4930,2,4,5,4,11,7,4,7,4,0,False,False,False,1,3,2021-11-11T15:39:17.113,11,False,7.0
2021,9,3186,480,10,7700,2,44,3,-4,20,24,20,0,20,0,True,False,False,0,3,2021-11-11T17:45:17.37,20,False,0.0
2021,9,3186,495,10,282,2,47,5,3,8,5,7,1,7,0,False,False,False,0,1,2021-11-08T14:05:59.64,8,False,1.0
2021,9,3186,520,9,322,3,2,10,8,0,0,0,0,0,0,False,False,False,0,3,2021-11-08T14:10:28.937,0,False,0.0
2021,9,3186,525,9,7816,13,12,2,30,0,0,0,0,0,0,False,False,False,0,2,2021-11-11T17:45:34.33,0,False,0.0
2021,9,3186,535,10,7700,2,51,3,-5,-3,2,-3,0,-3,0,True,False,False,0,3,2021-11-11T17:45:55.887,-3,False,0.0
2021,9,3186,550,9,7816,13,5,2,20,0,0,0,0,0,0,True,False,False,0,2,2021-11-11T17:00:21.02,0,False,0.0
2021,9,3186,555,9,6441,2,42,10,4,4,0,4,0,4,0,False,False,False,0,3,2021-11-11T15:39:17.113,4,False,0.0
2021,9,3186,560,9,6441,13,5,6,18,0,0,0,0,0,0,False,False,False,0,3,2021-11-08T14:24:22.787,0,False,0.0
2021,9,3186,575,10,4930,13,35,6,27,0,0,0,0,0,0,False,False,False,0,3,2021-11-08T14:47:52.93,0,False,0.0
2021,9,3186,585,10,7700,2,47,5,1,16,15,16,0,16,0,True,False,False,0,4,2021-11-08T14:51:34.54,16,False,0.0
2021,9,3186,620,10,7700,13,35,6,18,0,0,0,0,0,0,False,False,False,0,3,2021-11-08T15:01:55.64,0,False,0.0
2021,9,3186,625,10,7938,2,6,10,14,40,26,35,5,35,0,False,False,False,0,2,2021-11-11T17:46:25.227,40,False,5.0
2021,9,3186,655,9,4202,13,13,10,3,0,0,0,0,0,0,False,False,False,0,3,2021-11-11T17:00:32.66,0,False,
2021,9,3186,660,9,7816,2,6,7,18,18,0,18,0,18,0,False,False,False,0,2,2021-11-09T20:57:11.613,18,False,0.0
2021,9,3186,665,9,7816,2,6,7,15,28,13,22,6,22,0,False,False,False,0,2,2021-11-09T20:57:24.843,28,False,
2021,9,3186,670,9,7816,2,5,3,5,5,0,5,0,5,0,False,False,False,0,3,2021-11-08T15:26:04.027,5,False,0.0
2021,9,3186,675,9,6441,13,4,10,7,0,0,0,0,0,0,False,False,False,0,3,2021-11-09T20:57:44.78,0,False,0.0
2021,9,3186,680,9,7816,13,6,10,12,0,0,0,0,0,0,False,False,False,0,2,2021-11-11T17:02:29.627,0,False,0.0
2021,9,3186,720,9,7816,13,13,10,1,0,0,0,0,0,0,False,False,False,0,3,2021-11-08T15:48:26.847,0,False,0.0
2021,9,3186,735,9,6712,2,6,9,5,4,-1,4,0,4,0,False,False,False,0,2,2021-11-08T15:52:35.697,4,False,0.0
2021,9,3186,740,9,6441,2,17,8,22,24,2,24,0,24,0,False,False,False,0,3,2021-11-08T15:54:01.517,24,False,0.0
2021,9,3186,745,9,6712,2,5,3,9,9,0,9,0,9,0,False,False,False,0,3,2021-11-11T17:46:47.233,9,True,0.0
2021,9,3186,755,9,7183,2,46,3,-1,32,33,0,32,0,0,False,False,False,2,1,2021-11-11T15:39:17.113,32,False,32.0
2021,9,3186,760,9,6712,2,7,3,5,5,0,5,0,5,6,False,False,False,0,2,2021-11-08T16:00:25.41,5,True,0.0
2021,9,3186,805,9,8243,13,12,3,6,0,0,0,0,0,0,False,False,False,0,3,2021-11-11T17:47:05.98,0,False,0.0
2021,9,3186,815,9,6446,2,39,9,6,10,4,8,2,8,0,False,False,False,0,3,2021-11-11T17:20:46.13,10,False,2.0
2021,9,3186,820,9,7816,13,8,1,40,0,0,0,0,0,0,False,False,False,0,3,2021-11-08T16:13:34.98,0,False,0.0
2021,9,3186,830,9,6446,2,4,9,7,7,0,7,0,7,0,False,False,False,0,3,2021-11-08T16:16:45.31,7,False,0.0
2021,9,3186,835,9,4202,2,44,3,-3,4,7,0,4,0,0,False,False,False,1,1,2021-11-11T17:06:10.713,4,False,4.0
2021,9,3186,840,9,6712,13,12,6,20,0,0,0,0,0,0,False,False,False,0,3,2021-11-11T17:01:46.45,0,False,0.0
2021,9,3186,845,9,6446,2,12,6,19,20,1,20,0,20,0,False,False,False,0,3,2021-11-11T17:01:37.267,20,False,0.0
2021,9,3186,850,9,6712,2,5,3,10,11,1,11,0,11,0,True,False,False,0,3,2021-11-11T17:44:52.163,11,False,0.0
2021,9,3186,860,9,6712,2,13,9,4,4,0,4,0,4,6,True,False,False,0,3,2021-11-09T20:58:51.24,4,True,0.0
2021,9,3187,15,19,4912,2,26,5,5,7,2,7,0,7,0,False,False,False,0,2,2021-11-08T11:02:11.79,7,False,0.0
2021,9,3187,35,19,5096,2,48,4,-3,5,8,1,4,1,0,True,False,False,0,1,2021-11-09T16:52:39.617,5,False,
2021,9,3187,45,19,7175,2,5,9,9,8,-1,8,0,8,0,False,False,False,0,3,2021-11-11T17:57:18.087,8,False,0.0
2021,9,3187,65,5,5220,13,26,10,2,0,0,0,0,0,0,False,False,False,0,2,2021-11-11T23:15:40.127,0,False,0.0
2021,9,3187,95,19,4282,2,6,9,8,12,4,12,0,12,0,False,False,False,0,4,2021-11-11T23:15:57.02,12,False,0.0
2021,9,3187,100,19,7175,13,35,7,16,0,0,0,0,0,0,False,False,False,0,3,2021-11-08T11:44:00.413,0,False,0.0
2021,9,3187,110,19,1212,2,46,3,-2,-1,1,-1,0,-1,0,False,False,False,0,1,2021-11-08T11:46:43.697,-1,False,0.0
2021,9,3187,115,19,5096,2,50,10,-5,4,9,3,1,3,0,True,False,False,0,2,2021-11-09T16:52:54.827,4,False,1.0
2021,9,3187,130,5,5220,2,8,4,13,13,0,13,0,13,0,False,False,False,0,2,2021-11-11T23:26:54.623,13,False,0.0
2021,9,3187,150,5,8408,2,47,5,1,6,5,4,2,4,0,True,False,False,0,3,2021-11-11T23:29:56.457,6,False,2.0
2021,9,3187,195,5,4799,13,24,3,14,0,0,0,0,0,0,True,False,False,0,1,2021-11-11T17:32:09.937,0,False,0.0
2021,9,3187,205,5,3477,2,13,9,2,2,0,2,0,2,0,False,False,False,0,3,2021-11-11T23:16:14.947,2,False,0.0
2021,9,3187,220,19,4912,2,5,5,5,9,4,8,1,8,0,False,False,False,0,3,2021-11-08T14:15:51.747,9,False,1.0
2021,9,3187,235,19,8493,2,28,10,-3,41,44,24,17,24,0,False,False,False,2,1,2022-02-16T22:09:09.367,41,False,17.0
2021,9,3187,280,5,8406,3,50,3,-1,0,0,0,0,0,0,False,False,False,0,2,2022-02-16T22:09:40.797,0,False,0.0
2021,9,3187,295,19,7175,13,2,4,6,0,0,0,0,0,0,False,False,False,0,3,2021-11-09T16:51:56.46,0,False,0.0
2021,9,3187,300,5,566,2,44,3,4,6,2,6,0,6,0,False,False,False,1,1,2021-11-11T23:16:44.683,6,False,0.0
2021,9,3187,320,5,8409,13,12,5,6,0,0,0,0,0,0,False,False,False,0,1,2021-11-11T23:17:00.36,0,False,0.0
2021,9,3187,340,19,8493,2,45,5,-3,3,6,1,2,1,0,False,False,False,0,1,2021-11-08T15:26:15.697,3,False,2.0
2021,9,3187,345,19,1212,2,19,2,23,28,5,24,4,24,0,False,False,False,0,1,2021-11-08T15:29:29.973,28,False,4.0
2021,9,3187,380,19,7172,2,48,5,-5,3,8,1,2,1,0,False,False,False,0,1,2021-11-08T15:39:15.703,3,False,2.0
2021,9,3187,400,19,4282,2,4,10,7,7,0,7,0,7,6,False,False,False,0,4,2021-11-08T15:44:50.363,7,True,0.0
2021,9,3187,415,5,566,2,4,10,3,5,2,5,0,5,0,True,False,False,0,1,2021-11-11T23:35:42.643,5,False,0.0
2021,9,3187,440,5,2688,13,12,9,13,0,0,0,0,0,0,False,False,False,0,3,2021-11-11T23:37:35.547,0,False,0.0
2021,9,3187,455,19,4912,13,12,5,6,0,0,0,0,0,0,False,False,False,0,3,2022-02-23T20:34:56.873,0,False,0.0
2021,9,3187,485,5,8409,2,4,4,3,33,30,18,15,18,0,False,False,False,1,1,2021-11-11T23:19:34.283,33,False,15.0
2021,9,3187,495,5,5220,2,6,4,10,13,3,11,2,11,0,False,False,False,0,3,2021-11-11T23:17:18.853,13,False,2.0
2021,9,3187,505,5,6425,13,32,3,8,0,0,0,0,0,0,False,False,False,0,4,2021-11-11T23:17:26.55,0,False,0.0
2021,9,3187,535,5,8408,13,35,4,10,0,0,0,0,0,0,False,False,False,0,4,2022-02-25T20:27:08.993,0,False,0.0
2021,9,3187,540,5,4799,2,48,10,-3,-3,0,-3,0,-3,0,False,False,False,0,1,2021-11-11T18:01:04.917,-3,False,0.0
2021,9,3187,545,5,3477,13,35,10,-3,0,0,0,0,0,0,False,False,False,0,3,2021-11-08T17:05:37.07,0,False,0.0
2021,9,3187,550,19,2256,13,11,6,17,0,0,0,0,0,0,False,False,False,0,3,2021-11-11T23:40:32.317,0,False,
2021,9,3187,565,19,5096,13,4,9,4,0,0,0,0,0,0,False,False,False,0,3,2022-02-16T22:13:25.9,0,False,0.0
2021,9,3187,570,19,4282,13,36,3,12,0,0,0,0,0,0,False,False,False,0,4,2022-02-25T15:31:52.24,0,False,0.0
2021,9,3187,575,19,7175,13,24,6,18,0,0,0,0,0,0,False,False,False,0,3,2022-02-23T20:40:20.033,0,False,0.0
2021,9,3187,595,5,5220,2,13,9,5,6,1,6,0,6,0,False,False,False,0,3,2021-11-11T23:17:53.363,6,False,0.0
2021,9,3187,600,5,4799,2,4,9,6,21,15,19,2,19,0,True,False,False,0,1,2021-11-09T18:25:33.187,21,False,2.0
2021,9,3187,605,5,4799,2,5,3,2,19,17,8,11,8,0,False,False,False,1,1,2021-11-11T17:32:41.423,19,False,11.0
2021,9,3187,625,5,4799,2,16,4,5,17,12,13,4,13,0,True,False,False,0,1,2021-11-09T18:25:50.027,17,False,4.0
2021,9,3187,635,5,5220,13,7,3,14,0,0,0,0,0,0,False,False,False,0,3,2021-11-08T18:14:34.747,0,False,0.0
2021,9,3187,645,19,4912,2,5,5,8,18,10,13,5,13,0,False,False,False,0,3,2021-11-11T23:47:22.027,18,False,5.0
2021,9,3187,715,5,4799,2,28,9,2,2,0,2,0,2,0,False,False,False,0,1,2021-11-11T23:13:36.15,2,False,
2021,9,3187,720,5,2688,2,32,5,1,6,5,4,2,4,0,False,False,False,0,4,2021-11-11T17:32:52.08,6,False,2.0
2021,9,3187,725,5,6425,2,32,3,2,9,7,7,2,7,0,False,False,False,0,4,2021-11-11T23:18:12.587,9,False,2.0
2021,9,3187,730,5,566,2,5,5,4,7,3,7,0,7,0,False,False,False,0,1,2021-11-11T23:43:46.02,7,False,0.0
2021,9,3187,735,5,5220,13,35,8,27,0,0,0,0,0,0,False,False,False,0,3,2022-02-16T22:14:44.66,0,False,0.0
2021,9,3187,740,5,566,2,5,5,4,12,8,12,0,12,0,False,False,False,0,1,2021-11-08T18:56:36.847,12,False,0.0
2021,9,3187,745,5,3477,13,3,3,12,0,0,0,0,0,0,False,False,False,0,2,2022-02-16T22:15:42.733,0,False,0.0
2021,9,3187,760,5,566,13,32,5,-2,0,0,0,0,0,0,False,False,False,0,1,2021-11-11T23:44:20.827,0,False,0.0
2021,9,3187,765,5,5220,13,12,6,22,0,0,0,0,0,0,False,False,False,0,2,2021-11-11T23:20:03.047,0,False,0.0
2021,9,3188,15,3,8430,2,2,10,11,13,2,12,1,12,0,False,False,False,0,3,2021-11-11T17:58:45.573,13,False,1.0
2021,9,3188,20,3,6454,13,6,4,10,0,0,0,0,0,0,False,False,False,0,3,2021-11-11T17:58:45.573,0,False,0.0
2021,9,3188,30,3,6936,13,51,3,-2,0,0,0,0,0,0,False,False,False,0,3,2021-11-11T20:34:49.23,0,False,0.0
2021,9,3188,50,3,6454,3,7,2,23,0,0,0,0,0,0,False,False,False,0,4,2021-11-09T15:56:57.407,0,False,0.0
2021,9,3188,60,3,6454,13,35,3,11,0,0,0,0,0,0,False,False,False,0,3,2021-11-11T20:36:53.35,0,False,0.0
2021,9,3188,85,18,4572,2,5,3,2,6,4,3,3,3,0,False,False,False,0,1,2021-11-08T11:18:28.6,6,False,3.0
2021,9,3188,95,18,7711,2,19,1,43,50,7,50,0,50,6,False,False,False,0,3,2021-11-11T20:37:43.857,50,True,0.0
2021,9,3188,110,3,6454,2,5,3,10,13,3,11,2,11,0,False,False,False,0,3,2021-11-11T20:39:32.237,13,False,2.0
2021,9,3188,125,3,8430,2,12,8,15,15,0,15,0,15,0,False,False,False,0,2,2021-11-08T11:37:43.477,15,False,0.0
2021,9,3188,140,3,6936,13,4,4,10,0,0,0,0,0,0,False,False,False,0,3,2021-11-08T11:45:25.44,0,False,0.0
2021,9,3188,160,18,2223,2,4,9,5,5,0,5,0,5,0,False,False,False,0,4,2021-11-08T11:55:06.28,5,False,0.0
2021,9,3188,170,18,6900,2,16,9,3,3,0,3,0,3,0,False,False,False,0,1,2021-11-08T11:58:27.943,3,False,0.0
2021,9,3188,180,18,7711,2,13,4,2,7,5,4,3,4,0,False,False,False,0,3,2021-11-08T12:02:22.78,7,False,3.0
2021,9,3188,205,18,6361,13,33,4,2,0,0,0,0,0,0,False,False,False,0,4,2021-11-08T12:22:27.627,0,False,
2021,9,3188,235,3,8430,2,4,4,7,7,0,7,0,7,0,False,False,False,0,2,2021-11-08T12:43:39.293,7,False,0.0
2021,9,3188,250,3,713,2,53,3,-7,-1,6,-7,6,-7,0,True,False,False,1,4,2021-11-11T18:55:13.007,-1,False,6.0
2021,9,3188,255,3,6936,2,50,3,-1,9,10,8,1,8,0,False,False,False,0,2,2021-11-08T12:52:46.36,9,False,1.0
2021,9,3188,265,18,6361,2,53,3,-5,7,12,3,4,3,0,True,False,False,0,4,2021-11-09T14:47:25.22,7,False,4.0
2021,9,3188,295,3,713,13,47,5,5,0,0,0,0,0,0,False,False,False,0,1,2021-11-11T20:41:10.083,0,False,0.0
2021,9,3188,305,3,6454,13,12,9,5,0,0,0,0,0,0,False,False,False,0,3,2021-11-11T18:52:25.157,0,False,0.0
2021,9,3188,315,18,1381,13,4,3,7,0,0,0,0,0,0,False,False,False,0,2,2021-11-08T13:36:32.983,0,False,0.0
2021,9,3188,325,18,7712,2,4,10,12,20,8,19,1,19,0,False,False,False,0,2,2021-11-08T13:40:22.407,20,False,1.0
2021,9,3188,335,18,4572,2,46,3,1,4,3,2,2,2,0,False,False,False,0,1,2021-11-11T19:31:01.923,4,False,2.0
2021,9,3188,340,18,4940,13,6,3,4,0,0,0,0,0,0,False,False,False,0,2,2021-11-11T20:42:03.783,0,False,0.0
2021,9,3188,355,3,6454,13,17,1,23,0,0,0,0,0,0,False,False,False,0,3,2021-11-11T19:37:35.79,0,False,0.0
2021,9,3188,370,18,1381,13,5,5,8,0,0,0,0,0,0,False,False,False,0,3,2022-02-16T21:57:09.773,0,False,0.0
2021,9,3188,380,18,7711,13,3,3,9,0,0,0,0,0,0,False,False,False,0,2,2021-11-11T17:58:45.573,0,False,0.0
2021,9,3188,395,3,6936,2,4,5,4,4,0,4,0,4,0,False,False,False,0,2,2021-11-08T14:20:24.09,4,False,0.0
2021,9,3188,415,3,6936,13,19,2,40,0,0,0,0,0,0,False,False,False,0,4,2021-11-08T14:25:39.927,0,False,0.0
2021,9,3188,430,3,8430,13,12,2,45,0,0,0,0,0,0,False,False,False,0,2,2021-11-11T19:38:43.923,0,False,
2021,9,3188,440,3,713,2,47,5,2,5,3,5,0,5,6,False,False,False,0,3,2021-11-11T20:43:07.217,5,True,0.0
2021,9,3188,480,3,8430,13,12,7,17,0,0,0,0,0,0,False,False,False,0,2,2021-11-10T01:20:04.163,0,False,0.0
2021,9,3188,495,3,5017,2,32,5,4,12,8,9,3,9,0,False,False,False,0,4,2021-11-11T20:51:05.06,12,False,3.0
2021,9,3188,505,3,5017,2,32,5,4,22,18,10,12,10,0,False,False,False,0,4,2022-02-16T21:57:31.103,22,False,12.0
2021,9,3188,515,3,7672,2,34,4,-4,3,7,-1,4,-1,0,True,False,False,1,3,2021-11-08T15:00:07.54,3,False,4.0
2021,9,3188,525,3,6936,2,4,10,3,3,0,3,0,3,0,False,False,False,0,3,2021-11-11T19:32:01.297,3,False,0.0
2021,9,3188,530,3,5017,2,30,5,0,1,1,1,0,1,6,True,False,False,0,4,2021-11-11T17:58:45.573,1,True,0.0
2021,9,3188,545,18,6361,13,32,5,2,0,0,0,0,0,0,False,False,False,0,4,2021-12-10T19:16:37.33,0,False,0.0
2021,9,3188,550,18,1381,2,30,5,3,3,0,3,0,3,0,True,False,False,0,3,2021-11-08T15:13:03.683,3,False,
2021,9,3188,555,18,6361,2,2,4,6,18,12,13,5,13,0,False,False,False,0,4,2021-11-11T17:58:45.573,18,False,5.0
2021,9,3188,560,18,1381,13,12,5,9,0,0,0,0,0,0,False,False,False,0,2,2022-02-16T21:59:51.207,0,False,0.0
2021,9,3188,580,18,1381,2,13,4,3,5,2,4,1,4,0,False,False,False,0,2,2021-11-09T14:47:11.833,5,False,1.0
2021,9,3188,590,18,6361,2,6,4,5,9,4,9,0,9,0,False,False,False,0,4,2021-11-08T15:31:56.93,9,False,0.0
2021,9,3188,595,18,7712,13,13,5,3,0,0,0,0,0,0,False,False,False,0,3,2021-11-11T19:17:58.303,0,False,0.0
2021,9,3188,630,3,6454,2,3,3,8,8,0,8,0,8,0,False,False,False,0,2,2022-02-16T22:00:36.02,8,False,0.0
2021,9,3188,650,3,8430,13,19,2,31,0,0,0,0,0,0,False,False,False,0,2,2022-02-16T22:01:03.693,0,False,0.0
2021,9,3188,655,3,6454,2,2,10,7,8,1,6,2,6,0,False,False,False,0,2,2022-02-16T22:01:43.19,8,False,2.0
2021,9,3188,670,3,5017,13,38,4,0,0,0,0,0,0,0,False,False,False,0,4,2021-11-11T17:58:45.573,0,False,0.0
2021,9,3188,675,3,6936,2,51,3,-3,18,21,16,2,16,0,False,False,False,0,3,2021-11-08T16:18:19.517,18,False,2.0
2021,9,3188,685,3,8430,2,13,4,4,11,7,11,0,11,0,False,False,False,0,3,2021-11-11T20:47:38.977,11,False,0.0
2021,9,3188,695,3,7672,2,35,4,5,5,0,5,0,5,6,False,False,False,0,3,2021-11-11T20:48:01.117,5,True,0.0
2021,9,3188,715,18,7711,13,4,9,14,0,0,0,0,0,0,False,False,False,0,2,2021-11-08T16:30:18.517,0,False,0.0
2021,9,3188,720,18,6361,2,32,3,3,5,2,5,0,5,0,False,False,False,0,4,2021-11-08T16:31:52.603,5,False,0.0
2021,9,3188,730,3,6936,2,47,5,-1,22,23,7,15,7,0,True,False,False,1,3,2021-11-11T20:49:03.787,22,False,15.0
2021,9,3188,775,18,6361,2,5,9,5,6,1,6,0,6,0,False,False,False,0,4,2021-11-08T16:45:40.373,6,False,0.0
2021,9,3188,785,18,4152,2,19,6,27,27,0,27,0,27,0,False,False,False,0,2,2021-11-08T18:25:05.277,27,False,0.0
2021,9,3188,800,18,1381,13,8,1,17,0,0,0,0,0,0,False,False,False,0,2,2021-11-08T16:58:18.973,0,False,0.0
2021,9,3188,810,18,6361,13,6,4,9,0,0,0,0,0,0,False,False,False,0,3,2021-11-08T17:00:36.89,0,False,0.0
2021,9,3188,820,18,7711,2,5,5,11,12,1,12,0,12,0,False,False,False,0,3,2021-11-08T17:03:04.26,12,False,0.0
2021,9,3188,835,18,1381,2,9,5,1,1,0,1,0,1,6,False,False,False,0,2,2021-11-08T17:05:49.117,1,True,0.0
2021,9,3188,855,3,8430,2,13,4,3,6,3,6,0,6,0,False,False,False,0,3,2021-11-08T17:10:10.69,6,False,0.0
2021,9,3188,860,3,6454,2,13,4,4,8,4,6,2,6,0,False,False,False,0,3,2021-11-08T17:11:28.86,8,False,2.0
2021,9,3188,870,3,8430,13,9,6,20,0,0,0,0,0,0,False,False,False,0,2,2021-11-11T17:58:45.573,0,False,0.0
2021,9,3188,875,3,6454,2,13,4,4,7,3,6,1,6,0,False,False,False,0,3,2021-11-11T17:58:45.573,7,False,1.0
2021,9,3188,885,3,6936,2,51,5,-4,0,4,0,0,0,0,False,False,False,0,3,2021-11-11T19:34:46.32,0,False,
2021,9,3188,905,3,6936,2,47,5,-1,7,8,6,1,6,0,True,False,False,0,3,2021-11-11T17:58:45.573,7,False,1.0
2021,9,3188,920,3,6936,2,4,10,10,20,10,20,0,20,0,False,False,False,0,3,2021-11-08T17:35:40.78,20,False,0.0
2021,9,3188,930,3,5017,13,46,3,-5,0,0,0,0,0,0,False,False,False,0,1,2021-11-11T19:49:41.817,0,False,0.0
2021,9,3188,940,18,4572,2,44,3,-4,2,6,2,0,2,0,False,False,False,0,1,2021-11-08T17:43:15.26,2,False,0.0
2021,9,3188,950,18,1381,13,8,6,17,0,0,0,0,0,0,False,False,False,0,3,2021-11-11T17:58:45.573,0,False,0.0
2021,9,3188,960,3,6936,2,22,2,18,20,2,19,1,19,0,False,False,False,0,3,2021-11-11T17:58:45.573,20,False,1.0
2021,9,3188,970,3,4368,2,32,5,1,7,6,6,1,6,0,False,False,False,0,4,2021-11-08T17:59:54.473,7,False,1.0
2021,9,3188,995,3,6936,2,51,3,-1,6,7,4,2,4,0,False,False,False,0,3,2021-11-08T18:09:45.26,6,False,
2021,9,3188,1000,3,6936,2,4,5,10,13,3,13,0,13,0,False,False,False,1,2,2021-11-08T18:15:01.99,13,True,0.0
2021,9,3189,20,7,7659,2,4,9,11,11,0,11,0,11,0,False,False,False,0,3,2021-11-08T09:59:50.31,11,False,0.0
2021,9,3189,25,7,4679,2,51,10,-2,11,13,7,4,7,0,True,False,False,0,3,2021-11-11T19:03:54.723,11,False,4.0
2021,9,3189,30,7,4679,2,48,9,-3,9,12,7,2,7,0,False,False,False,0,1,2022-02-16T22:17:43.267,9,False,2.0
2021,9,3189,40,7,7659,2,11,6,18,20,2,20,0,20,0,True,False,False,0,3,2021-11-08T10:11:46.88,20,True,0.0
2021,9,3189,45,7,8317,2,2,10,9,15,6,13,2,13,0,False,False,False,0,2,2021-11-08T10:14:30.497,15,False,2.0
2021,9,3189,55,7,2631,13,38,10,4,0,0,0,0,0,0,False,False,False,0,4,2021-11-08T10:22:35.193,0,False,0.0
2021,9,3189,65,7,8317,13,26,10,2,0,0,0,0,0,0,False,False,False,0,2,2021-11-11T19:58:24.913,0,False,0.0
2021,9,3189,85,7,8317,13,12,8,50,0,0,0,0,0,0,False,False,False,0,2,2022-02-24T16:00:57.977,0,False,0.0
2021,9,3189,90,7,6975,2,32,10,1,19,18,13,6,13,0,False,False,False,1,4,2021-11-11T19:59:08.997,19,False,6.0
2021,9,3189,100,7,3445,2,3,2,16,16,0,16,0,16,0,False,False,False,0,2,2021-11-09T20:30:07.43,16,True,0.0
2021,9,3189,110,7,8317,13,9,2,20,0,0,0,0,0,0,False,False,False,0,2,2022-02-23T20:45:09.687,0,False,0.0
2021,9,3189,115,7,4455,2,4,4,5,9,4,9,0,9,0,False,False,False,0,3,2022-02-23T20:45:59.53,9,False,0.0
2021,9,3189,120,7,7659,2,5,5,9,9,0,9,0,9,0,False,False,False,0,3,2021-11-11T20:11:26.143,9,False,0.0
2021,9,3189,150,8,6439,2,48,4,-3,3,6,-2,5,-2,0,False,False,False,1,1,2021-11-11T20:14:27.977,3,False,5.0
2021,9,3189,155,8,6439,2,19,2,23,23,0,23,0,23,0,True,False,False,0,2,2021-11-11T19:03:54.723,23,True,0.0
2021,9,3189,160,8,3883,2,5,5,3,3,0,3,0,3,0,False,False,False,0,4,2021-11-08T10:56:16.897,3,False,0.0
2021,9,3189,180,8,3883,2,2,10,6,11,5,9,2,9,0,False,False,False,0,3,2021-11-08T11:01:22.557,11,False,2.0
2021,9,3189,190,8,3883,13,7,5,7,0,0,0,0,0,0,False,False,False,0,3,2021-11-08T11:04:23.09,0,False,
2021,9,3189,195,8,4976,13,29,5,1,0,0,0,0,0,0,False,False,False,0,2,2022-02-16T22:18:42.81,0,False,0.0
2021,9,3189,215,7,2631,2,4,10,5,5,0,5,0,5,0,False,False,False,0,4,2021-11-08T11:23:45.6,5,False,0.0
2021,9,3189,220,7,7659,2,2,10,9,11,2,9,2,9,0,False,False,False,0,2,2021-11-11T19:53:37.717,11,False,2.0
2021,9,3189,245,7,7659,2,3,6,17,16,-1,16,0,16,0,False,False,False,0,2,2021-11-08T11:32:00.01,16,False,0.0
2021,9,3189,250,7,4455,3,46,3,2,0,0,0,0,0,0,False,False,False,0,3,2022-02-16T22:19:20.853,0,False,0.0
2021,9,3189,255,7,3521,13,12,2,27,0,0,0,0,0,0,False,False,False,0,3,2022-02-24T16:01:14.833,0,False,0.0
2021,9,3189,260,8,7651,2,19,8,43,60,17,60,0,60,6,False,False,False,0,3,2021-11-08T11:38:08.37,60,True,0.0
2021,9,3189,275,7,8317,2,5,5,4,6,2,4,2,4,0,True,False,False,0,2,2021-11-08T11:40:21.39,6,False,2.0
2021,9,3189,285,7,4679,2,44,3,-5,12,17,1,11,1,0,True,False,False,1,1,2021-11-11T19:03:54.723,12,False,11.0
2021,9,3189,295,7,8317,2,5,9,5,5,0,5,0,5,0,False,True,True,0,3,2021-11-08T11:46:36.493,5,False,0.0
2021,9,3189,305,8,8349,2,6,4,12,15,3,14,1,14,0,False,False,False,0,3,2021-11-08T14:46:44.44,15,False,1.0
2021,9,3189,310,8,232,2,50,9,-2,6,8,3,3,3,0,False,False,False,0,3,2021-11-08T11:52:32.26,6,False,3.0
2021,9,3189,340,7,7659,13,2,4,5,0,0,0,0,0,0,False,False,False,0,3,2021-11-08T12:07:58.753,0,False,
2021,9,3189,350,7,8317,2,50,9,-3,5,8,3,2,3,0,False,False,False,0,2,2021-11-08T12:13:13.47,5,False,2.0
2021,9,3189,360,7,2631,2,4,9,5,12,7,12,0,12,0,False,False,False,0,3,2021-11-08T12:14:54.92,12,False,0.0
2021,9,3189,380,7,7659,13,8,7,17,0,0,0,0,0,0,False,False,False,0,2,2021-11-08T12:20:45.6,0,False,0.0
2021,9,3189,390,7,4455,2,32,3,-5,8,13,0,8,0,0,False,False,False,1,1,2021-11-11T20:01:13.007,8,False,8.0
2021,9,3189,420,8,7651,13,3,6,18,0,0,0,0,0,0,False,False,False,0,2,2021-11-08T12:34:25.55,0,False,0.0
2021,9,3189,425,8,7652,2,5,5,4,5,1,5,0,5,0,False,False,False,0,3,2021-11-11T19:03:54.723,5,False,0.0
2021,9,3189,430,8,8354,2,26,5,5,22,17,13,9,13,0,True,False,False,1,3,2021-11-08T12:37:14.967,22,False,9.0
2021,9,3189,440,8,232,2,5,10,7,7,0,7,0,7,0,False,False,False,0,3,2021-11-08T12:40:01.62,7,False,0.0
2021,9,3189,460,7,4679,2,46,9,0,11,11,10,1,10,0,False,False,False,0,1,2021-11-08T12:44:46.35,11,False,1.0
2021,9,3189,475,7,8317,2,52,4,1,9,8,6,3,6,0,False,False,False,0,3,2021-11-11T19:56:30.783,9,False,3.0
2021,9,3189,510,7,2631,2,30,10,1,3,2,1,2,1,0,True,False,False,0,4,2021-11-08T12:55:19.263,3,False,2.0
2021,9,3189,515,7,4679,2,4,10,0,3,3,2,1,2,0,False,False,False,0,1,2021-11-08T12:57:25.82,3,False,1.0
2021,9,3189,520,7,8317,13,2,10,9,0,0,0,0,0,0,False,False,False,0,2,2021-11-11T19:58:01.68,0,False,0.0
2021,9,3189,525,8,232,13,8,10,8,0,0,0,0,0,0,False,False,False,0,3,2021-11-08T13:00:24.667,0,False,0.0
2021,9,3189,540,8,4976,13,12,5,6,0,0,0,0,0,0,False,False,False,0,4,2021-11-11T19:56:42.24,0,False,0.0
2021,9,3189,560,7,2631,2,4,5,4,4,0,4,0,4,0,False,False,False,0,4,2021-11-08T13:09:15.177,4,False,0.0
2021,9,3189,580,8,232,2,45,5,-6,-2,4,-3,1,-3,0,False,False,False,0,1,2021-11-11T19:03:54.723,-2,False,1.0
2021,9,3189,595,7,8325,2,16,9,4,11,7,10,1,10,0,False,False,False,0,1,2021-11-08T13:18:30.47,11,False,1.0
2021,9,3189,600,7,6975,2,31,4,1,11,10,9,2,9,0,False,False,False,0,4,2021-11-08T13:21:27.197,11,False,2.0
2021,9,3189,605,7,8317,13,9,2,23,0,0,0,0,0,0,False,False,False,0,2,2021-11-08T13:23:09.987,0,False,0.0
2021,9,3189,610,7,7659,2,2,10,5,11,6,5,6,5,0,False,False,False,0,3,2021-11-08T13:24:36.083,11,False,6.0
2021,9,3189,625,7,8317,2,5,3,6,9,3,8,1,8,0,False,False,False,0,2,2022-02-16T22:20:26.223,9,False,1.0
2021,9,3189,645,8,7652,2,29,2,18,21,3,21,0,21,0,True,False,False,0,3,2021-11-08T13:36:33.103,21,True,0.0
2021,9,3189,660,8,232,13,6,8,40,0,0,0,0,0,0,False,False,False,0,3,2021-11-08T13:49:19.85,0,False,0.0
2021,9,3189,690,7,8317,3,19,2,42,0,0,0,0,0,0,False,False,False,0,2,2021-11-08T14:44:04.28,0,False,0.0
2021,9,3189,700,7,8317,2,12,6,26,32,6,32,0,32,0,False,False,False,0,2,2021-11-08T13:59:32.17,32,False,
2021,9,3189,705,7,3521,2,52,9,3,11,8,9,2,9,0,False,False,False,0,3,2021-11-11T19:03:54.723,11,False,2.0
2021,9,3189,710,7,7659,13,19,6,44,0,0,0,0,0,0,False,False,False,0,2,2021-11-11T19:03:54.723,0,False,0.0
2021,9,3189,735,8,7651,2,9,6,23,26,3,26,0,26,0,False,False,False,0,2,2021-11-11T19:57:06.867,26,False,0.0
2021,9,3189,755,8,4976,2,19,7,18,18,0,18,0,18,6,False,False,False,0,3,2021-11-11T19:57:28.663,18,True,0.0
2021,9,3189,775,7,6975,2,47,5,2,6,4,6,0,6,0,False,False,False,0,4,2021-11-09T00:08:44.457,6,False,0.0
2021,9,3189,780,7,8317,3,4,3,2,0,0,0,0,0,0,False,False,False,0,2,2021-11-09T00:08:58.887,0,False,0.0
2021,9,3190,10,15,5152,2,47,10,1,11,10,5,6,5,0,False,False,False,0,4,2021-11-08T18:17:28.463,11,False,6.0
2021,9,3190,25,15,7591,2,50,3,-1,4,5,1,3,1,0,False,False,False,0,2,2021-11-11T19:27:05.543,4,False,3.0
2021,9,3190,30,15,8343,3,36,9,14,0,0,0,0,0,0,True,False,False,0,3,2021-11-11T21:03:48.837,0,False,0.0
2021,9,3190,35,15,153,2,28,9,5,6,1,4,2,4,0,False,False,False,1,1,2021-11-11T21:03:38.577,6,False,2.0
2021,9,3190,45,15,4487,2,26,3,2,23,21,21,2,21,0,True,False,False,0,2,2021-11-11T21:04:00.797,23,False,2.0
2021,9,3190,60,15,4487,3,13,3,3,0,0,0,0,0,0,True,False,False,0,3,2021-11-11T21:04:23.827,0,False,0.0
2021,9,3190,80,4,6983,2,4,4,2,7,5,5,2,5,0,False,False,False,0,1,2021-11-11T18:56:04.853,7,False,2.0
2021,9,3190,90,4,213,13,8,1,16,0,0,0,0,0,0,False,False,False,0,3,2021-11-11T21:23:06.493,0,False,0.0
2021,9,3190,95,4,2853,13,3,5,7,0,0,0,0,0,0,False,False,False,0,2,2021-11-11T19:27:05.543,0,False,0.0
2021,9,3190,105,4,594,2,49,3,-2,1,3,1,0,1,0,False,False,False,0,2,2022-02-22T20:03:09.873,1,False,0.0
2021,9,3190,110,4,213,2,29,3,14,16,2,15,1,15,0,False,False,False,0,2,2021-11-08T11:21:04.22,16,False,1.0
2021,9,3190,120,4,594,2,51,10,-1,0,1,0,0,0,0,True,False,False,0,2,2021-11-08T11:26:55.54,0,False,0.0
2021,9,3190,125,4,7645,13,12,5,5,0,0,0,0,0,0,True,False,False,0,1,2021-11-08T11:29:36.293,0,False,0.0
2021,9,3190,140,15,5152,13,39,4,6,0,0,0,0,0,0,False,False,False,0,4,2022-02-21T15:07:14.27,0,False,0.0
2021,9,3190,160,4,594,2,4,10,4,4,0,4,0,4,0,False,False,False,0,3,2021-11-08T11:40:01.95,4,False,0.0
2021,9,3190,165,4,6983,2,4,4,2,9,7,7,2,7,0,False,False,False,0,1,2021-11-11T21:24:46.19,9,False,2.0
2021,9,3190,175,4,594,2,4,9,4,9,5,8,1,8,0,False,False,False,0,3,2021-11-08T11:58:12.407,9,False,1.0
2021,9,3190,185,4,2853,2,4,3,14,14,0,14,0,14,0,False,False,False,0,2,2021-11-08T12:06:05.527,14,False,0.0
2021,9,3190,190,4,594,2,49,3,-3,1,4,-1,2,-1,0,False,False,False,0,2,2021-11-11T21:03:01.537,1,False,2.0
2021,9,3190,195,4,6983,2,4,4,2,7,5,5,2,5,0,False,False,False,0,1,2022-02-21T15:09:08.437,7,False,2.0
2021,9,3190,200,4,594,2,5,5,2,2,0,2,0,2,0,False,False,False,0,3,2021-11-08T12:15:06.78,2,True,0.0
2021,9,3190,205,4,594,13,6,4,6,0,0,0,0,0,0,False,False,False,0,3,2021-11-08T12:20:28.597,0,False,
2021,9,3190,210,4,213,13,12,3,2,0,0,0,0,0,0,False,False,False,0,2,2021-11-08T12:24:51.307,0,False,0.0
2021,9,3190,245,15,914,2,4,9,7,12,5,8,4,8,0,False,False,False,1,3,2021-11-08T12:38:02.103,12,False,4.0
2021,9,3190,250,15,4487,2,51,10,-2,-1,1,-1,0,-1,0,False,False,False,0,3,2021-11-08T12:43:21.06,-1,False,0.0
2021,9,3190,255,15,7591,2,2,10,3,6,3,4,2,4,0,False,False,False,0,2,2021-11-08T12:47:19.753,6,False,2.0
2021,9,3190,270,15,7591,2,50,5,-2,7,9,6,1,6,0,True,False,False,0,2,2021-11-11T21:25:55.58,5,False,1.0
2021,9,3190,275,15,4487,2,5,3,3,5,2,5,0,5,0,False,False,False,0,3,2021-11-08T13:01:03.187,5,False,0.0
2021,9,3190,280,15,914,2,4,10,4,5,1,4,1,4,0,False,False,False,0,3,2021-11-08T13:07:12.217,5,False,1.0
2021,9,3190,285,15,7591,13,6,1,15,0,0,0,0,0,0,True,False,False,0,4,2021-11-11T19:27:05.543,0,False,0.0
2021,9,3190,305,4,594,2,4,5,7,9,2,9,0,9,0,False,False,False,0,3,2021-11-11T19:27:05.543,9,False,0.0
2021,9,3190,315,4,594,3,4,8,17,0,0,0,0,0,0,False,False,False,0,2,2021-11-08T13:31:30.34,0,False,0.0
2021,9,3190,320,4,213,13,12,2,19,0,0,0,0,0,0,False,False,False,0,2,2021-11-08T13:37:16.217,0,False,0.0
2021,9,3190,330,15,914,2,5,5,4,4,0,4,0,4,0,False,False,False,0,2,2021-11-11T22:10:27.36,4,True,0.0
2021,9,3190,350,15,5152,2,53,9,-2,5,7,3,2,3,0,False,False,False,0,4,2021-11-08T18:01:18.513,5,False,2.0
2021,9,3190,360,15,5152,2,24,6,28,28,0,28,0,28,0,False,False,False,0,3,2021-11-08T18:16:28.207,28,False,0.0
2021,9,3190,375,15,4487,3,35,7,35,0,0,0,0,0,0,False,False,False,0,3,2021-11-08T14:08:56.883,0,False,
2021,9,3190,390,4,2853,2,50,3,-1,11,12,9,2,9,0,False,False,False,0,2,2021-11-11T19:27:05.543,11,False,2.0
2021,9,3190,395,4,7645,13,28,4,-2,0,0,0,0,0,0,False,False,False,0,1,2021-11-11T19:27:05.543,0,False,0.0
2021,9,3190,450,4,7645,2,17,10,9,13,4,11,2,11,0,False,False,False,0,1,2021-11-11T21:28:46.49,13,False,2.0
2021,9,3190,460,4,594,2,4,4,7,7,0,7,0,7,0,False,False,False,0,3,2021-11-11T19:27:05.543,7,False,0.0
2021,9,3190,465,4,5119,2,39,4,5,9,4,5,4,5,0,False,False,False,0,3,2021-11-11T19:27:05.543,9,False,4.0
2021,9,3190,470,4,7645,2,48,9,-4,5,9,2,3,2,0,False,False,False,2,1,2021-11-11T21:10:28.39,5,False,3.0
2021,9,3190,480,4,594,13,4,10,6,0,0,0,0,0,0,False,False,False,0,3,2021-11-11T21:29:53.897,0,False,0.0
2021,9,3190,495,15,914,13,9,2,27,0,0,0,0,0,0,True,False,False,0,3,2021-11-10T00:50:37.473,0,False,
2021,9,3190,500,15,3750,2,32,5,2,9,7,8,1,8,0,False,False,False,0,4,2021-11-08T15:29:43.747,9,False,1.0
2021,9,3190,520,15,4886,2,31,9,4,4,0,3,1,3,0,False,False,False,0,4,2021-11-09T15:58:57.093,4,False,1.0
2021,9,3190,525,15,5152,13,6,3,4,0,0,0,0,0,0,False,False,False,0,3,2021-11-11T21:05:46.75,0,False,0.0
2021,9,3190,560,4,213,2,4,7,22,22,0,22,0,22,0,False,False,False,0,2,2021-11-08T16:06:27.667,22,False,0.0
2021,9,3190,570,4,594,13,6,7,18,0,0,0,0,0,0,False,False,False,0,3,2021-11-08T16:12:04.483,0,False,0.0
2021,9,3190,575,4,213,2,12,9,5,8,3,7,1,7,0,False,False,False,0,3,2022-02-24T16:02:35.657,8,False,1.0
2021,9,3190,580,4,6983,13,32,10,1,0,0,0,0,0,0,False,False,False,0,1,2021-11-09T15:58:18.007,0,False,0.0
2021,9,3190,590,15,5152,2,4,9,9,16,7,14,2,14,0,False,False,False,0,3,2021-11-08T17:59:39.763,16,False,2.0
2021,9,3190,600,15,153,3,12,2,21,0,0,0,0,0,0,False,False,False,0,2,2021-11-08T16:28:26.71,0,False,0.0
2021,9,3190,615,15,7591,2,5,10,6,9,3,7,2,7,0,False,False,False,0,3,2021-11-08T16:33:13.67,9,False,2.0
2021,9,3190,630,15,914,13,5,5,3,0,0,0,0,0,0,False,False,False,0,2,2021-11-08T16:39:51.72,0,False,0.0
2021,9,3190,635,15,5152,13,9,3,3,0,0,0,0,0,0,False,False,False,0,2,2021-11-11T21:05:59.403,0,False,0.0
2021,9,3190,650,4,2853,2,51,5,-2,12,14,-2,14,-2,0,False,False,False,1,3,2021-11-11T21:11:26.293,12,False,14.0
2021,9,3190,655,4,2853,2,2,3,5,15,10,5,10,5,0,False,False,False,1,2,2021-11-08T16:46:36.257,15,False,10.0
2021,9,3190,660,4,6990,2,5,3,2,3,1,3,0,3,0,False,True,False,0,4,2021-11-11T21:03:22.72,3,False,0.0
2021,9,3190,665,4,213,13,4,5,4,0,0,0,0,0,0,False,False,False,0,2,2021-11-08T16:51:31.903,0,False,0.0
2021,9,3190,670,4,2853,2,2,5,4,5,1,4,1,4,0,False,False,False,0,2,2021-11-11T19:27:05.543,5,False,1.0
2021,9,3190,695,15,4487,13,11,5,14,0,0,0,0,0,0,False,False,False,0,3,2021-11-08T17:03:24.017,0,False,0.0
2021,9,3190,710,4,6983,2,46,9,-1,-2,-1,-2,0,-2,0,False,False,False,0,1,2021-11-11T22:12:17.707,-2,False,0.0
2021,9,3190,715,4,2853,2,12,8,24,28,4,26,2,26,0,False,False,False,0,2,2021-11-11T21:06:12.02,28,False,2.0
2021,9,3190,720,4,5119,2,51,9,-1,1,2,1,0,1,0,True,False,False,0,3,2021-11-08T17:11:36.373,1,False,0.0
2021,9,3190,725,4,6990,2,39,4,5,7,2,7,0,7,0,False,False,False,0,3,2021-11-08T17:13:20.647,7,False,0.0
2021,9,3190,750,15,4179,13,35,5,9,0,0,0,0,0,0,False,False,False,0,3,2022-02-21T15:10:32.223,0,False,0.0
2021,9,3190,755,15,914,13,21,6,28,0,0,0,0,0,0,False,False,False,0,2,2021-11-11T21:06:59.32,0,False,0.0
2021,9,3190,765,4,7646,13,5,5,3,0,0,0,0,0,0,False,False,False,0,3,2021-11-08T17:28:45.603,0,False,0.0
2021,9,3190,770,4,213,2,12,7,16,19,3,17,2,17,0,False,False,False,0,2,2021-11-11T21:36:45.91,19,False,2.0
2021,9,3190,775,4,6983,2,31,9,2,5,3,4,1,4,0,False,False,False,0,1,2021-11-08T17:35:47.037,5,False,1.0
2021,9,3190,780,4,6983,2,31,9,0,14,14,11,3,11,0,False,False,False,2,1,2021-11-08T17:37:31.313,14,False,3.0
2021,9,3190,790,4,6983,2,6,9,1,3,2,1,2,1,0,False,False,False,1,1,2021-11-11T21:11:42.393,3,False,2.0
2021,9,3190,795,4,7646,3,26,3,6,0,0,0,0,0,0,False,False,False,0,3,2021-11-08T17:42:30.983,0,False,0.0
2021,9,3190,815,4,2853,13,12,7,17,0,0,0,0,0,0,False,False,False,0,2,2021-11-08T17:46:32.3,0,False,0.0
2021,9,3191,15,17,6274,13,2,10,9,0,0,0,0,0,0,False,False,False,0,2,2021-11-08T10:12:53.063,0,False,0.0
2021,9,3191,20,17,4752,13,4,10,11,0,0,0,0,0,0,False,False,False,0,2,2021-11-11T20:15:44.033,0,False,0.0
2021,9,3191,40,13,2407,2,30,5,-2,23,25,20,3,20,0,False,False,False,0,3,2021-11-08T16:42:59.33,23,False,3.0
2021,9,3191,55,13,876,13,9,6,25,0,0,0,0,0,0,False,False,False,0,3,2021-11-11T20:15:54.177,0,False,0.0
2021,9,3191,60,13,8417,2,5,5,6,9,3,7,2,7,0,False,False,False,0,3,2022-02-21T15:53:57.57,9,False,2.0
2021,9,3191,65,13,876,13,7,6,16,0,0,0,0,0,0,False,False,False,0,3,2021-11-08T10:34:44.033,0,False,0.0
2021,9,3191,75,17,8483,2,2,3,4,8,4,8,0,8,0,False,False,False,0,2,2022-02-22T20:02:10.92,8,False,0.0
2021,9,3191,85,17,8483,2,35,6,16,17,1,17,0,17,0,False,False,False,0,3,2021-11-11T20:16:14.713,17,False,0.0
2021,9,3191,100,17,6274,2,29,3,14,18,4,15,3,15,0,False,False,False,0,3,2021-11-08T10:52:54.497,18,False,3.0
2021,9,3191,105,17,6274,13,29,3,13,0,0,0,0,0,0,False,False,False,0,3,2022-02-21T15:55:08.51,0,False,0.0
2021,9,3191,110,17,8483,2,2,10,7,12,5,12,0,12,0,False,False,False,0,3,2021-11-08T10:54:42.24,12,False,0.0
2021,9,3191,125,17,7024,2,54,10,-2,3,5,1,2,1,0,False,False,False,0,1,2021-11-11T20:15:12.177,3,False,2.0
2021,9,3191,150,13,876,13,4,10,7,0,0,0,0,0,0,False,False,False,0,2,2022-02-25T20:28:55.683,0,False,0.0
2021,9,3191,160,13,876,13,50,9,-6,0,0,0,0,0,0,False,False,False,0,3,2021-11-11T20:35:18.04,0,False,0.0
2021,9,3191,175,17,8483,13,12,2,40,0,0,0,0,0,0,False,False,False,0,3,2022-02-21T16:01:03.003,0,False,0.0
2021,9,3191,185,13,2455,2,4,9,4,9,5,7,2,7,0,False,False,False,0,3,2021-11-09T20:49:02.773,9,False,2.0
2021,9,3191,190,13,2407,2,2,3,7,15,8,11,4,11,0,False,False,False,0,2,2021-11-08T11:29:48.633,15,False,4.0
2021,9,3191,200,13,2407,3,2,9,9,0,0,0,0,0,0,True,False,False,0,3,2021-11-08T11:33:02.407,0,False,0.0
2021,9,3191,235,17,7024,2,32,5,-1,6,7,4,2,4,0,False,False,False,0,1,2021-11-11T20:38:18.087,6,False,2.0
2021,9,3191,255,13,100,2,26,9,6,6,0,6,0,6,0,False,False,False,0,3,2021-11-11T17:20:20.62,6,False,0.0
2021,9,3191,260,13,8417,2,4,3,5,7,2,5,2,5,0,False,False,False,0,2,2021-11-11T20:16:50.103,7,False,2.0
2021,9,3191,270,13,2455,2,5,3,5,5,0,5,0,5,0,False,False,False,0,1,2021-11-08T12:05:50.21,5,False,0.0
2021,9,3191,275,13,100,13,24,5,13,0,0,0,0,0,0,False,False,False,0,3,2021-11-11T20:53:27.93,0,False,0.0
2021,9,3191,290,17,7981,13,7,2,37,0,0,0,0,0,0,False,False,False,0,3,2021-11-08T12:10:37.95,0,False,0.0
2021,9,3191,300,17,4383,3,12,3,12,0,0,0,0,0,0,False,False,False,0,3,2021-11-11T20:38:51.59,0,False,0.0
2021,9,3191,320,13,876,2,13,9,5,10,5,6,4,6,0,False,False,False,1,3,2021-11-08T12:25:32.677,10,False,4.0
2021,9,3191,335,13,876,13,5,5,7,0,0,0,0,0,0,False,False,False,0,2,2021-11-08T12:30:52.797,0,False,0.0
2021,9,3191,350,13,876,13,11,5,13,0,0,0,0,0,0,True,False,False,0,3,2022-02-21T15:56:10.967,0,False,0.0
2021,9,3191,355,13,876,2,5,5,6,6,0,6,0,6,0,False,False,False,0,3,2021-11-11T20:17:37.68,6,False,0.0
2021,9,3191,360,13,876,13,19,7,17,0,0,0,0,0,0,False,False,False,0,2,2022-02-21T16:05:58.657,0,False,0.0
2021,9,3191,380,17,6274,13,2,4,10,0,0,0,0,0,0,False,False,False,0,3,2022-02-21T16:03:45.867,0,False,0.0
2021,9,3191,385,17,8483,2,5,5,10,12,2,10,2,10,0,False,False,False,0,2,2021-11-08T12:45:10.027,12,False,2.0
2021,9,3191,390,17,8483,2,4,5,10,10,0,10,0,10,0,False,False,False,0,2,2021-11-08T12:55:11.043,10,False,0.0
2021,9,3191,400,17,7024,2,47,5,-2,5,7,1,4,1,0,False,False,False,2,1,2021-11-08T12:57:20.07,5,False,4.0
2021,9,3191,405,17,364,3,5,3,5,0,0,0,0,0,0,False,False,False,0,3,2021-11-10T02:22:50.32,0,False,
2021,9,3191,410,17,364,2,4,3,6,11,5,10,1,10,0,False,False,False,0,3,2021-11-08T13:04:47.053,11,False,1.0
2021,9,3191,425,17,6274,2,17,1,18,18,0,18,0,18,0,False,False,False,0,3,2021-11-11T20:17:51.393,18,False,0.0
2021,9,3191,430,17,6274,13,7,5,10,0,0,0,0,0,0,False,False,False,0,3,2022-02-21T16:03:11.643,0,False,0.0
2021,9,3191,455,13,1510,13,12,3,8,0,0,0,0,0,0,False,False,False,0,1,2022-02-24T16:04:11.2,0,False,0.0
2021,9,3191,460,17,6276,2,7,5,12,21,9,18,3,18,0,False,False,False,0,3,2021-11-08T13:27:42.08,21,False,3.0
2021,9,3191,475,17,4484,13,7,5,5,0,0,0,0,0,0,False,False,False,0,3,2021-11-11T20:58:10.28,0,False,0.0
2021,9,3191,480,17,4383,2,2,4,5,5,0,5,0,5,6,False,False,False,0,2,2021-11-08T13:33:54.027,5,True,0.0
2021,9,3191,510,13,876,2,4,5,9,9,0,9,0,9,0,False,False,False,0,2,2021-11-09T20:48:27.8,9,False,0.0
2021,9,3191,525,13,2455,3,11,3,12,0,0,0,0,0,0,False,False,False,0,1,2021-11-08T13:56:31.863,0,False,0.0
2021,9,3191,530,13,100,13,2,4,14,0,0,0,0,0,0,False,False,False,0,3,2021-11-08T14:05:37.4,0,False,0.0
2021,9,3191,540,17,6276,2,13,9,5,6,1,6,0,6,0,False,False,False,0,3,2021-11-08T14:04:44.353,6,False,0.0
2021,9,3191,545,17,8483,13,13,4,-1,0,0,0,0,0,0,False,False,False,0,3,2021-11-11T20:42:08.303,0,False,0.0
2021,9,3191,550,13,4498,2,31,10,1,8,7,5,3,5,0,False,False,False,0,4,2021-11-08T14:10:47.623,8,False,3.0
2021,9,3191,555,13,100,13,11,2,23,0,0,0,0,0,0,True,False,False,0,3,2021-11-11T20:43:29.493,0,False,0.0
2021,9,3191,560,13,1510,2,46,3,0,34,34,23,11,23,0,False,False,False,1,1,2021-11-11T21:01:52.547,34,False,
2021,9,3191,565,13,100,13,7,6,24,0,0,0,0,0,0,False,False,False,0,2,2021-11-11T20:18:27.49,0,False,0.0
2021,9,3191,580,17,4383,2,2,9,8,10,2,8,2,8,0,False,False,False,0,2,2021-11-08T14:21:27.09,10,False,2.0
2021,9,3191,585,17,6274,2,2,9,8,9,1,8,1,8,0,False,False,False,0,2,2021-11-08T14:22:55.563,9,False,1.0
2021,9,3191,590,17,7024,2,32,3,0,1,1,1,0,1,0,False,False,False,0,1,2021-11-08T14:26:03.28,1,False,0.0
2021,9,3191,595,17,8483,2,13,9,3,4,1,3,1,3,0,False,False,False,0,3,2021-11-08T14:29:50.003,4,False,1.0
2021,9,3191,610,17,6274,2,2,4,9,9,0,9,0,9,0,False,False,False,0,3,2021-11-11T17:20:20.62,9,False,0.0
2021,9,3191,615,17,364,13,12,9,9,0,0,0,0,0,0,False,False,False,0,3,2021-11-08T14:37:07.1,0,False,0.0
2021,9,3191,625,17,4484,2,38,4,2,11,9,9,2,9,0,False,False,False,0,3,2021-11-08T14:46:03.477,11,False,2.0
2021,9,3191,630,17,8483,13,45,5,1,0,0,0,0,0,0,True,False,False,0,3,2021-11-11T21:18:59.117,0,False,
2021,9,3191,645,17,7024,2,18,3,2,2,0,2,0,2,0,False,False,False,0,2,2021-11-08T15:00:30.55,2,False,0.0
2021,9,3191,670,13,4498,2,17,9,7,15,8,11,4,11,0,False,False,False,0,4,2021-11-08T15:13:45.383,15,False,4.0
2021,9,3191,675,13,3586,2,30,5,0,4,4,4,0,4,0,False,False,False,0,3,2021-11-11T21:07:50.49,4,False,0.0
2021,9,3191,690,13,100,2,5,5,3,39,36,39,0,39,0,True,False,False,0,3,2021-11-11T20:44:40.207,39,False,0.0
2021,9,3191,695,13,2455,2,44,3,-3,15,18,13,2,13,0,False,False,False,1,1,2021-11-08T15:19:45.203,15,False,2.0
2021,9,3191,700,13,876,13,12,2,15,0,0,0,0,0,0,False,False,False,0,3,2021-11-08T15:21:14.003,0,False,0.0
2021,9,3191,705,13,8418,2,30,3,2,4,2,4,0,4,0,False,False,False,0,4,2021-11-11T21:08:21.143,4,False,0.0
2021,9,3191,710,13,876,2,5,5,5,10,5,9,1,9,0,False,False,False,0,2,2021-11-08T15:25:39.577,10,False,1.0
2021,9,3191,720,13,6528,2,12,5,2,3,1,3,0,3,0,False,False,False,0,4,2022-02-24T16:04:22.253,3,True,0.0
2021,9,3191,725,13,2455,13,5,5,1,0,0,0,0,0,0,True,False,False,0,1,2021-11-08T15:31:55.7,0,False,0.0
2021,9,3191,740,17,7981,2,2,3,6,13,7,9,4,9,0,False,False,False,0,2,2021-11-08T15:40:51.813,13,False,4.0
2021,9,3191,745,17,7981,3,6,9,8,0,0,0,0,0,0,False,False,False,0,2,2021-11-11T17:20:20.62,0,False,0.0
2021,9,3191,750,17,4383,13,12,2,16,0,0,0,0,0,0,False,False,False,0,3,2022-02-24T16:04:41.177,0,False,0.0
2021,9,3191,760,17,8483,2,13,10,4,14,10,14,0,14,0,True,False,False,0,2,2021-11-08T15:54:07.507,14,True,0.0
2021,9,3191,765,17,8483,2,39,4,5,6,1,6,0,6,0,False,False,False,0,3,2021-11-08T15:55:33.983,6,False,0.0
2021,9,3191,785,13,8418,2,30,5,-2,5,7,2,3,2,0,False,False,False,1,4,2021-11-11T21:10:41.297,5,False,3.0
2021,9,3191,790,13,876,2,4,10,5,10,5,7,3,7,0,False,False,False,0,3,2021-11-08T16:02:44.327,10,False,3.0
2021,9,3191,820,17,7024,2,32,9,-4,6,10,3,3,3,0,False,False,False,0,1,2021-11-08T16:11:35.59,6,False,3.0
2021,9,3191,825,17,4383,2,26,10,5,7,2,7,0,7,0,False,False,False,0,3,2021-11-11T17:20:20.62,7,False,0.0
2021,9,3191,850,17,4383,13,12,6,34,0,0,0,0,0,0,False,False,False,0,2,2021-11-08T16:19:38.593,0,False,0.0
2021,9,3191,860,13,8417,2,13,4,5,11,6,9,2,9,0,False,False,False,0,3,2021-11-08T16:21:44.927,11,False,2.0
2021,9,3191,865,13,6528,2,4,10,7,7,0,7,0,7,0,False,True,True,0,4,2021-11-11T20:19:30.023,4,False,0.0
2021,9,3191,900,13,6528,13,31,4,10,0,0,0,0,0,0,False,False,False,0,3,2021-11-11T17:20:20.62,0,False,0.0
2021,9,3191,905,13,100,2,2,4,4,4,0,4,0,4,0,False,False,False,0,3,2021-11-08T16:32:18.83,4,False,0.0
2021,9,3191,915,13,876,2,4,3,11,9,-2,9,0,9,0,False,False,False,0,2,2021-11-08T16:51:15.243,11,False,2.0
2021,9,3192,10,21,813,2,47,10,1,9,8,6,3,6,0,False,False,False,0,4,2021-11-08T10:10:12.303,9,False,3.0
2021,9,3192,20,21,3957,2,48,10,-2,5,7,3,2,3,0,False,False,False,1,1,2022-02-21T16:38:36.367,5,False,2.0
2021,9,3192,40,21,4422,2,24,2,26,30,4,30,0,30,6,False,False,False,0,3,2021-11-08T10:28:08.487,30,True,0.0
2021,9,3192,60,23,7241,2,51,9,-6,6,12,2,4,2,0,False,False,False,1,1,2021-11-11T22:45:34.12,6,False,4.0
2021,9,3192,65,23,2994,2,4,5,5,6,1,6,0,6,0,False,False,False,0,2,2021-11-08T10:37:30.653,6,False,0.0
2021,9,3192,75,23,7250,3,51,10,-2,0,0,0,0,0,0,False,False,False,0,3,2022-02-21T16:39:16.013,0,False,0.0
2021,9,3192,80,23,7250,2,24,2,16,20,4,19,1,19,0,False,False,False,0,3,2021-11-11T22:36:24.713,20,False,1.0
2021,9,3192,85,23,7240,2,47,10,2,6,4,4,2,4,0,False,False,False,0,1,2021-11-08T10:55:13.81,6,False,2.0
2021,9,3192,100,23,7250,2,5,5,2,2,0,2,0,2,6,False,False,False,0,2,2021-11-11T23:04:32.047,2,True,0.0
2021,9,3192,120,21,3957,2,45,5,-1,6,7,6,0,6,0,True,False,False,0,1,2021-11-11T22:46:06.073,6,False,0.0
2021,9,3192,145,23,7689,13,21,2,15,0,0,0,0,0,0,False,False,False,0,2,2022-02-21T16:41:09.017,0,False,
2021,9,3192,155,23,2994,13,13,10,3,0,0,0,0,0,0,False,False,False,0,4,2021-11-08T11:23:09.847,0,False,0.0
2021,9,3192,160,23,3843,13,28,9,-2,0,0,0,0,0,0,False,False,False,0,1,2021-11-11T17:27:21.037,0,False,0.0
2021,9,3192,175,23,7241,2,4,4,3,8,5,5,3,5,0,False,False,False,0,1,2021-11-11T16:49:29.96,8,False,3.0
2021,9,3192,185,23,7250,2,34,4,-4,3,7,2,1,2,0,True,False,False,0,3,2021-11-08T11:41:09.013,3,False,1.0
2021,9,3192,195,23,7689,13,2,10,6,0,0,0,0,0,0,False,False,False,0,3,2021-11-08T11:44:21.003,0,False,0.0
2021,9,3192,200,23,2994,13,26,9,5,0,0,0,0,0,0,False,False,False,0,3,2021-11-11T22:49:58.273,0,False,0.0
2021,9,3192,220,21,3957,2,44,3,-5,12,17,12,0,12,0,True,False,False,0,1,2021-11-09T16:37:45.61,12,False,0.0
2021,9,3192,235,21,813,2,26,10,7,7,0,7,0,7,0,False,False,False,0,4,2021-11-11T16:49:29.96,7,False,0.0
2021,9,3192,250,21,4180,2,48,10,-7,-7,0,-7,0,-7,0,False,False,False,0,1,2021-11-08T12:04:34.483,-7,False,0.0
2021,9,3192,270,23,4307,13,46,3,2,0,0,0,0,0,0,False,False,False,0,1,2021-11-11T16:49:29.96,0,False,0.0
2021,9,3192,275,23,7689,3,2,4,14,0,0,0,0,0,0,False,False,False,0,3,2022-02-21T16:43:01.243,0,False,0.0
2021,9,3192,290,21,4492,2,2,10,11,14,3,11,3,11,0,False,False,False,0,2,2021-11-08T12:18:01.427,14,False,3.0
2021,9,3192,305,21,813,2,30,5,2,3,1,2,1,2,0,True,False,False,0,4,2021-11-11T22:37:32.217,3,False,1.0
2021,9,3192,360,23,7240,2,46,9,-1,7,8,6,1,6,0,False,False,False,1,1,2021-11-11T22:50:48.743,7,False,1.0
2021,9,3192,370,23,3843,2,4,9,4,8,4,6,2,6,0,False,False,False,0,1,2021-11-08T12:41:00.07,8,False,2.0
2021,9,3192,375,23,3843,2,16,9,6,10,4,9,1,9,0,False,False,False,0,1,2021-11-08T12:44:01.583,10,False,1.0
2021,9,3192,385,23,2994,2,35,8,18,20,2,20,0,20,0,False,False,False,0,3,2021-11-08T12:47:14.383,20,False,0.0
2021,9,3192,395,23,7250,2,6,4,6,7,1,7,0,7,0,False,False,False,1,3,2021-11-11T22:38:27.663,7,False,0.0
2021,9,3192,400,23,4949,13,12,5,14,0,0,0,0,0,0,False,False,False,0,2,2021-11-08T12:51:36.89,0,False,0.0
2021,9,3192,405,23,2994,13,17,9,14,0,0,0,0,0,0,False,False,False,0,3,2021-11-08T12:53:25.56,0,False,0.0
2021,9,3192,435,23,7241,2,48,10,-3,2,5,0,2,0,0,False,False,False,0,1,2021-11-11T22:52:35.543,2,False,2.0
2021,9,3192,440,23,7250,13,5,3,6,0,0,0,0,0,0,False,False,False,0,3,2021-11-11T17:38:14.193,0,False,0.0
2021,9,3192,455,23,7240,2,46,3,3,15,12,7,8,7,0,False,False,False,0,1,2021-11-08T13:09:14.1,15,False,8.0
2021,9,3192,460,23,4307,2,51,5,-4,9,13,8,1,8,0,True,False,False,0,1,2021-11-08T16:12:03.867,9,False,1.0
2021,9,3192,470,23,7250,2,4,9,3,5,2,5,0,5,0,False,False,False,0,3,2021-11-08T13:15:40.947,5,False,0.0
2021,9,3192,485,23,7250,2,32,9,-1,9,10,6,3,6,0,False,False,False,1,3,2021-11-11T17:33:59.687,9,False,3.0
2021,9,3192,490,23,7689,13,8,1,35,0,0,0,0,0,0,False,False,False,0,3,2021-11-08T13:23:13.077,0,False,0.0
2021,9,3192,510,23,4949,2,17,2,18,20,2,20,0,20,0,False,False,False,0,2,2021-11-11T16:49:29.96,20,False,0.0
2021,9,3192,525,23,2994,13,7,5,7,0,0,0,0,0,0,False,False,False,0,3,2021-11-08T13:38:45.843,0,False,0.0
2021,9,3192,545,21,813,13,5,10,5,0,0,0,0,0,0,False,False,False,0,3,2021-11-11T17:28:00.067,0,False,0.0
2021,9,3192,550,21,4492,2,2,9,12,14,2,10,4,10,0,False,False,False,0,2,2021-11-08T13:47:02.66,14,False,4.0
2021,9,3192,560,21,4422,2,46,3,2,2,0,2,0,2,0,True,False,False,0,3,2021-11-11T16:49:29.96,2,False,0.0
2021,9,3192,565,21,8518,2,5,5,4,9,5,8,1,8,0,True,False,False,0,3,2021-11-09T16:36:10.733,9,False,1.0
2021,9,3192,570,21,813,2,32,4,-2,1,3,1,0,1,0,False,False,False,0,4,2022-02-21T16:44:37.193,1,False,0.0
2021,9,3192,615,23,2994,2,17,8,17,24,7,20,4,20,0,False,False,False,0,4,2021-11-08T14:08:27.883,24,False,4.0
2021,9,3192,625,23,4307,2,28,10,-1,22,23,10,12,10,0,False,False,False,1,1,2021-11-11T22:40:58.073,22,False,12.0
2021,9,3192,630,23,4307,2,32,9,-4,11,15,10,1,10,0,False,False,False,0,1,2021-11-11T22:36:45.507,11,False,1.0
2021,9,3192,635,23,4307,2,45,5,-6,2,8,-6,8,-6,0,True,False,False,1,2,2021-11-08T14:20:35.363,2,False,8.0
2021,9,3192,645,23,7241,2,13,9,1,3,2,1,2,1,0,True,False,False,0,3,2021-11-08T15:37:58.413,3,False,2.0
2021,9,3192,660,21,7090,13,4,5,9,0,0,0,0,0,0,False,False,False,0,2,2021-11-11T22:36:55.567,0,False,0.0
2021,9,3192,675,21,4422,13,17,7,27,0,0,0,0,0,0,False,False,False,0,3,2021-11-09T16:36:40.467,0,False,
2021,9,3192,690,21,4422,13,35,7,15,0,0,0,0,0,0,False,False,False,0,3,2022-02-21T16:47:12.35,0,False,0.0
2021,9,3192,700,23,7689,13,17,8,16,0,0,0,0,0,0,False,False,False,0,3,2022-02-21T16:47:45.55,0,False,0.0
2021,9,3192,705,23,2994,2,2,10,9,12,3,11,1,11,0,True,False,False,0,4,2021-11-08T14:52:27.363,12,False,1.0
2021,9,3192,710,23,4949,13,24,2,26,0,0,0,0,0,0,False,False,False,0,2,2021-11-11T16:49:29.96,0,False,0.0
2021,9,3192,735,21,4180,2,47,5,-1,-1,0,-1,0,-1,0,False,False,False,0,1,2021-11-11T17:37:21.447,-1,False,0.0
2021,9,3192,745,21,4422,2,39,10,5,6,1,6,0,6,0,False,False,False,0,3,2021-11-08T15:04:26.327,6,False,0.0
2021,9,3192,765,23,2994,2,32,5,2,3,1,3,0,3,0,False,False,False,0,4,2021-11-11T22:59:22.51,3,False,0.0
2021,9,3192,770,23,2994,2,2,4,7,19,12,16,3,16,0,False,False,False,0,3,2022-02-21T16:49:07.34,19,False,3.0
2021,9,3192,775,23,4307,2,28,4,2,9,7,8,1,8,0,False,False,False,0,1,2021-11-11T23:01:02.747,9,False,1.0
2021,9,3192,790,23,4307,2,48,9,-1,17,18,14,3,14,0,False,False,False,0,1,2021-11-08T15:16:47.833,17,False,3.0
2021,9,3192,795,23,2994,2,6,9,5,8,3,8,0,8,0,False,False,False,0,3,2021-11-11T23:04:59.517,8,False,0.0
2021,9,3192,800,23,4307,13,28,9,0,0,0,0,0,0,0,False,False,False,0,1,2021-11-08T15:20:19.17,0,False,0.0
2021,9,3192,805,23,7250,2,47,5,-1,3,4,1,2,1,0,False,False,False,0,3,2021-11-08T15:22:24.703,3,False,2.0
2021,9,3192,815,23,4949,13,12,3,13,0,0,0,0,0,0,False,False,False,0,2,2021-11-11T22:37:05.29,0,False,0.0
2021,9,3193,15,24,7800,2,51,10,-4,2,6,0,2,0,0,False,False,False,0,3,2021-11-08T10:33:05.973,2,False,2.0
2021,9,3193,20,24,6373,2,12,3,6,18,12,18,0,18,0,False,False,False,0,3,2021-11-08T10:35:58.93,18,False,0.0
2021,9,3193,25,24,6373,13,6,9,14,0,0,0,0,0,0,False,False,False,0,3,2021-11-08T10:37:45.46,0,False,0.0
2021,9,3193,30,24,6373,13,5,3,12,0,0,0,0,0,0,False,False,False,0,4,2021-11-09T19:19:01.993,0,False,0.0
2021,9,3193,40,24,6373,13,8,6,27,0,0,0,0,0,0,False,False,False,0,3,2021-11-11T20:15:45.69,0,False,0.0
2021,9,3193,55,26,309,13,35,2,15,0,0,0,0,0,0,False,False,False,0,3,2022-02-21T16:51:35.757,0,False,0.0
2021,9,3193,60,26,7453,2,4,5,12,19,7,14,5,14,0,False,False,False,0,2,2021-11-11T22:23:51.993,19,False,5.0
2021,9,3193,65,26,309,2,5,3,8,12,4,11,1,11,0,False,False,False,0,3,2021-11-08T10:53:19.23,12,False,1.0
2021,9,3193,75,26,309,2,5,5,6,9,3,7,2,7,0,False,False,False,0,2,2021-11-08T11:19:44.8,9,False,2.0
2021,9,3193,90,26,309,2,6,7,16,17,1,17,0,17,0,False,False,False,0,3,2021-11-11T23:06:46.747,17,False,0.0
2021,9,3193,100,26,4050,2,53,9,-5,23,28,16,7,16,0,False,False,False,0,4,2021-11-08T11:18:56.4,23,False,7.0
2021,9,3193,105,26,4619,13,29,3,2,0,0,0,0,0,0,False,False,False,0,2,2022-02-21T16:52:09.41,0,False,0.0
2021,9,3193,115,26,4619,3,49,10,-2,0,0,0,0,0,0,True,False,False,0,2,2021-11-08T11:16:56.177,0,False,0.0
2021,9,3193,120,26,309,2,5,5,1,1,0,1,0,1,0,True,False,False,0,2,2021-11-09T19:18:36.713,1,False,0.0
2021,9,3193,125,24,7800,13,19,6,28,0,0,0,0,0,0,False,False,False,0,2,2021-11-08T11:24:12.243,0,False,0.0
2021,9,3193,145,26,958,2,4,10,6,9,3,8,1,8,0,False,False,False,0,3,2021-11-11T23:05:19.73,9,False,1.0
2021,9,3193,160,26,958,2,46,3,0,23,23,20,3,20,0,False,False,False,0,3,2022-02-21T16:55:08.267,23,False,3.0
2021,9,3193,175,26,4050,2,47,10,2,2,0,2,0,2,6,False,False,False,0,1,2021-11-08T11:39:00.223,2,True,0.0
2021,9,3193,210,24,8509,2,6,6,22,27,5,25,2,25,0,False,False,False,0,3,2021-11-11T20:15:45.69,27,False,2.0
2021,9,3193,260,26,7491,2,32,3,1,12,11,7,5,7,0,False,False,False,0,4,2022-02-21T16:53:26.777,12,False,5.0
2021,9,3193,275,26,958,2,5,5,6,15,9,13,2,13,0,False,False,False,0,3,2021-11-08T12:09:00.467,15,False,2.0
2021,9,3193,280,26,309,2,51,9,-4,3,7,3,0,3,0,False,False,False,0,3,2021-11-11T23:02:34.053,3,False,0.0
2021,9,3193,285,26,958,2,46,3,1,1,0,1,0,1,0,False,False,False,0,3,2021-11-11T23:07:09.963,1,False,0.0
2021,9,3193,290,26,309,2,16,9,3,4,1,4,0,4,0,False,False,False,0,1,2021-11-08T12:13:16.177,4,False,0.0
2021,9,3193,330,24,7800,2,5,5,7,7,0,7,0,7,0,False,False,False,0,3,2021-11-08T12:24:50.42,7,False,0.0
2021,9,3193,390,24,8509,13,7,3,6,0,0,0,0,0,0,False,False,False,0,3,2021-11-08T12:38:49.363,0,False,0.0
2021,9,3193,405,26,4616,2,48,9,-6,11,17,7,4,7,0,False,False,False,0,1,2021-11-08T15:32:14.317,11,False,4.0
2021,9,3193,420,26,4619,2,4,10,4,9,5,5,4,5,0,False,False,False,1,2,2021-11-11T22:39:24.677,9,False,4.0
2021,9,3193,430,26,309,2,2,4,8,16,8,12,4,12,0,False,False,False,0,3,2021-11-08T12:57:20.59,16,False,4.0
2021,9,3193,435,26,8552,2,11,5,13,15,2,15,0,15,0,True,False,False,0,3,2021-11-11T22:44:12.913,15,False,0.0
2021,9,3193,440,26,7491,2,9,2,17,19,2,19,0,19,0,False,False,False,0,2,2021-11-11T23:22:41.627,19,False,0.0
2021,9,3193,445,26,4619,13,4,3,10,0,0,0,0,0,0,False,False,False,0,2,2021-11-08T13:03:03.587,0,False,0.0
2021,9,3193,490,26,4619,2,8,7,47,49,2,47,2,47,0,False,False,False,0,3,2021-11-08T13:15:31.843,49,False,2.0
2021,9,3193,495,26,309,2,5,5,5,8,3,6,2,6,0,False,False,False,0,3,2021-11-08T13:15:21.873,8,False,2.0
2021,9,3193,505,26,7491,2,47,5,0,8,8,2,6,2,6,False,False,False,1,4,2021-11-08T13:23:47.777,8,False,6.0
2021,9,3193,525,24,8509,2,3,2,17,23,6,20,3,20,0,False,False,False,0,2,2021-11-08T13:28:20.507,23,False,3.0
2021,9,3193,530,24,8509,2,35,6,19,19,0,19,0,19,0,False,False,False,0,3,2021-11-08T13:30:12.21,19,False,0.0
2021,9,3193,540,24,6373,2,47,5,2,21,19,5,16,5,0,False,False,False,1,4,2021-11-08T13:33:40.627,21,False,16.0
2021,9,3193,580,26,4616,2,32,5,-4,-2,2,-2,0,-2,0,False,False,False,0,1,2021-11-08T15:32:32.35,-2,False,0.0
2021,9,3193,585,26,8552,2,4,9,7,7,0,7,0,7,0,False,False,False,0,2,2021-11-08T13:46:45.1,7,False,0.0
2021,9,3193,590,26,4619,3,5,3,9,0,0,0,0,0,0,False,False,False,0,2,2022-02-21T16:54:13.3,0,False,
2021,9,3193,595,26,4050,2,32,3,-2,3,5,3,0,3,0,False,False,False,0,1,2021-11-08T13:51:28.973,3,False,0.0
2021,9,3193,605,26,309,2,4,10,4,8,4,5,3,5,0,False,False,False,0,2,2021-11-08T14:11:21.617,8,False,3.0
2021,9,3193,615,26,309,2,4,8,15,18,3,18,0,18,0,False,False,False,0,2,2021-11-11T22:49:58.433,18,False,0.0
2021,9,3193,660,24,7798,2,50,3,-2,-6,-4,-4,-2,-4,0,False,False,False,2,2,2021-11-11T22:07:44.86,-6,False,-2.0
2021,9,3193,665,24,8509,2,5,6,19,19,0,19,0,19,0,False,False,False,0,3,2021-11-08T14:19:46.11,19,False,0.0
2021,9,3193,675,24,6373,2,46,3,2,4,2,2,2,2,0,False,False,False,0,4,2021-11-08T14:22:37.867,4,False,2.0
2021,9,3193,710,24,8509,2,8,1,22,28,6,26,2,26,6,False,False,False,0,3,2021-11-11T20:15:45.69,28,False,2.0
2021,9,3193,725,26,309,2,30,10,-4,3,7,3,0,3,0,True,False,False,0,3,2021-11-08T15:49:28.31,3,False,0.0
2021,9,3193,730,26,4616,2,4,5,3,14,11,6,8,6,0,False,False,False,1,1,2021-11-08T14:42:09.863,14,False,8.0
2021,9,3193,740,26,7695,2,4,9,4,4,0,4,0,4,0,False,False,False,0,1,2021-11-08T14:46:20.2,4,False,0.0
2021,9,3193,745,26,7453,13,5,5,6,0,0,0,0,0,0,False,False,False,0,2,2021-11-08T15:32:45.72,0,False,0.0
2021,9,3193,750,26,309,2,4,10,5,5,0,5,0,5,0,False,False,False,0,1,2021-11-08T14:54:46.343,5,False,0.0
2021,9,3193,770,26,4050,2,30,3,3,11,8,8,3,8,0,False,False,False,0,4,2021-11-08T14:58:01.593,11,False,3.0
2021,9,3194,10,12,8279,13,32,4,1,0,0,0,0,0,0,False,False,False,0,4,2021-11-08T10:13:47.023,0,False,0.0
2021,9,3194,20,12,4537,13,12,9,0,0,0,0,0,0,0,False,False,False,0,1,2021-11-08T10:19:40.08,0,False,0.0
2021,9,3194,30,16,3938,2,46,3,-2,2,4,1,1,1,0,True,False,False,0,3,2021-11-08T10:25:10.243,2,False,1.0
2021,9,3194,35,16,3938,13,4,5,9,0,0,0,0,0,0,False,False,False,0,2,2021-11-08T10:28:01.08,0,False,0.0
2021,9,3194,40,16,374,2,4,4,7,7,0,7,0,7,0,False,False,False,0,3,2021-11-08T10:29:51.023,7,False,0.0
2021,9,3194,50,16,3938,2,5,5,7,10,3,8,2,8,0,False,False,False,0,3,2021-11-08T10:34:29.127,10,False,2.0
2021,9,3194,75,16,3938,2,6,4,9,8,-1,9,-1,9,0,False,False,False,0,3,2021-11-08T10:45:11.52,8,False,
2021,9,3194,80,16,7176,2,34,4,-4,4,8,4,0,4,0,True,False,False,0,3,2021-11-08T10:46:30.2,4,False,0.0
2021,9,3194,85,16,4143,2,13,10,2,2,0,2,0,2,0,False,False,False,0,2,2021-11-08T10:49:21.577,2,False,0.0
2021,9,3194,105,16,374,2,17,4,1,1,0,1,0,1,6,True,False,False,0,4,2021-11-08T10:55:42.833,1,True,0.0
2021,9,3194,130,12,556,2,5,5,5,10,5,5,5,5,0,False,False,False,0,3,2021-11-09T19:47:38.753,10,False,5.0
2021,9,3194,140,12,7742,2,48,10,-2,15,17,12,3,12,0,False,False,False,0,1,2021-11-09T19:47:51.94,15,False,3.0
2021,9,3194,155,12,4537,13,50,3,-4,0,0,0,0,0,0,False,False,False,0,2,2021-11-08T11:27:30.453,0,False,0.0
2021,9,3194,165,16,374,13,26,10,3,0,0,0,0,0,0,True,False,False,0,3,2021-11-08T11:29:45.34,0,False,0.0
2021,9,3194,170,16,6499,2,48,9,-2,7,9,5,2,5,0,False,False,False,0,1,2021-11-08T11:30:54.923,7,False,2.0
2021,9,3194,175,16,797,2,44,3,-3,2,5,0,2,0,0,False,False,False,0,1,2021-11-08T11:32:12.233,2,False,2.0
2021,9,3194,185,16,6499,2,47,5,-2,-2,0,-2,0,-2,0,False,False,False,0,1,2021-11-12T00:56:05.007,-2,False,0.0
2021,9,3194,210,12,7742,2,5,3,4,5,1,5,0,5,0,False,False,False,0,1,2021-11-08T11:45:01.69,5,True,0.0
2021,9,3194,215,12,556,2,13,9,3,6,3,4,2,4,0,False,False,False,0,3,2021-11-09T19:48:06.333,6,False,2.0
2021,9,3194,230,16,7176,2,51,3,-2,7,9,5,2,5,0,True,False,False,0,3,2021-11-08T12:01:23.68,7,False,2.0
2021,9,3194,235,16,3938,2,4,10,12,12,0,12,0,12,0,False,False,False,0,3,2021-11-12T01:02:25.197,12,False,0.0
2021,9,3194,240,16,7176,13,8,2,50,0,0,0,0,0,0,False,False,False,0,2,2021-11-08T16:04:23.463,0,False,0.0
2021,9,3194,245,16,374,3,2,10,10,0,0,0,0,0,0,True,False,False,0,3,2021-11-08T12:06:31.28,0,False,0.0
2021,9,3194,250,16,3938,13,4,5,12,0,0,0,0,0,0,False,False,False,0,3,2021-11-08T12:09:14.423,0,False,0.0
2021,9,3194,260,12,7742,2,47,5,2,21,19,18,3,18,0,False,False,False,0,1,2021-11-08T12:12:27.99,21,False,3.0
2021,9,3194,275,12,556,13,2,10,6,0,0,0,0,0,0,False,False,False,0,2,2021-11-08T12:16:40.197,0,False,
2021,9,3194,290,12,556,13,9,6,22,0,0,0,0,0,0,False,False,False,0,2,2021-11-11T23:37:21.003,0,False,0.0
2021,9,3194,300,16,3938,13,8,6,50,0,0,0,0,0,0,False,False,False,0,3,2021-11-08T12:31:08.85,0,False,0.0
2021,9,3194,310,16,3938,13,8,1,29,0,0,0,0,0,0,False,False,False,0,3,2021-11-12T00:55:23.34,0,False,
2021,9,3194,335,16,7176,13,51,3,-2,0,0,0,0,0,0,True,False,False,0,3,2021-11-08T12:44:40.7,0,False,0.0
2021,9,3194,345,16,6499,2,46,3,-1,2,3,2,0,2,0,False,False,False,0,1,2021-11-08T12:46:29.403,2,False,0.0
2021,9,3194,365,12,496,2,12,8,35,35,0,35,0,35,0,False,False,False,0,3,2021-11-08T13:00:51.693,35,False,0.0
2021,9,3194,370,12,496,2,46,3,1,0,-1,0,0,0,0,False,False,False,0,3,2021-11-08T12:58:33.723,0,False,0.0
2021,9,3194,385,12,556,13,7,5,10,0,0,0,0,0,0,False,False,False,0,3,2021-11-11T23:37:21.003,0,False,0.0
2021,9,3194,395,12,556,13,29,5,14,0,0,0,0,0,0,False,False,False,0,2,2022-02-21T15:19:57.94,0,False,0.0
2021,9,3194,400,16,3938,13,29,6,20,0,0,0,0,0,0,False,False,False,0,2,2021-11-08T13:05:09.37,0,False,0.0
2021,9,3194,405,16,374,2,35,8,17,25,8,22,3,22,0,False,False,False,0,3,2021-11-08T16:00:12.777,25,False,3.0
2021,9,3194,415,16,3938,13,3,3,14,0,0,0,0,0,0,False,False,False,0,2,2021-11-08T13:10:03.683,0,False,0.0
2021,9,3194,420,16,6499,13,11,5,6,0,0,0,0,0,0,False,False,False,0,1,2021-11-12T01:14:20.31,0,False,0.0
2021,9,3194,445,16,1989,13,6,7,16,0,0,0,0,0,0,False,False,False,0,2,2021-11-08T13:14:02.537,0,False,0.0
2021,9,3194,450,16,7417,2,47,5,-2,6,8,1,5,1,0,False,False,False,1,1,2021-11-12T01:15:15.23,6,False,5.0
2021,9,3194,490,16,2568,13,30,10,0,0,0,0,0,0,0,False,False,False,0,4,2021-11-08T13:32:14.313,0,False,0.0
2021,9,3194,495,16,374,3,5,3,9,0,0,0,0,0,0,True,False,False,0,3,2021-11-08T13:33:27.913,0,False,0.0
2021,9,3194,505,12,7743,2,30,10,0,11,11,9,2,9,0,False,False,False,0,4,2021-11-08T13:49:42.863,11,False,2.0
2021,9,3194,525,12,467,2,12,4,-3,-1,2,-2,1,-2,0,False,False,False,0,4,2021-11-08T13:55:22.72,-1,False,1.0
2021,9,3194,570,16,797,2,48,9,-5,14,19,11,3,11,0,False,False,False,0,1,2021-11-08T14:07:16.79,14,False,3.0
2021,9,3194,575,16,797,2,46,3,1,10,9,9,1,9,0,True,False,False,0,1,2021-11-09T18:20:31.017,10,False,1.0
2021,9,3194,585,16,374,2,5,5,6,13,7,10,3,10,0,True,False,False,0,3,2021-11-08T14:10:35.373,13,False,3.0
2021,9,3194,590,16,7176,3,5,3,4,0,0,0,0,0,0,False,False,False,0,2,2021-11-12T00:56:20.87,0,False,0.0
2021,9,3194,615,12,556,2,5,3,14,14,0,14,0,14,0,False,False,False,0,3,2021-11-08T14:20:02.853,14,True,0.0
2021,9,3194,620,12,6357,2,6,10,14,16,2,16,0,16,0,False,False,False,0,2,2021-11-08T14:21:43.877,16,False,0.0
2021,9,3194,625,12,6357,2,5,3,3,3,0,3,0,3,0,False,False,False,0,2,2021-11-12T01:07:46.493,3,False,0.0
2021,9,3194,630,12,556,2,51,10,0,8,8,7,1,7,0,False,False,False,0,3,2021-11-08T14:24:10.45,8,False,1.0
2021,9,3194,635,12,7742,13,5,9,2,0,0,0,0,0,0,False,False,False,0,1,2021-11-11T23:37:21.003,0,False,
2021,9,3194,645,12,7742,2,47,5,1,3,2,2,1,2,0,False,False,False,0,1,2021-11-09T19:48:57.74,3,False,1.0
2021,9,3194,650,12,556,2,5,3,1,2,1,2,0,2,0,False,False,False,0,3,2021-11-08T14:35:56.627,2,False,0.0
2021,9,3194,655,12,556,2,5,5,2,2,0,2,0,2,0,False,False,False,0,3,2021-11-08T14:37:22.713,2,False,0.0
2021,9,3194,675,12,556,13,5,5,4,0,0,0,0,0,0,False,False,False,0,3,2021-11-09T19:49:59.737,0,False,0.0
2021,9,3194,680,12,556,13,9,3,19,0,0,0,0,0,0,False,False,False,0,3,2021-11-12T01:13:02.247,0,False,0.0
2021,9,3194,690,16,3938,13,19,2,45,0,0,0,0,0,0,False,False,False,0,3,2021-11-08T15:01:16.72,0,False,0.0
2021,9,3194,695,16,3938,13,6,1,26,0,0,0,0,0,0,False,False,False,0,2,2021-11-08T15:07:20.28,0,False,0.0
2021,9,3194,705,12,556,13,4,5,4,0,0,0,0,0,0,False,False,False,0,2,2021-11-08T15:13:21.857,0,False,0.0
2021,9,3194,710,12,556,13,19,2,26,0,0,0,0,0,0,False,False,False,0,2,2021-11-08T15:16:06.897,0,False,0.0
2021,9,3194,715,12,496,2,18,3,1,15,14,12,3,12,0,False,False,False,1,2,2022-02-24T16:06:03.74,15,False,3.0
2021,9,3194,720,12,556,13,19,6,35,0,0,0,0,0,0,False,False,False,0,2,2021-11-08T15:20:26.927,0,False,0.0
2021,9,3194,735,12,496,13,4,10,4,0,0,0,0,0,0,False,False,False,0,3,2021-11-08T15:24:21.407,0,False,0.0
2021,9,3194,740,12,7743,2,4,9,4,5,1,5,0,5,0,True,False,False,0,3,2021-11-08T15:25:22.527,5,False,0.0
2021,9,3194,745,12,496,13,9,2,19,0,0,0,0,0,0,False,False,False,0,3,2021-11-08T15:26:48.87,0,False,0.0
2021,9,3194,755,12,6691,2,7,3,12,20,8,14,6,14,6,False,False,False,1,3,2021-11-08T15:28:31.12,20,False,6.0
2021,9,3194,775,16,374,2,17,7,16,22,6,20,2,20,0,False,False,False,0,4,2021-11-08T15:34:19.897,22,False,2.0
2021,9,3194,785,16,7176,2,18,3,1,9,8,7,2,7,0,False,False,False,0,2,2021-11-08T15:42:18.607,9,False,2.0
2021,9,3194,820,16,3938,2,12,5,13,13,0,13,0,13,0,False,False,False,0,3,2021-11-08T15:48:49.457,13,False,0.0
2021,9,3195,15,28,262,2,4,9,4,4,0,4,0,4,0,False,False,False,0,2,2021-11-08T11:18:37.1,4,False,0.0
2021,9,3195,20,28,4922,2,5,10,13,19,6,17,2,17,0,False,False,False,0,4,2021-11-08T11:20:19.46,19,False,2.0
2021,9,3195,25,28,7619,13,5,3,7,0,0,0,0,0,0,False,False,False,0,3,2021-11-08T11:22:19.963,0,False,0.0
2021,9,3195,30,28,4922,13,17,8,20,0,0,0,0,0,0,True,False,False,0,4,2021-11-11T15:38:15.833,0,False,0.0
2021,9,3195,50,1,6405,2,4,9,5,10,5,5,5,5,0,False,False,False,0,3,2022-02-21T17:07:19.247,10,False,5.0
2021,9,3195,55,1,5032,13,7,2,26,0,0,0,0,0,0,False,False,False,0,4,2021-11-08T11:36:23.84,0,False,0.0
2021,9,3195,60,1,5032,2,32,10,-2,0,2,-1,1,-1,0,False,False,False,0,1,2021-11-09T22:45:53.323,0,False,1.0
2021,9,3195,75,28,4922,2,6,4,11,18,7,18,0,18,0,False,True,True,1,4,2021-11-08T11:47:25.683,18,False,0.0
2021,9,3195,95,1,894,2,53,10,-6,9,15,8,1,8,0,False,False,False,0,4,2021-11-08T11:52:24.53,9,False,1.0
2021,9,3195,100,1,6405,2,49,5,-1,9,10,7,2,7,0,False,False,False,0,2,2021-11-08T11:55:31.263,9,False,2.0
2021,9,3195,105,1,8439,2,51,9,-5,8,13,8,0,8,0,False,False,False,0,3,2021-11-08T11:58:04.96,8,False,0.0
2021,9,3195,140,28,7224,2,6,4,11,16,5,12,4,12,0,False,False,False,0,3,2021-11-08T12:09:33.303,16,False,4.0
2021,9,3195,150,28,7224,3,2,9,7,0,0,0,0,0,0,False,False,False,0,2,2021-11-08T12:12:25.127,0,False,0.0
2021,9,3195,155,28,7224,13,4,2,15,0,0,0,0,0,0,False,False,False,0,3,2021-11-08T12:14:46.493,0,False,0.0
2021,9,3195,170,1,5032,2,32,5,0,5,5,4,1,4,0,False,False,False,0,1,2021-11-08T12:21:21.497,5,False,
2021,9,3195,175,1,4587,2,48,4,-3,0,3,0,0,0,0,False,False,False,2,1,2021-11-11T14:57:18.14,0,False,0.0
2021,9,3195,180,1,4587,2,28,4,0,21,21,3,18,3,0,False,False,False,1,1,2021-11-08T12:24:31.51,21,False,18.0
2021,9,3195,185,1,6405,2,2,9,8,17,9,14,3,14,0,False,False,False,0,2,2021-11-08T12:27:16.667,17,False,3.0
2021,9,3195,195,1,894,13,39,4,5,0,0,0,0,0,0,False,False,False,0,3,2021-11-08T12:31:42.767,0,False,0.0
2021,9,3195,205,1,6933,2,22,2,33,33,0,33,0,33,0,False,False,False,0,2,2022-02-21T17:08:35.927,33,False,0.0
2021,9,3195,225,28,8471,2,51,3,-4,7,11,5,2,5,0,False,False,False,0,1,2021-11-08T12:41:06.857,7,False,2.0
2021,9,3195,240,28,4922,13,12,5,-2,0,0,0,0,0,0,False,False,False,0,4,2021-11-08T12:47:46.96,0,False,
2021,9,3195,250,28,7619,2,5,5,5,11,6,8,3,8,0,False,False,False,0,3,2021-11-08T12:51:42.67,11,False,3.0
2021,9,3195,255,28,4922,2,6,10,8,14,6,12,2,12,0,False,False,False,0,3,2021-11-08T12:53:33.17,14,False,2.0
2021,9,3195,260,28,7619,2,8,7,16,22,6,22,0,22,0,False,True,True,0,3,2021-11-08T12:56:34.863,22,False,0.0
2021,9,3195,270,1,6405,2,35,8,37,50,13,46,4,46,0,False,False,False,0,3,2021-11-08T13:03:58.03,50,False,4.0
2021,9,3195,280,1,894,2,16,10,5,17,12,13,4,13,0,False,False,False,0,4,2021-11-11T14:15:20.957,17,False,4.0
2021,9,3195,290,1,8439,2,54,10,-3,6,9,5,1,5,0,False,False,False,0,1,2021-11-11T14:53:08.173,6,False,1.0
2021,9,3195,310,1,8439,2,50,9,-4,-2,2,-2,0,-2,0,False,False,False,0,3,2022-02-25T17:47:33.84,-2,False,0.0
2021,9,3195,340,28,8471,2,26,9,1,11,10,1,10,1,0,True,False,False,2,1,2021-11-11T15:02:49.84,11,False,10.0
2021,9,3195,350,28,262,2,5,5,10,10,0,10,0,10,0,False,False,False,0,4,2021-11-08T13:30:36.747,10,False,0.0
2021,9,3195,355,28,917,13,35,8,16,0,0,0,0,0,0,False,False,False,0,3,2021-11-08T13:32:45.89,0,False,
2021,9,3195,380,28,7619,2,5,7,16,16,0,16,0,16,0,False,False,False,0,3,2021-11-08T13:38:10.643,16,False,0.0
2021,9,3195,400,28,4922,2,5,3,6,6,0,6,0,6,6,False,False,False,0,4,2021-11-08T13:44:55.1,6,True,0.0
2021,9,3195,430,1,6933,2,12,7,15,25,10,17,8,17,0,False,False,False,1,3,2021-11-08T13:50:55.893,25,False,8.0
2021,9,3195,440,1,4587,2,48,10,-2,45,47,45,0,45,6,False,False,False,0,1,2021-11-08T13:57:47.18,45,True,0.0
2021,9,3195,465,28,917,13,4,8,20,0,0,0,0,0,0,True,False,False,0,2,2021-11-08T14:03:20.287,0,False,0.0
2021,9,3195,480,1,6933,2,49,3,-2,4,6,4,0,4,0,False,False,False,0,2,2021-11-08T14:10:17.823,4,False,0.0
2021,9,3195,485,1,8439,2,4,10,4,4,0,4,0,4,0,False,False,False,0,3,2021-11-08T14:11:42.557,4,False,0.0
2021,9,3195,490,1,894,2,51,9,-2,1,3,0,1,0,0,False,False,False,0,3,2021-11-08T14:12:53.873,1,False,1.0
2021,9,3195,500,1,4587,2,48,9,-2,5,7,-1,6,-1,0,False,False,False,1,1,2021-11-08T14:15:23.533,5,False,6.0
2021,9,3195,520,28,7224,2,45,5,-2,5,7,4,1,4,0,True,False,False,0,3,2022-02-21T17:09:22.557,5,False,1.0
2021,9,3195,525,28,7619,2,6,4,12,19,7,17,2,17,0,False,False,False,0,3,2021-11-11T16:06:05.02,19,False,2.0
2021,9,3195,530,28,4922,2,29,6,29,29,0,29,0,29,0,True,False,False,0,3,2021-11-08T14:22:55.963,29,False,0.0
2021,9,3195,540,28,7751,2,26,10,1,1,0,1,0,1,0,False,False,False,0,1,2021-11-11T14:15:20.957,1,False,0.0
2021,9,3195,545,28,7619,2,8,4,11,11,0,11,0,11,6,True,False,False,0,2,2021-11-08T14:27:24.597,11,True,0.0
2021,9,3195,585,1,894,3,46,3,1,0,0,0,0,0,0,True,False,False,0,4,2021-11-08T14:47:41.333,0,False,0.0
2021,9,3195,595,28,7224,2,50,9,-3,32,35,21,11,21,0,False,False,False,1,3,2021-11-08T14:50:27.143,32,False,11.0
2021,9,3195,600,28,7224,13,19,2,26,0,0,0,0,0,0,False,False,False,0,3,2021-11-08T14:52:26.13,0,False,0.0
2021,9,3195,605,28,8471,2,48,10,-4,7,11,-3,10,-3,0,False,False,False,1,1,2021-11-08T14:53:43.54,7,False,10.0
2021,9,3195,615,28,7619,2,2,10,6,10,4,8,2,8,0,False,False,False,0,2,2021-11-08T14:55:53.687,10,False,2.0
2021,9,3195,630,28,4922,13,5,10,11,0,0,0,0,0,0,False,False,False,0,3,2021-11-08T14:59:44.737,0,False,0.0
2021,9,3195,660,28,4922,2,6,4,14,15,1,15,0,15,0,False,False,False,0,4,2021-11-11T15:09:33.607,15,False,0.0
2021,9,3195,665,28,8471,2,4,10,0,6,6,5,1,5,0,False,False,False,0,1,2021-11-08T15:08:36.857,6,False,1.0
2021,9,3195,670,28,917,2,5,3,5,5,0,5,0,5,0,False,False,False,0,3,2021-11-08T15:09:56.82,5,False,0.0
2021,9,3195,675,28,917,13,12,5,6,0,0,0,0,0,0,False,False,False,0,3,2021-11-08T15:12:01.957,0,False,
2021,9,3195,680,28,917,3,6,9,9,0,0,0,0,0,0,False,False,False,0,3,2021-11-08T15:15:33.547,0,False,0.0
2021,9,3195,685,28,8471,2,16,9,7,12,5,10,2,10,0,False,False,False,0,1,2021-11-08T15:17:40.54,12,False,2.0
2021,9,3195,710,1,6405,2,5,10,5,5,0,5,0,5,0,True,False,False,0,3,2021-11-08T15:23:58.467,5,False,0.0
2021,9,3195,715,1,8439,2,4,9,2,9,7,8,1,8,0,False,False,False,0,3,2021-11-08T15:25:36.013,9,False,1.0
2021,9,3195,730,1,4587,2,2,9,2,6,4,2,4,2,0,True,False,False,1,3,2021-11-08T15:32:51.48,6,False,4.0
2021,9,3195,740,1,6405,2,49,5,-1,0,1,-1,1,-1,0,False,False,False,0,2,2021-11-11T15:34:03.503,0,False,1.0
2021,9,3195,785,28,7751,2,26,9,1,5,4,3,2,3,0,False,False,False,0,1,2021-11-08T15:44:47.607,5,False,2.0
2021,9,3195,790,28,7619,13,19,6,22,0,0,0,0,0,0,False,False,False,0,2,2021-11-08T15:46:04.32,0,False,0.0
2021,9,3195,795,28,7224,13,6,4,14,0,0,0,0,0,0,False,False,False,0,2,2021-11-11T15:11:08.537,0,False,0.0
2021,9,3195,825,28,7224,2,52,4,2,3,1,3,0,3,0,False,False,False,0,2,2021-11-11T14:15:20.957,3,False,0.0
2021,9,3195,830,28,7751,13,28,10,-3,0,0,0,0,0,0,False,False,False,0,1,2021-11-08T15:55:58.12,0,False,0.0
2021,9,3195,835,28,7224,2,2,10,6,7,1,6,1,6,0,False,False,False,0,2,2021-11-08T15:57:19.097,7,False,1.0
2021,9,3195,840,28,7751,2,16,9,4,5,1,5,0,5,0,False,False,False,0,1,2021-11-08T15:58:32.013,5,False,0.0
2021,9,3196,15,29,4866,2,5,3,4,8,4,7,1,7,0,False,False,False,0,3,2021-11-08T10:25:18.413,8,False,1.0
2021,9,3196,25,29,1958,2,45,5,-3,14,17,10,4,10,0,True,False,False,0,3,2021-11-11T18:54:55.757,14,False,4.0
2021,9,3196,55,31,6793,2,2,10,9,15,6,13,2,13,0,False,False,False,0,2,2021-11-11T18:40:20.47,15,False,2.0
2021,9,3196,65,31,6793,13,5,2,17,0,0,0,0,0,0,False,False,False,0,2,2021-11-11T18:40:46.793,0,False,0.0
2021,9,3196,75,29,4866,2,39,4,7,12,5,9,3,9,0,False,False,False,0,3,2021-11-08T10:41:19.657,12,False,3.0
2021,9,3196,85,29,4866,13,5,6,24,0,0,0,0,0,0,False,False,False,0,3,2021-12-04T15:35:59.763,0,False,0.0
2021,9,3196,105,29,4866,2,4,3,4,4,0,4,0,4,0,False,False,False,0,3,2021-11-08T10:48:01.17,4,False,0.0
2021,9,3196,110,29,1958,13,2,10,7,0,0,0,0,0,0,False,False,False,0,2,2021-11-08T10:49:03.65,0,False,0.0
2021,9,3196,125,31,792,2,48,3,-3,5,8,3,2,3,0,False,False,False,0,1,2021-11-08T10:52:08.643,5,False,2.0
2021,9,3196,135,31,4545,2,49,3,-3,-3,0,-3,0,-3,0,True,False,False,0,2,2021-11-08T10:53:49.83,-3,False,0.0
2021,9,3196,150,29,7378,2,48,3,-6,0,6,-1,1,-1,0,True,False,False,0,1,2021-11-08T10:57:43.223,0,False,1.0
2021,9,3196,155,29,7378,13,48,10,-3,0,0,0,0,0,0,False,False,False,0,1,2021-11-08T10:59:40.587,0,False,0.0
2021,9,3196,160,29,1958,13,6,8,23,0,0,0,0,0,0,False,False,False,0,2,2021-11-11T19:15:16.09,0,False,0.0
2021,9,3196,170,31,6724,2,26,5,-1,7,8,5,2,5,0,False,False,False,0,4,2021-11-08T11:04:20.9,7,False,2.0
2021,9,3196,185,31,6793,3,5,5,12,0,0,0,0,0,0,True,False,False,0,3,2021-11-09T17:46:54.92,0,False,0.0
2021,9,3196,205,29,3398,2,46,3,3,7,4,6,1,6,0,True,False,False,0,4,2021-11-08T11:10:29.89,7,False,1.0
2021,9,3196,210,29,4866,13,6,10,-2,0,0,0,0,0,0,False,False,False,0,2,2021-11-08T16:11:27.523,0,False,0.0
2021,9,3196,215,31,2865,2,7,3,2,2,0,2,0,2,6,False,False,False,0,4,2021-11-08T11:15:47.16,2,True,0.0
2021,9,3196,230,29,1958,13,5,5,3,0,0,0,0,0,0,False,False,False,0,3,2021-11-10T00:34:59.373,0,False,0.0
2021,9,3196,255,29,7378,2,45,5,-5,1,6,1,0,1,0,False,False,False,0,1,2021-11-08T11:56:17.847,1,False,0.0
2021,9,3196,270,31,661,2,4,3,10,10,0,10,0,10,0,False,False,False,0,2,2021-11-08T11:58:44.593,10,False,0.0
2021,9,3196,290,31,7913,2,2,4,8,14,6,13,1,13,0,False,False,False,0,3,2021-11-08T16:21:03.483,14,False,1.0
2021,9,3196,300,31,6793,2,49,5,-1,1,2,-1,2,-1,0,False,False,False,1,2,2021-11-08T12:04:19.993,1,False,2.0
2021,9,3196,310,31,3911,13,13,4,3,0,0,0,0,0,0,False,False,False,0,3,2021-11-08T12:07:04.3,0,False,0.0
2021,9,3196,315,31,661,2,18,5,-1,8,9,1,7,1,0,False,False,False,1,2,2021-11-08T16:17:37.38,8,False,7.0
2021,9,3196,335,31,6793,13,11,5,1,0,0,0,0,0,0,False,False,False,0,3,2022-02-21T15:46:16.377,0,False,0.0
2021,9,3196,360,29,3398,2,2,4,7,10,3,9,1,9,0,True,False,False,0,3,2021-11-11T19:27:06.7,10,False,1.0
2021,9,3196,375,29,4866,2,50,9,-3,6,9,5,1,5,0,False,False,False,0,2,2021-11-08T12:37:08.11,6,False,1.0
2021,9,3196,385,29,1958,13,35,3,11,0,0,0,0,0,0,False,False,False,0,3,2021-11-08T12:38:36.21,0,False,0.0
2021,9,3196,410,31,6793,2,13,10,1,3,2,3,0,3,0,False,False,False,0,3,2021-11-08T12:42:58.667,3,False,0.0
2021,9,3196,415,31,4545,2,32,10,-3,5,8,4,1,4,0,False,False,False,0,1,2021-11-08T12:44:34.303,5,False,1.0
2021,9,3196,430,31,4545,2,48,10,-3,9,12,8,1,8,0,False,False,False,0,1,2021-11-08T12:46:28.86,9,False,1.0
2021,9,3196,450,31,2865,2,46,3,2,9,7,9,0,9,0,False,False,False,0,1,2021-11-08T13:05:10.937,9,False,0.0
2021,9,3196,460,31,6793,13,35,6,15,0,0,0,0,0,0,True,False,False,0,3,2021-11-08T13:07:14.027,0,False,0.0
2021,9,3196,470,31,6793,3,4,9,5,0,0,0,0,0,0,False,False,False,0,3,2021-11-08T13:09:47.963,0,False,0.0
2021,9,3196,480,29,1958,2,5,3,8,18,10,17,1,17,0,False,False,False,0,3,2021-11-08T13:11:24.32,18,False,1.0
2021,9,3196,495,29,7828,2,4,9,10,20,10,18,2,18,0,False,False,False,0,3,2021-11-08T13:15:14.857,20,False,2.0
2021,9,3196,505,29,7828,13,23,1,40,0,0,0,0,0,0,False,False,False,0,3,2021-11-11T19:28:22.8,0,False,
2021,9,3196,515,29,3398,2,53,10,1,26,25,20,6,20,0,False,False,False,0,4,2021-11-08T13:20:56.863,26,False,6.0
2021,9,3196,520,29,7828,2,35,9,12,15,3,13,2,13,0,False,False,False,0,3,2021-11-08T13:22:49.257,15,False,2.0
2021,9,3196,525,29,7828,13,9,3,4,0,0,0,0,0,0,False,False,False,0,2,2021-11-11T18:38:57.583,0,False,0.0
2021,9,3196,530,29,7828,13,12,10,4,0,0,0,0,0,0,False,False,False,0,2,2022-02-21T15:29:21.373,0,False,0.0
2021,9,3196,535,29,3398,13,12,9,4,0,0,0,0,0,0,False,False,False,0,3,2022-02-21T15:47:42.187,0,True,0.0
2021,9,3196,555,31,661,2,50,10,-2,4,6,2,2,2,0,False,False,False,0,3,2021-11-08T13:52:38.37,4,False,2.0
2021,9,3196,565,31,6793,2,3,3,7,7,0,7,0,7,0,False,False,False,0,3,2021-11-11T18:00:29.333,7,False,0.0
2021,9,3196,575,29,1958,2,31,9,4,6,2,6,0,6,0,False,False,False,0,3,2021-11-08T13:56:40.147,6,False,0.0
2021,9,3196,585,29,4866,2,13,9,4,17,13,17,0,17,0,False,False,False,0,3,2021-11-08T13:58:20.72,17,False,0.0
2021,9,3196,590,29,3398,13,32,5,3,0,0,0,0,0,0,False,False,False,0,4,2021-11-11T19:30:30.743,0,False,0.0
2021,9,3196,595,29,7828,2,50,10,1,6,5,2,4,2,0,False,False,False,0,2,2021-11-08T14:00:22.157,6,False,4.0
2021,9,3196,600,29,6266,2,12,5,-2,3,5,2,1,2,0,False,False,False,0,1,2022-02-24T16:08:13.083,3,False,1.0
2021,9,3196,610,29,4866,2,39,4,4,4,0,4,0,4,0,False,False,False,0,3,2021-11-08T14:03:49.243,4,False,0.0
2021,9,3196,645,31,2865,2,53,9,-3,11,14,6,5,6,0,False,False,False,0,4,2021-11-08T14:32:02.697,11,False,5.0
2021,9,3196,655,31,2865,2,5,5,3,7,4,5,2,5,0,False,False,False,0,3,2021-11-08T14:34:06.253,7,False,2.0
2021,9,3196,660,31,661,2,4,10,9,13,4,11,2,11,0,False,False,False,0,3,2021-11-08T14:35:33.647,13,False,2.0
2021,9,3196,675,31,6793,13,26,9,5,0,0,0,0,0,0,False,False,False,0,3,2021-11-08T14:37:40.13,0,False,0.0
2021,9,3196,690,29,4866,2,5,9,5,9,4,8,1,8,0,False,False,False,0,3,2021-11-08T14:42:13.207,9,False,1.0
2021,9,3196,695,29,7828,13,22,7,19,0,0,0,0,0,0,False,False,False,0,3,2022-02-25T15:42:09.567,0,False,0.0
2021,9,3196,705,29,1958,2,4,10,13,22,9,22,0,22,0,False,False,False,1,2,2021-11-11T19:02:50.08,22,False,0.0
2021,9,3196,710,29,1958,2,4,10,13,13,0,13,0,13,0,False,False,False,0,2,2021-11-11T19:31:48.617,13,False,0.0
2021,9,3196,715,29,3398,13,17,8,24,0,0,0,0,0,0,False,False,False,0,3,2021-11-08T14:48:38.753,0,False,0.0
2021,9,3196,720,29,4866,2,4,10,3,7,4,5,2,5,0,True,False,False,1,1,2021-11-11T19:44:24.533,7,False,2.0
2021,9,3196,725,29,7378,2,13,10,0,2,2,1,1,1,0,True,False,False,0,3,2021-11-08T14:51:03.393,2,False,1.0
2021,9,3196,730,29,7828,13,35,9,12,0,0,0,0,0,0,False,False,False,0,3,2021-11-08T14:54:22.067,0,False,0.0
2021,9,3196,755,31,2901,2,12,10,-4,-4,0,-4,0,-4,0,False,False,False,0,4,2021-11-08T14:59:37.953,-4,False,
2021,9,3196,760,31,6793,2,6,9,14,16,2,15,1,15,0,True,False,False,0,3,2021-11-08T15:02:00.883,16,False,1.0
2021,9,3196,800,29,4866,2,51,9,-5,13,18,5,8,5,0,True,False,False,0,1,2022-02-21T15:32:42.23,13,False,8.0
2021,9,3196,805,29,3398,2,47,5,3,3,0,3,0,3,0,False,False,False,0,3,2021-11-08T15:48:23.38,3,False,0.0
2021,9,3196,810,29,1958,2,8,1,16,16,0,16,0,16,0,False,False,False,0,2,2021-11-11T18:00:29.333,16,False,0.0
2021,9,3196,815,29,3398,2,5,5,5,5,0,5,0,5,0,False,False,False,0,3,2021-11-08T15:53:04.203,5,True,0.0
2021,9,3196,820,29,4866,2,4,10,5,9,4,8,1,8,0,False,False,False,0,3,2021-11-08T15:54:00.537,9,False,1.0
2021,9,3196,840,29,4866,2,51,9,-2,6,8,5,1,5,0,False,False,False,0,3,2021-11-08T15:56:14.897,6,False,1.0
2021,9,3196,845,29,4866,13,6,4,4,0,0,0,0,0,0,False,False,False,0,3,2021-11-08T15:57:22.23,0,False,0.0
2021,9,3196,850,29,6266,13,45,5,-6,0,0,0,0,0,0,False,False,False,0,1,2021-11-11T19:34:56.26,0,False,0.0
2021,9,3196,855,29,1958,2,5,5,9,9,0,9,0,9,0,False,False,False,0,3,2021-11-08T15:59:34.09,9,True,0.0
2021,9,3196,875,29,3398,13,12,5,2,0,0,0,0,0,0,False,False,False,0,4,2021-11-08T16:02:30.927,0,False,0.0
2021,9,3196,885,29,1958,13,8,4,7,0,0,0,0,0,0,False,False,False,0,3,2021-11-11T18:47:36.74,0,False,
2021,9,3196,890,29,6266,2,12,4,3,3,0,3,0,3,6,False,False,False,0,1,2021-11-08T16:05:40.43,3,True,0.0
2021,9,3197,20,6,464,2,4,9,3,3,0,3,0,3,0,True,False,False,0,3,2021-11-09T10:41:12.55,3,False,0.0
2021,9,3197,30,25,7666,13,4,5,5,0,0,0,0,0,0,False,False,False,0,3,2021-11-09T10:42:41.12,0,False,
2021,9,3197,40,25,7060,2,49,3,-1,2,3,2,0,2,0,False,False,False,0,2,2021-11-09T10:46:58.92,2,False,0.0
2021,9,3197,45,25,7666,2,19,2,23,26,3,24,2,24,0,False,False,False,0,2,2021-11-09T10:49:15.24,26,False,2.0
2021,9,3197,90,6,464,2,5,6,16,16,0,16,0,16,0,False,False,False,0,2,2021-11-09T11:18:06.55,16,True,
2021,9,3197,95,6,1378,13,19,2,41,0,0,0,0,0,0,False,False,False,0,2,2021-11-09T16:31:39.203,0,False,0.0
2021,9,3197,100,6,6786,2,28,4,6,6,0,6,0,6,0,False,False,False,0,1,2021-11-09T11:23:25.813,6,False,0.0
2021,9,3197,110,25,8422,13,6,9,5,0,0,0,0,0,0,False,False,False,0,3,2021-11-09T11:32:37.437,0,False,0.0
2021,9,3197,115,25,8422,2,55,4,-2,9,11,5,4,5,0,True,False,False,0,4,2021-11-10T18:40:23.817,9,False,4.0
2021,9,3197,135,25,6486,13,4,4,7,0,0,0,0,0,0,False,False,False,0,3,2021-11-09T11:36:18.68,0,False,0.0
2021,9,3197,165,6,7725,13,4,4,-6,0,0,0,0,0,0,False,False,False,0,3,2021-11-11T21:19:41.64,0,False,0.0
2021,9,3197,200,25,7060,2,29,3,9,11,2,9,2,9,0,False,False,False,0,2,2021-11-09T11:58:15.913,11,False,2.0
2021,9,3197,205,25,7666,2,2,10,2,5,3,5,0,5,0,False,False,False,1,2,2021-11-11T21:58:12.183,5,False,
2021,9,3197,210,25,7666,13,2,10,4,0,0,0,0,0,0,False,False,False,0,2,2021-11-09T12:01:14.307,0,False,0.0
2021,9,3197,225,25,8422,2,12,3,4,4,0,4,0,4,6,True,False,False,0,3,2021-11-10T18:40:45.387,4,True,0.0
2021,9,3197,245,6,1378,13,6,4,13,0,0,0,0,0,0,False,False,False,0,3,2021-11-09T12:11:19.1,0,False,0.0
2021,9,3197,260,25,7666,2,50,9,-2,0,2,-1,1,-1,0,False,False,False,0,2,2021-11-09T12:14:11.54,0,False,1.0
2021,9,3197,275,25,8422,2,28,10,-2,7,9,7,0,7,0,False,False,False,0,4,2021-11-09T12:20:17.637,7,False,0.0
2021,9,3197,285,6,7728,2,7,6,24,25,1,25,0,25,0,False,False,False,0,4,2021-11-11T22:51:13.67,25,True,0.0
2021,9,3197,300,6,4305,2,12,5,8,15,7,8,7,8,0,False,False,False,1,3,2021-11-11T21:58:34.42,15,False,
2021,9,3197,305,6,7728,13,17,1,30,0,0,0,0,0,0,False,False,False,0,3,2022-02-21T17:04:24.31,0,False,0.0
2021,9,3197,315,25,4227,2,55,4,-2,3,5,1,2,1,0,False,False,False,0,4,2021-11-09T12:33:24.577,3,False,2.0
2021,9,3197,325,25,7073,2,32,10,-2,1,3,0,1,0,0,False,False,False,0,4,2021-11-09T12:37:51.46,1,False,1.0
2021,9,3197,375,6,7728,2,4,4,8,8,0,8,0,8,0,False,False,False,0,3,2021-11-09T12:50:23.643,8,False,0.0
2021,9,3197,380,6,7728,2,17,1,18,21,3,21,0,21,0,False,False,False,0,3,2021-11-09T12:52:06.977,21,False,0.0
2021,9,3197,400,6,666,13,29,5,7,0,0,0,0,0,0,False,False,False,0,2,2021-11-09T12:55:10.787,0,False,0.0
2021,9,3197,410,6,666,13,9,3,12,0,0,0,0,0,0,False,False,False,0,2,2021-11-11T22:23:32.533,0,False,0.0
2021,9,3197,440,25,7060,2,18,5,-5,-5,0,-5,0,-5,0,False,False,False,0,2,2021-11-11T22:52:16.5,-5,False,
2021,9,3197,450,25,8421,2,47,5,-1,3,4,-1,4,-1,0,False,False,False,1,1,2021-11-09T13:12:00.34,3,False,4.0
2021,9,3197,455,25,6486,13,12,9,8,0,0,0,0,0,0,False,False,False,0,3,2021-11-09T13:13:26.587,0,False,0.0
2021,9,3197,470,6,7725,13,5,3,7,0,0,0,0,0,0,False,False,False,0,3,2021-11-09T13:17:39.147,0,False,0.0
2021,9,3197,475,6,464,2,12,3,10,17,7,15,2,15,0,False,False,False,0,3,2021-11-09T13:19:28.523,17,False,2.0
2021,9,3197,485,6,1378,2,7,2,46,50,4,49,1,49,0,False,False,False,0,3,2021-11-11T22:23:44.103,50,False,1.0
2021,9,3197,490,6,7728,2,12,10,10,10,0,10,0,10,0,True,False,False,0,3,2021-11-10T19:08:41.593,10,False,0.0
2021,9,3197,500,6,666,2,7,5,1,1,0,1,0,1,6,False,False,False,0,4,2021-11-09T13:31:11.68,1,True,
2021,9,3197,510,6,6786,2,48,10,-6,11,17,8,3,8,0,False,False,False,0,1,2021-11-09T13:34:48.797,11,False,3.0
2021,9,3197,525,25,6486,2,17,8,42,42,0,42,0,42,0,False,False,False,0,3,2021-11-11T22:23:56.593,42,False,0.0
2021,9,3197,565,25,7666,13,12,4,10,0,0,0,0,0,0,False,False,False,0,3,2021-11-09T13:47:36.673,0,False,0.0
2021,9,3197,570,25,8422,2,29,5,10,10,0,10,0,10,6,False,False,False,0,3,2021-11-09T13:50:17.837,10,True,0.0
2021,9,3197,595,6,7725,2,4,7,20,20,0,20,0,20,0,False,False,False,0,2,2021-11-09T13:56:03.95,20,False,0.0
2021,9,3197,610,6,666,2,17,7,23,28,5,23,5,23,0,False,False,False,0,4,2021-11-09T13:59:18.653,28,False,5.0
2021,9,3197,630,25,7060,13,19,6,28,0,0,0,0,0,0,False,False,False,0,2,2021-11-11T22:58:20.847,0,False,
2021,9,3197,635,25,8421,2,55,4,-2,9,11,2,7,2,0,False,False,False,1,1,2021-11-11T21:58:57.21,9,False,7.0
2021,9,3197,665,25,7060,13,4,9,7,0,0,0,0,0,0,False,False,False,0,2,2021-11-09T14:23:01.823,0,False,
2021,9,3197,690,25,7060,13,5,5,13,0,0,0,0,0,0,False,False,False,0,3,2021-11-09T14:35:53.233,0,False,0.0
2021,9,3197,700,6,464,13,4,7,20,0,0,0,0,0,0,False,False,False,0,2,2021-11-11T22:24:12.537,0,False,0.0
2021,9,3197,705,6,7725,2,5,5,5,5,0,5,0,5,0,False,False,False,0,3,2021-11-11T22:24:30.433,5,False,0.0
2021,9,3197,735,25,7666,2,2,10,1,4,3,2,2,2,0,False,False,False,0,2,2021-11-09T14:51:31.4,4,False,2.0
2021,9,3197,745,25,7060,2,5,5,10,10,0,10,0,10,0,False,False,False,0,3,2021-11-09T14:55:01.323,10,False,0.0
2021,9,3197,750,25,6277,2,51,3,-2,2,4,0,2,0,0,True,False,False,0,1,2021-11-09T14:58:24.437,2,False,2.0
2021,9,3197,755,25,7060,13,2,9,3,0,0,0,0,0,0,False,False,False,0,2,2021-11-09T16:32:30.207,0,False,0.0
2021,9,3197,780,25,7060,2,26,3,1,11,10,10,1,10,0,False,False,False,1,2,2021-11-09T15:14:01.907,11,False,1.0
2021,9,3197,800,6,464,2,4,3,10,9,-1,9,0,9,0,False,False,False,0,3,2021-11-09T15:18:33.643,9,False,0.0
2021,9,3197,805,6,7725,13,24,2,53,0,0,0,0,0,0,False,False,False,0,2,2022-02-21T17:05:28.687,0,False,0.0
2021,9,3197,815,6,464,13,6,9,14,0,0,0,0,0,0,False,False,False,0,3,2021-11-11T22:58:39.087,0,False,0.0
2021,9,3197,830,6,464,2,9,2,28,39,11,38,1,38,0,False,False,False,0,3,2021-11-09T15:28:51.857,39,False,1.0
2021,9,3197,835,6,7725,2,12,6,16,16,0,16,0,16,6,False,False,False,0,3,2021-11-09T15:31:01.157,16,True,0.0
2021,9,3197,855,25,8421,2,47,10,0,4,4,2,2,2,0,False,False,False,1,1,2021-11-11T22:29:46.863,4,False,2.0
2021,9,3197,860,25,6259,2,26,9,2,12,10,12,0,12,0,False,False,False,0,3,2021-11-09T15:44:15.76,12,True,0.0
2021,9,3197,865,25,8421,2,4,4,2,4,2,4,0,4,0,False,False,False,0,1,2021-11-11T22:30:17.32,4,False,
2021,9,3197,870,25,7060,2,2,10,5,22,17,22,0,22,0,False,False,False,0,2,2021-11-09T15:48:49.047,22,False,0.0
2021,9,3197,880,25,8422,2,5,3,13,13,0,13,0,13,0,False,False,False,0,3,2021-11-09T15:51:50.3,13,False,0.0
2021,9,3197,910,6,7728,13,32,5,-1,0,0,0,0,0,0,False,False,False,0,3,2021-11-11T22:24:57.353,0,False,0.0
2021,9,3197,915,6,6786,2,32,3,5,7,2,7,0,7,0,False,False,False,0,4,2021-11-11T22:53:27.33,7,True,
2021,9,3197,920,6,7728,2,5,3,8,11,3,11,0,11,0,False,False,False,0,3,2021-11-09T16:01:58.517,11,True,0.0
2021,9,3197,925,6,7728,2,5,5,10,12,2,12,0,12,0,False,False,False,0,2,2021-11-11T22:25:08.09,12,False,0.0
2021,9,3197,930,6,1378,13,5,5,5,0,0,0,0,0,0,False,False,False,0,2,2021-11-09T16:05:38.08,0,False,0.0
2021,10,3198,20,3,8430,2,4,3,7,7,0,7,0,7,0,False,False,False,0,2,2021-11-12T10:25:16.163,7,False,0.0
2021,10,3198,40,3,6936,2,3,3,4,4,0,4,0,4,0,True,False,False,0,3,2021-11-18T14:37:13.097,4,False,0.0
2021,10,3198,50,3,121,13,8,1,28,0,0,0,0,0,0,False,False,False,0,2,2021-11-18T21:42:19.93,0,False,0.0
2021,10,3198,70,17,364,2,50,10,-1,16,17,0,16,0,0,False,False,False,2,2,2021-11-18T21:42:38.373,16,False,16.0
2021,10,3198,75,17,6274,13,29,6,24,0,0,0,0,0,0,False,False,False,0,3,2021-11-12T10:56:11.143,0,False,0.0
2021,10,3198,95,3,7672,2,51,5,-2,11,13,8,3,8,0,True,False,False,0,2,2021-11-18T21:42:55.807,11,False,3.0
2021,10,3198,110,3,6454,2,4,8,15,15,0,15,0,15,0,False,False,False,0,3,2021-11-18T21:43:20.553,15,False,0.0
2021,10,3198,125,3,6936,2,51,3,-2,7,9,5,2,5,0,True,True,False,0,3,2021-11-12T11:21:27.987,7,False,2.0
2021,10,3198,145,17,6274,13,13,9,7,0,0,0,0,0,0,True,False,False,0,2,2021-11-18T15:18:45.937,0,False,0.0
2021,10,3198,155,3,6936,13,35,6,22,0,0,0,0,0,0,False,False,False,0,3,2021-11-18T16:56:38.483,0,False,0.0
2021,10,3198,160,3,6936,2,5,3,3,5,2,4,1,4,0,False,False,False,0,3,2021-11-12T11:38:12.8,5,False,1.0
2021,10,3198,190,17,6274,13,4,4,6,0,0,0,0,0,0,False,False,False,0,3,2021-11-12T11:48:34.707,0,False,0.0
2021,10,3198,205,3,6936,13,4,10,10,0,0,0,0,0,0,False,False,False,0,3,2021-11-18T21:40:05.233,0,False,0.0
2021,10,3198,210,3,713,2,45,10,-3,6,9,5,1,5,0,True,False,False,0,1,2021-11-12T11:58:55.863,6,False,1.0
2021,10,3198,220,17,7618,2,6,10,2,9,7,9,0,9,0,False,False,False,0,1,2021-11-18T21:40:13.387,9,False,0.0
2021,10,3198,230,17,8483,2,5,5,11,11,0,11,0,11,0,False,False,False,0,3,2021-11-12T12:14:57.95,11,False,0.0
2021,10,3198,240,17,4752,2,26,5,3,7,4,7,0,7,0,False,False,False,0,3,2021-11-12T12:24:26.757,7,False,0.0
2021,10,3198,245,17,4484,2,17,1,21,21,0,21,0,21,0,False,False,False,0,4,2021-11-12T12:26:39.893,21,False,0.0
2021,10,3198,255,17,6274,13,6,10,13,0,0,0,0,0,0,False,False,False,0,3,2021-11-18T14:37:13.143,0,False,0.0
2021,10,3198,260,17,4484,2,53,10,-5,2,7,1,1,1,0,False,False,False,0,4,2021-11-12T12:34:28.917,2,False,1.0
2021,10,3198,265,17,7087,13,9,5,13,0,0,0,0,0,0,False,False,False,0,2,2021-11-12T12:36:47.637,0,False,0.0
2021,10,3198,280,3,6454,2,4,9,9,13,4,13,0,13,0,False,False,False,0,3,2021-11-12T12:43:57.19,13,False,0.0
2021,10,3198,290,3,6936,13,51,10,-1,0,0,0,0,0,0,False,False,False,0,3,2021-11-12T12:48:33.913,0,False,0.0
2021,10,3198,295,3,6936,2,49,5,-1,3,4,3,0,3,0,False,False,False,0,2,2021-11-12T12:50:33.193,3,False,0.0
2021,10,3198,310,17,8483,13,5,3,5,0,0,0,0,0,0,False,False,False,0,3,2021-11-12T12:58:50.187,0,False,0.0
2021,10,3198,315,17,8483,2,26,5,3,6,3,4,2,4,0,False,False,False,0,3,2021-11-12T13:01:02.827,6,False,2.0
2021,10,3198,335,17,8483,13,9,2,22,0,0,0,0,0,0,False,False,False,0,2,2022-02-16T20:16:05.56,0,False,0.0
2021,10,3198,345,3,6936,2,50,5,-3,11,14,9,2,9,0,False,False,False,0,3,2021-11-12T13:12:35.997,11,False,2.0
2021,10,3198,355,3,6936,13,4,5,4,0,0,0,0,0,0,False,False,False,0,2,2021-11-12T13:16:16.983,0,False,0.0
2021,10,3198,380,17,4752,2,3,2,15,19,4,19,0,19,0,False,False,False,0,2,2021-11-12T14:32:08.46,19,False,0.0
2021,10,3198,390,17,7051,2,28,10,-4,2,6,2,0,2,0,False,False,False,0,1,2021-11-12T14:32:47.683,2,False,0.0
2021,10,3198,395,17,4752,2,19,2,24,52,28,42,10,42,0,False,False,False,1,2,2021-11-12T14:33:18.69,52,False,10.0
2021,10,3198,405,17,4484,2,5,5,11,11,0,11,0,11,0,False,False,False,0,4,2021-11-12T14:33:49.273,11,False,0.0
2021,10,3198,410,17,7087,13,9,5,4,0,0,0,0,0,0,False,False,False,0,2,2021-11-12T14:34:18.923,0,False,0.0
2021,10,3198,420,17,4484,13,4,10,4,0,0,0,0,0,0,True,False,False,0,4,2021-11-12T14:34:43.12,0,False,0.0
2021,10,3198,455,17,7024,3,4,3,6,0,0,0,0,0,0,False,False,False,0,2,2022-02-16T20:17:06.153,0,False,0.0
2021,10,3198,485,3,6936,13,12,2,42,0,0,0,0,0,0,False,False,False,0,3,2022-02-16T20:18:04.767,0,False,0.0
2021,10,3198,500,17,8483,2,5,5,6,9,3,6,3,6,0,False,False,False,0,3,2021-11-12T14:22:42.867,9,False,3.0
2021,10,3198,510,17,6274,13,6,4,3,0,0,0,0,0,0,False,False,False,0,3,2021-11-12T14:30:53.907,0,False,0.0
2021,10,3198,515,17,6274,13,5,3,11,0,0,0,0,0,0,False,False,False,0,3,2021-11-12T14:30:29.547,0,False,0.0
2021,10,3198,530,3,713,2,4,9,4,9,5,5,4,5,0,False,False,False,0,1,2021-11-12T14:41:29.867,9,False,4.0
2021,10,3198,540,3,8430,2,2,10,5,9,4,7,2,7,0,False,False,False,0,2,2021-11-12T14:45:05.43,9,False,2.0
2021,10,3198,565,17,364,2,13,10,2,1,-1,1,0,1,0,False,False,False,0,2,2021-11-18T21:44:16.427,1,False,0.0
2021,10,3198,570,17,364,2,2,5,5,6,1,5,1,5,0,False,False,False,0,2,2021-11-18T16:27:43.673,6,False,1.0
2021,10,3198,575,17,364,13,35,10,7,0,0,0,0,0,0,False,False,False,0,2,2021-11-18T21:44:39.767,0,False,0.0
2021,10,3198,585,3,6454,2,5,5,4,11,7,5,6,5,0,False,False,False,1,3,2021-11-18T16:29:36.937,11,False,6.0
2021,10,3198,595,3,6454,13,4,9,14,0,0,0,0,0,0,False,False,False,0,3,2021-11-12T15:24:14.043,0,False,0.0
2021,10,3198,610,17,7024,2,12,3,-11,14,25,14,0,14,0,False,False,False,1,1,2021-11-18T15:22:31.837,14,False,0.0
2021,10,3198,615,17,7024,2,48,10,-5,10,15,10,0,10,0,False,False,False,0,1,2021-11-12T15:33:07.623,10,False,
2021,10,3198,620,17,8483,2,7,6,35,35,0,35,0,35,0,False,False,False,0,3,2021-11-12T15:36:26.89,35,False,0.0
2021,10,3198,640,17,8483,13,9,5,11,0,0,0,0,0,0,False,False,False,0,3,2021-11-12T15:55:31.9,0,False,
2021,10,3198,650,17,6274,13,17,4,1,0,0,0,0,0,0,True,False,False,0,3,2021-11-12T16:02:13.46,0,False,0.0
2021,10,3198,660,17,6274,13,13,3,6,0,0,0,0,0,0,True,False,False,0,3,2022-03-03T13:29:22.65,0,False,
2021,10,3198,665,17,7636,2,55,10,-6,5,11,5,0,5,0,False,False,False,0,5,2021-11-12T16:10:49.137,5,False,
2021,10,3198,670,17,4383,13,9,3,11,0,0,0,0,0,0,False,False,False,0,2,2021-11-12T16:15:03.04,0,False,0.0
2021,10,3198,685,3,6936,13,20,6,55,0,0,0,0,0,0,False,False,False,0,2,2021-11-12T18:00:20.527,0,False,
2021,10,3198,690,3,6936,13,5,2,16,0,0,0,0,0,0,False,False,False,0,2,2022-02-16T20:19:25.85,0,False,0.0
2021,10,3198,695,3,7672,2,34,4,-4,0,4,0,0,0,0,True,False,False,0,3,2021-11-12T16:25:25.56,0,False,0.0
2021,10,3198,700,3,121,2,2,10,6,8,2,8,0,8,0,False,True,True,0,2,2021-11-12T16:27:05.73,7,False,0.0
2021,10,3198,725,3,6816,13,47,5,1,0,0,0,0,0,0,False,False,False,0,3,2021-11-12T16:36:49.117,0,False,0.0
2021,10,3198,730,3,6936,3,2,10,3,0,0,0,0,0,0,False,False,False,0,2,2022-02-16T20:19:56.003,0,False,0.0
2021,10,3198,740,17,6276,2,30,9,0,23,23,21,2,21,0,True,False,False,0,4,2021-11-13T16:03:23.903,23,False,2.0
2021,10,3198,755,17,4752,2,13,4,6,6,0,6,0,6,0,False,False,False,0,2,2021-11-12T16:49:46.27,6,False,0.0
2021,10,3198,775,3,6936,2,5,3,7,7,0,7,0,7,0,False,False,False,0,2,2021-11-12T16:54:06.183,7,False,0.0
2021,10,3198,780,3,7672,13,12,3,8,0,0,0,0,0,0,False,False,False,0,3,2021-11-18T15:37:11.29,0,False,
2021,10,3198,785,3,7672,2,46,3,3,8,5,5,3,5,0,False,False,False,0,3,2021-11-18T14:37:13.223,8,False,3.0
2021,10,3198,795,3,6454,2,5,10,4,4,0,4,0,4,0,False,False,False,0,3,2021-11-12T17:01:28.52,4,False,0.0
2021,10,3198,800,3,8430,2,5,3,8,8,0,8,0,8,0,False,False,False,0,2,2021-11-18T16:32:35.563,8,True,0.0
2021,10,3198,805,3,8430,13,5,3,5,0,0,0,0,0,0,False,False,False,0,3,2021-11-12T17:05:48.743,0,False,0.0
2021,10,3198,815,3,6936,13,5,3,6,0,0,0,0,0,0,False,False,False,0,3,2021-11-12T18:00:56.117,0,False,
2021,10,3198,820,3,8430,2,5,3,6,20,14,6,14,6,0,False,False,False,1,2,2021-11-18T16:57:05.27,20,False,14.0
2021,10,3198,825,3,6454,2,35,4,5,5,0,5,0,5,6,False,False,False,0,4,2021-11-12T17:14:18.547,5,True,0.0
2021,10,3198,845,17,364,2,11,6,19,64,45,62,2,62,0,True,False,False,0,4,2021-11-12T17:54:25.613,64,False,2.0
2021,10,3198,905,3,713,2,4,4,6,8,2,8,0,8,0,False,False,False,0,1,2021-11-18T14:37:13.223,8,False,0.0
2021,10,3198,915,3,8430,2,19,6,25,30,5,27,3,27,0,False,False,False,0,2,2021-11-12T17:35:19.97,30,False,3.0
2021,10,3198,925,3,8430,2,5,3,6,6,0,6,0,6,0,False,False,False,0,3,2021-11-13T00:42:37.697,6,False,0.0
2021,10,3198,930,3,7672,2,35,9,9,9,0,9,0,9,0,False,False,False,0,3,2021-11-18T14:37:13.223,9,False,0.0
2021,10,3198,940,3,6454,2,13,10,4,15,11,10,5,10,0,False,False,False,1,3,2021-11-12T17:40:51.287,15,False,5.0
2021,10,3198,945,3,713,13,44,3,-1,0,0,0,0,0,0,True,False,False,0,1,2021-11-12T17:42:31.913,0,False,0.0
2021,10,3198,950,3,6454,13,12,10,7,0,0,0,0,0,0,False,False,False,0,3,2021-11-12T17:44:55.857,0,False,0.0
2021,10,3198,955,3,8430,13,5,10,7,0,0,0,0,0,0,False,False,False,0,3,2021-11-12T17:47:07.873,0,False,0.0
2021,10,3199,10,22,6812,2,51,5,-5,4,9,3,1,3,0,True,False,False,0,1,2021-11-15T10:00:32.68,4,False,1.0
2021,10,3199,15,22,4997,13,2,4,9,0,0,0,0,0,0,False,False,False,0,3,2021-11-15T10:06:26.133,0,False,0.0
2021,10,3199,20,22,8451,13,11,3,6,0,0,0,0,0,0,False,False,False,0,1,2021-11-18T19:00:28.007,0,False,0.0
2021,10,3199,30,4,2853,13,29,2,35,0,0,0,0,0,0,False,False,False,0,2,2022-02-17T23:01:05.743,0,False,0.0
2021,10,3199,35,4,213,2,4,3,5,11,6,8,3,8,0,False,False,False,0,2,2022-02-16T20:30:34.197,11,False,3.0
2021,10,3199,40,4,6953,2,13,3,2,17,15,14,3,14,0,True,False,False,0,3,2021-11-15T10:22:25.197,17,False,3.0
2021,10,3199,50,4,4913,2,12,6,15,15,0,15,0,15,6,False,False,False,0,1,2022-02-24T16:19:03.783,15,True,0.0
2021,10,3199,70,22,8451,13,46,3,2,0,0,0,0,0,0,False,False,False,0,3,2021-11-18T18:42:28.687,0,False,0.0
2021,10,3199,75,22,6270,2,6,5,6,6,0,6,0,6,0,False,False,False,0,2,2021-11-18T21:24:54.823,6,False,0.0
2021,10,3199,80,22,8454,13,9,6,25,0,0,0,0,0,0,False,False,False,0,2,2021-11-18T18:12:11.7,0,False,
2021,10,3199,85,22,6812,2,16,4,3,7,4,6,1,6,0,False,False,False,0,1,2021-11-15T10:41:44.647,7,False,1.0
2021,10,3199,90,22,3170,2,5,9,3,3,0,3,0,3,0,True,False,False,0,3,2021-11-18T18:42:54.333,3,False,0.0
2021,10,3199,95,22,3170,13,2,10,11,0,0,0,0,0,0,False,False,False,0,2,2021-11-18T18:20:42.35,0,False,0.0
2021,10,3199,100,4,4913,2,48,9,-2,4,6,3,1,3,0,False,False,False,0,1,2021-11-15T10:49:49.897,4,False,1.0
2021,10,3199,105,4,2853,2,5,5,6,7,1,7,0,7,0,False,False,False,0,3,2021-11-15T10:52:06.43,7,False,0.0
2021,10,3199,110,4,5119,13,35,2,18,0,0,0,0,0,0,False,False,False,0,3,2021-11-15T10:54:28.797,0,False,0.0
2021,10,3199,115,4,594,2,51,3,-1,7,8,6,1,6,0,False,False,False,0,3,2022-02-16T20:31:03.43,7,False,1.0
2021,10,3199,120,4,5119,2,4,10,5,12,7,10,2,10,0,False,False,False,0,3,2021-11-15T11:00:08.87,12,False,2.0
2021,10,3199,125,4,4913,2,55,9,-5,3,8,3,0,3,0,False,False,False,0,1,2021-11-15T11:02:16.093,3,False,0.0
2021,10,3199,135,4,2853,3,9,3,10,0,0,0,0,0,0,False,False,False,0,2,2021-11-15T11:06:34.973,0,False,0.0
2021,10,3199,155,22,8451,2,16,4,2,3,1,3,0,3,0,False,False,False,0,1,2021-11-15T11:13:24.687,3,False,0.0
2021,10,3199,160,22,4997,13,6,4,14,0,0,0,0,0,0,False,False,False,0,3,2021-11-15T11:15:53.193,0,False,0.0
2021,10,3199,165,22,6812,2,48,10,-5,2,7,2,0,2,0,False,False,False,0,1,2021-11-15T11:17:58.513,2,False,0.0
2021,10,3199,180,4,6983,2,48,10,-2,6,8,3,3,3,0,False,False,False,1,1,2021-11-18T18:23:50.617,6,False,3.0
2021,10,3199,210,22,5080,13,26,5,3,0,0,0,0,0,0,False,False,False,0,3,2021-11-18T18:12:31.39,0,False,0.0
2021,10,3199,220,22,6812,2,46,3,2,9,7,4,5,4,0,False,False,False,0,1,2021-11-18T18:25:55.503,9,False,5.0
2021,10,3199,235,22,8451,2,31,4,1,10,9,8,2,8,0,False,False,False,0,1,2021-11-18T18:43:22.043,10,False,2.0
2021,10,3199,240,22,8454,2,12,3,0,4,4,2,2,2,0,False,False,False,0,3,2021-11-16T21:20:34.413,4,False,2.0
2021,10,3199,260,4,594,2,4,9,4,8,4,7,1,7,0,False,False,False,0,3,2022-02-16T20:32:09.557,8,False,1.0
2021,10,3199,270,4,2853,2,5,5,6,6,0,6,0,6,0,False,False,False,0,3,2021-11-15T12:13:39.62,6,False,0.0
2021,10,3199,275,4,2853,2,2,9,4,6,2,5,1,5,0,False,False,False,0,2,2021-11-15T12:16:07.513,6,False,1.0
2021,10,3199,280,4,213,2,5,6,16,16,0,16,0,16,0,False,False,False,0,3,2021-11-16T18:06:19.75,16,False,0.0
2021,10,3199,295,4,5119,3,52,10,2,0,0,0,0,0,0,False,False,False,0,3,2021-11-18T17:30:00.503,0,False,0.0
2021,10,3199,310,22,3170,2,45,5,-1,3,4,-1,4,-1,0,True,False,False,1,2,2021-11-15T12:39:27.253,3,False,
2021,10,3199,320,22,2391,2,17,9,13,21,8,21,0,21,0,False,False,False,0,3,2021-11-18T21:32:50.81,21,False,0.0
2021,10,3199,330,22,4997,2,21,3,12,18,6,14,4,14,0,False,False,False,0,3,2021-11-18T18:27:57.833,18,False,4.0
2021,10,3199,350,22,8454,13,9,6,15,0,0,0,0,0,0,False,False,False,0,2,2021-11-18T21:35:41.303,0,True,0.0
2021,10,3199,370,4,2853,2,21,6,27,57,30,46,11,46,0,False,False,False,0,2,2022-02-16T20:33:11.587,57,False,11.0
2021,10,3199,380,4,2853,13,13,9,2,0,0,0,0,0,0,False,False,False,0,3,2022-02-17T23:03:46.933,0,False,0.0
2021,10,3199,390,4,2853,13,29,3,12,0,0,0,0,0,0,False,False,False,0,3,2021-11-15T13:26:31.743,0,False,0.0
2021,10,3199,395,4,2853,2,9,3,12,12,0,12,0,12,6,False,False,False,0,2,2022-02-17T23:02:28.653,12,True,0.0
2021,10,3199,410,22,6812,2,16,4,2,14,12,11,3,11,0,False,False,False,0,1,2021-11-15T13:32:28.287,14,False,3.0
2021,10,3199,415,22,6812,13,12,3,1,0,0,0,0,0,0,False,False,False,0,1,2021-11-16T21:21:37.327,0,False,0.0
2021,10,3199,420,22,6812,3,5,5,3,0,0,0,0,0,0,False,False,False,0,1,2021-11-15T13:36:51.137,0,False,0.0
2021,10,3199,425,22,5080,2,6,7,20,28,8,21,7,21,0,False,True,True,0,3,2021-11-18T18:16:26.997,28,False,7.0
2021,10,3199,450,4,2853,2,19,6,22,23,1,23,0,23,0,False,False,False,0,3,2021-11-16T18:08:54.093,23,False,0.0
2021,10,3199,485,22,8454,13,8,8,47,0,0,0,0,0,0,False,False,False,0,3,2021-11-18T18:21:13.983,0,False,0.0
2021,10,3199,490,4,213,2,19,2,31,31,0,31,0,31,0,False,False,False,0,2,2021-11-18T18:16:49.733,31,False,
2021,10,3199,495,4,7646,2,8,7,43,49,6,49,0,49,0,False,False,False,0,3,2022-02-16T20:33:44.563,49,False,0.0
2021,10,3199,520,22,8451,2,16,4,1,19,18,7,12,7,0,False,False,False,1,1,2021-11-15T14:48:13.717,19,False,12.0
2021,10,3199,525,22,5080,2,5,5,14,14,0,14,0,14,0,False,False,False,0,3,2021-11-15T14:50:32.193,14,False,0.0
2021,10,3199,535,22,5080,13,6,9,12,0,0,0,0,0,0,False,False,False,0,2,2021-11-15T14:54:33.213,0,True,0.0
2021,10,3199,540,4,213,2,12,6,25,25,0,25,0,25,0,False,False,False,0,2,2021-11-15T14:56:56.86,25,True,
2021,10,3199,545,4,2853,2,5,3,8,8,0,8,0,8,0,False,False,False,0,2,2021-11-15T15:00:10.147,8,False,0.0
2021,10,3199,555,4,7646,2,43,2,32,36,4,32,4,32,0,False,False,False,0,3,2021-11-16T18:07:18.227,36,False,4.0
2021,10,3199,560,4,6953,3,32,3,1,0,0,0,0,0,0,True,False,False,0,4,2022-02-16T20:34:07.283,0,False,
2021,10,3199,585,22,5080,2,2,10,8,12,4,10,2,10,0,False,False,False,0,2,2021-11-15T15:16:33.537,12,False,2.0
2021,10,3199,595,22,743,2,46,3,1,11,10,7,4,7,0,False,False,False,0,1,2021-11-15T15:29:29.277,11,False,4.0
2021,10,3199,615,22,4997,13,20,6,25,0,0,0,0,0,0,False,False,False,0,2,2021-11-18T18:21:41.51,0,True,0.0
2021,10,3199,620,4,7646,2,6,8,18,20,2,19,1,19,0,False,False,False,0,2,2021-11-15T15:39:34.547,20,False,1.0
2021,10,3199,625,4,2853,13,35,8,27,0,0,0,0,0,0,False,False,False,0,2,2021-11-18T18:22:07.58,0,False,0.0
2021,10,3199,635,22,8451,2,48,9,-6,11,17,2,9,2,0,False,False,False,2,1,2021-11-15T15:50:36.437,11,False,9.0
2021,10,3199,645,22,6812,13,12,5,0,0,0,0,0,0,0,False,False,False,0,1,2021-11-16T21:21:50.34,0,False,0.0
2021,10,3199,650,22,6270,2,2,9,6,6,0,6,0,6,0,True,False,False,0,3,2021-11-16T21:23:57.477,6,False,0.0
2021,10,3199,655,22,3170,2,6,9,8,8,0,8,0,8,0,False,False,False,0,3,2021-11-18T18:47:50.427,8,False,0.0
2021,10,3199,665,22,4997,13,35,5,12,0,0,0,0,0,0,False,False,False,0,3,2022-02-24T16:21:05.223,0,False,0.0
2021,10,3199,670,22,8454,13,13,10,3,0,0,0,0,0,0,False,False,False,0,3,2021-11-18T18:48:12.213,0,False,0.0
2021,10,3199,680,22,3170,2,4,4,6,9,3,8,1,8,0,False,False,False,0,3,2021-11-15T16:25:09.54,9,False,1.0
2021,10,3199,725,22,743,2,32,5,-8,-7,1,-7,0,-7,0,False,False,False,0,1,2022-02-24T16:22:08.423,-7,False,0.0
2021,10,3199,730,22,5080,2,6,10,13,21,8,15,6,15,0,False,False,False,1,3,2021-11-15T16:44:09.033,21,False,6.0
2021,10,3199,735,22,5080,2,6,4,14,18,4,16,2,16,0,False,False,False,0,3,2021-11-15T16:47:55.9,18,False,2.0
2021,10,3199,740,22,743,13,48,9,-5,0,0,0,0,0,0,False,False,False,0,1,2021-11-15T16:49:57.497,0,False,0.0
2021,10,3199,755,22,3170,3,5,5,4,0,0,0,0,0,0,False,False,False,0,3,2021-11-15T16:53:59.063,0,False,0.0
2021,10,3199,760,22,3170,13,12,6,24,0,0,24,-1023,24,0,False,False,False,0,3,2021-11-18T21:33:26.897,0,False,0.0
2021,10,3199,765,4,2853,2,23,6,37,43,6,37,6,37,0,False,False,False,0,3,2022-02-16T20:34:34.73,43,False,6.0
2021,10,3199,800,22,2391,13,12,5,5,0,0,0,0,0,0,True,False,False,0,4,2021-11-16T21:22:39.677,0,False,0.0
2021,10,3199,815,22,8454,2,29,2,21,25,4,23,2,23,0,False,False,False,0,2,2021-11-15T17:17:56.37,25,False,2.0
2021,10,3199,825,22,6270,2,5,5,5,7,2,7,0,7,0,False,False,False,0,3,2021-11-15T17:22:35.553,7,False,0.0
2021,10,3199,835,22,8454,2,4,10,5,15,10,7,8,7,6,False,False,False,1,3,2021-11-15T17:27:11.743,15,False,8.0
2021,10,3200,20,30,7893,2,18,3,-2,2,4,1,1,1,0,False,False,False,0,2,2021-11-15T10:05:26.907,2,False,1.0
2021,10,3200,25,30,7893,13,5,5,10,0,0,0,0,0,0,False,False,False,0,3,2021-11-18T16:03:13.91,0,False,0.0
2021,10,3200,40,32,7128,2,12,3,5,8,3,7,1,7,0,False,False,False,0,3,2022-02-24T16:26:59.16,8,False,1.0
2021,10,3200,50,32,3562,2,5,5,14,14,0,14,0,14,0,False,False,False,0,3,2021-11-15T10:14:49.667,14,False,0.0
2021,10,3200,65,32,4788,3,39,4,7,0,0,0,0,0,0,False,False,False,0,3,2021-11-16T19:56:40.917,0,False,0.0
2021,10,3200,80,30,4937,3,5,9,1,0,0,0,0,0,0,False,False,False,0,1,2021-11-15T10:24:27.083,0,False,0.0
2021,10,3200,85,30,8307,13,4,10,3,0,0,0,0,0,0,False,False,False,0,3,2021-11-18T16:04:19.41,0,False,0.0
2021,10,3200,90,32,7128,3,12,7,16,0,0,0,0,0,0,False,False,False,0,3,2022-02-16T21:18:49.277,0,False,0.0
2021,10,3200,100,32,4788,2,5,5,8,13,5,12,1,12,0,True,False,False,0,3,2021-11-15T10:46:46.717,13,False,1.0
2021,10,3200,105,32,6430,2,30,5,-1,4,5,4,0,4,0,False,False,False,0,3,2021-11-15T10:49:15.3,4,False,0.0
2021,10,3200,135,30,4516,2,50,10,-3,3,6,3,0,3,0,False,False,False,0,3,2021-11-15T11:00:24.903,3,False,0.0
2021,10,3200,150,30,793,13,6,7,15,0,0,0,0,0,0,False,False,False,0,2,2021-11-18T17:38:08.09,0,False,0.0
2021,10,3200,165,32,7807,2,2,9,7,8,1,7,1,7,0,False,False,False,0,3,2021-11-15T11:11:19.037,8,False,1.0
2021,10,3200,185,32,3885,2,4,3,-1,11,12,9,2,9,0,False,False,False,1,2,2022-02-16T21:19:42.777,11,False,2.0
2021,10,3200,190,32,3885,2,4,9,4,4,0,4,0,4,0,False,False,False,0,3,2021-11-15T11:19:48.243,4,False,0.0
2021,10,3200,200,32,7128,2,51,5,-4,1,5,1,0,1,0,False,False,False,0,3,2021-11-15T11:23:09.733,1,False,0.0
2021,10,3200,205,32,3562,2,7,6,20,20,0,20,0,20,6,False,False,False,0,3,2021-11-18T15:42:18.91,20,False,0.0
2021,10,3200,225,30,8307,2,19,2,25,29,4,26,3,26,0,False,False,False,0,2,2021-11-15T11:32:59.43,29,False,3.0
2021,10,3200,240,30,4937,2,4,10,3,9,6,6,3,6,0,False,False,False,0,1,2021-11-15T11:38:49.227,9,False,3.0
2021,10,3200,250,30,4516,13,17,9,13,0,0,0,0,0,0,True,False,False,0,3,2021-11-15T11:42:40.977,0,False,0.0
2021,10,3200,255,30,7893,2,4,3,5,8,3,7,1,7,0,False,False,False,0,2,2021-11-15T11:47:38.573,8,False,1.0
2021,10,3200,260,30,4937,2,44,3,-4,3,7,1,2,1,0,False,False,False,0,1,2021-11-15T11:49:38.007,3,False,2.0
2021,10,3200,270,30,931,13,11,3,6,0,0,0,0,0,0,False,False,False,0,1,2021-11-18T16:03:55.17,0,False,0.0
2021,10,3200,275,30,931,3,13,4,2,0,0,0,0,0,0,False,False,False,0,3,2021-11-15T11:57:50.757,0,False,0.0
2021,10,3200,290,32,3562,2,8,7,20,22,2,21,1,21,0,False,False,False,0,2,2021-11-18T17:38:08.09,22,False,1.0
2021,10,3200,310,32,7128,2,4,3,7,7,0,7,0,7,0,False,False,False,0,2,2021-11-18T17:38:08.09,7,False,0.0
2021,10,3200,320,32,4788,2,38,10,1,9,8,6,3,6,0,False,False,False,2,4,2021-11-18T17:08:26.693,9,False,3.0
2021,10,3200,350,32,3562,13,5,5,5,0,0,0,0,0,0,False,False,False,0,2,2021-11-18T15:42:53.053,0,False,0.0
2021,10,3200,355,32,4788,2,12,4,5,8,3,6,2,6,0,False,False,False,0,3,2021-11-15T12:31:59.05,8,False,2.0
2021,10,3200,380,30,4516,2,6,4,5,6,1,6,0,6,0,True,False,False,0,3,2021-11-15T12:37:32.313,6,False,0.0
2021,10,3200,385,30,7893,2,13,4,4,7,3,6,1,6,0,False,False,False,0,3,2021-11-15T12:39:01.943,7,False,1.0
2021,10,3200,395,30,4516,2,2,4,6,11,5,9,2,9,0,False,False,False,1,3,2021-11-15T12:41:28.063,11,False,2.0
2021,10,3200,405,30,931,2,31,9,2,4,2,4,0,4,0,False,False,False,0,1,2021-11-18T15:43:04.48,4,False,0.0
2021,10,3200,410,30,2290,13,35,7,17,0,0,0,0,0,0,False,False,False,0,3,2021-11-18T17:11:33.493,0,False,0.0
2021,10,3200,415,30,7893,13,3,3,12,0,0,0,0,0,0,False,False,False,0,2,2021-11-15T12:47:45.353,0,False,0.0
2021,10,3200,420,30,793,2,2,9,7,22,15,22,0,22,0,False,False,False,0,2,2021-11-15T12:51:16.017,22,False,0.0
2021,10,3200,455,32,3885,2,48,10,-3,14,17,12,2,12,0,False,False,False,0,1,2021-11-15T13:05:09.733,14,False,2.0
2021,10,3200,470,30,4937,2,46,3,5,5,0,5,0,5,0,False,False,False,0,3,2021-11-15T13:12:19.61,5,False,0.0
2021,10,3200,475,30,2290,13,13,4,4,0,0,0,0,0,0,False,False,False,0,3,2021-11-15T13:15:15.863,0,False,0.0
2021,10,3200,485,32,8528,2,47,5,0,1,1,1,0,1,0,True,False,False,0,4,2021-11-15T13:19:36.717,1,False,0.0
2021,10,3200,495,32,3562,13,19,6,32,0,0,0,0,0,0,False,False,False,0,2,2021-11-18T15:43:24.703,0,False,0.0
2021,10,3200,505,30,4516,2,50,9,-2,14,16,7,7,7,0,False,False,False,1,3,2021-11-15T13:30:30.857,14,False,7.0
2021,10,3200,510,30,4937,2,4,9,5,15,10,12,3,12,0,False,False,False,0,1,2021-11-16T17:43:02.857,15,False,3.0
2021,10,3200,515,30,4516,2,49,3,-2,8,10,5,3,5,0,True,False,False,0,3,2022-02-14T21:52:04.637,8,False,3.0
2021,10,3200,520,30,2290,2,33,4,6,6,0,6,0,6,6,False,False,False,0,4,2021-11-18T15:43:37.303,6,False,0.0
2021,10,3200,535,32,8533,2,5,5,14,15,1,15,0,15,0,False,False,False,0,3,2021-11-15T13:43:47.953,15,False,0.0
2021,10,3200,540,32,6430,2,13,3,6,6,0,6,0,6,0,True,False,False,0,4,2022-02-16T21:20:59.933,6,False,0.0
2021,10,3200,545,32,3562,13,51,3,-5,0,0,0,0,0,0,True,False,False,0,3,2022-02-16T21:21:35.003,0,False,0.0
2021,10,3200,550,32,8528,2,8,7,16,18,2,16,2,16,0,True,False,False,0,3,2021-11-18T15:43:59.023,18,False,2.0
2021,10,3200,570,32,6430,13,8,10,14,0,0,0,0,0,0,False,False,False,0,3,2021-11-15T15:42:29.803,0,False,
2021,10,3200,590,30,4937,2,4,3,0,7,7,2,5,2,0,False,False,False,0,1,2021-11-18T16:05:11.073,7,False,
2021,10,3200,595,30,4937,2,46,3,1,2,1,2,0,2,0,False,False,False,0,1,2021-11-15T14:13:01.753,2,False,0.0
2021,10,3200,600,30,4516,2,4,4,13,15,2,13,2,13,0,True,False,False,0,3,2021-11-15T14:20:14.173,15,False,2.0
2021,10,3200,610,30,4937,2,5,10,2,4,2,4,0,4,0,False,False,False,0,1,2021-11-15T14:20:01.993,4,False,0.0
2021,10,3200,615,30,4516,2,50,3,-1,0,1,0,0,0,0,False,False,False,0,2,2021-11-15T14:22:22.333,0,False,0.0
2021,10,3200,640,32,7128,2,6,7,21,21,0,21,0,21,0,False,False,False,0,2,2022-02-16T21:22:24.337,21,False,0.0
2021,10,3200,655,32,8533,2,13,10,2,9,7,9,0,9,0,False,True,True,0,3,2021-11-18T17:27:49.197,7,False,0.0
2021,10,3200,660,30,4937,2,4,9,2,4,2,4,0,4,0,False,False,False,0,1,2022-02-16T21:23:33.537,4,False,0.0
2021,10,3200,665,30,4937,2,44,3,0,3,3,3,0,3,0,True,False,False,0,1,2021-11-15T14:44:32.037,3,False,0.0
2021,10,3200,670,30,793,2,19,6,19,40,21,40,0,40,6,False,False,False,0,2,2021-11-15T14:46:14.013,40,False,0.0
2021,10,3200,690,32,3885,2,28,10,2,6,4,4,2,4,0,False,False,False,0,1,2021-11-18T15:44:17.95,6,False,2.0
2021,10,3200,700,32,7128,2,50,5,-1,16,17,13,3,13,0,False,False,False,0,2,2021-11-15T15:00:24.543,16,False,3.0
2021,10,3200,720,32,8528,2,13,5,2,6,4,6,0,6,0,False,False,False,0,4,2021-11-18T17:18:33.383,6,False,0.0
2021,10,3200,745,32,2675,2,5,3,5,5,0,5,0,5,0,False,False,False,0,2,2021-11-15T15:13:11.443,5,False,0.0
2021,10,3200,760,32,7807,2,2,9,3,6,3,3,3,3,0,False,False,False,0,2,2021-11-15T15:21:29.92,6,False,3.0
2021,10,3200,770,32,7128,2,2,9,6,6,0,6,0,6,0,False,False,False,0,2,2021-11-15T15:23:36.73,6,False,0.0
2021,10,3202,15,9,7816,2,50,9,-3,37,40,11,26,11,0,False,False,False,0,2,2021-11-18T20:52:43.52,37,False,26.0
2021,10,3202,20,9,6436,13,2,9,7,0,0,0,0,0,0,False,False,False,0,2,2022-02-16T16:48:37.55,0,False,0.0
2021,10,3202,30,9,6436,2,4,5,9,11,2,9,2,9,0,False,False,False,0,2,2021-11-15T10:26:25.307,11,False,2.0
2021,10,3202,40,9,7816,13,44,9,-4,0,0,0,0,0,0,True,False,False,0,2,2021-11-15T10:30:00.597,0,False,0.0
2021,10,3202,45,9,7816,2,7,3,13,13,0,13,0,13,6,False,False,False,0,3,2021-11-15T10:31:40.79,13,False,0.0
2021,10,3202,60,2,8389,2,6,10,10,17,7,14,3,14,0,False,False,False,0,4,2021-11-15T10:40:27.577,17,False,3.0
2021,10,3202,70,2,8389,2,35,10,13,18,5,16,2,16,0,False,False,False,0,4,2021-11-15T11:18:26.713,18,False,2.0
2021,10,3202,85,2,7303,13,26,9,2,0,0,0,0,0,0,False,False,False,0,2,2021-11-15T10:49:14.76,0,False,0.0
2021,10,3202,90,2,6247,13,8,10,12,0,0,12,-1011,12,0,False,False,False,0,2,2021-11-15T10:53:02.5,0,False,0.0
2021,10,3202,115,9,4202,2,48,10,-2,5,7,3,2,3,0,False,False,False,0,1,2021-11-15T10:57:50.727,5,False,2.0
2021,10,3202,120,9,7183,3,12,3,1,0,0,0,0,0,0,False,False,False,0,1,2021-11-18T20:08:24.6,0,False,0.0
2021,10,3202,135,2,8389,2,7,8,16,17,1,17,0,17,0,False,False,False,0,3,2021-11-15T11:03:58.637,17,False,0.0
2021,10,3202,140,2,811,2,4,10,14,14,0,14,0,14,0,False,False,False,0,3,2021-11-15T11:05:53.017,14,False,0.0
2021,10,3202,150,2,7303,13,2,9,7,0,0,0,0,0,0,False,False,False,0,2,2021-11-15T11:10:46.387,0,False,0.0
2021,10,3202,155,2,8389,13,5,5,8,0,0,0,0,0,0,False,False,False,0,3,2021-11-15T11:14:05.61,0,False,0.0
2021,10,3202,160,2,6247,13,12,10,8,0,0,0,0,0,0,False,False,False,0,3,2022-02-24T16:29:01.49,0,False,0.0
2021,10,3202,165,9,7816,3,17,8,29,0,0,0,0,0,0,False,False,False,0,3,2021-11-15T11:16:11.7,0,False,
2021,10,3202,170,9,7183,2,5,10,2,9,7,8,1,8,0,False,False,False,0,1,2021-11-15T11:18:11.54,9,False,1.0
2021,10,3202,180,9,8243,2,5,3,11,12,1,12,0,12,0,True,False,False,0,1,2021-11-18T21:04:15.65,12,False,0.0
2021,10,3202,195,9,322,2,2,9,4,6,2,4,2,4,0,False,False,False,0,2,2021-11-15T11:27:37.537,6,False,2.0
2021,10,3202,200,9,7816,2,5,5,9,21,12,9,12,9,0,True,False,False,0,3,2021-11-15T11:29:19.277,21,False,12.0
2021,10,3202,215,9,4202,2,48,10,-4,6,10,3,3,3,0,False,False,False,0,1,2022-02-16T16:50:44.043,6,False,3.0
2021,10,3202,245,2,3506,2,30,10,-1,0,1,0,0,0,0,True,False,False,0,4,2021-11-18T20:44:30.313,0,False,0.0
2021,10,3202,255,2,811,3,5,3,7,0,0,0,0,0,0,False,False,False,0,3,2021-11-15T12:00:22.02,0,False,0.0
2021,10,3202,265,9,4446,2,46,3,4,18,14,15,3,15,0,True,False,False,0,3,2021-11-16T17:40:35.74,18,False,3.0
2021,10,3202,290,9,7816,2,4,10,4,5,1,4,1,4,0,False,False,False,1,3,2021-11-15T12:09:45,5,False,1.0
2021,10,3202,295,9,6436,2,12,6,23,23,0,23,0,23,0,False,False,False,0,2,2021-11-15T12:11:33.573,23,False,0.0
2021,10,3202,335,9,322,2,18,3,-2,7,9,5,2,5,0,False,False,False,0,2,2022-02-16T16:52:24.2,7,False,2.0
2021,10,3202,350,9,4202,2,18,3,-2,4,6,1,3,1,0,True,False,False,0,2,2021-11-15T12:24:42.323,4,False,3.0
2021,10,3202,355,9,7816,2,4,9,4,9,5,5,4,5,0,False,False,False,1,3,2021-11-15T12:26:14.77,9,False,4.0
2021,10,3202,360,9,6436,2,6,10,6,8,2,7,1,7,0,False,False,False,0,2,2021-11-18T20:52:43.52,8,False,1.0
2021,10,3202,365,9,322,2,2,10,13,16,3,14,2,14,0,False,False,False,0,3,2021-11-18T21:18:14.707,16,False,2.0
2021,10,3202,390,9,7816,2,7,3,9,9,0,9,0,9,6,False,False,False,0,3,2021-11-18T21:06:40.14,9,True,0.0
2021,10,3202,415,2,7303,13,4,4,11,0,0,0,0,0,0,False,False,False,0,3,2021-11-15T12:37:02.743,0,False,0.0
2021,10,3202,475,2,6247,13,8,8,16,0,0,0,0,0,0,False,False,False,0,3,2021-11-18T21:08:49.67,0,False,0.0
2021,10,3202,480,2,8389,2,5,5,5,8,3,7,1,7,0,False,False,False,0,3,2021-11-15T13:24:35.84,8,False,1.0
2021,10,3202,485,2,2554,3,2,9,2,0,0,0,0,0,0,False,False,False,0,2,2021-11-18T20:09:19.463,0,False,0.0
2021,10,3202,510,9,6436,3,2,10,10,0,0,0,0,0,0,False,False,False,0,2,2021-11-15T13:31:37.797,0,False,0.0
2021,10,3202,530,2,7303,2,5,6,15,13,-2,13,0,13,0,False,False,False,0,3,2021-11-15T13:41:46.593,13,False,0.0
2021,10,3202,540,2,4405,2,32,3,0,21,21,15,6,15,0,False,False,False,0,1,2021-11-15T13:44:34.143,21,False,6.0
2021,10,3202,550,2,4405,13,32,10,1,0,0,0,0,0,0,False,False,False,0,1,2021-11-15T13:47:09.707,0,False,0.0
2021,10,3202,555,2,7303,13,4,5,4,0,0,0,0,0,0,False,False,False,0,2,2021-11-18T20:13:18.803,0,False,0.0
2021,10,3202,560,9,6446,2,4,4,6,14,8,13,1,13,0,False,False,False,0,3,2021-11-15T13:51:32.48,14,False,1.0
2021,10,3202,565,9,7183,2,47,10,1,9,8,6,3,6,0,False,False,False,1,1,2021-11-18T20:53:47.88,9,False,3.0
2021,10,3202,595,2,7303,2,6,9,8,9,1,8,1,8,0,False,False,False,0,2,2021-11-18T20:52:43.52,9,False,1.0
2021,10,3202,600,2,8389,13,5,9,16,0,0,0,0,0,0,False,False,False,0,4,2021-11-18T21:10:50.117,0,False,0.0
2021,10,3202,610,9,7183,2,48,10,-4,19,23,10,9,10,0,False,False,False,0,1,2021-11-18T21:11:42.583,19,False,9.0
2021,10,3202,620,9,6712,2,39,4,6,7,1,7,0,7,0,False,False,False,0,3,2021-11-15T14:15:45.583,7,False,0.0
2021,10,3202,625,9,322,2,8,8,16,22,6,17,5,17,0,False,False,False,2,2,2021-11-15T14:17:31.973,22,False,5.0
2021,10,3202,630,9,7183,2,55,4,-4,11,15,6,5,6,0,False,False,False,0,4,2021-11-15T14:24:20.36,4,False,5.0
2021,10,3202,635,9,6712,13,17,7,18,0,0,0,0,0,0,False,False,False,0,3,2021-11-15T14:27:49.127,0,False,
2021,10,3202,640,9,6446,13,36,9,13,0,0,0,0,0,0,False,False,False,0,3,2021-11-15T14:30:49.633,0,False,0.0
2021,10,3202,645,9,7183,2,47,5,3,6,3,4,2,4,0,False,False,False,0,1,2021-11-15T14:32:45.347,6,False,2.0
2021,10,3202,695,2,8389,13,6,4,8,0,0,0,0,0,0,False,False,False,0,3,2021-11-18T20:14:28.07,0,False,0.0
2021,10,3202,705,9,7183,2,4,5,5,9,4,8,1,8,0,True,False,False,0,2,2021-11-16T17:41:07.163,9,False,1.0
2021,10,3202,710,9,4385,2,18,5,0,5,5,4,1,4,0,True,False,False,0,2,2021-11-16T17:41:25.873,5,False,1.0
2021,10,3202,715,9,8243,2,5,9,3,3,0,3,0,3,0,False,False,False,0,3,2021-11-15T15:13:21.47,3,False,0.0
2021,10,3202,735,2,8397,13,2,10,10,0,0,0,0,0,0,False,False,False,0,2,2022-02-16T16:54:47.777,0,False,0.0
2021,10,3202,755,9,6436,2,12,2,28,28,0,28,0,28,0,False,False,False,0,2,2021-11-16T17:45:02.85,28,False,
2021,10,3202,780,2,8397,2,47,5,2,14,12,5,9,5,0,False,False,False,1,3,2021-11-18T20:50:30.033,14,False,9.0
2021,10,3202,795,2,7303,13,2,4,10,0,0,0,0,0,0,False,False,False,0,3,2021-11-18T21:19:14.42,0,False,0.0
2021,10,3202,805,2,6240,13,5,6,15,0,0,0,0,0,0,False,False,False,0,2,2021-11-18T20:10:19.447,0,False,0.0
2021,10,3202,810,2,8397,13,19,6,35,0,0,0,0,0,0,False,False,False,0,2,2021-11-15T15:39:52.71,0,False,0.0
2021,10,3203,10,31,2865,2,5,5,4,3,-1,3,0,3,0,False,False,False,0,3,2021-11-15T10:27:17.01,3,False,0.0
2021,10,3203,25,31,6793,3,52,4,2,0,0,0,0,0,0,False,False,False,0,3,2021-11-18T14:06:42.353,0,False,0.0
2021,10,3203,40,20,8127,2,4,10,9,10,1,9,1,9,0,False,False,False,0,3,2021-11-15T10:51:02.583,10,False,1.0
2021,10,3203,45,20,7888,2,47,5,0,8,8,8,0,8,0,False,False,False,0,4,2021-11-15T10:51:17.117,8,False,0.0
2021,10,3203,60,20,6388,2,38,10,3,6,3,5,1,5,0,False,False,False,0,4,2021-11-15T10:51:52.81,6,False,1.0
2021,10,3203,65,20,8131,13,19,2,26,0,0,0,0,0,0,False,False,False,0,2,2021-11-15T10:54:34.113,0,True,0.0
2021,10,3203,80,31,4545,3,4,5,6,0,0,0,0,0,0,False,False,False,0,2,2022-02-16T21:04:42.04,0,True,0.0
2021,10,3203,85,31,6724,2,38,9,2,2,0,2,0,2,0,False,False,False,0,3,2021-11-15T11:01:14.97,2,False,0.0
2021,10,3203,95,20,7888,2,53,10,-4,7,11,2,5,2,0,True,False,False,0,4,2021-11-15T11:04:16.733,7,False,5.0
2021,10,3203,110,20,2408,3,16,10,5,0,0,0,0,0,0,True,False,False,0,1,2022-02-16T21:06:55.41,0,False,
2021,10,3203,115,20,6388,2,4,5,4,6,2,5,1,5,0,False,False,False,0,2,2021-11-15T11:13:02.593,6,False,1.0
2021,10,3203,125,20,6388,13,5,3,12,0,0,0,0,0,0,False,False,False,0,3,2021-11-15T11:16:46.873,0,True,0.0
2021,10,3203,140,31,4070,2,2,9,4,50,46,44,6,44,0,False,False,False,1,2,2021-11-15T11:22:18.14,50,False,6.0
2021,10,3203,150,31,4844,2,38,10,3,9,6,9,0,9,0,True,False,False,1,3,2021-11-16T18:21:14.12,9,False,0.0
2021,10,3203,155,31,6793,13,24,2,15,0,0,0,0,0,0,False,False,False,0,3,2021-11-15T11:27:57.243,0,True,0.0
2021,10,3203,165,31,4545,13,24,5,10,0,0,0,0,0,0,False,False,False,0,1,2021-11-18T14:06:42.353,0,True,0.0
2021,10,3203,195,20,7353,2,19,6,30,46,16,41,5,41,0,False,False,False,0,3,2021-11-15T11:44:39.267,46,False,5.0
2021,10,3203,210,20,6388,2,7,5,10,11,1,11,0,11,6,False,False,False,0,3,2021-11-18T14:06:42.353,11,True,0.0
2021,10,3203,225,31,2865,2,13,3,7,16,9,14,2,14,0,False,False,False,0,4,2021-11-15T11:52:23.34,16,False,2.0
2021,10,3203,235,31,4070,2,35,8,17,17,0,17,0,17,0,False,False,False,0,3,2021-11-15T11:56:36.477,17,False,0.0
2021,10,3203,245,31,6793,13,19,2,20,0,0,0,0,0,0,False,False,False,0,2,2021-11-15T12:03:51.56,0,True,0.0
2021,10,3203,250,31,7913,2,2,3,9,10,1,10,0,10,0,False,False,False,0,2,2021-11-18T14:06:42.353,10,False,0.0
2021,10,3203,260,31,2865,13,5,3,13,0,0,0,0,0,0,False,False,False,0,4,2021-11-15T12:11:59.723,0,True,0.0
2021,10,3203,270,31,4545,2,47,5,-3,1,4,1,0,1,0,False,False,False,0,1,2021-11-15T12:16:22.507,1,False,0.0
2021,10,3203,290,20,7888,2,38,9,3,3,0,3,0,3,0,False,False,False,0,4,2021-11-15T15:50:45.17,3,False,0.0
2021,10,3203,300,20,7353,13,51,3,-4,0,0,0,0,0,0,True,False,False,0,3,2021-11-15T12:27:50.2,0,True,0.0
2021,10,3203,310,20,255,13,35,6,26,0,0,0,0,0,0,False,False,False,0,3,2021-11-15T12:31:24.967,0,True,0.0
2021,10,3203,320,31,4070,2,13,10,3,16,13,16,0,16,0,False,False,False,0,3,2021-11-15T12:34:56.187,16,False,0.0
2021,10,3203,325,31,6793,2,35,2,16,16,0,16,0,16,0,False,False,False,0,3,2021-11-15T12:37:42.79,16,False,0.0
2021,10,3203,345,31,3911,2,39,9,7,9,2,9,0,9,0,True,False,False,0,3,2021-11-15T12:41:44.04,9,False,0.0
2021,10,3203,360,31,7917,13,33,3,8,0,0,0,0,0,0,False,False,False,0,4,2021-11-15T12:47:06.727,0,True,
2021,10,3203,390,31,6724,13,39,4,6,0,0,0,0,0,0,False,False,False,0,3,2021-11-15T12:53:38.72,0,True,
2021,10,3203,410,20,902,2,4,9,3,12,9,8,4,8,0,False,False,False,0,1,2021-11-15T12:58:56.447,12,False,4.0
2021,10,3203,415,20,8127,3,4,10,8,0,0,0,0,0,0,False,False,False,0,3,2021-11-15T13:00:29.147,0,False,0.0
2021,10,3203,420,20,7353,2,7,2,19,21,2,21,0,21,0,False,False,False,0,3,2021-11-15T13:02:08.597,21,True,0.0
2021,10,3203,450,20,7888,2,13,5,4,6,2,6,0,6,0,False,False,False,0,3,2021-11-15T13:08:32.06,6,True,0.0
2021,10,3203,475,31,4070,2,6,10,3,10,7,7,3,7,0,False,False,False,0,3,2021-11-18T15:14:01.42,10,False,3.0
2021,10,3203,480,31,792,2,51,5,-6,-1,5,-3,2,-3,0,False,False,False,0,1,2021-11-15T13:16:57.093,-1,False,2.0
2021,10,3203,485,31,2901,2,32,5,2,2,0,2,0,2,6,False,False,False,0,4,2021-11-15T13:20:23.753,2,True,0.0
2021,10,3203,500,20,4535,13,46,3,2,0,0,0,0,0,0,False,False,False,0,4,2021-11-15T13:22:51.183,0,True,0.0
2021,10,3203,510,20,7888,13,13,9,5,0,0,0,0,0,0,False,False,False,0,3,2021-11-15T13:26:02.623,0,True,0.0
2021,10,3203,545,20,902,13,4,9,-7,0,0,0,0,0,0,False,False,False,0,1,2021-11-15T13:40:02.503,0,True,0.0
2021,10,3203,550,20,6388,2,13,9,7,21,14,16,5,16,0,False,False,False,0,3,2021-11-18T14:06:42.353,21,False,5.0
2021,10,3203,560,20,7888,2,4,9,4,8,4,6,2,6,0,False,False,False,0,4,2021-11-15T13:45:28.83,8,False,2.0
2021,10,3203,565,20,4535,2,38,9,7,15,8,15,0,15,0,False,False,False,0,3,2021-11-15T13:49:36.017,15,False,0.0
2021,10,3203,575,20,902,2,5,3,4,10,6,7,3,7,0,False,False,False,1,1,2021-11-15T13:53:03.177,10,False,3.0
2021,10,3203,585,20,902,13,5,5,-6,0,0,0,0,0,0,False,False,False,0,1,2021-11-15T13:59:07.907,0,True,0.0
2021,10,3203,615,31,6724,3,53,3,-6,0,0,0,0,0,0,False,False,False,0,4,2022-02-16T21:08:43.383,0,False,0.0
2021,10,3203,635,20,255,13,19,8,35,0,0,0,0,0,0,False,False,False,0,3,2021-11-15T14:15:18.527,0,True,0.0
2021,10,3203,645,31,2865,2,13,5,5,5,0,5,0,5,0,False,False,False,0,4,2021-11-16T18:20:21.713,5,False,0.0
2021,10,3203,660,31,4070,2,5,3,7,7,0,7,0,7,0,False,False,False,0,3,2021-11-15T14:27:16.933,7,False,0.0
2021,10,3203,670,31,2865,2,46,3,2,2,0,2,0,2,0,False,False,False,0,4,2021-11-15T14:31:30.973,2,False,0.0
2021,10,3203,680,31,4844,2,48,3,-4,39,43,36,3,36,0,False,False,False,0,1,2021-11-15T14:34:52.677,39,False,3.0
2021,10,3203,685,31,8331,2,49,5,-2,0,2,0,0,0,0,False,False,False,0,2,2021-11-15T14:38:32.167,0,False,0.0
2021,10,3203,715,20,902,2,11,6,16,34,18,31,3,31,0,False,False,False,0,1,2021-11-16T21:58:35.407,34,False,3.0
2021,10,3203,725,20,8127,2,17,8,18,26,8,21,5,21,0,False,False,False,0,3,2021-11-15T14:48:45.287,26,False,5.0
2021,10,3203,735,20,6388,2,51,3,1,2,1,2,0,2,0,False,False,False,0,3,2021-11-18T14:06:42.353,2,False,
2021,10,3203,745,20,6388,13,8,9,8,0,0,0,0,0,0,False,False,False,0,3,2021-11-18T14:06:42.353,0,True,
2021,10,3203,750,20,6388,13,32,3,-1,0,0,0,0,0,0,False,False,False,0,4,2022-02-16T21:09:36.46,0,True,0.0
2021,10,3203,760,20,6388,13,7,5,1,0,0,0,0,0,0,False,False,False,0,3,2022-02-16T21:10:42.6,0,True,0.0
2021,10,3203,795,31,4070,13,17,10,-3,0,0,0,0,0,0,False,False,False,0,3,2021-11-15T15:11:43.917,0,True,0.0
2021,10,3203,815,20,8131,2,7,2,20,22,2,21,1,21,0,False,False,False,0,3,2021-11-18T15:24:52.537,22,False,1.0
2021,10,3203,820,20,8131,13,19,2,33,0,0,0,0,0,0,True,False,False,0,3,2021-11-16T21:59:21.533,0,True,0.0
2021,10,3203,825,20,902,2,48,5,-4,5,9,0,5,0,0,False,False,False,1,1,2021-11-18T15:29:49.383,5,False,5.0
2021,10,3203,830,20,7353,2,3,5,8,17,9,14,3,14,0,False,False,False,0,3,2021-11-15T15:24:29.927,17,False,3.0
2021,10,3203,840,20,902,13,16,9,-7,0,0,0,0,0,0,True,False,False,0,1,2021-11-15T15:26:28.983,0,True,0.0
2021,10,3203,850,20,7353,2,47,5,1,5,4,4,1,4,0,False,False,False,0,1,2022-02-16T21:13:42.803,5,False,
2021,10,3203,855,20,8131,2,9,2,15,15,0,15,0,15,6,False,False,False,0,3,2021-11-16T22:01:36.337,15,True,0.0
2021,10,3204,20,14,7584,2,4,5,5,4,-1,4,0,4,0,False,False,False,0,2,2021-11-15T01:12:21.063,4,False,0.0
2021,10,3204,25,14,7584,2,2,10,5,7,2,5,2,5,0,False,False,False,0,2,2021-11-15T01:13:41.743,7,False,2.0
2021,10,3204,50,14,5197,13,7,3,5,0,0,0,0,0,0,False,False,False,0,4,2021-11-18T13:38:30.35,0,False,0.0
2021,10,3204,80,15,5152,13,5,7,15,0,0,0,0,0,0,False,False,False,0,3,2021-11-17T00:27:36.337,0,False,0.0
2021,10,3204,105,15,8099,2,28,10,0,0,0,0,0,0,0,False,False,False,0,1,2021-11-18T14:32:16.807,0,False,0.0
2021,10,3204,110,15,4487,13,19,6,27,0,0,0,0,0,0,False,False,False,0,2,2021-11-18T14:32:57.167,0,False,0.0
2021,10,3204,120,14,1114,2,4,5,6,5,-1,5,0,5,0,False,False,False,0,2,2021-11-15T15:00:32.407,5,True,0.0
2021,10,3204,135,14,7582,13,4,4,3,0,0,0,0,0,0,False,False,False,0,1,2022-02-16T19:42:01.907,0,False,0.0
2021,10,3204,140,14,6543,2,5,5,6,7,1,6,1,6,0,False,False,False,0,3,2021-11-15T02:10:37.407,7,False,1.0
2021,10,3204,170,15,914,13,12,2,38,0,0,0,0,0,0,True,False,False,0,3,2021-11-18T14:24:30.463,0,False,0.0
2021,10,3204,180,15,914,2,4,10,12,12,0,12,0,12,0,False,False,False,0,2,2021-11-17T00:14:38.013,12,False,0.0
2021,10,3204,210,14,1119,2,39,4,5,12,7,9,3,9,0,False,False,False,0,4,2021-11-15T02:49:33.757,12,False,3.0
2021,10,3204,220,14,7582,13,32,10,-2,0,0,0,0,0,0,False,False,False,0,1,2021-11-18T13:27:24.897,0,False,0.0
2021,10,3204,230,15,7591,13,29,6,22,0,0,0,0,0,0,False,False,False,0,2,2021-11-18T14:34:34.083,0,False,0.0
2021,10,3204,240,15,4487,13,22,2,15,0,0,0,0,0,0,False,False,False,0,3,2021-11-18T14:37:14.483,0,False,0.0
2021,10,3204,265,14,7582,2,31,9,2,2,0,2,0,2,0,False,False,False,0,1,2021-11-18T13:55:47.543,2,False,0.0
2021,10,3204,290,15,914,13,4,9,6,0,0,0,0,0,0,False,False,False,0,3,2021-11-15T03:21:13.907,0,False,0.0
2021,10,3204,310,14,1114,13,6,8,18,0,0,0,0,0,0,False,False,False,0,2,2021-11-15T03:36:10.237,0,False,0.0
2021,10,3204,340,14,7584,2,35,9,14,18,4,16,2,16,0,False,False,False,0,3,2021-11-15T03:46:01.287,18,False,2.0
2021,10,3204,345,14,1119,3,12,5,10,0,0,0,0,0,0,False,False,False,0,3,2022-02-16T19:43:15.88,0,False,0.0
2021,10,3204,360,14,8400,2,26,3,4,15,11,13,2,13,0,True,False,False,0,3,2021-11-18T14:05:30.643,15,False,2.0
2021,10,3204,365,14,1119,2,31,4,4,9,5,7,2,7,0,False,False,False,0,4,2021-11-18T14:24:46.513,9,False,2.0
2021,10,3204,385,14,7582,2,48,3,-6,3,9,-1,4,-1,0,True,False,False,1,1,2021-11-16T21:25:33.34,3,False,4.0
2021,10,3204,395,14,7582,2,28,3,2,6,4,6,0,6,0,False,False,False,0,1,2021-11-15T04:05:22.49,6,False,0.0
2021,10,3204,420,15,5152,13,5,5,4,0,0,0,0,0,0,False,False,False,0,3,2021-11-18T13:56:52.26,0,False,0.0
2021,10,3204,425,15,4487,13,9,6,19,0,0,0,0,0,0,False,False,False,0,3,2021-11-18T14:06:50.333,0,False,0.0
2021,10,3204,435,14,6543,2,47,5,1,10,9,7,3,7,0,False,False,False,0,1,2021-11-15T04:24:22.88,10,False,3.0
2021,10,3204,440,14,6543,13,28,10,1,0,0,0,0,0,0,False,False,False,0,1,2021-11-18T14:25:01.983,0,False,0.0
2021,10,3204,445,14,1114,13,5,2,15,0,0,0,0,0,0,False,False,False,0,2,2021-11-18T14:25:13.903,0,False,0.0
2021,10,3204,450,14,6543,13,46,3,5,0,0,0,0,0,0,False,False,False,0,3,2021-11-15T04:29:40.08,0,False,0.0
2021,10,3204,460,15,153,13,32,5,9,0,0,0,0,0,0,False,False,False,0,1,2021-11-18T13:39:57.76,0,False,0.0
2021,10,3204,465,15,5152,2,12,8,20,24,4,20,4,20,0,False,False,False,0,3,2021-11-15T15:01:08.023,24,False,4.0
2021,10,3204,480,15,4487,3,2,10,3,0,0,0,0,0,0,False,False,False,0,2,2021-11-15T04:38:16.53,0,False,0.0
2021,10,3204,485,15,7591,3,46,9,1,0,0,0,0,0,0,False,False,False,0,3,2021-11-15T04:39:32.92,0,False,0.0
2021,10,3204,515,15,914,13,35,7,23,0,0,0,0,0,0,False,False,False,0,3,2021-11-18T14:28:18.52,0,False,
2021,10,3204,530,15,5152,2,30,10,0,15,15,13,2,13,0,False,False,False,0,4,2021-11-15T15:04:28.023,7,False,2.0
2021,10,3204,535,15,8099,2,48,10,-5,9,14,7,2,7,0,False,False,False,0,1,2021-11-15T12:48:58.893,9,False,2.0
2021,10,3204,540,15,914,13,7,2,22,0,0,0,0,0,0,False,False,False,0,2,2021-11-18T14:40:00.733,0,False,0.0
2021,10,3204,545,15,7591,13,4,5,9,0,0,0,0,0,0,False,False,False,0,2,2021-11-15T12:57:30.887,0,False,0.0
2021,10,3204,555,14,5197,2,4,10,5,6,1,6,0,6,0,False,False,False,0,3,2021-11-15T13:00:53.253,6,False,0.0
2021,10,3204,565,14,1114,13,5,3,7,0,0,0,0,0,0,False,False,False,0,2,2021-11-18T14:43:03.31,0,False,0.0
2021,10,3204,575,15,7591,2,4,4,5,5,0,5,0,5,0,False,False,False,0,3,2021-11-15T13:05:16.807,5,False,0.0
2021,10,3204,580,15,7591,2,4,9,5,6,1,5,1,5,0,False,False,False,0,3,2021-11-15T13:06:46.55,6,False,1.0
2021,10,3204,590,15,5152,3,4,4,5,0,0,0,0,0,0,False,False,False,0,3,2021-11-18T14:25:31.177,0,False,0.0
2021,10,3204,595,15,5152,2,12,3,13,13,0,13,0,13,0,False,False,False,0,3,2021-11-18T13:30:39.503,13,True,
2021,10,3204,600,15,5152,2,32,5,6,13,7,9,4,9,0,False,False,False,0,4,2021-11-18T13:35:44.87,13,False,4.0
2021,10,3204,605,15,4179,2,6,8,17,18,1,17,1,17,0,False,False,False,0,2,2021-11-18T13:40:12.82,18,False,1.0
2021,10,3204,615,15,7591,13,19,6,29,0,0,0,0,0,0,False,False,False,0,2,2021-11-18T14:45:23.827,0,False,0.0
2021,10,3204,620,15,153,2,48,4,-6,0,6,0,0,0,0,False,False,False,0,1,2021-11-15T13:21:21.28,0,False,0.0
2021,10,3204,635,14,7584,2,13,10,4,15,11,14,1,14,0,False,False,False,0,3,2021-11-18T13:40:22.79,15,False,1.0
2021,10,3204,645,14,7582,2,48,9,-6,-5,1,-5,0,-5,0,False,False,False,0,1,2021-11-15T13:29:59.037,-5,False,0.0
2021,10,3204,655,14,1114,13,4,8,15,0,0,0,0,0,0,False,False,False,0,2,2021-11-18T14:47:31.517,0,False,0.0
2021,10,3204,665,15,8099,3,48,9,-5,0,0,0,0,0,0,False,False,False,0,1,2021-11-18T13:59:02.757,0,False,0.0
2021,10,3204,680,15,914,2,29,2,20,23,3,21,2,21,0,False,False,False,0,2,2021-11-15T13:44:53.747,23,False,2.0
2021,10,3204,685,15,7591,2,50,9,-4,4,8,3,1,3,0,False,False,False,0,3,2021-11-18T13:26:56.797,4,False,1.0
2021,10,3204,705,15,5152,2,2,10,4,14,10,11,3,11,0,False,False,False,0,2,2021-11-15T13:54:22.683,14,False,3.0
2021,10,3204,735,14,7582,2,48,10,-2,1,3,0,1,0,0,False,False,False,0,1,2021-11-15T14:04:37.557,1,False,1.0
2021,10,3204,745,14,4449,2,50,9,-3,-3,0,-3,0,-3,0,False,False,False,0,3,2021-11-15T14:06:56.287,-3,False,0.0
2021,10,3204,760,15,914,13,29,2,17,0,0,0,0,0,0,False,False,False,0,2,2021-11-15T14:12:32.12,0,False,0.0
2021,10,3204,765,15,4487,3,6,4,6,0,0,0,0,0,0,True,False,False,0,3,2021-11-18T14:26:11.12,0,False,0.0
2021,10,3204,780,14,1119,2,46,3,1,10,9,3,7,3,0,True,False,False,0,4,2022-02-16T19:45:01.3,10,False,7.0
2021,10,3204,790,14,7495,2,13,9,3,16,13,16,0,16,0,True,False,False,0,3,2021-11-18T13:32:26.533,16,False,0.0
2021,10,3204,800,14,7582,2,11,5,1,3,2,3,0,3,0,False,False,False,0,1,2021-11-15T14:28:19.307,3,False,0.0
2021,10,3204,805,14,7584,2,12,2,27,27,0,27,0,27,0,False,False,False,0,3,2021-11-15T14:29:46.393,27,True,0.0
2021,10,3204,825,14,1119,13,6,10,10,0,0,0,0,0,0,True,False,False,0,4,2021-11-18T14:08:44.71,0,False,0.0
2021,10,3204,830,14,4449,2,13,9,4,12,8,10,2,10,0,False,False,False,0,3,2021-11-15T14:39:48.783,12,False,2.0
2021,10,3204,845,15,7591,13,4,10,8,0,0,0,0,0,0,False,False,False,0,3,2021-11-18T13:32:51.003,0,False,0.0
2021,10,3204,850,15,5152,2,4,10,8,9,1,9,0,9,0,False,False,False,0,3,2021-11-15T14:44:35.173,9,False,0.0
2021,10,3204,865,15,8099,2,4,4,2,9,7,6,3,6,0,False,False,False,0,1,2021-11-15T14:47:38.47,9,False,3.0
2021,10,3204,870,15,8099,2,4,9,5,9,4,9,0,9,0,False,False,False,0,1,2021-11-15T14:48:56.967,9,False,0.0
2021,10,3205,10,25,6486,2,13,10,3,6,3,4,2,4,0,False,False,False,0,2,2021-11-15T17:05:58.983,6,False,2.0
2021,10,3205,25,25,6259,2,24,3,9,11,2,11,0,11,0,False,False,False,0,3,2021-11-15T17:09:11.843,11,False,0.0
2021,10,3205,35,25,609,2,39,4,3,4,1,3,1,3,0,True,False,False,0,4,2021-11-16T19:53:25.473,4,False,1.0
2021,10,3205,40,25,6486,13,19,6,26,0,0,0,0,0,0,False,False,False,0,2,2021-11-18T19:39:20.39,0,False,
2021,10,3205,55,25,8422,13,5,5,5,0,0,0,0,0,0,False,False,False,0,4,2021-11-15T10:45:24.733,0,False,0.0
2021,10,3205,60,25,6486,2,9,5,9,9,0,9,0,9,6,False,False,False,0,3,2021-11-15T17:08:54.303,9,True,0.0
2021,10,3205,85,11,8641,2,47,10,1,2,1,2,0,2,0,False,False,False,0,4,2021-11-15T16:43:09.927,2,False,0.0
2021,10,3205,100,25,4227,2,30,10,0,9,9,5,4,5,0,False,False,False,0,4,2022-02-16T20:41:03.267,9,False,4.0
2021,10,3205,105,25,6259,2,34,4,-4,-3,1,-4,1,-4,0,True,False,False,0,3,2021-11-18T18:13:21.91,-3,False,1.0
2021,10,3205,110,25,7060,13,29,3,13,0,0,0,0,0,0,False,False,False,0,2,2021-11-15T11:04:13.49,0,False,0.0
2021,10,3205,125,11,7732,2,51,5,-3,-3,0,-3,0,-3,0,False,False,False,0,1,2021-11-18T16:34:09.237,-3,False,0.0
2021,10,3205,145,25,7060,2,26,9,3,7,4,7,0,7,0,False,False,False,0,3,2021-11-18T19:42:39.75,7,False,0.0
2021,10,3205,150,25,6259,2,35,2,19,17,-2,18,-1,18,0,True,False,False,0,4,2021-11-15T11:24:32.91,17,False,-1.0
2021,10,3205,155,25,7060,2,51,10,-3,-2,1,-2,0,-2,0,False,False,False,0,3,2021-11-18T16:36:19.033,-2,False,0.0
2021,10,3205,160,25,6277,3,31,10,-2,0,0,0,0,0,0,False,False,False,0,1,2021-11-18T19:44:23.307,0,False,0.0
2021,10,3205,165,25,6277,13,32,5,6,0,0,0,0,0,0,False,False,False,0,1,2021-11-18T19:18:41.07,0,False,0.0
2021,10,3205,170,11,4037,13,8,8,40,0,0,0,0,0,0,False,False,False,0,2,2021-11-18T19:19:08.43,0,False,0.0
2021,10,3205,200,25,6259,13,2,10,5,0,0,0,0,0,0,False,False,False,0,3,2021-11-18T16:40:29.333,0,False,0.0
2021,10,3205,205,25,6259,2,47,10,1,1,0,1,0,1,0,True,False,False,0,3,2021-11-16T19:55:09.213,1,False,0.0
2021,10,3205,215,11,8359,2,50,10,-2,7,9,3,4,3,0,False,False,False,0,3,2022-02-14T21:57:29.657,7,False,4.0
2021,10,3205,250,25,6259,2,4,9,4,7,3,6,1,6,0,False,False,False,0,3,2021-11-15T12:00:26.997,7,False,1.0
2021,10,3205,255,25,7060,2,3,3,10,20,10,17,3,17,0,False,False,False,1,2,2021-11-18T18:51:04.403,20,False,3.0
2021,10,3205,265,25,6259,2,34,4,-4,-4,0,-4,0,-4,0,True,False,False,0,4,2021-11-15T12:06:03.277,-4,False,0.0
2021,10,3205,270,25,6259,2,5,5,14,14,0,14,0,14,0,False,False,False,0,3,2021-11-15T12:07:58.003,14,False,0.0
2021,10,3205,305,25,8422,2,4,10,3,6,3,5,1,5,0,True,False,False,0,3,2021-11-18T17:02:42.783,6,False,1.0
2021,10,3205,310,25,7060,2,46,3,2,3,1,3,0,3,0,True,False,False,0,4,2021-11-15T12:25:58.69,3,False,0.0
2021,10,3205,315,25,8422,2,51,10,-1,6,7,2,4,2,0,False,False,False,0,3,2021-11-18T16:34:28.397,6,False,4.0
2021,10,3205,335,11,7732,13,46,3,-1,0,0,0,0,0,0,False,False,False,0,1,2021-11-15T16:51:55.803,0,False,0.0
2021,10,3205,345,11,8359,2,4,3,5,5,0,5,0,5,0,True,False,False,0,3,2021-11-15T12:37:18.113,5,False,0.0
2021,10,3205,385,11,6810,13,53,9,-2,0,0,0,0,0,0,False,False,False,0,4,2022-02-17T22:43:49.537,0,False,0.0
2021,10,3205,430,11,7732,3,48,9,-8,0,0,0,0,0,0,False,False,False,0,1,2021-11-18T18:14:27.83,0,False,0.0
2021,10,3205,465,25,8422,13,6,4,10,0,0,0,0,0,0,False,False,False,0,4,2021-11-18T19:45:34.07,0,False,0.0
2021,10,3205,475,25,7060,13,5,3,10,0,0,0,0,0,0,False,False,False,0,3,2021-11-18T17:07:36.8,0,False,0.0
2021,10,3205,485,25,8421,2,28,10,0,5,5,3,2,3,0,False,False,False,0,1,2021-11-15T13:32:02.367,5,False,2.0
2021,10,3205,490,25,7060,3,9,2,20,0,0,0,0,0,0,False,False,False,0,2,2021-11-18T19:37:11.773,0,False,
2021,10,3205,500,25,6486,13,7,6,16,0,0,0,0,0,0,False,False,False,0,2,2022-02-17T22:45:11.437,0,False,0.0
2021,10,3205,510,25,6486,13,2,10,1,0,0,0,0,0,0,False,False,False,0,2,2021-11-18T16:37:09.473,0,False,0.0
2021,10,3205,520,25,6259,13,4,10,5,0,0,0,0,0,0,False,False,False,0,3,2021-11-15T13:46:33.717,0,False,0.0
2021,10,3205,535,11,8641,13,32,10,1,0,0,0,0,0,0,False,False,False,0,4,2021-11-15T16:57:54.667,0,False,0.0
2021,10,3205,545,11,8359,2,50,10,-1,19,20,-1,20,-1,0,False,False,False,1,3,2021-11-18T18:51:38.233,19,False,20.0
2021,10,3205,560,11,4037,2,50,5,0,0,0,0,0,0,0,False,False,False,0,2,2021-11-18T19:21:12.8,0,False,0.0
2021,10,3205,580,25,7060,13,4,3,10,0,0,0,0,0,0,False,False,False,0,2,2021-11-18T19:47:50.547,0,False,0.0
2021,10,3205,585,25,6259,2,5,2,16,14,-2,14,0,14,0,False,False,False,0,3,2021-11-18T19:21:29.077,14,True,0.0
2021,10,3205,600,25,6486,13,19,6,26,0,0,0,0,0,0,False,False,False,0,2,2021-11-15T14:11:20.353,0,False,0.0
2021,10,3205,625,11,7732,2,48,4,1,5,4,2,3,2,0,False,False,False,0,1,2021-11-18T16:35:08.993,5,False,3.0
2021,10,3205,660,25,6486,13,19,2,26,0,0,0,0,0,0,False,False,False,0,2,2021-11-15T14:28:04.093,0,False,
2021,10,3205,665,25,8421,2,28,4,1,10,9,4,6,4,0,False,False,False,2,1,2021-11-18T19:21:44.11,10,False,6.0
2021,10,3205,685,11,4037,3,2,9,4,0,0,0,0,0,0,False,False,False,0,2,2022-02-16T20:47:12.72,0,False,0.0
2021,10,3205,690,11,6831,2,4,3,2,5,3,3,2,3,0,False,False,False,0,2,2021-11-15T14:36:26.127,5,False,2.0
2021,10,3205,730,25,7060,2,13,5,5,9,4,8,1,8,0,False,False,False,0,3,2021-11-15T14:51:43.063,9,False,1.0
2021,10,3205,740,25,8421,2,47,5,-2,6,8,-1,7,-1,0,False,False,False,1,1,2021-11-15T14:54:31.05,6,False,7.0
2021,10,3205,745,25,7060,13,2,10,7,0,0,0,0,0,0,False,False,False,0,2,2021-11-15T14:55:57.803,0,False,0.0
2021,10,3205,785,25,7060,13,2,10,5,0,0,0,0,0,0,False,False,False,0,2,2021-11-18T16:41:40.693,0,False,0.0
2021,10,3205,795,25,6486,13,2,10,8,0,0,0,0,0,0,False,False,False,0,2,2021-11-15T15:07:18.16,0,False,0.0
2021,10,3205,815,11,4037,2,4,10,5,9,4,6,3,6,0,False,False,False,0,3,2021-11-15T15:11:53.257,9,False,3.0
2021,10,3205,825,11,6831,2,49,10,-3,4,7,2,2,2,0,False,False,False,0,3,2021-11-18T16:39:01.64,4,False,2.0
2021,10,3205,835,11,7732,2,47,5,-1,1,2,1,0,1,0,False,False,False,0,1,2021-11-15T15:16:16.29,1,False,0.0
2021,10,3205,845,11,8359,13,29,6,16,0,0,0,0,0,0,False,False,False,0,3,2021-11-15T16:41:20.217,0,False,0.0
2021,10,3205,850,11,6831,13,4,2,18,0,0,0,0,0,0,False,False,False,0,2,2021-11-15T15:21:41.203,0,False,0.0
2021,10,3205,875,11,8359,2,35,3,11,30,19,29,1,29,0,False,False,False,0,4,2021-11-15T17:01:50.11,30,False,1.0
2021,10,3205,905,25,7060,2,19,2,24,39,15,38,1,38,0,False,True,True,2,2,2021-11-15T17:12:20.593,36,False,1.0
2021,10,3205,910,11,6810,13,17,1,15,0,0,0,0,0,0,False,False,False,0,4,2021-11-18T16:47:11.147,0,False,
2021,10,3205,920,11,7732,13,48,9,-6,0,0,0,0,0,0,False,False,False,0,1,2021-11-18T19:37:28.33,0,False,
2021,10,3205,935,11,8359,2,49,10,-4,3,7,-2,5,-2,0,False,False,False,0,2,2021-11-18T16:40:14.503,3,False,
2021,10,3205,940,11,4037,2,50,3,-3,8,11,3,5,3,0,False,False,False,0,2,2021-11-15T15:51:50.917,8,False,5.0
2021,10,3205,965,25,8422,13,17,1,17,0,0,0,0,0,0,False,False,False,0,4,2022-02-16T20:49:09.637,0,False,0.0
2021,10,3205,985,11,7732,3,12,5,3,0,0,0,0,0,0,False,False,False,0,1,2021-11-18T19:23:28.35,0,False,0.0
2021,10,3205,990,11,8359,13,5,2,19,0,0,0,0,0,0,False,False,False,0,3,2021-11-15T16:09:10.81,0,False,0.0
2021,10,3205,1000,25,8422,2,4,9,9,10,1,10,0,10,0,False,False,False,0,4,2021-11-18T18:18:00.11,10,False,0.0
2021,10,3205,1010,25,8422,3,32,10,-1,0,0,0,0,0,0,False,False,False,0,4,2021-11-18T18:18:21.303,0,False,0.0
2021,10,3205,1015,25,6259,2,4,4,3,6,3,5,1,5,0,False,False,False,0,3,2021-11-15T16:40:46.733,6,False,1.0
2021,10,3205,1025,25,8422,2,39,4,5,8,3,7,1,7,0,False,False,False,0,4,2021-11-15T16:21:54.027,8,False,1.0
2021,10,3205,1030,25,7060,13,29,5,14,0,0,0,0,0,0,False,False,False,0,2,2021-11-15T16:23:13.447,0,False,0.0
2021,10,3205,1035,25,609,2,31,4,3,9,6,9,0,9,0,False,False,False,0,4,2021-11-18T18:19:01.557,9,False,0.0
2021,10,3205,1040,25,8421,2,28,9,-1,7,8,2,5,2,0,False,False,False,1,1,2021-11-18T19:23:42.6,7,False,5.0
2021,10,3205,1050,25,6259,13,5,2,15,0,0,0,0,0,0,False,False,False,0,3,2021-11-18T19:23:52.887,0,False,0.0
2021,10,3205,1055,25,7060,2,13,9,4,10,6,10,0,10,0,False,False,False,1,2,2021-11-18T19:50:49.743,10,True,0.0
2021,10,3205,1060,25,8422,2,47,5,0,1,1,1,0,1,0,False,True,True,0,4,2021-11-15T16:31:42.867,1,False,0.0
2021,10,3205,1065,11,4037,2,6,6,16,12,-4,12,0,12,0,False,False,False,0,2,2021-11-18T19:24:02.47,12,False,0.0
2021,10,3206,15,8,3883,2,6,9,5,6,1,5,1,5,0,False,False,False,0,3,2021-11-15T10:06:11.5,6,False,1.0
2021,10,3206,20,8,7651,13,17,7,16,0,0,0,0,0,0,False,False,False,0,3,2021-11-15T15:04:48.79,0,False,0.0
2021,10,3206,30,8,7652,2,30,5,1,13,12,11,2,11,0,False,False,False,0,4,2021-11-15T10:14:25.753,13,False,2.0
2021,10,3206,55,8,4976,13,5,10,2,0,0,0,0,0,0,False,False,False,0,4,2021-11-15T10:29:10.723,0,False,0.0
2021,10,3206,60,8,7651,13,35,9,2,0,0,0,0,0,0,False,False,False,0,3,2022-02-16T17:04:35.193,0,False,0.0
2021,10,3206,65,8,3883,2,36,3,2,2,0,2,0,2,6,True,False,False,0,3,2021-11-18T18:57:45.613,2,False,0.0
2021,10,3206,85,19,8493,2,48,10,-2,2,4,-2,4,-2,0,False,False,False,1,1,2021-11-18T21:33:03.21,2,False,4.0
2021,10,3206,90,19,4282,2,4,10,11,12,1,12,0,12,0,False,False,False,0,4,2021-11-18T21:47:30.707,12,False,0.0
2021,10,3206,105,19,7175,2,2,10,5,7,2,5,2,5,0,False,False,False,0,3,2021-11-15T10:52:25.05,7,False,2.0
2021,10,3206,125,19,2256,2,5,5,10,11,1,11,0,11,0,False,False,False,0,2,2021-11-15T11:01:59.83,11,False,0.0
2021,10,3206,145,19,1212,2,48,9,-2,20,22,17,3,17,0,False,False,False,0,1,2021-11-15T11:10:37.697,20,False,3.0
2021,10,3206,155,19,4282,2,5,5,3,3,0,3,0,3,6,False,False,False,0,3,2021-11-15T11:14:44.17,3,True,0.0
2021,10,3206,180,8,7651,3,4,9,4,0,0,0,0,0,0,False,False,False,0,3,2021-11-15T11:20:18.62,0,False,0.0
2021,10,3206,185,8,4976,13,5,5,10,0,0,0,0,0,0,False,False,False,0,3,2021-11-18T21:32:48.203,0,False,0.0
2021,10,3206,205,8,232,2,4,10,5,11,6,9,2,9,0,False,False,False,0,3,2021-11-15T11:29:28.177,11,False,2.0
2021,10,3206,210,8,3883,2,6,4,4,11,7,9,2,9,0,False,False,False,0,3,2021-11-15T11:31:32.02,11,False,2.0
2021,10,3206,220,8,7651,13,19,2,21,0,0,0,0,0,0,False,False,False,0,2,2021-11-15T11:35:37.823,0,False,0.0
2021,10,3206,225,8,4976,2,4,3,6,6,0,5,1,5,0,False,False,False,0,2,2021-11-18T18:57:45.63,6,False,
2021,10,3206,230,8,8349,13,7,6,25,0,0,0,0,0,0,True,False,False,0,3,2021-11-18T22:09:06.593,0,False,0.0
2021,10,3206,265,19,4912,2,6,10,11,12,1,12,0,12,0,False,False,False,0,3,2021-11-15T12:00:34.513,12,False,0.0
2021,10,3206,270,19,2256,13,8,2,45,0,0,0,0,0,0,False,False,False,0,3,2021-11-15T12:03:18.32,0,False,0.0
2021,10,3206,280,19,7175,2,19,6,23,26,3,26,0,26,0,False,False,False,0,2,2021-11-15T12:06:28.887,26,False,0.0
2021,10,3206,290,19,4912,2,17,7,20,23,3,21,2,21,6,False,False,False,0,3,2021-11-15T12:10:01.02,23,False,2.0
2021,10,3206,315,8,7009,2,48,5,-4,-1,3,-1,0,-1,0,False,True,False,0,1,2021-11-15T12:21:07.543,-7,False,0.0
2021,10,3206,330,19,8493,2,46,3,1,4,3,2,2,2,0,False,False,False,0,1,2021-11-18T21:31:44.89,4,False,2.0
2021,10,3206,335,19,4912,13,2,10,7,0,0,0,0,0,0,False,False,False,0,2,2021-11-18T21:55:53.28,0,False,
2021,10,3206,360,19,8493,2,48,5,-4,8,12,5,3,5,0,False,False,False,1,1,2021-11-18T21:34:49.15,8,False,3.0
2021,10,3206,365,19,7175,2,46,3,2,5,3,5,0,5,0,False,False,False,0,3,2021-11-18T22:09:23.583,5,False,0.0
2021,10,3206,370,19,4282,2,5,3,11,11,0,11,0,11,0,False,False,False,0,3,2021-11-15T15:05:58.943,11,True,
2021,10,3206,375,19,1212,2,48,10,-2,1,3,1,0,1,0,False,False,False,0,1,2021-11-15T12:40:09.56,1,False,0.0
2021,10,3206,395,19,2256,13,50,3,-3,0,0,0,0,0,0,True,False,False,0,2,2021-11-18T18:57:45.63,0,False,0.0
2021,10,3206,450,8,7009,2,4,5,5,9,4,8,1,8,0,False,False,False,0,2,2021-11-15T13:00:15.373,9,False,1.0
2021,10,3206,455,8,3883,2,26,9,5,6,1,5,1,5,0,False,False,False,0,3,2021-11-15T13:01:54.037,6,False,1.0
2021,10,3206,475,19,2256,2,4,5,3,10,7,5,5,5,0,False,False,False,0,2,2021-11-15T13:07:16.867,10,False,5.0
2021,10,3206,485,19,4282,2,7,6,17,19,2,17,2,17,0,True,False,False,0,3,2021-11-18T21:57:46.75,19,False,2.0
2021,10,3206,495,19,1212,2,48,3,-2,17,19,14,3,14,0,False,False,False,0,1,2021-11-18T21:58:09.63,17,False,3.0
2021,10,3206,500,19,8493,2,32,3,-1,0,1,-1,1,-1,0,False,False,False,1,1,2021-11-18T21:58:37.63,0,False,1.0
2021,10,3206,525,8,7009,2,4,4,5,9,4,7,2,7,0,False,False,False,0,1,2021-11-15T13:22:32.35,9,False,2.0
2021,10,3206,535,8,7009,2,45,5,-5,2,7,1,1,1,0,False,False,False,0,1,2021-11-15T13:25:04.507,2,False,1.0
2021,10,3206,545,8,4976,2,12,5,5,11,6,6,5,6,0,False,False,False,0,3,2022-02-24T16:30:21.667,11,False,5.0
2021,10,3206,550,8,4976,3,17,8,16,0,0,0,0,0,0,False,False,False,0,3,2021-11-15T13:30:50.087,0,False,0.0
2021,10,3206,555,8,7009,13,5,5,4,0,0,0,0,0,0,False,False,False,0,1,2022-02-16T17:05:47.82,0,False,0.0
2021,10,3206,570,19,2256,13,3,5,12,0,0,0,0,0,0,False,False,False,0,2,2021-11-15T13:43:08.623,0,False,
2021,10,3206,575,19,4912,2,50,9,-1,15,16,13,2,13,0,False,False,False,0,3,2021-11-18T18:57:45.63,15,False,2.0
2021,10,3206,605,19,8493,3,46,3,0,0,0,0,0,0,0,False,False,False,0,1,2021-11-15T13:56:26.47,0,False,0.0
2021,10,3206,610,19,4282,2,17,4,3,3,0,3,0,3,6,False,False,False,0,3,2021-11-15T13:58:51.377,3,True,0.0
2021,10,3206,630,8,232,2,50,5,-2,5,7,5,0,5,0,False,False,False,0,3,2021-11-18T21:21:56.723,5,False,0.0
2021,10,3206,635,8,7009,2,48,3,-2,18,20,12,6,12,0,False,False,False,0,1,2021-11-18T21:33:59.72,18,False,6.0
2021,10,3206,640,8,3883,13,12,5,3,0,0,0,0,0,0,False,False,False,0,3,2021-11-18T21:33:32.4,0,False,0.0
2021,10,3206,655,8,3606,13,19,8,39,0,0,0,0,0,0,False,False,False,0,2,2021-11-18T18:57:45.63,0,False,0.0
2021,10,3206,660,8,7651,2,4,3,14,16,2,16,0,16,0,False,False,False,0,2,2021-11-15T14:14:07.837,16,False,0.0
2021,10,3206,675,8,232,2,50,5,-2,3,5,2,1,2,0,False,False,False,0,3,2021-11-18T18:57:45.63,3,False,1.0
2021,10,3206,680,8,7009,2,28,9,2,9,7,6,3,6,0,False,False,False,0,1,2021-11-15T14:18:38.197,9,False,3.0
2021,10,3206,685,8,7652,2,5,5,4,5,1,5,0,5,0,False,False,False,0,3,2021-11-15T14:19:57.62,5,False,0.0
2021,10,3206,705,8,232,13,4,5,3,0,0,0,0,0,0,False,False,False,0,2,2021-11-15T14:26:11.883,0,False,0.0
2021,10,3206,710,8,232,2,52,10,3,7,4,4,3,4,0,False,False,False,0,2,2021-11-15T14:28:40.727,7,False,3.0
2021,10,3206,720,19,7173,2,9,2,24,26,2,26,0,26,0,False,False,False,0,2,2021-11-15T14:32:51.823,26,True,0.0
2021,10,3206,730,19,4912,2,2,9,9,48,39,40,8,40,0,False,False,False,0,2,2021-11-15T14:38:26.48,48,False,8.0
2021,10,3206,745,19,7175,2,47,5,3,11,8,2,9,2,6,False,False,False,1,3,2021-11-18T21:32:27.257,11,False,9.0
2021,10,3206,770,8,7009,2,47,5,0,18,18,4,14,4,0,False,False,False,1,1,2021-11-15T14:50:20.743,18,False,14.0
2021,10,3207,10,18,6262,2,47,5,2,14,12,14,0,14,0,False,False,False,0,4,2021-11-15T11:30:50.83,14,False,0.0
2021,10,3207,20,18,7711,2,30,5,-1,6,7,6,0,6,0,False,False,False,0,3,2021-11-15T17:44:31.45,6,True,0.0
2021,10,3207,30,18,4572,2,45,5,-7,-1,6,-2,1,-2,0,False,False,False,0,1,2021-11-15T17:45:21.937,-1,False,1.0
2021,10,3207,35,18,7711,13,6,7,15,0,0,0,0,0,0,False,False,False,0,2,2021-12-04T20:30:31.21,0,False,0.0
2021,10,3207,55,26,4616,2,48,9,-4,7,11,5,2,5,0,False,False,False,0,1,2021-11-15T11:31:43.44,7,False,2.0
2021,10,3207,70,18,4572,2,45,10,-6,10,16,9,1,9,0,False,False,False,0,1,2021-11-15T11:31:55.253,10,False,1.0
2021,10,3207,80,26,309,2,2,4,7,11,4,10,1,10,0,False,False,False,0,3,2021-11-15T11:32:04.97,11,False,1.0
2021,10,3207,90,26,4619,2,4,9,5,10,5,6,4,6,0,False,False,False,0,3,2021-11-18T18:30:56.4,10,False,4.0
2021,10,3207,105,26,8552,13,6,9,4,0,0,0,0,0,0,False,False,False,0,2,2021-11-18T16:08:20.673,0,False,0.0
2021,10,3207,120,18,7711,13,8,2,35,0,0,0,0,0,0,False,False,False,0,3,2021-12-04T20:31:21.903,0,False,
2021,10,3207,125,18,6900,2,31,4,0,24,24,6,18,6,0,False,False,False,4,1,2021-11-15T11:26:08.503,24,False,18.0
2021,10,3207,135,18,7711,2,5,3,7,7,0,7,0,7,0,False,False,False,0,3,2021-11-15T11:30:41.943,7,False,0.0
2021,10,3207,145,18,4152,2,32,5,3,7,4,6,1,6,0,False,False,False,0,4,2021-11-15T11:40:15.81,7,False,1.0
2021,10,3207,160,18,1381,2,2,9,6,9,3,8,1,8,0,False,False,False,0,3,2021-11-15T11:42:33.657,9,False,1.0
2021,10,3207,170,18,1381,2,13,9,3,3,0,3,0,3,0,False,False,False,0,3,2021-11-15T11:44:37.777,3,False,0.0
2021,10,3207,185,26,309,2,12,5,10,18,8,18,0,18,0,False,False,False,0,2,2021-11-15T17:45:42.403,18,True,0.0
2021,10,3207,190,26,958,2,46,3,0,5,5,1,4,1,0,False,False,False,1,3,2021-11-15T11:57:15.433,5,False,
2021,10,3207,200,26,4619,13,9,2,20,0,0,0,0,0,0,False,False,False,0,2,2021-11-15T11:56:18.917,0,False,
2021,10,3207,205,26,309,2,47,5,1,2,1,2,0,2,0,True,False,False,0,3,2022-02-16T19:48:52.843,2,False,0.0
2021,10,3207,215,26,4616,13,6,5,0,0,0,0,0,0,0,False,False,False,0,1,2021-12-04T20:32:22.443,0,False,0.0
2021,10,3207,230,18,1381,13,5,6,18,0,0,0,0,0,0,False,False,False,0,3,2021-11-17T02:57:33.707,0,False,0.0
2021,10,3207,245,18,1381,13,6,10,5,0,0,0,0,0,0,False,False,False,0,2,2021-11-15T12:15:32.79,0,False,0.0
2021,10,3207,250,18,7711,2,5,6,18,18,0,18,0,18,0,False,False,False,0,2,2021-11-15T12:17:44.403,18,True,0.0
2021,10,3207,265,18,7711,2,6,4,13,21,8,20,1,20,0,False,False,False,0,2,2021-11-15T12:22:25.237,21,False,1.0
2021,10,3207,285,18,7711,13,9,5,1,0,0,0,0,0,0,False,False,False,0,2,2021-11-15T12:34:39.817,0,False,0.0
2021,10,3207,290,18,4152,2,30,9,0,1,1,1,0,1,0,True,False,False,0,4,2021-11-18T18:20:00.24,1,True,
2021,10,3207,295,18,6361,13,17,9,11,0,0,0,0,0,0,True,False,False,0,3,2021-11-18T18:31:29.367,0,False,0.0
2021,10,3207,310,26,309,13,35,7,19,0,0,0,0,0,0,False,False,False,0,3,2021-11-15T13:01:32.537,0,False,0.0
2021,10,3207,320,18,7711,2,6,4,13,21,8,13,8,13,0,False,False,False,1,2,2021-11-18T18:31:59.663,21,False,8.0
2021,10,3207,340,18,6361,2,6,4,5,5,0,5,0,5,6,False,False,False,0,4,2021-11-15T13:16:47.26,5,True,0.0
2021,10,3207,360,26,4619,2,18,5,0,7,7,3,4,3,0,False,False,False,0,2,2021-11-15T13:20:25.807,7,False,4.0
2021,10,3207,375,26,7453,3,5,5,6,0,0,0,0,0,0,False,False,False,0,3,2021-11-15T13:29:13.257,0,False,0.0
2021,10,3207,380,26,309,13,9,6,33,0,0,0,0,0,0,False,False,False,0,3,2021-11-18T19:40:55.507,0,False,
2021,10,3207,385,26,4616,2,5,3,4,6,2,6,0,6,0,False,False,False,0,1,2021-11-15T17:47:50.707,6,False,
2021,10,3207,390,26,309,2,30,10,0,8,8,6,2,6,0,False,False,False,0,4,2021-11-16T19:42:09.943,8,False,2.0
2021,10,3207,410,26,4619,2,2,10,4,5,1,4,1,4,0,False,False,False,0,2,2021-11-15T13:46:24.04,5,False,1.0
2021,10,3207,450,18,7712,13,3,4,13,0,0,0,0,0,0,False,False,False,0,3,2021-11-15T14:00:53.713,0,False,0.0
2021,10,3207,465,26,309,2,4,10,3,4,1,4,0,4,0,False,False,False,0,3,2021-11-15T14:03:25.677,4,False,0.0
2021,10,3207,470,26,958,13,5,5,8,0,0,0,0,0,0,False,False,False,0,3,2021-11-15T14:05:03.213,0,False,0.0
2021,10,3207,495,26,309,2,5,2,18,22,4,21,1,21,0,False,False,False,0,2,2021-11-15T14:11:49.917,22,False,1.0
2021,10,3207,500,26,7491,2,47,5,1,17,16,16,1,16,0,False,False,False,0,4,2021-11-15T14:22:22.567,17,False,1.0
2021,10,3207,510,26,4619,2,30,10,-1,11,12,10,1,10,0,False,False,False,0,3,2021-11-15T14:33:14.91,11,False,1.0
2021,10,3207,520,26,4619,13,2,4,6,0,0,0,0,0,0,False,False,False,0,3,2022-02-16T19:50:54.473,0,False,0.0
2021,10,3207,525,26,958,2,5,3,10,10,0,10,0,10,0,False,False,False,0,3,2021-11-15T23:46:39.893,10,False,0.0
2021,10,3207,535,26,7491,13,47,5,1,0,0,0,0,0,0,False,False,False,0,4,2021-11-15T14:51:10.09,0,False,0.0
2021,10,3207,540,26,4616,2,4,4,2,2,0,2,0,2,6,False,False,False,0,1,2021-11-15T14:52:37.517,2,True,0.0
2021,10,3207,555,18,7711,2,30,3,0,4,4,4,0,4,0,False,False,False,0,3,2021-11-15T14:56:40.657,4,True,0.0
2021,10,3207,590,26,4616,13,11,2,15,0,0,0,0,0,0,False,False,False,0,1,2021-11-15T15:19:49.143,0,False,0.0
2021,10,3207,610,18,7711,2,19,6,22,27,5,25,2,25,0,False,False,False,0,2,2021-11-15T15:37:10.35,27,False,2.0
2021,10,3207,620,18,6262,3,39,4,7,0,0,0,0,0,0,False,False,False,0,3,2021-11-15T15:40:27.853,0,False,0.0
2021,10,3207,625,18,7711,13,5,3,13,0,0,0,0,0,0,False,False,False,0,3,2021-11-15T15:41:15.577,0,False,
2021,10,3207,630,18,1381,2,18,5,-1,19,20,1,18,1,0,False,False,False,1,2,2022-02-16T19:53:32.493,19,False,18.0
2021,10,3207,650,18,6361,2,35,9,1,1,0,1,0,1,6,True,False,False,0,4,2021-11-15T15:54:19.787,1,True,0.0
2021,10,3207,670,26,958,13,5,5,7,0,0,0,0,0,0,False,False,False,0,3,2021-11-15T16:09:14.363,0,False,0.0
2021,10,3207,675,26,309,13,5,3,12,0,0,0,0,0,0,True,False,False,0,3,2021-11-16T19:43:10.87,0,False,0.0
2021,10,3207,685,18,4152,2,32,3,2,3,1,3,0,3,0,False,False,False,0,4,2022-02-16T19:53:16.503,3,False,0.0
2021,10,3207,695,18,7711,2,2,10,7,12,5,11,1,11,0,True,False,False,0,3,2021-11-15T16:24:08.77,12,False,1.0
2021,10,3207,710,18,4572,2,48,10,-5,15,20,13,2,13,0,False,False,False,0,1,2021-11-17T02:57:47.917,15,False,2.0
2021,10,3207,725,18,1381,2,6,9,9,16,7,10,6,10,0,False,False,False,1,3,2021-11-17T02:57:59.66,16,False,6.0
2021,10,3207,765,26,309,2,3,10,7,7,0,6,1,6,0,False,False,False,0,3,2021-11-15T16:53:29.783,7,False,1.0
2021,10,3207,770,26,8552,2,5,5,6,7,1,7,0,7,0,False,False,False,0,3,2021-11-15T16:55:09.03,7,False,0.0
2021,10,3207,775,26,4616,3,16,10,5,0,0,0,0,0,0,False,False,False,0,1,2021-11-15T16:56:12.11,0,False,0.0
2021,10,3207,780,26,309,2,35,2,18,26,8,20,6,20,0,False,False,False,0,3,2021-11-15T16:59:16.04,26,False,6.0
2021,10,3207,790,26,309,13,2,4,6,0,0,0,0,0,0,False,False,False,0,3,2021-11-15T17:04:38.17,0,False,0.0
2021,10,3207,795,26,8552,2,2,10,5,13,8,8,5,8,0,False,False,False,0,2,2021-11-15T17:10:43.787,13,False,5.0
2021,10,3207,800,26,4616,2,5,9,4,6,2,5,1,5,0,False,False,False,0,1,2021-11-15T17:07:16.053,6,False,1.0
2021,10,3207,805,26,4619,3,2,9,3,0,0,0,0,0,0,False,False,False,0,2,2021-11-16T19:43:27.937,0,False,0.0
2021,10,3207,810,26,8552,2,2,10,2,2,0,2,0,2,0,False,False,False,0,2,2021-11-15T17:10:03.27,2,False,0.0
2021,10,3207,830,18,4152,2,26,4,0,3,3,1,2,1,0,False,False,False,0,4,2021-11-18T16:08:20.673,3,False,2.0
2021,10,3207,840,18,7711,2,29,2,23,27,4,26,1,26,0,False,False,False,0,2,2021-11-15T17:18:35.82,27,False,1.0
2021,10,3207,850,18,6361,2,47,5,2,5,3,4,1,4,0,False,False,False,0,4,2021-11-15T17:21:58.94,5,False,1.0
2021,10,3207,860,18,6361,13,9,6,29,0,0,0,0,0,0,True,False,False,0,3,2021-11-15T17:26:06.797,0,False,0.0
2021,10,3207,870,18,1381,2,6,8,18,18,0,18,0,18,0,False,False,False,0,2,2021-11-15T17:28:21.63,18,False,0.0
2021,10,3208,10,1,894,2,46,9,1,1,0,1,0,1,0,False,False,False,0,4,2021-11-15T17:18:58.453,1,False,0.0
2021,10,3208,15,1,910,2,51,5,-2,4,6,3,1,3,0,False,False,False,0,2,2021-11-15T17:15:12.64,4,False,1.0
2021,10,3208,25,5,3477,13,5,5,-4,0,0,0,0,0,0,False,False,False,0,3,2021-11-15T17:19:27.943,0,False,0.0
2021,10,3208,35,5,4799,2,16,4,7,13,6,9,4,9,0,True,False,False,0,1,2021-11-15T11:25:12.483,13,False,4.0
2021,10,3208,65,1,8439,13,9,6,23,0,0,0,0,0,0,False,False,False,0,3,2021-11-18T14:37:24.28,0,False,0.0
2021,10,3208,85,5,3477,2,5,3,5,17,12,16,1,16,0,False,False,False,0,3,2021-11-18T15:37:38.193,17,False,1.0
2021,10,3208,100,5,3477,2,47,5,2,2,0,2,0,2,6,False,False,False,0,3,2021-11-18T14:37:24.28,2,True,0.0
2021,10,3208,120,1,6405,2,5,6,19,19,0,19,0,19,0,False,False,False,0,2,2021-11-15T11:51:06.067,19,False,0.0
2021,10,3208,130,1,6405,2,26,10,5,5,0,5,0,5,0,False,False,False,0,3,2021-11-18T15:45:35.86,5,False,0.0
2021,10,3208,135,1,6405,2,5,3,7,20,13,20,0,20,0,False,False,False,0,2,2021-11-15T11:55:30.193,20,True,0.0
2021,10,3208,140,1,6933,13,4,7,18,0,0,0,0,0,0,False,False,False,0,2,2021-11-18T14:37:24.28,0,False,0.0
2021,10,3208,150,5,5220,2,4,9,6,6,0,6,0,6,0,False,False,False,0,3,2021-11-16T19:03:23.767,6,False,0.0
2021,10,3208,170,5,5220,13,2,10,7,0,0,0,0,0,0,False,False,False,0,2,2022-02-16T16:08:53.817,0,False,0.0
2021,10,3208,175,5,3477,2,8,9,12,16,4,14,2,14,0,False,False,False,0,3,2021-11-15T13:34:25.737,16,False,2.0
2021,10,3208,190,5,5220,2,51,9,-3,-2,1,-2,0,-2,0,False,False,False,0,3,2021-11-18T15:02:16.223,-2,False,0.0
2021,10,3208,210,1,6405,2,4,10,4,4,0,4,0,4,0,False,False,False,0,3,2021-11-18T15:02:29.457,4,False,0.0
2021,10,3208,215,1,910,13,9,5,10,0,0,0,0,0,0,False,False,False,0,2,2022-02-25T15:44:20.63,0,False,0.0
2021,10,3208,220,1,4587,13,7,2,15,0,0,0,0,0,0,False,False,False,0,1,2021-11-15T13:47:28.34,0,False,0.0
2021,10,3208,230,1,6405,13,4,9,13,0,0,0,0,0,0,False,False,False,0,3,2021-11-15T13:49:21.467,0,False,0.0
2021,10,3208,255,5,4799,2,16,9,4,6,2,5,1,5,0,False,False,False,0,1,2021-11-15T17:20:19.03,6,False,1.0
2021,10,3208,260,5,5220,2,2,9,5,10,5,6,4,6,0,False,False,False,0,2,2021-11-18T15:02:40.293,10,False,4.0
2021,10,3208,270,5,8406,13,35,5,13,0,0,0,0,0,0,False,False,False,0,3,2022-02-16T16:10:53,0,False,0.0
2021,10,3208,275,5,3477,2,51,3,-3,2,5,1,1,1,0,True,False,False,0,2,2021-11-16T19:04:10.963,2,False,1.0
2021,10,3208,285,5,3477,13,39,9,6,0,0,0,0,0,0,False,False,False,0,4,2021-11-18T15:46:37.327,0,False,0.0
2021,10,3208,300,1,8439,3,5,5,12,0,0,0,0,0,0,False,False,False,0,3,2021-11-15T14:11:29.207,0,False,0.0
2021,10,3208,310,1,4587,2,48,9,-2,0,2,-1,1,-1,0,False,False,False,0,1,2021-11-18T15:02:50.92,0,False,1.0
2021,10,3208,315,1,6405,2,50,3,-5,-5,0,-5,0,-5,0,False,False,False,0,2,2021-11-18T14:37:24.327,0,False,0.0
2021,10,3208,345,5,566,2,44,3,-5,3,8,1,2,1,0,False,False,False,0,1,2021-11-16T19:04:28.643,3,False,2.0
2021,10,3208,350,5,566,2,48,9,-5,11,16,7,4,7,0,False,False,False,0,1,2021-11-15T14:30:13.32,11,False,4.0
2021,10,3208,355,5,8406,13,2,1,19,0,0,0,0,0,0,False,False,False,0,3,2021-11-18T15:03:02.08,0,True,0.0
2021,10,3208,360,1,894,13,4,9,3,0,0,0,0,0,0,True,False,False,0,3,2021-11-15T14:34:29.52,0,False,0.0
2021,10,3208,365,1,6405,2,5,10,4,5,1,4,1,4,0,False,False,False,0,3,2021-11-15T14:36:11.417,5,False,1.0
2021,10,3208,375,1,910,13,8,8,15,0,0,0,0,0,0,False,False,False,0,2,2022-02-16T16:21:14.933,0,False,0.0
2021,10,3208,390,5,4799,2,4,9,6,6,0,6,0,6,0,True,False,False,0,1,2021-11-18T15:08:08.113,6,False,0.0
2021,10,3208,400,5,4799,2,16,9,3,9,6,7,2,7,0,False,False,False,0,1,2021-11-15T14:44:57.257,9,False,2.0
2021,10,3208,405,5,4799,2,47,5,2,2,0,2,0,2,0,False,False,False,0,1,2021-11-15T14:46:41.42,2,False,0.0
2021,10,3208,415,5,5220,2,2,5,5,10,5,10,0,10,0,False,False,False,0,2,2021-11-18T15:03:12.713,10,False,0.0
2021,10,3208,420,5,566,2,4,10,5,6,1,5,1,5,0,False,False,False,0,1,2021-11-15T14:51:37,6,False,1.0
2021,10,3208,430,5,6372,2,35,10,8,10,2,8,2,8,0,False,False,False,0,4,2021-11-18T15:45:01.477,10,False,2.0
2021,10,3208,435,5,4799,2,47,5,0,1,1,1,0,1,0,False,False,False,0,1,2021-11-15T14:56:20.507,1,False,0.0
2021,10,3208,440,5,4799,2,6,5,3,2,-1,2,0,2,0,False,False,False,0,2,2021-11-15T14:57:38.52,2,False,0.0
2021,10,3208,475,5,5220,2,4,5,5,4,-1,4,0,4,0,False,False,False,0,2,2021-11-18T15:47:50.757,4,False,
2021,10,3208,480,5,4799,2,48,5,-6,3,9,0,3,0,0,True,False,False,0,1,2021-11-16T19:05:26.553,3,False,3.0
2021,10,3208,495,1,894,2,7,2,15,19,4,17,2,17,0,False,False,False,0,4,2021-11-18T15:48:54.94,19,False,2.0
2021,10,3208,500,1,4587,2,48,10,-3,21,24,20,1,20,0,False,False,False,0,1,2021-11-15T15:20:00.447,21,False,1.0
2021,10,3208,515,1,894,13,7,6,29,0,0,0,0,0,0,False,False,False,0,3,2021-11-15T15:29:46.167,0,False,0.0
2021,10,3208,530,5,5220,13,50,10,-2,0,0,0,0,0,0,False,False,False,0,2,2021-11-16T19:04:47.723,0,False,0.0
2021,10,3208,535,5,4799,2,6,9,3,9,6,7,2,7,0,True,False,False,0,1,2021-11-16T19:05:04.993,9,False,2.0
2021,10,3208,545,5,6372,2,51,5,-2,8,10,8,0,8,0,False,False,False,0,3,2021-11-15T15:37:57.74,8,False,0.0
2021,10,3208,555,5,5220,13,19,6,33,0,0,0,0,0,0,False,False,False,0,2,2021-11-15T15:40:59.72,0,False,
2021,10,3208,565,5,4799,2,11,3,3,15,12,10,5,10,0,False,False,False,0,1,2021-11-15T15:45:31.977,15,False,5.0
2021,10,3208,585,1,6933,13,19,6,35,0,0,0,0,0,0,False,False,False,0,2,2021-11-15T15:52:03,0,False,
2021,10,3208,605,1,8439,2,38,10,0,7,7,7,0,7,0,False,False,False,0,3,2021-11-15T15:58:40.313,7,True,0.0
2021,10,3208,625,1,894,2,32,5,-1,9,10,5,4,5,0,False,False,False,0,4,2021-11-15T16:05:05.83,9,False,4.0
2021,10,3208,670,1,4587,2,45,5,-3,-5,-2,-5,0,-5,0,False,False,False,1,1,2021-11-15T17:16:23.54,-5,False,0.0
2021,10,3208,675,1,910,13,9,5,11,0,0,0,0,0,0,False,False,False,0,2,2021-11-18T15:03:44.96,0,False,0.0
2021,10,3208,680,1,894,2,2,4,12,17,5,13,4,13,0,False,False,False,0,3,2021-11-18T15:23:03.957,17,False,4.0
2021,10,3208,685,1,6405,2,47,5,3,5,2,5,0,5,0,False,False,False,0,3,2021-11-15T16:28:16.09,5,False,0.0
2021,10,3208,705,1,8439,2,5,3,3,3,0,3,0,3,0,False,False,False,0,3,2021-11-18T14:37:24.343,3,False,0.0
2021,10,3208,720,1,910,13,9,5,11,0,0,0,0,0,0,False,False,False,0,2,2021-11-15T16:37:23.593,0,False,0.0
2021,10,3208,745,5,5220,13,5,3,5,0,0,0,0,0,0,False,False,False,0,2,2021-11-15T16:45:35.02,0,False,0.0
2021,10,3208,755,5,566,2,47,5,0,7,7,6,1,6,0,False,False,False,0,1,2021-11-18T15:43:28.437,7,False,1.0
2021,10,3208,780,5,8408,2,55,4,-2,3,5,0,3,0,0,False,False,False,0,4,2022-02-16T16:23:47.41,3,False,3.0
2021,10,3208,800,1,7762,13,16,10,3,0,0,0,0,0,0,False,False,False,0,1,2022-02-16T16:25:00.89,0,False,0.0
2021,10,3209,25,24,6389,2,48,9,-5,16,21,13,3,13,0,False,False,False,0,1,2021-11-15T09:29:52.617,16,False,3.0
2021,10,3209,35,24,7800,2,5,2,15,18,3,16,2,16,0,False,False,False,0,3,2021-11-15T09:34:47.547,18,False,2.0
2021,10,3209,40,24,7800,2,51,3,-4,3,7,-3,6,-3,0,False,False,False,1,3,2022-02-16T16:39:44.25,3,False,6.0
2021,10,3209,50,24,7798,13,12,5,12,0,0,0,0,0,0,False,False,False,0,3,2021-11-15T09:45:28.693,0,False,0.0
2021,10,3209,70,10,282,3,45,5,-4,0,0,0,0,0,0,False,False,False,0,1,2021-11-18T16:46:02.863,0,False,0.0
2021,10,3209,75,10,282,2,45,5,-2,-2,0,-2,0,-2,0,False,False,False,0,1,2021-11-18T20:27:50.683,-2,False,0.0
2021,10,3209,90,24,6373,2,30,3,4,4,0,4,0,4,0,False,False,False,0,4,2021-11-15T10:01:31.267,4,True,0.0
2021,10,3209,110,24,7800,2,44,3,-1,6,7,6,0,6,0,True,False,False,0,3,2021-11-18T20:29:51.113,6,False,0.0
2021,10,3209,115,24,6373,2,6,6,16,24,8,21,3,21,0,False,False,False,0,3,2021-11-15T10:15:29.4,24,False,3.0
2021,10,3209,130,24,8509,2,24,2,36,36,0,36,0,36,6,False,False,False,0,3,2021-11-15T17:10:53.913,36,False,0.0
2021,10,3209,175,10,4930,2,13,5,3,7,4,5,2,5,0,False,False,False,0,3,2021-11-18T20:32:16.653,7,False,2.0
2021,10,3209,185,10,7700,2,4,5,4,5,1,4,1,4,0,False,False,False,1,3,2021-11-15T10:49:04.403,5,False,1.0
2021,10,3209,240,10,7703,2,39,4,5,64,59,62,2,62,0,False,False,False,0,4,2021-11-18T18:03:19.123,64,False,2.0
2021,10,3209,250,10,7700,3,30,3,1,0,0,0,0,0,0,True,False,False,0,4,2022-02-16T16:41:10.867,0,False,0.0
2021,10,3209,260,10,4930,13,29,3,3,0,0,0,0,0,0,False,False,False,0,2,2021-11-15T11:24:49.437,0,False,0.0
2021,10,3209,295,24,6389,2,50,3,-1,8,9,7,1,7,0,False,False,False,0,2,2021-11-15T11:38:11.763,8,False,1.0
2021,10,3209,320,24,7800,2,13,10,2,6,4,4,2,4,0,False,False,False,0,2,2021-11-15T18:16:47.98,6,False,2.0
2021,10,3209,325,24,8666,2,47,5,2,4,2,3,1,3,0,False,False,False,0,4,2021-11-15T11:54:20.55,4,False,1.0
2021,10,3209,335,24,8509,2,2,9,5,5,0,5,0,5,6,False,False,False,0,3,2021-11-15T12:00:07.133,5,True,0.0
2021,10,3209,350,10,282,3,48,9,0,0,0,0,0,0,0,False,False,False,0,1,2021-11-15T12:03:52.347,0,False,0.0
2021,10,3209,360,10,7700,2,4,10,4,4,0,4,0,4,0,False,False,False,0,3,2021-11-15T18:04:01.86,4,False,0.0
2021,10,3209,385,24,8513,2,12,5,5,9,4,9,0,9,0,False,False,False,0,1,2021-11-15T12:21:15.737,9,False,0.0
2021,10,3209,390,24,8509,2,6,10,5,11,6,8,3,8,0,False,False,False,1,2,2021-11-18T17:40:53.703,11,False,3.0
2021,10,3209,395,24,7798,2,3,3,12,12,0,12,0,12,0,False,False,False,0,2,2021-11-15T12:31:38.88,12,True,0.0
2021,10,3209,400,24,8509,2,6,9,5,14,9,11,3,11,0,False,False,False,0,2,2021-11-15T12:34:04.683,14,False,3.0
2021,10,3209,405,24,8509,13,21,6,24,0,0,0,0,0,0,False,False,False,0,2,2021-11-18T16:46:02.88,0,False,0.0
2021,10,3209,410,24,8666,13,5,3,11,0,0,0,0,0,0,False,False,False,0,3,2021-11-15T12:37:30.097,0,False,0.0
2021,10,3209,420,24,7800,3,19,6,34,0,0,0,0,0,0,False,False,False,0,2,2021-11-15T12:40:23.86,0,False,0.0
2021,10,3209,435,10,6840,2,32,5,4,13,9,10,3,10,0,False,False,False,0,4,2021-11-15T12:43:36.627,13,False,3.0
2021,10,3209,450,10,6840,2,32,5,3,15,12,10,5,10,0,False,False,False,0,4,2021-11-15T12:49:34.3,15,False,5.0
2021,10,3209,455,10,6281,2,6,7,20,26,6,24,2,24,0,False,False,False,0,2,2022-02-16T16:41:53.717,26,False,2.0
2021,10,3209,470,10,8541,13,47,10,1,0,0,0,0,0,0,False,False,False,0,1,2021-11-15T18:05:01.547,0,False,0.0
2021,10,3209,480,10,8541,2,6,4,5,10,5,8,2,8,0,False,False,False,0,1,2021-11-15T13:03:59.383,10,False,2.0
2021,10,3209,495,24,8666,2,4,10,3,2,-1,3,-1,3,0,False,False,False,0,3,2021-11-15T13:10:30.453,2,False,-1.0
2021,10,3209,500,24,8509,13,7,2,21,0,0,0,0,0,0,False,False,False,0,2,2021-11-15T13:14:02.08,0,False,0.0
2021,10,3209,525,10,7700,2,4,10,7,7,0,7,0,7,0,False,False,False,0,3,2021-11-15T17:09:20.227,7,False,0.0
2021,10,3209,535,10,7703,2,31,9,4,4,0,4,0,4,0,False,False,False,0,4,2021-11-18T20:42:00.163,4,False,0.0
2021,10,3209,540,10,6281,13,12,10,3,0,0,0,0,0,0,False,False,False,0,2,2021-11-18T17:27:25.347,0,False,0.0
2021,10,3209,550,10,282,13,5,3,3,0,0,0,0,0,0,False,False,False,0,1,2021-11-15T13:49:37.977,0,False,0.0
2021,10,3209,555,10,6840,2,32,10,4,10,6,10,0,10,0,False,False,False,0,4,2021-11-15T13:52:05.16,10,False,0.0
2021,10,3209,585,24,7800,13,11,2,21,0,0,0,0,0,0,True,False,False,0,3,2021-11-18T20:43:21.28,0,False,0.0
2021,10,3209,590,10,6840,2,4,9,5,6,1,5,1,5,0,False,False,False,0,4,2021-11-15T14:09:27.903,6,False,1.0
2021,10,3209,595,10,6840,2,6,9,14,15,1,14,1,14,0,False,False,False,0,3,2021-11-15T14:17:26.49,15,False,1.0
2021,10,3209,600,10,7700,13,4,9,6,0,0,6,-1005,6,0,False,False,False,0,3,2021-11-15T14:15:38.75,0,False,0.0
2021,10,3209,610,10,4930,2,4,10,4,7,3,5,2,5,0,False,False,False,0,3,2021-11-15T14:19:52.967,7,False,2.0
2021,10,3209,635,10,7700,2,4,10,4,5,1,4,1,4,0,False,False,False,0,3,2021-11-18T20:43:49.263,5,False,1.0
2021,10,3209,640,10,8541,2,12,5,-9,-9,0,-9,0,-9,0,False,False,False,0,1,2021-11-15T14:34:23.93,-9,False,0.0
2021,10,3209,645,10,7700,13,24,6,46,0,0,0,0,0,0,False,False,False,0,2,2022-02-25T15:46:44.247,0,False,0.0
2021,10,3209,720,10,4930,13,4,5,10,0,0,0,0,0,0,False,False,False,0,2,2021-11-18T20:48:04.59,0,False,0.0
2021,10,3209,725,10,4930,2,13,4,1,0,-1,0,0,0,0,False,False,False,0,3,2021-11-15T15:37:02.55,0,False,0.0
2021,10,3209,760,10,7700,2,2,10,7,13,6,10,3,10,0,False,True,False,2,3,2021-11-18T18:03:59.33,13,False,3.0
2021,10,3209,765,10,7703,2,4,9,6,9,3,7,2,7,0,False,False,False,0,3,2021-11-18T17:37:51.257,9,False,2.0
2021,10,3209,770,10,6281,13,19,6,35,0,0,0,0,0,0,False,False,False,0,2,2021-11-15T18:06:54.65,0,False,
2021,10,3209,775,10,7700,2,4,9,9,14,5,10,4,10,0,False,False,False,0,3,2021-11-15T16:21:33.723,14,False,4.0
2021,10,3209,780,10,6840,13,4,10,4,0,0,0,0,0,0,False,False,False,0,3,2021-11-15T16:21:49.443,0,False,0.0
2021,10,3209,785,10,6281,2,4,10,3,3,0,3,0,3,0,False,False,False,0,2,2021-11-18T20:48:26.933,3,False,0.0
2021,10,3209,790,10,6281,13,9,5,10,0,0,0,0,0,0,False,False,False,0,2,2021-11-15T16:25:37.343,0,False,0.0
2021,10,3209,795,10,4930,13,12,5,10,0,0,0,0,0,0,False,False,False,0,3,2021-11-15T16:28:22.05,0,False,0.0
2021,10,3210,10,12,556,2,51,9,0,3,3,3,0,3,0,False,False,False,0,3,2021-11-19T00:44:08.31,3,False,0.0
2021,10,3210,15,12,556,13,5,3,4,0,0,0,0,0,0,False,False,False,0,3,2022-02-17T23:23:51.987,0,False,0.0
2021,10,3210,20,12,6357,2,19,6,25,41,16,37,4,37,0,False,False,False,0,2,2021-11-18T22:48:54.66,41,False,4.0
2021,10,3210,40,12,556,2,4,10,9,9,0,9,0,9,0,False,False,False,0,3,2021-11-15T10:36:31.943,9,False,0.0
2021,10,3210,80,12,7593,2,46,3,2,4,2,2,2,2,0,True,False,False,0,4,2021-11-15T10:53:55.527,4,False,2.0
2021,10,3210,95,27,4850,2,51,3,1,12,11,4,8,4,0,False,False,False,1,4,2021-11-19T00:06:39.963,12,False,8.0
2021,10,3210,100,27,650,13,7,2,34,0,0,0,0,0,0,False,False,False,0,3,2021-11-15T11:08:28.317,0,False,
2021,10,3210,115,27,6397,2,53,10,-6,-6,0,-6,0,-6,0,False,False,False,0,4,2022-02-16T17:13:18.003,-6,False,0.0
2021,10,3210,135,12,6357,13,19,2,41,0,0,0,0,0,0,False,False,False,0,2,2021-11-19T00:17:26,0,False,0.0
2021,10,3210,140,12,6691,13,8,8,36,0,0,0,0,0,0,False,False,False,0,3,2021-11-15T11:30:07.953,0,False,0.0
2021,10,3210,155,27,7408,3,2,9,7,0,0,0,0,0,0,False,False,False,0,3,2022-02-16T17:13:57.917,0,False,0.0
2021,10,3210,160,27,4850,2,53,9,-5,6,11,-5,11,-5,0,False,False,False,1,4,2021-11-15T11:37:23.023,6,False,11.0
2021,10,3210,170,12,556,2,51,9,-2,6,8,3,3,3,0,False,False,False,0,3,2021-11-15T11:39:37.587,6,False,3.0
2021,10,3210,190,12,7742,2,48,9,-2,12,14,7,5,7,0,False,False,False,0,1,2021-11-19T00:21:13.96,12,False,5.0
2021,10,3210,200,12,496,2,51,5,-5,6,11,3,3,3,0,True,False,False,0,3,2022-02-16T19:31:41.31,6,False,3.0
2021,10,3210,205,12,556,2,6,7,15,34,19,25,9,25,0,False,False,False,0,2,2021-11-15T11:55:23.19,34,False,9.0
2021,10,3210,210,12,556,13,51,3,-1,0,0,0,0,0,0,False,False,False,0,3,2021-11-15T11:57:07.03,0,False,0.0
2021,10,3210,215,12,467,2,53,10,-2,3,5,1,2,1,0,False,False,False,0,4,2021-11-15T12:00:31.707,3,False,2.0
2021,10,3210,235,12,556,13,2,10,4,0,0,0,0,0,0,False,False,False,0,3,2021-11-15T12:07:50.78,0,False,0.0
2021,10,3210,240,12,496,13,12,3,9,0,0,0,0,0,0,False,False,False,0,3,2021-11-15T12:09:35.333,0,False,0.0
2021,10,3210,255,27,6397,2,13,9,4,28,24,28,0,28,0,False,False,False,0,4,2021-11-15T12:25:51.36,28,False,0.0
2021,10,3210,280,12,7743,2,47,5,2,4,2,2,2,2,0,True,False,False,0,4,2021-11-15T12:37:47.73,4,False,2.0
2021,10,3210,285,12,556,2,2,9,4,14,10,10,4,10,0,False,False,False,0,3,2021-11-15T12:39:58.667,14,False,4.0
2021,10,3210,290,12,4537,3,48,10,-3,0,0,0,0,0,0,False,False,False,0,1,2021-11-19T00:26:07.593,0,False,0.0
2021,10,3210,300,12,7743,13,12,5,12,0,0,0,0,0,0,False,False,False,0,3,2021-11-19T00:26:33.663,0,False,
2021,10,3210,305,12,496,2,4,10,5,8,3,5,3,5,0,False,False,False,1,2,2022-03-08T19:14:04.103,8,False,3.0
2021,10,3210,315,12,4537,2,47,5,0,10,10,6,4,6,0,False,False,False,0,1,2022-03-08T19:14:35.157,10,False,4.0
2021,10,3210,330,12,6691,2,13,5,5,6,1,6,0,6,0,False,False,False,0,3,2021-11-18T22:48:54.66,6,True,0.0
2021,10,3210,345,12,6691,13,4,10,4,0,0,0,0,0,0,False,False,False,0,3,2021-11-15T13:22:02.553,0,False,0.0
2021,10,3210,350,27,7408,2,4,3,0,1,1,0,1,0,0,False,False,False,0,2,2021-11-15T13:24:59.87,1,False,1.0
2021,10,3210,360,27,4850,2,39,10,7,9,2,7,2,7,0,False,False,False,0,4,2022-03-08T19:14:54.11,9,False,2.0
2021,10,3210,365,27,4850,2,5,5,4,9,5,6,3,6,0,False,False,False,0,3,2022-03-08T19:15:14.74,9,False,3.0
2021,10,3210,375,27,7408,2,5,3,7,7,0,7,0,7,0,False,False,False,0,2,2021-11-15T13:39:28.617,7,True,0.0
2021,10,3210,380,27,650,13,19,2,35,0,0,0,0,0,0,False,False,False,0,2,2021-11-19T00:53:56.09,0,False,0.0
2021,10,3210,385,27,7408,13,7,6,15,0,0,0,0,0,0,False,False,False,0,2,2021-11-15T13:46:00.487,0,False,
2021,10,3210,395,27,7408,13,19,6,45,0,0,0,0,0,0,False,False,False,0,2,2021-11-15T13:48:45.583,0,False,0.0
2021,10,3210,410,27,4850,2,30,10,-2,5,7,2,3,2,0,False,False,False,0,4,2021-11-19T00:08:07.967,5,False,3.0
2021,10,3210,420,27,650,13,5,2,15,0,0,0,0,0,0,False,False,False,0,3,2021-11-15T14:00:26.003,0,False,0.0
2021,10,3210,430,27,7852,13,12,6,43,0,0,0,0,0,0,False,False,False,0,2,2022-02-24T16:31:49.143,0,False,0.0
2021,10,3210,445,12,6691,3,35,7,29,0,0,0,0,0,0,False,False,False,0,3,2021-11-18T23:29:56.423,0,False,0.0
2021,10,3210,455,12,4537,2,32,5,3,4,1,4,0,4,0,False,False,False,0,3,2021-11-15T14:13:08.493,4,False,0.0
2021,10,3210,465,27,650,2,12,3,7,7,0,7,0,7,0,True,False,False,0,3,2021-11-15T14:16:47.38,7,True,0.0
2021,10,3210,470,27,7408,2,35,8,16,18,2,17,1,17,0,False,False,False,0,3,2022-03-08T19:16:00.347,18,False,1.0
2021,10,3210,475,27,650,13,4,9,3,0,0,0,0,0,0,False,False,False,0,2,2021-11-15T14:20:54.427,0,False,0.0
2021,10,3210,480,27,3656,2,45,5,-5,8,13,6,2,6,0,False,False,False,1,1,2021-11-15T14:22:25.463,8,False,2.0
2021,10,3210,495,27,7496,13,9,6,18,0,0,0,0,0,0,False,False,False,0,2,2022-02-16T19:33:30.69,0,False,0.0
2021,10,3210,500,27,7404,2,46,3,2,6,4,3,3,3,0,False,False,False,0,1,2021-11-15T14:28:57.533,6,False,3.0
2021,10,3210,505,27,7852,13,12,5,12,0,0,0,0,0,0,False,False,False,0,2,2021-11-19T00:30:29.933,0,False,0.0
2021,10,3210,510,27,7404,3,4,3,2,0,0,0,0,0,0,False,False,False,0,2,2021-11-15T14:31:33.973,0,False,0.0
2021,10,3210,515,27,7408,13,12,3,12,0,0,0,0,0,0,False,False,False,0,2,2021-11-19T00:03:21.46,0,False,0.0
2021,10,3210,520,12,4537,2,48,9,-3,23,26,18,5,18,0,False,False,False,0,1,2021-11-19T00:07:17.437,23,False,5.0
2021,10,3210,530,12,4537,2,48,9,-1,24,25,2,22,2,0,False,False,False,1,1,2021-11-15T14:37:52.543,24,False,22.0
2021,10,3210,550,12,4537,3,12,5,3,0,0,0,0,0,0,True,False,False,0,1,2021-11-19T00:07:55.85,0,False,0.0
2021,10,3210,555,12,556,2,51,10,-1,4,5,2,2,2,0,False,False,False,1,3,2021-11-15T14:45:14.69,4,False,2.0
2021,10,3210,560,12,7743,13,12,8,15,0,0,0,0,0,0,False,False,False,0,3,2021-11-15T16:25:06.113,0,False,0.0
2021,10,3210,570,27,8472,2,34,10,-5,-4,1,-4,0,-4,0,True,False,False,0,3,2021-11-15T14:49:09.927,-4,False,0.0
2021,10,3210,575,27,7408,13,2,9,8,0,0,0,0,0,0,False,False,False,0,2,2021-11-15T14:51:52.233,0,False,0.0
2021,10,3210,590,12,496,2,44,3,0,7,7,6,1,6,0,True,False,False,1,3,2021-11-19T00:54:07.58,7,False,1.0
2021,10,3210,605,12,556,13,6,9,13,0,0,0,0,0,0,False,False,False,0,2,2022-02-16T19:34:14.913,0,False,0.0
2021,10,3210,615,12,556,2,2,9,4,8,4,7,1,7,0,True,False,False,0,3,2021-11-16T19:25:01.917,8,False,1.0
2021,10,3210,625,12,7743,2,32,3,-1,5,6,1,4,1,0,False,False,False,0,4,2021-11-15T15:19:36.497,5,False,4.0
2021,10,3210,670,27,4850,2,5,3,3,4,1,3,1,3,0,False,False,False,0,3,2021-11-16T16:25:10.89,4,False,1.0
2021,10,3210,685,27,650,13,23,8,43,0,0,0,0,0,0,False,False,False,0,3,2021-11-15T15:36:05.09,0,False,0.0
2021,10,3210,695,12,7742,2,46,3,1,50,49,8,42,8,0,False,False,False,2,1,2022-03-08T19:16:29.113,50,False,42.0
2021,10,3210,705,12,467,2,4,9,6,7,1,7,0,7,0,False,False,False,0,4,2021-11-15T15:42:54.007,7,False,0.0
2021,10,3210,720,12,556,13,29,3,10,0,0,0,0,0,0,False,False,False,0,2,2021-11-15T15:47:37.787,0,False,
2021,10,3210,760,27,7404,2,12,3,8,8,0,8,0,8,0,False,False,False,0,1,2021-11-15T15:59:28.893,8,False,0.0
2021,10,3210,765,27,650,13,12,2,23,0,0,0,0,0,0,False,False,False,0,2,2022-02-24T16:32:31.197,0,False,0.0
2021,10,3210,780,27,7408,13,2,10,11,0,0,0,0,0,0,False,False,False,0,3,2021-11-15T16:04:14.77,0,False,0.0
2021,10,3210,785,27,7496,13,12,10,14,0,0,0,0,0,0,False,False,False,0,2,2022-02-24T16:33:42.543,0,False,0.0
2021,10,3210,790,27,4850,2,5,5,5,10,5,9,1,9,0,False,False,False,0,4,2021-11-15T16:10:21.113,10,False,1.0
2021,10,3210,795,27,4850,2,12,5,8,8,0,8,0,8,0,False,False,False,0,3,2022-02-24T16:34:06.577,8,False,0.0
2021,10,3210,800,27,650,13,12,2,43,0,0,0,0,0,0,False,False,False,0,2,2022-02-24T16:34:50.88,0,False,0.0
2021,10,3210,805,27,7404,2,46,9,2,9,7,8,1,8,0,False,False,False,0,1,2021-11-15T16:16:04.353,9,False,1.0
2021,10,3210,810,27,8472,13,23,7,37,0,0,0,0,0,0,False,False,False,0,3,2021-11-15T16:17:50.543,0,False,0.0
2021,10,3210,830,27,7852,13,2,9,8,0,0,0,0,0,0,False,False,False,0,3,2021-11-15T16:20:40.95,0,False,0.0
2021,10,3210,835,27,650,2,4,6,15,16,1,16,0,16,0,False,False,False,0,2,2022-03-08T19:16:50.51,16,False,0.0
2021,10,3211,25,16,797,2,4,9,3,6,3,3,3,3,0,False,False,False,1,1,2021-11-19T14:24:15.507,6,False,3.0
2021,10,3211,40,23,7241,2,51,10,-6,6,12,4,2,4,0,True,False,False,0,1,2021-11-15T11:18:01.7,6,False,2.0
2021,10,3211,55,23,7240,2,32,10,3,5,2,3,2,3,0,False,False,False,0,1,2021-11-15T11:21:52.74,5,False,2.0
2021,10,3211,60,23,7241,2,5,4,1,1,0,1,0,1,0,False,False,False,0,1,2021-11-15T11:23:26.307,1,False,0.0
2021,10,3211,75,16,374,2,4,10,5,7,2,6,1,6,0,False,False,False,0,3,2021-11-15T11:32:27.79,7,False,1.0
2021,10,3211,80,16,6499,2,44,3,-6,5,11,1,4,1,0,False,False,False,0,1,2021-11-15T11:34:29.833,5,False,4.0
2021,10,3211,90,16,3938,13,19,6,43,0,0,0,0,0,0,False,False,False,0,2,2021-11-19T14:20:41.843,0,False,0.0
2021,10,3211,95,16,374,2,5,9,11,11,0,11,0,11,0,False,False,False,0,3,2021-11-19T13:03:46.397,11,False,0.0
2021,10,3211,100,16,6499,2,48,10,-4,22,26,8,14,8,0,False,False,False,1,1,2021-11-19T14:25:00.077,22,False,14.0
2021,10,3211,105,16,374,2,5,5,13,19,6,18,1,18,0,True,False,False,0,1,2021-11-15T11:45:17.19,19,False,1.0
2021,10,3211,110,16,3938,2,44,3,-1,8,9,3,5,3,0,False,False,False,1,3,2022-02-16T19:58:43.84,8,False,5.0
2021,10,3211,125,16,3938,2,22,3,8,8,0,8,0,8,6,False,False,False,0,2,2021-11-15T11:52:28.8,8,True,0.0
2021,10,3211,140,23,2994,2,30,10,0,4,4,1,3,1,0,False,False,False,0,4,2021-11-15T11:55:18.147,4,False,3.0
2021,10,3211,155,23,3843,2,28,10,-2,3,5,2,1,2,0,False,False,False,0,1,2021-11-15T11:57:46.077,3,False,1.0
2021,10,3211,165,23,7689,2,5,2,17,27,10,19,8,19,0,False,False,False,1,3,2022-02-16T20:00:08.777,27,False,8.0
2021,10,3211,175,23,7250,2,51,9,-3,3,6,2,1,2,0,False,False,False,0,3,2021-11-15T12:05:34.297,3,False,1.0
2021,10,3211,185,23,7689,13,9,6,19,0,0,0,0,0,0,False,False,False,0,2,2021-11-15T16:51:47.917,0,False,
2021,10,3211,195,23,7250,2,7,5,6,6,0,6,0,6,6,False,False,False,0,2,2021-11-15T12:11:57.067,6,True,0.0
2021,10,3211,210,16,6499,2,4,4,4,7,3,7,0,7,0,False,False,False,0,1,2021-11-16T17:41:46.307,7,False,0.0
2021,10,3211,220,16,374,2,12,10,-3,13,16,3,10,3,0,True,False,False,2,4,2022-02-24T16:36:15.09,13,False,10.0
2021,10,3211,230,16,374,2,53,10,-2,12,14,10,2,10,0,False,False,False,0,4,2021-11-15T12:26:38.717,12,False,2.0
2021,10,3211,240,16,6499,2,48,10,-4,-1,3,-3,2,-3,0,False,False,False,0,1,2021-11-19T14:21:09.607,-1,False,2.0
2021,10,3211,245,16,4143,13,12,7,22,0,0,0,0,0,0,False,False,False,0,2,2021-11-15T12:34:36.283,0,False,0.0
2021,10,3211,290,16,374,13,31,9,9,0,0,0,0,0,0,False,False,False,0,3,2021-11-19T14:21:21.113,0,False,0.0
2021,10,3211,295,16,374,2,6,4,10,16,6,13,3,13,0,False,False,False,0,3,2021-11-19T14:36:37.537,16,False,3.0
2021,10,3211,300,16,7176,2,2,4,4,27,23,17,10,17,0,False,False,False,2,3,2021-11-15T12:54:10.14,27,False,10.0
2021,10,3211,310,16,6499,2,46,3,-1,3,4,3,0,3,0,False,False,False,0,1,2021-11-15T12:57:38.133,3,False,0.0
2021,10,3211,345,16,3938,2,13,5,1,1,0,1,0,1,6,False,False,False,0,3,2021-11-15T13:04:33.313,1,True,0.0
2021,10,3211,360,23,2994,13,4,9,10,0,0,0,0,0,0,False,False,False,0,3,2021-11-15T13:09:00.287,0,False,0.0
2021,10,3211,365,23,2994,2,39,4,5,7,2,6,1,6,0,False,False,False,0,3,2021-11-15T13:10:32.097,7,False,1.0
2021,10,3211,370,23,4949,13,4,9,9,0,0,0,0,0,0,False,False,False,0,2,2021-11-15T13:11:49.01,0,False,0.0
2021,10,3211,380,16,7176,2,44,3,-5,0,5,0,0,0,0,True,False,False,0,3,2021-11-15T13:14:45.747,0,True,0.0
2021,10,3211,385,16,6500,2,26,9,2,9,7,8,1,8,0,False,False,False,0,3,2021-11-15T13:16:41.153,9,False,1.0
2021,10,3211,390,16,6500,2,2,3,4,7,3,7,0,7,0,False,False,False,0,3,2021-11-15T13:18:17.727,7,False,0.0
2021,10,3211,400,16,797,13,12,4,0,0,0,0,0,0,0,False,False,False,0,1,2022-02-24T16:36:35.893,0,False,0.0
2021,10,3211,405,16,6500,13,19,2,46,0,0,0,0,0,0,False,False,False,0,3,2021-11-15T13:23:09.63,0,False,0.0
2021,10,3211,410,16,374,2,6,4,11,11,0,11,0,11,0,False,False,False,0,3,2021-11-19T14:28:53.157,11,False,0.0
2021,10,3211,420,16,6499,2,4,4,5,7,2,6,1,6,0,False,False,False,0,1,2021-11-15T13:26:35.38,7,False,1.0
2021,10,3211,455,23,7250,2,4,5,3,5,2,5,0,5,0,False,False,False,0,3,2021-11-15T13:32:55.363,5,False,0.0
2021,10,3211,460,23,4949,2,35,7,18,22,4,20,2,20,0,True,False,False,0,3,2022-02-16T20:02:17.36,22,False,2.0
2021,10,3211,465,23,7689,2,8,1,25,37,12,32,5,32,6,False,False,False,0,3,2021-11-15T13:37:15.49,37,False,5.0
2021,10,3211,485,16,3938,13,13,9,7,0,0,0,0,0,0,False,False,False,0,3,2021-11-15T13:42:26.73,0,False,0.0
2021,10,3211,490,16,4143,2,4,10,7,13,6,10,3,10,0,False,False,False,0,2,2021-11-15T13:44:36.877,13,False,3.0
2021,10,3211,500,16,6499,2,45,5,-5,17,22,17,0,17,0,False,False,False,1,1,2021-11-15T13:48:28.133,17,False,0.0
2021,10,3211,505,16,3938,2,50,9,-4,2,6,2,0,2,0,False,True,False,0,3,2021-11-15T13:50:26.757,8,False,0.0
2021,10,3211,515,16,797,13,11,2,17,0,0,0,0,0,0,False,False,False,0,1,2021-11-15T13:54:43.883,0,False,0.0
2021,10,3211,520,16,3938,2,13,9,3,10,7,5,5,5,0,False,False,False,0,2,2021-11-15T13:56:41.34,10,False,5.0
2021,10,3211,525,16,8537,3,32,3,1,0,0,0,0,0,0,False,False,False,0,4,2021-11-15T13:58:19.62,0,False,0.0
2021,10,3211,530,16,8537,13,2,3,-1,0,0,0,0,0,0,False,False,False,0,2,2022-02-16T20:03:13.86,0,False,0.0
2021,10,3211,545,16,8537,2,33,9,1,1,0,1,0,1,6,False,False,False,0,4,2022-02-16T20:04:09.65,1,True,0.0
2021,10,3211,565,23,7689,2,8,4,13,24,11,21,3,21,0,False,False,False,0,3,2021-11-15T14:10:25.493,24,False,3.0
2021,10,3211,570,23,967,2,8,8,35,40,5,40,0,40,0,False,True,True,0,3,2021-11-19T14:29:13.123,38,False,0.0
2021,10,3211,575,16,3938,2,8,9,12,16,4,13,3,13,0,False,False,False,0,3,2022-02-16T20:04:53.593,16,False,3.0
2021,10,3211,590,16,3938,2,7,6,27,32,5,32,0,32,0,True,False,False,0,2,2021-11-15T14:24:04.873,32,True,0.0
2021,10,3211,600,16,6499,2,44,3,-5,3,8,2,1,2,0,False,False,False,0,1,2021-11-15T14:34:34.523,3,False,1.0
2021,10,3211,605,16,4143,2,50,10,-8,7,15,5,2,5,0,False,False,False,0,3,2021-11-15T14:38:01.077,7,False,2.0
2021,10,3211,635,23,4949,13,17,7,28,0,0,0,0,0,0,False,False,False,0,3,2021-11-19T14:22:20.06,0,False,0.0
2021,10,3211,640,16,374,3,4,4,9,0,0,0,0,0,0,False,False,False,0,4,2022-02-16T20:05:29.63,0,False,0.0
2021,10,3211,645,16,4143,2,4,9,4,3,-1,3,0,3,0,False,False,False,0,3,2021-11-19T14:26:18.58,3,False,0.0
2021,10,3211,655,16,3938,13,19,2,37,0,0,0,0,0,0,False,False,False,0,2,2021-11-19T14:23:28.923,0,False,0.0
2021,10,3211,660,16,5039,2,4,3,9,16,7,12,4,12,0,False,False,False,0,2,2021-11-15T14:56:49.48,16,False,4.0
2021,10,3211,670,16,7176,13,8,7,35,0,0,0,0,0,0,False,False,False,0,3,2021-11-15T15:00:33.263,0,False,0.0
2021,10,3211,675,16,6499,2,12,6,37,38,1,38,0,38,6,False,False,False,0,1,2021-11-15T15:02:56.04,38,True,0.0
2021,10,3211,690,23,2994,2,4,10,5,11,6,8,3,8,0,True,False,False,0,4,2021-11-15T15:15:24.59,11,False,3.0
2021,10,3211,695,23,7250,2,4,9,3,5,2,5,0,5,0,False,False,False,0,3,2021-11-19T14:26:35.587,5,False,0.0
2021,10,3211,700,23,2994,13,17,1,30,0,0,0,0,0,0,False,False,False,0,3,2021-11-19T13:03:46.41,0,False,0.0
2021,10,3211,705,23,7689,13,20,1,38,0,0,0,0,0,0,False,False,False,0,2,2021-11-19T13:03:46.41,0,False,0.0
2021,10,3211,725,16,6500,2,18,10,-2,8,10,2,6,2,0,False,False,False,2,2,2021-11-15T15:35:38.03,8,False,6.0
2021,10,3211,740,16,374,2,31,4,2,30,28,3,27,3,0,False,False,False,3,4,2021-11-15T15:42:33.16,30,False,27.0
2021,10,3211,750,16,6500,2,20,2,22,22,0,22,0,22,6,False,False,False,0,3,2021-11-15T15:50:30.983,22,True,0.0
2021,10,3211,770,23,7250,2,4,9,4,5,1,5,0,5,0,False,False,False,0,3,2021-11-19T13:03:46.41,5,False,0.0
2021,10,3211,775,23,7250,2,51,10,-3,7,10,7,0,7,0,False,False,False,0,3,2021-11-15T16:00:15.487,7,False,0.0
2021,10,3211,785,23,7250,13,4,9,5,0,0,0,0,0,0,False,False,False,0,3,2021-11-19T12:35:29.41,0,False,0.0
2021,10,3211,790,23,2994,13,4,4,5,0,0,0,0,0,0,False,False,False,0,3,2021-11-19T12:36:03.157,0,False,0.0
2021,10,3211,795,23,2994,2,51,5,-4,2,6,0,2,0,0,False,False,False,0,4,2021-11-15T16:08:27.597,2,False,2.0
2021,10,3211,800,23,4307,2,4,10,3,9,6,5,4,5,0,False,False,False,0,1,2021-11-15T16:09:57.357,9,False,4.0
2021,10,3211,805,23,4307,2,4,4,3,6,3,6,0,6,0,False,False,False,0,1,2021-11-15T16:12:00.077,6,False,0.0
2021,10,3211,810,23,7241,2,4,3,2,12,10,7,5,7,0,False,False,False,1,1,2021-11-19T13:03:46.41,12,False,5.0
2021,10,3211,815,23,7241,2,31,9,-3,3,6,0,3,0,0,False,False,False,0,1,2021-11-19T14:23:59.133,3,False,3.0
2021,10,3211,820,23,7250,2,5,5,6,15,9,13,2,13,0,False,False,False,0,3,2021-11-19T14:26:51.643,15,False,2.0
2021,10,3211,825,23,7241,2,31,10,-2,-2,0,-2,0,-2,0,False,False,False,0,1,2021-11-15T16:26:04.393,-2,False,0.0
2021,10,3211,830,23,2994,2,6,4,10,10,0,10,0,10,0,False,False,False,0,3,2021-11-15T16:29:53.387,10,True,
2021,10,3211,835,23,4307,13,48,4,-3,0,0,0,0,0,0,False,False,False,0,1,2021-11-15T16:31:54.69,0,False,0.0
2021,10,3211,845,23,2994,13,17,1,19,0,0,0,0,0,0,False,False,False,0,3,2021-11-19T13:03:46.41,0,False,
2021,10,3211,855,23,7250,13,12,2,20,0,0,0,0,0,0,False,False,False,0,3,2021-11-15T16:37:19.91,0,False,0.0
2021,10,3212,10,29,1067,2,4,5,4,5,1,5,0,5,0,False,False,False,0,2,2021-11-16T17:27:20.39,5,False,0.0
2021,10,3212,20,29,4866,2,51,10,-3,2,5,1,1,1,0,False,False,False,0,3,2022-02-16T20:57:43.803,2,False,1.0
2021,10,3212,25,29,1067,13,12,7,51,0,0,0,0,0,0,False,False,False,0,3,2022-02-24T16:38:10.127,0,False,0.0
2021,10,3212,45,28,7619,2,50,9,-3,-1,2,-3,2,-3,0,False,False,False,0,3,2021-11-16T10:26:58.73,-1,False,2.0
2021,10,3212,50,28,4922,2,5,5,5,18,13,10,8,10,0,False,False,False,1,3,2021-11-16T10:30:21.25,18,False,8.0
2021,10,3212,90,28,262,2,6,4,5,6,1,5,1,5,0,False,False,False,0,3,2021-11-16T10:56:08.94,6,False,1.0
2021,10,3212,95,28,4922,2,6,4,4,7,3,6,1,6,0,False,False,False,0,3,2021-11-16T10:58:45.077,7,False,1.0
2021,10,3212,120,28,4922,2,5,10,8,8,0,8,0,8,6,False,False,False,0,3,2021-11-16T16:55:08.057,8,True,0.0
2021,10,3212,135,29,7378,2,48,9,-5,6,11,5,1,5,0,False,False,False,0,1,2021-11-16T11:20:40.667,6,False,1.0
2021,10,3212,140,29,4866,2,4,9,4,8,4,6,2,6,0,False,False,False,0,3,2021-11-19T15:56:52.487,8,False,2.0
2021,10,3212,145,29,8455,13,6,8,20,0,0,0,0,0,0,False,False,False,0,2,2021-11-19T16:00:44.03,0,False,0.0
2021,10,3212,150,29,3398,3,50,10,3,0,0,0,0,0,0,False,False,False,0,2,2021-11-19T15:59:19.557,0,False,0.0
2021,10,3212,170,29,7828,2,35,8,16,16,0,16,0,16,0,False,False,False,0,3,2021-11-16T11:39:26.387,16,False,0.0
2021,10,3212,180,29,4866,2,11,6,17,29,12,29,0,29,0,False,False,False,0,3,2021-11-16T11:43:53.77,29,False,0.0
2021,10,3212,185,29,1067,2,3,3,13,13,0,13,0,13,0,False,False,False,0,2,2021-11-16T11:46:52.817,13,True,0.0
2021,10,3212,195,29,8455,3,36,4,10,0,0,0,0,0,0,False,False,False,0,3,2021-11-16T11:52:15.88,0,False,0.0
2021,10,3212,200,29,3398,2,4,4,10,10,0,10,0,10,6,False,False,False,0,3,2021-11-16T11:54:15.203,10,True,0.0
2021,10,3212,235,28,4922,2,39,10,5,10,5,9,1,9,0,False,False,False,0,4,2021-11-16T12:09:55.407,10,False,1.0
2021,10,3212,255,28,7224,2,2,10,3,20,17,7,13,7,0,False,False,False,2,2,2021-11-16T17:25:46.51,20,False,13.0
2021,10,3212,270,28,7619,2,2,9,8,21,13,10,11,10,0,False,False,False,2,2,2021-11-19T15:59:36.193,21,False,11.0
2021,10,3212,295,29,8455,2,5,5,5,8,3,8,0,8,0,False,False,False,0,3,2021-11-16T12:44:29.437,8,False,0.0
2021,10,3212,300,29,7828,2,35,7,17,33,16,27,6,27,0,False,False,False,0,3,2021-11-19T15:04:59.46,33,False,6.0
2021,10,3212,305,29,4866,2,32,3,0,5,5,4,1,4,0,False,False,False,0,3,2021-11-16T12:53:37.29,5,False,1.0
2021,10,3212,330,29,3398,2,53,9,-4,-2,2,-2,0,-2,0,False,False,False,0,3,2021-11-16T13:06:21.963,-2,False,0.0
2021,10,3212,335,29,7378,2,44,3,-3,5,8,5,0,5,0,False,False,False,0,1,2021-11-19T15:04:59.46,5,False,0.0
2021,10,3212,345,29,7366,2,30,10,-4,2,6,2,0,2,0,False,False,False,0,4,2021-11-16T13:16:19.76,2,False,0.0
2021,10,3212,390,29,7378,2,47,5,0,2,2,1,1,1,0,False,False,False,0,1,2021-11-16T13:38:21.613,2,False,1.0
2021,10,3212,400,29,7378,13,2,10,2,0,0,0,0,0,0,False,False,False,0,2,2021-11-16T13:43:15.06,0,False,0.0
2021,10,3212,415,28,7619,2,2,9,5,6,1,6,0,6,0,False,False,False,0,3,2021-11-16T13:47:04.093,6,False,0.0
2021,10,3212,420,28,7753,2,5,5,3,3,0,3,0,3,0,False,False,False,0,3,2021-11-19T15:57:45.317,3,False,0.0
2021,10,3212,425,28,7224,2,6,4,11,19,8,11,8,11,0,False,False,False,2,3,2021-11-19T15:59:59.767,19,False,8.0
2021,10,3212,450,28,6624,2,46,9,1,1,0,1,0,1,0,False,False,False,0,1,2021-11-16T17:28:34.91,1,False,
2021,10,3212,455,28,4922,2,4,4,5,7,2,5,2,5,0,False,False,False,0,4,2021-11-16T14:10:42.96,7,False,2.0
2021,10,3212,475,29,8455,13,6,4,13,0,0,0,0,0,0,False,False,False,0,3,2021-11-19T15:58:18.17,0,False,0.0
2021,10,3212,485,29,4866,3,5,10,4,0,0,0,0,0,0,False,False,False,0,3,2021-11-16T14:25:15.697,0,False,0.0
2021,10,3212,505,28,7619,13,5,5,5,0,0,0,0,0,0,False,False,False,0,3,2021-11-16T14:34:14.33,0,False,0.0
2021,10,3212,510,28,7224,2,6,4,9,11,2,9,2,9,0,False,False,False,0,3,2021-11-17T21:30:30.413,11,False,2.0
2021,10,3212,515,28,7753,13,35,10,14,0,0,0,0,0,0,False,False,False,0,3,2021-11-16T14:41:29.717,0,False,0.0
2021,10,3212,530,28,4922,13,6,9,9,0,0,0,0,0,0,False,False,False,0,2,2021-11-19T15:58:31.803,0,False,0.0
2021,10,3212,540,29,4866,2,4,9,5,6,1,5,1,5,0,False,False,False,0,3,2021-11-16T14:49:58.267,6,False,1.0
2021,10,3212,545,29,7378,2,12,10,-3,-3,0,-3,0,-3,0,False,False,False,0,1,2022-02-24T16:38:37.717,-3,False,0.0
2021,10,3212,550,29,3398,3,32,3,4,0,0,0,0,0,0,False,False,False,0,4,2021-11-16T14:56:13.797,0,False,0.0
2021,10,3212,585,28,7224,2,39,4,6,7,1,7,0,7,0,False,False,False,0,3,2021-11-19T15:04:59.46,7,False,0.0
2021,10,3212,600,28,7224,2,6,4,10,40,30,14,26,14,6,False,False,False,1,3,2021-11-16T15:27:15.813,40,False,26.0
2021,10,3212,615,29,3398,2,6,9,6,12,6,8,4,8,0,False,False,False,0,3,2021-11-19T16:01:12.013,12,False,4.0
2021,10,3212,620,29,8455,13,4,10,12,0,0,0,0,0,0,False,False,False,0,3,2021-11-16T15:33:50.897,0,False,0.0
2021,10,3212,625,29,4866,13,4,10,5,0,0,0,0,0,0,False,False,False,0,3,2021-11-18T00:05:48.153,0,False,
2021,10,3212,630,29,7828,3,8,10,13,0,0,0,0,0,0,False,False,False,0,2,2021-11-16T15:38:49.08,0,False,0.0
2021,10,3212,635,29,4866,2,4,9,12,16,4,14,2,14,0,False,False,False,0,3,2021-11-16T15:40:51.09,16,False,2.0
2021,10,3212,640,29,4866,13,7,2,43,0,0,0,0,0,0,False,False,False,0,3,2021-11-16T15:45:23.223,0,False,0.0
2021,10,3212,645,29,4866,2,50,5,0,6,6,2,4,2,0,False,False,False,0,2,2021-11-16T15:47:29.63,6,False,4.0
2021,10,3212,650,29,4866,2,5,3,10,11,1,11,0,11,0,False,False,False,0,3,2021-11-16T15:49:29.297,11,False,0.0
2021,10,3212,655,29,4866,13,2,9,5,0,0,0,0,0,0,False,False,False,0,3,2021-11-16T17:13:39,0,False,
2021,10,3212,660,29,7828,2,13,4,5,5,0,5,0,5,0,False,False,False,0,3,2021-11-16T15:55:37.297,5,False,0.0
2021,10,3212,665,29,7828,3,9,6,18,0,0,0,0,0,0,False,False,False,0,2,2021-11-16T15:58:34.64,0,False,0.0
2021,10,3212,670,29,4866,2,13,9,2,9,7,6,3,6,0,False,False,False,0,3,2021-11-16T16:00:37.597,9,False,3.0
2021,10,3212,685,29,4866,2,51,10,-2,5,7,5,0,5,0,False,False,False,0,3,2022-02-16T21:00:24.223,5,False,0.0
2021,10,3212,695,29,7828,13,8,4,11,0,0,0,0,0,0,False,False,False,0,3,2021-11-19T15:04:59.477,0,False,0.0
2021,10,3212,730,29,6266,2,4,9,1,2,1,2,0,2,0,False,False,False,0,1,2021-11-19T15:58:46.887,2,False,0.0
2021,10,3212,735,29,4866,2,36,9,12,25,13,24,1,24,0,False,False,False,0,3,2021-11-16T16:27:11.253,25,False,1.0
2021,10,3212,740,29,6266,2,5,9,3,9,6,8,1,8,0,False,False,False,0,1,2021-11-19T16:00:13.97,9,False,1.0
2021,10,3212,745,29,7828,13,50,5,0,0,0,0,0,0,0,False,False,False,0,2,2021-11-16T16:33:02.703,0,False,0.0
2021,10,3212,750,29,7378,13,9,3,8,0,0,0,0,0,0,False,False,False,0,2,2021-11-16T16:34:26.097,0,False,0.0
2021,11,3213,10,19,7175,2,5,5,4,5,1,5,0,5,0,True,False,False,0,3,2021-11-19T10:21:13.017,5,False,0.0
2021,11,3213,20,19,4282,13,35,2,16,0,0,0,0,0,0,True,False,False,0,3,2021-11-19T10:20:48.46,0,False,
2021,11,3213,30,19,7173,2,5,5,5,5,0,5,0,5,0,False,False,False,0,3,2021-11-19T10:22:55.147,5,False,0.0
2021,11,3213,50,2,2554,2,4,10,0,7,7,6,1,6,0,False,False,False,0,1,2021-11-19T10:28:09.837,7,False,
2021,11,3213,60,2,8389,13,2,4,8,0,0,0,0,0,0,False,False,False,0,3,2021-11-19T10:32:17.57,0,False,0.0
2021,11,3213,70,19,5096,2,32,3,0,17,17,6,11,6,0,True,False,False,1,4,2021-11-19T10:36:09.537,17,False,11.0
2021,11,3213,85,19,4912,2,51,9,-3,6,9,5,1,5,0,False,False,False,0,3,2021-11-19T10:40:21.343,6,False,1.0
2021,11,3213,110,19,4282,13,5,5,14,0,0,0,0,0,0,False,False,False,0,3,2021-11-19T10:45:23.22,0,False,0.0
2021,11,3213,125,2,2554,2,45,5,0,6,6,5,1,5,0,False,False,False,0,1,2021-11-19T10:48:46.47,6,False,1.0
2021,11,3213,135,2,6247,2,6,9,9,12,3,10,2,10,0,False,False,False,0,3,2021-11-24T18:16:20.017,12,False,2.0
2021,11,3213,140,2,6247,2,45,5,-3,1,4,1,0,1,0,True,False,False,0,3,2021-11-19T10:52:55.967,1,False,0.0
2021,11,3213,145,2,3506,13,7,6,23,0,0,0,0,0,0,False,False,False,0,2,2021-11-19T10:54:48.427,0,False,0.0
2021,11,3213,150,2,3506,13,3,3,13,0,0,0,0,0,0,False,False,False,0,2,2021-11-24T18:16:28.75,0,False,0.0
2021,11,3213,160,19,7173,2,4,3,6,9,3,7,2,7,0,False,False,False,0,2,2021-11-19T11:00:36.727,9,False,2.0
2021,11,3213,185,19,7172,2,47,5,2,9,7,9,0,9,0,False,False,False,0,1,2021-11-19T11:08:14.087,9,True,0.0
2021,11,3213,195,19,2256,2,13,10,5,19,14,19,0,19,6,False,False,False,0,3,2021-11-19T11:10:20.347,19,True,0.0
2021,11,3213,210,2,6247,2,4,9,6,9,3,6,3,6,0,False,False,False,0,3,2021-11-19T11:12:26.873,9,False,3.0
2021,11,3213,220,2,6247,2,13,4,4,8,4,6,2,6,0,False,False,False,0,2,2021-11-24T18:16:38.647,8,False,2.0
2021,11,3213,230,2,7303,2,13,4,5,9,4,8,1,8,0,False,False,False,0,2,2021-11-19T11:18:25.65,9,False,1.0
2021,11,3213,240,2,2554,13,44,9,-5,0,0,0,0,0,0,False,False,False,0,1,2021-11-19T11:22:08.217,0,False,0.0
2021,11,3213,245,2,7303,2,6,9,5,9,4,7,2,7,0,False,False,False,0,2,2021-11-19T11:24:01.533,9,False,2.0
2021,11,3213,265,2,8389,2,5,3,7,7,0,7,0,7,0,True,False,False,0,3,2021-11-19T11:29:08.353,7,False,0.0
2021,11,3213,290,19,4912,2,50,10,-1,12,13,10,2,10,0,False,False,False,0,3,2021-11-19T11:37:05.507,12,False,2.0
2021,11,3213,295,19,1212,2,48,10,-4,6,10,3,3,3,0,False,False,False,0,1,2021-11-19T11:38:41.7,6,False,3.0
2021,11,3213,310,2,7296,2,47,5,0,0,0,0,0,0,0,False,False,False,0,1,2021-11-19T11:46:11.677,0,False,0.0
2021,11,3213,330,19,1212,2,4,4,5,9,4,6,3,6,0,False,False,False,1,1,2021-11-24T18:17:53.817,9,False,3.0
2021,11,3213,335,19,4912,2,6,10,5,5,0,5,0,5,0,False,False,False,0,2,2021-11-19T11:58:41.71,5,False,0.0
2021,11,3213,345,19,7175,2,5,3,14,18,4,18,0,18,0,False,False,False,0,3,2021-11-19T12:01:04.163,18,True,0.0
2021,11,3213,350,19,2256,2,4,3,5,6,1,6,0,6,0,False,False,False,0,2,2021-11-19T12:01:58.58,6,True,0.0
2021,11,3213,360,19,7175,2,6,4,10,10,0,10,0,10,0,False,False,False,0,3,2021-11-19T12:04:04.817,10,False,0.0
2021,11,3213,385,2,7303,3,39,4,4,0,0,0,0,0,0,True,False,False,0,3,2021-11-19T12:08:29.053,0,False,0.0
2021,11,3213,395,2,3506,13,17,6,21,0,0,0,0,0,0,False,False,False,0,3,2021-11-24T18:18:21.8,0,False,
2021,11,3213,410,2,7296,3,48,9,-3,0,0,0,0,0,0,False,False,False,0,1,2021-11-19T12:18:12.88,0,False,0.0
2021,11,3213,415,2,2554,2,16,9,3,10,7,9,1,9,0,False,False,False,0,1,2021-11-24T18:19:16.973,10,False,1.0
2021,11,3213,435,19,4282,2,31,9,7,10,3,9,1,9,0,True,False,False,0,3,2021-11-19T12:25:50.923,10,False,1.0
2021,11,3213,440,19,7175,13,3,3,7,0,0,0,0,0,0,False,False,False,0,3,2021-11-24T18:26:00.617,0,False,0.0
2021,11,3213,455,2,7296,2,45,5,-3,0,3,-3,3,-3,0,False,False,False,1,1,2021-11-19T12:32:36.967,0,False,3.0
2021,11,3213,460,2,6247,13,2,4,12,0,0,0,0,0,0,True,False,False,0,3,2021-11-19T12:35:26.91,0,False,0.0
2021,11,3213,480,19,8493,2,44,3,-3,6,9,6,0,6,0,False,False,False,0,1,2021-11-19T12:43:42.433,6,False,0.0
2021,11,3213,485,19,7175,2,4,3,6,6,0,6,0,6,0,False,False,False,0,3,2021-11-19T12:45:38.96,6,False,0.0
2021,11,3213,500,19,4282,2,35,10,12,15,3,12,3,12,0,False,False,False,0,4,2021-11-19T14:52:52.627,15,False,3.0
2021,11,3213,505,19,5096,13,17,8,25,0,0,0,0,0,0,False,False,False,0,4,2021-11-19T12:56:37.42,0,False,0.0
2021,11,3213,510,2,8389,2,4,9,6,6,0,6,0,6,0,True,False,False,0,3,2021-11-19T12:59:48.487,6,False,0.0
2021,11,3213,515,2,7303,2,6,5,5,5,0,5,0,5,0,False,False,False,0,2,2021-11-19T13:03:12.28,5,False,0.0
2021,11,3213,525,2,2835,2,46,3,2,11,9,8,3,8,0,False,False,False,0,4,2021-11-19T13:07:56.407,11,False,3.0
2021,11,3213,535,2,3506,2,4,10,4,4,0,4,0,4,0,False,False,False,0,3,2021-11-19T13:11:00.87,4,False,0.0
2021,11,3213,555,19,7175,13,6,10,13,0,0,0,0,0,0,False,False,False,0,3,2021-11-19T13:20:31.86,0,False,0.0
2021,11,3213,560,19,2256,2,13,9,2,3,1,2,1,2,0,False,False,False,0,3,2021-11-19T13:21:46.317,3,False,1.0
2021,11,3213,580,2,6247,2,8,7,16,19,3,19,0,19,0,False,False,False,0,3,2021-11-19T13:32:55.53,19,False,0.0
2021,11,3213,590,2,8389,2,6,4,13,16,3,14,2,14,0,False,False,False,0,3,2021-11-19T13:46:37.763,16,False,2.0
2021,11,3213,595,2,8389,13,7,2,22,0,0,0,0,0,0,False,False,False,0,3,2021-11-19T13:52:09.117,0,False,0.0
2021,11,3213,605,19,7175,13,7,6,31,0,0,0,0,0,0,False,False,False,0,3,2021-11-19T13:56:48.953,0,False,
2021,11,3213,615,19,4912,2,6,1,15,19,4,19,0,19,0,False,False,False,0,3,2021-11-24T18:15:20.183,19,False,0.0
2021,11,3213,635,19,2256,2,4,3,2,2,0,2,0,2,0,False,False,False,0,2,2021-11-19T14:13:53.673,2,False,0.0
2021,11,3213,655,2,3506,2,13,4,5,17,12,15,2,15,0,False,False,False,0,2,2021-11-19T14:19:50.593,17,False,2.0
2021,11,3213,660,2,2554,2,46,3,-1,4,5,1,3,1,0,False,False,False,1,1,2021-11-19T14:22:53.713,4,False,3.0
2021,11,3213,665,2,7303,13,4,3,5,0,0,0,0,0,0,False,False,False,0,2,2021-11-24T18:25:07.8,0,False,0.0
2021,11,3213,690,19,2256,2,4,3,8,10,2,10,0,10,0,False,False,False,0,2,2021-11-19T14:55:21.333,10,False,0.0
2021,11,3213,745,2,7540,2,5,5,5,5,0,5,0,5,0,False,False,False,0,3,2021-11-19T14:37:20.713,5,True,0.0
2021,11,3213,755,2,6247,13,4,4,5,0,0,0,0,0,0,False,False,False,0,3,2021-11-19T14:39:38.707,0,False,0.0
2021,11,3213,770,2,6247,13,5,3,2,0,0,0,0,0,0,False,False,False,0,3,2021-11-19T14:44:39.313,0,False,0.0
2021,11,3214,10,20,8131,13,9,6,17,0,0,0,0,0,0,False,False,False,0,2,2021-11-22T10:09:53.753,0,False,0.0
2021,11,3214,20,20,902,2,32,3,-2,5,7,5,0,5,0,False,False,False,0,4,2021-11-22T10:13:07.487,5,False,0.0
2021,11,3214,30,20,7888,13,53,9,-4,0,0,0,0,0,0,False,False,False,0,4,2022-02-16T23:48:55.153,0,False,0.0
2021,11,3214,35,20,7353,13,8,1,25,0,0,0,0,0,0,False,False,False,0,3,2021-11-24T15:05:39.803,0,False,0.0
2021,11,3214,45,24,8509,2,4,9,7,8,1,7,1,7,0,False,False,False,0,3,2021-11-22T10:22:02.45,8,False,1.0
2021,11,3214,80,20,7888,13,35,5,6,0,0,0,0,0,0,False,False,False,0,4,2021-11-24T14:44:17.043,0,False,0.0
2021,11,3214,85,24,6373,13,35,2,18,0,0,0,0,0,0,False,False,False,0,4,2022-02-16T23:49:43.397,0,False,0.0
2021,11,3214,90,24,6373,2,5,5,3,4,1,3,1,3,0,False,False,False,0,3,2021-11-24T15:18:36.107,4,False,1.0
2021,11,3214,95,24,6373,2,5,2,11,16,5,13,3,13,0,False,False,False,0,3,2022-02-17T20:45:10.537,16,False,3.0
2021,11,3214,100,24,7798,13,12,9,-4,0,0,0,0,0,0,False,False,False,0,2,2022-02-24T16:43:25.34,0,False,0.0
2021,11,3214,110,24,6373,2,5,5,4,14,10,5,9,5,0,False,False,False,2,3,2021-11-22T10:45:37.77,14,False,9.0
2021,11,3214,140,20,6388,13,5,5,3,0,0,0,0,0,0,False,False,False,0,3,2022-02-17T20:43:35.883,0,False,0.0
2021,11,3214,205,20,902,2,46,9,1,7,6,5,2,5,0,False,False,False,0,1,2021-11-24T15:07:30.113,7,False,2.0
2021,11,3214,230,20,6388,2,31,4,7,6,-1,6,0,6,0,False,False,False,0,3,2021-11-24T15:07:58.193,6,False,0.0
2021,11,3214,235,20,7353,13,3,5,13,0,0,0,0,0,0,False,False,False,0,3,2021-11-24T14:37:32.423,0,False,0.0
2021,11,3214,255,20,902,13,46,3,-1,0,0,0,0,0,0,False,False,False,0,1,2021-11-24T15:20:20.647,0,False,0.0
2021,11,3214,260,20,7356,2,12,5,8,8,0,8,0,8,0,False,False,False,0,3,2021-11-24T15:20:44.377,8,True,
2021,11,3214,265,20,7888,2,12,10,18,18,0,18,0,18,6,False,False,False,0,4,2022-02-17T20:49:24.247,18,True,0.0
2021,11,3214,290,24,8509,2,12,8,13,33,20,32,1,32,0,False,False,False,1,2,2022-02-24T16:45:22.52,33,False,1.0
2021,11,3214,295,24,6937,13,12,5,28,0,0,0,0,0,0,True,False,False,0,1,2022-02-17T20:46:47.397,0,False,0.0
2021,11,3214,300,24,6389,2,48,10,-3,-2,1,-3,1,-3,0,False,False,False,0,1,2021-11-22T13:15:27.8,-2,False,1.0
2021,11,3214,305,24,6389,2,47,5,2,4,2,4,0,4,0,True,False,False,0,1,2021-11-24T15:21:27.507,4,False,0.0
2021,11,3214,325,20,8131,13,4,9,4,0,0,0,0,0,0,False,False,False,0,3,2021-11-24T15:21:48.717,0,False,0.0
2021,11,3214,375,24,6373,2,3,5,9,14,5,10,4,10,0,False,False,False,0,3,2021-11-24T15:22:08.897,14,False,4.0
2021,11,3214,380,24,6373,2,12,5,13,13,0,13,0,13,6,False,False,False,0,4,2022-02-24T16:44:45.83,13,True,
2021,11,3214,385,24,8509,13,9,6,23,0,0,0,0,0,0,False,False,False,0,3,2021-11-24T15:22:50.033,0,False,0.0
2021,11,3214,395,24,8509,13,8,8,19,0,0,0,0,0,0,False,False,False,0,3,2021-11-24T15:23:11.653,0,False,0.0
2021,11,3214,410,20,7888,2,53,10,-5,19,24,19,0,19,0,False,False,False,0,4,2022-02-16T23:51:37.087,19,False,0.0
2021,11,3214,425,20,8131,13,6,1,17,0,0,0,0,0,0,False,False,False,0,2,2021-11-24T14:15:24.893,0,False,0.0
2021,11,3214,475,24,8509,2,4,10,6,6,0,6,0,6,0,False,False,False,0,2,2021-11-22T15:18:35.837,6,False,0.0
2021,11,3214,480,24,7798,13,3,5,11,0,0,0,0,0,0,False,False,False,0,2,2021-11-24T15:11:24.51,0,False,0.0
2021,11,3214,490,20,6388,2,4,10,5,5,0,0,5,0,0,False,False,False,0,3,2021-11-22T15:24:58.03,5,False,5.0
2021,11,3214,495,20,7353,13,3,5,10,0,0,0,0,0,0,False,False,False,0,2,2021-11-22T15:27:19.163,0,False,0.0
2021,11,3214,575,20,7888,13,47,5,2,0,0,0,0,0,0,True,False,False,0,4,2021-11-23T23:40:59.023,0,False,0.0
2021,11,3214,585,24,6373,2,53,10,-3,14,17,11,3,11,0,False,False,False,0,4,2021-11-22T16:19:55.357,14,False,3.0
2021,11,3214,600,24,8509,2,50,5,0,14,14,7,7,7,0,False,False,False,0,2,2021-11-24T15:57:58.697,14,False,7.0
2021,11,3214,675,20,7888,2,6,4,10,10,0,10,0,10,0,False,False,False,0,3,2021-11-23T23:39:12.88,10,False,0.0
2021,11,3214,680,20,7353,2,2,10,8,9,1,9,0,9,0,False,False,False,0,2,2021-11-22T16:44:10.623,9,False,0.0
2021,11,3214,705,20,902,13,44,3,-4,0,0,0,0,0,0,False,False,False,0,1,2021-11-24T15:13:19.44,0,False,0.0
2021,11,3214,710,20,8131,2,17,8,26,26,0,26,0,26,6,False,False,False,0,2,2021-11-24T14:15:24.893,26,False,0.0
2021,11,3214,730,24,8665,13,5,3,14,0,0,0,0,0,0,True,False,False,0,4,2022-02-16T23:52:25.06,0,False,0.0
2021,11,3214,735,24,6373,3,5,3,6,0,0,0,0,0,0,False,False,False,0,3,2021-11-24T14:15:24.927,0,False,0.0
2021,11,3214,745,20,6388,2,35,2,16,21,5,19,2,19,0,False,False,False,0,3,2021-11-23T23:39:59.32,21,False,2.0
2021,11,3214,775,24,6373,3,5,5,9,0,0,0,0,0,0,False,False,False,0,3,2021-11-22T19:22:28.427,0,False,0.0
2021,11,3214,790,20,8131,13,35,2,27,0,0,0,0,0,0,False,False,False,0,3,2021-11-24T15:15:49.827,0,False,
2021,11,3214,805,20,7888,2,53,10,-5,-6,-1,-6,0,-6,0,False,False,False,0,4,2021-11-22T17:25:20.59,-6,False,0.0
2021,11,3214,810,20,7888,2,7,2,17,17,0,17,0,17,0,False,False,False,0,3,2021-11-22T17:26:54.69,17,False,0.0
2021,11,3214,825,20,7353,2,50,3,-1,2,3,2,0,2,0,False,False,False,0,2,2021-11-22T17:33:20.673,2,False,0.0
2021,11,3214,840,24,7798,2,50,5,-1,-1,0,-1,0,-1,0,False,False,False,0,2,2022-02-16T23:53:35.79,-1,False,0.0
2021,11,3214,845,24,7003,2,4,9,6,23,17,18,5,18,0,False,False,False,0,3,2021-11-22T17:51:14.01,23,False,5.0
2021,11,3214,910,20,902,2,4,4,3,5,2,4,1,4,0,False,False,False,0,1,2021-11-24T14:43:30.843,5,False,1.0
2021,11,3214,915,20,902,2,4,9,2,2,0,2,0,2,0,False,False,False,0,1,2021-11-22T18:04:35.017,2,False,0.0
2021,11,3214,920,20,6388,2,2,10,5,10,5,7,3,7,0,False,False,False,0,3,2021-11-22T18:06:04.18,10,False,3.0
2021,11,3214,925,20,902,2,48,9,-5,1,6,0,1,0,0,False,False,False,0,1,2021-11-22T18:07:30.557,1,False,1.0
2021,11,3214,930,20,3848,2,17,1,16,20,4,17,3,17,0,False,False,False,0,3,2021-11-22T18:09:08.753,20,False,3.0
2021,11,3214,935,20,3360,2,4,4,3,6,3,4,2,4,0,False,False,False,0,1,2021-11-22T18:10:34.617,6,False,2.0
2021,11,3214,945,20,902,2,18,3,-2,5,7,4,1,4,0,True,False,False,1,2,2021-11-24T15:58:39.08,5,False,1.0
2021,11,3214,955,20,6388,3,39,4,6,0,0,0,0,0,0,False,False,False,0,3,2022-02-16T23:54:38.75,0,False,0.0
2021,11,3214,960,20,6388,2,8,8,21,22,1,23,-1,23,0,False,False,False,0,2,2021-11-24T15:24:17.493,22,False,-1.0
2021,11,3214,965,20,7356,2,9,3,4,4,0,4,0,4,6,False,False,False,0,2,2021-11-23T23:40:39.75,4,False,0.0
2021,11,3215,10,17,6274,2,4,9,3,3,0,3,0,3,0,False,False,False,0,3,2021-11-24T16:15:32.727,3,False,0.0
2021,11,3215,15,17,6274,2,11,3,7,26,19,22,4,22,0,False,False,False,0,4,2021-11-22T12:17:58.427,26,False,4.0
2021,11,3215,25,17,7024,2,5,9,1,1,0,1,0,1,0,False,False,False,0,1,2021-11-22T12:20:39.943,1,False,0.0
2021,11,3215,40,17,4484,2,38,9,6,19,13,9,10,9,0,False,False,False,0,4,2021-11-24T16:19:09.36,19,False,10.0
2021,11,3215,50,17,8483,2,5,3,4,7,3,4,3,4,0,False,False,False,0,3,2021-11-22T12:29:10.8,7,False,3.0
2021,11,3215,55,17,7051,2,32,5,0,5,5,-1,6,-1,0,False,False,False,2,3,2021-11-24T16:56:32.06,5,False,6.0
2021,11,3215,85,22,5080,13,2,10,4,0,0,0,0,0,0,False,False,False,0,3,2021-11-24T16:16:19.807,0,False,0.0
2021,11,3215,90,22,3170,2,5,5,3,9,6,9,0,9,0,False,False,False,0,3,2021-11-24T16:22:28.593,9,False,0.0
2021,11,3215,95,22,8451,2,32,9,1,2,1,2,0,2,0,False,False,False,0,1,2021-11-22T12:50:25.403,2,False,0.0
2021,11,3215,105,22,5080,13,17,1,22,0,0,0,0,0,0,False,False,False,0,3,2021-11-22T12:53:14.67,0,False,0.0
2021,11,3215,120,17,364,2,50,10,-2,8,10,6,2,6,0,True,False,False,1,2,2021-11-22T12:59:11.297,8,False,2.0
2021,11,3215,125,17,8483,13,35,8,21,0,0,0,0,0,0,True,False,False,0,2,2021-11-24T16:16:59.2,0,False,0.0
2021,11,3215,150,22,6270,13,5,3,2,0,0,0,0,0,0,False,False,False,0,3,2021-11-22T13:21:42.103,0,False,0.0
2021,11,3215,155,22,3170,2,47,5,2,2,0,2,0,2,6,True,False,False,0,3,2021-11-22T13:23:23.36,2,True,0.0
2021,11,3215,175,17,6274,13,2,9,9,0,0,0,0,0,0,False,False,False,0,3,2021-11-22T13:32:45.337,0,False,0.0
2021,11,3215,185,17,364,13,13,10,0,0,0,0,0,0,0,False,False,False,0,2,2021-11-22T13:36:08.56,0,False,0.0
2021,11,3215,200,22,2391,2,12,5,1,5,4,5,0,5,0,False,False,False,0,4,2021-11-22T13:40:19.833,5,False,0.0
2021,11,3215,210,22,8454,2,5,5,5,5,0,5,0,5,0,False,False,False,0,3,2021-11-22T13:43:59.15,5,False,0.0
2021,11,3215,225,22,2391,2,13,9,2,29,27,25,4,25,0,False,False,False,0,4,2021-11-22T13:50:52.89,29,False,4.0
2021,11,3215,250,17,8483,2,5,3,8,13,5,13,0,13,0,False,False,False,0,3,2021-11-22T14:02:57.93,13,False,0.0
2021,11,3215,265,17,8483,2,2,9,3,3,0,3,0,3,0,True,False,False,0,3,2021-11-24T16:17:17.64,3,False,0.0
2021,11,3215,275,22,5080,2,4,10,6,14,8,7,7,7,0,True,False,False,2,2,2021-11-22T14:14:45.423,14,False,7.0
2021,11,3215,285,22,6237,2,2,9,10,20,10,18,2,18,0,False,False,False,0,3,2021-11-22T14:21:53.063,20,False,2.0
2021,11,3215,290,22,5080,2,5,3,6,9,3,9,0,9,0,False,False,False,0,2,2021-11-22T14:24:59.057,9,False,0.0
2021,11,3215,300,22,8454,13,19,5,7,0,0,0,0,0,0,False,False,False,0,2,2021-11-24T16:57:36.66,0,False,0.0
2021,11,3215,305,22,8454,13,8,4,14,0,0,0,0,0,0,False,False,False,0,3,2021-11-24T13:01:13.463,0,False,0.0
2021,11,3215,320,17,6276,2,47,5,2,4,2,4,0,4,0,False,False,False,0,4,2021-11-22T14:39:09.593,4,False,0.0
2021,11,3215,325,17,6274,2,35,10,8,17,9,12,5,12,0,False,False,False,0,2,2021-11-24T16:58:27.883,17,False,
2021,11,3215,345,22,8454,2,49,10,-2,5,7,2,3,2,0,False,False,False,2,3,2021-11-24T16:19:42.363,5,False,3.0
2021,11,3215,370,22,3170,13,11,5,13,0,0,0,0,0,0,False,False,False,0,3,2021-11-22T14:55:11.347,0,False,0.0
2021,11,3215,380,17,8483,2,2,10,4,7,3,5,2,5,0,False,False,False,0,2,2021-11-22T14:57:09.243,7,False,2.0
2021,11,3215,390,17,6274,2,4,9,6,7,1,7,0,7,0,False,False,False,0,3,2021-11-24T16:34:15.497,7,False,0.0
2021,11,3215,400,17,8483,2,13,4,2,6,4,5,1,5,0,False,False,False,0,3,2021-11-22T15:00:13.657,6,False,1.0
2021,11,3215,405,17,364,2,5,5,8,9,1,9,0,9,0,False,False,False,0,3,2021-11-22T15:01:46.93,9,False,0.0
2021,11,3215,410,17,7024,2,47,5,0,1,1,1,0,1,0,False,False,False,0,1,2021-11-22T15:02:48.763,1,False,0.0
2021,11,3215,415,17,6274,2,5,5,7,8,1,8,0,8,0,False,False,False,0,3,2021-11-22T15:04:06.907,8,False,0.0
2021,11,3215,430,17,6276,13,6,4,10,0,0,0,0,0,0,False,False,False,0,3,2022-02-17T20:53:16.263,0,False,0.0
2021,11,3215,435,17,4383,13,3,3,3,0,0,0,0,0,0,False,False,False,0,2,2021-11-24T00:40:50.133,0,False,0.0
2021,11,3215,455,22,8454,2,4,8,20,22,2,22,0,22,0,False,False,False,0,2,2022-02-16T23:32:27.443,22,False,0.0
2021,11,3215,465,22,3170,2,4,5,4,5,1,5,0,5,0,False,False,False,0,2,2021-11-23T21:41:06.763,5,False,0.0
2021,11,3215,475,22,8454,13,47,5,0,0,0,0,0,0,0,False,False,False,0,3,2021-11-22T15:40:05.713,0,False,0.0
2021,11,3215,485,22,5080,13,19,8,33,0,0,0,0,0,0,False,False,False,0,2,2021-11-22T15:43:03.107,0,False,0.0
2021,11,3215,505,17,364,2,11,6,23,34,11,32,2,32,0,True,False,False,0,3,2022-02-16T23:33:30.063,34,False,
2021,11,3215,520,17,4383,2,19,6,45,65,20,58,7,58,6,False,False,False,0,3,2022-02-17T20:54:37.747,65,False,7.0
2021,11,3215,540,22,8454,2,5,5,2,4,2,3,1,3,0,False,False,False,0,3,2021-11-22T16:32:40.177,4,False,1.0
2021,11,3215,545,22,8454,2,5,3,3,9,6,9,0,9,0,True,False,False,0,2,2021-11-22T16:39:49.187,9,False,0.0
2021,11,3215,550,22,8454,2,5,2,23,23,0,23,0,23,0,False,False,False,0,2,2021-11-22T16:41:10.817,23,False,0.0
2021,11,3215,560,22,2391,2,32,5,3,5,2,4,1,4,0,False,False,False,0,4,2021-11-22T16:43:09.35,5,False,1.0
2021,11,3215,570,22,3170,2,5,9,5,5,0,5,0,5,0,False,False,False,0,3,2021-11-24T17:00:34.043,5,False,0.0
2021,11,3215,580,22,4997,13,2,10,14,0,0,0,0,0,0,True,False,False,0,2,2022-02-16T23:35:18.223,0,False,0.0
2021,11,3215,590,17,7024,3,28,3,-3,0,0,0,0,0,0,False,False,False,0,1,2022-02-16T23:36:05.967,0,False,0.0
2021,11,3215,615,22,743,2,47,5,-1,2,3,2,0,2,0,False,False,False,0,1,2021-11-22T17:02:35.82,2,False,0.0
2021,11,3215,620,22,8454,2,2,9,14,62,48,60,2,60,6,False,False,False,0,2,2021-11-22T17:04:14.86,62,False,2.0
2021,11,3215,635,17,8483,2,13,5,3,15,12,9,6,9,0,False,False,False,0,3,2021-11-22T17:06:56.643,15,False,6.0
2021,11,3215,650,17,8483,2,5,3,7,8,1,8,0,8,0,False,False,False,0,3,2021-11-22T17:11:22.347,8,False,0.0
2021,11,3215,665,17,6276,2,21,3,14,18,4,18,0,18,0,False,False,False,0,4,2021-11-24T16:36:55.87,18,False,0.0
2021,11,3215,670,17,6276,2,46,3,3,8,5,6,2,6,0,False,False,False,0,4,2021-11-22T17:17:20.89,8,False,2.0
2021,11,3215,675,17,364,2,50,10,-2,1,3,1,0,1,0,False,False,False,0,2,2021-11-22T17:19:18.69,1,False,0.0
2021,11,3215,680,17,4383,2,4,9,4,7,3,7,0,7,0,False,False,False,0,3,2021-11-22T17:20:35.203,7,False,0.0
2021,11,3215,685,17,6274,2,30,9,1,6,5,6,0,6,0,False,False,False,0,4,2021-11-22T17:22:08.803,6,False,0.0
2021,11,3215,695,17,7024,13,13,4,2,0,0,0,0,0,0,False,False,False,0,3,2021-11-22T17:27:33.497,0,False,
2021,11,3215,710,17,7087,13,35,5,5,0,0,0,0,0,0,False,False,False,0,3,2021-11-22T17:31:38.897,0,False,0.0
2021,11,3215,715,17,7024,2,17,9,4,5,1,5,0,5,6,False,False,False,0,1,2021-11-22T17:33:51.263,5,False,0.0
2021,11,3215,730,22,5080,13,6,10,14,0,0,0,0,0,0,True,False,False,0,2,2021-11-22T17:39:59,0,False,0.0
2021,11,3215,760,17,6276,2,30,9,0,7,7,7,0,7,0,False,False,False,0,4,2021-11-22T17:45:39.543,7,False,0.0
2021,11,3215,795,17,8483,2,46,3,3,6,3,6,0,6,0,False,False,False,0,3,2021-11-22T17:57:46.327,6,False,0.0
2021,11,3215,835,22,5080,2,4,5,6,12,6,5,7,5,0,False,False,False,0,2,2021-11-24T16:20:04.503,12,False,7.0
2021,11,3215,840,22,2391,3,28,5,1,0,0,0,0,0,0,False,False,False,0,1,2021-11-22T18:08:53.273,0,False,0.0
2021,11,3215,845,22,3170,2,4,9,6,8,2,7,1,7,0,False,False,False,0,3,2021-11-22T18:10:01.29,8,False,1.0
2021,11,3215,850,22,8454,2,29,3,11,11,0,11,0,11,0,False,False,False,0,2,2021-11-22T18:11:10.523,11,True,0.0
2021,11,3215,855,22,6812,2,46,3,-1,8,9,5,3,5,0,False,False,False,0,1,2021-11-22T18:12:25.4,8,False,3.0
2021,11,3215,860,22,3170,2,4,10,7,15,8,12,3,12,0,False,False,False,1,3,2021-11-22T18:13:30.05,15,False,3.0
2021,11,3216,15,5,4799,2,5,5,3,8,5,3,5,3,0,False,False,False,2,1,2021-11-22T10:22:35.51,8,False,5.0
2021,11,3216,50,5,5220,2,5,5,7,13,6,9,4,9,0,False,False,False,0,3,2021-11-22T10:47:57.42,13,False,4.0
2021,11,3216,55,5,5220,2,8,10,10,10,0,10,0,10,6,False,False,False,0,2,2022-02-16T21:52:54.483,10,True,0.0
2021,11,3216,95,5,3477,2,4,9,4,5,1,5,0,5,0,False,False,False,0,3,2021-11-22T11:28:06.447,5,False,0.0
2021,11,3216,110,32,7128,2,35,2,22,30,8,29,1,29,0,False,False,False,0,3,2021-11-22T11:42:14.267,30,False,1.0
2021,11,3216,115,32,3562,13,2,4,10,0,0,0,0,0,0,False,False,False,0,3,2022-02-17T21:12:02.21,0,False,
2021,11,3216,120,32,8528,2,32,5,3,7,4,6,1,6,0,False,False,False,0,4,2022-02-16T21:53:25.773,7,False,1.0
2021,11,3216,150,5,3477,2,47,5,1,3,2,3,0,3,0,False,False,False,0,3,2021-11-24T15:34:03.51,3,False,0.0
2021,11,3216,155,5,4799,13,16,4,2,0,0,0,0,0,0,False,False,False,0,1,2021-11-24T13:25:49.763,0,False,0.0
2021,11,3216,175,32,7128,2,19,6,39,39,0,39,0,39,0,False,False,False,0,2,2021-11-22T12:19:52.107,39,True,0.0
2021,11,3216,185,32,8659,13,12,4,4,0,0,0,0,0,0,False,False,False,0,1,2022-02-24T16:48:23.883,0,False,0.0
2021,11,3216,200,32,6430,2,2,4,6,6,0,6,0,6,6,False,False,False,0,3,2021-11-22T12:31:21.21,6,True,0.0
2021,11,3216,220,5,5220,2,6,10,11,11,0,11,0,11,0,False,False,False,0,2,2021-11-22T12:38:25.297,11,False,0.0
2021,11,3216,230,5,4799,2,48,9,-5,2,7,-1,3,-1,0,False,False,False,0,1,2022-02-16T21:53:59.52,2,False,3.0
2021,11,3216,235,5,5220,13,6,4,6,0,0,0,0,0,0,False,False,False,0,3,2021-11-22T12:48:02.62,0,False,0.0
2021,11,3216,255,32,3885,2,6,9,2,4,2,4,0,4,0,False,False,False,0,1,2021-11-22T12:58:09.937,4,False,0.0
2021,11,3216,275,5,8408,2,17,8,17,19,2,19,0,19,0,False,False,False,0,3,2021-11-22T13:09:02.127,19,False,0.0
2021,11,3216,280,5,6372,2,51,9,-3,7,10,2,5,2,0,False,False,False,0,3,2022-02-16T21:54:28.493,7,False,5.0
2021,11,3216,325,32,8533,2,4,5,5,5,0,5,0,5,0,False,False,False,0,2,2021-11-22T13:35:35.817,5,True,0.0
2021,11,3216,355,32,3562,2,2,9,7,18,11,17,1,17,0,False,False,False,0,3,2021-11-22T13:46:32.6,18,False,1.0
2021,11,3216,365,32,3885,13,26,3,1,0,0,0,0,0,0,False,False,False,0,2,2021-11-24T15:38:43.897,0,False,0.0
2021,11,3216,375,32,2675,2,2,4,8,12,4,11,1,11,0,False,False,False,0,3,2021-11-22T13:56:48.617,12,False,1.0
2021,11,3216,385,32,7128,2,2,10,12,12,0,12,0,12,6,False,False,False,0,3,2021-11-22T14:02:17.537,12,False,0.0
2021,11,3216,415,32,7128,2,30,5,3,7,4,6,1,6,0,True,False,False,0,4,2022-02-16T21:54:52.507,7,False,1.0
2021,11,3216,425,32,7128,13,8,7,45,0,0,0,0,0,0,False,False,False,0,2,2021-11-23T16:31:38.173,0,False,0.0
2021,11,3216,435,32,6430,2,6,4,11,13,2,11,2,11,0,False,False,False,0,3,2021-11-22T18:18:34.3,13,False,2.0
2021,11,3216,465,32,3562,2,26,3,4,4,0,4,0,4,6,False,False,False,0,2,2021-11-24T15:42:22.153,4,True,0.0
2021,11,3216,490,5,4799,2,4,10,3,9,6,8,1,8,0,True,False,False,0,1,2021-11-24T13:25:49.81,9,False,1.0
2021,11,3216,500,5,8406,3,13,9,5,0,0,0,0,0,0,False,False,False,0,3,2022-02-16T21:55:24.687,0,False,0.0
2021,11,3216,505,5,5220,13,2,4,11,0,0,0,0,0,0,True,False,False,0,3,2021-11-24T13:25:49.81,0,False,0.0
2021,11,3216,525,32,7128,2,5,2,16,15,-1,15,0,15,0,False,False,False,0,3,2022-02-16T21:55:51.697,15,False,0.0
2021,11,3216,565,32,8528,2,32,5,2,10,8,8,2,8,0,False,False,False,0,4,2021-11-24T15:16:05.043,10,False,2.0
2021,11,3216,585,5,3477,2,51,10,-3,4,7,2,2,2,0,False,False,False,0,3,2021-11-22T15:26:20.587,4,False,2.0
2021,11,3216,600,5,5220,2,4,10,4,10,6,6,4,6,0,False,False,False,1,2,2021-11-24T14:43:06.207,10,False,4.0
2021,11,3216,610,5,8408,2,35,3,12,16,4,16,0,16,0,False,False,False,0,3,2022-02-16T21:56:19.357,16,False,0.0
2021,11,3216,615,5,4799,2,17,8,25,27,2,27,0,27,6,False,False,False,0,1,2021-11-22T15:47:18.95,27,True,0.0
2021,11,3216,650,32,2675,2,4,10,12,18,6,12,6,12,0,False,False,False,1,3,2021-11-22T16:02:27.86,18,False,6.0
2021,11,3216,655,32,8528,2,12,3,6,6,0,6,0,6,0,False,False,False,0,3,2021-11-24T14:43:30.497,6,False,0.0
2021,11,3216,675,32,3562,13,9,2,22,0,0,0,0,0,0,False,False,False,0,3,2022-02-16T21:58:10.777,0,False,0.0
2021,11,3216,680,32,7128,13,35,6,22,0,0,0,0,0,0,False,False,False,0,3,2021-11-24T14:41:30.82,0,False,0.0
2021,11,3216,705,5,3477,2,26,10,5,7,2,7,0,7,0,False,False,False,0,3,2021-11-24T13:25:49.827,7,False,0.0
2021,11,3216,710,5,5220,2,5,5,4,6,2,5,1,5,0,False,False,False,0,3,2021-11-22T16:41:40.64,6,False,1.0
2021,11,3216,715,5,4799,2,6,10,3,4,1,4,0,4,0,False,False,False,0,1,2021-11-22T16:45:56.08,4,False,0.0
2021,11,3216,725,5,4799,2,5,3,2,2,0,2,0,2,0,True,False,False,0,1,2021-11-23T17:20:22.94,2,False,0.0
2021,11,3216,780,5,4799,2,4,9,5,8,3,6,2,6,0,True,False,False,0,3,2021-11-22T17:06:24.45,8,False,2.0
2021,11,3216,785,5,3477,2,5,3,11,11,0,11,0,11,0,False,False,False,0,2,2021-11-24T13:25:49.857,11,True,0.0
2021,11,3216,790,5,3477,13,13,10,3,0,0,0,0,0,0,False,False,False,0,2,2021-11-24T15:19:52.263,0,False,0.0
2021,11,3216,795,5,6425,2,32,5,4,7,3,7,0,7,0,False,False,False,0,3,2021-11-22T17:16:58.627,7,False,0.0
2021,11,3216,800,5,6372,13,5,9,3,0,0,0,0,0,0,False,False,False,0,3,2021-11-22T17:19:24.33,0,False,0.0
2021,11,3217,10,14,1114,2,4,3,8,8,0,8,0,8,0,False,False,False,0,2,2021-11-22T11:36:29.227,8,False,0.0
2021,11,3217,15,14,8400,13,13,10,1,0,0,0,0,0,0,False,False,False,0,4,2021-11-22T11:38:52.383,0,False,0.0
2021,11,3217,35,14,7582,2,51,9,-6,-4,2,-4,0,-4,0,False,False,False,0,1,2021-11-22T16:25:36.233,-4,False,0.0
2021,11,3217,40,14,7584,2,6,9,14,18,4,15,3,15,0,False,False,False,0,3,2021-11-24T16:50:14.787,18,False,3.0
2021,11,3217,75,4,213,2,12,5,6,7,1,7,0,7,0,False,False,False,0,2,2021-11-22T11:58:44.643,7,False,0.0
2021,11,3217,85,4,6953,2,53,10,-4,11,15,7,4,7,0,True,False,False,0,4,2021-11-23T18:02:58.017,11,False,4.0
2021,11,3217,90,4,213,2,3,3,11,9,-2,9,0,9,0,False,False,False,0,2,2021-11-24T16:23:25.697,9,True,0.0
2021,11,3217,105,4,7937,2,46,3,0,7,7,7,0,7,0,False,False,False,0,1,2021-11-22T12:10:38.717,7,False,0.0
2021,11,3217,115,4,213,13,12,2,17,0,0,0,0,0,0,False,False,False,0,2,2022-02-17T21:06:08.12,0,False,
2021,11,3217,120,4,7646,13,4,8,21,0,0,0,0,0,0,False,False,False,0,2,2021-11-23T18:10:27.043,0,False,0.0
2021,11,3217,125,14,1119,3,6,10,11,0,0,0,0,0,0,False,False,False,0,3,2022-02-16T21:42:59.767,0,False,0.0
2021,11,3217,135,14,1119,2,6,7,15,18,3,16,2,16,0,False,False,False,0,4,2021-11-24T16:23:42.737,18,False,2.0
2021,11,3217,140,14,7584,2,50,9,-3,5,8,0,5,0,0,False,False,False,0,2,2021-11-22T12:25:02.13,5,False,5.0
2021,11,3217,145,14,7582,2,11,3,11,23,12,11,12,11,6,False,False,False,1,1,2021-11-24T13:55:55.077,23,False,12.0
2021,11,3217,165,4,7646,2,6,7,20,20,0,20,0,20,0,False,False,False,0,2,2021-11-22T16:57:55.227,20,False,0.0
2021,11,3217,170,4,2853,2,26,5,2,2,0,2,0,2,0,True,False,False,2,3,2021-11-23T18:03:11.203,2,False,0.0
2021,11,3217,180,4,6953,2,6,10,14,18,4,17,1,17,0,False,False,False,0,4,2021-11-22T12:36:23.693,18,False,1.0
2021,11,3217,195,4,2853,13,12,2,22,0,0,0,0,0,0,False,False,False,0,4,2022-02-24T16:50:39.477,0,False,0.0
2021,11,3217,205,4,594,2,5,3,3,3,0,3,0,3,0,False,False,False,0,2,2021-11-22T12:49:29.337,3,True,0.0
2021,11,3217,215,4,2853,2,3,5,6,6,0,6,0,6,6,False,False,False,0,2,2021-11-23T18:13:46.79,6,True,0.0
2021,11,3217,230,14,1119,13,13,10,0,0,0,0,0,0,0,False,False,False,0,4,2021-11-22T12:53:37.513,0,False,0.0
2021,11,3217,240,14,1119,13,4,9,10,0,0,0,0,0,0,False,False,False,0,3,2021-11-24T13:55:55.077,0,False,
2021,11,3217,300,14,5197,13,7,3,11,0,0,0,0,0,0,False,False,False,0,3,2021-11-22T13:22:33.84,0,False,0.0
2021,11,3217,305,14,7584,13,2,9,5,0,0,0,0,0,0,True,False,False,0,2,2021-11-24T00:14:56.287,0,False,0.0
2021,11,3217,340,4,6983,2,32,10,-2,14,16,12,2,12,0,False,False,False,1,1,2021-11-22T13:31:29.117,14,False,2.0
2021,11,3217,345,4,6953,2,28,5,2,12,10,10,2,10,0,True,False,False,0,1,2022-02-16T21:43:56.887,12,False,2.0
2021,11,3217,350,4,6953,2,32,10,-1,7,8,7,0,7,0,True,False,False,0,1,2021-11-22T13:32:50.74,7,False,0.0
2021,11,3217,360,4,2853,2,2,9,5,6,1,6,0,6,0,False,False,False,0,2,2021-11-23T18:13:46.79,6,False,0.0
2021,11,3217,375,4,7645,3,4,9,4,0,0,0,0,0,0,False,False,False,0,1,2021-11-24T16:50:44.053,0,False,0.0
2021,11,3217,380,4,213,2,13,10,4,10,6,8,2,8,0,False,False,False,0,3,2021-11-22T13:39:26.043,10,False,2.0
2021,11,3217,410,4,4913,13,4,9,4,0,0,0,0,0,0,False,False,False,0,1,2021-11-22T14:16:28.867,0,False,0.0
2021,11,3217,415,4,6953,3,5,6,16,0,0,0,0,0,0,False,False,False,0,3,2022-02-17T21:07:33.74,0,False,0.0
2021,11,3217,420,4,7646,13,6,8,17,0,0,0,0,0,0,False,False,False,0,3,2022-02-16T21:45:17.543,0,False,0.0
2021,11,3217,430,14,7584,13,35,5,10,0,0,0,0,0,0,False,False,False,0,3,2021-11-22T14:22:47.293,0,False,0.0
2021,11,3217,440,14,1119,2,4,9,6,9,3,8,1,8,0,False,False,False,0,3,2021-11-22T14:24:34.003,9,False,1.0
2021,11,3217,445,14,1114,2,13,9,5,18,13,8,10,8,0,False,False,False,1,3,2021-11-24T16:50:53.757,18,False,10.0
2021,11,3217,450,14,4449,13,4,10,3,0,0,0,0,0,0,False,False,False,0,3,2021-11-22T14:28:08.77,0,False,0.0
2021,11,3217,470,14,7582,13,12,9,6,0,0,0,0,0,0,False,False,False,0,1,2021-11-24T17:05:13.697,0,False,
2021,11,3217,475,14,7583,13,4,4,7,0,0,0,0,0,0,False,False,False,0,3,2021-11-24T13:55:55.077,0,False,0.0
2021,11,3217,480,14,7582,2,51,5,-3,0,3,0,0,0,0,False,False,False,0,1,2021-11-22T14:37:35.457,0,False,0.0
2021,11,3217,485,14,7584,13,13,10,5,0,0,0,0,0,0,False,False,False,0,3,2021-11-22T14:39:01.147,0,False,0.0
2021,11,3217,515,4,6953,3,30,3,-2,0,0,0,0,0,0,False,False,False,0,4,2021-11-24T16:51:07.027,0,False,0.0
2021,11,3217,520,4,594,3,2,10,7,0,0,0,0,0,0,False,False,False,0,3,2022-02-16T21:45:58.877,0,False,0.0
2021,11,3217,540,14,1119,2,47,5,3,3,0,3,0,3,0,False,False,False,0,4,2021-11-24T16:23:56.913,3,False,0.0
2021,11,3217,570,4,213,13,6,7,17,0,0,0,0,0,0,False,False,False,0,2,2021-11-22T15:02:56.61,0,False,0.0
2021,11,3217,575,4,213,13,4,8,15,0,0,0,0,0,0,False,False,False,0,2,2022-03-08T18:08:07.263,0,False,0.0
2021,11,3217,600,14,8400,2,30,10,0,8,8,3,5,3,0,False,False,False,2,4,2021-11-22T15:15:14.787,8,False,5.0
2021,11,3217,620,4,594,2,4,3,4,6,2,5,1,5,0,False,False,False,0,3,2021-11-22T15:20:21.19,6,False,1.0
2021,11,3217,625,4,2853,13,3,3,13,0,0,0,0,0,0,False,False,False,0,2,2021-11-24T16:51:20.757,0,False,0.0
2021,11,3217,635,4,594,2,4,10,6,7,1,6,1,6,0,False,False,False,0,3,2021-11-24T16:24:30.503,7,False,1.0
2021,11,3217,645,4,4913,2,48,10,-3,16,19,12,4,12,0,False,False,False,0,1,2021-11-22T15:25:16.41,16,False,4.0
2021,11,3217,650,4,594,2,4,3,3,7,4,5,2,5,0,False,False,False,0,3,2021-11-22T15:26:56.383,7,False,2.0
2021,11,3217,655,4,6953,3,4,9,6,0,0,0,0,0,0,False,False,False,0,4,2021-11-23T18:11:16.043,0,False,0.0
2021,11,3217,660,4,6953,2,9,6,28,31,3,28,3,28,0,False,False,False,0,3,2021-11-24T17:14:16.93,31,False,3.0
2021,11,3217,665,4,6953,2,30,5,0,1,1,1,0,1,0,False,False,False,0,4,2021-11-22T15:31:53.213,1,False,0.0
2021,11,3217,670,4,6953,13,5,5,9,0,0,0,0,0,0,False,False,False,0,3,2021-11-24T16:51:33.427,0,False,0.0
2021,11,3217,675,4,2853,2,6,9,9,9,0,9,0,9,6,False,False,False,0,2,2021-11-22T15:35:39.057,9,True,0.0
2021,11,3217,755,4,6983,2,6,10,3,8,5,6,2,6,0,False,False,False,0,1,2021-11-22T15:53:48.257,8,False,2.0
2021,11,3217,760,4,6983,3,4,4,2,0,0,0,0,0,0,False,False,False,0,1,2021-11-22T15:55:02.563,0,False,0.0
2021,11,3217,765,4,7646,2,6,9,7,7,0,7,0,7,0,False,False,False,0,2,2021-11-22T15:56:13.163,7,False,0.0
2021,11,3217,770,4,6983,2,46,3,0,4,4,3,1,3,0,False,False,False,0,1,2021-11-23T18:11:44.153,4,False,1.0
2021,11,3217,775,4,6990,13,17,8,12,0,0,0,0,0,0,False,False,False,0,3,2021-11-24T17:14:27.833,0,False,0.0
2021,11,3218,20,8,232,2,6,9,11,13,2,12,1,12,0,False,False,False,0,2,2021-11-24T14:26:35.19,13,False,1.0
2021,11,3218,25,8,3883,13,2,10,6,0,0,0,0,0,0,False,False,False,0,3,2021-11-22T10:06:06.363,0,False,0.0
2021,11,3218,45,11,8641,2,32,10,1,12,11,10,2,10,0,False,False,False,0,4,2021-11-22T10:51:43.857,12,False,2.0
2021,11,3218,70,11,4875,13,4,3,5,0,0,0,0,0,0,False,False,False,0,2,2021-11-22T10:35:20.523,0,False,0.0
2021,11,3218,85,8,232,13,8,2,32,0,0,0,0,0,0,False,False,False,0,2,2021-11-24T13:43:36.03,0,False,0.0
2021,11,3218,90,11,6810,2,4,10,5,9,4,6,3,6,0,False,False,False,0,3,2021-11-22T10:37:50.573,9,False,3.0
2021,11,3218,100,11,8359,2,51,10,-1,13,14,8,5,8,0,False,False,False,2,3,2021-11-22T10:46:20.78,13,False,
2021,11,3218,115,11,7732,13,6,9,8,0,0,0,0,0,0,False,False,False,0,1,2021-11-24T13:45:14.257,0,False,0.0
2021,11,3218,125,8,6439,2,45,10,-6,9,15,4,5,4,0,False,False,False,1,1,2021-11-22T11:13:09.9,9,False,5.0
2021,11,3218,145,8,4976,2,7,2,19,21,2,20,1,20,0,False,False,False,0,4,2021-11-22T11:22:50.25,21,False,1.0
2021,11,3218,150,8,3883,2,53,10,-4,20,24,18,2,18,0,False,False,False,0,4,2021-11-22T11:24:47.467,20,False,2.0
2021,11,3218,175,11,6629,13,53,9,-7,0,0,0,0,0,0,False,False,False,0,4,2021-11-22T11:41:42.737,0,False,0.0
2021,11,3218,185,11,6810,13,5,10,12,0,0,0,0,0,0,False,False,False,0,3,2021-11-22T11:43:53.69,0,False,0.0
2021,11,3218,200,8,3606,13,9,2,17,0,0,0,0,0,0,False,False,False,0,2,2021-11-24T12:23:31.533,0,False,0.0
2021,11,3218,205,8,232,13,4,10,14,0,0,0,0,0,0,False,False,False,0,3,2021-11-24T13:19:26.45,0,False,
2021,11,3218,225,8,3883,13,7,2,19,0,0,0,0,0,0,False,False,False,0,4,2021-11-22T12:04:01.777,0,False,0.0
2021,11,3218,230,8,232,2,4,10,3,3,0,3,0,3,0,True,False,False,0,1,2021-11-24T13:21:21.297,3,False,0.0
2021,11,3218,235,8,3606,13,4,5,8,0,0,0,0,0,0,False,False,False,0,2,2021-11-22T12:24:49.913,0,False,0.0
2021,11,3218,270,8,7652,13,7,5,14,0,0,0,0,0,0,True,False,False,0,3,2021-11-23T17:55:37.867,0,False,
2021,11,3218,280,8,3883,2,5,3,4,7,3,5,2,5,0,False,False,False,0,4,2021-11-22T12:41:44.027,7,False,2.0
2021,11,3218,285,8,232,13,4,8,16,0,0,0,0,0,0,False,False,False,0,2,2021-11-24T14:17:26.013,0,False,0.0
2021,11,3218,290,8,3606,2,7,6,16,17,1,17,0,17,0,False,False,False,0,3,2021-11-24T14:18:12.72,17,True,0.0
2021,11,3218,300,8,3883,2,5,3,5,6,1,5,1,5,0,False,False,False,0,4,2021-11-22T12:50:58.747,6,False,1.0
2021,11,3218,315,8,232,13,5,3,6,0,0,0,0,0,0,False,False,False,0,3,2021-11-22T12:55:25.28,0,False,
2021,11,3218,325,8,3883,2,35,2,16,20,4,18,2,18,0,False,False,False,0,4,2021-11-22T13:00:11.353,20,False,2.0
2021,11,3218,330,8,232,2,30,10,-2,3,5,2,1,2,0,False,False,False,0,3,2021-11-22T13:03:03.213,3,False,1.0
2021,11,3218,345,8,3606,13,4,9,9,0,0,0,0,0,0,False,False,False,0,2,2021-11-22T13:08:35.887,0,False,
2021,11,3218,350,8,6439,2,46,3,3,5,2,5,0,5,6,False,False,False,0,1,2022-02-16T22:18:36.6,5,True,0.0
2021,11,3218,365,11,7732,2,48,9,-4,-1,3,-1,0,-1,0,False,False,False,0,1,2021-11-22T13:14:38.433,-1,False,0.0
2021,11,3218,370,11,6810,2,26,10,3,5,2,3,2,3,0,False,False,False,0,3,2021-11-24T12:23:31.533,5,False,2.0
2021,11,3218,385,11,8359,2,13,9,2,3,1,2,1,2,0,False,False,False,0,2,2021-11-22T13:19:27.447,3,False,1.0
2021,11,3218,395,11,4875,13,3,5,13,0,0,0,0,0,0,False,False,False,0,2,2021-11-22T13:21:52.857,0,False,0.0
2021,11,3218,400,11,4875,13,4,6,20,0,0,0,0,0,0,False,False,False,0,2,2021-11-24T13:22:52.49,0,False,
2021,11,3218,405,11,6810,13,6,4,13,0,0,0,0,0,0,False,False,False,0,3,2021-11-24T13:47:31.213,0,False,0.0
2021,11,3218,410,11,7732,2,53,9,-7,2,9,1,1,1,0,False,False,False,0,4,2021-11-22T13:31:51.157,2,False,1.0
2021,11,3218,425,11,6810,2,7,5,6,9,3,7,2,7,0,False,False,False,0,3,2021-11-24T13:24:45.383,9,False,2.0
2021,11,3218,450,11,8359,2,44,9,-2,-1,1,-2,1,-2,0,False,False,False,0,3,2022-02-16T22:19:13.687,-1,False,1.0
2021,11,3218,455,11,4037,13,35,9,10,0,0,0,0,0,0,True,False,False,0,3,2021-11-24T13:25:41.307,0,False,0.0
2021,11,3218,465,8,232,2,5,10,7,7,0,7,0,7,0,True,False,False,0,3,2021-11-24T14:28:14.07,7,False,0.0
2021,11,3218,485,8,232,13,6,9,12,0,0,0,0,0,0,False,False,False,0,2,2021-11-22T14:11:52.963,0,False,0.0
2021,11,3218,490,8,4976,2,39,9,10,10,0,10,0,10,0,False,False,False,0,3,2021-11-23T17:51:39.307,10,False,
2021,11,3218,495,8,8054,2,13,9,4,9,5,9,0,9,0,False,False,False,0,3,2021-11-23T18:00:40.037,9,False,0.0
2021,11,3218,505,11,8359,2,5,5,10,10,0,10,0,10,0,False,False,False,0,3,2021-11-22T14:28:46.34,10,False,0.0
2021,11,3218,510,11,4875,13,8,8,44,0,0,0,0,0,0,False,False,False,0,2,2022-02-16T22:19:59.19,0,False,0.0
2021,11,3218,520,8,8054,2,7,2,37,37,0,37,0,37,0,False,False,False,0,3,2021-11-22T14:38:13.293,37,True,0.0
2021,11,3218,535,8,8054,13,8,1,34,0,0,0,0,0,0,False,False,False,0,2,2021-11-22T14:43:05.447,0,False,
2021,11,3218,560,11,6810,2,32,3,0,0,0,0,0,0,0,True,False,False,0,4,2021-11-23T21:37:01.903,0,False,0.0
2021,11,3218,580,8,4976,13,46,3,-4,0,0,0,0,0,0,True,False,False,0,4,2022-02-16T22:21:13.06,0,False,0.0
2021,11,3218,585,8,3606,13,12,3,14,0,0,0,0,0,0,False,False,False,0,3,2022-02-17T21:26:54.16,0,False,0.0
2021,11,3218,590,8,3606,13,5,3,14,0,0,0,0,0,0,False,False,False,0,3,2021-11-24T14:29:32.403,0,False,0.0
2021,11,3218,615,11,6810,2,4,9,4,4,0,4,0,4,0,False,False,False,0,4,2021-11-22T15:23:51.123,4,False,0.0
2021,11,3218,625,11,7732,2,53,9,-7,-1,6,-2,1,-2,0,False,False,False,0,4,2022-02-22T20:23:20.8,-1,False,1.0
2021,11,3218,650,8,3883,13,5,9,4,0,0,0,0,0,0,False,False,False,0,4,2021-11-22T15:36:07.72,0,False,0.0
2021,11,3218,655,8,232,13,8,7,19,0,0,0,0,0,0,False,False,False,0,3,2021-11-23T18:00:59.563,0,False,0.0
2021,11,3218,660,11,8359,2,45,5,-2,6,8,6,0,6,0,True,False,False,0,3,2021-11-22T15:39:35.043,6,False,0.0
2021,11,3218,705,8,4976,2,53,10,-4,-1,3,-3,2,-3,0,False,False,False,0,4,2021-11-22T15:51:22.323,-1,False,2.0
2021,11,3218,710,8,4976,13,46,9,3,0,0,0,0,0,0,False,False,False,0,4,2021-11-22T15:53:02.66,0,False,0.0
2021,11,3218,720,11,6810,2,35,9,10,24,14,20,4,20,0,False,False,False,0,4,2021-11-24T13:11:40.427,24,False,4.0
2021,11,3218,730,11,6571,2,48,10,-6,-4,2,-4,0,-4,0,False,False,False,0,1,2021-11-22T15:59:53.193,-4,False,0.0
2021,11,3219,10,28,4922,2,32,9,4,9,5,7,2,7,0,False,False,False,0,4,2021-11-22T10:38:24.557,9,False,2.0
2021,11,3219,20,28,262,2,6,10,4,7,3,6,1,6,0,True,False,False,0,2,2021-11-23T17:57:54.49,7,False,1.0
2021,11,3219,35,28,6624,2,44,3,6,8,2,8,0,8,0,False,False,False,0,1,2021-11-22T10:50:44.68,8,True,0.0
2021,11,3219,70,28,7619,2,2,10,8,13,5,9,4,9,0,False,False,False,0,2,2022-03-08T19:01:28.28,13,False,4.0
2021,11,3219,105,28,6624,13,13,10,2,0,0,0,0,0,0,False,False,False,0,4,2022-02-16T22:31:37.683,0,False,0.0
2021,11,3219,135,15,7591,2,51,5,-2,6,8,2,4,2,0,False,False,False,0,3,2021-11-24T17:47:03.85,6,False,4.0
2021,11,3219,140,15,1412,13,9,6,30,0,0,0,0,0,0,False,False,False,0,3,2021-11-22T11:50:00.523,0,False,0.0
2021,11,3219,150,28,7619,2,35,8,18,34,16,17,17,17,0,False,False,False,1,3,2022-03-08T19:02:30.597,34,False,17.0
2021,11,3219,165,28,7619,2,2,10,5,7,2,5,2,5,0,False,False,False,0,2,2021-11-22T12:03:21.753,7,False,2.0
2021,11,3219,200,15,7591,2,50,9,-3,6,9,3,3,3,0,False,True,True,0,3,2022-01-06T16:56:30.283,6,False,3.0
2021,11,3219,225,28,7760,13,8,9,14,0,0,0,0,0,0,False,False,False,0,4,2021-11-24T18:37:46.783,0,False,
2021,11,3219,235,28,262,13,7,10,6,0,0,0,0,0,0,True,False,False,0,4,2022-01-06T16:56:30.297,0,False,0.0
2021,11,3219,240,28,7619,2,35,9,6,6,0,6,0,6,6,False,False,False,0,3,2021-11-24T19:12:02.373,6,True,0.0
2021,11,3219,270,15,957,2,35,10,10,18,8,15,3,15,0,False,False,False,0,3,2021-11-23T20:57:30.523,18,False,3.0
2021,11,3219,275,15,7591,2,5,3,5,16,11,9,7,9,0,False,False,False,1,3,2021-11-24T17:57:44.567,16,False,7.0
2021,11,3219,285,15,8099,2,48,10,-3,6,9,3,3,3,0,False,False,False,0,1,2021-11-22T13:30:30.493,6,False,3.0
2021,11,3219,290,15,4487,2,5,3,1,8,7,6,2,6,0,False,False,False,0,3,2021-11-24T18:42:46.96,8,False,2.0
2021,11,3219,310,15,914,13,29,5,14,0,0,0,0,0,0,False,False,False,0,2,2021-11-24T18:43:21.653,0,False,0.0
2021,11,3219,340,28,7619,2,2,9,8,9,1,9,0,9,0,True,False,False,0,3,2021-11-23T17:59:28.09,9,False,0.0
2021,11,3219,355,28,7619,2,2,10,5,9,4,7,2,7,0,False,False,False,1,2,2022-01-06T16:56:30.297,9,False,2.0
2021,11,3219,365,28,8463,2,11,5,8,23,15,23,0,23,0,False,False,False,0,1,2022-01-06T16:56:30.297,23,True,0.0
2021,11,3219,390,15,914,13,6,7,19,0,0,0,0,0,0,False,False,False,0,2,2022-01-06T17:32:05.59,0,False,0.0
2021,11,3219,400,15,4179,13,5,3,14,0,0,0,0,0,0,False,False,False,0,2,2021-11-22T14:34:54.58,0,False,0.0
2021,11,3219,415,28,7224,2,35,10,9,15,6,11,4,11,0,False,False,False,0,3,2022-03-08T19:04:17.59,15,False,4.0
2021,11,3219,420,28,7619,2,51,5,-2,7,9,5,2,5,0,True,False,False,0,3,2021-11-23T17:59:54.21,7,False,2.0
2021,11,3219,435,28,4922,2,35,9,11,13,2,12,1,12,0,False,False,False,0,4,2021-11-22T14:52:46.947,13,False,1.0
2021,11,3219,455,28,7753,2,46,3,1,4,3,2,2,2,0,False,False,False,0,1,2022-03-08T19:05:06.73,4,False,2.0
2021,11,3219,460,28,975,13,32,10,1,0,0,0,0,0,0,False,False,False,0,4,2021-11-24T17:52:06.55,0,False,0.0
2021,11,3219,465,28,4922,2,2,9,1,1,0,1,0,1,6,False,False,False,0,3,2021-11-22T15:09:46.797,1,True,0.0
2021,11,3219,490,15,7591,2,4,9,4,15,11,6,9,6,0,True,False,False,1,2,2021-11-24T18:02:20.073,15,False,9.0
2021,11,3219,495,15,8099,13,12,3,4,0,0,0,0,0,0,False,False,False,0,1,2021-11-22T15:27:13.86,0,False,0.0
2021,11,3219,530,28,7224,13,9,6,19,0,0,0,0,0,0,False,False,False,0,2,2021-11-23T17:57:18,0,False,0.0
2021,11,3219,540,15,7591,2,51,10,-1,7,8,6,1,6,0,False,False,False,0,3,2022-03-08T19:05:34.087,7,False,1.0
2021,11,3219,560,15,8099,2,46,3,0,3,3,1,2,1,0,False,False,False,0,1,2022-03-08T19:05:51.907,3,False,2.0
2021,11,3219,570,15,4487,2,4,10,6,7,1,7,0,7,0,True,False,False,0,2,2021-11-23T20:55:32.75,7,False,0.0
2021,11,3219,575,15,4487,2,46,3,2,3,1,3,0,3,0,False,False,False,0,3,2021-11-24T19:03:19.147,3,False,0.0
2021,11,3219,585,15,4179,3,35,3,8,0,0,0,0,0,0,False,False,False,0,3,2021-11-24T17:53:09.413,0,False,0.0
2021,11,3219,590,15,4179,2,4,5,7,11,4,10,1,10,0,False,False,False,0,2,2021-11-22T16:15:42.313,11,False,1.0
2021,11,3219,605,15,153,13,4,9,1,0,0,0,0,0,0,False,False,False,0,1,2022-02-24T16:51:35.533,0,False,0.0
2021,11,3219,645,28,4922,2,5,5,3,11,8,6,5,6,0,False,False,False,1,4,2021-11-24T18:03:11.673,11,False,5.0
2021,11,3219,675,15,914,2,4,10,11,13,2,11,2,11,0,False,False,False,0,2,2021-11-24T17:53:48.32,13,False,2.0
2021,11,3219,680,15,914,2,7,2,17,22,5,19,3,19,0,False,False,False,0,2,2021-11-22T17:03:27.757,22,False,3.0
2021,11,3219,685,15,914,2,4,5,8,8,0,8,0,8,0,False,False,False,0,2,2021-11-22T17:47:10.803,8,False,0.0
2021,11,3219,690,15,957,3,4,9,12,0,0,0,0,0,0,False,False,False,0,3,2021-11-22T17:05:42.777,0,False,0.0
2021,11,3219,700,15,914,2,4,5,9,9,0,9,0,9,0,False,False,False,0,2,2021-11-24T19:10:27.057,9,False,0.0
2021,11,3219,710,15,914,13,12,5,13,0,0,0,0,0,0,False,False,False,0,2,2021-11-22T17:15:34.763,0,False,
2021,11,3220,15,31,6793,13,6,10,12,0,0,0,0,0,0,False,False,False,0,2,2021-11-22T10:28:10.197,0,False,0.0
2021,11,3220,20,31,3911,2,4,10,12,11,-1,11,0,11,0,False,False,False,0,3,2021-11-22T10:31:52.227,11,False,0.0
2021,11,3220,40,31,3911,13,8,7,28,0,0,0,0,0,0,False,False,False,0,3,2021-11-22T18:59:25.3,0,False,0.0
2021,11,3220,50,31,7913,2,2,4,6,10,4,8,2,8,0,False,False,False,0,3,2022-02-17T00:19:47.54,10,False,2.0
2021,11,3220,80,13,876,2,5,5,5,8,3,7,1,7,0,False,False,False,0,3,2021-11-22T11:31:28.853,8,False,1.0
2021,11,3220,90,13,3586,2,34,4,-4,10,14,9,1,9,0,True,False,False,0,2,2021-11-24T00:02:37.107,10,False,1.0
2021,11,3220,95,13,8417,2,3,5,9,9,0,9,0,9,0,False,False,False,0,2,2021-11-22T11:43:34.733,9,False,0.0
2021,11,3220,115,13,4662,2,5,9,6,8,2,7,1,7,0,False,False,False,0,3,2021-11-24T15:49:48.53,8,False,1.0
2021,11,3220,120,13,2407,2,5,3,12,12,0,12,0,12,0,False,False,False,0,2,2021-11-22T12:02:33.207,12,False,0.0
2021,11,3220,135,13,8418,3,5,5,7,0,0,0,0,0,0,False,False,False,0,2,2022-02-17T00:20:47.413,0,False,0.0
2021,11,3220,165,31,6793,2,5,5,11,10,-1,10,0,10,0,False,False,False,0,2,2021-11-22T12:32:36.383,10,False,0.0
2021,11,3220,175,31,6793,2,6,10,10,11,1,11,0,11,0,False,False,False,1,2,2021-11-22T12:40:52.62,11,False,0.0
2021,11,3220,185,31,4070,13,9,6,18,0,0,0,0,0,0,False,False,False,0,3,2021-11-22T13:19:16.93,0,False,0.0
2021,11,3220,195,31,6793,13,2,9,6,0,0,0,0,0,0,False,False,False,0,3,2021-11-24T16:45:54.727,0,False,0.0
2021,11,3220,210,13,2455,2,47,10,0,3,3,2,1,2,0,False,False,False,0,1,2021-11-24T16:24:18.733,3,False,1.0
2021,11,3220,215,13,8417,13,9,3,6,0,0,0,0,0,0,False,False,False,0,2,2022-01-06T17:52:53.193,0,False,0.0
2021,11,3220,230,31,6793,13,6,9,11,0,0,0,0,0,0,True,False,False,0,3,2021-11-23T17:11:22.137,0,False,0.0
2021,11,3220,250,13,2407,2,2,9,13,13,0,13,0,13,0,False,False,False,0,2,2021-11-22T13:17:38.353,13,False,0.0
2021,11,3220,255,13,876,13,5,5,14,0,0,0,0,0,0,False,False,False,0,2,2021-11-24T15:40:47.923,0,False,
2021,11,3220,265,13,876,2,26,10,5,10,5,8,2,8,0,False,False,False,0,3,2021-11-22T13:40:18.513,10,False,2.0
2021,11,3220,270,13,2455,2,45,5,-1,5,6,1,4,1,0,False,False,False,0,1,2021-11-22T19:02:48.977,5,False,4.0
2021,11,3220,280,13,2407,2,5,5,6,6,0,6,0,6,0,False,False,False,0,3,2021-11-22T13:50:38.45,6,False,0.0
2021,11,3220,325,31,4844,2,48,10,-4,15,19,11,4,11,0,False,False,False,0,1,2021-11-22T14:08:54.27,15,False,4.0
2021,11,3220,340,31,6724,2,46,3,1,1,0,1,0,1,0,False,False,False,0,3,2021-11-22T14:16:01.47,1,False,0.0
2021,11,3220,355,13,4662,2,30,10,0,2,2,1,1,1,0,False,False,False,0,4,2022-01-06T17:36:38.013,2,False,1.0
2021,11,3220,365,13,2455,2,48,10,-4,8,12,7,1,7,0,False,False,False,0,1,2021-11-22T14:27:26.063,8,False,1.0
2021,11,3220,375,31,6793,13,6,10,13,0,0,0,0,0,0,False,False,False,0,2,2022-02-17T00:22:43.453,0,False,0.0
2021,11,3220,380,31,6722,2,31,10,1,8,7,6,2,6,0,False,False,False,0,1,2021-11-22T14:37:01.493,8,False,2.0
2021,11,3220,385,31,6793,2,4,5,7,7,0,7,0,7,0,False,False,False,0,2,2021-11-22T14:38:28.567,7,True,0.0
2021,11,3220,390,31,6722,3,16,10,3,0,0,0,0,0,0,False,False,False,0,1,2021-11-24T16:27:45.03,0,False,0.0
2021,11,3220,395,31,3911,2,4,9,9,12,3,10,2,10,0,False,False,False,0,3,2021-11-22T14:43:33.63,12,False,2.0
2021,11,3220,400,31,6724,2,4,10,7,7,0,7,0,7,0,False,False,False,0,3,2021-11-22T14:44:54.42,7,False,0.0
2021,11,3220,410,31,6722,2,48,10,-3,10,13,9,1,9,0,False,False,False,0,1,2021-11-22T14:46:51.61,10,False,1.0
2021,11,3220,415,31,6722,2,31,10,0,8,8,5,3,5,0,False,False,False,0,1,2021-11-22T14:48:17.44,8,False,3.0
2021,11,3220,425,31,8331,2,6,9,10,12,2,10,2,10,0,False,False,False,0,2,2021-11-22T14:50:55.73,12,False,2.0
2021,11,3220,475,13,8418,2,5,5,7,7,0,7,0,7,0,False,False,False,0,2,2021-11-22T15:08:52.183,7,False,0.0
2021,11,3220,510,13,8418,13,5,5,9,0,0,0,0,0,0,False,False,False,0,3,2021-11-22T15:24:24.043,0,False,0.0
2021,11,3220,550,31,792,2,4,9,1,5,4,4,1,4,0,False,False,False,0,1,2021-11-22T15:42:12.39,5,False,1.0
2021,11,3220,555,31,6793,2,2,10,7,11,4,9,2,9,0,False,False,False,0,2,2022-02-17T00:23:19.313,11,False,2.0
2021,11,3220,565,31,792,2,48,4,-4,-1,3,-2,1,-2,0,False,False,False,0,1,2021-11-22T15:47:48.363,-1,False,1.0
2021,11,3220,570,31,7913,2,4,10,14,16,2,15,1,15,0,False,False,False,1,2,2021-11-24T15:52:17.343,16,False,1.0
2021,11,3220,575,31,6793,2,4,3,7,9,2,9,0,9,0,False,False,False,0,2,2022-02-17T20:13:45.44,9,False,0.0
2021,11,3220,580,31,6722,2,4,4,2,5,3,4,1,4,0,False,False,False,0,1,2022-02-17T00:24:08.733,5,False,1.0
2021,11,3220,585,31,8331,13,19,6,30,0,0,0,0,0,0,False,False,False,0,2,2022-02-25T15:48:24.63,0,False,0.0
2021,11,3220,590,31,3911,2,6,9,6,7,1,6,1,6,0,False,False,False,0,3,2021-11-22T16:06:33.463,7,False,1.0
2021,11,3220,595,31,7913,13,5,5,9,0,0,0,0,0,0,False,False,False,0,3,2021-11-24T16:46:53.593,0,False,0.0
2021,11,3220,600,31,6722,2,46,3,0,5,5,3,2,3,0,False,False,False,0,1,2021-11-22T16:12:12.967,5,False,2.0
2021,11,3220,605,31,8331,2,8,1,18,18,0,18,0,18,6,False,False,False,0,3,2022-01-06T17:36:38.013,18,True,0.0
2021,11,3220,625,13,4662,13,5,9,3,0,0,0,0,0,0,False,False,False,0,4,2021-11-24T16:41:47.093,0,False,0.0
2021,11,3220,630,13,2455,13,4,4,3,0,0,0,0,0,0,False,False,False,0,1,2021-11-22T16:22:04.917,0,False,0.0
2021,11,3220,645,31,6722,2,48,9,-4,-2,2,-2,0,-2,0,False,False,False,0,1,2021-11-22T16:27:55.713,-2,False,0.0
2021,11,3220,660,31,6724,2,31,10,4,4,0,4,0,4,0,False,False,False,0,3,2022-01-06T17:53:05.083,4,False,0.0
2021,11,3220,665,31,6724,13,12,5,9,0,0,0,0,0,0,False,False,False,0,3,2021-11-22T16:39:13.287,0,False,0.0
2021,11,3220,675,13,876,13,5,5,7,0,0,0,0,0,0,False,False,False,0,2,2021-11-22T16:43:25.353,0,False,0.0
2021,11,3220,680,13,2407,2,5,5,6,6,0,6,0,6,0,False,False,False,0,3,2021-11-22T16:47:16.59,6,False,0.0
2021,11,3220,695,31,3911,13,4,10,9,0,0,0,0,0,0,False,False,False,0,3,2021-11-22T19:00:11.843,0,False,0.0
2021,11,3220,700,31,6724,2,31,9,2,7,5,6,1,6,0,False,False,False,0,4,2021-11-22T16:55:53.917,7,False,1.0
2021,11,3220,710,31,6722,13,46,10,-2,0,0,0,0,0,0,False,False,False,0,1,2021-11-22T16:59:00.717,0,False,0.0
2021,11,3220,715,31,7913,2,8,1,21,46,25,40,6,40,0,False,False,False,0,2,2021-11-24T16:47:40.41,46,False,6.0
2021,11,3220,720,31,8331,13,7,6,24,0,0,0,0,0,0,False,False,False,0,2,2021-11-24T15:43:25.447,0,False,0.0
2021,11,3220,730,13,2407,13,12,10,10,0,0,0,0,0,0,False,False,False,0,3,2021-11-22T17:15:09.333,0,False,0.0
2021,11,3220,750,31,3911,2,4,10,11,11,0,11,0,11,0,False,False,False,0,3,2022-01-06T18:03:51.97,11,False,0.0
2021,11,3220,755,31,8331,2,2,9,5,5,0,5,0,5,0,False,False,False,0,2,2021-11-22T17:30:04.467,5,False,0.0
2021,11,3220,760,31,7913,2,4,10,5,9,4,6,3,6,0,False,False,False,1,2,2021-11-22T17:32:28.013,9,False,3.0
2021,11,3220,765,31,6722,2,13,4,1,9,8,7,2,7,0,False,False,False,0,1,2021-11-24T15:54:57.02,9,False,2.0
2021,11,3220,770,31,6722,2,46,3,2,4,2,4,0,4,0,False,True,False,0,1,2021-11-22T19:13:05.353,4,False,0.0
2021,11,3220,785,13,100,13,4,5,6,0,0,0,0,0,0,False,False,False,0,2,2021-11-22T17:43:25.69,0,False,0.0
2021,11,3220,810,31,7913,2,30,5,0,4,4,4,0,4,0,False,False,False,0,3,2021-11-22T17:52:44.293,4,False,0.0
2021,11,3220,815,31,7913,2,6,9,8,8,0,8,0,8,0,True,False,False,0,2,2021-11-24T16:48:16.817,8,False,0.0
2021,11,3220,825,31,7916,13,17,10,14,0,0,0,0,0,0,False,False,False,0,3,2022-02-17T20:15:52.043,0,False,0.0
2021,11,3220,830,31,8331,13,4,9,14,0,0,0,0,0,0,False,False,False,0,2,2021-11-22T19:19:44.413,0,False,0.0
2021,11,3220,880,31,7913,2,3,5,14,14,0,14,0,14,0,False,False,False,0,2,2021-11-22T18:13:47.677,14,False,0.0
2021,11,3220,890,31,6724,2,39,4,6,7,1,6,1,6,0,False,False,False,0,3,2021-11-22T18:29:53.203,7,False,1.0
2021,11,3220,895,31,6724,13,5,2,17,0,0,0,0,0,0,False,False,False,0,3,2021-11-24T15:43:42.167,0,False,0.0
2021,11,3221,10,12,556,2,13,4,4,37,33,31,6,31,0,False,False,False,1,3,2021-11-22T15:09:39.93,37,False,6.0
2021,11,3221,15,12,6357,13,2,9,8,0,0,0,0,0,0,False,False,False,0,3,2021-11-22T10:14:57.99,0,False,0.0
2021,11,3221,20,12,7742,2,51,10,-5,2,7,1,1,1,0,False,False,False,0,1,2021-11-24T13:48:46.97,2,False,1.0
2021,11,3221,25,12,6357,13,19,2,33,0,0,0,0,0,0,False,False,False,0,2,2021-11-22T10:18:05.257,0,False,0.0
2021,11,3221,45,18,7711,2,51,3,-3,5,8,5,0,5,0,False,False,False,0,3,2022-02-17T21:02:39.06,5,False,0.0
2021,11,3221,50,18,7711,2,35,8,16,43,27,42,1,42,0,False,False,False,0,2,2021-11-22T10:25:19.197,43,False,1.0
2021,11,3221,85,12,6357,13,19,2,36,0,0,0,0,0,0,False,False,False,0,3,2021-11-24T17:02:25.96,0,False,
2021,11,3221,90,12,7742,2,44,3,-4,4,8,3,1,3,0,False,False,False,0,1,2021-11-24T16:32:18.167,4,False,1.0
2021,11,3221,95,12,7742,2,47,5,4,13,9,6,7,6,0,False,False,False,1,1,2021-11-24T13:48:46.97,13,False,7.0
2021,11,3221,105,12,556,13,35,5,13,0,0,0,0,0,0,False,False,False,0,3,2022-02-16T23:15:18.877,0,False,0.0
2021,11,3221,115,12,8044,2,32,3,0,3,3,1,2,1,0,False,False,False,0,4,2021-11-24T16:32:51.737,3,False,
2021,11,3221,130,18,4572,2,4,4,2,3,1,3,0,3,0,False,False,False,0,1,2021-11-22T10:48:59.983,3,False,0.0
2021,11,3221,140,18,1381,2,7,6,18,18,0,18,0,18,0,False,False,False,0,2,2021-11-22T10:52:10.83,18,True,0.0
2021,11,3221,150,18,7711,2,7,2,42,56,14,51,5,51,0,False,False,False,0,3,2021-11-24T16:45:51.127,56,False,5.0
2021,11,3221,175,12,7742,2,44,3,-5,3,8,2,1,2,0,False,False,False,0,1,2021-11-22T15:33:36.75,3,False,1.0
2021,11,3221,180,12,6357,2,5,5,4,5,1,4,1,4,0,False,False,False,0,3,2021-11-22T15:33:47.417,5,False,1.0
2021,11,3221,195,12,6357,13,35,2,32,0,0,0,0,0,0,False,False,False,0,3,2021-11-24T13:48:46.987,0,False,0.0
2021,11,3221,205,12,6357,2,7,6,34,39,5,37,2,37,0,False,False,False,0,3,2021-11-24T17:02:01.723,39,False,2.0
2021,11,3221,215,12,556,2,5,5,7,8,1,8,0,8,0,False,False,False,0,2,2021-11-22T11:17:56.78,8,False,0.0
2021,11,3221,225,12,6357,13,26,5,1,0,0,0,0,0,0,False,False,False,0,2,2021-11-24T16:21:33.84,0,False,0.0
2021,11,3221,230,12,6357,13,12,5,3,0,0,0,0,0,0,False,False,False,0,2,2021-11-24T16:47:17.98,0,False,0.0
2021,11,3221,240,18,6361,2,39,4,6,15,9,13,2,13,0,False,False,False,0,3,2021-11-23T23:02:26.687,15,False,2.0
2021,11,3221,250,18,7711,13,8,8,39,0,0,0,0,0,0,False,False,False,0,2,2021-11-22T15:12:32.597,0,False,
2021,11,3221,265,18,7711,13,8,9,13,0,0,0,0,0,0,False,False,False,0,3,2021-11-24T16:31:00.45,0,False,
2021,11,3221,280,18,1381,2,5,3,5,10,5,9,1,9,6,True,False,False,0,3,2021-11-24T16:48:48.14,10,False,1.0
2021,11,3221,305,12,556,13,13,5,-2,0,0,0,0,0,0,False,False,False,0,3,2021-11-24T17:02:52.68,0,False,0.0
2021,11,3221,320,18,1381,2,4,5,3,5,2,3,2,3,0,True,False,False,0,2,2021-11-23T23:05:28.733,5,False,2.0
2021,11,3221,340,12,6356,2,2,4,8,17,9,12,5,12,0,False,False,False,1,2,2021-11-24T16:33:48.32,17,False,5.0
2021,11,3221,345,12,556,2,4,4,4,4,0,4,0,4,0,False,False,False,0,3,2021-11-24T13:48:46.987,4,False,
2021,11,3221,350,12,6357,13,21,5,10,0,0,0,0,0,0,False,False,False,0,2,2021-11-24T13:48:46.987,0,False,0.0
2021,11,3221,355,12,7743,2,4,10,5,12,7,10,2,10,0,True,False,False,0,4,2021-11-23T19:43:35.407,12,False,2.0
2021,11,3221,360,12,496,2,2,4,13,15,2,15,0,15,0,False,False,False,0,3,2021-11-24T16:50:19.787,15,False,0.0
2021,11,3221,375,12,8279,2,47,5,4,8,4,8,0,8,0,False,False,False,0,4,2021-11-22T15:54:06.413,8,False,0.0
2021,11,3221,390,12,7743,2,12,7,25,25,0,25,0,25,6,False,False,False,0,3,2021-11-22T14:42:26.573,25,True,0.0
2021,11,3221,405,18,7712,13,7,6,22,0,0,0,0,0,0,False,False,False,0,3,2021-11-23T23:03:29.367,0,False,0.0
2021,11,3221,410,18,4940,2,4,9,6,7,1,6,1,6,0,False,False,False,0,2,2021-11-23T23:08:09.74,7,False,1.0
2021,11,3221,420,18,4940,13,46,3,3,0,0,0,0,0,0,False,False,False,0,3,2021-11-23T23:03:44.387,0,False,0.0
2021,11,3221,445,18,6361,2,6,7,15,15,0,15,0,15,0,False,False,False,0,4,2021-11-22T12:35:06.157,15,False,0.0
2021,11,3221,465,18,1381,2,51,9,-3,6,9,6,0,6,0,True,False,False,0,3,2021-11-23T23:04:04.457,6,True,0.0
2021,11,3221,475,18,7712,13,21,2,25,0,0,0,0,0,0,False,False,False,0,2,2021-11-24T16:51:52.317,0,False,0.0
2021,11,3221,485,18,4572,2,47,5,-1,7,8,7,0,7,0,False,False,False,0,1,2021-11-22T15:34:37.477,7,False,0.0
2021,11,3221,510,18,6900,13,45,5,-2,0,0,0,0,0,0,False,False,False,0,1,2021-11-24T16:23:25.803,0,False,0.0
2021,11,3221,515,18,7711,2,16,10,7,9,2,9,0,9,6,False,False,False,0,1,2021-11-24T19:19:39.347,9,True,0.0
2021,11,3221,535,12,7742,2,4,10,0,13,13,10,3,10,0,False,False,False,0,1,2021-11-22T14:46:30.97,13,False,3.0
2021,11,3221,540,12,556,2,4,5,9,12,3,10,2,10,0,False,False,False,0,2,2021-11-24T16:52:31.797,12,False,2.0
2021,11,3221,545,12,556,2,30,9,-1,17,18,17,0,17,0,False,False,False,0,3,2021-11-24T16:52:52.063,17,True,0.0
2021,11,3221,565,12,556,2,12,10,10,10,0,10,0,10,6,False,False,False,0,3,2021-11-24T19:20:03.29,10,True,0.0
2021,11,3221,580,18,1381,13,19,1,48,0,0,0,0,0,0,False,False,False,0,3,2021-11-24T17:03:27.36,0,False,0.0
2021,11,3221,585,18,7711,2,8,7,17,21,4,18,3,18,0,False,False,False,0,3,2021-11-24T13:48:47.017,21,False,3.0
2021,11,3221,600,18,6361,2,30,10,-2,5,7,2,3,2,0,True,False,False,0,4,2021-11-23T23:05:37.64,5,False,3.0
2021,11,3221,605,18,1381,13,23,1,29,0,0,0,0,0,0,False,False,False,0,3,2021-11-24T17:03:40.15,0,False,0.0
2021,11,3221,645,12,7742,2,44,3,-7,9,16,6,3,6,0,False,False,False,1,1,2021-11-23T19:40:22.183,9,False,3.0
2021,11,3221,650,12,556,2,6,4,13,13,0,13,0,13,0,False,False,False,0,3,2021-11-24T16:56:58.903,13,False,0.0
2021,11,3221,655,12,6356,2,28,10,-1,26,27,17,9,17,0,False,False,False,2,4,2021-11-24T19:20:31.783,26,False,9.0
2021,11,3221,665,12,6357,2,44,3,-5,4,9,3,1,3,0,True,False,False,0,3,2021-11-22T13:36:06.877,4,False,1.0
2021,11,3221,680,12,496,13,44,9,-4,0,0,0,0,0,0,True,False,False,0,3,2022-02-16T23:18:15.997,0,False,0.0
2021,11,3221,685,12,556,2,21,6,18,18,0,18,0,18,6,False,False,False,0,3,2021-11-24T16:27:42.647,18,True,0.0
2021,11,3221,700,18,4572,3,48,9,-3,0,0,0,0,0,0,False,False,False,0,1,2021-11-22T13:46:08.263,0,False,0.0
2021,11,3221,705,18,7712,2,7,2,19,19,0,19,0,19,0,False,False,False,0,3,2021-11-22T13:47:29.813,19,False,0.0
2021,11,3221,715,18,7711,2,4,9,6,6,0,6,0,6,0,False,False,False,0,3,2021-11-24T16:58:20.26,6,False,0.0
2021,11,3221,730,18,1381,2,50,9,0,7,7,6,1,6,0,False,False,False,0,2,2022-02-16T23:18:59.127,7,False,1.0
2021,11,3221,735,18,7712,13,24,2,28,0,0,0,0,0,0,False,False,False,0,3,2021-11-24T13:48:47.017,0,False,0.0
2021,11,3221,740,18,1381,2,4,3,3,7,4,3,4,3,0,False,False,False,1,3,2021-11-24T16:59:01.85,7,False,4.0
2021,11,3221,745,18,1381,2,6,10,3,3,0,3,0,3,0,False,False,False,0,2,2021-11-24T13:48:47.017,3,False,0.0
2021,11,3221,755,18,7711,13,2,4,4,0,0,0,0,0,0,False,False,False,0,2,2021-11-24T16:28:59.887,0,False,0.0
2021,11,3221,760,18,7711,2,9,2,18,23,5,22,1,22,6,False,False,False,0,3,2021-11-24T16:59:25.78,23,False,1.0
2021,11,3221,775,12,6357,2,8,7,28,75,47,75,0,75,6,False,False,False,0,3,2021-11-22T14:17:58.88,75,True,0.0
2021,11,3221,795,18,7711,13,7,2,32,0,0,0,0,0,0,False,False,False,0,2,2021-12-03T22:48:27.48,0,False,0.0
2021,11,3221,800,18,7711,2,4,9,6,6,0,6,0,6,0,False,False,False,0,3,2021-11-22T14:23:36.093,6,False,0.0
2021,11,3221,810,18,4572,2,46,3,-1,19,20,5,14,5,0,False,False,False,1,1,2021-11-24T16:30:45.483,19,False,14.0
2021,11,3221,815,18,1381,2,4,3,11,26,15,11,15,11,0,False,False,False,0,2,2021-11-24T16:36:57.807,26,False,15.0
2021,11,3222,25,3,121,2,4,5,5,11,6,10,1,10,0,False,False,False,0,2,2021-11-22T18:50:09.78,11,False,1.0
2021,11,3222,35,3,5017,13,54,9,0,0,0,0,0,0,0,True,False,False,0,4,2021-11-22T18:50:24.173,0,False,0.0
2021,11,3222,60,6,4305,2,5,3,5,6,1,6,0,6,0,False,False,False,0,3,2021-11-22T10:42:15.687,6,True,0.0
2021,11,3222,70,6,7725,2,11,2,26,29,3,29,0,29,0,True,False,False,0,2,2021-11-24T18:20:37.127,29,True,0.0
2021,11,3222,110,3,713,2,44,3,-3,1,4,0,1,0,0,False,False,False,0,1,2021-11-22T18:50:43.6,1,False,1.0
2021,11,3222,120,3,6454,2,7,3,13,16,3,16,0,16,0,False,False,False,0,3,2021-11-22T18:50:56.707,16,False,0.0
2021,11,3222,155,6,7725,13,35,2,22,0,0,0,0,0,0,False,False,False,0,3,2021-11-22T11:26:37.057,0,False,0.0
2021,11,3222,160,6,1378,13,4,3,12,0,0,0,0,0,0,False,False,False,0,2,2021-11-22T11:28:21.08,0,False,0.0
2021,11,3222,190,3,713,2,45,5,-3,5,8,5,0,5,0,True,False,False,0,1,2021-11-22T18:51:13.833,5,True,0.0
2021,11,3222,195,3,6454,2,46,3,1,9,8,7,2,7,0,True,False,False,0,3,2021-11-24T18:49:45.747,9,False,2.0
2021,11,3222,215,3,6454,2,47,5,1,8,7,3,5,3,0,True,False,False,0,4,2021-11-24T18:25:34.72,8,False,5.0
2021,11,3222,245,6,1378,2,6,1,21,22,1,21,1,21,0,False,False,False,0,3,2021-11-24T00:10:21.057,22,False,1.0
2021,11,3222,270,3,7672,2,45,5,-3,-2,1,-2,0,-2,0,True,False,False,0,3,2021-11-22T18:52:12.02,-2,False,0.0
2021,11,3222,285,3,6454,2,6,9,11,11,0,11,0,11,0,False,True,True,0,3,2021-11-22T18:52:35.397,11,False,0.0
2021,11,3222,290,3,6454,2,4,4,11,11,0,11,0,11,0,False,False,False,0,3,2021-11-22T18:52:48.117,11,False,0.0
2021,11,3222,295,3,8430,2,5,3,2,2,0,2,0,2,0,False,False,False,0,3,2021-11-23T23:48:27.397,2,False,0.0
2021,11,3222,300,3,306,2,4,4,2,3,1,3,0,3,0,False,False,False,0,1,2021-12-04T19:48:52.923,3,False,0.0
2021,11,3222,335,6,1378,13,2,9,5,0,0,0,0,0,0,False,False,False,0,2,2021-11-22T12:54:46.543,0,False,0.0
2021,11,3222,350,6,7725,13,4,3,11,0,0,0,0,0,0,False,False,False,0,2,2021-11-22T13:03:14.813,0,False,0.0
2021,11,3222,355,6,7725,13,2,4,11,0,0,0,0,0,0,False,False,False,0,3,2021-11-22T13:13:47.587,0,False,0.0
2021,11,3222,365,3,121,13,6,9,5,0,0,0,0,0,0,False,False,False,0,2,2021-11-22T18:53:32.78,0,False,0.0
2021,11,3222,370,3,8430,2,2,10,0,12,12,6,6,6,0,False,False,False,1,2,2021-11-24T16:31:27.047,12,False,6.0
2021,11,3222,380,3,7672,13,4,5,8,0,0,0,0,0,0,False,False,False,0,2,2021-11-22T18:53:56.4,0,False,0.0
2021,11,3222,385,3,8430,13,7,2,19,0,0,0,0,0,0,False,False,False,0,3,2021-11-24T16:31:27.047,0,False,0.0
2021,11,3222,390,3,7672,2,51,3,3,9,6,9,0,9,0,False,False,False,0,3,2021-11-22T18:54:19.06,9,False,0.0
2021,11,3222,400,3,8430,2,4,5,6,15,9,14,1,14,0,False,False,False,0,2,2021-11-22T18:54:42.183,15,False,1.0
2021,11,3222,405,3,6454,2,13,9,3,2,-1,2,0,2,0,False,False,False,0,4,2021-11-22T19:15:02.66,2,False,0.0
2021,11,3222,415,3,713,2,47,5,0,9,9,7,2,7,0,False,False,False,0,1,2021-11-22T18:55:07.603,9,False,2.0
2021,11,3222,425,3,6454,13,2,10,7,0,0,0,0,0,0,False,False,False,0,3,2021-11-22T18:55:20.713,0,True,0.0
2021,11,3222,470,6,7725,2,5,2,20,22,2,22,0,22,0,False,False,False,0,3,2021-12-04T19:49:21.503,22,False,0.0
2021,11,3222,480,6,7728,13,2,9,10,0,0,0,0,0,0,False,False,False,0,4,2021-11-22T14:03:37.38,0,False,0.0
2021,11,3222,500,3,121,2,4,10,4,8,4,5,3,5,0,False,False,False,0,2,2021-11-22T18:55:38.173,8,False,3.0
2021,11,3222,515,3,8430,13,4,5,7,0,0,0,0,0,0,False,False,False,0,2,2021-11-22T18:55:52.42,0,False,0.0
2021,11,3222,520,3,8430,13,19,2,22,0,0,0,0,0,0,False,False,False,0,2,2021-11-22T18:56:04.14,0,False,
2021,11,3222,525,3,306,2,32,3,-3,-2,1,-2,0,-2,0,False,False,False,0,1,2021-11-24T16:31:27.047,-2,False,0.0
2021,11,3222,530,3,7672,13,12,10,8,0,0,0,0,0,0,False,False,False,0,2,2021-11-24T00:11:36.153,0,False,0.0
2021,11,3222,535,3,8430,13,12,5,12,0,0,0,0,0,0,False,False,False,0,2,2021-11-24T18:44:07.547,0,False,0.0
2021,11,3222,550,6,666,2,5,3,8,23,15,17,6,17,0,False,False,False,0,4,2021-11-22T14:49:22.717,23,False,6.0
2021,11,3222,555,6,7725,2,51,10,-2,60,62,16,44,16,6,False,False,False,1,3,2021-11-24T17:39:02.443,60,False,44.0
2021,11,3222,575,3,713,2,4,9,3,3,0,3,0,3,0,False,False,False,0,1,2021-11-24T16:31:27.047,3,False,0.0
2021,11,3222,585,3,2976,13,32,9,0,0,0,0,0,0,0,False,False,False,0,4,2021-11-22T18:57:10.047,0,False,0.0
2021,11,3222,600,6,666,13,47,5,1,0,0,0,0,0,0,False,False,False,0,3,2021-11-22T15:09:33.76,0,False,0.0
2021,11,3222,610,6,7725,13,35,8,17,0,0,0,0,0,0,False,False,False,0,3,2021-11-22T18:44:02.953,0,False,0.0
2021,11,3222,620,6,1378,2,4,10,10,10,0,10,0,10,0,False,False,False,0,3,2021-11-22T15:16:35.54,10,False,0.0
2021,11,3222,625,6,1378,13,19,5,10,0,0,0,0,0,0,False,False,False,0,2,2021-11-22T15:20:37.96,0,False,0.0
2021,11,3222,640,3,6454,2,5,5,5,5,0,5,0,5,0,False,False,False,0,3,2021-11-22T18:57:26.733,5,False,
2021,11,3222,645,3,7672,2,4,9,4,9,5,7,2,7,0,False,False,False,0,3,2021-11-22T18:57:39.21,9,False,2.0
2021,11,3222,650,3,6454,2,5,5,3,4,1,4,0,4,0,False,False,False,0,3,2021-11-22T18:57:51.39,4,False,0.0
2021,11,3222,670,3,6454,13,4,10,12,0,0,0,0,0,0,False,False,False,0,3,2021-11-23T23:48:59.177,0,False,
2021,11,3222,700,6,666,2,12,10,-5,2,7,-3,5,-3,0,False,False,False,1,3,2021-11-24T00:11:45.923,2,False,5.0
2021,11,3222,715,6,7725,13,19,2,37,0,0,0,0,0,0,False,False,False,0,2,2021-11-22T19:13:00.48,0,False,0.0
2021,11,3222,740,3,6454,2,51,5,-3,12,15,7,5,7,0,False,False,False,0,2,2021-11-22T18:58:35.623,12,False,5.0
2021,11,3222,760,3,6454,13,5,5,8,0,0,0,0,0,0,False,False,False,0,2,2021-11-24T17:28:34.977,0,False,0.0
2021,11,3222,775,6,3233,2,2,9,3,3,0,3,0,3,0,False,False,False,0,2,2021-11-23T20:57:27.36,3,False,0.0
2021,11,3222,780,6,7725,13,7,2,19,0,0,0,0,0,0,False,False,False,0,3,2021-11-22T16:45:35.057,0,False,0.0
2021,11,3222,790,3,713,2,45,5,1,7,6,6,1,6,0,True,False,False,0,1,2021-11-22T16:55:42.423,7,False,1.0
2021,11,3222,830,6,7725,13,4,10,10,0,0,0,0,0,0,False,False,False,0,3,2021-11-22T17:14:55.417,0,False,0.0
2021,11,3222,835,6,7728,2,6,4,8,12,4,8,4,8,0,False,False,False,0,3,2021-11-22T17:18:07.273,12,False,4.0
2021,11,3222,840,6,7725,13,4,3,11,0,0,0,0,0,0,False,False,False,0,2,2021-11-22T17:19:28.7,0,False,0.0
2021,11,3222,845,6,1378,13,4,10,5,0,0,0,0,0,0,False,False,False,0,3,2021-11-22T17:21:14.157,0,False,0.0
2021,11,3222,850,6,6786,2,32,5,0,9,9,7,2,7,0,False,False,False,1,1,2021-11-24T17:25:45.14,9,False,2.0
2021,11,3222,860,6,7725,2,5,3,2,6,4,6,0,6,0,False,False,False,0,3,2021-11-22T17:30:54.12,6,False,0.0
2021,11,3222,865,6,7725,2,47,5,3,4,1,3,1,3,0,True,False,False,0,3,2021-11-22T17:32:10.573,4,False,1.0
2021,11,3222,875,6,3233,13,35,8,36,0,0,0,0,0,0,False,False,False,0,3,2021-11-22T17:34:27.743,0,False,0.0
2021,11,3222,880,6,7725,13,5,5,7,0,0,0,0,0,0,False,False,False,0,3,2021-11-22T19:14:30.81,0,False,0.0
2021,11,3222,895,6,1378,2,19,8,34,49,15,49,0,49,6,False,False,False,0,2,2021-11-22T18:39:45.687,49,True,0.0
2021,11,3222,915,3,8430,13,19,8,24,0,0,0,0,0,0,False,False,False,0,3,2021-11-22T18:59:49.613,0,False,
2021,11,3222,920,3,7672,2,9,2,16,21,5,21,0,21,0,False,False,False,0,3,2021-11-24T16:31:27.047,21,True,0.0
2021,11,3222,930,3,713,2,47,5,-2,6,8,0,6,0,0,False,False,False,1,1,2021-11-22T19:00:18.333,6,False,6.0
2021,11,3222,935,3,7672,13,47,5,2,0,0,0,0,0,0,False,False,False,0,3,2021-11-22T19:00:29.71,0,False,
2021,11,3222,940,3,121,2,19,2,27,29,2,27,2,27,0,False,False,False,0,3,2021-11-22T19:00:42.923,29,False,2.0
2021,11,3222,965,6,7725,13,5,2,19,0,0,0,0,0,0,False,False,False,0,2,2021-11-22T18:30:05.797,0,False,0.0
2021,11,3222,970,6,1378,13,13,4,5,0,0,0,0,0,0,False,False,False,0,2,2022-02-17T21:33:55.373,0,False,0.0
2021,11,3222,980,6,1378,2,12,2,23,23,0,23,0,23,0,False,False,False,0,2,2021-11-22T18:36:22.93,23,True,0.0
2021,11,3223,10,7,6975,2,53,10,-4,3,7,3,0,3,0,False,False,False,0,4,2021-11-22T13:45:07.997,3,False,0.0
2021,11,3223,30,7,2631,13,39,4,6,0,0,0,0,0,0,False,False,False,0,4,2021-11-22T13:51:48.473,0,False,0.0
2021,11,3223,45,23,2994,2,51,9,-2,-2,0,-2,0,-2,0,False,False,False,0,3,2021-11-22T13:58:18.083,-2,False,0.0
2021,11,3223,50,23,7241,13,32,3,-3,0,0,0,0,0,0,False,False,False,0,1,2021-11-22T13:59:43.27,0,False,0.0
2021,11,3223,70,7,3521,13,12,2,16,0,0,0,0,0,0,False,False,False,0,3,2021-11-24T14:27:00.147,0,False,0.0
2021,11,3223,95,7,7659,13,5,5,9,0,0,0,0,0,0,False,False,False,0,2,2021-11-22T14:09:37.987,0,False,0.0
2021,11,3223,110,23,2994,2,5,5,5,25,20,24,1,24,0,False,False,False,0,3,2021-11-22T14:15:31.347,25,False,1.0
2021,11,3223,135,23,4307,3,51,10,-6,0,0,0,0,0,0,False,False,False,0,1,2021-11-22T14:22:04.117,0,False,0.0
2021,11,3223,150,7,4455,2,4,10,2,6,4,4,2,4,0,False,False,False,0,1,2021-11-22T14:25:17.8,6,False,2.0
2021,11,3223,155,7,4455,2,47,5,0,3,3,2,1,2,0,False,False,False,0,1,2021-11-22T14:26:41.767,3,False,1.0
2021,11,3223,160,7,2631,2,53,4,0,2,2,2,0,2,0,False,False,False,0,4,2021-11-22T14:28:19.827,2,False,0.0
2021,11,3223,165,7,3521,2,4,9,4,7,3,7,0,7,0,False,False,False,0,3,2021-11-22T14:30:02.673,7,False,0.0
2021,11,3223,185,23,4307,2,4,4,3,6,3,5,1,5,0,False,False,False,0,1,2021-11-22T14:34:00.343,6,False,1.0
2021,11,3223,195,23,2994,2,5,5,6,8,2,6,2,6,0,False,False,False,0,3,2021-11-22T14:36:38.117,8,False,2.0
2021,11,3223,205,23,7241,2,44,9,-4,6,10,4,2,4,0,False,False,False,0,1,2021-11-22T14:40:15.657,6,False,2.0
2021,11,3223,235,7,3521,2,6,10,5,14,9,9,5,9,0,False,False,False,0,3,2021-11-22T14:46:39.79,14,False,5.0
2021,11,3223,245,7,8317,2,2,9,5,9,4,8,1,8,0,False,False,False,0,2,2021-11-22T14:49:48.623,9,False,1.0
2021,11,3223,265,7,3521,2,4,9,9,14,5,9,5,9,0,False,False,False,0,3,2021-11-24T14:35:32.817,14,False,5.0
2021,11,3223,280,7,8317,13,19,2,24,0,0,0,0,0,0,False,False,False,0,2,2021-11-22T15:02:02.107,0,False,0.0
2021,11,3223,285,7,3521,2,6,4,5,3,-2,2,1,2,0,False,False,False,0,3,2021-11-22T15:03:47.797,3,False,1.0
2021,11,3223,305,23,2994,2,8,9,11,21,10,17,4,17,0,False,False,False,0,3,2021-11-22T15:10:45.833,21,False,4.0
2021,11,3223,315,23,7246,13,24,10,12,0,0,0,0,0,0,False,False,False,0,4,2021-11-22T15:13:37.047,0,False,0.0
2021,11,3223,340,7,8325,2,16,9,3,7,4,7,0,7,0,False,False,False,0,1,2021-11-22T15:18:11.897,7,False,0.0
2021,11,3223,345,7,7659,2,2,10,1,6,5,3,3,3,0,False,False,False,0,3,2021-11-22T15:20:06.587,6,False,3.0
2021,11,3223,350,7,3521,2,6,9,5,4,-1,4,0,4,0,False,False,False,0,3,2021-11-22T15:21:47.223,4,False,0.0
2021,11,3223,360,7,8317,13,19,2,34,0,0,0,0,0,0,False,False,False,0,2,2021-11-24T14:13:15.53,0,False,0.0
2021,11,3223,385,23,7250,2,13,10,3,4,1,3,1,3,0,False,False,False,0,3,2021-11-22T15:30:34.247,4,False,1.0
2021,11,3223,390,23,7241,2,32,10,-3,1,4,0,1,0,0,False,False,False,0,1,2021-11-24T14:14:47.55,1,False,1.0
2021,11,3223,405,23,7250,2,30,10,1,9,8,7,2,7,0,False,False,False,1,3,2022-02-16T23:26:20.473,9,False,2.0
2021,11,3223,435,7,8317,2,6,9,12,17,5,12,5,12,0,False,False,False,2,3,2021-11-24T14:14:14.783,17,False,5.0
2021,11,3223,450,7,3521,2,49,10,1,7,6,4,3,4,0,False,False,False,0,3,2021-11-22T15:55:44.417,7,False,3.0
2021,11,3223,460,7,7659,13,7,2,22,0,0,0,0,0,0,False,False,False,0,2,2021-11-22T16:00:09.28,0,False,
2021,11,3223,470,7,6971,2,45,5,-9,3,12,2,1,2,0,False,False,False,0,3,2021-11-22T16:04:51.153,3,False,1.0
2021,11,3223,500,23,7241,2,28,9,-3,2,5,-2,4,-2,0,False,False,False,1,1,2021-11-24T14:27:31.75,2,False,4.0
2021,11,3223,510,23,4949,13,19,2,53,0,0,0,0,0,0,False,False,False,0,2,2021-11-24T14:28:38.467,0,False,0.0
2021,11,3223,535,7,2631,2,4,3,4,7,3,6,1,6,0,False,False,False,0,2,2021-11-22T16:27:19.297,7,False,1.0
2021,11,3223,555,7,6975,13,39,4,6,0,0,0,0,0,0,False,False,False,0,3,2021-11-22T16:31:54.447,0,False,0.0
2021,11,3223,565,7,4455,2,48,9,-4,9,13,7,2,7,0,False,False,False,0,1,2021-11-22T16:37:17.053,9,False,2.0
2021,11,3223,580,23,2994,2,4,7,15,25,10,20,5,20,0,False,False,False,0,4,2022-02-16T23:26:45.81,25,False,5.0
2021,11,3223,585,23,2994,2,17,1,25,31,6,30,1,30,0,False,False,False,0,3,2021-11-22T16:43:45.237,31,False,1.0
2021,11,3223,590,23,7246,2,9,2,19,19,0,19,0,19,6,False,False,False,0,2,2021-11-22T16:44:51.917,19,True,0.0
2021,11,3223,605,7,7659,2,4,5,5,9,4,7,2,7,0,False,False,False,0,2,2021-11-22T16:47:34.407,9,False,2.0
2021,11,3223,615,7,8317,13,21,2,40,0,0,0,0,0,0,False,False,False,0,2,2022-02-16T23:27:35.953,0,False,0.0
2021,11,3223,620,7,3445,2,6,9,9,12,3,10,2,10,0,False,False,False,0,2,2021-11-22T16:51:30.583,12,False,2.0
2021,11,3223,655,7,3521,13,13,10,5,0,0,0,0,0,0,False,False,False,0,3,2021-11-22T17:06:28.597,0,False,0.0
2021,11,3223,665,7,8317,2,7,3,6,6,0,6,0,6,6,False,False,False,0,3,2021-11-22T17:09:27.847,6,True,0.0
2021,11,3223,680,23,7241,2,5,3,6,7,1,7,0,7,0,False,False,False,0,1,2021-11-24T14:24:06.44,7,True,0.0
2021,11,3223,685,23,2994,13,5,6,17,0,0,0,0,0,0,False,False,False,0,4,2021-11-22T17:18:23.297,0,False,0.0
2021,11,3223,710,23,2994,2,5,10,5,8,3,6,2,6,0,False,False,False,0,3,2021-11-22T17:27:00.21,8,False,2.0
2021,11,3223,715,23,4949,2,8,8,17,20,3,20,0,20,0,False,False,False,0,2,2021-11-22T17:55:08.37,20,False,0.0
2021,11,3223,730,23,7250,2,12,9,5,9,4,6,3,6,0,False,False,False,0,3,2021-11-22T17:32:16.143,9,False,3.0
2021,11,3223,735,23,7241,2,4,10,4,8,4,7,1,7,0,False,False,False,0,1,2021-11-22T17:33:18.63,8,False,1.0
2021,11,3223,740,23,7241,3,5,5,5,0,0,0,0,0,0,False,False,False,0,1,2021-11-22T17:34:28.943,0,False,0.0
2021,11,3223,750,23,7250,2,4,9,5,8,3,8,0,8,0,False,False,False,0,3,2021-11-22T17:37:21.177,8,False,0.0
2021,11,3224,15,27,650,2,5,5,5,6,1,6,0,6,0,False,False,False,0,3,2022-02-17T00:03:58.113,6,False,0.0
2021,11,3224,40,1,8439,2,4,9,4,4,0,4,0,4,0,True,False,False,0,3,2021-11-22T10:30:40.57,4,False,0.0
2021,11,3224,45,1,8439,2,42,9,4,8,4,5,3,5,0,False,False,False,1,3,2021-11-22T10:33:20.007,8,False,3.0
2021,11,3224,50,1,4587,2,48,9,-3,17,20,13,4,13,0,False,False,False,0,1,2021-11-22T16:06:44.29,17,False,4.0
2021,11,3224,65,1,7762,2,4,9,4,5,1,4,1,4,0,True,False,False,0,3,2021-11-22T10:43:50.737,5,False,1.0
2021,11,3224,75,1,6933,2,4,9,4,7,3,5,2,5,0,False,False,False,0,2,2021-11-22T10:49:09.057,7,False,2.0
2021,11,3224,80,1,8439,2,31,4,3,11,8,6,5,6,0,False,False,False,1,3,2021-11-24T18:14:38.43,11,False,5.0
2021,11,3224,100,1,894,3,13,4,2,0,0,0,0,0,0,False,False,False,0,3,2021-11-22T15:58:23.023,0,False,0.0
2021,11,3224,105,1,910,13,9,2,15,0,0,0,0,0,0,False,False,False,0,2,2021-11-22T15:58:36.993,0,False,
2021,11,3224,115,1,894,2,55,4,-2,1,3,1,0,1,6,False,False,False,0,4,2021-11-22T11:05:51.323,1,True,0.0
2021,11,3224,150,27,4850,2,51,3,-5,9,14,4,5,4,0,True,False,False,0,4,2021-11-22T11:17:25.52,9,False,5.0
2021,11,3224,190,1,8439,2,44,3,-5,-5,0,-5,0,-5,0,True,False,False,0,3,2021-11-22T11:36:44.303,-5,False,0.0
2021,11,3224,215,27,650,2,35,6,19,25,6,25,0,25,0,False,False,False,0,3,2021-11-22T11:43:58.453,25,True,0.0
2021,11,3224,225,27,7408,13,9,3,9,0,0,0,0,0,0,False,False,False,0,2,2021-11-22T11:48:55.2,0,False,0.0
2021,11,3224,230,27,7852,13,26,10,6,0,0,0,0,0,0,True,False,False,0,3,2021-11-22T16:19:09.607,0,False,0.0
2021,11,3224,250,1,5032,3,53,9,-3,0,0,0,0,0,0,False,False,False,0,4,2021-11-22T15:59:02.693,0,False,0.0
2021,11,3224,255,1,910,2,9,2,27,31,4,31,0,31,0,False,False,False,0,2,2021-11-22T12:12:10.013,31,False,0.0
2021,11,3224,260,1,8439,2,34,4,-4,7,11,7,0,7,0,True,False,False,0,3,2021-11-22T12:11:28.967,7,True,0.0
2021,11,3224,280,1,4587,2,48,9,-1,1,2,1,0,1,0,False,False,False,0,1,2021-11-22T12:25:01.27,1,False,0.0
2021,11,3224,285,1,4587,2,16,9,3,12,9,9,3,9,0,False,False,False,0,1,2021-11-22T12:27:10.143,12,False,3.0
2021,11,3224,300,1,894,2,17,10,13,25,12,18,7,18,0,False,False,False,0,4,2021-11-22T12:30:55.707,25,False,7.0
2021,11,3224,320,1,894,2,16,10,2,2,0,2,0,2,6,False,False,False,0,4,2021-11-22T16:04:14.843,2,True,0.0
2021,11,3224,335,27,7408,13,4,9,5,0,0,0,0,0,0,False,False,False,0,2,2021-11-22T12:45:25.517,0,False,0.0
2021,11,3224,340,27,7408,2,4,3,9,14,5,11,3,11,0,False,False,False,0,2,2021-11-22T12:44:54.447,14,False,3.0
2021,11,3224,345,27,650,2,12,2,30,36,6,36,0,36,0,False,False,False,0,2,2021-11-22T16:15:39.84,36,False,0.0
2021,11,3224,350,27,7408,2,5,5,6,4,-2,5,-1,5,0,False,False,False,0,3,2021-11-22T12:52:04.67,4,False,-1.0
2021,11,3224,355,27,4850,13,7,10,9,0,0,0,0,0,0,False,False,False,0,4,2021-11-22T12:53:42.727,0,False,0.0
2021,11,3224,375,1,894,2,4,4,4,10,6,7,3,7,0,False,False,False,0,3,2021-11-22T12:58:42.707,10,False,3.0
2021,11,3224,385,1,6933,2,4,3,6,20,14,6,14,6,0,False,False,False,1,2,2021-11-22T13:03:04.51,20,False,14.0
2021,11,3224,390,1,6405,3,4,10,3,0,0,0,0,0,0,False,False,False,0,3,2021-11-22T15:59:35.853,0,False,0.0
2021,11,3224,395,1,894,2,4,10,5,6,1,6,0,6,0,False,False,False,0,3,2021-11-22T13:05:48.433,6,False,0.0
2021,11,3224,400,1,6405,2,4,10,4,11,7,9,2,9,0,False,False,False,0,3,2021-11-22T13:08:03.01,11,False,2.0
2021,11,3224,410,1,4587,2,48,10,-4,4,8,-1,5,-1,0,False,False,False,0,1,2021-11-22T13:09:54.493,4,False,5.0
2021,11,3224,445,1,910,2,2,7,15,21,6,20,1,20,0,False,False,False,0,2,2021-11-24T18:11:36.193,21,False,1.0
2021,11,3224,450,1,8439,2,2,9,5,6,1,6,0,6,0,False,False,False,0,3,2022-02-17T00:04:55.143,6,False,0.0
2021,11,3224,455,1,8439,2,51,5,-6,-2,4,-3,1,-3,0,False,False,False,0,1,2022-02-17T00:05:20.33,-2,False,1.0
2021,11,3224,460,1,6405,13,2,9,-5,0,0,0,0,0,0,False,False,False,0,3,2021-11-22T15:59:51.887,0,False,0.0
2021,11,3224,475,27,4850,2,5,9,5,12,7,5,7,5,0,True,False,False,3,1,2021-11-24T18:58:24.1,12,False,7.0
2021,11,3224,490,27,7850,13,51,5,-4,0,0,0,0,0,0,True,False,False,0,3,2021-11-22T13:32:48.63,0,False,0.0
2021,11,3224,500,1,6405,2,5,5,14,14,0,14,0,14,0,False,False,False,0,2,2021-12-05T00:26:25.723,14,True,0.0
2021,11,3224,505,1,8439,2,4,9,5,7,2,6,1,6,0,False,False,False,0,3,2021-11-22T13:37:02.627,7,False,1.0
2021,11,3224,515,1,910,13,4,5,4,0,0,0,0,0,0,False,False,False,0,2,2022-02-17T20:37:17.457,0,False,0.0
2021,11,3224,530,27,6397,2,5,3,4,16,12,12,4,12,0,False,False,False,0,3,2021-11-22T13:48:52.297,16,False,4.0
2021,11,3224,535,27,7408,13,8,8,49,0,0,0,0,0,0,False,False,False,0,3,2021-11-24T18:11:36.193,0,False,0.0
2021,11,3224,540,27,7849,2,46,3,2,6,4,5,1,5,0,True,False,False,0,4,2021-11-22T13:53:35.987,6,False,1.0
2021,11,3224,545,27,7496,13,2,10,2,0,0,0,0,0,0,False,False,False,0,2,2021-11-22T13:55:40.463,0,False,0.0
2021,11,3224,560,1,6933,2,4,9,4,5,1,5,0,5,0,False,False,False,0,2,2021-11-24T18:14:38.43,5,False,0.0
2021,11,3224,565,1,910,2,4,8,15,16,1,15,1,15,0,False,False,False,0,2,2021-11-24T18:57:08.76,16,False,1.0
2021,11,3224,585,1,8439,2,32,5,-4,5,9,4,1,4,0,False,False,False,0,3,2021-11-22T14:13:23.813,5,False,1.0
2021,11,3224,595,27,4850,2,7,8,17,16,-1,15,1,15,0,False,False,False,0,4,2021-11-22T14:16:17.97,16,False,1.0
2021,11,3224,600,27,7408,13,17,2,23,0,0,0,0,0,0,False,False,False,0,3,2021-11-22T14:18:03.63,0,False,0.0
2021,11,3224,605,27,6397,3,5,3,4,0,0,0,0,0,0,False,False,False,0,3,2021-11-22T14:19:43.12,0,False,0.0
2021,11,3224,625,1,4587,2,4,10,3,3,0,3,0,3,0,False,False,False,0,1,2021-11-22T14:27:14.387,3,False,0.0
2021,11,3224,645,1,910,2,2,10,10,10,0,10,0,10,0,False,False,False,0,3,2021-11-22T14:33:20.807,10,False,0.0
2021,11,3224,655,1,894,2,16,10,3,9,6,6,3,6,0,False,False,False,0,1,2021-11-22T14:42:31.777,9,False,3.0
2021,11,3224,660,1,894,2,12,9,14,15,1,14,1,14,0,False,False,False,0,2,2021-11-22T14:44:44.65,15,False,1.0
2021,11,3224,670,1,8439,2,45,10,-7,7,14,0,7,0,0,True,False,False,0,3,2021-11-22T14:49:08.67,7,False,7.0
2021,11,3224,680,1,8439,2,44,3,-4,3,7,0,3,0,0,True,False,False,1,3,2021-11-24T18:59:53.453,3,False,3.0
2021,11,3224,685,1,4587,13,20,2,18,0,0,0,0,0,0,True,False,False,0,2,2021-11-22T16:00:41.967,0,False,
2021,11,3224,690,1,910,13,9,2,18,0,0,0,0,0,0,False,False,False,0,2,2021-11-22T16:00:54.95,0,False,0.0
2021,11,3224,700,27,650,2,12,2,31,48,17,48,0,48,0,False,False,False,0,3,2021-11-22T15:02:16.07,48,True,0.0
2021,11,3224,710,27,7850,2,28,4,2,2,0,2,0,2,0,False,False,False,0,1,2021-11-22T15:04:53.91,2,False,0.0
2021,11,3224,745,1,6933,2,12,5,13,12,-1,12,0,12,0,False,False,False,0,3,2022-02-24T16:55:13.4,12,True,0.0
2021,11,3224,755,1,4587,13,5,5,3,0,0,0,0,0,0,False,False,False,0,1,2021-11-24T18:11:36.193,0,False,0.0
2021,11,3224,760,1,894,2,26,10,7,20,13,16,4,16,0,False,False,False,0,3,2021-11-24T18:57:19.937,20,False,4.0
2021,11,3224,785,1,6405,13,12,5,4,0,0,0,0,0,0,False,False,False,0,3,2021-11-24T18:06:05.93,0,True,0.0
2021,11,3224,790,1,894,13,13,9,4,0,0,0,0,0,0,False,False,False,0,3,2021-11-22T15:33:46.263,0,False,
2021,11,3224,810,27,7408,2,4,3,9,10,1,10,0,10,0,False,False,False,0,2,2021-11-22T15:37:46.91,10,False,0.0
2021,11,3224,830,27,7408,2,13,5,3,3,0,3,0,3,0,False,False,False,0,2,2022-02-17T20:38:25.007,3,False,0.0
2021,11,3224,835,27,6397,3,32,9,-3,0,0,0,0,0,0,False,False,False,0,4,2021-11-22T15:43:54.07,0,False,0.0
2021,11,3225,10,9,6436,13,20,2,26,0,0,0,0,0,0,False,False,False,0,2,2021-11-22T10:01:32.223,0,True,0.0
2021,11,3225,15,9,7816,2,30,5,-1,8,9,6,2,6,0,False,False,False,0,3,2021-11-22T16:24:16.807,8,False,2.0
2021,11,3225,20,9,4446,3,6,10,12,0,0,0,0,0,0,False,False,False,0,3,2021-11-22T10:05:12.81,0,False,0.0
2021,11,3225,40,16,7681,2,46,3,1,1,0,1,0,1,0,False,False,False,0,1,2021-11-24T20:48:13.043,1,True,0.0
2021,11,3225,45,16,3938,2,5,5,10,10,0,10,0,10,0,False,False,False,0,3,2021-11-24T20:48:24.39,10,True,0.0
2021,11,3225,55,16,3938,2,5,5,5,8,3,7,1,7,0,False,False,False,0,2,2021-11-24T20:12:10.43,8,False,1.0
2021,11,3225,60,16,7176,3,13,4,4,0,0,0,0,0,0,False,False,False,0,3,2021-11-22T10:26:00.103,0,True,0.0
2021,11,3225,95,9,6436,2,49,3,-3,-3,0,-3,0,-3,0,False,False,False,0,2,2021-11-22T10:43:11.933,-3,False,0.0
2021,11,3225,110,16,6499,13,12,5,12,0,0,0,0,0,0,False,False,False,0,1,2021-11-22T10:49:50.287,0,True,0.0
2021,11,3225,115,16,1989,3,26,3,4,0,0,0,0,0,0,False,False,False,0,2,2021-11-22T10:51:28.713,0,False,0.0
2021,11,3225,135,9,6446,2,4,10,3,11,8,3,8,3,0,False,False,False,1,4,2021-11-24T20:12:30.043,11,False,8.0
2021,11,3225,140,9,6446,13,11,2,26,0,0,0,0,0,0,True,False,False,0,4,2021-11-24T20:48:38.89,0,True,0.0
2021,11,3225,150,9,6436,2,12,9,8,11,3,8,3,8,0,True,False,False,0,3,2021-11-24T18:25:34.693,11,False,3.0
2021,11,3225,160,9,4202,2,47,5,1,2,1,2,0,2,0,False,False,False,0,1,2021-11-22T11:09:44.853,2,False,0.0
2021,11,3225,175,9,6436,13,9,2,15,0,0,0,0,0,0,False,False,False,0,2,2021-11-22T11:13:28.887,0,True,0.0
2021,11,3225,190,16,7681,2,48,10,-5,12,17,0,12,0,0,False,False,False,0,1,2021-11-22T16:21:10.333,12,False,12.0
2021,11,3225,195,16,3938,2,44,3,-5,0,5,-1,1,-1,0,True,False,False,0,3,2021-11-22T11:22:09.04,0,False,1.0
2021,11,3225,205,16,3938,2,26,5,0,8,8,8,0,8,0,True,False,False,0,2,2021-11-22T11:25:23.66,8,False,0.0
2021,11,3225,210,16,6500,2,7,6,24,37,13,33,4,33,0,False,False,False,0,4,2021-11-24T20:48:51.463,37,False,4.0
2021,11,3225,225,16,7176,2,4,9,4,13,9,9,4,9,0,False,False,False,0,4,2021-11-22T11:33:12.49,13,False,4.0
2021,11,3225,245,9,8243,2,47,5,0,2,2,1,1,1,0,False,False,False,0,1,2021-11-22T11:40:17.593,2,False,1.0
2021,11,3225,255,9,6436,2,50,3,-3,8,11,-2,10,-2,0,False,False,False,0,2,2021-11-24T20:49:51.143,8,False,10.0
2021,11,3225,270,9,6446,2,4,10,3,11,8,9,2,9,0,False,False,False,0,4,2021-11-22T11:47:49.81,11,False,2.0
2021,11,3225,275,9,6436,13,12,6,19,0,0,0,0,0,0,False,False,False,0,2,2021-11-22T11:50:30.887,0,True,0.0
2021,11,3225,285,9,6446,2,8,10,14,17,3,17,0,17,0,False,False,False,0,3,2021-11-24T19:58:37.04,17,False,
2021,11,3225,290,9,6441,3,6,7,15,0,0,0,0,0,0,False,False,False,0,3,2021-11-22T12:01:28.07,0,False,
2021,11,3225,300,9,4446,13,5,2,19,0,0,0,0,0,0,False,False,False,0,3,2021-11-24T21:18:41.773,0,False,0.0
2021,11,3225,305,9,6436,13,4,5,10,0,0,0,0,0,0,False,False,False,0,2,2021-11-24T20:52:08.243,0,True,0.0
2021,11,3225,315,16,374,13,30,5,0,0,0,0,0,0,0,False,False,False,0,4,2021-11-22T12:12:03.697,0,True,0.0
2021,11,3225,320,16,3938,2,4,5,4,23,19,18,5,18,0,True,False,False,1,2,2021-11-24T19:44:20.95,23,False,5.0
2021,11,3225,335,16,3938,13,12,2,17,0,0,0,0,0,0,False,False,False,0,3,2021-11-24T20:52:34.74,0,True,0.0
2021,11,3225,350,9,6446,2,53,5,-1,3,4,0,3,0,0,False,False,False,0,4,2021-11-24T19:58:55.483,3,False,3.0
2021,11,3225,355,9,7816,2,51,3,-2,1,3,0,1,0,0,False,False,False,0,3,2021-11-22T12:30:19.863,1,False,1.0
2021,11,3225,370,16,4143,13,4,9,4,0,0,0,0,0,0,False,False,False,0,2,2021-11-24T20:53:23.47,0,True,
2021,11,3225,375,16,1989,2,5,5,6,7,1,6,1,6,0,False,False,False,0,2,2021-11-22T12:44:38.597,7,False,1.0
2021,11,3225,380,16,6499,2,48,5,-4,11,15,9,2,9,0,False,False,False,0,1,2021-11-24T20:07:17.037,11,False,2.0
2021,11,3225,425,16,374,3,4,5,5,0,0,0,0,0,0,True,False,False,0,3,2022-02-16T22:56:35.907,0,True,0.0
2021,11,3225,435,9,4202,2,48,3,-2,5,7,2,3,2,0,False,False,False,0,1,2021-11-22T13:07:13.757,5,False,3.0
2021,11,3225,440,9,6446,2,5,10,4,4,0,4,0,4,0,False,False,False,0,3,2021-11-24T18:12:30.573,4,False,0.0
2021,11,3225,445,9,7816,2,6,10,3,5,2,4,1,4,0,False,False,False,0,2,2021-11-24T18:12:30.573,5,False,1.0
2021,11,3225,450,9,7816,13,19,2,28,0,0,0,0,0,0,False,False,False,0,2,2021-11-22T13:27:55.35,0,True,0.0
2021,11,3225,475,16,8537,2,31,9,2,8,6,5,3,5,0,False,False,False,0,4,2021-11-22T13:20:20.487,8,False,3.0
2021,11,3225,485,16,374,2,8,6,18,24,6,22,2,22,0,False,False,False,0,4,2021-11-22T13:25:50.653,24,False,2.0
2021,11,3225,500,16,374,2,12,9,10,14,4,10,4,10,0,False,False,False,0,2,2021-11-22T13:33:17.803,14,False,4.0
2021,11,3225,505,16,374,3,2,10,7,0,0,0,0,0,0,False,False,False,0,3,2021-11-24T18:26:28.57,0,True,0.0
2021,11,3225,520,9,6441,2,35,2,15,16,1,16,0,16,0,False,False,False,0,3,2021-11-22T16:24:45.033,16,False,0.0
2021,11,3225,530,9,6441,3,34,4,-4,0,0,0,0,0,0,True,False,False,0,3,2021-11-24T18:12:30.573,0,False,0.0
2021,11,3225,535,9,6436,13,8,10,12,0,0,0,0,0,0,False,False,False,0,3,2021-11-22T13:52:24.703,0,True,0.0
2021,11,3225,560,16,6499,13,12,3,12,0,0,0,0,0,0,False,False,False,0,1,2021-11-24T18:25:55.4,0,True,0.0
2021,11,3225,570,9,6441,2,44,3,-4,4,8,3,1,3,0,True,False,False,0,2,2021-11-24T20:13:00.02,4,False,1.0
2021,11,3225,580,9,4202,2,44,3,-4,0,4,-2,2,-2,0,True,False,False,0,1,2021-11-22T14:12:36.34,0,False,2.0
2021,11,3225,590,16,374,2,2,10,11,22,11,18,4,18,0,False,False,False,0,3,2021-11-24T20:56:41.987,22,False,4.0
2021,11,3225,595,16,3938,2,35,10,9,10,1,10,0,10,0,False,False,False,0,3,2021-11-22T14:19:09.1,10,True,0.0
2021,11,3225,600,16,7176,2,51,3,-3,12,15,4,8,4,0,True,False,False,1,4,2022-02-16T22:57:14.487,12,False,8.0
2021,11,3225,635,9,7183,2,46,3,0,6,6,5,1,5,0,False,False,False,0,1,2021-11-22T14:38:25.943,6,False,1.0
2021,11,3225,640,9,6436,2,4,3,11,12,1,10,2,10,0,False,False,False,0,3,2021-11-24T20:00:02.73,12,False,2.0
2021,11,3225,645,9,6441,2,4,10,5,18,13,13,5,13,0,False,False,False,0,3,2021-11-22T14:42:43.89,18,False,5.0
2021,11,3225,650,9,7183,2,48,5,-5,14,19,13,1,13,0,False,False,False,0,1,2021-11-22T14:44:38.033,14,False,1.0
2021,11,3225,670,9,6441,2,44,3,-8,-2,6,-6,4,-6,0,True,False,False,0,3,2021-11-24T20:57:10.35,-2,False,4.0
2021,11,3225,690,16,374,2,46,3,0,6,6,5,1,5,0,False,False,False,0,4,2022-02-16T22:57:41.163,6,False,1.0
2021,11,3225,700,16,3938,2,5,3,4,6,2,6,0,6,0,False,False,False,0,3,2021-11-22T15:00:31.117,6,False,0.0
2021,11,3225,705,16,3938,3,2,9,6,0,0,0,0,0,0,True,False,False,0,2,2022-02-16T22:58:09.797,0,False,0.0
2021,11,3225,715,16,3938,2,13,10,3,4,1,4,0,4,0,True,False,False,0,3,2021-11-24T18:12:30.573,4,False,0.0
2021,11,3225,725,9,6441,13,24,2,43,0,0,0,0,0,0,False,False,False,0,2,2021-11-24T18:26:14.89,0,True,0.0
2021,11,3225,730,9,4202,2,46,3,0,3,3,3,0,3,0,True,False,False,0,1,2021-11-22T15:14:25.36,3,False,0.0
2021,11,3225,760,16,374,2,47,5,1,8,7,5,3,5,0,False,False,False,0,4,2021-11-22T15:25:27.44,8,False,3.0
2021,11,3225,765,16,6500,13,29,3,13,0,0,0,0,0,0,False,False,False,0,2,2021-11-24T20:13:48.577,0,True,0.0
2021,11,3225,775,16,3938,2,26,9,1,8,7,8,0,8,0,True,False,False,1,3,2021-11-22T15:31:52.25,8,True,0.0
2021,11,3225,805,16,2568,2,53,9,-3,8,11,6,2,6,0,False,False,False,0,4,2021-11-24T20:57:25.537,8,False,2.0
2021,11,3225,825,9,6446,13,7,6,17,0,0,0,0,0,0,False,False,False,0,3,2021-11-22T15:51:29.29,0,True,0.0
2021,11,3225,830,9,6446,2,5,5,14,19,5,16,3,16,0,False,False,False,0,3,2021-11-24T18:12:30.573,19,False,3.0
2021,11,3225,835,9,6441,3,8,7,27,0,0,0,0,0,0,True,False,False,0,3,2021-11-23T20:20:40.22,0,False,0.0
2021,11,3225,840,9,6446,2,47,5,4,5,1,5,0,5,0,False,False,False,0,3,2021-11-22T15:57:48.857,5,True,0.0
2021,11,3225,845,9,4202,2,12,3,5,19,14,19,0,19,0,False,False,False,0,1,2021-11-22T15:59:36.967,19,True,0.0
2021,11,3225,850,9,4202,2,46,3,3,7,4,4,3,4,0,False,False,False,0,1,2021-11-24T21:23:59.093,7,False,3.0
2021,11,3225,860,9,6712,2,4,5,8,11,3,9,2,9,0,False,False,False,0,3,2021-11-22T16:05:12.97,11,False,2.0
2021,11,3225,865,9,6436,2,2,10,6,16,10,11,5,11,0,False,False,False,0,2,2021-11-22T16:07:06.14,16,False,5.0
2021,11,3225,870,9,6712,13,8,9,15,0,0,0,0,0,0,False,False,False,0,3,2021-11-24T18:26:40.64,0,True,0.0
2021,11,3226,20,25,7666,2,13,4,2,8,6,7,1,7,0,True,False,False,1,3,2021-11-22T11:28:03.183,8,False,1.0
2021,11,3226,25,25,8422,13,7,2,19,0,0,0,0,0,0,True,False,False,0,4,2022-02-16T23:01:36.13,0,False,0.0
2021,11,3226,40,25,8422,2,6,4,5,4,-1,4,0,4,0,False,False,False,0,3,2021-11-24T16:16:53.137,4,False,0.0
2021,11,3226,50,25,7060,2,35,7,15,16,1,16,0,16,0,False,False,False,0,3,2021-11-22T11:40:43.693,16,False,0.0
2021,11,3226,60,25,8421,2,47,5,-1,0,1,0,0,0,0,False,False,False,0,1,2021-11-22T11:45:31.203,0,False,0.0
2021,11,3226,65,25,7060,13,19,2,23,0,0,0,0,0,0,False,False,False,0,2,2021-11-22T11:47:47.767,0,False,
2021,11,3226,70,25,8422,13,5,9,4,0,0,0,0,0,0,False,False,False,0,4,2021-11-23T17:52:49.08,0,False,0.0
2021,11,3226,75,25,7060,13,8,8,18,0,0,0,0,0,0,False,False,False,0,3,2021-11-22T11:52:11.013,0,False,0.0
2021,11,3226,100,26,4619,2,5,3,3,2,-1,2,0,2,0,False,False,False,0,3,2021-11-22T12:01:52.623,2,False,0.0
2021,11,3226,105,26,4619,2,6,7,17,22,5,20,2,20,0,False,False,False,0,2,2021-11-24T18:58:39.963,22,False,2.0
2021,11,3226,110,26,958,2,4,10,5,5,0,5,0,5,0,False,False,False,0,3,2021-11-22T12:06:34.673,5,False,0.0
2021,11,3226,115,26,309,2,6,5,11,11,0,11,0,11,0,False,False,False,0,3,2021-11-22T12:10:43.523,11,False,0.0
2021,11,3226,120,26,4616,2,51,9,-5,6,11,2,4,2,0,False,False,False,0,1,2021-11-22T12:13:00.283,6,False,4.0
2021,11,3226,135,26,7491,3,17,8,15,0,0,0,0,0,0,False,False,False,0,4,2021-11-24T18:50:58.51,0,False,0.0
2021,11,3226,145,26,4619,2,13,10,2,17,15,14,3,14,0,False,False,False,0,3,2021-11-22T12:22:10.647,17,False,3.0
2021,11,3226,150,26,4619,13,9,5,4,0,0,0,0,0,0,False,False,False,0,2,2021-11-22T12:24:18.513,0,False,
2021,11,3226,175,25,8421,2,4,4,1,3,2,1,2,1,0,True,False,False,0,1,2021-11-22T12:31:48.04,3,False,
2021,11,3226,190,25,7666,13,8,8,45,0,0,0,0,0,0,False,False,False,0,2,2021-11-22T12:35:34.56,0,False,0.0
2021,11,3226,195,25,6259,2,5,5,5,8,3,5,3,5,0,False,False,False,0,3,2021-11-24T16:17:17.987,8,False,3.0
2021,11,3226,220,25,7666,2,19,8,34,37,3,36,1,36,0,False,False,False,0,3,2021-11-24T18:51:08.277,37,False,1.0
2021,11,3226,235,25,7666,13,9,5,2,0,0,0,0,0,0,False,False,False,0,2,2021-11-22T12:47:55.223,0,False,0.0
2021,11,3226,240,25,8422,2,55,4,-1,0,1,0,0,0,0,True,False,False,0,4,2021-11-24T18:59:05.53,0,False,0.0
2021,11,3226,250,26,309,2,49,10,-3,5,8,3,2,3,0,False,False,False,0,2,2021-11-22T16:30:49.51,5,False,2.0
2021,11,3226,255,26,8553,2,32,5,-2,7,9,4,3,4,0,False,False,False,1,4,2021-11-22T12:54:03.79,7,False,3.0
2021,11,3226,280,26,7491,2,53,9,-3,10,13,2,8,2,0,False,False,False,1,4,2021-11-22T13:02:17.56,10,False,8.0
2021,11,3226,290,26,309,2,5,6,18,18,0,18,0,18,0,False,False,False,0,2,2021-11-22T13:06:13.323,18,False,0.0
2021,11,3226,300,26,4616,2,28,9,4,10,6,9,1,9,6,False,False,False,0,1,2021-11-24T18:51:17.793,10,False,1.0
2021,11,3226,320,25,7060,13,13,9,-1,0,0,0,0,0,0,False,False,False,0,3,2021-11-22T13:13:19.33,0,False,0.0
2021,11,3226,325,25,7060,2,19,2,17,22,5,20,2,20,0,False,False,False,0,2,2021-11-22T13:15:13.51,22,False,2.0
2021,11,3226,330,25,7060,2,2,9,4,7,3,5,2,5,0,False,False,False,0,2,2021-11-22T13:17:30.813,7,False,2.0
2021,11,3226,345,25,7060,2,5,5,9,9,0,9,0,9,0,False,False,False,0,3,2021-11-22T13:21:05.06,9,False,0.0
2021,11,3226,350,25,7060,2,20,3,10,10,0,10,0,10,6,False,False,False,0,2,2021-11-22T13:23:00.31,10,True,0.0
2021,11,3226,365,26,309,2,5,10,11,14,3,12,2,12,0,False,False,False,0,3,2021-11-24T18:51:26.737,14,False,2.0
2021,11,3226,375,26,4616,2,4,10,4,9,5,8,1,8,0,False,False,False,0,1,2021-11-22T13:29:31.853,9,False,1.0
2021,11,3226,390,26,958,2,35,9,7,10,3,8,2,8,0,False,False,False,0,3,2021-11-24T18:51:36.32,10,False,2.0
2021,11,3226,400,26,7453,2,13,9,3,18,15,18,0,18,0,False,False,False,0,3,2021-11-23T17:55:48.223,18,True,0.0
2021,11,3226,410,26,4616,2,5,3,3,6,3,6,0,6,0,False,False,False,0,1,2021-11-22T13:39:30.21,6,False,0.0
2021,11,3226,420,26,4616,13,26,4,4,0,0,0,0,0,0,False,False,False,0,3,2021-11-24T16:01:39.83,0,False,0.0
2021,11,3226,460,26,309,13,8,4,13,0,0,0,0,0,0,False,False,False,0,3,2021-11-24T18:55:01.307,0,False,0.0
2021,11,3226,465,26,309,2,8,8,26,30,4,30,0,30,0,False,False,False,0,3,2021-11-22T13:53:22.183,30,False,0.0
2021,11,3226,470,26,309,2,4,10,12,14,2,13,1,13,0,False,False,False,0,2,2021-11-22T13:55:51.533,14,False,1.0
2021,11,3226,480,26,4616,2,45,5,-3,17,20,3,14,3,6,False,False,False,2,1,2021-11-24T16:01:53.16,17,False,14.0
2021,11,3226,495,25,8422,2,53,9,-4,2,6,0,2,0,0,False,False,False,0,4,2021-11-24T16:26:48.833,2,False,2.0
2021,11,3226,505,25,7666,13,4,2,15,0,0,0,0,0,0,False,False,False,0,2,2021-11-22T14:04:04.6,0,False,0.0
2021,11,3226,515,26,309,2,4,3,1,8,7,7,1,7,0,False,False,False,0,2,2021-11-22T14:06:39.417,8,False,1.0
2021,11,3226,520,26,309,2,4,9,6,5,-1,4,1,4,0,False,False,False,0,3,2021-11-22T14:08:01.007,5,False,1.0
2021,11,3226,530,26,309,2,51,9,-3,7,10,5,2,5,0,False,False,False,0,3,2021-11-22T14:11:22.96,7,False,2.0
2021,11,3226,540,26,8552,2,5,10,8,17,9,13,4,13,0,False,False,False,0,3,2021-11-24T16:17:43.88,17,False,4.0
2021,11,3226,560,26,4619,2,50,9,-4,3,7,-1,4,-1,0,False,False,False,1,2,2022-02-16T23:04:28.603,3,False,4.0
2021,11,3226,570,26,6301,3,28,4,2,0,0,0,0,0,0,False,False,False,0,1,2021-11-22T14:24:50.853,0,False,0.0
2021,11,3226,590,25,8421,2,4,4,1,2,1,2,0,2,0,False,False,False,0,1,2021-11-22T14:28:19.573,2,False,0.0
2021,11,3226,595,25,8421,2,6,4,0,6,6,4,2,4,0,False,False,False,0,1,2021-11-22T14:29:34.283,6,False,2.0
2021,11,3226,600,25,7666,2,13,9,3,28,25,26,2,26,0,False,False,False,0,3,2021-11-22T14:31:13.203,28,False,2.0
2021,11,3226,605,25,7060,2,4,9,4,5,1,5,0,5,0,False,False,False,0,2,2021-11-22T14:32:40.89,5,False,0.0
2021,11,3226,615,25,8421,2,6,9,1,7,6,6,1,6,0,False,False,False,0,1,2021-11-24T18:51:49.943,7,False,1.0
2021,11,3226,620,25,609,2,32,10,-2,1,3,0,1,0,0,False,False,False,0,4,2021-11-24T18:56:22.22,1,False,1.0
2021,11,3226,630,25,6486,2,5,9,5,5,0,5,0,5,0,False,False,False,0,3,2021-11-24T16:02:20.137,5,False,0.0
2021,11,3226,635,25,8422,13,7,7,18,0,0,0,0,0,0,False,False,False,0,3,2021-11-24T18:52:03.443,0,False,0.0
2021,11,3226,660,26,4619,13,7,2,18,0,0,0,0,0,0,False,False,False,0,3,2021-11-22T14:48:56.853,0,False,0.0
2021,11,3226,675,25,8421,3,5,3,2,0,0,0,0,0,0,True,False,False,0,3,2021-11-22T14:58:16.8,0,False,0.0
2021,11,3226,685,25,7060,13,13,4,1,0,0,0,0,0,0,False,False,False,0,2,2021-11-22T15:01:16.967,0,False,0.0
2021,11,3226,690,25,7666,13,2,4,5,0,0,0,0,0,0,True,False,False,0,4,2021-11-24T19:00:59.4,0,False,
2021,11,3226,710,26,7491,2,32,5,0,11,11,11,0,11,0,False,False,False,1,4,2021-11-24T16:02:56.293,11,False,0.0
2021,11,3226,715,26,958,3,6,4,11,0,0,0,0,0,0,False,False,False,0,3,2021-11-22T15:09:33.67,0,False,0.0
2021,11,3226,720,26,7491,2,4,10,5,12,7,8,4,8,0,False,False,False,0,3,2021-11-22T15:11:13.677,12,False,4.0
2021,11,3226,730,26,309,13,4,10,6,0,0,0,0,0,0,False,False,False,0,3,2021-11-22T15:14:47.127,0,False,0.0
2021,11,3226,760,25,7666,2,5,5,14,16,2,16,0,16,0,False,False,False,0,4,2021-11-22T15:24:56.583,16,False,0.0
2021,11,3226,765,25,6259,2,5,3,4,4,0,4,0,4,0,False,False,False,0,4,2021-11-22T15:26:17.43,4,False,0.0
2021,11,3226,770,25,8421,2,6,10,-1,5,6,4,1,4,0,False,False,False,0,1,2021-11-22T15:27:52.04,5,False,1.0
2021,11,3226,775,25,7060,13,6,10,12,0,0,0,0,0,0,False,False,False,0,2,2021-11-22T15:30:02.03,0,False,0.0
2021,11,3226,780,25,7060,2,6,10,3,32,29,16,16,16,0,False,False,False,1,2,2021-11-24T18:52:14.523,32,False,16.0
2021,11,3226,785,25,609,2,17,8,16,18,2,18,0,18,0,False,False,False,0,4,2021-11-22T15:35:04.837,18,False,0.0
2021,11,3226,790,25,7666,2,5,5,3,4,1,4,0,4,0,False,False,False,0,2,2021-11-22T15:36:15.127,4,False,0.0
2021,11,3226,795,25,609,2,51,9,0,5,5,4,1,4,6,False,False,False,1,3,2021-11-22T15:37:31.843,5,False,1.0
2021,11,3226,810,26,309,13,7,5,14,0,0,0,0,0,0,True,False,False,0,3,2021-11-24T19:01:27.753,0,False,0.0
2021,11,3226,815,26,309,13,4,9,-10,0,0,0,0,0,0,False,False,False,0,3,2021-11-24T18:52:53.31,0,False,0.0
2021,11,3226,820,25,7666,13,9,5,11,0,0,0,0,0,0,False,False,False,0,2,2022-02-17T20:28:08.36,0,False,
2021,11,3226,825,25,6277,13,6,4,3,0,0,0,0,0,0,False,False,False,0,1,2022-02-16T23:05:40.37,0,False,0.0
2021,11,3226,830,25,8422,2,50,5,-2,5,7,5,0,5,6,False,False,False,0,2,2021-11-22T15:50:30.543,5,True,0.0
2021,11,3226,845,26,958,3,4,9,8,0,0,0,0,0,0,False,False,False,0,3,2021-11-22T15:52:45.457,0,False,0.0
2021,11,3226,860,26,958,2,32,5,5,13,8,12,1,12,0,False,False,False,0,4,2021-11-22T15:55:38.62,13,False,1.0
2021,11,3226,870,25,7666,13,2,10,3,0,0,0,0,0,0,False,False,False,0,2,2021-11-22T15:57:57.533,0,False,0.0
2021,11,3226,875,25,6486,2,13,9,2,7,5,7,0,7,0,False,False,False,0,3,2021-11-22T15:59:14.66,7,False,0.0
2021,11,3226,885,25,7060,13,19,6,23,0,0,0,0,0,0,False,False,False,0,2,2021-11-23T17:54:38.28,0,False,0.0
2021,11,3226,900,26,7491,2,53,9,-4,5,9,3,2,3,0,False,False,False,0,4,2021-11-24T18:53:53.063,5,False,2.0
2021,11,3226,905,26,4616,2,6,10,2,17,15,12,5,12,0,False,False,False,0,1,2021-11-22T16:09:37.653,17,False,5.0
2021,11,3226,910,26,4619,2,19,6,17,53,36,44,9,44,6,False,False,False,0,2,2021-11-24T16:19:34.67,53,False,9.0
2021,11,3226,940,25,7060,13,8,8,21,0,0,0,0,0,0,False,False,False,0,2,2021-11-24T18:54:02.453,0,False,0.0
2021,11,3226,950,25,6486,13,6,9,6,0,0,0,0,0,0,False,False,False,0,2,2021-11-24T19:02:02.077,0,False,0.0
2021,11,3227,10,30,4523,2,28,3,4,10,6,9,1,9,0,False,False,False,0,4,2021-11-24T22:30:56.36,10,False,1.0
2021,11,3227,15,30,4516,2,51,9,-3,8,11,6,2,6,0,False,False,False,0,3,2021-11-23T11:52:31.98,8,False,2.0
2021,11,3227,30,30,2290,2,17,4,14,15,1,15,0,15,0,False,False,False,0,4,2021-11-23T11:55:52.83,15,False,0.0
2021,11,3227,40,30,4937,2,47,5,-1,3,4,2,1,2,0,False,False,False,0,1,2021-11-23T11:57:25.687,3,False,1.0
2021,11,3227,45,30,4516,2,49,5,-1,13,14,13,0,13,6,True,False,False,1,3,2021-11-23T11:59:01.507,13,True,0.0
2021,11,3227,65,21,7090,2,4,5,8,9,1,9,0,9,0,False,False,False,0,2,2021-11-24T17:09:23.893,9,False,0.0
2021,11,3227,70,21,4492,2,2,4,10,12,2,10,2,10,0,False,False,False,0,2,2021-11-23T12:05:50.71,12,False,2.0
2021,11,3227,80,21,813,2,53,9,-6,-1,5,-4,3,-4,0,False,False,False,0,4,2021-11-23T12:08:54.033,-1,False,
2021,11,3227,95,21,4422,2,5,3,5,9,4,9,0,9,0,False,False,False,0,3,2021-11-24T23:54:27.75,9,False,0.0
2021,11,3227,105,21,8518,2,5,5,4,4,0,4,0,4,0,False,False,False,0,3,2021-11-23T12:14:51.39,4,False,0.0
2021,11,3227,110,21,7090,13,2,5,6,0,0,0,0,0,0,False,False,False,0,2,2021-11-23T12:16:49.93,0,False,
2021,11,3227,115,21,8518,13,4,3,12,0,0,0,0,0,0,False,False,False,0,2,2021-11-24T23:55:03.357,0,False,0.0
2021,11,3227,150,30,4516,2,13,4,6,7,1,7,0,7,0,False,False,False,0,3,2021-11-23T12:24:41.893,7,False,0.0
2021,11,3227,155,30,4937,2,51,10,-5,10,15,6,4,6,0,False,False,False,0,1,2021-11-23T12:25:47.763,10,False,4.0
2021,11,3227,160,30,4937,2,4,10,4,8,4,7,1,7,0,False,False,False,0,1,2021-11-23T12:26:48.007,8,False,1.0
2021,11,3227,170,30,63,2,39,4,6,6,0,6,0,6,0,False,False,False,0,4,2021-11-23T12:28:38.527,6,False,0.0
2021,11,3227,190,30,4937,2,46,3,2,6,4,4,2,4,0,False,False,False,0,1,2021-11-23T16:10:02.207,6,False,2.0
2021,11,3227,195,30,793,13,21,6,23,0,0,0,0,0,0,False,False,False,0,2,2021-11-23T12:34:09.133,0,False,0.0
2021,11,3227,205,30,4516,2,50,9,-2,6,8,1,5,1,0,False,False,False,0,2,2021-11-23T12:36:52.05,6,False,5.0
2021,11,3227,210,30,2290,13,39,4,5,0,0,0,0,0,0,False,False,False,0,4,2021-11-25T00:10:30.45,0,False,0.0
2021,11,3227,215,30,793,2,5,3,5,7,2,6,1,6,0,False,False,False,0,3,2021-11-24T23:44:41.667,7,False,1.0
2021,11,3227,220,30,2290,13,46,3,2,0,0,0,0,0,0,True,False,False,0,4,2021-11-23T12:41:11.07,0,False,0.0
2021,11,3227,230,30,7893,13,12,10,7,0,0,0,0,0,0,False,False,False,0,2,2021-11-23T12:43:18.023,0,False,0.0
2021,11,3227,245,21,4422,2,47,5,0,3,3,2,1,2,0,True,False,False,0,3,2021-11-25T00:11:02.44,3,False,1.0
2021,11,3227,250,21,6228,2,47,5,2,5,3,4,1,4,0,False,False,False,0,1,2021-11-23T12:46:54.267,5,False,1.0
2021,11,3227,265,30,793,3,18,3,0,0,0,0,0,0,0,False,False,False,0,2,2021-11-24T23:40:36.203,0,False,0.0
2021,11,3227,275,21,7862,2,33,9,2,2,0,2,0,2,6,False,False,False,0,4,2021-11-24T23:58:46.537,2,True,0.0
2021,11,3227,295,30,63,2,5,9,4,4,0,4,0,4,0,False,False,False,0,4,2021-11-23T13:01:44.64,4,False,0.0
2021,11,3227,300,30,63,2,12,8,29,35,6,30,5,30,0,False,False,False,1,3,2021-11-23T13:03:24.937,35,False,5.0
2021,11,3227,305,30,793,2,6,10,5,7,2,6,1,6,0,False,False,False,0,3,2021-12-03T17:13:12.14,7,False,1.0
2021,11,3227,315,30,63,13,35,4,9,0,0,0,0,0,0,False,False,False,0,4,2021-11-23T13:07:59.503,0,False,0.0
2021,11,3227,320,30,2290,2,5,10,10,12,2,11,1,11,0,False,False,False,0,4,2021-11-23T13:09:04.937,12,False,1.0
2021,11,3227,345,21,7090,13,19,8,47,0,0,0,0,0,0,False,False,False,0,2,2021-11-23T13:23:13.027,0,False,0.0
2021,11,3227,350,21,8518,2,54,9,-3,5,8,0,5,0,0,True,False,False,3,4,2021-11-24T23:45:05.763,5,False,5.0
2021,11,3227,360,21,8518,13,5,5,5,0,0,0,0,0,0,True,False,False,0,2,2021-11-24T17:13:43.067,0,False,0.0
2021,11,3227,375,30,793,2,4,5,5,16,11,5,11,5,0,False,False,False,1,2,2021-11-23T13:33:51.573,16,False,11.0
2021,11,3227,380,30,63,2,46,3,0,3,3,1,2,1,0,False,False,False,0,4,2021-11-25T00:12:51.303,3,False,2.0
2021,11,3227,390,30,4516,2,6,9,12,13,1,13,0,13,0,False,False,False,0,2,2021-11-23T13:36:14.743,13,False,0.0
2021,11,3227,395,30,63,2,5,10,6,9,3,5,4,5,0,False,False,False,0,4,2021-11-23T13:37:26.147,9,False,4.0
2021,11,3227,410,30,2290,13,17,1,18,0,0,0,0,0,0,False,False,False,0,3,2021-11-23T13:39:40.477,0,False,0.0
2021,11,3227,415,30,256,3,19,2,35,0,0,0,0,0,0,True,False,False,0,2,2021-11-24T17:45:09.38,0,False,0.0
2021,11,3227,420,30,4516,2,12,4,5,34,29,13,21,13,0,False,False,False,1,3,2021-11-24T23:57:11.24,34,False,
2021,11,3227,425,30,7893,13,7,7,19,0,0,0,0,0,0,False,False,False,0,3,2021-11-24T23:41:15.623,0,False,0.0
2021,11,3227,440,21,6228,2,48,10,-7,0,7,-3,3,-3,0,True,False,False,0,1,2021-11-24T23:58:09.327,0,False,3.0
2021,11,3227,445,21,6228,2,13,4,2,11,9,7,4,7,0,False,False,False,0,1,2021-11-23T13:48:15.283,11,False,4.0
2021,11,3227,455,21,7090,2,4,8,19,21,2,20,1,20,0,False,True,True,0,2,2021-11-24T23:41:31.893,21,False,1.0
2021,11,3227,470,21,8518,2,51,10,-2,4,6,0,4,0,0,False,False,False,0,3,2021-11-23T13:57:14.037,4,False,4.0
2021,11,3227,475,21,4492,13,2,4,8,0,0,0,0,0,0,False,False,False,0,2,2021-11-23T13:58:12.25,0,False,
2021,11,3227,480,21,813,2,11,6,16,28,12,27,1,27,0,False,False,False,0,4,2021-11-23T13:59:41.71,28,False,1.0
2021,11,3227,490,21,7090,13,3,3,13,0,0,0,0,0,0,False,False,False,0,2,2021-11-24T23:41:45.383,0,False,0.0
2021,11,3227,495,21,8518,2,4,9,6,8,2,6,2,6,0,False,False,False,1,3,2021-11-23T14:02:50.383,8,False,2.0
2021,11,3227,500,21,7592,13,13,10,7,0,0,0,0,0,0,False,False,False,0,2,2021-11-24T23:45:41.133,0,False,0.0
2021,11,3227,510,30,793,13,29,3,11,0,0,0,0,0,0,False,False,False,0,2,2021-11-24T23:42:08.937,0,False,0.0
2021,11,3227,515,30,793,2,4,6,18,17,-1,17,0,17,0,False,False,False,0,2,2021-11-23T14:08:06.91,17,False,0.0
2021,11,3227,520,30,256,2,6,4,13,14,1,14,0,14,0,False,False,False,0,2,2021-11-25T00:00:33.617,14,False,0.0
2021,11,3227,525,30,4937,2,48,9,-5,29,34,17,12,17,0,False,False,False,1,1,2021-11-23T14:12:30.523,29,False,
2021,11,3227,530,30,63,2,6,9,12,14,2,13,1,13,0,False,False,False,0,3,2021-11-23T14:14:02.117,14,False,1.0
2021,11,3227,535,30,4516,2,6,7,16,18,2,18,0,18,0,False,False,False,0,3,2021-11-23T14:15:17.723,18,False,0.0
2021,11,3227,540,30,4937,2,48,9,-4,4,8,4,0,4,0,False,False,False,0,1,2021-11-23T14:16:18.907,4,False,0.0
2021,11,3227,545,30,4937,13,16,9,0,0,0,0,0,0,0,True,False,False,0,1,2021-11-24T17:45:18.987,0,False,
2021,11,3227,560,30,793,2,4,9,5,5,0,5,0,5,6,False,False,False,0,3,2021-11-23T14:22:58.717,5,False,0.0
2021,11,3227,575,21,6228,2,12,5,5,11,6,11,0,11,0,False,False,False,0,1,2021-11-23T14:25:06.1,11,True,0.0
2021,11,3227,585,21,7059,13,38,9,-1,0,0,0,0,0,0,False,False,False,0,4,2021-11-24T23:43:28.317,0,False,0.0
2021,11,3227,590,30,4937,2,48,9,-3,8,11,2,6,2,0,False,False,False,0,1,2022-02-17T00:15:17.347,8,False,6.0
2021,11,3227,600,30,63,13,53,9,-3,0,0,0,0,0,0,False,False,False,0,4,2021-11-23T14:46:13.533,0,False,0.0
2021,11,3227,610,30,793,13,4,9,4,0,0,0,0,0,0,False,False,False,0,3,2021-11-23T14:47:46.18,0,False,0.0
2021,11,3227,615,30,931,2,46,3,0,3,3,2,1,2,0,False,False,False,0,1,2021-11-23T14:49:21.377,3,False,1.0
2021,11,3227,640,21,8518,13,4,8,19,0,0,0,0,0,0,False,False,False,0,3,2021-12-03T17:13:48.81,0,False,0.0
2021,11,3227,645,21,8518,2,4,5,11,8,-3,11,-3,11,0,False,False,False,0,3,2021-11-23T15:05:36.457,8,False,-3.0
2021,11,3227,650,21,8518,2,12,5,6,7,1,7,0,7,0,False,False,False,0,3,2021-11-24T17:09:38.427,7,False,0.0
2021,11,3227,660,21,6228,2,44,3,-7,-1,6,-2,1,-2,0,False,False,False,0,1,2021-11-23T15:10:53.923,-1,False,1.0
2021,11,3227,665,21,6228,2,32,3,-3,7,10,-3,10,-3,0,False,False,False,1,1,2021-11-23T15:12:12.507,5,False,10.0
2021,11,3227,675,21,4422,13,31,10,0,0,0,0,0,0,0,False,False,False,0,3,2021-11-24T22:30:56.36,0,False,0.0
2021,11,3227,680,21,8518,13,12,2,27,0,0,0,0,0,0,False,False,False,0,3,2021-11-24T23:42:52.08,0,False,0.0
2021,11,3227,705,30,793,13,2,10,7,0,0,0,0,0,0,False,False,False,0,2,2021-11-23T15:22:07.833,0,False,0.0
2021,11,3227,710,30,256,13,29,6,18,0,0,0,0,0,0,False,False,False,0,2,2021-11-23T15:25:42.1,0,False,0.0
2021,11,3227,720,21,7090,2,46,3,0,2,2,1,1,1,0,False,False,False,0,3,2021-11-25T00:03:16.517,2,False,1.0
2021,11,3227,730,21,8518,2,5,3,4,4,0,4,0,4,0,False,False,False,0,3,2021-11-23T15:29:38.56,4,False,0.0
2021,11,3227,740,21,7090,13,4,10,8,0,0,0,0,0,0,False,False,False,0,3,2021-11-24T23:43:54.4,0,False,0.0
2021,11,3227,745,30,793,2,8,7,17,21,4,21,0,21,0,False,False,False,0,3,2021-11-23T15:33:46.56,21,False,0.0
2021,11,3227,750,30,2290,13,8,10,13,0,0,0,0,0,0,False,False,False,0,4,2021-11-23T15:36:08.633,0,False,0.0
2021,11,3227,760,30,256,2,2,10,2,5,3,4,1,4,0,False,False,False,0,2,2021-11-23T15:38:17.287,5,False,1.0
2021,11,3227,775,21,4422,13,3,10,4,0,0,0,0,0,0,False,False,False,0,3,2021-11-24T22:30:56.36,0,False,0.0
2021,11,3227,780,21,7090,2,4,9,4,5,1,4,1,4,0,False,False,False,0,2,2021-11-23T15:41:39.573,5,False,1.0
2021,11,3227,785,21,4422,13,12,3,8,0,0,0,0,0,0,False,False,False,0,3,2021-11-23T15:43:43.683,0,False,0.0
2021,11,3227,815,21,3957,2,4,4,3,5,2,5,0,5,0,False,False,False,0,1,2021-11-24T23:43:06.793,5,False,0.0
2021,11,3227,820,21,4492,13,5,5,11,0,0,0,0,0,0,False,False,False,0,2,2021-11-23T15:52:54.27,0,False,0.0
2021,11,3227,850,30,8307,2,50,9,-2,3,5,2,1,2,0,False,False,False,0,2,2021-11-23T16:02:37.06,3,False,1.0
2021,11,3227,855,30,7893,2,3,5,9,8,-1,8,0,8,0,False,False,False,0,2,2021-11-23T15:59:03.57,8,True,0.0
2021,12,3228,10,6,3233,2,5,5,2,3,1,3,0,3,0,False,False,False,0,3,2021-11-26T11:20:01.95,3,False,0.0
2021,12,3228,25,6,7728,13,17,9,12,0,0,0,0,0,0,False,False,False,0,4,2021-11-26T11:25:12.557,0,False,0.0
2021,12,3228,30,6,7725,13,5,5,12,0,0,0,0,0,0,False,False,False,0,3,2021-11-26T11:26:52.687,0,False,0.0
2021,12,3228,45,11,7732,2,45,5,-4,0,4,-1,1,-1,0,False,False,False,1,1,2021-11-26T11:31:39.847,0,False,1.0
2021,12,3228,50,11,7732,2,47,5,0,3,3,3,0,3,0,False,True,False,0,1,2021-11-26T11:33:15.953,3,False,0.0
2021,12,3228,55,11,7732,2,47,5,1,6,5,6,0,6,0,False,False,False,0,1,2021-11-26T16:34:19,6,True,0.0
2021,12,3228,60,11,4875,2,5,6,16,16,0,16,0,16,0,False,False,False,0,2,2021-11-26T11:36:50.557,16,True,0.0
2021,12,3228,75,11,4875,2,20,2,34,39,5,37,2,37,6,False,False,False,0,2,2021-11-26T11:43:46.213,39,False,2.0
2021,12,3228,95,6,7725,2,2,3,6,11,5,8,3,8,0,False,False,False,0,2,2021-11-26T11:49:49.313,11,False,3.0
2021,12,3228,105,6,4305,2,50,9,-4,13,17,5,8,5,0,False,False,False,1,3,2021-12-01T13:53:46.477,13,False,8.0
2021,12,3228,120,6,7728,2,28,10,-5,8,13,6,2,6,0,False,False,False,0,1,2021-11-26T11:59:28.72,8,False,2.0
2021,12,3228,155,6,6786,2,53,9,-3,7,10,3,4,3,0,False,False,False,0,4,2021-11-26T12:16:06.07,7,False,4.0
2021,12,3228,165,6,4305,2,45,5,-4,12,16,-2,14,-2,0,True,False,False,1,3,2021-11-26T12:45:29.423,12,False,14.0
2021,12,3228,170,6,7725,2,6,8,18,33,15,25,8,25,0,False,False,False,0,3,2021-11-26T12:47:51.233,33,False,8.0
2021,12,3228,175,6,7728,2,13,9,1,2,1,2,0,2,0,True,False,False,0,4,2021-11-26T12:49:48.487,2,False,0.0
2021,12,3228,185,6,666,2,5,6,17,17,0,17,0,17,0,False,False,False,0,4,2021-11-27T20:56:18.37,17,False,0.0
2021,12,3228,195,6,666,13,7,5,10,0,0,0,0,0,0,False,False,False,0,3,2021-12-01T12:32:46.907,0,False,0.0
2021,12,3228,200,6,2714,13,4,5,10,0,0,0,0,0,0,False,False,False,0,4,2021-11-26T12:57:25.493,0,False,0.0
2021,12,3228,215,11,4561,2,28,5,-1,9,10,5,4,5,0,False,False,False,0,1,2021-11-26T12:59:58.947,9,False,4.0
2021,12,3228,230,11,6810,2,5,3,10,10,0,10,0,10,0,False,False,False,0,4,2021-11-26T13:04:56.7,10,True,0.0
2021,12,3228,240,11,8359,2,4,10,4,5,1,5,0,5,0,False,False,False,0,3,2021-11-26T13:07:59.027,5,False,0.0
2021,12,3228,265,11,4561,2,4,10,3,4,1,4,0,4,0,False,False,False,0,1,2021-11-26T13:14:49.8,4,False,0.0
2021,12,3228,270,11,4561,2,48,9,-6,-6,0,-6,0,-6,0,False,False,False,0,1,2021-11-26T13:16:05.223,-6,False,0.0
2021,12,3228,285,6,7725,2,35,8,39,52,13,49,3,49,0,False,False,False,0,3,2021-12-01T14:06:25.963,52,False,3.0
2021,12,3228,290,6,666,2,17,10,14,17,3,17,0,17,6,False,False,False,0,4,2021-11-26T13:22:45.937,17,True,0.0
2021,12,3228,305,11,4561,2,4,4,3,9,6,5,4,5,0,False,False,False,0,1,2021-11-26T13:25:12.983,9,False,4.0
2021,12,3228,325,6,7728,2,5,3,14,16,2,16,0,16,0,False,False,False,0,3,2021-11-26T13:31:59.2,16,False,0.0
2021,12,3228,335,6,1378,13,19,6,22,0,0,0,0,0,0,False,False,False,0,2,2021-11-26T13:34:01.837,0,False,0.0
2021,12,3228,340,6,7728,13,17,9,9,0,0,0,0,0,0,False,False,False,0,3,2021-11-26T13:34:57.317,0,False,0.0
2021,12,3228,345,6,3233,13,17,8,23,0,0,0,0,0,0,False,False,False,0,2,2021-12-01T14:07:41.033,0,False,0.0
2021,12,3228,365,11,4561,2,4,10,2,2,0,2,0,2,0,True,False,False,0,1,2021-11-26T13:41:12.513,2,False,0.0
2021,12,3228,370,11,4875,13,19,2,36,0,0,0,0,0,0,False,False,False,0,3,2021-11-27T21:13:27.333,0,False,0.0
2021,12,3228,380,6,7728,2,5,10,5,8,3,6,2,6,0,True,False,False,1,3,2021-11-26T13:46:29.123,8,False,2.0
2021,12,3228,385,6,6786,2,5,5,3,9,6,7,2,7,0,False,False,False,0,1,2021-11-26T14:04:27.34,9,False,2.0
2021,12,3228,390,6,7728,2,38,9,2,2,0,2,0,2,0,True,False,False,0,3,2021-11-26T14:06:20.69,2,False,0.0
2021,12,3228,400,6,7728,2,13,4,6,10,4,8,2,8,0,False,False,False,0,4,2021-11-26T14:09:04.843,10,False,2.0
2021,12,3228,405,6,7725,13,5,3,8,0,0,0,0,0,0,False,False,False,0,2,2021-11-26T14:10:24,0,False,0.0
2021,12,3228,440,11,4037,2,45,5,-6,0,6,-1,1,-1,0,True,False,False,1,2,2021-12-01T13:54:05.37,0,False,1.0
2021,12,3228,460,6,7725,13,39,4,6,0,0,0,0,0,0,False,False,False,0,3,2021-11-26T14:25:23.703,0,False,0.0
2021,12,3228,465,6,3233,2,12,2,17,19,2,19,0,19,0,False,False,False,0,2,2021-11-26T14:28:10.317,19,False,0.0
2021,12,3228,470,6,7725,2,2,4,10,11,1,11,0,11,0,False,False,False,0,3,2021-11-26T14:28:01.973,11,False,0.0
2021,12,3228,490,6,7728,13,47,5,2,0,0,0,0,0,0,False,False,False,0,3,2021-11-26T14:33:18.86,0,False,0.0
2021,12,3228,505,11,4037,2,50,5,-1,-1,0,-1,0,-1,0,False,False,False,0,2,2022-02-17T00:49:08.46,-1,False,0.0
2021,12,3228,510,11,4037,13,13,10,5,0,0,0,0,0,0,False,False,False,0,3,2021-11-26T14:37:53.47,0,False,0.0
2021,12,3228,540,11,4037,2,2,4,8,17,9,14,3,14,0,False,False,False,0,3,2021-11-26T16:38:26.707,17,False,3.0
2021,12,3228,545,11,6810,2,42,9,3,8,5,5,3,5,0,False,False,False,0,4,2021-11-26T16:35:27.397,8,False,3.0
2021,12,3228,555,11,6571,13,2,9,3,0,0,0,0,0,0,True,False,False,0,2,2021-11-26T14:57:41.483,0,False,0.0
2021,12,3228,560,11,8359,2,50,10,-4,0,4,-2,2,-2,0,False,False,False,0,2,2021-11-26T14:58:59.97,0,False,2.0
2021,12,3228,565,11,8359,2,13,10,2,11,9,9,2,9,0,False,False,False,0,3,2021-11-26T15:00:35.147,11,False,2.0
2021,12,3228,570,11,6810,2,7,2,17,17,0,17,0,17,6,False,False,False,0,4,2021-12-01T13:10:37.237,17,True,0.0
2021,12,3228,595,6,7725,2,6,8,16,16,0,16,0,16,0,False,False,False,0,3,2021-11-26T15:12:41.71,16,False,0.0
2021,12,3228,610,6,7576,13,5,2,17,0,0,0,0,0,0,False,False,False,0,3,2021-11-26T15:19:00.99,0,False,0.0
2021,12,3228,615,6,6786,2,28,10,-6,12,18,8,4,8,0,False,False,False,0,1,2021-11-26T15:20:23.3,12,False,4.0
2021,12,3228,640,11,4875,2,5,3,5,15,10,5,10,5,0,False,False,False,2,3,2021-12-01T13:54:19.87,15,False,10.0
2021,12,3228,670,11,4875,13,19,2,22,0,0,0,0,0,0,False,False,False,0,2,2021-11-26T15:42:43.45,0,False,0.0
2021,12,3228,675,11,8359,2,50,10,-2,7,9,5,2,5,0,False,False,False,0,3,2021-11-26T15:44:31.56,7,False,2.0
2021,12,3228,690,6,7728,2,4,10,7,7,0,7,0,7,0,True,False,False,0,3,2021-11-26T16:00:23.28,7,False,0.0
2021,12,3228,700,6,4305,13,16,10,4,0,0,0,0,0,0,False,False,False,0,1,2021-12-01T13:10:37.237,0,False,0.0
2021,12,3228,705,6,3233,2,12,10,13,13,0,13,0,13,0,False,False,False,0,2,2021-12-01T13:53:31.75,13,False,0.0
2021,12,3228,710,6,4305,13,3,6,17,0,0,0,0,0,0,False,False,False,0,2,2021-11-26T16:11:38,0,False,0.0
2021,12,3228,725,6,7728,2,4,9,10,12,2,10,2,10,0,False,False,False,0,3,2021-11-26T16:16:28.12,12,False,2.0
2021,12,3228,770,6,3233,2,6,9,6,7,1,7,0,7,0,False,False,False,0,3,2021-11-26T16:26:09.337,7,False,0.0
2021,12,3229,20,9,4202,2,31,9,1,1,0,1,0,1,0,False,False,False,0,1,2021-12-01T16:50:56.257,1,False,0.0
2021,12,3229,35,23,2994,2,4,3,5,12,7,5,7,5,0,False,False,False,0,2,2021-12-01T16:51:04.377,12,False,7.0
2021,12,3229,40,23,967,2,35,6,24,56,32,34,22,34,6,False,False,False,1,3,2021-11-26T11:42:13.55,56,False,22.0
2021,12,3229,55,9,7183,2,50,10,-3,6,9,3,3,3,0,False,False,False,0,3,2021-11-26T11:46:40.113,6,False,3.0
2021,12,3229,65,9,4446,2,2,10,6,15,9,9,6,9,0,False,False,False,0,2,2021-11-26T11:50:40.303,15,False,6.0
2021,12,3229,85,9,6441,2,35,2,17,17,0,17,0,17,0,True,False,False,0,3,2021-11-27T17:39:10.437,17,True,0.0
2021,12,3229,95,9,8243,2,32,3,3,10,7,7,3,7,6,False,False,False,1,4,2021-11-26T11:59:25.303,10,False,3.0
2021,12,3229,115,23,2994,13,6,9,10,0,0,0,0,0,0,False,False,False,0,3,2021-12-01T15:42:26.493,0,False,0.0
2021,12,3229,135,9,6441,13,35,9,14,0,0,0,0,0,0,True,False,False,0,3,2021-11-27T17:39:58.133,0,False,0.0
2021,12,3229,145,9,4202,13,31,9,0,0,0,0,0,0,0,False,False,False,0,1,2021-11-26T12:12:53.68,0,False,0.0
2021,12,3229,160,23,7250,13,9,2,21,0,0,0,0,0,0,False,False,False,0,3,2021-12-01T16:32:35.643,0,False,0.0
2021,12,3229,170,23,7250,2,4,4,5,5,0,5,0,5,0,False,False,False,0,3,2021-11-26T12:19:06.28,5,False,0.0
2021,12,3229,175,23,7689,13,4,5,11,0,0,0,0,0,0,False,False,False,0,2,2021-11-26T12:20:30.01,0,False,
2021,12,3229,185,23,2994,13,9,2,40,0,0,0,0,0,0,False,False,False,0,4,2021-11-26T14:09:21.097,0,False,0.0
2021,12,3229,190,23,7689,2,6,4,3,12,9,7,5,7,0,False,False,False,0,3,2021-12-01T17:05:41.57,12,False,5.0
2021,12,3229,205,23,967,13,19,2,31,0,0,0,0,0,0,False,False,False,0,2,2021-11-26T12:28:51.443,0,False,
2021,12,3229,230,9,6436,13,4,5,8,0,0,0,0,0,0,False,False,False,0,2,2021-11-26T14:06:38.797,0,False,
2021,12,3229,240,9,6446,2,4,4,4,10,6,6,4,6,0,False,False,False,0,3,2021-12-01T16:35:45.557,10,False,4.0
2021,12,3229,250,9,4446,13,4,9,9,0,0,0,0,0,0,True,False,False,0,2,2021-12-01T16:24:49.6,0,False,0.0
2021,12,3229,255,9,6446,3,6,4,8,0,0,0,0,0,0,False,False,False,0,3,2021-11-26T12:46:36.793,0,False,0.0
2021,12,3229,275,23,7250,13,26,9,5,0,0,0,0,0,0,False,False,False,0,3,2021-11-26T12:52:56.653,0,False,
2021,12,3229,285,23,2994,13,35,3,10,0,0,0,0,0,0,False,False,False,0,4,2021-11-26T12:55:58.797,0,False,0.0
2021,12,3229,290,23,4949,2,4,9,11,12,1,12,0,12,0,False,False,False,0,3,2021-11-26T12:57:49.477,12,False,0.0
2021,12,3229,295,23,2994,2,4,7,15,21,6,14,7,14,0,True,False,False,1,3,2021-11-26T12:59:28.71,21,False,7.0
2021,12,3229,300,23,7241,2,48,10,-2,17,19,-1,18,-1,0,False,False,False,1,1,2021-11-26T13:08:52.19,17,False,18.0
2021,12,3229,325,23,7122,13,26,10,4,0,0,0,0,0,0,False,False,False,0,4,2021-12-01T16:44:06.24,0,False,0.0
2021,12,3229,340,9,6436,2,4,10,5,9,4,7,2,7,0,False,False,False,0,3,2021-11-26T13:17:20.86,9,False,2.0
2021,12,3229,350,9,6446,2,12,10,2,4,2,3,1,3,0,False,False,False,0,4,2021-11-27T17:36:18.467,4,False,1.0
2021,12,3229,360,9,6446,13,21,10,8,0,0,0,0,0,0,False,False,False,0,3,2021-12-01T17:05:50.977,0,False,0.0
2021,12,3229,365,9,6441,13,13,4,5,0,0,0,0,0,0,False,False,False,0,3,2021-11-26T13:25:43.213,0,False,0.0
2021,12,3229,385,23,4949,2,12,2,29,29,0,29,0,29,0,False,False,False,0,2,2021-11-26T13:30:38.51,29,True,
2021,12,3229,390,23,7250,2,4,10,4,13,9,9,4,9,0,False,False,False,0,3,2021-11-26T13:33:36.6,13,False,4.0
2021,12,3229,405,9,6441,2,11,6,23,51,28,24,27,24,0,True,False,False,0,3,2021-12-01T16:37:00.783,51,False,27.0
2021,12,3229,430,9,6441,2,46,3,0,5,5,2,3,2,0,False,False,False,0,3,2021-11-26T13:44:50.907,5,False,3.0
2021,12,3229,435,9,7183,2,47,10,0,13,13,7,6,7,0,False,False,False,0,1,2021-12-01T16:25:24.257,13,False,6.0
2021,12,3229,510,9,4202,13,46,3,0,0,0,0,0,0,0,False,False,False,0,1,2021-11-26T14:21:48.49,0,False,0.0
2021,12,3229,515,9,4446,13,4,10,10,0,0,0,0,0,0,True,False,False,0,2,2021-11-27T17:40:28.667,0,False,0.0
2021,12,3229,520,9,6436,13,12,9,10,0,0,0,0,0,0,False,False,False,0,2,2022-02-24T17:20:28.15,0,False,
2021,12,3229,525,9,6441,2,46,3,0,5,5,1,4,1,0,False,False,False,0,3,2021-12-01T16:26:45.05,5,False,4.0
2021,12,3229,535,9,7183,2,51,10,-2,7,9,4,3,4,0,False,False,False,0,3,2021-11-26T14:28:57.67,7,False,3.0
2021,12,3229,545,23,7250,2,6,9,11,31,20,23,8,23,0,False,False,False,0,3,2021-11-26T14:32:31.3,31,False,8.0
2021,12,3229,550,23,7246,2,46,3,3,3,0,3,0,3,0,True,False,False,0,4,2021-12-01T16:38:01.43,3,False,0.0
2021,12,3229,555,23,7250,2,13,4,6,11,5,11,0,11,0,False,False,False,0,3,2021-12-01T16:38:24.82,11,False,0.0
2021,12,3229,600,23,7241,3,17,10,13,0,0,0,0,0,0,False,False,False,0,1,2021-11-26T15:15:20.697,0,False,0.0
2021,12,3229,605,23,4949,2,44,9,-10,-1,9,-6,5,-6,0,False,False,False,1,3,2021-11-26T15:17:13.657,-1,False,5.0
2021,12,3229,630,23,967,13,19,2,35,0,0,0,0,0,0,False,False,False,0,2,2021-11-26T15:23:04.417,0,False,
2021,12,3229,635,23,7246,13,17,8,15,0,0,0,0,0,0,False,False,False,0,4,2021-11-26T15:25:13.313,0,False,0.0
2021,12,3229,645,23,7250,2,5,3,4,4,0,4,0,4,0,False,False,False,0,3,2021-11-26T15:27:24.02,4,False,0.0
2021,12,3229,660,9,6436,2,4,10,6,7,1,7,0,7,0,False,False,False,0,3,2021-11-26T15:32:32.77,7,False,0.0
2021,12,3229,670,9,6441,13,4,9,10,0,0,0,0,0,0,False,False,False,0,3,2021-11-26T15:36:12.603,0,False,0.0
2021,12,3229,680,23,4949,2,46,3,2,35,33,29,6,29,0,True,False,False,1,3,2021-11-26T15:46:49.553,35,False,6.0
2021,12,3229,690,23,4307,2,4,4,2,10,8,2,8,2,0,False,False,False,1,1,2021-11-26T15:49:04.713,10,False,8.0
2021,12,3229,695,23,4949,13,19,2,41,0,0,0,0,0,0,False,False,False,0,2,2021-11-26T15:50:13.207,0,False,0.0
2021,12,3229,705,23,4307,2,48,9,-6,-5,1,-5,0,-5,0,False,False,False,0,1,2021-12-01T16:40:44.527,-5,False,0.0
2021,12,3229,715,23,7246,13,32,10,1,0,0,0,0,0,0,False,False,False,0,4,2021-11-26T15:52:38.73,0,False,0.0
2021,12,3229,725,9,4446,2,4,5,8,15,7,11,4,11,0,False,False,False,0,2,2021-11-26T16:06:09.88,15,False,4.0
2021,12,3229,730,9,4446,2,2,10,5,7,2,7,0,7,0,False,False,False,0,2,2021-11-26T16:07:18.097,7,False,0.0
2021,12,3229,735,9,6436,2,19,6,33,41,8,33,8,33,0,False,False,False,0,2,2021-11-26T16:08:41.343,41,False,8.0
2021,12,3229,740,9,4202,2,48,9,-4,12,16,8,4,8,0,False,False,False,0,1,2021-11-26T16:13:34.403,12,False,4.0
2021,12,3229,745,9,6436,13,7,3,14,0,0,0,0,0,0,False,False,False,0,3,2021-11-26T16:14:51.36,0,False,0.0
2021,12,3229,750,9,4446,2,5,5,5,7,2,6,1,6,0,False,False,False,0,3,2021-11-26T16:15:47.71,7,False,1.0
2021,12,3229,755,9,6446,2,17,10,7,7,0,7,0,7,6,False,False,False,0,4,2021-11-26T16:16:58.167,7,True,
2021,12,3229,760,9,7183,2,47,5,3,6,3,5,1,5,0,False,False,False,0,1,2021-11-26T16:50:52.613,6,False,1.0
2021,12,3229,775,23,967,2,3,5,14,16,2,14,2,14,0,False,False,False,0,2,2021-11-26T16:20:10.353,16,False,2.0
2021,12,3229,785,23,7250,2,17,1,41,54,13,47,7,47,0,False,False,False,0,3,2021-12-01T15:51:57.563,54,False,7.0
2021,12,3229,800,23,7241,13,5,3,5,0,0,0,0,0,0,False,False,False,0,1,2021-11-26T16:32:27.587,0,False,0.0
2021,12,3229,805,23,7250,2,4,10,5,9,4,6,3,6,0,False,False,False,0,2,2021-11-26T16:34:26.637,9,False,3.0
2021,12,3229,820,9,6441,2,39,4,5,5,0,5,0,5,0,False,False,False,0,3,2021-12-01T16:26:02.947,5,False,0.0
2021,12,3229,825,9,6436,13,4,3,11,0,0,0,0,0,0,False,False,False,0,2,2021-11-26T16:37:35.637,0,False,0.0
2021,12,3229,845,23,4949,2,4,3,2,9,7,8,1,8,0,False,False,False,0,2,2021-11-26T16:41:19.76,9,False,1.0
2021,12,3229,860,23,4949,2,45,5,-4,4,8,4,0,4,0,True,False,False,0,3,2021-11-26T16:45:32.953,4,False,0.0
2021,12,3229,865,23,4949,13,19,6,49,0,0,0,0,0,0,False,False,False,0,2,2021-12-01T15:39:56.083,0,False,0.0
2021,12,3229,880,9,4446,2,2,10,5,4,-1,4,0,4,0,True,False,False,0,2,2021-11-26T16:54:34.813,4,False,0.0
2021,12,3229,885,9,6436,2,19,6,27,32,5,27,5,27,0,False,False,False,0,2,2021-11-26T16:56:31.15,32,False,5.0
2021,12,3229,895,9,6446,2,17,1,26,32,6,28,4,28,6,False,False,False,0,3,2021-11-26T16:59:19.223,32,False,4.0
2021,12,3229,910,23,967,2,35,6,17,30,13,30,0,30,0,False,False,False,0,3,2021-11-26T18:05:44.92,30,True,0.0
2021,12,3229,925,23,7250,2,5,3,4,7,3,6,1,6,0,False,False,False,0,3,2021-11-26T17:05:26.423,7,False,1.0
2021,12,3229,935,23,7246,13,26,9,4,0,0,0,0,0,0,True,False,False,0,3,2021-11-27T19:07:45.28,0,False,0.0
2021,12,3229,950,9,6436,13,2,9,10,0,0,0,0,0,0,False,False,False,0,2,2021-12-01T16:42:19.39,0,False,0.0
2021,12,3229,955,9,6441,2,4,10,5,11,6,8,3,8,0,False,False,False,0,3,2021-11-26T17:10:51.21,11,False,3.0
2021,12,3229,960,9,4446,2,6,5,5,5,0,5,0,5,0,False,False,False,0,2,2021-11-26T17:11:50.92,5,False,0.0
2021,12,3229,965,9,4202,2,4,4,3,3,0,3,0,3,0,False,False,False,0,1,2021-12-01T16:26:16.363,3,False,0.0
2021,12,3229,970,9,6436,2,8,9,14,17,3,17,0,17,0,False,False,False,0,2,2021-11-26T18:00:23.763,17,False,0.0
2021,12,3229,980,9,6441,2,4,10,10,10,0,10,0,10,0,False,False,False,0,3,2021-11-26T17:17:20.053,10,False,0.0
2021,12,3229,990,9,4202,2,47,5,1,2,1,2,0,2,0,False,False,False,0,1,2021-11-26T17:20:09.737,2,True,0.0
2021,12,3229,995,9,6446,13,5,5,11,0,0,0,0,0,0,False,False,False,0,3,2021-12-01T15:40:10.87,0,False,0.0
2021,12,3229,1000,9,6446,13,17,1,15,0,0,0,0,0,0,False,False,False,0,3,2021-11-26T17:26:59.103,0,False,0.0
2021,12,3229,1030,9,4202,2,46,3,1,2,1,2,0,2,0,False,False,False,0,1,2021-11-26T17:31:10.643,2,False,0.0
2021,12,3229,1035,9,4202,2,48,3,-3,4,7,2,2,2,0,False,False,False,0,1,2021-11-26T17:32:10.46,4,False,2.0
2021,12,3229,1040,9,4446,3,12,5,8,0,0,0,0,0,0,False,False,False,0,3,2022-02-17T00:37:34.57,0,False,0.0
2021,12,3229,1050,23,7241,2,45,10,-7,8,15,4,4,4,0,False,False,False,0,1,2021-11-26T17:36:43.813,8,False,4.0
2021,12,3229,1070,23,4949,13,7,2,33,0,0,0,0,0,0,False,False,False,0,3,2021-11-26T17:45:46.667,0,False,
2021,12,3230,20,20,6388,2,13,10,3,7,4,7,0,7,0,False,False,False,0,3,2021-12-01T15:24:24.447,7,False,0.0
2021,12,3230,30,4,2853,2,4,10,4,14,10,4,10,4,0,True,False,False,2,2,2021-12-01T15:18:56.377,14,False,10.0
2021,12,3230,45,4,2853,2,6,10,6,9,3,7,2,7,0,True,False,False,1,2,2021-11-27T15:24:59.03,9,False,2.0
2021,12,3230,75,4,6953,2,54,3,0,7,7,2,5,2,6,True,False,False,1,4,2021-12-01T15:08:28.727,7,False,5.0
2021,12,3230,95,20,2408,2,45,5,-4,8,12,5,3,5,0,False,False,False,0,1,2021-11-26T10:47:02.32,8,False,3.0
2021,12,3230,100,20,6388,2,6,9,11,14,3,12,2,12,0,True,False,False,0,2,2021-11-26T14:42:50.33,14,False,2.0
2021,12,3230,110,20,7353,13,2,4,5,0,0,0,0,0,0,False,False,False,0,3,2021-12-01T15:25:05.377,0,False,0.0
2021,12,3230,115,20,2408,2,48,9,-4,13,17,9,4,9,0,False,False,False,0,1,2021-11-26T10:54:41.35,13,False,4.0
2021,12,3230,170,20,7356,2,30,3,1,9,8,8,1,8,0,False,False,False,0,3,2021-12-01T15:25:48.963,9,False,1.0
2021,12,3230,185,20,2408,3,11,3,3,0,0,0,0,0,0,False,False,False,0,1,2022-02-17T18:19:01.13,0,False,0.0
2021,12,3230,200,4,2853,2,4,5,4,7,3,7,0,7,0,True,False,False,0,2,2021-11-26T11:22:22.13,7,False,0.0
2021,12,3230,210,4,7646,2,33,5,14,26,12,26,0,26,0,True,False,False,0,4,2021-11-27T15:24:59.03,26,True,0.0
2021,12,3230,215,4,6953,2,46,3,1,1,0,1,0,1,0,True,False,False,0,4,2021-11-27T15:16:30.49,1,False,0.0
2021,12,3230,220,4,4913,2,16,4,4,6,2,6,0,6,0,False,False,False,0,1,2021-11-26T11:29:39.603,6,False,0.0
2021,12,3230,245,20,6388,2,4,5,8,7,-1,7,0,7,0,False,False,False,0,3,2021-11-26T11:35:47.45,7,False,0.0
2021,12,3230,260,20,6388,13,35,2,22,0,0,0,0,0,0,False,False,False,0,3,2021-11-26T11:41:12.91,0,False,0.0
2021,12,3230,265,20,7356,13,6,5,10,0,0,0,0,0,0,False,False,False,0,3,2021-12-01T14:07:57.76,0,False,0.0
2021,12,3230,270,20,8131,13,13,4,3,0,0,0,0,0,0,False,False,False,0,3,2021-11-26T11:45:32.487,0,False,0.0
2021,12,3230,280,4,2853,13,12,8,55,0,0,0,0,0,0,False,False,False,0,3,2022-02-24T17:21:53.973,0,False,
2021,12,3230,290,4,594,2,2,10,7,12,5,11,1,11,0,False,False,False,0,3,2021-11-27T15:17:15.977,12,False,1.0
2021,12,3230,295,4,213,2,51,3,-1,7,8,2,5,2,0,False,False,False,0,3,2021-12-01T15:06:56.35,7,False,5.0
2021,12,3230,305,4,2853,13,4,9,12,0,0,0,0,0,0,True,False,False,0,2,2022-02-17T16:50:30.673,0,False,0.0
2021,12,3230,325,20,8728,2,31,9,2,10,8,8,2,8,0,False,False,False,0,1,2021-12-01T14:07:57.76,10,False,2.0
2021,12,3230,335,20,7356,13,4,3,8,0,0,0,0,0,0,False,False,False,0,2,2021-11-26T12:08:43.18,0,False,0.0
2021,12,3230,340,4,594,2,4,3,6,9,3,9,0,9,0,False,False,False,0,3,2021-11-27T15:17:33.177,9,False,0.0
2021,12,3230,350,4,6983,2,5,5,2,4,2,4,0,4,0,False,False,False,0,1,2021-11-26T12:13:07.553,4,True,0.0
2021,12,3230,360,4,213,2,29,6,17,17,0,17,0,17,0,False,False,False,0,2,2021-11-27T15:17:45.707,17,True,0.0
2021,12,3230,370,4,213,2,13,9,4,4,0,4,0,4,0,False,False,False,0,3,2021-11-27T15:24:59.03,4,False,0.0
2021,12,3230,380,4,6953,2,12,5,7,7,0,7,0,7,0,False,False,False,0,1,2021-11-26T12:23:37.977,7,True,
2021,12,3230,385,4,6983,13,46,3,2,0,0,0,0,0,0,False,False,False,0,1,2021-12-01T15:01:37.463,0,False,0.0
2021,12,3230,420,4,594,2,2,4,5,7,2,6,1,6,0,False,False,False,0,3,2021-11-26T12:35:58.03,7,False,1.0
2021,12,3230,430,4,594,2,17,5,12,14,2,14,0,14,0,False,False,False,0,3,2021-11-26T12:39:45.12,14,False,0.0
2021,12,3230,445,4,2853,13,29,2,16,0,0,0,0,0,0,False,False,False,0,2,2021-11-27T15:18:16.023,0,False,
2021,12,3230,460,4,2853,2,26,3,4,5,1,4,1,4,6,False,False,False,0,2,2021-12-01T15:02:22.413,5,False,1.0
2021,12,3230,480,20,8131,13,9,2,24,0,0,0,0,0,0,False,False,False,0,2,2021-12-01T14:07:57.76,0,False,0.0
2021,12,3230,495,4,7646,2,3,2,15,21,6,15,6,15,0,False,False,False,1,2,2021-11-26T13:03:19.513,21,False,6.0
2021,12,3230,510,4,594,2,5,5,4,4,0,4,0,4,0,False,False,False,0,3,2021-11-27T15:21:02.41,4,False,0.0
2021,12,3230,515,4,6953,2,5,5,10,24,14,23,1,23,6,True,False,False,0,4,2021-11-27T15:25:34.78,24,False,1.0
2021,12,3230,540,20,8131,2,5,6,17,17,0,17,0,17,0,False,False,False,0,2,2021-12-01T15:00:04.997,17,False,0.0
2021,12,3230,550,20,7353,2,50,5,-2,9,11,-2,11,-2,0,False,False,False,1,2,2021-12-01T15:10:05.04,9,False,11.0
2021,12,3230,565,20,7356,2,35,6,19,24,5,23,1,23,0,False,False,False,0,3,2022-02-17T18:19:15.097,24,False,1.0
2021,12,3230,585,20,3848,2,12,5,11,11,0,11,0,11,6,False,False,False,0,3,2021-11-26T13:30:25.13,11,True,0.0
2021,12,3230,600,4,2853,2,4,5,5,5,0,5,0,5,0,True,False,False,0,2,2021-11-27T15:21:24.337,5,False,0.0
2021,12,3230,615,4,2853,2,4,3,6,6,0,6,0,6,0,False,False,False,0,2,2021-11-26T13:38:01.043,6,False,0.0
2021,12,3230,620,4,2853,13,29,3,11,0,0,0,0,0,0,False,False,False,0,3,2021-11-26T13:40:06.153,0,False,0.0
2021,12,3230,640,20,2408,2,48,3,-3,-3,0,-3,0,-3,0,False,False,False,0,1,2021-12-01T15:27:41.34,-3,False,0.0
2021,12,3230,645,20,7353,13,19,2,16,0,0,0,0,0,0,False,False,False,0,2,2021-11-26T13:46:01.733,0,False,0.0
2021,12,3230,650,20,8131,2,13,4,1,7,6,4,3,4,0,False,False,False,0,3,2021-11-26T13:47:53.953,7,False,3.0
2021,12,3230,660,4,2853,2,21,6,23,28,5,25,3,25,0,True,False,False,0,2,2021-11-27T15:25:34.78,28,False,3.0
2021,12,3230,675,4,4913,2,48,9,-2,23,25,8,15,8,6,False,False,False,0,1,2021-12-01T15:06:13.833,23,False,15.0
2021,12,3230,690,20,2408,2,51,5,-5,6,11,6,0,6,0,False,False,False,0,1,2021-11-26T13:58:29.977,6,False,0.0
2021,12,3230,695,20,6388,2,13,10,4,3,-1,3,0,3,0,False,False,False,0,3,2021-12-01T15:28:09.547,3,False,0.0
2021,12,3230,700,20,2408,2,4,4,2,7,5,6,1,6,0,False,False,False,0,1,2021-11-26T14:02:11.16,7,False,1.0
2021,12,3230,705,20,7353,13,45,5,-5,0,0,0,0,0,0,True,False,False,0,1,2021-11-27T15:07:00.993,0,False,0.0
2021,12,3230,715,20,7353,13,19,2,21,0,0,0,0,0,0,False,False,False,0,2,2021-11-26T14:07:33.257,0,False,0.0
2021,12,3230,755,20,7356,2,6,4,13,14,1,13,1,13,0,False,False,False,0,3,2021-11-26T14:18:47.28,14,False,1.0
2021,12,3231,15,30,63,13,35,10,12,0,0,0,0,0,0,False,False,False,0,4,2021-11-29T10:40:28.107,0,False,0.0
2021,12,3231,20,30,793,13,13,4,5,0,0,0,0,0,0,False,False,False,0,3,2021-12-01T18:34:39.877,0,False,0.0
2021,12,3231,40,14,7584,13,22,2,20,0,0,0,0,0,0,False,False,False,0,2,2021-11-29T18:34:04.24,0,False,0.0
2021,12,3231,55,30,63,13,31,5,3,0,0,0,0,0,0,False,False,False,0,4,2021-11-29T11:31:40.793,0,False,0.0
2021,12,3231,60,30,63,2,17,10,14,20,6,19,1,19,0,False,False,False,0,4,2021-11-29T18:26:36.75,20,False,1.0
2021,12,3231,65,30,793,2,5,3,9,9,0,9,0,9,0,False,False,False,0,2,2021-11-29T11:37:05.48,9,False,0.0
2021,12,3231,75,30,4516,13,11,2,15,0,0,0,0,0,0,False,False,False,0,3,2021-11-29T11:42:59.347,0,False,0.0
2021,12,3231,80,30,4937,2,44,3,-3,0,3,0,0,0,0,False,False,False,0,1,2021-11-29T11:44:35.3,0,False,0.0
2021,12,3231,85,30,4516,2,50,10,-4,0,4,0,0,0,0,True,True,True,0,3,2021-12-01T18:02:03.413,0,False,0.0
2021,12,3231,100,14,1119,2,28,3,5,8,3,6,2,6,0,False,False,False,0,4,2021-12-01T16:38:29.207,8,False,2.0
2021,12,3231,105,14,7584,3,5,10,6,0,0,0,0,0,0,False,False,False,0,3,2022-02-17T01:04:46.953,0,False,0.0
2021,12,3231,120,30,793,2,18,3,-1,4,5,3,1,3,0,False,False,False,1,2,2021-11-29T12:04:42.433,4,False,1.0
2021,12,3231,125,30,4937,2,48,10,-7,-1,6,-5,4,-5,0,True,False,False,0,1,2021-11-30T17:51:38.833,-1,False,4.0
2021,12,3231,135,14,7582,2,47,5,-1,4,5,2,2,2,0,False,False,False,0,1,2022-03-08T19:09:09.13,4,False,2.0
2021,12,3231,145,14,7584,3,13,9,2,0,0,0,0,0,0,False,False,False,0,3,2021-11-29T12:21:50.96,0,False,0.0
2021,12,3231,165,30,4937,3,5,5,3,0,0,0,0,0,0,True,False,False,0,1,2021-11-30T17:51:46.497,0,False,0.0
2021,12,3231,180,14,4449,2,4,10,6,9,3,9,0,9,0,False,True,True,0,3,2021-11-29T12:49:47.897,9,False,0.0
2021,12,3231,185,30,63,2,31,9,4,10,6,8,2,8,0,False,False,False,0,4,2021-11-29T18:27:02.953,10,False,2.0
2021,12,3231,190,30,4937,2,4,9,4,8,4,6,2,6,0,False,False,False,0,1,2021-12-01T18:28:43.323,8,False,2.0
2021,12,3231,200,30,2290,2,53,4,-5,7,12,4,3,4,0,False,False,False,0,4,2021-11-29T13:04:04.847,7,False,3.0
2021,12,3231,240,14,7582,2,47,5,-1,8,9,1,7,1,0,False,False,False,2,1,2021-11-29T13:26:01.123,8,False,7.0
2021,12,3231,250,14,7495,2,8,8,51,62,11,53,9,53,6,False,False,False,0,2,2021-11-29T13:31:23.173,62,False,9.0
2021,12,3231,265,30,6414,13,12,9,2,0,0,0,0,0,0,False,False,False,0,1,2022-02-24T17:23:55.657,0,False,
2021,12,3231,275,30,7268,13,19,2,44,0,0,0,0,0,0,False,False,False,0,4,2021-12-01T18:02:28.777,0,False,0.0
2021,12,3231,280,14,6543,2,4,9,6,10,4,8,2,8,0,False,False,False,0,3,2021-11-29T13:48:38.963,10,False,2.0
2021,12,3231,285,14,1119,2,6,9,12,14,2,13,1,13,0,False,False,False,0,3,2021-12-01T16:38:29.207,14,False,1.0
2021,12,3231,290,14,4449,13,9,2,24,0,0,0,0,0,0,False,False,False,0,2,2021-12-01T16:38:29.207,0,False,
2021,12,3231,295,14,4449,2,13,9,2,3,1,3,0,3,0,False,False,False,0,3,2021-11-29T14:00:59.497,3,False,0.0
2021,12,3231,310,14,7584,2,47,5,1,3,2,1,2,1,0,True,False,False,0,4,2021-11-30T23:37:06.463,3,False,2.0
2021,12,3231,325,14,1119,2,11,5,14,15,1,15,0,15,6,False,False,False,0,4,2021-11-29T14:14:51.967,15,True,0.0
2021,12,3231,340,30,4516,2,4,9,3,7,4,5,2,5,0,False,False,False,0,3,2021-11-29T14:18:35.273,7,False,2.0
2021,12,3231,345,30,63,2,8,4,14,15,1,15,0,15,0,False,False,False,0,3,2021-12-01T18:27:11.54,15,False,0.0
2021,12,3231,350,30,7893,2,2,4,5,9,4,8,1,8,0,False,False,False,0,2,2021-12-01T18:05:02.87,9,False,1.0
2021,12,3231,365,30,63,2,17,8,19,26,7,24,2,24,0,False,False,False,0,3,2021-11-29T14:32:53.09,26,False,2.0
2021,12,3231,370,30,4937,2,4,4,2,5,3,4,1,4,0,False,False,False,0,1,2021-12-01T18:25:44.447,5,False,1.0
2021,12,3231,380,30,4937,2,46,3,1,4,3,4,0,4,6,False,False,False,0,1,2021-11-29T14:39:27.563,4,True,0.0
2021,12,3231,395,14,1114,2,4,3,8,9,1,9,0,9,0,False,False,False,0,2,2021-12-01T18:24:46.783,9,True,0.0
2021,12,3231,400,14,1114,2,5,3,5,5,0,5,0,5,0,False,False,False,0,2,2021-11-29T14:44:40.83,5,False,0.0
2021,12,3231,415,14,4449,13,8,1,46,0,0,0,0,0,0,True,False,False,0,3,2021-12-01T16:38:29.207,0,False,0.0
2021,12,3231,430,14,7584,2,5,5,12,12,0,12,0,12,0,False,False,False,0,2,2021-11-29T15:08:00.233,12,True,0.0
2021,12,3231,435,14,5197,13,7,2,28,0,0,0,0,0,0,False,False,False,0,3,2021-11-29T18:22:37.413,0,False,0.0
2021,12,3231,440,14,7584,13,6,10,3,0,0,0,0,0,0,False,False,False,0,2,2021-12-01T18:03:54.94,0,False,0.0
2021,12,3231,445,14,1119,2,7,2,20,22,2,21,1,21,0,False,False,False,0,3,2021-12-01T18:23:53.193,22,False,1.0
2021,12,3231,450,14,4449,3,49,9,-3,0,0,0,0,0,0,False,False,False,0,3,2022-02-17T01:05:42.217,0,False,0.0
2021,12,3231,455,14,6543,2,28,10,3,9,6,3,6,3,0,False,False,False,1,1,2021-12-01T18:06:14.333,9,False,6.0
2021,12,3231,465,14,4449,13,12,5,3,0,0,0,0,0,0,False,False,False,0,2,2021-12-01T18:23:10.05,0,False,0.0
2021,12,3231,475,14,1114,2,5,5,4,4,0,4,0,4,6,False,False,False,0,3,2021-11-29T15:35:01.083,4,True,0.0
2021,12,3231,505,14,6543,13,51,10,-3,0,0,0,0,0,0,False,False,False,0,3,2021-11-29T15:44:57.98,0,False,0.0
2021,12,3231,510,14,7584,2,8,7,22,23,1,22,1,22,0,False,False,False,0,3,2021-12-01T18:39:44.217,23,False,1.0
2021,12,3231,515,14,7582,2,48,10,-5,-3,2,-4,1,-4,0,False,False,False,0,1,2021-11-29T15:50:18.86,-3,False,1.0
2021,12,3231,520,14,4449,13,39,4,4,0,0,0,0,0,0,False,False,False,0,3,2021-11-29T15:58:07.553,0,False,0.0
2021,12,3231,525,14,7584,2,6,4,14,15,1,15,0,15,0,False,False,False,0,3,2021-12-01T18:40:22.397,15,False,0.0
2021,12,3231,535,14,7582,2,44,3,-1,5,6,4,1,4,0,False,False,False,0,1,2022-03-08T19:10:01.18,5,False,1.0
2021,12,3231,540,14,8400,2,4,9,5,15,10,10,5,10,0,False,False,False,1,4,2021-12-01T18:12:24.003,15,False,5.0
2021,12,3231,565,30,63,2,51,10,0,11,11,5,6,5,0,False,False,False,1,3,2021-12-01T18:06:46.937,11,False,6.0
2021,12,3231,570,30,7268,13,19,2,45,0,0,0,0,0,0,False,False,False,0,2,2021-11-29T17:13:06.193,0,False,
2021,12,3231,575,30,2290,2,39,4,8,10,2,10,0,10,0,False,False,False,0,4,2021-11-29T16:23:01.07,10,False,0.0
2021,12,3231,600,14,7582,13,46,3,2,0,0,0,0,0,0,False,False,False,0,1,2022-02-17T01:06:47.557,0,False,0.0
2021,12,3231,605,14,1119,2,39,4,5,11,6,8,3,8,0,False,False,False,0,4,2021-11-29T16:45:17.033,11,False,3.0
2021,12,3231,615,14,1114,13,51,5,-1,0,0,0,0,0,0,False,False,False,0,3,2021-11-29T16:48:45.457,0,False,0.0
2021,12,3231,620,14,1119,2,4,10,9,11,2,10,1,10,0,True,False,False,0,3,2022-03-08T19:10:27.777,11,False,1.0
2021,12,3231,625,14,8400,2,46,9,1,7,6,3,4,3,0,False,False,False,0,4,2021-12-01T18:50:54.303,7,False,4.0
2021,12,3231,630,14,7584,13,8,7,41,0,0,0,0,0,0,True,False,False,0,3,2021-12-01T18:03:02.677,0,False,0.0
2021,12,3231,650,30,63,2,11,5,14,32,18,19,13,19,0,False,False,False,1,4,2021-11-29T17:04:51.38,32,False,13.0
2021,12,3231,660,30,63,2,32,3,1,9,8,6,3,6,0,False,False,False,0,4,2021-12-01T18:21:16.65,9,False,3.0
2021,12,3231,665,30,2290,13,4,9,10,0,0,0,0,0,0,False,False,False,0,3,2021-11-29T17:12:11.473,0,False,
2021,12,3231,685,14,4449,13,46,3,1,0,0,0,0,0,0,True,False,False,0,4,2021-12-01T18:41:48.923,0,False,0.0
2021,12,3231,695,14,5197,2,4,9,7,8,1,8,0,8,0,False,False,False,0,3,2022-03-08T19:11:15.98,8,False,0.0
2021,12,3231,725,30,4937,2,44,9,-3,2,5,1,1,1,0,False,False,False,0,1,2021-11-29T17:31:09.28,2,False,1.0
2021,12,3231,730,30,2290,13,4,9,5,0,0,0,0,0,0,True,False,False,0,3,2021-11-29T17:33:38.737,0,False,0.0
2021,12,3231,740,30,4516,2,6,4,5,9,4,6,3,6,0,False,False,False,0,2,2021-11-29T17:39:00.523,9,False,3.0
2021,12,3231,755,30,793,13,2,10,6,0,0,0,0,0,0,False,False,False,0,2,2021-11-29T17:43:27.82,0,False,0.0
2021,12,3231,760,30,63,13,5,5,6,0,0,0,0,0,0,True,False,False,0,3,2021-11-29T17:45:27.193,0,False,0.0
2021,12,3231,790,14,6543,2,51,10,-4,7,11,5,2,5,0,True,False,False,0,1,2021-11-29T18:29:04.723,7,False,2.0
2021,12,3231,815,14,1114,2,4,3,8,10,2,10,0,10,0,False,False,False,0,2,2021-11-29T18:01:33.05,10,False,0.0
2021,12,3231,835,30,793,2,18,3,0,3,3,0,3,0,0,False,False,False,1,2,2021-12-01T18:08:02.807,3,False,3.0
2021,12,3231,840,30,4516,2,5,5,5,8,3,7,1,7,0,True,False,False,0,3,2021-11-30T17:51:55.663,8,False,1.0
2021,12,3231,860,30,2290,2,5,3,6,6,0,6,0,6,0,False,False,False,0,3,2021-11-29T18:10:45.613,6,False,0.0
2021,12,3231,865,30,4937,2,4,10,-1,13,14,7,6,7,0,False,False,False,1,1,2021-12-01T18:43:10.32,13,False,6.0
2021,12,3231,900,14,1119,13,5,3,13,0,0,0,0,0,0,False,False,False,0,3,2021-12-01T18:16:17.437,0,False,0.0
2021,12,3231,910,14,7584,13,19,6,30,0,0,0,0,0,0,False,False,False,0,3,2021-11-29T18:21:00.293,0,False,0.0
2021,12,3232,10,13,2455,2,5,5,5,6,1,5,1,5,0,False,False,False,0,2,2021-12-01T20:22:31.513,6,False,1.0
2021,12,3232,20,13,876,13,30,3,0,0,0,0,0,0,0,True,False,False,0,3,2021-11-29T10:13:48.997,0,False,0.0
2021,12,3232,30,13,8417,2,2,9,5,8,3,7,1,7,0,False,False,False,0,2,2021-11-29T10:18:06.827,8,False,1.0
2021,12,3232,40,13,4662,13,35,9,9,0,0,0,0,0,0,False,False,False,0,4,2021-11-29T10:23:20.777,0,False,0.0
2021,12,3232,45,13,8417,2,4,5,7,20,13,18,2,18,0,False,False,False,0,2,2021-11-29T10:26:22.513,20,False,2.0
2021,12,3232,65,13,2455,13,48,4,-14,0,0,0,0,0,0,False,False,False,0,1,2021-12-01T19:04:39.18,0,False,0.0
2021,12,3232,70,22,4997,2,2,9,7,11,4,10,1,10,0,False,False,False,0,2,2021-11-29T10:38:25.06,11,False,1.0
2021,12,3232,140,22,6812,13,12,4,6,0,0,0,0,0,0,False,False,False,0,1,2021-12-01T19:04:58.153,0,False,0.0
2021,12,3232,145,13,8418,2,30,10,-3,2,5,1,1,1,0,True,False,False,0,1,2021-12-20T15:49:49.3,2,False,
2021,12,3232,160,13,8417,13,17,10,14,0,0,0,0,0,0,False,False,False,0,3,2021-11-29T11:34:56.58,0,False,
2021,12,3232,180,13,8418,2,39,4,8,13,5,12,1,12,6,False,False,False,0,3,2021-12-01T19:05:24.067,13,False,1.0
2021,12,3232,200,22,743,13,47,5,3,0,0,0,0,0,0,False,False,False,0,1,2021-12-01T19:36:25.417,0,False,0.0
2021,12,3232,205,22,8454,13,12,3,2,0,0,0,0,0,0,False,False,False,0,3,2021-12-01T19:36:56.35,0,False,0.0
2021,12,3232,215,13,876,2,50,10,-3,1,4,0,1,0,0,False,False,False,1,3,2021-12-01T20:19:30.23,1,False,1.0
2021,12,3232,225,13,1510,2,13,9,4,20,16,11,9,11,0,True,False,False,0,3,2021-12-01T00:40:35.767,20,False,9.0
2021,12,3232,230,13,8417,13,7,2,39,0,0,0,0,0,0,False,False,False,0,3,2021-11-29T12:25:25.367,0,False,0.0
2021,12,3232,245,13,876,2,19,8,40,40,0,0,40,0,6,False,False,False,0,2,2021-11-29T12:39:24.027,40,False,40.0
2021,12,3232,270,22,8454,3,2,4,4,0,0,0,0,0,0,True,False,False,0,3,2021-11-30T16:56:06.757,0,False,0.0
2021,12,3232,290,13,2455,2,51,10,-6,10,16,7,3,7,0,False,False,False,0,1,2021-11-29T13:15:54.163,10,False,3.0
2021,12,3232,300,22,3170,2,26,3,4,5,1,5,0,5,0,True,False,False,0,3,2021-11-30T16:56:21.357,5,False,0.0
2021,12,3232,310,22,8454,2,34,4,-3,11,14,11,0,11,0,True,False,False,0,3,2021-11-29T13:26:10.29,11,True,0.0
2021,12,3232,315,22,743,2,48,9,-7,6,13,4,2,4,0,False,False,False,0,1,2021-12-01T19:06:55.697,6,False,2.0
2021,12,3232,325,22,6270,2,34,4,-4,1,5,1,0,1,0,True,False,False,0,3,2021-11-29T13:29:27.397,1,False,0.0
2021,12,3232,330,22,6270,13,13,9,5,0,0,0,0,0,0,False,False,False,0,3,2021-11-29T13:32:12.29,0,False,0.0
2021,12,3232,335,22,2391,2,4,10,3,10,7,6,4,6,0,False,False,False,0,3,2021-11-30T16:54:41.827,10,False,4.0
2021,12,3232,385,13,8417,13,5,6,16,0,0,0,0,0,0,False,False,False,0,2,2021-11-29T13:47:25.99,0,False,0.0
2021,12,3232,390,13,100,2,3,5,11,11,0,11,0,11,0,False,False,False,0,3,2021-11-29T13:50:12.163,11,False,0.0
2021,12,3232,395,13,1510,2,31,9,3,5,2,5,0,5,0,False,False,False,0,1,2021-12-01T19:00:05.817,5,False,0.0
2021,12,3232,405,13,8418,2,32,5,-4,4,8,0,4,0,0,False,False,False,1,4,2021-12-01T19:00:26.727,4,False,4.0
2021,12,3232,410,13,3586,2,34,4,-3,-4,-1,-4,0,-4,0,True,False,False,0,3,2021-11-29T13:57:48.853,-4,False,0.0
2021,12,3232,445,22,8454,2,4,7,22,22,0,22,0,22,0,False,False,False,0,2,2021-11-29T14:29:27.527,22,False,0.0
2021,12,3232,455,22,8454,2,8,9,13,16,3,14,2,14,0,False,False,False,0,2,2021-11-29T14:35:21.043,16,False,2.0
2021,12,3232,485,22,743,2,48,5,-5,-3,2,-3,0,-3,0,False,False,False,0,1,2021-11-29T14:50:16.183,-3,False,0.0
2021,12,3232,490,22,2391,13,12,6,16,0,0,0,0,0,0,False,False,False,0,3,2021-12-01T19:01:18.41,0,False,0.0
2021,12,3232,530,13,876,2,3,3,4,4,0,4,0,4,0,False,False,False,0,2,2021-11-29T15:08:43.187,4,False,0.0
2021,12,3232,565,22,6270,2,4,9,5,46,41,46,0,46,0,False,False,False,0,3,2021-11-30T16:54:54.677,46,False,0.0
2021,12,3232,615,13,100,13,5,5,5,0,0,0,0,0,0,False,False,False,0,3,2021-11-29T15:51:58.213,0,False,0.0
2021,12,3232,625,22,8454,13,17,4,10,0,0,0,0,0,0,False,False,False,0,2,2021-12-01T20:23:18.603,0,False,0.0
2021,12,3232,630,22,7229,13,44,3,-6,0,0,0,0,0,0,True,False,False,0,1,2021-11-29T16:00:53.29,0,False,0.0
2021,12,3232,655,13,100,13,7,2,20,0,0,0,0,0,0,False,False,False,0,2,2021-12-01T19:56:57.997,0,False,0.0
2021,12,3232,680,22,2391,2,32,3,2,3,1,3,0,3,0,False,False,False,0,3,2021-12-01T20:24:46.97,3,False,0.0
2021,12,3232,685,22,4997,2,6,4,13,13,0,13,0,13,0,False,False,False,0,2,2021-11-29T16:33:45.8,13,False,0.0
2021,12,3232,695,22,8454,13,13,3,6,0,0,0,0,0,0,False,False,False,0,3,2021-11-29T16:39:31.72,0,False,0.0
2021,12,3232,705,22,2391,2,12,4,3,7,4,7,0,7,0,False,False,False,0,3,2021-12-01T19:02:24.883,7,False,0.0
2021,12,3232,735,22,8454,2,34,4,-4,-3,1,-4,1,-4,0,True,False,False,1,3,2021-12-01T19:14:52.507,-3,False,1.0
2021,12,3232,765,13,100,2,44,3,0,7,7,6,1,6,0,True,False,False,1,2,2021-12-01T19:15:43.52,7,False,1.0
2021,12,3232,770,13,1510,2,46,3,1,2,1,2,0,2,0,False,False,False,0,1,2021-11-29T16:58:11.07,2,False,0.0
2021,12,3232,780,13,8417,13,3,5,7,0,0,0,0,0,0,False,False,False,0,2,2021-11-29T17:17:30.867,0,False,0.0
2021,12,3232,815,13,876,13,19,6,45,0,0,0,0,0,0,False,False,False,0,2,2021-11-29T17:25:02.63,0,False,0.0
2021,12,3232,820,13,8418,2,32,5,1,6,5,6,0,6,0,False,False,False,0,4,2021-11-29T17:26:54.66,6,False,0.0
2021,12,3232,830,13,100,2,13,5,5,5,0,5,0,5,0,False,False,False,0,3,2021-11-29T17:28:55.65,5,False,0.0
2021,12,3233,10,21,6228,13,4,9,0,0,0,0,0,0,0,True,False,False,0,2,2021-11-30T18:42:48.117,0,False,0.0
2021,12,3233,20,21,4422,13,38,4,3,0,0,0,0,0,0,False,False,False,0,3,2021-12-01T20:50:10.17,0,False,0.0
2021,12,3233,35,24,8509,13,4,5,6,0,0,0,0,0,0,False,False,False,0,2,2021-11-29T10:41:13.807,0,False,0.0
2021,12,3233,50,21,6228,2,51,5,-5,1,6,-1,2,-1,0,True,False,False,0,1,2021-11-29T10:49:00.94,1,False,2.0
2021,12,3233,55,21,4422,2,53,9,-6,20,26,18,2,18,0,True,False,False,0,4,2022-02-17T16:54:35.537,20,False,2.0
2021,12,3233,70,21,4422,2,5,5,6,7,1,6,1,6,0,False,False,False,0,3,2021-11-29T11:05:07.73,7,False,1.0
2021,12,3233,85,21,4492,13,13,10,3,0,0,0,0,0,0,False,False,False,0,3,2021-11-29T11:21:03.93,0,False,0.0
2021,12,3233,95,21,4492,13,9,2,17,0,0,0,0,0,0,False,False,False,0,2,2021-11-29T11:26:27.273,0,False,0.0
2021,12,3233,120,24,8509,13,3,3,12,0,0,0,0,0,0,False,False,False,0,2,2021-11-29T11:37:10.74,0,False,0.0
2021,12,3233,125,24,8509,2,6,9,14,14,0,14,0,14,0,False,False,False,0,2,2021-11-29T11:39:32.797,14,False,0.0
2021,12,3233,135,24,6937,2,46,3,0,0,0,0,0,0,0,False,False,False,0,1,2021-11-29T11:43:33.69,0,False,0.0
2021,12,3233,140,24,7800,2,12,2,19,19,0,19,0,19,0,True,False,False,0,2,2021-12-01T22:37:06.883,19,False,0.0
2021,12,3233,150,24,6389,2,16,9,1,2,1,2,0,2,0,False,False,False,0,1,2021-11-29T18:14:39.547,2,False,0.0
2021,12,3233,155,24,7800,13,8,1,15,0,0,0,0,0,0,False,False,False,0,3,2021-11-29T18:27:24.163,0,False,0.0
2021,12,3233,160,21,7090,2,4,7,15,18,3,18,0,18,0,False,False,False,0,3,2021-11-29T18:27:44.7,18,False,0.0
2021,12,3233,180,21,4674,2,13,9,6,19,13,14,5,14,0,False,False,False,0,3,2021-11-29T12:21:12.89,19,False,5.0
2021,12,3233,195,21,3389,2,4,10,4,6,2,5,1,5,0,False,False,False,0,3,2021-11-29T12:24:31.743,6,False,1.0
2021,12,3233,200,21,7090,13,4,5,12,0,0,0,0,0,0,False,False,False,0,2,2021-11-29T12:27:35.553,0,False,0.0
2021,12,3233,210,24,6373,2,51,5,-4,0,4,-2,2,-2,0,True,False,False,0,3,2021-12-01T22:41:22.517,0,False,2.0
2021,12,3233,215,24,7800,13,7,6,29,0,0,0,0,0,0,False,False,False,0,3,2021-11-29T12:38:30.05,0,False,0.0
2021,12,3233,220,24,6373,13,12,10,7,0,0,0,0,0,0,False,False,False,0,3,2021-11-29T12:43:42.91,0,False,0.0
2021,12,3233,235,21,4492,2,4,9,14,14,0,14,0,14,0,False,False,False,0,3,2021-12-01T22:38:20.74,14,False,0.0
2021,12,3233,240,21,4674,2,2,3,6,9,3,9,0,9,0,False,False,False,0,2,2021-11-29T12:57:30.833,9,False,0.0
2021,12,3233,265,21,4422,3,12,5,0,0,0,0,0,0,0,False,False,False,0,3,2021-11-29T13:18:19.857,0,False,0.0
2021,12,3233,290,24,7003,2,30,3,2,13,11,11,2,11,0,True,False,False,0,4,2021-11-30T22:44:19.607,13,False,2.0
2021,12,3233,320,24,7800,2,13,10,4,4,0,4,0,4,0,False,False,False,0,3,2021-11-29T13:49:53.407,4,False,0.0
2021,12,3233,345,24,7798,2,21,2,21,21,0,21,0,21,0,False,False,False,0,2,2021-11-29T14:03:20.34,21,False,0.0
2021,12,3233,355,24,4382,3,47,5,2,0,0,0,0,0,0,False,False,False,0,3,2021-12-01T20:50:10.187,0,False,0.0
2021,12,3233,375,24,6389,13,12,5,1,0,0,0,0,0,0,False,False,False,0,1,2021-12-01T22:26:25.693,0,False,0.0
2021,12,3233,405,24,8513,13,2,9,1,0,0,0,0,0,0,False,False,False,0,2,2021-11-29T18:16:24.817,0,False,0.0
2021,12,3233,410,24,7798,13,2,9,3,0,0,0,0,0,0,False,False,False,0,2,2021-11-29T14:30:14.507,0,False,0.0
2021,12,3233,415,21,6228,2,48,9,-7,0,7,-1,1,-1,0,False,False,False,0,1,2022-02-17T16:56:21.25,0,False,1.0
2021,12,3233,420,21,4422,2,5,3,5,10,5,8,2,8,0,False,False,False,0,3,2021-11-29T14:37:37.807,10,False,2.0
2021,12,3233,435,21,3957,2,48,10,-5,17,22,8,9,8,0,False,False,False,0,1,2021-11-29T14:45:12.45,17,False,9.0
2021,12,3233,445,21,7090,2,13,10,6,17,11,11,6,11,0,False,False,False,0,2,2021-12-01T21:50:39.72,17,False,6.0
2021,12,3233,455,21,4492,13,9,3,5,0,0,0,0,0,0,False,False,False,0,2,2021-11-29T15:02:52.42,0,False,0.0
2021,12,3233,460,21,4422,13,23,9,5,0,0,0,0,0,0,False,False,False,0,3,2021-12-01T22:39:20.797,0,False,
2021,12,3233,465,21,7059,2,31,9,1,1,0,1,0,1,6,False,False,False,0,4,2021-11-29T15:17:22.34,1,True,0.0
2021,12,3233,485,24,7798,13,19,2,45,0,0,0,0,0,0,False,False,False,0,2,2021-11-29T15:35:12.643,0,False,0.0
2021,12,3233,495,21,4422,13,50,3,-2,0,0,0,0,0,0,False,False,False,0,2,2021-11-29T15:44:30.797,0,False,0.0
2021,12,3233,510,24,7800,13,51,9,2,0,0,0,0,0,0,False,False,False,0,3,2022-02-17T16:57:21.67,0,False,0.0
2021,12,3233,580,21,4492,13,2,10,9,0,0,0,0,0,0,False,False,False,0,3,2021-12-01T20:50:10.203,0,False,0.0
2021,12,3233,615,24,6389,2,46,3,0,6,6,4,2,4,0,False,False,False,0,1,2021-11-29T18:13:27.083,6,False,2.0
2021,12,3233,640,21,4492,2,2,4,9,18,9,9,9,9,0,False,False,False,0,3,2021-12-01T22:02:42.277,18,False,9.0
2021,12,3233,645,21,4492,2,6,8,16,18,2,16,2,16,0,False,False,False,0,2,2021-11-29T17:00:52.463,18,False,2.0
2021,12,3233,655,21,7090,2,47,5,0,5,5,3,2,3,0,True,False,False,0,3,2021-11-29T17:05:29.66,5,False,2.0
2021,12,3233,660,21,6228,2,46,3,4,4,0,4,0,4,0,False,False,False,0,1,2021-12-01T21:41:11.327,4,False,0.0
2021,12,3233,665,21,7059,2,12,5,5,10,5,8,2,8,0,False,False,False,0,4,2021-11-29T17:11:23.61,10,False,2.0
2021,12,3233,675,21,6228,2,5,3,7,8,1,7,1,7,0,False,False,False,0,1,2021-11-29T17:16:35.467,8,False,1.0
2021,12,3233,685,21,3389,13,4,10,8,0,0,0,0,0,0,False,False,False,0,3,2021-12-01T22:27:59.217,0,False,0.0
2021,12,3233,700,24,7798,2,2,10,8,10,2,9,1,9,0,False,False,False,0,2,2021-12-01T20:50:10.233,10,False,1.0
2021,12,3233,715,24,8509,2,4,9,8,8,0,8,0,8,0,False,False,False,0,3,2021-11-29T17:30:46.567,8,False,0.0
2021,12,3233,765,24,8513,2,47,5,1,7,6,4,3,4,0,False,False,False,0,1,2021-11-29T17:46:23.76,7,False,3.0
2021,12,3233,770,24,8513,2,47,5,1,14,13,13,1,13,0,False,False,False,0,1,2021-12-01T20:50:10.233,14,False,1.0
2021,12,3233,775,24,7798,3,19,6,34,0,0,0,0,0,0,False,False,False,0,2,2021-12-01T21:41:58.613,0,False,0.0
2021,12,3233,780,24,8513,2,4,10,2,11,9,9,2,9,0,False,False,False,0,1,2021-11-29T17:54:42.137,11,False,2.0
2021,12,3233,790,24,6373,13,5,5,11,0,0,0,0,0,0,False,False,False,0,3,2021-11-29T17:58:21.92,0,False,0.0
2021,12,3233,795,24,7798,13,6,1,16,0,0,0,0,0,0,False,False,False,0,2,2022-02-17T16:59:32.197,0,False,0.0
2021,12,3233,800,24,7798,3,12,8,27,0,0,0,0,0,0,False,False,False,0,2,2021-11-29T18:03:04.543,0,False,0.0
2021,12,3234,10,17,364,2,46,3,1,2,1,1,1,1,0,True,False,False,0,3,2021-11-29T10:04:36.063,2,False,1.0
2021,12,3234,15,17,6274,2,45,5,0,5,5,5,0,5,0,True,False,False,0,1,2021-11-29T10:10:51.913,5,False,0.0
2021,12,3234,25,17,364,2,34,4,-4,-1,3,-2,1,-2,0,True,False,False,0,3,2021-12-01T17:23:51.953,-1,False,1.0
2021,12,3234,30,17,8483,2,2,9,8,25,17,21,4,21,0,False,False,False,0,3,2021-12-01T17:26:49.057,25,False,4.0
2021,12,3234,55,5,5220,13,2,9,6,0,0,0,0,0,0,False,False,False,0,2,2021-11-29T10:42:48.897,0,False,0.0
2021,12,3234,65,5,5220,3,2,10,3,0,0,0,0,0,0,False,False,False,0,2,2021-11-29T10:56:41.157,0,False,0.0
2021,12,3234,90,5,4799,13,26,10,1,0,0,0,0,0,0,False,False,False,0,1,2021-11-30T19:05:09.91,0,False,0.0
2021,12,3234,95,5,5220,2,17,1,37,64,27,58,6,58,0,False,False,False,0,3,2021-11-29T11:12:11.317,64,False,6.0
2021,12,3234,130,17,7087,2,30,9,-3,4,7,1,3,1,0,False,False,False,0,1,2021-12-01T17:37:12.447,4,False,3.0
2021,12,3234,140,17,8483,2,35,9,10,10,0,10,0,10,0,False,False,False,0,2,2021-11-29T11:45:33.46,10,False,0.0
2021,12,3234,150,17,6276,2,32,9,3,6,3,4,2,4,0,True,False,False,0,3,2021-11-30T22:15:13.817,6,False,2.0
2021,12,3234,175,5,8408,2,38,9,2,4,2,4,0,4,0,False,False,False,0,4,2021-11-29T12:01:31.98,4,False,0.0
2021,12,3234,200,5,3477,13,7,5,13,0,0,0,0,0,0,False,False,False,0,3,2021-12-01T18:11:50.233,0,False,0.0
2021,12,3234,205,17,364,13,44,3,-2,0,0,0,0,0,0,True,False,False,0,3,2021-11-29T12:20:07.887,0,False,0.0
2021,12,3234,215,17,8483,13,35,9,11,0,0,0,0,0,0,False,False,False,0,2,2021-11-29T12:34:33.47,0,False,0.0
2021,12,3234,225,5,3477,2,12,3,9,9,0,9,0,9,0,True,False,False,0,3,2022-02-24T17:27:54.277,9,False,
2021,12,3234,235,5,5220,13,6,8,17,0,0,0,0,0,0,False,False,False,0,2,2021-11-29T12:45:42.763,0,False,0.0
2021,12,3234,240,17,8483,2,30,3,-3,0,3,0,0,0,0,False,False,False,0,3,2021-11-29T12:49:31.707,0,False,0.0
2021,12,3234,250,17,8483,2,4,9,9,9,0,9,0,9,6,False,False,False,0,3,2021-11-29T12:54:10.923,9,True,0.0
2021,12,3234,275,5,3477,13,8,1,27,0,0,0,0,0,0,False,False,False,0,2,2021-11-29T13:06:41.113,0,False,0.0
2021,12,3234,290,17,8483,2,6,10,13,57,44,55,2,55,0,False,False,False,0,2,2021-11-29T13:12:35.753,57,False,2.0
2021,12,3234,295,17,7618,2,50,10,-1,9,10,7,2,7,0,False,False,False,0,3,2021-11-29T13:16:14.7,9,False,2.0
2021,12,3234,300,17,4383,13,13,9,5,0,0,0,0,0,0,False,False,False,0,3,2021-12-01T17:56:35.763,0,False,0.0
2021,12,3234,335,5,3477,13,26,9,3,0,0,0,0,0,0,False,False,False,0,3,2021-12-01T17:55:05.93,0,False,0.0
2021,12,3234,340,5,566,13,31,4,1,0,0,0,0,0,0,False,False,False,0,1,2021-11-29T13:36:59.68,0,False,0.0
2021,12,3234,360,17,7024,2,2,5,1,5,4,4,1,4,0,True,False,False,0,2,2021-11-29T13:46:18.993,5,False,1.0
2021,12,3234,380,17,364,2,50,10,-4,5,9,4,1,4,0,True,False,False,0,3,2021-11-29T13:54:24.617,5,False,1.0
2021,12,3234,415,5,566,13,4,9,2,0,0,0,0,0,0,True,False,False,0,1,2021-11-29T13:59:41.953,0,False,0.0
2021,12,3234,420,5,566,2,4,4,3,13,10,10,3,10,0,False,False,False,0,1,2021-11-29T14:01:00.677,13,False,3.0
2021,12,3234,425,5,566,13,4,4,1,0,0,0,0,0,0,False,False,False,0,1,2021-11-29T14:02:37.79,0,False,0.0
2021,12,3234,430,5,566,3,4,4,1,0,0,0,0,0,0,True,False,False,0,1,2021-11-29T14:03:55.64,0,False,0.0
2021,12,3234,435,5,6425,13,4,4,10,0,0,0,0,0,0,False,False,False,0,3,2021-11-29T14:08:53.417,0,False,0.0
2021,12,3234,445,17,6274,2,39,9,4,5,1,5,0,5,0,False,False,False,0,3,2021-11-29T14:11:54.42,5,False,0.0
2021,12,3234,450,17,6274,2,5,3,7,7,0,7,0,7,0,False,False,False,0,3,2021-11-29T14:13:47.573,7,False,0.0
2021,12,3234,455,17,8483,2,4,10,11,11,0,11,0,11,0,False,False,False,0,3,2021-11-29T14:15:45.667,11,False,0.0
2021,12,3234,465,17,4752,2,13,10,5,11,6,11,0,11,0,False,False,False,0,2,2021-11-29T14:19:42.88,11,False,0.0
2021,12,3234,475,17,8483,2,46,3,2,7,5,7,0,7,0,True,False,False,0,3,2021-11-29T14:22:25.883,7,True,0.0
2021,12,3234,500,5,5220,2,5,5,3,4,1,4,0,4,0,True,False,False,0,3,2021-11-29T16:34:51.88,4,False,0.0
2021,12,3234,520,5,8408,13,5,2,16,0,0,0,0,0,0,False,False,False,0,4,2021-11-29T15:28:28.313,0,False,0.0
2021,12,3234,530,5,5220,13,3,5,12,0,0,0,0,0,0,False,False,False,0,2,2021-11-29T15:31:29.407,0,False,0.0
2021,12,3234,535,5,566,2,16,10,3,7,4,6,1,6,0,False,False,False,0,1,2021-12-01T15:36:08.38,7,False,1.0
2021,12,3234,545,17,8483,2,2,9,4,7,3,6,1,6,0,False,False,False,0,2,2021-12-01T17:44:34.15,7,False,1.0
2021,12,3234,565,17,6276,2,32,3,0,4,4,3,1,3,0,False,False,False,0,4,2021-11-29T15:51:16.283,4,False,1.0
2021,12,3234,570,17,8483,2,5,10,10,11,1,11,0,11,0,False,False,False,0,3,2021-11-29T15:55:44.153,11,False,0.0
2021,12,3234,575,17,6276,2,46,3,2,11,9,10,1,10,0,False,False,False,0,4,2021-12-01T15:36:08.38,11,False,1.0
2021,12,3234,585,17,4752,13,6,8,17,0,0,0,0,0,0,False,False,False,0,3,2021-11-29T17:10:42.983,0,False,
2021,12,3234,595,17,6276,2,30,9,0,9,9,3,6,3,0,False,False,False,0,4,2021-11-29T16:11:51.403,9,False,6.0
2021,12,3234,605,17,6276,2,46,3,1,2,1,2,0,2,0,True,False,False,0,4,2021-11-29T16:14:52.5,2,False,0.0
2021,12,3234,630,5,6425,3,30,10,0,0,0,0,0,0,0,False,False,False,0,4,2022-02-17T16:40:39.8,0,False,0.0
2021,12,3234,640,5,8409,13,28,4,1,0,0,0,0,0,0,False,False,False,0,1,2021-12-01T15:36:08.38,0,False,0.0
2021,12,3234,685,17,7024,2,47,5,-2,-2,0,-2,0,-2,0,False,False,False,0,1,2021-11-29T16:49:11.677,-2,False,0.0
2021,12,3234,690,17,6276,2,30,9,-3,3,6,0,3,0,0,False,False,False,0,4,2021-12-01T17:47:16.433,3,False,
2021,12,3234,705,17,364,2,50,5,-4,5,9,3,2,3,0,True,False,False,1,3,2021-11-29T16:59:10.07,5,False,2.0
2021,12,3234,725,5,5220,2,3,2,17,18,1,18,0,18,0,False,False,False,0,2,2021-11-29T17:03:20.557,18,False,0.0
2021,12,3234,740,5,6425,13,12,3,8,0,0,0,0,0,0,False,False,False,0,3,2021-12-01T16:46:54.327,0,False,0.0
2021,12,3234,755,17,364,2,2,10,3,6,3,6,0,6,0,False,False,False,0,2,2021-11-29T17:17:57.22,6,False,0.0
2021,12,3234,780,17,4752,13,11,6,15,0,0,0,0,0,0,True,False,False,0,2,2022-02-17T16:41:59.607,0,False,0.0
2021,12,3234,805,5,6372,2,8,1,23,24,1,24,0,24,0,False,False,False,0,3,2021-12-01T15:36:08.38,24,False,0.0
2021,12,3234,815,5,8408,3,6,4,12,0,0,0,0,0,0,False,False,False,0,3,2021-11-29T17:42:13.887,0,False,0.0
2021,12,3234,820,5,5220,13,29,2,25,0,0,0,0,0,0,False,False,False,0,2,2021-11-29T17:44:24.343,0,False,0.0
2021,12,3234,825,5,4341,2,35,4,7,13,6,10,3,10,0,False,False,False,0,2,2021-12-01T15:36:08.38,13,False,3.0
2021,12,3234,830,5,3477,2,5,2,15,15,0,15,0,15,0,False,False,False,0,3,2021-11-29T17:49:48.62,15,False,0.0
2021,12,3234,835,5,5220,2,5,2,17,17,0,17,0,17,0,False,False,False,0,2,2021-11-29T17:51:17.39,17,False,0.0
2021,12,3234,850,5,5220,13,5,5,10,0,0,0,0,0,0,False,False,False,0,3,2021-11-29T17:57:06.527,0,False,0.0
2021,12,3234,865,5,6372,13,17,1,23,0,0,0,0,0,0,False,False,False,0,3,2021-11-29T18:01:40.16,0,False,0.0
2021,12,3235,15,31,2865,2,39,4,4,8,4,6,2,6,0,False,False,False,0,3,2021-11-29T10:21:27.997,8,False,2.0
2021,12,3235,40,19,7175,13,42,4,6,0,0,0,0,0,0,False,False,False,0,3,2021-11-30T19:17:39.963,0,False,
2021,12,3235,60,19,4282,13,6,9,10,0,0,0,0,0,0,False,False,False,0,4,2021-12-01T14:12:41.693,0,False,0.0
2021,12,3235,65,19,1212,2,48,9,-3,11,14,4,7,4,0,False,False,False,1,1,2021-12-01T13:21:30.753,11,False,7.0
2021,12,3235,80,19,4912,2,7,5,4,4,0,4,0,4,6,False,False,False,0,3,2021-11-29T10:38:39.297,4,True,0.0
2021,12,3235,105,31,2901,2,4,4,9,10,1,9,1,9,0,False,False,False,0,4,2021-11-29T10:43:57.453,10,False,1.0
2021,12,3235,120,31,3911,2,4,5,2,2,0,2,0,2,0,False,False,False,0,2,2021-11-29T10:48:46.773,2,False,0.0
2021,12,3235,140,31,4834,2,6,10,7,14,7,9,5,9,0,False,False,False,0,2,2021-12-01T13:00:35.19,14,False,5.0
2021,12,3235,150,31,4834,2,45,5,-2,8,10,0,8,0,0,False,False,False,1,3,2021-11-29T10:58:30.437,8,False,8.0
2021,12,3235,175,31,7913,2,49,9,-2,1,3,1,0,1,6,False,False,False,0,2,2021-11-29T11:02:47.283,1,False,0.0
2021,12,3235,190,19,7175,2,7,7,20,22,2,22,0,22,0,False,False,False,0,3,2021-11-29T11:29:33.11,22,False,0.0
2021,12,3235,195,19,7175,2,26,9,3,20,17,16,4,16,0,False,False,False,1,3,2021-11-29T11:31:22.25,20,False,4.0
2021,12,3235,200,19,5096,2,35,10,12,16,4,15,1,15,0,False,False,False,0,4,2021-11-29T11:32:26.233,16,False,1.0
2021,12,3235,205,19,5096,2,32,5,0,13,13,6,7,6,0,False,False,False,0,4,2021-11-29T11:34:01.863,13,False,7.0
2021,12,3235,220,19,4282,13,13,5,4,0,0,0,0,0,0,False,False,False,0,4,2021-11-29T11:37:08.04,0,False,0.0
2021,12,3235,240,31,6722,2,47,5,2,2,0,2,0,2,0,False,False,False,0,1,2021-11-29T11:40:50.983,2,False,0.0
2021,12,3235,260,31,4844,2,45,10,-4,3,7,-1,4,-1,0,False,False,False,0,1,2021-11-29T11:44:52.51,3,False,4.0
2021,12,3235,265,31,3911,13,21,6,17,0,0,0,0,0,0,True,False,False,0,3,2021-11-29T11:46:02.66,0,False,0.0
2021,12,3235,275,19,7172,2,48,9,-2,12,14,9,3,9,0,False,False,False,0,1,2021-11-29T11:49:31.383,12,False,3.0
2021,12,3235,285,19,7175,2,8,6,34,38,4,38,0,38,0,False,False,False,0,3,2021-12-01T12:43:24.263,38,False,0.0
2021,12,3235,290,19,8493,13,9,3,11,0,0,0,0,0,0,False,False,False,0,1,2021-11-30T19:17:55.427,0,False,0.0
2021,12,3235,300,19,2256,2,4,3,5,5,0,4,1,4,0,False,False,False,0,2,2021-11-29T11:56:24.18,5,False,1.0
2021,12,3235,320,31,7913,2,21,2,23,24,1,23,1,23,0,False,False,False,0,3,2021-11-29T11:59:24.05,24,False,1.0
2021,12,3235,330,31,3911,13,49,9,1,0,0,0,0,0,0,False,False,False,0,2,2021-11-29T12:00:42.767,0,False,0.0
2021,12,3235,340,19,1212,2,47,10,1,19,18,10,9,10,0,False,False,False,1,1,2021-11-29T12:03:37.163,19,False,9.0
2021,12,3235,345,19,4912,2,5,5,5,5,0,5,0,5,0,False,False,False,0,3,2021-11-29T12:04:48.797,5,False,0.0
2021,12,3235,350,19,7175,13,35,8,19,0,0,0,0,0,0,False,False,False,0,2,2021-11-29T12:06:32.617,0,False,0.0
2021,12,3235,355,19,1212,2,45,5,-3,3,6,2,1,2,0,False,False,False,0,1,2021-11-29T12:07:49.367,3,False,1.0
2021,12,3235,360,19,4282,13,7,2,25,0,0,0,0,0,0,False,False,False,0,4,2021-12-01T14:15:19.237,0,False,0.0
2021,12,3235,375,31,6724,2,33,4,1,7,6,4,3,4,0,False,False,False,0,4,2021-12-01T14:15:58.21,7,False,3.0
2021,12,3235,385,31,7913,13,6,4,14,0,0,0,0,0,0,False,False,False,0,3,2021-11-29T12:15:43.087,0,False,0.0
2021,12,3235,405,19,1212,2,48,9,-3,21,24,19,2,19,0,False,False,False,0,1,2021-11-29T12:20:09.15,21,False,2.0
2021,12,3235,415,19,2256,2,5,3,11,10,-1,10,0,10,0,False,False,False,0,2,2021-12-01T12:43:24.263,10,False,0.0
2021,12,3235,430,19,4912,2,5,3,6,7,1,7,0,7,0,True,False,False,0,3,2021-11-29T12:23:28.13,7,False,0.0
2021,12,3235,435,19,7175,13,5,5,7,0,0,0,0,0,0,False,False,False,0,2,2021-11-29T12:25:01.2,0,False,0.0
2021,12,3235,465,19,5096,2,35,10,9,20,11,16,4,16,0,False,False,False,0,3,2021-11-29T12:55:51.973,20,False,4.0
2021,12,3235,480,19,4912,13,51,9,-5,0,0,0,0,0,0,True,False,False,0,1,2021-11-29T12:59:00.33,0,False,0.0
2021,12,3235,485,19,5096,13,5,10,7,0,0,0,0,0,0,False,False,False,0,3,2021-11-29T13:00:03.687,0,False,0.0
2021,12,3235,515,19,4282,2,38,10,0,9,9,5,4,5,0,False,False,False,0,4,2021-11-29T13:07:13.287,9,False,4.0
2021,12,3235,530,19,7175,13,17,7,17,0,0,0,0,0,0,True,False,False,0,3,2021-11-30T19:18:08.17,0,False,0.0
2021,12,3235,545,31,7913,13,4,10,5,0,0,0,0,0,0,False,False,False,0,2,2022-03-03T13:36:44.98,0,False,0.0
2021,12,3235,555,31,4834,13,5,3,8,0,0,0,0,0,0,False,False,False,0,2,2021-11-29T13:17:20.637,0,False,0.0
2021,12,3235,565,19,7175,2,26,5,5,11,6,9,2,9,0,False,False,False,0,3,2021-11-29T13:19:13.827,11,False,2.0
2021,12,3235,575,19,2256,2,6,9,5,5,0,5,0,5,0,False,False,False,0,2,2021-11-29T13:21:56.963,5,False,0.0
2021,12,3235,580,19,4912,2,13,10,4,41,37,24,17,24,6,False,False,False,2,3,2021-12-01T12:43:24.263,41,False,17.0
2021,12,3235,630,31,8331,2,5,5,14,14,0,14,0,14,0,False,False,False,0,2,2021-11-29T13:37:16.203,14,True,0.0
2021,12,3235,660,31,2901,13,7,5,4,0,0,0,0,0,0,False,False,False,0,2,2021-11-29T13:47:34.463,0,False,0.0
2021,12,3235,670,31,4834,13,35,10,2,0,0,0,0,0,0,False,False,False,0,3,2021-12-01T14:17:49.583,0,False,0.0
2021,12,3235,680,19,4912,2,5,5,4,4,0,4,0,4,0,False,False,False,0,3,2021-11-29T13:52:38.053,4,True,0.0
2021,12,3235,685,19,4282,2,6,10,7,7,0,7,0,7,0,False,False,False,0,4,2021-11-29T13:53:47.213,7,False,0.0
2021,12,3235,715,19,7175,2,13,9,6,7,1,7,0,7,0,False,False,False,0,3,2021-11-29T14:02:25.49,7,False,0.0
2021,12,3235,730,31,6722,13,28,10,0,0,0,0,0,0,0,False,False,False,0,1,2021-11-29T14:05:41.66,0,False,0.0
2021,12,3235,740,31,7913,13,8,1,21,0,0,0,0,0,0,False,False,False,0,2,2021-12-01T13:08:51.437,0,False,0.0
2021,12,3235,745,31,7913,13,4,10,14,0,0,0,0,0,0,False,False,False,0,2,2021-11-29T14:15:35,0,False,0.0
2021,12,3236,10,7,4679,2,44,3,-4,5,9,3,2,3,0,False,False,False,0,1,2021-11-30T15:59:14.257,5,False,2.0
2021,12,3236,25,7,8325,13,2,3,4,0,0,0,0,0,0,False,False,False,0,2,2022-02-17T19:05:00.82,0,False,
2021,12,3236,45,7,3521,2,5,3,9,9,0,9,0,9,0,False,False,False,0,3,2021-12-01T15:06:42.38,9,True,0.0
2021,12,3236,75,25,7060,2,35,5,10,11,1,11,0,11,0,False,False,False,0,3,2021-11-29T11:24:30.073,11,False,0.0
2021,12,3236,85,25,7666,13,24,2,18,0,0,0,0,0,0,False,False,False,0,4,2021-12-01T14:38:30.287,0,False,0.0
2021,12,3236,115,25,7666,2,19,2,36,41,5,36,5,36,0,False,False,False,0,2,2021-11-29T11:34:08.82,41,False,5.0
2021,12,3236,120,25,7060,2,3,3,9,7,-2,7,0,7,0,False,False,False,0,2,2021-11-30T17:18:31.73,7,False,
2021,12,3236,130,25,7060,2,4,9,3,0,-3,5,-5,5,0,False,False,False,0,3,2021-11-29T11:38:58.657,0,False,
2021,12,3236,135,25,8421,2,4,10,0,0,0,0,0,0,0,False,False,False,0,1,2021-11-29T11:40:43.057,0,False,0.0
2021,12,3236,140,25,7060,2,6,10,5,11,6,9,2,9,0,False,False,False,0,2,2021-12-01T13:09:46.89,11,False,2.0
2021,12,3236,150,25,7053,13,11,3,2,0,0,0,0,0,0,False,False,False,0,4,2021-11-29T11:44:06.163,0,False,0.0
2021,12,3236,155,25,7666,13,19,2,22,0,0,0,0,0,0,False,False,False,0,2,2022-02-17T19:05:17.353,0,False,0.0
2021,12,3236,175,7,8325,2,50,3,-3,5,8,3,2,3,0,True,False,False,0,2,2021-12-01T13:41:33.333,5,False,2.0
2021,12,3236,180,7,7659,2,6,4,13,16,3,14,2,14,0,False,False,False,0,2,2021-11-29T14:45:17.287,16,False,2.0
2021,12,3236,185,7,3521,2,4,10,2,4,2,3,1,3,0,False,False,False,0,2,2021-11-29T11:51:22.057,4,False,1.0
2021,12,3236,195,7,8317,2,51,9,-5,12,17,8,4,8,0,True,False,False,0,1,2021-12-01T14:28:09.86,12,False,4.0
2021,12,3236,200,7,7659,2,19,2,32,32,0,32,0,32,6,False,False,False,0,2,2021-11-29T14:45:57.417,32,True,0.0
2021,12,3236,225,25,8422,2,46,3,0,7,7,2,5,2,0,False,False,False,1,4,2021-11-29T12:01:55.833,7,False,5.0
2021,12,3236,230,25,7666,2,38,4,8,11,3,11,0,11,0,True,False,False,0,3,2021-11-29T12:03:38.26,11,False,0.0
2021,12,3236,240,25,7060,13,19,2,28,0,0,0,0,0,0,False,False,False,0,2,2021-11-30T17:19:02.843,0,False,0.0
2021,12,3236,245,25,6328,2,13,9,2,2,0,2,0,2,0,False,False,False,1,3,2021-12-01T14:58:20.267,2,False,0.0
2021,12,3236,255,7,8317,2,49,9,-4,11,15,-3,14,-3,0,True,False,False,1,2,2021-12-01T14:39:26.093,11,False,14.0
2021,12,3236,270,7,7659,2,5,2,16,16,0,16,0,16,0,False,False,False,0,2,2021-11-29T14:46:21.453,16,True,0.0
2021,12,3236,280,7,6971,13,22,2,40,0,0,0,0,0,0,False,False,False,0,3,2021-11-29T12:16:55.86,0,False,0.0
2021,12,3236,285,7,2631,2,5,5,6,7,1,6,1,6,0,False,False,False,0,4,2021-12-07T20:21:31.587,7,False,1.0
2021,12,3236,350,25,7666,13,2,4,6,0,0,0,0,0,0,False,False,False,0,2,2021-11-29T12:32:00.757,0,False,0.0
2021,12,3236,360,7,7659,2,2,10,10,15,5,13,2,13,0,False,False,False,0,2,2021-11-29T14:46:44.65,15,False,2.0
2021,12,3236,365,7,7659,2,3,5,14,16,2,15,1,15,0,False,False,False,0,2,2021-11-29T12:35:10.333,16,False,1.0
2021,12,3236,370,7,2631,2,47,5,3,6,3,5,1,5,0,False,False,False,0,4,2021-11-29T12:36:13.93,6,False,1.0
2021,12,3236,385,7,4679,2,32,10,-6,0,6,0,0,0,0,False,False,False,0,1,2021-11-29T12:39:00.68,0,False,0.0
2021,12,3236,390,7,3521,2,5,3,14,14,0,14,0,14,0,False,False,False,0,3,2021-11-29T12:40:34.597,14,True,
2021,12,3236,395,7,7659,13,19,2,33,0,0,0,0,0,0,False,False,False,0,2,2021-12-01T14:38:47.813,0,False,0.0
2021,12,3236,400,25,6486,13,5,3,3,0,0,0,0,0,0,False,False,False,0,3,2021-12-01T14:39:01.58,0,False,0.0
2021,12,3236,415,25,8421,3,46,3,2,0,0,0,0,0,0,False,False,False,0,3,2021-11-29T12:46:43.647,0,False,0.0
2021,12,3236,440,25,8421,13,44,3,-5,0,0,0,0,0,0,False,False,False,0,1,2021-11-29T13:03:08.8,0,False,0.0
2021,12,3236,445,25,7060,2,7,6,16,15,-1,16,-1,16,0,False,False,False,0,3,2022-02-17T19:05:40.79,15,False,-1.0
2021,12,3236,450,25,7060,13,5,3,2,0,0,0,0,0,0,False,False,False,0,2,2021-12-01T14:28:47.067,0,False,0.0
2021,12,3236,455,25,6486,2,13,9,2,3,1,2,1,2,0,False,False,False,0,3,2021-11-29T13:04:08.697,3,False,1.0
2021,12,3236,485,7,2631,2,53,10,-3,-4,-1,-4,0,-4,0,False,False,False,0,3,2021-11-29T13:11:03.667,-4,False,0.0
2021,12,3236,490,7,4679,2,52,10,0,0,0,0,0,0,0,False,False,False,0,3,2021-12-01T13:34:26.51,0,False,0.0
2021,12,3236,505,25,7060,2,13,10,0,10,10,2,8,2,0,False,False,False,1,3,2021-11-29T13:15:48.897,10,False,8.0
2021,12,3236,510,25,6277,3,47,5,-2,0,0,0,0,0,0,False,False,False,0,1,2021-11-29T13:16:37.833,0,False,0.0
2021,12,3236,515,25,8421,2,47,10,0,12,12,0,12,0,0,False,False,False,2,1,2021-12-01T14:39:39.947,12,False,12.0
2021,12,3236,530,7,4679,2,50,3,-3,-7,-4,-5,-2,-5,0,True,False,False,0,2,2021-12-01T13:41:43.48,-7,False,-2.0
2021,12,3236,535,7,8317,2,4,7,17,16,-1,16,0,16,0,False,False,False,0,2,2021-11-29T14:50:57.217,16,False,0.0
2021,12,3236,550,7,7659,13,4,9,10,0,0,0,0,0,0,False,False,False,0,2,2021-11-29T13:27:10.827,0,False,0.0
2021,12,3236,575,25,7060,13,50,3,-2,0,0,0,0,0,0,False,False,False,0,2,2021-12-01T13:09:46.937,0,False,0.0
2021,12,3236,580,25,8421,2,45,10,-3,2,5,1,1,1,0,False,False,False,0,1,2021-12-01T13:09:46.937,2,False,1.0
2021,12,3236,605,7,4455,2,31,9,1,12,11,10,2,10,0,False,False,False,0,1,2021-11-29T13:50:11.8,12,False,2.0
2021,12,3236,610,7,7659,2,35,9,11,19,8,17,2,17,0,False,False,False,0,3,2021-11-29T13:52:21.913,19,False,2.0
2021,12,3236,630,25,7666,13,4,9,11,0,0,0,0,0,0,False,False,False,0,3,2021-12-01T15:10:03.8,0,False,0.0
2021,12,3236,635,25,7060,13,2,10,4,0,0,0,0,0,0,False,False,False,0,2,2022-02-17T00:29:03.233,0,False,0.0
2021,12,3236,640,25,7666,2,19,2,26,30,4,26,4,26,0,False,False,False,0,2,2021-11-29T13:58:56.77,30,False,4.0
2021,12,3236,650,25,7060,2,4,3,6,7,1,7,0,7,0,False,False,False,0,2,2021-11-29T14:00:39.983,7,False,
2021,12,3236,655,25,7666,3,3,3,13,0,0,0,0,0,0,False,False,False,0,2,2021-11-29T14:02:17.58,0,False,0.0
2021,12,3236,660,25,8422,2,6,9,3,9,6,5,4,5,0,False,False,False,1,2,2021-11-29T14:03:44.977,9,False,4.0
2021,12,3236,700,7,3445,13,4,5,7,0,0,0,0,0,0,False,False,False,0,2,2021-11-29T14:12:10.65,0,False,0.0
2021,12,3236,710,25,7060,2,6,9,14,16,2,15,1,15,0,False,False,False,0,2,2021-11-29T14:13:50.417,16,False,1.0
2021,12,3236,725,25,7060,2,12,3,4,13,9,13,0,13,0,False,False,False,0,2,2021-12-01T13:14:58.263,13,True,0.0
2021,12,3236,735,25,8422,2,4,10,9,9,0,9,0,9,0,False,False,False,0,3,2021-11-29T14:19:50.76,9,False,0.0
2021,12,3236,740,25,7060,2,6,9,2,6,4,5,1,5,0,False,False,False,0,2,2021-12-01T13:09:46.937,6,False,1.0
2021,12,3236,745,25,7060,2,26,3,2,8,6,7,1,7,0,False,False,False,0,2,2021-11-29T14:22:01.073,8,False,1.0
2021,12,3236,750,25,8422,2,9,2,15,15,0,15,0,15,6,False,False,False,0,2,2021-11-29T14:23:12.82,15,True,0.0
2021,12,3236,795,25,6277,2,6,10,2,6,4,4,2,4,0,False,False,False,0,1,2021-12-01T13:09:46.937,6,False,2.0
2021,12,3236,810,25,7060,2,4,10,4,5,1,5,0,5,0,False,False,False,1,2,2021-11-29T14:36:38.277,5,True,0.0
2021,12,3236,820,25,7053,2,32,9,2,10,8,8,2,8,0,False,False,False,0,4,2021-12-01T13:09:46.937,10,False,2.0
2021,12,3236,830,25,7060,13,19,2,24,0,0,0,0,0,0,False,False,False,0,2,2021-11-29T14:40:05.713,0,False,0.0
2021,12,3236,835,25,7665,2,46,3,0,11,11,9,2,9,0,False,False,False,0,1,2021-11-29T14:41:26.107,11,False,2.0
2021,12,3237,10,2,2835,2,46,3,1,6,5,6,0,6,0,True,False,False,1,1,2021-11-30T23:04:19.9,6,False,0.0
2021,12,3237,25,2,6247,2,5,5,3,9,6,6,3,6,0,False,False,False,0,3,2021-11-29T17:11:02.73,9,False,3.0
2021,12,3237,30,2,6247,13,4,9,6,0,0,0,0,0,0,False,False,False,0,3,2021-12-01T17:22:58.637,0,False,0.0
2021,12,3237,40,2,811,2,46,3,1,7,6,3,4,3,0,True,False,False,0,1,2022-02-17T16:30:04.57,7,False,4.0
2021,12,3237,55,2,2554,13,6,10,0,0,0,0,0,0,0,False,False,False,0,1,2021-11-29T04:30:02.497,0,False,0.0
2021,12,3237,70,15,7591,2,49,9,-4,1,5,0,1,0,0,True,False,False,1,2,2021-12-01T17:36:57.187,1,False,1.0
2021,12,3237,75,15,7591,2,30,5,6,11,5,10,1,10,0,True,False,False,0,4,2021-11-29T17:31:04.453,11,False,1.0
2021,12,3237,90,15,914,2,5,5,5,5,0,5,0,5,0,False,False,False,0,3,2021-11-29T04:59:08.083,5,False,0.0
2021,12,3237,110,15,7591,13,4,5,14,0,0,0,0,0,0,False,False,False,0,3,2021-11-29T05:04:37.6,0,False,0.0
2021,12,3237,130,2,2554,2,32,5,-2,18,20,14,4,14,0,False,False,False,0,1,2021-12-01T16:32:08.927,18,False,4.0
2021,12,3237,150,2,3506,2,35,10,10,13,3,11,2,11,0,False,False,False,0,3,2021-11-29T05:16:18.067,13,False,2.0
2021,12,3237,195,15,5152,2,5,9,4,9,5,4,5,4,0,False,False,False,0,3,2021-11-29T05:25:33.797,9,False,5.0
2021,12,3237,210,15,914,13,7,6,33,0,0,0,0,0,0,False,False,False,0,3,2021-12-06T19:34:24.53,0,False,0.0
2021,12,3237,220,2,7540,2,12,10,2,7,5,4,3,4,0,False,False,False,0,4,2022-02-24T17:31:18.547,7,False,3.0
2021,12,3237,225,2,2554,2,28,9,-5,0,5,-3,3,-3,0,False,False,False,0,1,2021-12-01T16:28:54.913,0,False,3.0
2021,12,3237,250,2,811,13,4,3,4,0,0,0,0,0,0,False,False,False,0,3,2021-12-01T16:29:05.683,0,False,0.0
2021,12,3237,260,15,8099,2,28,4,5,8,3,6,2,6,0,False,False,False,0,1,2021-11-29T05:43:56.13,8,False,2.0
2021,12,3237,270,2,8389,13,5,5,5,0,0,0,0,0,0,True,False,False,0,2,2021-12-01T16:54:14.053,0,False,0.0
2021,12,3237,275,2,3506,13,5,5,9,0,0,0,0,0,0,False,False,False,0,2,2021-12-01T16:54:42.87,0,False,0.0
2021,12,3237,280,2,6247,2,13,10,1,4,3,3,1,3,0,False,False,False,0,3,2021-12-01T17:23:26.797,4,False,1.0
2021,12,3237,310,15,3750,2,13,10,5,11,6,6,5,6,0,False,False,False,0,4,2021-12-01T17:03:54.947,11,False,5.0
2021,12,3237,315,15,3750,13,5,3,10,0,0,0,0,0,0,False,False,False,0,4,2021-12-01T17:22:05.7,0,False,0.0
2021,12,3237,325,15,7591,2,52,4,4,24,20,20,4,20,0,False,False,False,0,3,2021-12-01T17:23:42.317,24,False,4.0
2021,12,3237,345,15,7591,2,44,3,-5,-1,4,-3,2,-3,0,True,False,False,0,1,2021-12-01T15:29:06.58,-1,False,2.0
2021,12,3237,355,15,914,2,35,6,20,21,1,21,0,21,0,False,False,False,0,3,2021-11-29T17:42:09.52,21,False,0.0
2021,12,3237,360,15,7591,2,51,10,-1,-2,-1,-1,-1,-1,0,False,False,False,0,3,2021-11-29T17:20:05.303,-2,False,-1.0
2021,12,3237,370,15,4886,13,5,5,7,0,0,0,0,0,0,False,False,False,0,3,2021-11-29T06:11:53.207,0,False,0.0
2021,12,3237,375,15,4179,2,12,9,5,8,3,6,2,6,0,False,False,False,1,2,2021-12-01T16:33:01.973,8,False,2.0
2021,12,3237,395,2,2554,2,31,4,1,7,6,5,2,5,0,False,False,False,0,1,2021-11-30T23:04:37.313,7,False,2.0
2021,12,3237,400,2,8389,13,5,2,19,0,0,0,0,0,0,False,False,False,0,3,2021-12-01T16:29:47.257,0,False,0.0
2021,12,3237,405,15,914,2,2,5,8,9,1,9,0,9,0,False,False,False,0,2,2021-11-29T06:19:08.917,9,False,0.0
2021,12,3237,420,15,4179,13,12,6,19,0,0,0,0,0,0,False,False,False,0,2,2021-12-01T16:33:28.637,0,False,0.0
2021,12,3237,450,15,957,2,39,4,5,14,9,5,9,5,0,False,False,False,1,3,2021-11-29T14:13:36.273,14,False,9.0
2021,12,3237,465,15,914,13,2,10,3,0,0,0,0,0,0,False,False,False,0,2,2021-11-29T14:17:36.5,0,False,0.0
2021,12,3237,475,2,6247,2,39,4,7,15,8,13,2,13,0,False,False,False,0,3,2021-12-01T17:22:35.47,15,False,2.0
2021,12,3237,485,2,2835,2,46,3,-1,10,11,1,9,1,0,True,False,False,1,1,2021-11-29T14:25:08.77,10,False,9.0
2021,12,3237,490,2,811,2,4,5,3,20,17,3,17,3,0,False,False,False,1,2,2021-12-01T16:34:06.533,20,False,17.0
2021,12,3237,500,2,8389,2,6,10,7,19,12,14,5,14,0,False,False,False,0,2,2021-11-29T14:31:14.997,19,False,5.0
2021,12,3237,510,2,7303,2,50,10,-1,5,6,2,3,2,0,False,False,False,0,3,2021-12-01T16:27:29.85,5,False,3.0
2021,12,3237,515,2,6247,2,2,9,9,12,3,12,0,12,6,True,False,False,0,2,2021-12-01T17:10:40.003,12,True,0.0
2021,12,3237,535,15,914,13,35,8,19,0,0,0,0,0,0,False,False,False,0,2,2021-11-29T14:42:16.54,0,False,0.0
2021,12,3237,540,15,2757,2,32,10,-4,5,9,3,2,3,0,False,False,False,0,4,2021-11-29T14:43:45.407,5,False,2.0
2021,12,3237,570,15,4179,2,35,6,15,14,-1,14,0,14,0,False,False,False,1,3,2021-12-01T17:19:00.607,14,False,0.0
2021,12,3237,575,15,8099,2,48,10,-5,-5,0,-5,0,-5,0,False,False,False,0,1,2021-11-29T14:52:38.77,-5,False,0.0
2021,12,3237,590,15,4179,13,19,2,29,0,0,0,0,0,0,False,False,False,0,2,2021-11-29T14:56:24.703,0,False,0.0
2021,12,3237,605,15,2757,2,17,8,19,21,2,20,1,20,0,False,False,False,0,3,2021-11-29T17:27:52.09,21,False,1.0
2021,12,3237,610,15,957,2,8,10,7,7,0,7,0,7,6,False,False,False,0,2,2021-12-01T15:29:06.597,7,True,0.0
2021,12,3237,635,2,6247,2,39,4,7,8,1,7,1,7,0,False,False,False,0,3,2021-11-29T17:13:46.41,8,False,1.0
2021,12,3237,640,2,6247,2,18,5,-1,14,15,1,13,1,0,False,False,False,1,2,2021-12-01T16:27:45.043,14,False,13.0
2021,12,3237,650,2,8389,13,13,9,4,0,0,0,0,0,0,False,False,False,0,3,2021-12-01T15:29:06.597,0,False,0.0
2021,12,3237,655,2,8389,13,13,9,4,0,0,0,0,0,0,False,False,False,0,4,2021-12-01T17:11:13.533,0,False,0.0
2021,12,3237,665,15,4179,2,51,3,-2,11,13,9,2,9,0,False,False,False,0,3,2022-02-17T16:32:37.42,11,False,2.0
2021,12,3237,675,15,8099,2,5,3,4,26,22,5,21,5,0,False,False,False,1,1,2021-12-01T15:29:06.597,26,False,21.0
2021,12,3237,695,15,4179,2,4,5,8,20,12,13,7,13,0,False,False,False,0,2,2021-11-29T17:46:56.337,20,False,7.0
2021,12,3237,735,15,4179,13,12,2,16,0,0,0,0,0,0,True,False,False,0,2,2021-11-29T15:53:49.62,0,False,0.0
2021,12,3237,740,15,7591,13,12,2,16,0,0,0,0,0,0,False,False,False,0,2,2021-12-01T17:37:47.943,0,False,0.0
2021,12,3237,765,2,3506,2,4,3,8,9,1,8,1,8,0,False,False,False,0,2,2021-11-29T15:59:40.933,9,False,1.0
2021,12,3237,770,2,8389,2,2,10,6,7,1,6,1,6,0,False,False,False,0,2,2021-11-29T16:01:22.493,7,False,1.0
2021,12,3237,810,2,7303,13,2,10,2,0,0,0,0,0,0,False,False,False,0,2,2021-11-29T16:11:11.963,0,False,0.0
2021,12,3237,830,15,2757,2,51,10,0,3,3,3,0,3,0,False,False,False,0,3,2021-12-01T16:28:30.587,3,False,0.0
2021,12,3237,840,15,8099,13,5,9,5,0,0,0,0,0,0,False,False,False,0,1,2021-11-29T16:16:50.267,0,False,0.0
2021,12,3237,845,15,914,2,4,3,8,8,0,8,0,8,0,False,False,False,0,2,2021-12-01T16:30:57.21,8,False,0.0
2021,12,3237,850,15,2757,13,17,1,15,0,0,0,0,0,0,False,False,False,0,3,2021-11-29T16:19:46.25,0,False,0.0
2021,12,3237,855,15,153,3,28,9,-1,0,0,0,0,0,0,False,False,False,0,1,2021-11-29T16:21:13.95,0,False,0.0
2021,12,3237,860,15,4179,13,35,4,14,0,0,0,0,0,0,False,False,False,0,3,2021-12-01T15:50:25.873,0,False,0.0
2021,12,3237,865,15,7591,13,4,8,16,0,0,0,0,0,0,False,False,False,0,3,2021-11-29T16:23:59.787,0,False,0.0
2021,12,3238,10,10,6840,2,46,3,2,3,1,3,0,3,0,False,False,False,0,4,2021-11-29T10:28:58.65,3,False,0.0
2021,12,3238,25,10,6840,13,35,6,19,0,0,0,0,0,0,False,False,False,0,4,2021-11-29T10:41:23.67,0,False,0.0
2021,12,3238,30,10,7700,2,2,10,5,13,8,7,6,7,0,True,False,False,1,3,2021-11-29T10:45:28.537,13,False,6.0
2021,12,3238,40,10,7703,13,12,2,20,0,0,0,0,0,0,False,False,False,0,4,2022-02-24T17:34:26.58,0,False,0.0
2021,12,3238,55,10,8541,13,46,3,4,0,0,0,0,0,0,False,False,False,0,1,2021-11-29T11:04:07.147,0,False,0.0
2021,12,3238,70,26,8552,2,5,5,7,7,0,7,0,7,0,False,False,False,0,2,2021-11-29T11:12:36.693,7,True,0.0
2021,12,3238,85,10,4930,2,6,1,18,19,1,18,1,18,0,False,False,False,0,2,2021-11-29T11:35:29.06,19,False,1.0
2021,12,3238,110,10,6281,2,4,9,4,5,1,4,1,4,0,False,False,False,0,3,2021-11-29T11:44:46.39,5,False,1.0
2021,12,3238,135,26,4619,13,24,2,24,0,0,0,0,0,0,False,False,False,0,3,2022-02-17T00:42:27.733,0,False,0.0
2021,12,3238,145,26,958,13,12,5,11,0,0,0,0,0,0,False,False,False,0,4,2021-12-01T21:53:17.277,0,False,0.0
2021,12,3238,155,10,4930,2,46,3,3,7,4,5,2,5,0,True,False,False,0,3,2021-11-30T20:10:21.823,7,False,2.0
2021,12,3238,160,10,7703,2,32,5,0,12,12,8,4,8,0,False,False,False,0,4,2021-11-29T12:12:54.95,12,False,4.0
2021,12,3238,165,10,7700,13,5,4,2,0,0,0,0,0,0,False,False,False,0,3,2022-02-17T00:43:20.923,0,False,0.0
2021,12,3238,170,10,6840,2,5,5,6,7,1,6,1,6,0,False,False,False,0,3,2021-11-29T12:32:49.77,7,False,1.0
2021,12,3238,205,10,4930,13,6,4,9,0,0,0,0,0,0,False,False,False,0,2,2022-02-17T18:48:52.977,0,False,0.0
2021,12,3238,230,26,8553,13,4,9,6,0,0,0,0,0,0,False,False,False,0,4,2021-11-29T12:56:28.207,0,False,0.0
2021,12,3238,235,26,4619,2,29,6,18,27,9,23,4,23,0,False,False,False,0,3,2021-12-01T23:22:11.29,27,False,
2021,12,3238,240,26,309,2,7,2,22,24,2,24,0,24,0,False,False,False,0,2,2021-11-29T13:02:10.663,24,False,0.0
2021,12,3238,250,26,309,2,44,3,-4,-2,2,-2,0,-2,0,False,False,False,0,3,2021-11-29T13:10:00.48,-2,False,0.0
2021,12,3238,255,26,4616,2,16,4,5,10,5,7,3,7,0,False,False,False,0,1,2021-12-01T22:54:50.747,10,False,3.0
2021,12,3238,260,26,4050,2,47,5,1,5,4,5,0,5,0,False,False,False,0,4,2021-11-29T13:14:13.477,5,False,0.0
2021,12,3238,270,26,958,2,31,9,5,9,4,6,3,6,0,False,False,False,0,4,2021-11-29T13:21:01.09,9,False,3.0
2021,12,3238,285,26,309,13,2,9,5,0,0,0,0,0,0,True,False,False,0,3,2021-11-29T13:24:51.78,0,False,0.0
2021,12,3238,300,10,282,2,51,10,-1,5,6,4,1,4,0,True,False,False,0,1,2021-12-01T23:41:41.457,5,False,1.0
2021,12,3238,310,26,8175,3,47,4,0,0,0,0,0,0,0,False,False,False,0,1,2021-12-01T23:23:30.753,0,False,0.0
2021,12,3238,315,26,4619,2,4,10,9,13,4,9,4,9,0,False,False,False,0,2,2021-11-29T13:46:37.477,13,False,4.0
2021,12,3238,330,26,309,13,32,9,-2,0,0,0,0,0,0,False,False,False,0,3,2021-11-29T13:51:09.547,0,False,0.0
2021,12,3238,355,10,6281,13,9,6,21,0,0,0,0,0,0,False,False,False,0,2,2021-12-01T22:59:13.31,0,False,
2021,12,3238,360,10,6840,2,32,10,1,2,1,1,1,1,0,False,False,False,0,4,2022-02-17T00:43:52.15,2,False,1.0
2021,12,3238,365,10,7938,13,12,5,0,0,0,0,0,0,0,False,False,False,0,3,2021-12-01T22:58:31.417,0,False,0.0
2021,12,3238,370,26,4616,2,16,9,5,6,1,5,1,5,0,False,False,False,0,1,2021-11-29T14:04:50.8,6,False,1.0
2021,12,3238,385,26,309,2,5,2,16,18,2,18,0,18,0,False,False,False,0,3,2021-11-29T14:08:42.68,18,True,0.0
2021,12,3238,390,26,309,2,39,4,8,14,6,10,4,10,0,False,False,False,0,3,2021-12-01T23:15:48.887,14,False,4.0
2021,12,3238,400,26,4616,3,16,10,5,0,0,0,0,0,0,False,False,False,0,1,2021-12-01T23:13:08.99,0,False,0.0
2021,12,3238,405,26,4616,2,16,10,2,12,10,10,2,10,6,True,False,False,0,1,2021-11-29T14:14:13.73,12,False,2.0
2021,12,3238,440,10,7700,2,6,10,10,12,2,11,1,11,0,False,False,False,0,3,2021-11-29T14:20:22.037,12,False,1.0
2021,12,3238,455,26,309,13,3,2,16,0,0,0,0,0,0,True,False,False,0,2,2021-11-29T14:23:44.62,0,False,
2021,12,3238,460,26,309,2,5,5,5,9,4,7,2,7,0,True,False,False,0,3,2021-11-29T14:26:09.333,9,False,2.0
2021,12,3238,465,26,4619,2,5,5,5,11,6,7,4,7,0,False,False,False,0,3,2021-12-01T23:11:29.603,11,False,4.0
2021,12,3238,475,26,4050,2,11,3,8,13,5,10,3,10,0,False,False,False,0,1,2021-12-01T23:24:04.06,13,False,3.0
2021,12,3238,485,26,309,13,26,5,9,0,0,0,0,0,0,False,False,False,0,3,2021-11-29T14:51:16.82,0,False,
2021,12,3238,490,26,7695,2,12,5,1,17,16,14,3,14,0,True,False,False,0,1,2022-02-24T17:34:51.09,17,False,3.0
2021,12,3238,505,26,4619,2,5,3,8,8,0,8,0,8,0,False,False,False,0,2,2021-12-01T23:25:29.92,8,False,0.0
2021,12,3238,540,10,6281,13,2,10,5,0,0,0,0,0,0,False,False,False,0,2,2021-11-29T15:06:20.76,0,False,0.0
2021,12,3238,545,10,282,13,51,9,-2,0,0,0,0,0,0,True,False,False,0,1,2021-11-30T20:13:28.09,0,False,0.0
2021,12,3238,555,26,4619,13,35,5,13,0,0,0,0,0,0,False,False,False,0,3,2021-11-29T15:24:40.82,0,False,0.0
2021,12,3238,580,26,7453,2,2,4,6,8,2,8,0,8,0,False,False,False,0,3,2021-11-29T15:34:26.1,8,False,0.0
2021,12,3238,590,26,4616,2,5,5,4,4,0,3,1,3,0,False,False,False,0,1,2021-12-01T23:30:19.823,4,False,1.0
2021,12,3238,595,26,4616,2,5,10,2,2,0,2,0,2,0,False,False,False,0,1,2021-12-01T21:05:48.89,2,False,0.0
2021,12,3238,600,26,309,13,24,3,11,0,0,0,0,0,0,True,False,False,0,3,2021-12-01T23:31:30.98,0,False,0.0
2021,12,3238,605,26,7453,2,12,5,1,15,14,2,13,2,0,False,False,False,1,3,2021-12-01T23:03:20.867,15,False,13.0
2021,12,3238,615,26,4619,13,12,5,5,0,0,0,0,0,0,False,False,False,0,2,2021-12-01T23:03:42.55,0,False,0.0
2021,12,3238,625,26,4616,2,48,9,-2,12,14,4,8,4,0,False,False,False,0,1,2021-11-29T15:57:08.343,12,False,
2021,12,3238,630,26,958,13,12,2,23,0,0,0,0,0,0,False,False,False,0,4,2021-12-01T23:32:05.48,0,False,0.0
2021,12,3238,635,10,8541,2,46,9,2,1,-1,2,-1,2,0,False,False,False,0,1,2021-11-29T16:01:22.767,1,False,-1.0
2021,12,3238,645,10,6281,2,5,3,12,12,0,12,0,12,0,False,False,False,0,3,2021-11-29T16:04:43.233,12,True,0.0
2021,12,3238,660,10,8541,2,48,9,-4,14,18,14,0,14,0,False,False,False,0,1,2021-11-29T16:08:31.733,14,False,0.0
2021,12,3238,665,10,8541,2,45,10,-4,42,46,2,40,2,0,False,False,False,2,1,2021-12-01T23:04:39.157,42,False,40.0
2021,12,3238,680,10,4702,2,12,5,1,1,0,1,0,1,6,False,False,False,0,4,2021-12-01T23:05:01.93,1,True,0.0
2021,12,3238,695,26,4619,2,5,5,7,7,0,7,0,7,0,False,False,False,0,2,2021-11-29T16:18:48.32,7,False,0.0
2021,12,3238,700,26,309,2,6,4,6,13,7,12,1,12,0,False,False,False,0,3,2021-12-01T21:05:48.89,13,False,1.0
2021,12,3238,705,26,958,13,5,5,5,0,0,0,0,0,0,False,False,False,0,3,2021-11-29T16:21:34.603,0,False,0.0
2021,12,3238,710,26,8552,2,5,5,5,18,13,15,3,15,0,False,False,False,0,3,2021-11-29T16:23:06.53,18,False,3.0
2021,12,3238,715,26,4616,3,18,5,7,0,0,0,0,0,0,True,False,False,0,2,2021-12-01T23:33:31.6,0,False,0.0
2021,12,3238,730,26,4616,2,28,10,0,34,34,20,14,20,0,False,False,False,2,1,2021-12-01T22:57:34.163,34,False,14.0
2021,12,3238,735,26,309,2,2,4,6,9,3,8,1,8,0,False,False,False,0,3,2021-11-29T16:32:08.743,9,False,1.0
2021,12,3238,740,26,7491,2,47,5,1,5,4,2,3,2,0,False,False,False,0,3,2021-11-29T16:33:34.397,5,False,3.0
2021,12,3238,745,26,7695,2,48,10,-7,-2,5,-4,2,-4,0,False,False,False,0,1,2021-11-29T16:35:15.147,-2,False,2.0
2021,12,3238,750,26,4619,13,6,10,11,0,0,0,0,0,0,False,False,False,0,2,2021-11-29T16:37:12.6,0,False,0.0
2021,12,3238,760,26,7695,3,16,9,5,0,0,0,0,0,0,False,False,False,0,1,2022-02-17T00:45:19.51,0,False,0.0
2021,12,3238,770,26,7453,13,9,2,16,0,0,0,0,0,0,False,False,False,0,2,2021-12-01T21:05:48.89,0,False,0.0
2021,12,3238,775,26,958,2,12,7,16,16,0,16,0,16,6,False,False,False,0,3,2021-11-29T16:49:52.437,16,True,0.0
2021,12,3239,20,29,7378,2,48,9,-4,4,8,3,1,3,0,False,False,False,0,1,2021-11-29T10:19:33.51,4,False,1.0
2021,12,3239,25,29,3398,13,38,10,9,0,0,0,0,0,0,False,False,False,0,3,2021-12-01T18:38:49.52,0,False,0.0
2021,12,3239,30,29,1067,13,13,10,0,0,0,0,0,0,0,False,False,False,0,3,2021-11-29T10:30:36.383,0,False,0.0
2021,12,3239,45,12,6357,2,4,10,4,8,4,6,2,6,0,False,False,False,0,3,2021-11-29T10:40:17.317,8,False,2.0
2021,12,3239,60,12,556,2,5,9,5,15,10,11,4,11,0,False,False,False,1,3,2021-11-29T10:48:36.013,15,False,4.0
2021,12,3239,65,12,7742,2,44,3,-5,0,5,0,0,0,0,False,False,False,0,1,2021-12-01T18:57:43.777,0,False,0.0
2021,12,3239,70,12,7742,2,48,10,0,2,2,1,1,1,0,False,False,False,0,1,2021-11-29T10:54:13.233,2,False,1.0
2021,12,3239,75,12,496,2,2,4,7,7,0,7,0,7,0,False,False,False,0,3,2021-11-29T11:12:34.07,7,False,0.0
2021,12,3239,95,12,556,2,2,9,5,7,2,5,2,5,0,False,False,False,1,2,2021-11-29T11:14:59.117,7,False,2.0
2021,12,3239,105,12,467,13,12,5,1,0,0,0,0,0,0,False,False,False,0,4,2021-12-01T16:33:09.633,0,False,0.0
2021,12,3239,110,12,6691,13,20,2,33,0,0,0,0,0,0,False,False,False,0,2,2022-02-17T00:53:50.117,0,False,0.0
2021,12,3239,135,12,556,2,49,10,-1,5,6,3,2,3,0,False,False,False,0,2,2022-02-17T00:54:38.7,5,False,2.0
2021,12,3239,165,29,7828,2,4,10,4,5,1,4,1,4,0,False,False,False,0,3,2021-11-29T11:54:37.983,5,False,1.0
2021,12,3239,190,12,7743,2,30,3,0,1,1,0,1,0,0,False,False,False,0,4,2021-11-29T18:37:18.6,1,False,1.0
2021,12,3239,215,29,3398,13,7,2,17,0,0,0,0,0,0,False,False,False,0,3,2021-12-01T18:52:38.563,0,False,0.0
2021,12,3239,220,29,7828,2,8,1,44,79,35,44,35,44,6,False,False,False,0,3,2022-02-17T18:37:45.03,79,False,35.0
2021,12,3239,235,12,6357,13,2,9,8,0,0,0,0,0,0,False,False,False,0,2,2021-11-29T12:32:15.293,0,False,0.0
2021,12,3239,245,12,496,2,17,7,16,54,38,17,37,17,0,False,False,False,1,3,2021-11-29T12:39:14.027,54,False,37.0
2021,12,3239,260,12,496,13,24,3,9,0,0,0,0,0,0,False,False,False,0,3,2021-11-29T12:47:26.927,0,False,0.0
2021,12,3239,280,29,1067,2,2,9,4,5,1,5,0,5,0,False,False,False,0,3,2021-11-29T12:56:02.32,5,False,0.0
2021,12,3239,285,29,1067,13,6,4,9,0,0,0,0,0,0,False,False,False,0,2,2021-11-29T12:57:56.62,0,False,0.0
2021,12,3239,300,29,7828,13,21,2,25,0,0,0,0,0,0,False,False,False,0,2,2022-02-17T00:55:15.34,0,True,0.0
2021,12,3239,310,29,1067,13,6,9,3,0,0,0,0,0,0,False,False,False,0,2,2021-11-29T13:10:43.74,0,False,0.0
2021,12,3239,325,12,496,2,44,3,-2,27,29,17,10,17,0,True,False,False,1,1,2022-02-17T00:55:44.9,27,False,10.0
2021,12,3239,340,12,556,2,19,6,29,43,14,43,0,43,0,False,False,False,0,3,2021-12-01T15:22:12.56,43,True,0.0
2021,12,3239,350,12,496,2,16,9,6,7,1,6,1,6,6,False,False,False,0,1,2021-12-01T18:39:15.34,7,False,1.0
2021,12,3239,365,29,6266,2,5,3,2,11,9,9,2,9,0,False,False,False,0,1,2021-12-01T15:22:12.56,11,False,2.0
2021,12,3239,380,29,4866,2,4,6,17,22,5,18,4,18,0,False,False,False,0,3,2021-11-29T13:52:19.923,22,False,4.0
2021,12,3239,385,29,3398,2,53,9,-2,3,5,1,2,1,0,False,False,False,0,4,2021-11-29T13:54:10.877,3,False,2.0
2021,12,3239,395,29,4866,2,2,4,7,19,12,17,2,17,0,False,False,False,0,3,2021-12-01T18:48:57.593,19,False,2.0
2021,12,3239,410,29,7378,2,16,9,6,6,0,6,0,6,6,False,False,False,0,1,2021-11-29T14:04:06.05,6,True,0.0
2021,12,3239,425,12,556,2,6,4,10,10,0,10,0,10,0,False,False,False,0,3,2021-11-29T14:08:15.787,10,False,0.0
2021,12,3239,430,12,6357,13,8,8,47,0,0,0,0,0,0,False,False,False,0,2,2021-12-01T15:13:09.52,0,False,0.0
2021,12,3239,435,12,6691,13,5,2,15,0,0,0,0,0,0,False,False,False,0,3,2021-11-29T14:13:51.3,0,False,0.0
2021,12,3239,440,12,6691,2,50,10,-1,6,7,4,2,4,0,False,False,False,0,3,2021-11-29T14:15:58.32,6,False,2.0
2021,12,3239,455,12,4537,13,6,4,2,0,0,0,0,0,0,False,False,False,0,1,2021-11-29T14:21:56.22,0,False,0.0
2021,12,3239,460,12,6691,2,5,5,7,7,0,7,0,7,0,False,False,False,0,2,2021-11-29T14:23:44.913,7,False,0.0
2021,12,3239,465,12,7743,13,6,4,13,0,0,0,0,0,0,False,False,False,0,3,2021-11-29T14:25:50.013,0,False,0.0
2021,12,3239,495,12,7742,2,46,3,1,8,7,3,5,3,0,False,False,False,0,1,2021-11-29T14:41:46.35,8,False,5.0
2021,12,3239,500,12,6357,2,7,2,24,28,4,28,0,28,0,False,False,False,0,3,2021-12-01T19:03:25.853,28,False,0.0
2021,12,3239,525,12,7742,2,45,5,-3,6,9,4,2,4,0,False,False,False,1,1,2021-11-29T14:57:12.607,6,False,2.0
2021,12,3239,535,12,556,2,5,3,6,6,0,6,0,6,0,False,False,False,0,2,2021-11-29T15:02:25.147,6,False,0.0
2021,12,3239,540,12,6357,13,19,2,21,0,0,0,0,0,0,False,False,False,0,2,2021-11-29T15:04:22.363,0,False,0.0
2021,12,3239,550,12,7743,2,4,9,7,12,5,10,2,10,0,False,False,False,0,3,2021-11-29T15:07:13,12,False,2.0
2021,12,3239,560,12,7742,2,16,9,0,5,5,2,3,2,6,False,False,False,1,1,2021-11-29T15:10:33.777,5,False,3.0
2021,12,3239,580,29,4866,13,6,4,4,0,0,0,0,0,0,False,False,False,0,3,2021-11-29T15:16:33.66,0,False,0.0
2021,12,3239,585,29,4866,13,12,6,25,0,0,0,0,0,0,False,False,False,0,3,2021-12-01T19:05:17.39,0,False,0.0
2021,12,3239,600,12,467,2,12,5,0,2,2,0,2,0,0,False,False,False,0,4,2021-12-01T16:33:25.05,2,False,2.0
2021,12,3239,605,12,6356,13,7,6,40,0,0,0,0,0,0,False,False,False,0,3,2022-02-17T18:37:17.127,0,False,0.0
2021,12,3239,615,12,556,2,2,10,7,9,2,9,0,9,0,False,False,False,0,2,2021-12-01T19:05:52.407,9,False,0.0
2021,12,3239,625,12,467,2,53,9,-3,2,5,2,0,2,0,False,True,False,0,4,2021-12-01T19:07:05.47,2,False,0.0
2021,12,3239,630,12,6691,13,8,9,11,0,0,0,0,0,0,False,False,False,0,3,2021-12-01T15:22:12.56,0,True,0.0
2021,12,3239,655,29,7828,13,4,6,20,0,0,0,0,0,0,False,False,False,0,2,2021-11-29T15:59:04.85,0,False,0.0
2021,12,3239,660,29,4866,13,26,9,5,0,0,0,0,0,0,True,False,False,0,3,2021-12-01T18:54:34.277,0,False,0.0
2021,12,3239,680,29,7378,2,4,10,0,1,1,0,1,0,0,False,False,False,0,1,2021-12-01T15:22:12.56,1,False,1.0
2021,12,3239,685,29,1067,2,4,5,8,8,0,8,0,8,0,False,False,False,0,2,2021-11-29T16:10:08.423,8,False,0.0
2021,12,3239,695,29,1067,13,4,7,15,0,0,0,0,0,0,False,False,False,0,2,2021-11-29T16:14:52.177,0,False,0.0
2021,12,3239,700,29,7828,2,39,4,6,9,3,7,2,7,0,False,False,False,0,3,2021-12-01T18:40:01.243,9,False,2.0
2021,12,3239,715,29,1067,2,20,6,34,54,20,54,0,54,6,False,False,False,0,2,2021-11-29T16:24:37.633,54,True,0.0
2021,12,3239,745,12,6357,2,4,9,6,8,2,8,0,8,0,False,False,False,0,3,2021-11-29T16:37:12.33,8,False,0.0
2021,12,3239,750,12,6357,2,5,5,3,6,3,5,1,5,0,False,False,False,0,3,2021-11-29T16:39:08.023,6,False,1.0
2021,12,3239,755,12,6357,13,5,3,13,0,0,0,0,0,0,False,False,False,0,2,2021-12-01T18:55:22.563,0,False,0.0
2021,12,3239,770,29,4866,2,5,5,4,13,9,4,9,4,0,False,False,False,1,3,2021-11-29T16:54:10.863,13,False,9.0
2021,12,3239,775,29,7828,13,6,1,19,0,0,0,0,0,0,False,False,False,0,2,2021-11-29T16:54:00.707,0,False,0.0
2021,12,3239,780,29,7378,2,47,5,2,7,5,5,2,5,0,False,False,False,0,3,2021-12-01T19:08:08.707,7,False,2.0
2021,12,3239,785,29,1067,13,19,2,24,0,0,0,0,0,0,False,False,False,0,2,2021-11-29T16:58:26.053,0,False,0.0
2021,12,3239,805,12,6356,2,5,5,6,7,1,7,0,7,0,False,False,False,0,2,2021-11-29T17:04:56.473,7,False,0.0
2021,12,3239,820,12,6357,13,24,2,34,0,0,0,0,0,0,False,False,False,0,3,2021-12-01T19:08:58.007,0,False,0.0
2021,12,3239,835,29,4866,2,4,9,10,10,0,10,0,10,0,False,False,False,0,3,2021-12-01T18:40:34.387,10,False,0.0
2021,12,3239,840,29,3398,13,7,2,15,0,0,0,0,0,0,False,False,False,0,3,2021-11-29T17:29:55.343,0,False,0.0
2021,12,3239,845,29,7828,3,5,2,16,0,0,0,0,0,0,False,False,False,0,2,2021-12-01T19:33:30.883,0,False,0.0
2021,12,3239,865,12,556,2,2,9,2,9,7,3,6,3,0,False,False,False,1,3,2022-02-17T00:57:20.537,9,False,6.0
2021,12,3239,900,12,556,13,2,4,8,0,0,0,0,0,0,False,False,False,0,3,2021-11-29T17:52:08.29,0,False,0.0
2021,12,3239,910,29,1067,2,4,5,4,7,3,6,1,6,0,False,False,False,0,2,2021-11-29T17:55:28.46,7,False,1.0
2021,12,3239,915,29,4866,2,5,5,5,7,2,6,1,6,0,False,False,False,0,3,2021-11-29T17:57:32.3,7,False,1.0
2021,12,3239,920,29,1067,2,2,10,5,7,2,6,1,6,0,False,False,False,0,2,2021-12-01T15:22:12.56,7,False,1.0
2021,12,3239,925,29,7828,13,4,6,17,0,0,0,0,0,0,False,False,False,0,2,2021-12-01T19:12:42.33,0,False,0.0
2021,12,3239,940,29,3398,13,5,5,5,0,0,0,0,0,0,True,False,False,0,3,2021-11-29T18:06:00.983,0,False,0.0
2021,12,3239,945,29,4866,2,4,9,6,11,5,9,2,9,0,False,False,False,1,3,2021-11-29T18:08:26.613,11,False,2.0
2021,12,3239,950,29,7828,13,12,2,15,0,0,0,0,0,0,False,False,False,0,3,2021-11-29T18:11:10.33,0,False,0.0
2021,12,3239,960,29,4866,2,13,4,4,14,10,8,6,8,0,False,False,False,0,3,2021-11-29T18:13:37.633,14,False,6.0
2021,12,3240,10,18,7711,13,50,9,-3,0,0,0,0,0,0,True,False,False,0,2,2022-02-17T17:10:04.553,0,False,0.0
2021,12,3240,20,18,7711,13,8,8,47,0,0,0,0,0,0,False,False,False,0,3,2022-02-17T17:10:46.043,0,False,0.0
2021,12,3240,35,28,7224,13,6,1,27,0,0,0,0,0,0,True,False,False,0,4,2021-11-30T21:18:10.823,0,False,0.0
2021,12,3240,40,28,7753,2,8,8,16,21,5,16,5,16,0,False,False,False,0,3,2021-11-29T09:45:06.973,21,False,5.0
2021,12,3240,45,28,7619,13,2,10,8,0,0,0,0,0,0,False,False,False,0,2,2021-11-29T09:46:58.127,0,False,0.0
2021,12,3240,60,28,7224,13,6,4,7,0,0,0,0,0,0,False,False,False,0,3,2021-12-01T15:26:03.773,0,False,0.0
2021,12,3240,65,18,4572,2,46,3,0,2,2,2,0,2,0,False,False,False,0,1,2021-11-29T09:52:05.103,2,False,0.0
2021,12,3240,70,18,4572,2,50,5,-4,11,15,7,4,7,0,False,False,False,0,2,2021-11-30T16:05:57.62,11,False,4.0
2021,12,3240,80,18,1381,2,11,6,23,29,6,6,23,6,0,True,False,False,0,3,2021-11-29T10:01:00.79,29,False,23.0
2021,12,3240,95,18,7711,13,12,10,2,0,0,0,0,0,0,False,False,False,0,2,2021-12-01T15:26:13.18,0,False,0.0
2021,12,3240,105,18,1381,2,35,9,2,2,0,2,0,2,6,False,False,False,0,3,2021-12-01T15:46:29.13,2,True,0.0
2021,12,3240,125,28,7619,13,6,4,11,0,0,0,0,0,0,False,False,False,0,3,2022-02-17T17:11:19.62,0,False,0.0
2021,12,3240,130,28,7619,2,6,7,20,37,17,37,0,37,0,False,False,False,0,3,2021-12-01T14:43:54.567,37,False,0.0
2021,12,3240,160,18,4572,2,48,9,-5,7,12,1,6,1,0,False,False,False,1,1,2021-11-29T14:16:53.593,7,False,6.0
2021,12,3240,190,28,8471,2,4,5,3,3,0,3,0,3,0,True,False,False,0,2,2021-11-29T10:35:27.49,3,False,0.0
2021,12,3240,205,18,1381,2,46,3,2,4,2,2,2,2,0,True,False,False,0,3,2021-12-01T15:36:53.737,4,False,2.0
2021,12,3240,220,18,7711,2,7,6,17,30,13,30,0,30,0,False,False,False,0,3,2021-11-29T10:45:07.9,30,False,0.0
2021,12,3240,225,18,7711,2,30,10,-2,15,17,2,13,2,0,True,False,False,1,3,2021-11-29T10:49:36.88,15,False,13.0
2021,12,3240,235,18,1381,2,35,7,20,20,0,20,0,20,6,False,False,False,0,3,2021-11-29T10:51:02.013,20,True,0.0
2021,12,3240,265,28,4922,13,5,3,4,0,0,0,0,0,0,False,False,False,0,3,2021-12-01T15:32:19.067,0,False,0.0
2021,12,3240,275,18,1381,2,2,10,5,7,2,7,0,7,0,False,False,False,0,2,2021-11-29T11:01:51.903,7,False,0.0
2021,12,3240,290,18,4572,13,45,10,-6,0,0,0,0,0,0,False,False,False,0,1,2021-12-01T15:32:36.043,0,False,0.0
2021,12,3240,295,18,4572,2,48,9,-4,6,10,6,0,6,0,False,False,False,0,1,2021-11-29T11:09:12.003,6,False,0.0
2021,12,3240,315,28,8471,2,48,3,-6,2,8,-3,5,-3,0,False,False,False,0,1,2021-12-01T15:25:24.247,2,False,5.0
2021,12,3240,320,28,7760,2,2,10,8,11,3,10,1,10,0,False,False,False,0,3,2021-11-29T11:17:13.227,11,False,1.0
2021,12,3240,335,28,7619,13,3,2,18,0,0,0,0,0,0,False,False,False,0,3,2021-11-29T11:26:26.377,0,False,0.0
2021,12,3240,340,28,6624,2,50,3,-4,2,6,0,2,0,0,False,False,False,0,2,2021-11-29T11:28:47.417,2,False,2.0
2021,12,3240,345,28,6624,2,51,9,-9,-3,6,-9,6,-9,0,False,False,False,1,1,2022-02-24T17:38:59.903,-3,False,
2021,12,3240,375,28,8471,13,26,4,2,0,0,0,0,0,0,False,False,False,0,1,2021-11-29T11:43:49.167,0,False,0.0
2021,12,3240,380,28,8471,2,26,10,0,9,9,7,2,7,0,False,False,False,0,1,2021-11-29T11:45:09.03,9,False,2.0
2021,12,3240,390,28,7619,2,8,4,14,24,10,20,4,20,0,False,False,False,0,3,2021-11-29T11:47:25.297,24,False,4.0
2021,12,3240,400,28,7753,2,5,5,3,3,0,3,0,3,6,False,False,False,0,3,2021-11-29T11:49:13.927,3,True,0.0
2021,12,3240,415,18,4572,2,32,3,3,14,11,14,0,14,0,False,False,False,0,3,2021-11-29T11:51:22.837,14,False,0.0
2021,12,3240,435,28,8471,2,5,5,0,13,13,1,12,1,0,False,False,False,0,1,2021-11-29T11:54:45.903,13,False,12.0
2021,12,3240,455,28,4922,2,48,10,-1,13,14,11,2,11,0,True,False,False,0,1,2021-11-30T21:25:43.913,13,False,2.0
2021,12,3240,475,18,1381,13,4,9,5,0,0,0,0,0,0,False,False,False,0,2,2021-11-29T12:07:51.637,0,False,0.0
2021,12,3240,505,18,7711,2,4,7,15,15,0,15,0,15,0,False,False,False,0,2,2021-12-01T15:32:55.697,15,False,0.0
2021,12,3240,510,18,4572,2,48,10,-5,24,29,24,0,24,0,False,False,False,0,1,2022-02-17T17:15:19.803,24,False,0.0
2021,12,3240,530,28,7619,2,6,7,17,30,13,28,2,28,0,False,False,False,0,3,2021-11-29T12:24:20.813,30,False,2.0
2021,12,3240,555,28,7224,13,9,2,28,0,0,0,0,0,0,False,False,False,0,2,2022-02-17T17:16:29.043,0,False,0.0
2021,12,3240,580,28,7224,2,2,10,7,12,5,7,5,7,0,False,False,False,0,3,2021-11-29T12:38:26.187,12,False,5.0
2021,12,3240,590,28,7619,2,51,5,-3,6,9,3,3,3,0,True,False,False,0,3,2021-11-30T21:22:00.75,6,False,
2021,12,3240,595,28,8471,2,26,10,1,8,7,4,4,4,0,False,False,False,0,1,2021-11-29T12:43:38.717,8,False,4.0
2021,12,3240,620,28,7753,13,21,2,15,0,0,0,0,0,0,False,False,False,0,2,2021-11-29T13:00:49.013,0,True,0.0
2021,12,3240,625,28,262,2,6,4,5,11,6,11,0,11,0,False,False,False,0,1,2021-11-29T13:02:05.54,11,False,0.0
2021,12,3240,640,18,4152,2,31,4,3,16,13,8,8,8,0,True,False,False,2,4,2021-12-01T15:33:10.377,16,False,8.0
2021,12,3240,650,18,4152,2,32,3,1,1,0,1,0,1,0,False,False,False,0,4,2021-11-29T14:26:21,1,False,
2021,12,3240,655,18,6900,2,45,5,-2,5,7,1,4,1,0,False,False,False,0,1,2021-12-01T15:46:29.147,5,False,4.0
2021,12,3240,665,18,7711,13,19,6,32,0,0,0,0,0,0,False,False,False,0,2,2022-02-17T17:56:10.857,0,False,
2021,12,3240,675,18,1381,13,12,8,15,0,0,0,0,0,0,False,False,False,0,2,2021-11-29T13:18:24.15,0,False,0.0
2021,12,3240,680,18,6361,2,4,10,8,17,9,10,7,10,0,True,False,False,1,3,2021-12-01T15:33:41.873,17,False,7.0
2021,12,3240,690,18,6361,2,5,3,5,7,2,7,0,7,0,False,True,False,0,4,2021-11-30T16:06:53.8,8,False,0.0
2021,12,3240,705,18,6361,13,6,4,3,0,0,0,0,0,0,False,False,False,0,3,2021-12-01T14:44:27.407,0,False,0.0
2021,12,3240,715,18,7711,13,22,9,3,0,0,0,0,0,0,False,False,False,0,3,2021-11-29T13:33:41.647,0,False,0.0
2021,12,3240,730,28,6410,2,2,10,5,5,0,5,0,5,0,False,False,False,0,2,2022-02-17T17:16:53.407,5,False,0.0
2021,12,3240,740,28,262,2,8,8,19,26,7,19,7,19,0,False,False,False,0,4,2021-12-01T15:27:11.13,26,False,7.0
2021,12,3240,795,18,7712,2,47,5,4,5,1,5,0,5,0,True,False,False,0,3,2021-11-29T13:53:45.063,5,False,0.0
2021,12,3240,800,18,7711,2,6,1,23,23,0,23,0,23,0,False,False,False,0,3,2021-11-29T13:55:13.647,23,False,0.0
2021,12,3240,805,18,6900,13,6,10,3,0,0,0,0,0,0,False,False,False,0,1,2022-02-17T17:17:45.97,0,False,0.0
2021,12,3240,810,18,6900,2,45,5,-3,2,5,0,2,0,0,False,False,False,0,1,2021-11-29T13:57:58.27,2,False,2.0
2021,12,3240,815,18,7712,13,4,9,11,0,0,0,0,0,0,False,False,False,0,3,2021-11-29T13:59:21.547,0,False,0.0
2021,12,3240,820,18,7711,13,6,1,15,0,0,0,0,0,0,False,False,False,0,2,2021-11-29T14:00:49.72,0,False,0.0
2021,12,3241,10,8,232,2,2,10,6,11,5,8,3,8,0,False,False,False,0,2,2021-11-29T10:22:23.69,11,False,3.0
2021,12,3241,20,8,7652,2,4,3,5,9,4,7,2,7,0,False,False,False,0,2,2021-11-29T10:26:27.657,9,False,2.0
2021,12,3241,25,8,232,2,5,8,20,36,16,27,9,27,0,False,False,False,0,3,2021-11-29T10:30:02.253,36,False,9.0
2021,12,3241,30,8,7651,13,6,8,22,0,0,0,0,0,0,False,False,False,0,3,2021-12-01T19:06:10.01,0,False,0.0
2021,12,3241,40,8,7651,13,9,6,19,0,0,0,0,0,0,False,False,False,0,2,2021-11-29T10:40:27.54,0,False,0.0
2021,12,3241,50,3,8430,2,4,10,5,8,3,7,1,7,0,False,False,False,0,2,2021-12-01T19:06:22.94,8,False,1.0
2021,12,3241,75,3,7672,2,52,4,2,2,0,2,0,2,0,False,False,False,0,3,2021-12-01T19:14:07.39,2,False,0.0
2021,12,3241,95,8,8054,2,13,5,4,10,6,9,1,9,0,False,False,False,0,4,2021-11-29T11:10:00.51,10,False,1.0
2021,12,3241,100,8,7652,2,30,10,-1,0,1,-1,1,-1,0,True,False,False,0,1,2021-12-01T19:06:43.687,0,False,1.0
2021,12,3241,105,8,6439,13,12,5,10,0,0,0,0,0,0,False,False,False,0,2,2022-02-17T17:39:04.76,0,False,0.0
2021,12,3241,110,8,7651,13,3,6,15,0,0,0,0,0,0,False,False,False,0,2,2021-11-29T11:21:48.543,0,False,
2021,12,3241,120,8,6439,13,46,3,2,0,0,0,0,0,0,False,False,False,0,1,2021-12-01T20:14:23.447,0,False,0.0
2021,12,3241,125,8,232,2,50,10,-2,-1,1,-1,0,-1,0,False,False,False,0,3,2021-11-29T11:34:35.707,-1,False,0.0
2021,12,3241,130,8,3883,13,12,5,9,0,0,0,0,0,0,False,False,False,0,4,2021-12-01T20:34:52.74,0,False,0.0
2021,12,3241,145,3,8274,13,44,9,-4,0,0,0,0,0,0,False,False,False,0,1,2021-11-29T11:43:21.723,0,False,0.0
2021,12,3241,150,3,6936,2,4,9,8,7,-1,7,0,7,0,False,False,False,0,3,2021-11-29T11:45:36.927,7,False,0.0
2021,12,3241,180,3,6936,13,21,2,36,0,0,0,0,0,0,False,False,False,0,2,2021-12-01T20:19:58.08,0,False,0.0
2021,12,3241,185,3,8430,2,13,4,3,5,2,4,1,4,0,False,False,False,0,3,2021-12-01T20:20:10.803,5,False,1.0
2021,12,3241,245,3,6936,2,4,9,4,6,2,5,1,5,0,False,False,False,1,3,2021-12-01T20:20:30.917,6,False,1.0
2021,12,3241,260,3,6454,2,5,10,4,9,5,5,4,5,0,False,False,False,0,3,2021-11-29T12:29:26.097,9,False,4.0
2021,12,3241,280,3,6454,13,17,8,26,0,0,0,0,0,0,False,False,False,0,3,2021-11-29T12:39:23.26,0,False,0.0
2021,12,3241,295,3,713,2,48,10,-1,8,9,5,3,5,0,False,False,False,0,1,2022-02-17T17:40:40.237,8,False,3.0
2021,12,3241,315,3,5017,13,46,9,1,0,0,0,0,0,0,False,False,False,0,1,2021-11-29T13:03:13.853,0,False,0.0
2021,12,3241,335,8,7652,2,7,6,25,41,16,33,8,33,0,False,False,False,0,4,2021-11-29T13:06:28.66,41,False,8.0
2021,12,3241,345,3,8430,2,6,9,13,13,0,13,0,13,0,False,False,False,0,2,2021-12-01T19:14:07.39,13,False,0.0
2021,12,3241,350,3,8430,13,13,4,9,0,0,0,0,0,0,False,False,False,0,2,2021-11-29T15:54:41.777,0,False,0.0
2021,12,3241,355,8,232,2,46,3,4,11,7,11,0,11,0,False,False,False,0,3,2021-11-29T13:20:51.83,11,False,0.0
2021,12,3241,360,8,6439,2,46,3,3,7,4,7,0,7,0,False,False,False,0,3,2021-11-29T13:24:51.13,7,False,0.0
2021,12,3241,370,8,7651,2,5,3,4,4,0,4,0,4,0,False,False,False,0,3,2021-11-29T13:27:08.537,4,False,0.0
2021,12,3241,380,8,4976,13,9,6,22,0,0,0,0,0,0,False,False,False,0,3,2022-02-17T19:10:20.607,0,False,0.0
2021,12,3241,385,8,4976,13,39,4,6,0,0,0,0,0,0,False,False,False,0,4,2021-11-29T13:32:06.327,0,False,0.0
2021,12,3241,400,3,6454,13,4,4,8,0,0,0,0,0,0,False,False,False,0,3,2021-11-29T15:55:02.083,0,False,0.0
2021,12,3241,405,8,7651,13,4,5,9,0,0,0,0,0,0,False,False,False,0,2,2021-11-29T13:39:06.483,0,False,0.0
2021,12,3241,415,3,121,2,3,3,8,8,0,8,0,8,0,False,False,False,0,2,2021-12-01T20:20:45.293,8,True,0.0
2021,12,3241,430,3,6936,2,5,5,8,8,0,8,0,8,0,False,False,False,0,2,2021-11-29T13:47:59.697,8,True,0.0
2021,12,3241,435,3,7672,13,12,2,30,0,0,0,0,0,0,False,False,False,0,3,2021-12-01T20:09:36.003,0,False,
2021,12,3241,440,3,6454,13,4,10,7,0,0,0,0,0,0,False,False,False,0,3,2021-11-29T15:55:28.39,0,False,0.0
2021,12,3241,445,8,5053,13,4,4,2,0,0,0,0,0,0,False,False,False,0,1,2021-11-29T13:56:45.527,0,False,0.0
2021,12,3241,490,3,6454,2,47,10,0,4,4,1,3,1,0,False,False,False,1,4,2021-12-01T20:16:26.543,4,False,3.0
2021,12,3241,500,3,6936,2,51,10,-3,7,10,4,3,4,0,True,False,False,0,3,2021-12-01T20:43:17.837,7,False,3.0
2021,12,3241,515,3,6454,2,12,2,39,39,0,39,0,39,0,False,False,False,0,3,2021-11-29T14:24:59.753,39,False,0.0
2021,12,3241,535,3,6454,2,12,4,13,13,0,13,0,13,6,False,False,False,0,3,2021-11-29T14:33:01.723,13,True,0.0
2021,12,3241,550,8,6439,2,46,3,0,16,16,2,14,2,0,False,False,False,1,1,2021-11-29T14:36:19.133,16,False,14.0
2021,12,3241,555,8,7651,2,12,9,6,6,0,6,0,6,0,False,False,False,0,2,2021-11-29T14:38:44.89,6,False,0.0
2021,12,3241,565,8,8354,13,5,3,6,0,0,0,0,0,0,False,False,False,0,2,2021-11-29T14:42:06.593,0,False,0.0
2021,12,3241,575,3,6454,13,6,10,14,0,0,0,0,0,0,False,False,False,0,4,2022-02-17T17:42:43.047,0,False,0.0
2021,12,3241,580,3,6936,2,4,10,5,11,6,10,1,10,0,False,False,False,0,3,2021-12-01T19:08:10.163,11,False,1.0
2021,12,3241,600,3,8430,2,4,9,5,5,0,5,0,5,0,False,False,False,0,2,2021-11-29T15:03:12.37,5,False,0.0
2021,12,3241,615,3,6936,2,44,3,-5,-1,4,-2,1,-2,0,True,False,False,0,3,2021-12-01T20:43:45.997,-1,False,1.0
2021,12,3241,620,3,6936,13,5,5,5,0,0,0,0,0,0,False,False,False,0,3,2021-11-29T15:12:21.843,0,False,0.0
2021,12,3241,635,8,232,2,35,2,20,38,18,37,1,37,0,False,False,False,0,3,2021-11-29T15:17:49.417,38,False,1.0
2021,12,3241,640,8,4976,2,42,10,6,8,2,7,1,7,0,False,False,False,0,4,2021-12-01T20:10:05.88,8,False,1.0
2021,12,3241,645,8,3883,13,7,6,20,0,0,0,0,0,0,False,False,False,0,4,2021-11-29T15:33:08.093,0,False,
2021,12,3241,655,8,4976,2,8,8,20,20,0,20,0,20,6,False,False,False,0,3,2021-11-29T15:39:00.443,20,True,0.0
2021,12,3241,670,3,5017,2,12,3,-5,0,5,-3,3,-3,0,True,False,False,0,4,2022-02-24T17:44:23.227,0,False,3.0
2021,12,3241,695,3,6454,13,35,7,40,0,0,0,0,0,0,False,False,False,0,3,2021-12-01T20:21:55.35,0,False,0.0
2021,12,3241,700,8,232,2,4,7,15,16,1,16,0,16,0,False,False,False,0,2,2021-11-29T16:03:35.453,16,False,0.0
2021,12,3241,705,8,3883,13,35,8,21,0,0,0,0,0,0,False,False,False,0,4,2021-11-29T16:09:46.447,0,False,0.0
2021,12,3241,730,8,8054,2,26,9,5,8,3,4,4,4,0,False,False,False,1,3,2021-11-29T16:23:19.4,8,False,4.0
2021,12,3241,740,3,8434,13,5,6,19,0,0,0,0,0,0,False,False,False,0,4,2021-11-29T17:26:37.89,0,False,0.0
2021,12,3241,750,3,7672,13,5,5,9,0,0,0,0,0,0,False,False,False,0,3,2021-12-01T20:22:18.75,0,False,0.0
2021,12,3241,765,8,232,13,11,6,18,0,0,0,0,0,0,True,False,False,0,3,2021-11-29T16:37:33.457,0,False,0.0
2021,12,3241,770,8,232,13,5,5,8,0,0,0,0,0,0,False,False,False,0,3,2021-12-01T20:39:49.363,0,False,0.0
2021,12,3241,800,3,6936,2,4,9,8,10,2,8,2,8,0,False,False,False,0,3,2021-12-01T20:06:16.407,10,False,2.0
2021,12,3241,845,3,6936,2,13,4,3,3,0,3,0,3,0,False,False,False,0,3,2021-11-29T17:07:28.417,3,False,0.0
2021,12,3241,870,8,232,3,29,3,13,0,0,0,0,0,0,False,False,False,0,2,2022-02-17T17:47:07.917,0,False,0.0
2021,12,3241,875,8,3883,13,6,9,9,0,0,0,0,0,0,True,False,False,0,3,2021-12-01T19:14:07.403,0,False,0.0
2021,12,3241,880,8,4976,2,13,9,3,7,4,5,2,5,0,False,False,False,0,3,2021-11-29T17:17:44.593,7,False,2.0
2021,12,3242,10,32,1427,13,31,9,3,0,0,0,0,0,0,False,False,False,0,4,2021-11-30T10:00:05.683,0,False,0.0
2021,12,3242,20,32,7128,13,6,8,17,0,0,0,0,0,0,False,False,False,0,2,2021-11-30T10:04:25.08,0,False,0.0
2021,12,3242,30,27,650,2,30,5,1,2,1,2,0,2,0,True,False,False,0,3,2021-11-30T10:07:26.933,2,False,0.0
2021,12,3242,40,27,4850,13,46,3,3,0,0,0,0,0,0,False,False,False,0,3,2021-12-02T19:10:57.967,0,False,0.0
2021,12,3242,50,32,1427,2,30,10,1,5,4,3,2,3,0,False,False,False,0,4,2021-11-30T10:13:38.963,5,False,2.0
2021,12,3242,55,32,7807,2,48,10,-6,4,10,4,0,4,0,False,False,False,0,1,2021-12-02T18:39:16.327,4,False,0.0
2021,12,3242,75,32,8528,2,28,10,4,15,11,13,2,13,0,False,False,False,0,4,2021-12-02T18:28:57.303,15,False,2.0
2021,12,3242,85,32,3885,2,51,10,-4,2,6,1,1,1,0,False,False,False,0,3,2021-11-30T10:27:59.157,2,False,1.0
2021,12,3242,90,32,7128,2,42,10,7,8,1,8,0,8,0,False,False,False,0,3,2021-12-02T18:40:05.787,8,False,0.0
2021,12,3242,100,32,2675,2,4,5,5,6,1,6,0,6,0,False,False,False,0,3,2021-11-30T10:30:49.707,6,False,0.0
2021,12,3242,120,32,3885,2,12,5,0,0,0,0,0,0,0,True,False,False,0,2,2021-12-02T18:29:56.37,0,False,0.0
2021,12,3242,145,27,650,2,35,6,23,55,32,55,0,55,0,False,False,False,0,3,2021-11-30T14:36:38.287,55,False,0.0
2021,12,3242,150,27,650,13,7,10,11,0,0,0,0,0,0,False,False,False,0,4,2021-11-30T10:51:39.723,0,False,0.0
2021,12,3242,160,27,4850,2,13,9,6,6,0,6,0,6,6,False,False,False,0,4,2021-11-30T10:54:35.96,6,True,0.0
2021,12,3242,185,32,7807,2,47,5,-2,1,3,-1,2,-1,0,False,False,False,0,1,2021-11-30T11:00:23.323,1,False,2.0
2021,12,3242,190,32,1427,13,9,5,14,0,0,0,0,0,0,False,False,False,0,3,2021-11-30T11:02:38.687,0,False,
2021,12,3242,195,32,7128,13,35,2,15,0,0,0,0,0,0,False,False,False,0,3,2021-11-30T11:04:32.077,0,False,0.0
2021,12,3242,200,32,7807,2,48,10,-5,1,6,1,0,1,0,False,False,False,0,1,2021-11-30T11:06:40.06,1,False,0.0
2021,12,3242,205,32,7128,13,19,2,40,0,0,0,0,0,0,False,False,False,0,2,2021-12-02T19:26:52.123,0,False,0.0
2021,12,3242,215,27,6397,2,5,10,6,13,7,9,4,9,0,False,False,False,0,4,2021-11-30T11:11:58.843,13,False,4.0
2021,12,3242,225,27,8472,2,12,3,9,9,0,9,0,9,0,False,False,False,0,2,2021-11-30T11:15:26.42,9,True,0.0
2021,12,3242,255,32,7128,2,3,3,14,12,-2,12,0,12,0,False,False,False,0,3,2021-11-30T11:23:19.867,12,False,0.0
2021,12,3242,265,32,4803,2,51,5,-4,9,13,8,1,8,0,True,False,False,0,1,2021-11-30T11:25:59.51,9,False,1.0
2021,12,3242,280,32,2675,2,13,3,5,8,3,8,0,8,0,False,False,False,0,3,2021-11-30T11:31:31.123,8,False,0.0
2021,12,3242,290,32,1427,13,17,8,30,0,0,0,0,0,0,False,False,False,0,4,2021-12-02T18:31:45.62,0,False,0.0
2021,12,3242,295,27,650,2,8,6,39,39,0,39,0,39,0,False,False,False,0,4,2021-11-30T11:40:45.857,39,False,0.0
2021,12,3242,300,27,3656,2,5,3,3,13,10,13,0,13,0,False,True,True,0,1,2021-12-02T18:30:45.053,13,False,0.0
2021,12,3242,305,32,1427,2,5,5,14,14,0,14,0,14,0,False,False,False,0,4,2022-02-17T17:22:33.957,14,True,0.0
2021,12,3242,310,32,7807,2,48,5,-6,9,15,6,3,6,0,False,False,False,0,1,2021-12-02T18:45:43.297,9,False,3.0
2021,12,3242,345,32,2675,13,5,2,18,0,0,0,0,0,0,False,False,False,0,3,2021-11-30T11:55:33.097,0,False,
2021,12,3242,355,32,3562,2,4,10,13,16,3,15,1,15,0,False,False,False,0,3,2021-12-02T18:28:06.647,16,False,1.0
2021,12,3242,370,32,3885,2,48,10,-8,10,18,3,7,3,6,False,False,False,0,1,2021-12-02T18:32:08.513,10,False,7.0
2021,12,3242,385,27,4850,2,39,4,4,8,4,8,0,8,0,True,False,False,0,3,2021-11-30T12:11:24.98,8,False,0.0
2021,12,3242,390,27,4850,13,5,5,7,0,0,0,0,0,0,False,False,False,0,4,2021-12-02T17:10:06.93,0,False,0.0
2021,12,3242,430,27,7850,2,47,5,-2,2,4,1,1,1,0,False,False,False,0,1,2021-12-02T18:48:15.43,2,False,1.0
2021,12,3242,440,27,4850,13,4,9,4,0,0,0,0,0,0,True,False,False,0,3,2021-12-02T18:30:55.96,0,False,0.0
2021,12,3242,450,32,7128,2,30,5,-1,20,21,17,3,17,0,False,False,False,0,3,2021-11-30T12:29:11.587,20,False,3.0
2021,12,3242,465,32,3562,2,51,9,-2,2,4,1,1,1,0,False,False,False,0,3,2021-11-30T12:33:02.767,2,False,1.0
2021,12,3242,470,32,3562,13,3,5,14,0,0,0,0,0,0,False,False,False,0,3,2021-11-30T14:35:22.05,0,False,0.0
2021,12,3242,475,32,3562,2,2,9,8,9,1,9,0,9,0,False,False,False,0,3,2021-12-02T00:49:21.453,9,False,0.0
2021,12,3242,485,32,7807,2,16,10,5,11,6,6,5,6,0,False,False,False,1,1,2021-11-30T12:39:35.483,11,False,5.0
2021,12,3242,520,27,4850,2,53,10,-5,7,12,-2,9,-2,0,False,False,False,1,4,2021-12-02T18:32:48.81,7,False,9.0
2021,12,3242,525,27,8472,13,2,9,7,0,0,0,0,0,0,False,False,False,0,2,2022-02-17T17:23:41.03,0,False,0.0
2021,12,3242,545,32,7128,2,5,5,7,11,4,9,2,9,0,False,False,False,0,3,2021-11-30T12:57:36.893,11,False,2.0
2021,12,3242,560,27,6397,2,4,9,5,6,1,5,1,5,0,False,False,False,0,4,2021-11-30T13:01:04.997,6,False,1.0
2021,12,3242,565,27,7408,13,9,6,29,0,0,0,0,0,0,False,False,False,0,2,2021-11-30T13:02:24.677,0,False,0.0
2021,12,3242,570,27,650,13,12,7,20,0,0,0,0,0,0,True,False,False,0,3,2021-12-01T17:22:42.623,0,False,0.0
2021,12,3242,605,27,8472,2,30,10,-2,1,3,1,0,1,0,False,False,False,0,3,2021-11-30T13:12:39.757,1,False,0.0
2021,12,3242,625,32,7807,2,4,4,1,6,5,4,2,4,0,False,False,False,0,1,2021-11-30T13:19:39.153,6,False,2.0
2021,12,3242,630,32,7807,2,48,10,-6,3,9,3,0,3,0,False,False,False,0,1,2022-02-17T17:24:29.83,3,False,0.0
2021,12,3242,650,27,7408,13,2,10,13,0,0,0,0,0,0,False,False,False,0,2,2021-11-30T13:27:20.453,0,False,0.0
2021,12,3242,660,27,7408,13,21,6,36,0,0,0,0,0,0,False,False,False,0,2,2021-12-02T18:28:18.777,0,False,0.0
2021,12,3242,665,27,7852,13,51,3,-3,0,0,0,0,0,0,False,False,False,0,3,2021-11-30T13:32:34.813,0,False,0.0
2021,12,3242,695,32,1427,2,13,9,4,12,8,10,2,10,0,False,False,False,0,4,2021-11-30T13:43:09.137,12,False,2.0
2021,12,3242,700,32,3885,2,28,3,-5,6,11,6,0,6,0,False,False,False,0,1,2021-12-02T18:54:18.1,6,False,0.0
2021,12,3242,735,32,3885,2,2,9,5,8,3,8,0,8,0,False,False,False,0,3,2021-11-30T13:51:42.96,8,False,0.0
2021,12,3242,745,32,3562,2,4,9,12,15,3,13,2,13,0,False,False,False,0,3,2021-11-30T13:57:43.437,15,False,2.0
2021,12,3242,780,32,1427,13,12,4,3,0,0,0,0,0,0,False,False,False,0,4,2021-12-02T19:11:25.223,0,True,0.0
2021,12,3242,785,27,4850,2,5,5,7,12,5,12,0,12,0,False,False,False,0,4,2021-11-30T14:07:32.753,12,True,0.0
2021,12,3242,790,27,7850,2,45,5,-3,1,4,1,0,1,0,False,False,False,0,1,2021-11-30T14:08:55.38,1,False,0.0
2021,12,3242,795,27,7850,2,4,4,3,4,1,4,0,4,0,False,False,False,0,1,2021-12-02T19:01:34.933,4,False,0.0
2021,12,3242,805,27,650,13,17,1,24,0,0,0,0,0,0,False,False,False,0,3,2021-11-30T14:12:09.827,0,False,
2021,12,3242,815,27,7850,2,4,4,3,13,10,10,3,10,0,False,False,False,0,1,2021-11-30T14:15:18.197,13,False,3.0
2021,12,3242,820,27,7408,2,5,3,13,13,0,13,0,13,0,False,False,False,0,2,2021-11-30T14:16:45.837,13,True,0.0
2021,12,3242,830,27,4850,13,38,4,4,0,0,0,0,0,0,False,False,False,0,4,2022-02-17T17:26:30.353,0,False,0.0
2021,12,3242,835,27,4850,2,39,4,4,4,0,3,1,3,0,False,False,False,0,3,2021-12-02T19:02:13.767,4,False,1.0
2021,12,3242,840,27,7850,2,4,9,4,7,3,5,2,5,0,False,False,False,0,1,2021-12-02T19:02:31.62,7,False,2.0
2021,12,3242,845,27,7852,2,17,7,31,32,1,32,0,32,6,False,False,False,0,3,2021-11-30T14:23:24.687,32,True,0.0
2021,13,3243,10,20,6388,2,4,5,5,6,1,6,0,6,0,False,False,False,0,2,2021-12-03T12:12:51.287,6,False,0.0
2021,13,3243,15,20,3848,2,31,10,4,12,8,8,4,8,0,False,False,False,0,4,2022-02-24T17:46:41.633,12,False,4.0
2021,13,3243,20,20,902,2,48,5,-7,-2,5,-5,3,-5,0,False,False,False,0,1,2021-12-08T20:15:44.403,-2,False,3.0
2021,13,3243,30,20,2408,2,48,10,-7,-6,1,-6,0,-6,0,True,False,False,0,1,2021-12-04T19:35:37.51,-6,False,0.0
2021,13,3243,40,9,7816,13,12,7,23,0,0,0,0,0,0,False,False,False,0,2,2021-12-03T18:40:42.93,0,False,0.0
2021,13,3243,50,9,4446,13,6,4,13,0,0,0,0,0,0,False,False,False,0,3,2021-12-03T12:29:21.673,0,False,0.0
2021,13,3243,70,20,2136,13,12,5,10,0,0,0,0,0,0,True,False,False,0,2,2022-02-22T20:05:54.17,0,False,0.0
2021,13,3243,75,20,7356,2,11,6,16,25,9,24,1,24,0,False,False,False,0,3,2021-12-08T20:45:12.44,25,False,1.0
2021,13,3243,90,20,8131,13,20,2,27,0,0,0,0,0,0,False,False,False,0,2,2021-12-08T19:11:34.9,0,False,0.0
2021,13,3243,100,9,4446,2,26,9,6,9,3,9,0,9,0,True,False,False,0,3,2021-12-03T12:51:43.543,9,False,0.0
2021,13,3243,110,9,4446,2,5,5,4,5,1,5,0,5,0,False,False,False,0,3,2021-12-03T12:56:43.533,5,False,0.0
2021,13,3243,120,9,7183,2,46,3,1,1,0,1,0,1,0,False,False,False,0,3,2021-12-08T20:47:15.683,1,False,0.0
2021,13,3243,125,9,7816,13,12,9,10,0,0,0,0,0,0,False,False,False,0,3,2022-02-25T15:52:58.01,0,False,0.0
2021,13,3243,135,20,6388,13,35,6,21,0,0,0,0,0,0,False,False,False,0,4,2021-12-03T13:11:48.007,0,False,0.0
2021,13,3243,140,20,8131,13,17,7,15,0,0,0,0,0,0,False,False,False,0,2,2021-12-08T19:11:34.9,0,False,0.0
2021,13,3243,160,9,322,2,8,8,20,41,21,37,4,37,0,False,False,False,1,3,2021-12-08T19:11:34.9,41,False,4.0
2021,13,3243,170,9,6446,2,30,10,1,7,6,6,1,6,0,True,False,False,0,4,2021-12-03T18:17:16.583,7,False,1.0
2021,13,3243,180,9,6436,2,9,5,1,1,0,1,0,1,6,False,False,False,0,2,2021-12-03T18:46:38.64,1,True,0.0
2021,13,3243,200,20,8127,2,17,8,25,27,2,27,0,27,0,False,False,False,0,4,2021-12-08T19:11:34.9,27,False,0.0
2021,13,3243,215,20,2408,13,47,5,0,0,0,0,0,0,0,False,False,False,0,1,2022-02-22T20:06:10.067,0,False,0.0
2021,13,3243,225,20,7353,2,5,5,5,9,4,9,0,9,0,False,False,False,0,3,2021-12-03T13:53:10.637,9,False,0.0
2021,13,3243,235,20,7356,2,35,6,15,24,9,24,0,24,6,False,False,False,0,4,2021-12-03T13:57:20.687,24,True,0.0
2021,13,3243,250,9,7816,2,4,5,11,21,10,11,10,11,0,False,False,False,1,2,2021-12-03T14:01:31.01,21,False,10.0
2021,13,3243,260,9,6712,2,4,9,9,10,1,10,0,10,0,False,False,False,0,3,2021-12-03T14:03:41.323,10,False,0.0
2021,13,3243,275,9,6446,2,4,9,4,10,6,5,5,5,0,False,False,False,0,3,2021-12-08T20:16:02.35,10,False,5.0
2021,13,3243,280,9,6436,2,50,10,-1,5,6,3,2,3,0,False,False,False,0,2,2021-12-03T14:10:02.813,5,False,2.0
2021,13,3243,305,20,2136,13,12,2,16,0,0,0,0,0,0,False,False,False,0,3,2021-12-08T20:27:01.68,0,False,0.0
2021,13,3243,315,9,6436,13,5,6,19,0,0,0,0,0,0,False,False,False,0,2,2021-12-03T14:19:25.51,0,False,0.0
2021,13,3243,335,20,3725,2,32,5,3,9,6,8,1,8,0,False,True,False,0,4,2021-12-04T19:33:31.987,9,False,1.0
2021,13,3243,345,20,2408,2,28,10,1,1,0,1,0,1,0,False,False,False,0,1,2021-12-03T14:33:31.783,1,False,0.0
2021,13,3243,350,20,6388,2,4,3,9,9,0,9,0,9,0,False,False,False,0,2,2021-12-03T14:38:43.577,9,False,0.0
2021,13,3243,355,20,2408,3,28,5,-1,0,0,0,0,0,0,False,False,False,0,1,2021-12-04T19:33:49.397,0,False,0.0
2021,13,3243,360,20,3848,2,53,9,-5,30,35,28,2,28,0,False,False,False,0,4,2021-12-08T20:27:47.63,30,False,2.0
2021,13,3243,365,20,2136,13,13,10,5,0,0,0,0,0,0,False,False,False,0,3,2021-12-03T14:45:41.74,0,False,0.0
2021,13,3243,370,20,2136,13,21,6,21,0,0,0,0,0,0,False,False,False,0,3,2022-02-16T15:12:09.547,0,False,0.0
2021,13,3243,385,9,6436,2,12,6,17,17,0,17,0,17,0,False,False,False,0,2,2022-02-16T15:12:43.247,17,True,0.0
2021,13,3243,395,9,4202,2,46,3,0,1,1,1,0,1,0,False,False,False,0,1,2021-12-03T18:41:13.32,1,False,0.0
2021,13,3243,400,9,6446,2,5,3,3,4,1,4,0,4,0,False,False,False,0,3,2021-12-03T14:54:06.993,4,False,0.0
2021,13,3243,405,9,7816,2,17,10,10,20,10,11,9,11,0,False,False,False,1,3,2021-12-08T20:17:09.317,20,False,9.0
2021,13,3243,410,9,6446,13,12,6,15,0,0,0,0,0,0,False,False,False,0,3,2021-12-03T18:27:02.1,0,False,
2021,13,3243,415,9,7816,13,51,5,1,0,0,0,0,0,0,False,False,False,0,3,2021-12-03T18:23:49.217,0,False,0.0
2021,13,3243,420,9,322,2,26,10,0,0,0,0,0,0,0,False,False,False,0,3,2021-12-03T18:23:58.927,0,False,0.0
2021,13,3243,425,9,322,13,4,5,13,0,0,0,0,0,0,False,False,False,0,2,2021-12-08T19:11:34.9,0,False,
2021,13,3243,430,9,6446,2,5,10,12,12,0,12,0,12,0,False,False,False,0,3,2021-12-08T19:11:34.9,12,False,0.0
2021,13,3243,440,9,7183,2,45,5,-1,2,3,2,0,2,0,False,False,False,0,1,2021-12-03T15:16:03.063,2,False,0.0
2021,13,3243,445,9,6446,2,5,5,10,10,0,10,0,10,0,False,False,False,0,3,2021-12-08T19:11:34.9,10,False,0.0
2021,13,3243,450,9,7816,13,7,3,7,0,0,0,0,0,0,True,False,False,0,3,2022-02-24T17:49:15.14,0,False,
2021,13,3243,460,9,4202,2,12,3,-1,1,2,1,0,1,0,False,False,False,0,1,2021-12-03T15:24:40.597,1,True,0.0
2021,13,3243,485,9,7816,2,5,3,3,3,0,3,0,3,0,False,False,False,0,3,2021-12-03T15:32:44.35,3,False,0.0
2021,13,3243,490,9,6436,13,6,10,14,0,0,0,0,0,0,False,False,False,0,3,2021-12-03T15:34:49.597,0,False,0.0
2021,13,3243,500,20,3848,2,30,3,1,6,5,5,1,5,0,True,False,False,0,4,2022-02-16T15:13:00.53,6,False,1.0
2021,13,3243,535,20,6388,13,35,6,20,0,0,0,0,0,0,True,False,False,0,3,2021-12-04T19:34:36.343,0,False,0.0
2021,13,3243,540,20,902,13,48,9,-3,0,0,0,0,0,0,False,False,False,0,1,2022-02-16T15:14:39.583,0,False,0.0
2021,13,3243,545,20,2408,13,46,3,-1,0,0,0,0,0,0,False,False,False,0,1,2021-12-08T20:49:29.917,0,False,0.0
2021,13,3243,560,9,6436,2,5,5,4,4,0,4,0,4,0,False,False,False,0,3,2021-12-08T20:32:19.353,4,True,0.0
2021,13,3243,570,9,7183,13,26,9,2,0,0,0,0,0,0,True,False,False,0,2,2021-12-03T16:05:45.87,0,False,0.0
2021,13,3243,580,20,7353,2,3,5,12,11,-1,11,0,11,0,False,False,False,0,2,2021-12-03T16:14:47.907,11,False,
2021,13,3243,585,20,2408,2,45,5,-5,1,6,0,1,0,0,False,False,False,0,1,2021-12-03T16:14:30.837,1,False,1.0
2021,13,3243,595,20,3848,13,12,5,13,0,0,0,0,0,0,False,False,False,0,4,2021-12-08T20:12:39.527,0,False,0.0
2021,13,3243,605,9,7183,13,12,3,6,0,0,0,0,0,0,False,False,False,0,1,2022-02-16T15:15:12.333,0,False,0.0
2021,13,3243,610,9,7816,2,2,9,6,13,7,7,6,7,0,False,False,False,0,3,2021-12-03T16:23:31.8,13,False,6.0
2021,13,3243,615,9,6436,13,19,2,35,0,0,0,0,0,0,False,False,False,0,2,2022-02-16T15:15:29.577,0,False,0.0
2021,13,3243,660,20,6388,13,2,4,10,0,0,0,0,0,0,False,False,False,0,2,2021-12-03T16:48:40,0,False,0.0
2021,13,3243,690,9,7816,2,8,8,25,25,0,25,0,25,0,False,False,False,0,3,2021-12-03T18:39:59.887,25,False,0.0
2021,13,3243,695,9,6436,2,4,9,9,9,0,9,0,9,0,False,False,False,0,3,2021-12-03T16:59:48.847,9,False,0.0
2021,13,3243,705,9,7816,2,34,4,-5,4,9,4,0,4,0,True,False,False,0,3,2021-12-03T17:01:30.147,4,True,0.0
2021,13,3243,715,9,7816,13,5,3,4,0,0,0,0,0,0,False,False,False,0,3,2021-12-03T17:05:30.383,0,False,0.0
2021,13,3243,730,20,7353,2,4,10,5,5,0,5,0,5,0,False,False,False,0,3,2021-12-03T17:09:39.837,5,False,0.0
2021,13,3243,735,20,6388,13,12,5,2,0,0,0,0,0,0,False,False,False,0,3,2022-02-24T17:49:59.513,0,False,0.0
2021,13,3243,750,9,4202,13,2,9,7,0,0,0,0,0,0,True,False,False,0,2,2021-12-04T23:02:56.957,0,False,0.0
2021,13,3243,755,9,7816,13,17,7,26,0,0,0,0,0,0,False,False,False,0,3,2021-12-03T17:16:59.23,0,False,0.0
2021,13,3243,775,20,2136,13,13,10,5,0,0,0,0,0,0,False,False,False,0,3,2021-12-08T21:07:00.82,0,True,0.0
2021,13,3243,780,20,7353,3,5,5,4,0,0,0,0,0,0,False,False,False,0,3,2021-12-03T17:25:11.033,0,False,0.0
2021,13,3243,785,20,7353,2,2,4,8,12,4,8,4,8,0,True,False,False,0,3,2021-12-04T19:36:16.353,12,False,4.0
2021,13,3243,790,20,6388,13,7,10,14,0,0,0,0,0,0,False,False,False,0,3,2021-12-08T19:22:03.82,0,False,0.0
2021,13,3243,800,9,7816,13,9,2,23,0,0,0,0,0,0,False,False,False,0,3,2021-12-03T17:35:56.4,0,False,0.0
2021,13,3243,805,9,6436,13,19,5,14,0,0,0,0,0,0,False,False,False,0,2,2021-12-03T17:38:34.623,0,False,0.0
2021,13,3243,815,20,2408,2,16,10,6,13,7,10,3,10,0,False,False,False,0,1,2021-12-03T17:43:04.273,13,False,3.0
2021,13,3243,820,20,7353,13,7,2,22,0,0,0,0,0,0,False,False,False,0,2,2021-12-08T20:14:03.423,0,False,0.0
2021,13,3243,845,9,7816,2,34,4,-5,3,8,-2,5,-2,0,True,False,False,1,2,2021-12-08T20:54:18.063,3,False,5.0
2021,13,3243,860,20,8131,2,6,9,6,13,7,9,4,9,0,False,False,False,0,2,2021-12-03T18:05:31.623,13,False,4.0
2021,13,3243,865,20,8131,13,13,4,2,0,0,0,0,0,0,False,False,False,0,3,2021-12-08T20:13:43.25,0,False,0.0
2021,13,3243,870,20,7353,13,13,10,-4,0,0,0,0,0,0,False,False,False,0,3,2021-12-03T18:05:55.73,0,False,0.0
2021,13,3243,885,20,7353,3,6,9,6,0,0,0,0,0,0,False,False,False,0,3,2021-12-03T18:04:11.497,0,False,0.0
2021,13,3243,890,20,7353,2,6,4,5,70,65,4,66,4,6,False,False,False,2,2,2021-12-08T20:54:55.04,70,False,66.0
2021,13,3244,15,21,3957,2,47,10,-1,3,4,1,2,1,0,False,False,False,0,1,2022-03-11T19:38:24.053,3,False,2.0
2021,13,3244,20,21,3389,2,6,9,13,15,2,14,1,14,0,False,False,False,0,3,2021-12-08T15:54:57.253,15,False,1.0
2021,13,3244,30,21,6228,2,48,9,-4,-3,1,-4,1,-4,0,False,False,False,1,1,2021-12-08T15:21:00.25,-3,False,1.0
2021,13,3244,35,21,813,2,31,10,4,7,3,6,1,6,0,False,False,False,0,3,2021-12-08T15:41:28.007,7,False,1.0
2021,13,3244,45,17,8483,2,12,3,3,9,6,7,2,7,0,False,False,False,0,3,2021-12-08T15:42:00.22,9,False,2.0
2021,13,3244,55,17,8483,2,5,3,5,5,0,5,0,5,0,True,False,False,0,2,2021-12-06T10:47:04.03,5,True,0.0
2021,13,3244,60,17,6276,13,11,5,11,0,0,0,0,0,0,False,False,False,0,4,2021-12-08T15:55:04.753,0,False,0.0
2021,13,3244,65,17,8483,2,4,5,10,11,1,11,0,11,0,False,False,False,0,2,2021-12-06T10:51:58.357,11,False,0.0
2021,13,3244,80,17,8483,3,35,4,11,0,0,0,0,0,0,True,False,False,0,3,2021-12-06T10:57:53.647,0,False,0.0
2021,13,3244,95,21,6228,2,34,4,-4,-5,-1,-3,-2,-3,0,True,False,False,1,2,2021-12-06T11:02:33.34,-5,False,-2.0
2021,13,3244,100,21,7090,2,49,9,-2,4,6,3,1,3,0,False,False,False,0,3,2021-12-06T11:04:03.377,4,False,1.0
2021,13,3244,105,21,4422,2,4,10,14,18,4,16,2,16,0,False,False,False,0,3,2021-12-06T11:05:08.297,18,False,2.0
2021,13,3244,115,21,4492,2,29,2,16,20,4,20,0,20,0,False,False,False,0,3,2021-12-08T15:42:30.857,20,True,0.0
2021,13,3244,120,21,7090,13,7,6,45,0,0,0,0,0,0,False,False,False,0,2,2021-12-08T15:14:02.257,0,False,0.0
2021,13,3244,130,17,6274,2,46,3,0,1,1,1,0,1,0,False,False,False,0,3,2021-12-06T11:16:10.22,1,False,0.0
2021,13,3244,145,21,3957,2,50,9,-2,-1,1,-2,1,-2,0,False,False,False,2,2,2022-02-16T15:01:10.14,-1,False,1.0
2021,13,3244,155,21,4492,2,5,3,5,5,0,5,0,5,0,False,False,False,0,3,2021-12-06T11:22:34.573,5,True,0.0
2021,13,3244,165,21,4492,2,2,9,8,12,4,10,2,10,0,False,False,False,0,2,2021-12-06T11:26:18.303,12,False,2.0
2021,13,3244,170,21,6228,3,16,5,6,0,0,0,0,0,0,False,False,False,0,3,2021-12-06T11:27:55.81,0,False,0.0
2021,13,3244,180,21,3389,13,26,3,6,0,0,0,0,0,0,False,False,False,0,3,2021-12-08T14:58:24.107,0,False,0.0
2021,13,3244,195,17,364,2,34,4,-4,4,8,3,1,3,0,True,False,False,0,3,2021-12-06T11:33:30.403,4,False,1.0
2021,13,3244,210,17,2253,2,17,9,12,12,0,12,0,12,0,False,False,False,0,2,2021-12-06T11:49:04.137,12,False,0.0
2021,13,3244,215,17,8487,2,31,9,3,8,5,6,2,6,0,False,False,False,0,4,2021-12-08T14:58:24.107,8,False,2.0
2021,13,3244,225,17,2253,2,4,3,4,6,2,4,2,4,0,False,False,False,0,2,2021-12-06T11:53:09.413,6,False,2.0
2021,13,3244,230,17,6274,2,46,3,-1,-2,-1,-1,-1,-1,0,False,False,False,0,3,2022-03-11T19:42:12.833,-2,False,-1.0
2021,13,3244,235,17,8483,2,4,5,5,6,1,6,0,6,0,False,False,False,0,3,2021-12-06T11:56:33.513,6,False,0.0
2021,13,3244,240,17,364,13,35,10,12,0,0,0,0,0,0,False,False,False,0,3,2021-12-06T11:58:08.107,0,False,0.0
2021,13,3244,255,21,7090,13,35,10,13,0,0,0,0,0,0,False,False,False,0,2,2021-12-08T15:31:08.943,0,False,0.0
2021,13,3244,265,21,4422,2,5,7,16,16,0,16,0,16,0,False,False,False,0,3,2022-03-11T19:44:48.203,16,False,0.0
2021,13,3244,270,21,6228,3,47,10,5,0,0,0,0,0,0,False,False,False,0,1,2022-02-16T15:02:09.763,0,False,0.0
2021,13,3244,280,21,3389,2,5,3,4,6,2,6,0,6,0,False,False,False,0,3,2022-02-22T19:56:53.257,6,False,0.0
2021,13,3244,290,17,6274,2,5,5,4,8,4,6,2,6,0,False,False,False,0,3,2021-12-06T12:09:48.933,8,False,2.0
2021,13,3244,295,17,364,2,46,3,2,4,2,2,2,2,0,True,False,False,0,3,2021-12-06T12:11:14.237,4,False,2.0
2021,13,3244,300,17,8483,2,39,4,8,8,0,8,0,8,0,False,False,False,0,3,2021-12-06T12:13:48.107,8,False,0.0
2021,13,3244,305,17,364,2,39,4,5,5,0,5,0,5,0,False,False,False,0,3,2021-12-06T12:13:39.79,5,False,0.0
2021,13,3244,310,17,6274,2,2,9,7,9,2,7,2,7,0,False,False,False,0,3,2021-12-06T12:14:55.783,9,False,2.0
2021,13,3244,315,17,8483,13,9,6,24,0,0,0,0,0,0,False,False,False,0,2,2021-12-06T12:17:50.23,0,False,
2021,13,3244,325,17,7024,2,51,10,-6,2,8,2,0,2,0,False,False,False,0,1,2021-12-08T15:31:30.96,2,False,0.0
2021,13,3244,330,17,6274,2,5,5,2,9,7,9,0,9,0,False,False,False,0,3,2021-12-06T12:20:32.583,9,True,0.0
2021,13,3244,340,17,2253,2,29,2,17,17,0,17,0,17,0,False,False,False,0,2,2021-12-06T12:22:39.693,17,False,0.0
2021,13,3244,350,17,6274,2,47,5,1,4,3,4,0,4,0,False,False,False,0,4,2021-12-08T15:32:24.313,4,False,0.0
2021,13,3244,355,17,6274,3,7,5,12,0,0,0,0,0,0,False,False,False,0,3,2021-12-06T12:26:03.17,0,False,0.0
2021,13,3244,360,17,8483,2,2,9,4,6,2,6,0,6,0,False,False,False,0,2,2021-12-07T22:32:05.877,6,False,0.0
2021,13,3244,375,17,4383,2,9,3,5,5,0,5,0,5,6,False,False,False,0,3,2022-03-11T19:47:47.737,5,True,0.0
2021,13,3244,410,17,364,13,26,9,5,0,0,0,0,0,0,True,False,False,0,3,2021-12-06T12:40:54.943,0,False,0.0
2021,13,3244,415,17,6274,13,35,10,12,0,0,0,0,0,0,False,False,False,0,3,2021-12-06T12:42:03.4,0,False,0.0
2021,13,3244,425,21,813,2,32,5,0,11,11,9,2,9,0,False,False,False,0,4,2021-12-06T12:45:15.753,11,False,2.0
2021,13,3244,440,21,4422,2,2,4,10,17,7,15,2,15,0,False,False,False,0,2,2021-12-08T15:55:26.923,17,False,2.0
2021,13,3244,460,21,4492,13,35,8,16,0,0,0,0,0,0,False,False,False,0,3,2021-12-06T12:54:29.633,0,False,0.0
2021,13,3244,465,21,7090,13,8,7,16,0,0,0,0,0,0,False,False,False,0,3,2021-12-08T14:58:24.123,0,False,0.0
2021,13,3244,490,17,8483,2,5,5,3,3,0,3,0,3,0,True,False,False,0,3,2021-12-08T15:33:04.017,3,False,0.0
2021,13,3244,500,21,4492,13,4,4,12,0,0,0,0,0,0,False,False,False,0,3,2021-12-06T13:10:36.057,0,False,0.0
2021,13,3244,510,21,7090,3,3,5,10,0,0,0,0,0,0,False,False,False,0,3,2022-02-16T15:02:58.77,0,False,0.0
2021,13,3244,520,17,6274,3,35,4,14,0,0,0,0,0,0,False,False,False,0,3,2022-02-16T15:03:53.08,0,False,0.0
2021,13,3244,550,21,3957,2,46,3,2,8,6,8,0,8,0,False,False,False,0,3,2021-12-06T13:22:55.93,8,False,0.0
2021,13,3244,555,21,4422,13,7,6,24,0,0,0,0,0,0,False,False,False,0,3,2022-02-16T15:04:22.157,0,False,0.0
2021,13,3244,565,17,8483,2,2,10,9,17,8,15,2,15,0,False,False,False,0,2,2021-12-08T15:56:08.413,17,False,2.0
2021,13,3244,575,17,8483,3,2,9,6,0,0,0,0,0,0,False,False,False,0,3,2021-12-08T15:33:33.623,0,False,0.0
2021,13,3244,580,17,364,13,16,9,7,0,0,0,0,0,0,False,False,False,0,3,2021-12-08T14:58:24.123,0,False,0.0
2021,13,3244,590,21,6228,2,4,10,2,3,1,2,1,2,0,False,False,False,0,1,2021-12-08T14:58:24.123,3,False,1.0
2021,13,3244,595,21,4674,13,2,10,8,0,0,0,0,0,0,False,False,False,0,3,2021-12-06T13:55:22.903,0,False,0.0
2021,13,3244,645,17,8483,2,35,1,21,25,4,25,0,25,0,False,False,False,0,2,2021-12-06T14:47:02.593,25,False,0.0
2021,13,3244,650,17,2253,2,2,10,10,11,1,10,1,10,0,False,False,False,0,2,2021-12-08T15:35:29.047,11,False,1.0
2021,13,3244,655,17,364,2,46,3,1,13,12,1,12,1,0,True,False,False,1,3,2021-12-08T15:21:56.66,13,False,12.0
2021,13,3244,660,17,7024,2,46,3,3,3,0,3,0,3,0,False,False,False,0,1,2021-12-08T15:35:45.947,3,False,0.0
2021,13,3244,670,17,4752,2,30,3,2,2,0,2,0,2,6,False,False,False,0,3,2021-12-06T15:03:37.913,2,False,0.0
2021,13,3244,690,21,6228,13,32,3,1,0,0,0,0,0,0,False,False,False,0,1,2021-12-08T15:56:15.563,0,False,0.0
2021,13,3244,715,17,6274,13,35,10,11,0,0,0,0,0,0,False,False,False,0,3,2021-12-08T15:36:48.02,0,False,0.0
2021,13,3244,725,21,7090,2,49,10,-2,9,11,4,5,4,0,False,False,False,0,3,2021-12-06T15:25:24.873,9,False,5.0
2021,13,3244,740,21,3957,2,48,10,-4,8,12,4,4,4,0,False,False,False,0,1,2021-12-06T15:28:50.237,8,False,4.0
2021,13,3244,745,21,813,13,51,3,-2,0,0,0,0,0,0,False,False,False,0,3,2021-12-08T15:56:26.343,0,False,0.0
2021,13,3244,755,21,6228,2,50,3,-1,2,3,0,2,0,0,False,False,False,0,2,2021-12-08T14:58:24.153,2,False,2.0
2021,13,3244,760,21,7090,13,19,6,27,0,0,0,0,0,0,False,False,False,0,2,2021-12-06T15:38:20.147,0,False,0.0
2021,13,3244,765,21,813,13,32,5,5,0,0,0,0,0,0,False,False,False,0,3,2021-12-06T15:39:45.88,0,False,0.0
2021,13,3244,785,17,364,13,47,5,-2,0,0,0,0,0,0,True,False,False,0,3,2021-12-06T15:44:47.57,0,False,0.0
2021,13,3244,790,17,2253,2,29,6,16,16,0,16,0,16,0,False,False,False,0,2,2021-12-08T15:13:19.727,16,True,0.0
2021,13,3244,810,17,6274,2,35,9,14,17,3,14,3,14,0,False,False,False,0,3,2021-12-06T15:53:02.86,17,False,3.0
2021,13,3244,860,21,4422,2,31,10,3,10,7,8,2,8,0,False,False,False,0,3,2021-12-06T15:59:14.65,10,False,2.0
2021,13,3244,865,21,6228,13,47,5,-2,0,0,0,0,0,0,False,False,False,0,1,2021-12-06T16:01:52.24,0,False,
2021,13,3244,870,21,6228,2,31,10,-1,11,12,11,0,11,0,False,False,False,0,1,2021-12-08T15:56:35.993,11,False,0.0
2021,13,3244,880,21,6228,2,31,10,1,11,10,9,2,9,0,False,False,False,0,1,2021-12-08T15:56:43.493,11,False,2.0
2021,13,3245,10,13,6893,13,12,5,4,0,0,0,0,0,0,False,False,False,0,3,2021-12-06T10:19:42.87,0,False,0.0
2021,13,3245,65,13,1510,2,16,4,3,15,12,12,3,12,0,False,False,False,0,1,2021-12-08T16:54:55.403,15,False,3.0
2021,13,3245,70,13,4662,2,53,10,-4,5,9,4,1,4,0,False,True,True,0,4,2021-12-06T10:51:08.103,5,False,1.0
2021,13,3245,80,14,7584,2,5,3,5,12,7,11,1,11,0,False,False,False,0,3,2021-12-08T16:44:53.01,12,False,1.0
2021,13,3245,95,14,6543,2,48,10,-5,4,9,3,1,3,0,False,False,False,0,1,2021-12-06T11:00:24.66,4,False,1.0
2021,13,3245,100,14,7584,2,4,10,5,8,3,5,3,5,0,False,False,False,1,2,2021-12-06T11:02:10.52,8,False,3.0
2021,13,3245,115,14,8400,13,4,4,8,0,0,0,0,0,0,False,False,False,0,3,2021-12-08T15:26:18.797,0,False,0.0
2021,13,3245,125,13,876,13,51,10,2,0,0,0,0,0,0,False,False,False,0,3,2021-12-08T15:53:35.803,0,False,0.0
2021,13,3245,135,13,2407,13,3,3,9,0,0,0,0,0,0,False,False,False,0,2,2021-12-06T11:13:49.863,0,False,0.0
2021,13,3245,145,14,7584,2,6,10,5,9,4,5,4,5,0,False,False,False,0,2,2021-12-06T11:16:21.683,9,False,4.0
2021,13,3245,160,14,1114,2,5,5,14,14,0,14,0,14,0,False,False,False,0,2,2021-12-06T11:20:36.743,14,False,0.0
2021,13,3245,185,14,7584,13,35,9,8,0,0,0,0,0,0,False,False,False,0,3,2021-12-06T11:25:48.41,0,False,0.0
2021,13,3245,205,13,2407,13,5,5,6,0,0,0,0,0,0,False,False,False,0,3,2021-12-06T11:35:06.257,0,False,0.0
2021,13,3245,225,14,6543,13,9,6,37,0,0,0,0,0,0,True,False,False,0,3,2021-12-06T11:41:24.307,0,False,0.0
2021,13,3245,230,14,4449,13,12,3,12,0,0,0,0,0,0,False,False,False,0,3,2021-12-06T11:43:09.587,0,False,0.0
2021,13,3245,245,13,876,13,4,5,9,0,0,0,0,0,0,False,False,False,0,2,2022-02-22T19:38:34.87,0,False,0.0
2021,13,3245,250,13,4662,2,32,10,1,12,11,8,4,8,0,False,False,False,0,4,2021-12-06T11:50:11.677,12,False,4.0
2021,13,3245,255,13,8418,13,35,6,29,0,0,0,0,0,0,False,False,False,0,4,2021-12-08T17:03:15.84,0,False,0.0
2021,13,3245,270,13,8417,2,35,7,20,23,3,22,1,22,0,False,False,False,0,2,2021-12-06T11:57:02.5,23,False,
2021,13,3245,285,13,876,13,52,10,4,0,0,0,0,0,0,False,False,False,0,3,2021-12-08T15:26:18.797,0,False,0.0
2021,13,3245,295,14,4449,2,13,10,4,6,2,5,1,5,0,False,False,False,0,3,2022-02-22T19:39:51.963,6,False,1.0
2021,13,3245,345,14,1119,2,4,4,5,13,8,11,2,11,0,False,False,False,0,3,2021-12-06T12:21:51.177,13,False,2.0
2021,13,3245,360,14,7495,2,35,5,2,2,0,2,0,2,6,False,False,False,0,3,2021-12-08T15:26:18.797,2,True,0.0
2021,13,3245,375,13,1510,2,12,3,1,4,3,4,0,4,0,False,False,False,0,1,2021-12-07T20:27:36.863,4,False,
2021,13,3245,430,14,1114,2,4,3,7,8,1,7,1,7,0,False,False,False,0,2,2021-12-06T12:42:17.913,8,False,1.0
2021,13,3245,440,14,7584,2,4,10,14,17,3,15,2,15,0,False,False,False,0,3,2021-12-08T17:04:12.48,17,False,2.0
2021,13,3245,450,14,6543,2,11,3,4,24,20,16,8,16,0,False,False,False,0,1,2021-12-08T15:26:18.813,24,False,8.0
2021,13,3245,465,14,7584,3,4,10,3,0,0,0,0,0,0,False,False,False,0,3,2021-12-06T12:55:51.297,0,False,0.0
2021,13,3245,485,13,6282,2,46,9,0,11,11,9,2,9,0,False,False,False,0,1,2021-12-06T13:05:10.05,11,False,2.0
2021,13,3245,495,13,4662,2,30,3,1,2,1,2,0,2,0,False,False,False,0,1,2021-12-06T14:59:00.26,2,False,0.0
2021,13,3245,500,13,8418,13,16,10,6,0,0,0,0,0,0,False,False,False,0,3,2021-12-06T13:11:33.243,0,False,0.0
2021,13,3245,515,14,7584,2,5,3,14,14,0,14,0,14,0,False,False,False,0,3,2021-12-06T13:15:24.697,14,False,0.0
2021,13,3245,530,14,6543,2,4,9,4,4,0,4,0,4,0,False,False,False,0,3,2021-12-06T13:19:44.85,4,True,0.0
2021,13,3245,550,13,876,2,2,4,6,10,4,10,0,10,0,False,False,False,0,3,2021-12-08T15:26:18.813,10,True,0.0
2021,13,3245,560,13,4662,2,13,10,3,4,1,3,1,3,0,False,False,False,0,4,2021-12-06T13:31:09.14,4,False,1.0
2021,13,3245,570,13,2407,13,43,6,15,0,0,0,0,0,0,False,False,False,0,3,2021-12-08T16:45:47.39,0,False,0.0
2021,13,3245,590,13,8417,13,4,3,8,0,0,0,0,0,0,False,False,False,0,2,2021-12-06T13:42:03.81,0,False,0.0
2021,13,3245,595,14,7584,2,13,9,4,17,13,11,6,11,0,False,False,False,0,3,2021-12-06T13:43:46.19,17,False,6.0
2021,13,3245,615,14,5197,2,32,5,-1,0,1,-1,1,-1,0,False,False,False,0,4,2022-02-16T14:41:39.117,0,False,1.0
2021,13,3245,625,14,8400,2,6,9,5,6,1,5,1,5,0,False,False,False,0,3,2021-12-06T13:54:10.663,6,False,1.0
2021,13,3245,630,14,4449,13,2,4,4,0,0,0,0,0,0,False,False,False,0,3,2021-12-08T16:46:11.64,0,False,0.0
2021,13,3245,645,13,1510,13,48,9,-3,0,0,0,0,0,0,False,False,False,0,1,2021-12-08T17:00:21.897,0,False,0.0
2021,13,3245,650,13,6893,13,39,4,5,0,0,0,0,0,0,False,False,False,0,3,2022-02-22T19:38:24.37,0,False,0.0
2021,13,3245,685,13,6490,13,44,3,-1,0,0,0,0,0,0,False,False,False,0,1,2021-12-06T14:12:40.963,0,False,0.0
2021,13,3245,690,13,2407,13,19,3,8,0,0,0,0,0,0,False,False,False,0,3,2021-12-08T17:01:34.063,0,False,0.0
2021,13,3245,700,13,876,2,13,9,4,14,10,14,0,14,0,False,False,False,0,3,2021-12-06T14:18:17.973,14,False,0.0
2021,13,3245,780,13,876,2,8,9,12,14,2,14,0,14,0,False,False,False,0,2,2021-12-06T14:37:38.647,14,False,0.0
2021,13,3245,795,13,8418,2,32,3,-5,2,7,-1,3,-1,0,False,False,False,0,4,2021-12-08T17:02:03.157,2,False,3.0
2021,13,3245,800,13,8418,2,12,5,5,5,0,5,0,5,0,False,False,False,0,4,2021-12-07T20:27:13.347,5,False,0.0
2021,13,3245,805,13,4662,13,39,4,4,0,0,0,0,0,0,False,False,False,0,4,2021-12-08T16:46:24.56,0,False,0.0
2021,13,3246,20,18,6361,2,53,9,-3,19,22,18,1,18,0,False,False,False,0,4,2021-12-08T18:01:34.57,19,False,1.0
2021,13,3246,30,18,1381,13,24,6,26,0,0,0,0,0,0,False,False,False,0,3,2021-12-08T18:02:59.67,0,False,0.0
2021,13,3246,35,18,1381,2,50,3,-1,0,1,-1,1,-1,0,False,False,False,0,2,2021-12-08T18:03:08.97,0,False,1.0
2021,13,3246,55,11,6629,13,38,3,3,0,0,0,0,0,0,False,False,False,0,1,2021-12-07T21:03:30.183,0,False,0.0
2021,13,3246,60,11,6810,3,32,5,3,0,0,0,0,0,0,False,False,False,0,4,2021-12-06T11:12:38.38,0,False,0.0
2021,13,3246,65,11,4037,2,13,9,3,9,6,7,2,7,0,False,False,False,0,2,2021-12-08T18:27:06.02,9,False,2.0
2021,13,3246,75,18,7711,2,4,10,13,18,5,16,2,16,0,False,False,False,0,3,2022-02-16T14:33:13.237,18,False,2.0
2021,13,3246,85,18,6361,2,53,9,-3,-2,1,-2,0,-2,0,False,False,False,0,4,2021-12-06T13:25:22.593,-2,False,0.0
2021,13,3246,90,18,4940,2,18,5,-2,-2,0,-2,0,-2,0,False,False,False,0,2,2021-12-06T13:25:33.657,-2,False,0.0
2021,13,3246,125,18,7711,2,35,3,22,34,12,31,3,31,0,False,False,False,0,2,2022-02-22T19:28:11.45,34,False,3.0
2021,13,3246,130,18,7712,13,12,5,2,0,0,0,0,0,0,False,False,False,0,2,2022-02-16T14:33:32.393,0,False,0.0
2021,13,3246,150,18,6361,2,6,4,5,6,1,5,1,5,0,True,False,False,0,3,2021-12-06T12:03:22.74,6,False,1.0
2021,13,3246,160,18,8383,13,46,3,3,0,0,0,0,0,0,False,False,False,0,1,2021-12-07T17:07:52,0,False,0.0
2021,13,3246,165,18,7712,13,2,9,5,0,0,0,0,0,0,False,False,False,0,2,2021-12-07T17:08:05.32,0,False,0.0
2021,13,3246,180,11,4561,2,12,3,4,9,5,7,2,7,0,False,False,False,0,1,2021-12-06T18:45:01.637,9,False,2.0
2021,13,3246,195,11,6810,2,17,1,25,25,0,25,0,25,0,False,False,False,0,3,2021-12-08T18:28:45.943,25,False,0.0
2021,13,3246,205,11,6810,2,2,4,9,9,0,9,0,9,6,False,False,False,0,3,2021-12-06T12:29:37.373,9,True,0.0
2021,13,3246,220,18,7712,2,30,9,-1,7,8,4,3,4,0,True,False,False,0,3,2021-12-08T18:18:44.063,7,False,3.0
2021,13,3246,255,11,4875,2,2,10,6,28,22,8,20,8,0,False,False,False,1,2,2021-12-07T21:03:46.963,28,False,20.0
2021,13,3246,260,11,8641,2,17,8,21,23,2,21,2,21,6,False,False,False,0,4,2021-12-06T12:58:10.39,23,False,2.0
2021,13,3246,275,18,6900,2,47,10,4,14,10,10,4,10,0,False,False,False,0,1,2021-12-06T18:29:30.95,14,False,4.0
2021,13,3246,290,18,8383,2,32,5,1,6,5,6,0,6,0,False,False,False,0,4,2021-12-08T18:20:56.06,6,False,0.0
2021,13,3246,305,11,8359,2,30,5,1,6,5,4,2,4,0,False,False,False,0,4,2022-02-16T14:34:08.41,6,False,2.0
2021,13,3246,330,11,8641,2,39,4,5,5,0,5,0,5,0,False,False,False,0,3,2021-12-06T13:32:52.877,5,False,0.0
2021,13,3246,335,11,4875,2,35,9,12,27,15,24,3,24,0,False,False,False,0,3,2021-12-06T13:37:10.867,27,False,3.0
2021,13,3246,350,11,8359,2,30,5,1,7,6,6,1,6,0,True,False,False,0,4,2021-12-08T18:29:29.91,7,False,1.0
2021,13,3246,390,18,7711,2,4,5,3,2,-1,2,0,2,0,True,False,False,0,2,2021-12-06T13:59:47.467,2,False,0.0
2021,13,3246,400,18,7711,2,6,10,13,16,3,14,2,14,0,False,False,False,0,3,2021-12-08T18:22:28.517,16,False,2.0
2021,13,3246,405,18,7711,2,6,10,13,15,2,15,0,15,0,False,False,False,0,2,2021-12-06T14:07:14.423,15,False,0.0
2021,13,3246,410,18,6361,13,7,5,12,0,0,0,0,0,0,False,False,False,0,4,2021-12-08T15:47:53.07,0,False,0.0
2021,13,3246,415,18,7711,13,9,2,20,0,0,0,0,0,0,False,False,False,0,2,2021-12-06T14:11:31.17,0,False,0.0
2021,13,3246,420,18,4940,13,17,7,25,0,0,0,0,0,0,False,False,False,0,3,2022-02-16T14:34:49.603,0,False,0.0
2021,13,3246,430,11,8359,2,32,10,-1,6,7,6,0,6,0,False,False,False,0,3,2021-12-08T18:08:42.56,6,True,0.0
2021,13,3246,435,11,4037,2,6,7,21,24,3,24,0,24,0,False,False,False,0,2,2021-12-06T14:24:56.723,24,False,0.0
2021,13,3246,445,11,8359,2,5,3,7,7,0,7,0,7,0,False,False,False,0,3,2021-12-06T14:26:56.383,7,True,0.0
2021,13,3246,455,11,4875,13,19,6,23,0,0,0,0,0,0,False,False,False,0,2,2021-12-08T18:00:40.163,0,False,0.0
2021,13,3246,485,11,6810,13,54,10,-5,0,0,0,0,0,0,True,False,False,0,4,2021-12-06T18:55:44.143,0,False,0.0
2021,13,3246,495,11,6571,3,28,5,0,0,0,0,0,0,0,False,False,False,0,1,2021-12-06T19:04:00.34,0,False,0.0
2021,13,3246,505,18,7711,2,30,10,1,11,10,11,0,11,0,False,False,False,0,3,2021-12-06T18:30:10.037,11,True,0.0
2021,13,3246,515,18,6361,2,6,4,3,5,2,3,2,3,0,False,False,False,0,4,2021-12-06T14:57:11.123,5,False,2.0
2021,13,3246,525,18,4152,2,17,4,12,19,7,17,2,17,0,True,False,False,0,1,2021-12-08T18:23:11.657,19,False,2.0
2021,13,3246,545,18,7711,13,2,9,3,0,0,0,0,0,0,False,False,False,0,2,2022-02-25T15:54:01.227,0,False,0.0
2021,13,3246,550,18,6361,2,39,4,9,10,1,10,0,10,0,False,False,False,0,4,2021-12-06T15:08:04.37,10,False,0.0
2021,13,3246,555,18,6361,13,9,5,12,0,0,0,0,0,0,False,False,False,0,2,2021-12-08T18:01:20.903,0,False,0.0
2021,13,3246,575,11,8361,13,12,3,0,0,0,0,0,0,0,False,False,False,0,1,2022-02-24T17:53:47.37,0,False,0.0
2021,13,3246,590,18,7711,2,23,7,45,48,3,42,6,42,0,False,False,False,0,3,2022-02-22T19:31:45.21,48,False,6.0
2021,13,3246,600,18,7711,13,3,2,15,0,0,0,0,0,0,False,False,False,0,2,2021-12-08T15:29:33.183,0,False,0.0
2021,13,3246,605,18,6361,2,5,5,7,7,0,7,0,7,0,False,False,False,0,3,2021-12-06T15:31:23.007,7,False,0.0
2021,13,3246,625,11,4875,2,12,10,8,8,0,8,0,8,0,False,False,False,0,2,2021-12-06T15:38:37.117,8,False,0.0
2021,13,3246,645,11,6810,13,9,2,24,0,0,0,0,0,0,False,False,False,0,3,2021-12-06T18:57:47.323,0,False,
2021,13,3246,650,11,6810,13,7,6,36,0,0,0,0,0,0,False,False,False,0,3,2021-12-06T15:50:41.227,0,False,0.0
2021,13,3246,675,18,7711,2,5,2,16,16,0,16,0,16,0,False,False,False,0,2,2021-12-06T15:57:41.557,16,False,0.0
2021,13,3246,690,18,6900,2,4,9,-4,4,8,2,2,2,0,False,False,False,0,1,2021-12-06T18:34:57.283,4,False,2.0
2021,13,3246,700,18,7712,2,7,2,16,21,5,21,0,21,0,True,False,False,0,3,2021-12-07T17:09:17.86,21,True,0.0
2021,13,3246,705,18,7712,2,35,9,7,14,7,13,1,13,0,False,False,False,0,3,2021-12-06T16:10:13.743,14,False,1.0
2021,13,3246,720,18,6900,2,4,4,4,16,12,13,3,13,0,False,False,False,0,1,2021-12-08T18:24:08.163,16,False,3.0
2021,13,3246,730,18,7712,13,2,9,5,0,0,0,0,0,0,False,False,False,0,2,2021-12-08T18:02:46,0,False,0.0
2021,13,3246,735,18,7712,2,2,4,5,5,0,5,0,5,6,False,False,False,0,3,2021-12-06T16:23:57.023,5,True,0.0
2021,13,3246,765,11,8359,2,2,4,12,14,2,14,0,14,0,False,False,False,0,3,2021-12-06T16:36:47.747,14,False,0.0
2021,13,3246,775,11,8359,13,26,10,5,0,0,0,0,0,0,False,False,False,0,3,2021-12-06T16:48:22.25,0,False,0.0
2021,13,3246,780,11,6810,13,39,9,7,0,0,0,0,0,0,False,False,False,0,3,2021-12-08T18:05:37.43,0,False,0.0
2021,13,3246,785,18,7711,2,4,9,13,14,1,13,1,13,0,False,False,False,0,2,2022-02-16T14:35:42.873,14,False,1.0
2021,13,3246,790,18,7711,2,18,3,-3,5,8,3,2,3,0,False,False,False,0,2,2022-02-16T14:36:03.71,5,False,2.0
2021,13,3246,805,18,8383,2,45,10,-5,-2,3,-2,0,-2,0,False,False,False,0,1,2021-12-08T18:24:28.027,-2,False,0.0
2021,13,3246,810,18,6361,2,32,3,6,11,5,11,0,11,0,False,False,False,0,4,2021-12-06T17:04:27.097,11,False,0.0
2021,13,3246,820,11,8641,3,46,3,2,0,0,0,0,0,0,False,False,False,0,4,2021-12-06T17:10:42.28,0,False,0.0
2021,13,3246,825,11,8359,2,5,5,5,9,4,7,2,7,0,False,False,False,0,1,2021-12-06T17:11:05.087,9,False,2.0
2021,13,3246,880,18,7711,2,13,9,3,3,0,3,0,3,6,False,False,False,0,3,2021-12-06T17:28:39.7,3,True,0.0
2021,13,3246,895,11,6810,2,13,10,4,5,1,4,1,4,0,True,False,False,0,2,2021-12-06T17:31:32.053,5,False,1.0
2021,13,3246,900,11,4875,2,13,10,5,6,1,6,0,6,0,False,False,False,0,3,2021-12-06T17:33:38.68,6,False,0.0
2021,13,3246,910,11,4875,3,39,4,5,0,0,0,0,0,0,False,False,False,0,3,2022-02-16T14:36:32.513,0,False,0.0
2021,13,3246,915,11,6571,2,28,4,6,13,7,9,4,9,0,False,False,False,1,1,2021-12-08T18:09:15.727,13,False,4.0
2021,13,3246,920,11,6633,2,4,3,9,9,0,9,0,9,0,False,False,False,0,2,2021-12-06T17:42:05.273,9,False,0.0
2021,13,3246,925,11,8359,2,5,5,6,9,3,9,0,9,0,False,False,False,0,3,2021-12-06T17:44:30.683,9,True,0.0
2021,13,3246,930,11,8359,2,4,9,6,9,3,7,2,7,0,False,False,False,0,3,2021-12-06T17:46:28.183,9,False,2.0
2021,13,3246,935,11,8359,13,17,2,24,0,0,0,0,0,0,False,False,False,0,3,2021-12-06T17:49:06.917,0,False,0.0
2021,13,3246,945,11,6810,2,4,9,8,10,2,10,0,10,0,False,False,False,0,3,2021-12-06T17:52:17.687,10,False,0.0
2021,13,3246,955,11,8359,2,5,5,8,8,0,8,0,8,0,False,False,False,0,3,2021-12-06T17:54:32.397,8,False,0.0
2021,13,3246,965,11,4875,13,4,10,11,0,0,0,0,0,0,False,False,False,0,2,2021-12-06T17:56:52.68,0,False,0.0
2021,13,3246,975,11,8359,2,4,3,11,11,0,11,0,11,6,False,False,False,0,2,2021-12-06T17:58:59.797,11,True,0.0
2021,13,3247,15,22,743,2,44,9,-3,8,11,6,2,6,0,False,False,False,0,1,2021-12-06T10:17:10.563,8,False,2.0
2021,13,3247,20,22,743,2,48,4,-1,7,8,4,3,4,0,False,False,False,0,1,2021-12-06T10:19:09.323,7,False,3.0
2021,13,3247,30,22,8454,2,2,9,3,3,0,3,0,3,6,False,False,False,0,3,2021-12-06T10:23:05.663,3,True,0.0
2021,13,3247,50,24,6373,2,53,10,-5,16,21,14,2,14,0,False,False,False,0,4,2021-12-06T10:25:57.603,16,False,2.0
2021,13,3247,60,24,6373,2,47,5,1,9,8,2,7,2,0,False,False,False,1,4,2021-12-06T10:28:30.7,9,False,7.0
2021,13,3247,70,24,6373,2,35,7,25,36,11,26,10,26,6,True,False,False,1,4,2021-12-08T16:57:34.257,36,False,10.0
2021,13,3247,90,22,3170,13,2,10,4,0,0,0,0,0,0,False,False,False,0,3,2022-02-16T15:18:37.88,0,False,0.0
2021,13,3247,95,22,5080,2,2,9,7,10,3,7,3,7,0,False,False,False,0,2,2021-12-08T16:07:08.597,10,False,3.0
2021,13,3247,100,22,8454,2,51,5,-1,7,8,6,1,6,0,True,False,False,0,3,2021-12-08T16:08:06.823,7,False,1.0
2021,13,3247,110,22,8454,2,4,5,5,5,0,5,0,5,0,False,False,False,0,2,2021-12-06T10:47:12.683,5,False,0.0
2021,13,3247,130,22,3170,2,51,3,-3,10,13,9,1,9,0,True,False,False,0,3,2021-12-06T10:52:28.54,10,False,1.0
2021,13,3247,155,24,6373,2,53,9,-3,12,15,8,4,8,0,False,False,False,0,4,2021-12-06T10:57:30.07,12,False,4.0
2021,13,3247,170,24,7800,2,13,10,4,10,6,5,5,5,0,False,False,False,0,3,2021-12-08T16:57:58.447,10,False,5.0
2021,13,3247,175,24,6937,2,5,10,2,12,10,11,1,11,0,False,False,False,0,1,2021-12-06T11:04:44.943,12,False,1.0
2021,13,3247,190,24,8513,2,48,10,-4,5,9,4,1,4,0,False,False,False,0,1,2021-12-06T11:12:02.867,5,False,1.0
2021,13,3247,195,24,6373,2,9,2,16,25,9,20,5,20,6,False,False,False,0,3,2021-12-06T11:15:32.603,25,False,5.0
2021,13,3247,215,22,8454,2,4,7,19,29,10,25,4,25,0,False,False,False,0,3,2021-12-06T15:04:13.927,29,False,4.0
2021,13,3247,225,22,743,2,48,9,-5,4,9,2,2,2,0,False,False,False,0,1,2021-12-08T16:52:22.517,4,False,2.0
2021,13,3247,230,22,3170,2,17,10,9,19,10,16,3,16,0,True,False,False,0,3,2021-12-08T16:09:34.933,19,False,3.0
2021,13,3247,245,22,8454,13,7,5,1,0,0,0,0,0,0,False,False,False,0,2,2022-02-16T15:19:03.837,0,False,0.0
2021,13,3247,250,22,2391,2,7,10,1,1,0,1,0,1,6,False,False,False,0,4,2021-12-06T11:31:22.487,1,True,0.0
2021,13,3247,270,24,8509,2,5,5,4,13,9,4,9,4,0,False,False,False,1,1,2021-12-06T11:35:57.827,13,False,9.0
2021,13,3247,280,24,8513,2,16,10,1,16,15,12,4,12,0,False,False,False,0,1,2021-12-06T11:38:52.48,16,False,4.0
2021,13,3247,300,24,8513,2,5,9,1,12,11,9,3,9,0,False,False,False,0,1,2021-12-08T16:52:32.927,12,False,3.0
2021,13,3247,320,22,5080,2,4,9,5,5,0,5,0,5,0,False,False,False,0,3,2021-12-08T16:52:42.42,5,False,0.0
2021,13,3247,375,24,7800,2,35,6,15,22,7,22,0,22,0,False,False,False,0,3,2021-12-08T16:54:59.183,22,True,0.0
2021,13,3247,395,24,8513,2,48,10,-2,-2,0,-2,0,-2,0,False,False,False,0,1,2021-12-06T12:11:43.513,-2,False,0.0
2021,13,3247,405,24,8513,2,47,5,2,2,0,2,0,2,0,False,False,False,0,1,2021-12-06T12:13:02.863,2,True,0.0
2021,13,3247,475,24,7800,2,12,6,21,28,7,26,2,26,0,False,False,False,0,3,2022-02-24T17:55:08.56,28,False,2.0
2021,13,3247,485,24,8509,13,19,2,28,0,0,0,0,0,0,False,False,False,0,2,2021-12-06T12:43:22.977,0,False,0.0
2021,13,3247,490,24,6373,13,7,7,22,0,0,0,0,0,0,False,False,False,0,3,2021-12-07T20:25:16.733,0,False,
2021,13,3247,520,22,743,3,47,5,1,0,0,0,0,0,0,False,False,False,0,1,2021-12-06T12:56:20.137,0,False,0.0
2021,13,3247,535,22,8454,13,6,4,12,0,0,0,0,0,0,False,False,False,0,3,2022-02-16T15:19:54.693,0,False,0.0
2021,13,3247,550,24,6937,2,44,9,-1,9,10,7,2,7,0,False,False,False,0,1,2021-12-06T13:07:34.133,9,False,2.0
2021,13,3247,560,24,7798,2,12,5,5,7,2,7,0,7,0,False,False,False,1,3,2021-12-06T13:11:32.58,7,True,0.0
2021,13,3247,565,24,8509,13,6,5,13,0,0,0,0,0,0,False,False,False,0,3,2021-12-06T13:13:06.773,0,False,0.0
2021,13,3247,580,24,6373,2,4,10,8,7,-1,7,0,7,0,False,False,False,0,4,2021-12-06T13:16:51.63,7,False,0.0
2021,13,3247,585,24,8509,2,13,10,2,2,0,2,0,2,0,True,False,False,0,2,2021-12-06T13:17:53.343,2,False,0.0
2021,13,3247,630,22,5080,13,35,5,12,0,0,0,0,0,0,False,False,False,0,4,2022-02-16T15:20:55.45,0,True,0.0
2021,13,3247,635,22,8454,2,8,4,14,18,4,15,3,15,0,False,False,False,0,3,2021-12-06T13:33:46.733,18,False,3.0
2021,13,3247,640,22,2391,2,38,3,13,14,1,14,0,14,0,False,False,False,0,4,2021-12-06T13:58:33.58,14,False,0.0
2021,13,3247,650,22,8454,3,4,6,20,0,0,0,0,0,0,False,False,False,0,3,2022-02-16T15:22:24.127,0,False,0.0
2021,13,3247,655,22,3170,13,39,1,19,0,0,0,0,0,0,True,False,False,0,3,2021-12-08T17:01:14.467,0,False,0.0
2021,13,3247,680,24,6937,2,28,10,-4,1,5,-2,3,-2,0,False,False,False,1,1,2021-12-06T13:56:14.267,1,False,3.0
2021,13,3247,705,22,3170,2,4,10,5,19,14,5,14,5,0,False,False,False,2,3,2021-12-06T14:05:46.913,19,False,14.0
2021,13,3247,710,22,7229,2,4,4,2,11,9,10,1,10,0,False,False,False,1,1,2021-12-06T14:07:00.69,11,False,1.0
2021,13,3247,715,22,7229,2,48,9,-6,-2,4,-3,1,-3,0,False,False,False,0,1,2021-12-06T14:08:09.477,-2,False,1.0
2021,13,3247,720,22,8454,2,4,10,11,15,4,13,2,13,0,False,False,False,0,2,2021-12-06T14:09:48.547,15,False,2.0
2021,13,3247,730,22,7118,2,4,10,12,11,-1,11,0,11,0,False,False,False,0,3,2021-12-06T14:12:10.89,11,False,
2021,13,3247,735,22,8454,13,21,2,33,0,0,0,0,0,0,False,False,False,0,2,2021-12-06T14:17:13.857,0,False,0.0
2021,13,3247,740,22,6812,3,4,10,3,0,0,0,0,0,0,False,False,False,0,1,2022-02-16T15:23:10.04,0,False,0.0
2021,13,3247,745,22,8454,13,8,7,27,0,0,0,0,0,0,False,False,False,0,3,2021-12-08T16:54:39.31,0,False,0.0
2021,13,3247,750,22,6812,13,12,10,5,0,0,0,0,0,0,False,False,False,0,1,2021-12-08T16:12:47.45,0,False,0.0
2021,13,3247,805,22,7610,2,4,10,5,4,-1,4,0,4,0,False,False,False,1,3,2021-12-06T14:44:38.86,4,False,0.0
2021,13,3247,810,22,3170,2,4,10,13,14,1,14,0,14,0,False,False,False,0,3,2021-12-08T16:17:17.04,14,False,0.0
2021,13,3247,815,22,8801,13,8,8,16,0,0,0,0,0,0,False,False,False,0,3,2022-02-16T15:24:06.007,0,False,0.0
2021,13,3247,820,22,8454,3,12,2,43,0,0,0,0,0,0,False,False,False,0,3,2021-12-08T16:14:51.373,0,False,0.0
2021,13,3247,825,22,6812,2,4,4,5,7,2,6,1,6,0,False,False,False,0,1,2021-12-08T16:15:15.233,7,False,1.0
2021,13,3247,830,22,6812,2,12,3,5,7,2,6,1,6,0,False,False,False,0,1,2021-12-08T16:03:01.34,7,False,1.0
2021,13,3247,840,22,6270,2,5,10,11,11,0,11,0,11,0,False,False,False,0,3,2021-12-06T14:57:48.47,11,False,0.0
2021,13,3248,35,16,4143,2,46,3,1,9,8,7,2,7,0,False,False,False,0,2,2021-12-06T13:05:02.727,9,False,2.0
2021,13,3248,45,16,374,2,33,9,3,9,6,8,1,8,0,True,False,False,0,4,2021-12-06T17:27:43.14,9,False,1.0
2021,13,3248,60,16,3938,13,12,7,22,0,0,0,0,0,0,False,False,False,0,3,2021-12-08T17:39:51.477,0,False,
2021,13,3248,65,16,4143,2,4,9,5,12,7,12,0,12,0,False,False,False,1,3,2021-12-06T13:17:08.113,12,False,0.0
2021,13,3248,70,16,3938,2,2,9,4,13,9,12,1,12,0,False,False,False,1,3,2021-12-06T13:18:35.65,13,False,1.0
2021,13,3248,75,16,374,13,16,4,6,0,0,0,0,0,0,True,False,False,0,3,2021-12-06T13:19:50.557,0,False,0.0
2021,13,3248,85,16,3938,2,13,9,2,9,7,9,0,9,0,False,False,False,0,3,2021-12-08T17:40:05.493,9,False,0.0
2021,13,3248,110,10,6281,13,2,10,9,0,0,0,0,0,0,False,False,False,0,2,2021-12-06T13:29:38.297,0,False,0.0
2021,13,3248,130,16,7681,2,48,10,-4,29,33,11,18,11,0,False,False,False,0,1,2021-12-08T18:04:01.837,29,False,18.0
2021,13,3248,135,16,374,13,2,10,13,0,0,0,0,0,0,False,False,False,0,4,2021-12-06T13:37:17.283,0,False,0.0
2021,13,3248,140,16,6500,3,8,7,15,0,0,0,0,0,0,False,False,False,0,3,2021-12-06T13:38:53.17,0,False,0.0
2021,13,3248,145,16,6500,2,6,10,8,14,6,9,5,9,0,False,False,False,0,3,2021-12-06T13:42:46.6,14,False,5.0
2021,13,3248,155,16,7681,2,48,9,-8,-7,1,-7,0,-7,0,False,False,False,0,1,2021-12-06T13:45:22.363,-7,False,0.0
2021,13,3248,160,16,6500,3,38,10,-1,0,0,0,0,0,0,False,False,False,0,3,2021-12-06T13:47:15.49,0,False,0.0
2021,13,3248,175,10,7700,2,35,6,18,36,18,34,2,34,0,False,False,False,0,3,2021-12-06T13:51:40.09,36,False,2.0
2021,13,3248,180,10,4930,13,9,2,26,0,0,0,0,0,0,False,False,False,0,2,2021-12-06T13:57:24.277,0,False,0.0
2021,13,3248,195,10,8541,3,46,9,-2,0,0,0,0,0,0,False,False,False,0,1,2022-02-16T14:44:46.08,0,False,0.0
2021,13,3248,210,10,7700,2,51,9,0,0,0,3,-3,3,0,False,False,False,2,3,2021-12-06T14:04:07.063,0,False,
2021,13,3248,220,10,6281,13,9,2,20,0,0,0,0,0,0,False,False,False,0,3,2021-12-08T17:42:51.393,0,False,0.0
2021,13,3248,225,10,7703,2,31,9,8,10,2,8,2,8,0,False,False,False,0,4,2021-12-06T14:08:53.613,10,False,2.0
2021,13,3248,245,16,3938,13,6,1,25,0,0,0,0,0,0,False,False,False,0,3,2021-12-06T14:16:07.457,0,False,0.0
2021,13,3248,250,16,374,13,6,9,7,0,0,0,0,0,0,False,False,False,0,3,2021-12-06T14:21:07.68,0,False,0.0
2021,13,3248,290,10,6281,13,8,1,45,0,0,0,0,0,0,False,False,False,0,2,2021-12-06T14:42:50.187,0,False,0.0
2021,13,3248,295,10,8541,2,5,9,2,10,8,4,6,4,0,False,False,False,0,1,2021-12-06T14:44:16.347,10,False,6.0
2021,13,3248,300,10,7703,2,30,3,3,6,3,6,0,6,0,False,False,False,0,4,2021-12-06T14:46:23.487,6,False,0.0
2021,13,3248,305,10,8541,2,48,9,-3,3,6,-1,4,-1,0,False,False,False,0,1,2022-02-16T14:46:07.587,3,False,4.0
2021,13,3248,325,10,6840,2,30,5,0,2,2,2,0,2,0,False,False,False,0,4,2021-12-06T14:59:23.933,2,True,0.0
2021,13,3248,340,10,6281,2,2,10,6,10,4,8,2,8,0,False,False,False,0,2,2021-12-06T15:02:57.903,10,False,2.0
2021,13,3248,405,10,8541,13,50,5,-4,0,0,0,0,0,0,False,False,False,0,2,2021-12-06T15:16:57.217,0,False,0.0
2021,13,3248,410,10,8541,2,8,8,17,34,17,29,5,29,0,False,False,False,0,2,2021-12-06T15:18:23.993,34,False,5.0
2021,13,3248,440,16,7176,2,51,9,-4,12,16,10,2,10,0,False,False,False,1,3,2021-12-06T15:30:46.117,12,False,2.0
2021,13,3248,445,16,7681,2,5,3,4,6,2,5,1,5,0,True,False,False,0,2,2021-12-06T15:32:42.247,6,False,1.0
2021,13,3248,450,16,3938,3,2,9,6,0,0,0,0,0,0,False,False,False,0,2,2021-12-06T15:34:13.41,0,False,0.0
2021,13,3248,455,16,6499,2,47,10,2,14,12,7,7,7,0,False,False,False,1,1,2021-12-08T18:07:16.533,14,False,7.0
2021,13,3248,460,16,3938,3,2,10,11,0,0,0,0,0,0,False,False,False,0,2,2021-12-06T15:37:41.02,0,False,0.0
2021,13,3248,475,10,6281,2,2,3,5,5,0,5,0,5,0,False,False,False,0,2,2021-12-08T18:33:42.56,5,False,0.0
2021,13,3248,485,16,374,2,12,9,9,14,5,10,4,10,0,False,False,False,0,4,2021-12-06T15:49:08.133,14,False,4.0
2021,13,3248,495,16,3938,2,12,5,1,0,-1,1,-1,1,0,False,False,False,1,3,2021-12-08T18:07:37.147,0,False,
2021,13,3248,500,16,6499,2,12,2,19,38,19,36,2,36,0,False,False,False,0,1,2021-12-06T15:55:11.083,38,False,2.0
2021,13,3248,510,16,6500,13,13,4,4,0,0,0,0,0,0,False,False,False,0,2,2021-12-08T18:39:44.38,0,False,0.0
2021,13,3248,515,16,374,13,16,3,11,0,0,0,0,0,0,True,False,False,0,3,2022-02-22T19:46:44.827,0,False,0.0
2021,13,3248,530,10,4930,2,4,5,5,9,4,6,3,6,0,True,False,False,0,3,2021-12-06T16:02:10.66,9,False,3.0
2021,13,3248,540,10,7703,2,32,9,-3,5,8,4,1,4,0,False,False,False,0,4,2021-12-08T17:45:59.643,5,False,1.0
2021,13,3248,555,10,7700,13,4,10,14,0,0,0,0,0,0,False,False,False,0,3,2021-12-08T14:04:54.377,0,False,0.0
2021,13,3248,570,16,5039,13,2,9,5,0,0,0,0,0,0,False,False,False,0,2,2021-12-06T16:13:05.387,0,False,0.0
2021,13,3248,575,16,6499,2,48,10,-4,8,12,5,3,5,0,False,False,False,0,1,2021-12-06T16:14:31.297,8,False,3.0
2021,13,3248,590,16,374,13,4,9,5,0,0,0,0,0,0,False,False,False,0,3,2021-12-06T16:16:56.663,0,False,0.0
2021,13,3248,600,16,374,2,4,4,3,4,1,3,1,3,0,False,False,False,0,3,2021-12-06T16:18:57.92,4,False,1.0
2021,13,3248,615,10,6840,2,5,3,6,8,2,8,0,8,0,False,False,False,0,4,2021-12-06T16:31:27.123,8,False,0.0
2021,13,3248,625,10,6840,3,12,5,3,0,0,0,0,0,0,False,False,False,0,4,2022-02-24T17:56:25.74,0,False,
2021,13,3248,635,10,6840,2,32,5,1,11,10,10,1,10,0,False,False,False,0,4,2021-12-06T16:36:45.947,11,False,1.0
2021,13,3248,645,10,6281,13,9,6,23,0,0,0,0,0,0,False,False,False,0,2,2021-12-08T18:40:19.05,0,False,0.0
2021,13,3248,655,10,4930,13,13,9,2,0,0,0,0,0,0,True,False,False,0,3,2021-12-06T16:46:13.53,0,False,0.0
2021,13,3248,670,10,7700,2,45,5,-2,9,11,7,2,7,0,False,False,False,0,3,2021-12-06T16:50:14.69,9,False,2.0
2021,13,3248,680,10,7700,2,45,5,-4,13,17,10,3,10,0,True,False,False,0,3,2021-12-06T16:52:30.537,13,False,3.0
2021,13,3248,685,10,4930,13,8,8,15,0,0,0,0,0,0,False,False,False,0,3,2021-12-06T16:54:13.847,0,False,0.0
2021,13,3248,690,10,4930,13,6,10,4,0,0,0,0,0,0,False,False,False,0,2,2021-12-06T16:55:18.857,0,False,0.0
2021,13,3248,695,10,6358,2,31,10,2,19,17,12,7,12,0,False,False,False,0,1,2021-12-06T16:56:32.043,19,False,7.0
2021,13,3248,705,10,7703,3,5,5,6,0,0,0,0,0,0,False,False,False,0,4,2021-12-06T16:58:26.36,0,False,
2021,13,3248,710,10,6840,2,4,10,6,12,6,8,4,8,0,False,False,False,0,4,2021-12-06T16:59:45.433,12,False,4.0
2021,13,3248,720,10,7703,13,17,10,12,0,0,0,0,0,0,False,False,False,0,4,2021-12-06T17:02:07.927,0,False,0.0
2021,13,3248,725,10,8541,2,28,9,-3,13,16,13,0,13,6,False,False,False,0,1,2021-12-06T17:03:22.88,13,True,0.0
2021,13,3248,785,10,8541,2,12,3,-3,6,9,3,3,3,0,False,False,False,0,1,2021-12-06T17:13:29.953,6,False,3.0
2021,13,3248,790,10,7700,2,6,1,16,19,3,18,1,18,0,False,False,False,0,3,2021-12-06T17:14:37.577,19,False,1.0
2021,13,3248,800,10,8541,2,44,3,0,10,10,10,0,10,0,False,False,False,0,1,2021-12-06T17:16:14.477,10,True,0.0
2021,13,3248,805,10,8541,13,6,4,4,0,0,0,0,0,0,False,False,False,0,1,2021-12-06T17:17:11.74,0,False,0.0
2021,13,3248,810,10,7938,2,4,9,4,7,3,7,0,7,0,True,False,False,0,3,2021-12-06T17:18:14.98,7,False,0.0
2021,13,3248,815,10,6281,2,13,10,2,8,6,6,2,6,0,False,False,False,0,3,2021-12-08T17:48:22.02,8,False,
2021,13,3248,820,10,7700,13,2,9,7,0,0,0,0,0,0,False,False,False,0,2,2021-12-06T17:20:41.327,0,False,0.0
2021,13,3249,20,6,4305,13,13,9,5,0,0,0,0,0,0,False,False,False,0,3,2021-12-08T19:44:05.513,0,False,0.0
2021,13,3249,40,1,894,2,6,4,10,10,0,10,0,10,0,False,False,False,0,3,2021-12-08T19:52:41.33,10,False,0.0
2021,13,3249,45,1,245,2,9,2,19,20,1,19,1,19,6,False,False,False,0,2,2021-12-08T18:27:25.787,20,False,1.0
2021,13,3249,75,6,7725,2,30,10,-2,-1,1,-2,1,-2,0,False,False,False,0,4,2021-12-06T14:33:35.277,-1,False,
2021,13,3249,85,6,6786,2,31,10,-1,12,13,11,1,11,0,False,False,False,0,1,2022-02-16T13:24:52.207,12,False,1.0
2021,13,3249,110,6,6786,2,18,3,-1,3,4,2,1,2,0,False,False,False,1,2,2021-12-08T19:47:30.833,3,False,1.0
2021,13,3249,115,6,7728,3,4,10,12,0,0,0,0,0,0,False,False,False,0,3,2021-12-08T19:44:30.247,0,False,0.0
2021,13,3249,140,1,6405,13,7,5,4,0,0,0,0,0,0,False,False,False,0,3,2021-12-08T18:27:25.787,0,False,0.0
2021,13,3249,185,6,6786,2,51,9,-6,5,11,5,0,5,0,True,False,False,0,1,2021-12-07T21:49:08.24,5,False,0.0
2021,13,3249,190,6,6786,2,28,4,3,6,3,5,1,5,0,False,False,False,0,1,2021-12-06T19:25:02.27,6,False,1.0
2021,13,3249,205,6,3233,13,4,9,4,0,0,0,0,0,0,False,False,False,0,3,2021-12-06T15:11:52.347,0,False,0.0
2021,13,3249,210,6,4305,2,50,9,-5,3,8,2,1,2,0,True,False,False,0,3,2021-12-07T21:47:39.637,3,False,1.0
2021,13,3249,215,6,4305,2,4,9,11,11,0,11,0,11,0,False,False,False,0,3,2021-12-06T15:18:42.793,11,False,0.0
2021,13,3249,235,6,3233,2,13,9,3,10,7,8,2,8,0,False,False,False,0,3,2021-12-06T15:25:46.497,10,False,2.0
2021,13,3249,275,1,7762,2,48,3,-6,12,18,-1,13,-1,0,False,False,False,2,1,2021-12-06T15:36:35.153,12,False,13.0
2021,13,3249,290,1,4587,2,45,5,0,23,23,2,21,2,6,False,False,False,1,1,2021-12-06T15:45:28.273,23,False,21.0
2021,13,3249,325,6,7725,2,51,3,-2,7,9,7,0,7,0,False,False,False,0,3,2021-12-06T15:52:42.177,2,False,0.0
2021,13,3249,330,6,7725,13,5,10,13,0,0,0,0,0,0,False,False,False,0,3,2021-12-08T19:59:05.167,0,False,0.0
2021,13,3249,345,1,894,13,4,10,5,0,0,0,0,0,0,False,False,False,0,3,2021-12-06T15:58:59.527,0,False,0.0
2021,13,3249,350,1,8439,2,49,5,-3,8,11,4,4,4,0,True,False,False,0,2,2021-12-08T19:56:13.55,8,False,4.0
2021,13,3249,385,6,3233,13,4,3,10,0,0,0,0,0,0,False,False,False,0,2,2022-02-16T13:25:30.067,0,False,0.0
2021,13,3249,390,6,7728,2,32,10,2,6,4,4,2,4,0,False,False,False,0,3,2021-12-08T19:56:47.493,6,False,2.0
2021,13,3249,440,1,8439,3,50,9,-4,0,0,0,0,0,0,False,False,False,0,3,2021-12-06T16:15:04.5,0,False,0.0
2021,13,3249,460,1,2071,2,28,9,1,7,6,5,2,5,0,False,False,False,0,1,2021-12-06T16:32:28.147,7,False,2.0
2021,13,3249,475,1,245,2,35,10,8,12,4,11,1,11,0,False,False,False,0,3,2021-12-06T16:37:26.46,12,False,1.0
2021,13,3249,480,1,4587,2,48,10,-3,13,16,8,5,8,0,False,False,False,1,1,2021-12-06T16:38:47.683,13,False,5.0
2021,13,3249,515,6,6786,2,12,3,2,10,8,9,1,9,0,False,False,False,0,1,2021-12-06T19:25:21.663,10,False,1.0
2021,13,3249,525,6,4566,3,35,9,14,0,0,0,0,0,0,False,False,False,0,3,2021-12-06T16:52:22.973,0,False,0.0
2021,13,3249,535,6,6786,2,32,5,-1,8,9,2,6,2,0,False,False,False,1,1,2021-12-06T19:25:32.27,8,False,
2021,13,3249,540,6,4305,2,11,2,16,34,18,25,9,25,0,True,False,False,0,2,2021-12-07T21:48:46.657,34,False,9.0
2021,13,3249,550,6,7728,13,35,8,13,0,0,0,0,0,0,False,False,False,0,4,2022-02-22T19:18:17.59,0,False,
2021,13,3249,555,6,6786,2,46,3,0,11,11,9,2,9,0,False,False,False,0,1,2021-12-06T19:25:51.69,11,False,2.0
2021,13,3249,560,6,7728,13,47,10,0,0,0,0,0,0,0,False,False,False,0,3,2021-12-08T19:57:39.607,0,False,0.0
2021,13,3249,570,6,6786,2,28,3,-3,2,5,2,0,2,0,False,False,False,0,1,2022-02-22T19:17:29.497,2,False,0.0
2021,13,3249,585,6,4566,13,35,5,5,0,0,0,0,0,0,False,False,False,0,3,2021-12-06T19:15:18.39,0,False,
2021,13,3249,600,6,666,2,46,3,0,1,1,1,0,1,6,False,False,False,0,3,2021-12-06T17:19:53.353,1,True,0.0
2021,13,3249,620,1,2071,2,53,9,-4,0,4,-2,2,-2,0,False,False,False,1,4,2022-02-16T13:27:24.587,0,False,2.0
2021,13,3249,625,1,6405,2,4,10,4,4,0,4,0,4,0,False,False,False,0,3,2021-12-06T17:49:41.507,4,False,0.0
2021,13,3249,630,1,6405,13,5,7,17,0,0,0,0,0,0,False,False,False,0,3,2021-12-06T19:15:33.503,0,False,
2021,13,3249,655,1,6405,13,35,9,9,0,0,0,0,0,0,False,False,False,0,3,2021-12-06T17:58:07.49,0,False,0.0
2021,13,3249,670,6,3233,2,4,10,4,7,3,7,0,7,0,False,False,False,0,3,2021-12-06T18:00:37.817,7,False,0.0
2021,13,3249,675,6,3233,13,4,5,9,0,0,0,0,0,0,False,False,False,0,2,2022-02-25T15:55:03.3,0,False,0.0
2021,13,3249,680,6,7725,2,2,9,4,12,8,8,4,8,0,False,False,False,0,3,2021-12-06T18:04:28.217,12,False,4.0
2021,13,3249,690,6,7725,3,4,7,17,0,0,0,0,0,0,False,False,False,0,3,2022-02-16T13:29:39.883,0,False,0.0
2021,13,3249,705,6,3233,13,4,3,11,0,0,0,0,0,0,False,False,False,0,3,2021-12-11T01:04:18.747,0,False,0.0
2021,13,3249,715,1,910,2,12,2,15,14,-1,15,-1,15,0,False,False,False,0,2,2021-12-06T18:19:24.33,14,False,-1.0
2021,13,3249,750,6,7728,2,5,5,11,11,0,11,0,11,0,False,False,False,0,3,2021-12-06T18:26:15.28,11,False,0.0
2021,13,3249,755,6,4305,2,4,4,6,6,0,6,0,6,0,False,False,False,0,3,2021-12-06T18:27:57.333,6,False,0.0
2021,13,3249,760,6,7725,2,50,5,-1,6,7,5,1,5,0,False,False,False,0,2,2021-12-06T18:29:13.297,6,False,1.0
2021,13,3249,770,6,7728,13,4,9,10,0,0,0,0,0,0,False,False,False,0,3,2021-12-06T18:31:37.8,0,False,0.0
2021,13,3249,775,6,6786,13,48,10,-6,0,0,0,0,0,0,False,False,False,0,1,2021-12-06T18:32:47.807,0,False,0.0
2021,13,3249,810,6,7728,13,35,10,14,0,0,0,0,0,0,False,False,False,0,3,2021-12-06T18:38:09.5,0,False,0.0
2021,13,3249,815,6,4305,3,13,10,2,0,0,0,0,0,0,False,False,False,0,2,2022-02-16T13:30:20.753,0,False,0.0
2021,13,3249,820,6,7728,2,8,10,13,24,11,15,9,15,0,False,False,False,1,3,2021-12-06T18:42:47.697,24,False,9.0
2021,13,3249,825,6,6786,2,5,4,3,2,-1,3,-1,3,0,False,False,False,0,1,2021-12-06T19:26:23.303,2,False,-1.0
2021,13,3249,830,6,7725,2,4,10,4,7,3,7,0,7,0,False,False,False,0,3,2021-12-06T18:45:49.697,7,False,0.0
2021,13,3249,840,6,3233,2,5,6,19,19,0,19,0,19,0,False,False,False,0,2,2021-12-06T18:48:01.34,19,False,0.0
2021,13,3249,855,6,7725,2,46,3,1,0,-1,0,0,0,0,False,False,False,0,3,2021-12-06T18:51:15.283,0,False,0.0
2021,13,3249,860,6,4305,2,30,9,3,8,5,8,0,8,6,True,False,False,0,1,2021-12-08T18:27:25.803,8,True,0.0
2021,13,3249,935,6,8365,2,4,4,3,11,8,7,4,7,0,False,False,False,0,1,2021-12-06T19:11:39.77,11,False,4.0
2021,13,3250,15,26,6301,2,32,10,-4,-1,3,-1,0,-1,0,False,False,False,0,1,2021-12-08T18:09:25.043,-1,False,0.0
2021,13,3250,20,26,309,2,12,10,10,10,0,10,0,10,0,False,False,False,0,3,2021-12-06T15:01:56.513,10,False,0.0
2021,13,3250,25,26,4619,2,49,9,-2,-1,1,-1,0,-1,0,False,False,False,0,2,2021-12-06T15:03:55.287,-1,False,0.0
2021,13,3250,30,26,4619,2,9,6,37,41,4,39,2,39,0,False,False,False,0,3,2021-12-06T15:07:12.687,41,False,2.0
2021,13,3250,40,26,4619,13,2,10,2,0,0,0,0,0,0,False,False,False,0,2,2021-12-06T15:10:26.277,0,False,0.0
2021,13,3250,45,26,7491,13,9,3,4,0,0,0,0,0,0,False,False,False,0,3,2021-12-06T15:12:22.063,0,False,0.0
2021,13,3250,50,26,309,2,2,4,4,4,0,4,0,4,6,False,False,False,0,3,2021-12-06T15:13:43.02,4,True,0.0
2021,13,3250,65,7,7659,2,5,3,5,5,0,5,0,5,0,False,False,False,0,3,2021-12-06T15:16:23.447,5,False,0.0
2021,13,3250,75,7,8317,2,26,5,6,12,6,10,2,10,0,False,False,False,0,2,2021-12-06T15:19:17.933,12,False,2.0
2021,13,3250,100,26,4619,2,4,10,4,5,1,4,1,4,0,False,False,False,0,2,2021-12-08T18:12:24.733,5,False,1.0
2021,13,3250,105,26,4616,2,48,10,-6,10,16,8,2,8,0,False,False,False,0,1,2021-12-06T15:32:49.437,10,False,2.0
2021,13,3250,130,7,8317,13,2,9,4,0,0,0,0,0,0,False,False,False,0,2,2021-12-06T15:39:06.987,0,False,0.0
2021,13,3250,135,7,7659,2,5,2,19,21,2,21,0,21,0,False,False,False,0,2,2021-12-06T15:53:40.473,21,False,0.0
2021,13,3250,140,7,8317,3,19,2,44,0,0,0,0,0,0,False,False,False,0,2,2021-12-08T18:30:01.827,0,False,0.0
2021,13,3250,145,26,4619,2,9,2,44,47,3,44,3,44,0,False,False,False,0,3,2021-12-06T15:45:32.447,47,False,3.0
2021,13,3250,150,26,7491,2,32,5,0,6,6,4,2,4,0,False,False,False,0,3,2021-12-08T18:09:46.633,6,False,2.0
2021,13,3250,165,26,309,2,17,10,7,7,0,7,0,7,6,False,False,False,0,4,2021-12-08T18:25:25.253,7,True,0.0
2021,13,3250,180,7,2631,2,47,5,2,3,1,2,1,2,0,False,False,False,1,4,2021-12-06T15:58:22.36,3,False,1.0
2021,13,3250,190,7,8317,2,4,9,4,9,5,7,2,7,0,False,False,False,0,3,2021-12-08T18:23:55.04,9,False,
2021,13,3250,200,7,7659,13,22,6,21,0,0,0,0,0,0,False,False,False,0,2,2021-12-06T16:09:19.17,0,False,0.0
2021,13,3250,210,26,309,13,21,3,13,0,0,0,0,0,0,False,False,False,0,3,2021-12-06T16:14:16.93,0,False,0.0
2021,13,3250,220,26,7491,13,12,6,38,0,0,0,0,0,0,False,False,False,0,3,2021-12-08T18:13:05.85,0,False,0.0
2021,13,3250,235,7,2631,2,26,10,6,7,1,7,0,7,0,False,False,False,0,3,2021-12-06T16:20:38.157,7,False,0.0
2021,13,3250,260,26,7453,2,7,6,44,44,0,44,0,44,6,False,False,False,0,3,2021-12-06T16:26:37.203,44,True,0.0
2021,13,3250,280,7,3521,13,35,2,16,0,0,0,0,0,0,False,False,False,0,3,2021-12-07T21:03:30.647,0,False,0.0
2021,13,3250,285,7,3521,2,2,10,6,32,26,24,8,24,0,False,False,False,1,3,2021-12-06T16:32:51.117,32,False,8.0
2021,13,3250,295,7,3521,2,6,1,17,16,-1,16,0,16,0,False,False,False,0,3,2021-12-06T16:36:12.523,16,False,0.0
2021,13,3250,300,7,7659,2,17,8,28,29,1,29,0,29,6,False,False,False,0,3,2021-12-06T16:37:35.41,29,True,0.0
2021,13,3250,325,26,958,2,35,6,22,23,1,23,0,23,0,False,False,False,0,4,2021-12-06T16:41:00.377,23,False,0.0
2021,13,3250,330,26,6301,2,4,4,1,7,6,5,2,5,0,False,False,False,0,1,2021-12-06T16:42:23.537,7,False,2.0
2021,13,3250,340,26,958,2,5,10,4,4,0,4,0,4,0,False,False,False,0,3,2021-12-06T16:44:38.507,4,False,0.0
2021,13,3250,350,26,309,13,7,2,16,0,0,0,0,0,0,False,False,False,0,3,2021-12-08T18:11:13.543,0,False,0.0
2021,13,3250,355,26,4616,2,28,5,-2,7,9,5,2,5,0,False,True,True,0,1,2021-12-08T15:21:19.567,7,False,2.0
2021,13,3250,390,26,7453,2,13,9,4,12,8,12,0,12,0,True,False,False,0,2,2021-12-06T16:57:04.993,12,False,0.0
2021,13,3250,405,26,309,2,5,5,4,7,3,6,1,6,0,False,False,False,0,3,2021-12-06T16:58:54.203,7,False,1.0
2021,13,3250,430,26,8552,13,19,2,52,0,0,0,0,0,0,False,False,False,0,2,2021-12-08T18:14:53.45,0,False,0.0
2021,13,3250,435,7,3521,2,5,5,5,5,0,5,0,5,0,False,False,False,0,2,2021-12-08T18:33:10.127,5,False,0.0
2021,13,3250,440,7,7659,2,5,3,7,7,0,7,0,7,0,False,False,False,0,3,2021-12-08T18:33:47.877,7,False,0.0
2021,13,3250,445,7,2631,13,26,10,5,0,0,0,0,0,0,False,False,False,0,3,2021-12-08T18:13:33.5,0,False,0.0
2021,13,3250,455,7,4455,2,12,4,-1,0,1,0,0,0,0,False,False,False,0,1,2021-12-08T18:34:40.59,0,False,0.0
2021,13,3250,460,7,4455,2,4,9,1,5,4,3,2,3,0,False,False,False,0,1,2021-12-06T17:11:59.927,5,False,2.0
2021,13,3250,485,7,7659,2,2,10,6,9,3,9,0,9,0,False,False,False,0,3,2021-12-06T17:26:26.59,9,False,0.0
2021,13,3250,500,7,3521,2,7,6,19,20,1,20,0,20,0,False,False,False,0,3,2021-12-06T17:31:33.367,20,False,0.0
2021,13,3250,510,7,7659,13,19,2,32,0,0,0,0,0,0,False,False,False,0,2,2021-12-06T17:33:55.447,0,False,0.0
2021,13,3250,520,7,7659,2,4,10,9,12,3,8,4,8,0,True,False,False,2,2,2021-12-08T18:35:24.607,12,False,4.0
2021,13,3250,535,26,309,13,35,10,14,0,0,0,0,0,0,False,False,False,0,3,2021-12-06T17:42:11.573,0,False,
2021,13,3250,545,26,4616,2,48,10,-4,12,16,9,3,9,0,False,False,False,0,1,2022-02-22T19:24:47.523,12,False,3.0
2021,13,3250,550,26,4616,2,16,4,7,9,2,9,0,9,0,False,True,True,0,1,2021-12-08T18:13:43.997,9,False,0.0
2021,13,3250,560,7,8317,2,4,5,4,6,2,5,1,5,0,False,False,False,0,2,2021-12-06T17:47:49.277,6,False,1.0
2021,13,3250,565,7,8317,2,4,5,5,9,4,7,2,7,0,False,False,False,0,2,2021-12-08T18:58:26.147,9,False,2.0
2021,13,3250,595,26,4619,13,4,3,10,0,0,0,0,0,0,False,False,False,0,2,2021-12-08T15:16:01.297,0,False,0.0
2021,13,3250,600,26,4616,2,44,3,-3,7,10,3,4,3,0,False,False,False,1,1,2021-12-06T17:55:46.937,7,False,4.0
2021,13,3250,605,26,309,2,39,9,4,6,2,5,1,5,0,False,False,False,0,3,2021-12-06T17:57:06.09,6,False,1.0
2021,13,3250,630,7,8317,2,5,5,11,11,0,11,0,11,0,False,False,False,0,3,2021-12-06T18:02:27.807,11,True,0.0
2021,13,3250,655,26,309,13,5,5,13,0,0,0,0,0,0,True,False,False,0,3,2021-12-08T14:50:16.597,0,False,0.0
2021,13,3250,660,26,7491,2,53,4,-3,-3,0,-3,0,-3,0,False,False,False,0,4,2021-12-08T14:54:19.4,-3,False,0.0
2021,13,3250,665,26,958,13,12,2,18,0,0,0,0,0,0,False,False,False,0,4,2021-12-08T18:13:56.043,0,False,0.0
2021,13,3250,685,7,3521,2,2,4,12,12,0,12,0,12,0,False,False,False,0,3,2021-12-06T18:19:09.677,12,False,0.0
2021,13,3250,715,7,8317,3,4,5,3,0,0,0,0,0,0,False,False,False,0,2,2021-12-06T18:25:50.21,0,False,0.0
2021,13,3250,720,7,2631,3,2,10,4,0,0,0,0,0,0,True,False,False,0,3,2021-12-06T18:26:58.803,0,False,0.0
2021,13,3250,735,26,7453,2,32,9,-1,1,2,1,0,1,0,False,False,False,0,3,2021-12-06T18:30:37.05,1,False,0.0
2021,13,3250,740,26,4619,2,13,10,3,18,15,18,0,18,0,False,False,False,0,4,2021-12-06T18:32:53.673,18,True,0.0
2021,13,3250,745,26,7453,2,17,8,20,33,13,22,11,22,0,False,False,False,1,3,2021-12-06T19:17:13.033,33,False,11.0
2021,13,3250,770,7,7659,2,5,5,11,16,5,15,1,15,0,False,False,False,1,2,2021-12-06T18:38:21.467,16,False,1.0
2021,13,3250,775,7,3521,13,35,10,14,0,0,0,0,0,0,True,False,False,0,3,2021-12-08T18:50:14.277,0,False,0.0
2021,13,3250,780,7,8317,2,4,3,3,14,11,6,8,6,0,False,False,False,0,2,2021-12-08T18:16:17.137,14,False,8.0
2021,13,3250,785,7,7659,2,8,1,18,25,7,23,2,23,0,False,False,False,0,3,2021-12-08T18:51:06.433,25,False,2.0
2021,13,3250,790,7,7659,13,12,5,10,0,0,0,0,0,0,False,False,False,0,2,2022-02-24T18:00:56.333,0,False,0.0
2021,13,3250,800,7,2631,13,12,7,15,0,0,0,0,0,0,False,False,False,0,3,2022-02-24T18:01:20.71,0,False,0.0
2021,13,3250,830,26,958,2,46,3,1,2,1,2,0,2,0,False,False,False,0,3,2021-12-06T18:53:24.163,2,False,0.0
2021,13,3250,845,7,4679,13,16,10,5,0,0,0,0,0,0,False,False,False,0,1,2021-12-06T18:59:11.737,0,False,0.0
2021,13,3250,850,7,7659,2,13,5,4,14,10,13,1,13,0,False,False,False,0,3,2021-12-06T18:58:55.933,14,False,1.0
2021,13,3250,860,7,7659,3,5,5,6,0,0,0,0,0,0,False,False,False,0,2,2021-12-06T19:01:09.197,0,False,0.0
2021,13,3250,865,7,2631,2,32,3,3,10,7,8,2,8,0,False,False,False,0,3,2021-12-08T18:14:10.38,10,False,2.0
2021,13,3250,870,7,7659,13,5,3,8,0,0,0,0,0,0,False,False,False,0,2,2021-12-08T18:14:21.057,0,False,0.0
2021,13,3251,10,30,4937,2,46,9,4,15,11,15,0,15,0,False,False,False,0,1,2021-12-06T13:54:59.547,15,True,0.0
2021,13,3251,15,30,4516,13,6,4,5,0,0,0,0,0,0,False,False,False,0,3,2021-12-08T17:09:32.883,0,False,0.0
2021,13,3251,20,30,4516,2,13,4,5,5,0,5,0,5,0,False,False,False,0,3,2021-12-08T17:09:32.883,5,False,0.0
2021,13,3251,25,30,4516,2,4,4,6,11,5,8,3,8,0,False,False,False,0,3,2021-12-08T17:09:32.883,11,False,3.0
2021,13,3251,30,30,4937,2,47,5,-1,0,1,0,0,0,0,False,False,False,0,1,2021-12-06T14:01:16.167,0,False,0.0
2021,13,3251,35,30,63,13,4,4,13,0,0,0,0,0,0,False,False,False,0,4,2021-12-06T14:02:30.62,0,False,0.0
2021,13,3251,40,30,4516,2,5,3,4,6,2,6,0,6,0,True,False,False,0,3,2021-12-07T20:19:51.03,6,False,0.0
2021,13,3251,45,30,4937,2,4,9,4,6,2,6,0,6,0,False,False,False,0,1,2021-12-06T14:05:53.77,6,False,0.0
2021,13,3251,50,30,793,2,4,3,3,3,0,3,0,3,0,False,False,False,0,2,2021-12-06T14:07:35.93,3,False,0.0
2021,13,3251,55,30,793,2,2,9,7,15,8,14,1,14,0,False,False,False,0,3,2021-12-06T14:08:42.58,15,False,1.0
2021,13,3251,60,30,4516,2,50,10,-4,7,11,5,2,5,0,False,False,False,0,3,2021-12-06T14:09:51.063,7,False,2.0
2021,13,3251,65,30,4516,2,4,9,3,4,1,3,1,3,0,False,False,False,0,3,2021-12-08T18:38:03.37,4,False,1.0
2021,13,3251,70,30,4937,2,47,5,3,3,0,3,0,3,6,False,False,False,0,1,2022-02-22T20:16:22.143,3,True,0.0
2021,13,3251,90,2,8389,2,18,3,-2,0,2,0,0,0,0,False,False,False,0,2,2021-12-06T14:17:29.493,0,False,0.0
2021,13,3251,95,2,7303,2,39,4,4,6,2,5,1,5,0,False,False,False,0,3,2021-12-06T14:18:46.73,6,False,1.0
2021,13,3251,100,2,811,2,50,10,-3,6,9,2,4,2,0,False,False,False,0,3,2021-12-08T17:14:28.087,6,False,4.0
2021,13,3251,130,30,4516,2,9,6,22,25,3,25,0,25,0,False,False,False,0,3,2021-12-06T14:27:08.097,25,False,0.0
2021,13,3251,135,30,793,13,4,9,11,0,0,0,0,0,0,False,False,False,0,2,2021-12-08T19:04:25.907,0,False,0.0
2021,13,3251,140,30,793,2,29,2,35,36,1,36,0,36,0,False,False,False,0,2,2021-12-06T14:35:11.377,36,True,0.0
2021,13,3251,150,30,63,13,7,5,7,0,0,0,0,0,0,False,False,False,0,4,2021-12-08T18:50:25.7,0,False,
2021,13,3251,155,30,2290,2,32,5,3,3,0,3,0,3,6,False,False,False,0,4,2021-12-06T14:40:04.997,3,True,0.0
2021,13,3251,170,2,8389,2,35,10,10,12,2,11,1,11,0,False,False,False,0,3,2021-12-08T17:19:40.407,12,False,1.0
2021,13,3251,180,2,3506,3,8,8,16,0,0,0,0,0,0,False,False,False,0,3,2021-12-06T14:44:52.79,0,False,0.0
2021,13,3251,200,30,6414,2,51,9,-6,0,6,0,0,0,0,False,False,False,0,1,2021-12-06T14:49:08.32,0,False,0.0
2021,13,3251,205,30,63,13,8,1,15,0,0,0,0,0,0,False,False,False,0,3,2021-12-06T14:50:34.403,0,False,0.0
2021,13,3251,225,2,8389,13,7,6,17,0,0,0,0,0,0,False,False,False,0,3,2022-02-22T19:05:33.467,0,False,0.0
2021,13,3251,235,2,6247,2,12,6,16,19,3,18,1,18,0,False,False,False,0,3,2022-02-24T18:03:04.603,19,False,1.0
2021,13,3251,245,2,811,13,35,6,20,0,0,0,0,0,0,False,False,False,0,3,2022-02-16T13:19:41.873,0,False,0.0
2021,13,3251,250,2,8389,2,5,2,15,29,14,15,14,15,0,False,False,False,1,3,2021-12-08T19:04:56.08,29,False,14.0
2021,13,3251,255,2,8389,2,4,5,6,7,1,7,0,7,0,False,False,False,0,2,2021-12-06T15:16:19.423,7,False,0.0
2021,13,3251,280,2,6247,2,16,9,6,10,4,7,3,7,0,False,False,False,0,1,2021-12-08T18:26:58.42,10,False,3.0
2021,13,3251,290,2,3506,13,12,5,1,0,0,0,0,0,0,False,False,False,0,3,2022-02-16T13:20:06.987,0,False,0.0
2021,13,3251,300,2,811,13,2,9,3,0,0,0,0,0,0,False,False,False,0,2,2021-12-08T18:40:05.963,0,False,0.0
2021,13,3251,320,30,63,3,39,4,5,0,0,0,0,0,0,False,False,False,0,4,2021-12-06T15:38:43.76,0,False,0.0
2021,13,3251,325,30,793,2,5,3,14,15,1,15,0,15,0,False,False,False,0,3,2021-12-11T02:40:26.78,15,False,0.0
2021,13,3251,330,30,4516,2,50,10,-4,6,10,3,3,3,0,False,False,False,0,3,2021-12-06T15:41:36.913,6,False,3.0
2021,13,3251,340,30,4516,2,35,9,14,17,3,16,1,16,0,False,False,False,0,3,2021-12-06T15:45:53.217,17,False,1.0
2021,13,3251,345,30,4937,2,4,9,5,12,7,11,1,11,0,False,False,False,0,1,2021-12-06T15:47:15.043,12,False,1.0
2021,13,3251,355,30,256,13,3,5,5,0,0,0,0,0,0,False,False,False,0,2,2021-12-08T19:05:28.367,0,False,0.0
2021,13,3251,360,30,63,2,35,10,10,27,17,27,0,27,6,False,False,False,0,3,2021-12-06T15:50:37.347,27,True,0.0
2021,13,3251,395,2,6247,2,4,9,5,9,4,5,4,5,0,False,False,False,1,3,2021-12-08T17:53:04.29,9,False,4.0
2021,13,3251,405,2,7296,2,4,4,4,8,4,7,1,7,0,False,False,False,0,1,2021-12-06T16:05:25.653,8,False,1.0
2021,13,3251,415,2,6247,2,5,3,6,9,3,9,0,9,0,False,False,False,0,3,2021-12-08T19:05:46.877,9,False,0.0
2021,13,3251,420,2,7303,13,6,9,10,0,0,0,0,0,0,False,False,False,0,3,2021-12-08T19:06:10.19,0,False,0.0
2021,13,3251,425,2,3506,2,18,5,-1,4,5,3,1,3,0,False,False,False,0,2,2021-12-06T16:10:44.993,4,False,1.0
2021,13,3251,430,2,2554,2,32,10,-6,-3,3,-3,0,-3,0,False,False,False,0,1,2021-12-08T17:46:10.593,-3,False,0.0
2021,13,3251,450,30,4516,2,50,9,-3,1,4,1,0,1,0,False,False,False,0,2,2021-12-08T18:41:36.027,1,False,0.0
2021,13,3251,455,30,4937,13,48,9,-5,0,0,0,0,0,0,False,False,False,0,1,2021-12-08T19:06:21.11,0,False,0.0
2021,13,3251,485,2,2554,2,32,9,-3,14,17,1,13,1,0,False,False,False,1,1,2021-12-08T19:06:41.767,14,False,13.0
2021,13,3251,500,2,2835,2,47,5,2,2,0,2,0,2,0,True,False,False,0,4,2021-12-07T23:35:25.5,2,False,0.0
2021,13,3251,505,2,6247,2,12,4,14,19,5,19,0,19,0,False,True,True,0,2,2021-12-08T19:06:58.42,19,False,0.0
2021,13,3251,515,30,63,13,39,4,6,0,0,0,0,0,0,False,False,False,0,4,2021-12-08T19:07:08.55,0,False,0.0
2021,13,3251,520,30,793,13,19,2,30,0,0,0,0,0,0,False,False,False,0,3,2021-12-06T16:47:17.857,0,False,0.0
2021,13,3251,535,2,811,2,44,3,-6,6,12,6,0,6,0,False,False,False,0,1,2021-12-06T16:50:16.397,6,False,0.0
2021,13,3251,550,2,6247,2,39,4,6,9,3,7,2,7,0,False,False,False,0,3,2021-12-06T16:54:13.343,9,False,2.0
2021,13,3251,560,2,3506,2,46,3,2,4,2,4,0,4,0,False,False,False,0,3,2021-12-06T16:57:18.957,4,False,0.0
2021,13,3251,565,2,6247,2,51,10,-1,16,17,2,14,2,0,False,False,False,1,3,2021-12-08T17:20:06.31,16,False,14.0
2021,13,3251,575,2,8389,13,5,5,14,0,0,0,0,0,0,False,False,False,0,3,2021-12-08T19:07:16.84,0,False,0.0
2021,13,3251,595,30,4516,2,4,4,5,9,4,6,3,6,0,False,False,False,0,3,2021-12-08T17:09:32.917,9,False,3.0
2021,13,3251,600,30,4937,2,46,3,-2,1,3,1,0,1,0,False,False,False,0,1,2021-12-06T17:10:15.44,1,False,0.0
2021,13,3251,605,30,4516,2,13,4,5,7,2,5,2,5,0,False,False,False,0,3,2021-12-06T17:11:20.2,7,False,2.0
2021,13,3251,615,30,4937,2,32,9,-5,11,16,5,6,5,0,False,False,False,1,1,2021-12-08T17:53:14.257,11,False,6.0
2021,13,3251,620,30,256,2,18,5,-2,5,7,4,1,4,0,False,False,False,0,2,2021-12-06T17:14:25.71,5,False,1.0
2021,13,3251,625,30,931,2,4,10,5,7,2,6,1,6,0,False,False,False,0,1,2021-12-06T17:15:34.33,7,False,1.0
2021,13,3251,635,30,931,13,47,5,0,0,0,0,0,0,0,False,False,False,0,1,2021-12-06T17:17:42.453,0,False,0.0
2021,13,3251,640,30,793,2,35,9,10,18,8,16,2,16,0,False,False,False,0,3,2021-12-06T17:19:02.363,18,False,2.0
2021,13,3251,645,30,4516,2,50,10,-3,1,4,-2,3,-2,0,False,False,False,0,3,2021-12-06T17:20:30.893,1,False,3.0
2021,13,3251,650,30,7893,2,4,10,6,5,-1,5,0,5,0,False,False,False,0,3,2021-12-06T17:22:31.837,5,False,0.0
2021,13,3251,655,30,63,2,9,5,11,11,0,11,0,11,6,False,False,False,0,3,2021-12-06T17:23:26.88,11,True,0.0
2021,13,3251,670,2,2554,2,31,9,1,6,5,3,3,3,0,False,False,False,1,1,2021-12-06T17:25:08.477,6,False,3.0
2021,13,3251,700,30,63,2,31,10,6,14,8,14,0,14,0,False,False,False,0,4,2021-12-06T17:30:25.86,14,False,0.0
2021,13,3251,705,30,4516,13,2,10,12,0,0,0,0,0,0,False,False,False,0,3,2021-12-06T19:38:51.45,0,False,0.0
2021,13,3251,710,30,63,2,13,9,6,6,0,6,0,6,0,False,False,False,0,3,2021-12-06T17:38:10.137,6,False,0.0
2021,13,3251,725,2,2554,2,5,5,4,20,16,10,10,10,0,False,False,False,1,1,2021-12-08T18:36:23.133,20,False,10.0
2021,13,3251,730,2,8389,13,35,10,11,0,0,0,0,0,0,False,False,False,0,3,2021-12-06T18:06:12.037,0,False,0.0
2021,13,3251,735,2,2554,2,48,5,-9,16,25,16,0,16,0,False,False,False,0,1,2021-12-11T03:03:43.013,16,False,
2021,13,3251,740,2,811,2,50,9,-3,6,9,5,1,5,0,False,False,False,0,3,2022-02-22T19:07:00.757,6,False,1.0
2021,13,3251,745,2,6247,2,8,7,16,17,1,17,0,17,0,False,False,False,0,2,2021-12-08T19:07:27.583,17,False,0.0
2021,13,3251,770,30,793,2,18,3,0,6,6,5,1,5,0,False,False,False,0,2,2021-12-06T18:26:23.46,6,False,1.0
2021,13,3251,775,30,793,13,29,3,8,0,0,0,0,0,0,False,False,False,0,2,2021-12-08T17:09:32.947,0,False,0.0
2021,13,3251,780,30,793,2,5,3,6,6,0,6,0,6,0,False,False,False,0,3,2021-12-08T18:44:45.077,6,False,0.0
2021,13,3251,785,30,4516,2,35,6,22,36,14,34,2,34,0,True,False,False,0,2,2021-12-06T18:30:46.187,36,False,2.0
2021,13,3251,800,30,4516,2,50,9,-1,5,6,4,1,4,0,False,False,False,0,2,2021-12-06T18:32:43.38,5,False,1.0
2021,13,3251,810,30,4516,2,47,5,2,3,1,3,0,3,0,True,False,False,0,3,2021-12-08T18:51:03.903,3,False,0.0
2021,13,3251,875,2,6247,2,2,4,7,8,1,9,-1,9,0,False,False,False,0,3,2022-02-16T13:20:43.493,8,False,-1.0
2021,13,3251,885,2,7303,2,5,3,5,8,3,8,0,8,0,False,False,False,0,3,2021-12-08T19:07:36.343,8,True,0.0
2021,13,3251,890,2,6247,2,4,3,5,8,3,7,1,7,0,False,False,False,0,3,2021-12-06T18:56:42.507,8,False,1.0
2021,13,3251,900,2,3506,2,4,9,6,2,-4,2,0,2,0,False,False,False,0,3,2021-12-06T18:59:58.24,2,False,0.0
2021,13,3251,905,2,6247,2,5,3,2,7,5,7,0,7,0,False,False,False,0,3,2021-12-06T19:01:24.9,7,True,0.0
2021,13,3251,910,2,7303,2,7,2,28,30,2,28,2,28,0,False,False,False,0,3,2021-12-06T19:03:08.127,30,False,2.0
2021,13,3251,915,2,7303,13,9,5,7,0,0,0,0,0,0,False,False,False,0,2,2021-12-06T19:04:13.197,0,False,0.0
2021,13,3251,920,2,6247,3,35,4,7,0,0,0,0,0,0,False,False,False,0,2,2021-12-06T19:35:02.733,0,False,0.0
2021,13,3252,15,32,8528,2,35,9,14,23,9,19,4,19,0,False,False,False,0,4,2021-12-06T15:17:10.137,23,False,4.0
2021,13,3252,25,32,4803,2,48,10,-6,-1,5,-5,4,-5,0,False,False,False,0,1,2021-12-08T20:41:30.807,-1,False,4.0
2021,13,3252,30,32,7128,2,5,3,12,13,1,13,0,13,0,False,False,False,0,3,2021-12-06T15:25:10.277,13,True,0.0
2021,13,3252,35,32,8527,2,45,5,-2,6,8,0,6,0,0,True,False,False,2,2,2021-12-06T15:27:26.593,6,False,6.0
2021,13,3252,50,32,1427,2,35,9,7,7,0,7,0,7,6,False,False,False,0,3,2021-12-06T15:36:42.53,7,True,0.0
2021,13,3252,65,23,7250,2,46,3,0,1,1,1,0,1,0,False,False,False,0,3,2021-12-06T15:38:28.453,1,False,0.0
2021,13,3252,70,23,4307,2,51,5,-5,8,13,4,4,4,0,True,False,False,1,1,2022-02-16T14:56:30.58,8,False,4.0
2021,13,3252,75,23,7250,2,46,9,-3,9,12,-1,10,-1,0,True,False,False,1,3,2022-02-16T14:56:48.55,9,False,10.0
2021,13,3252,80,23,7241,2,45,10,-7,3,10,0,3,0,0,False,False,False,0,1,2021-12-06T15:45:54.303,3,False,3.0
2021,13,3252,90,23,4307,13,31,9,0,0,0,0,0,0,0,False,False,False,0,1,2021-12-06T15:49:37.277,0,False,0.0
2021,13,3252,100,32,7807,13,28,10,3,0,0,0,0,0,0,False,False,False,0,1,2021-12-06T15:52:35.98,0,False,0.0
2021,13,3252,110,32,7128,2,4,9,4,4,0,4,0,4,0,False,False,False,0,3,2021-12-06T15:55:37.243,4,False,0.0
2021,13,3252,125,32,4084,2,28,10,3,7,4,6,1,6,0,False,False,False,0,1,2021-12-08T20:10:45.143,7,False,1.0
2021,13,3252,135,23,7689,13,35,7,18,0,0,0,0,0,0,False,False,False,0,3,2021-12-06T16:06:05.14,0,False,0.0
2021,13,3252,165,32,3562,2,4,9,5,6,1,5,1,5,0,False,False,False,0,2,2021-12-08T19:42:17.187,6,False,1.0
2021,13,3252,170,32,8528,3,26,10,1,0,0,0,0,0,0,False,False,False,0,4,2021-12-06T16:34:54.153,0,False,0.0
2021,13,3252,200,23,7250,2,3,3,10,10,0,10,0,10,0,False,False,False,0,2,2021-12-06T17:01:06.843,10,True,0.0
2021,13,3252,205,23,7241,2,44,3,-3,5,8,-1,6,-1,0,False,False,False,1,1,2021-12-06T17:02:46.097,5,False,6.0
2021,13,3252,215,23,7250,2,4,3,3,3,0,3,0,3,0,False,False,False,0,3,2021-12-06T17:07:04.767,3,False,0.0
2021,13,3252,220,23,7250,2,5,10,4,9,5,8,1,8,0,False,False,False,1,3,2021-12-06T17:08:52.39,9,False,1.0
2021,13,3252,225,23,7241,2,32,3,1,7,6,0,7,0,0,False,False,False,1,3,2021-12-06T17:11:25.397,7,False,7.0
2021,13,3252,230,23,7689,2,5,3,4,5,1,4,1,4,0,False,False,False,0,3,2021-12-06T17:14:03.133,5,False,1.0
2021,13,3252,240,23,7241,2,51,10,-7,0,7,0,0,0,0,True,False,False,0,1,2021-12-06T17:20:19.243,0,False,0.0
2021,13,3252,255,32,7128,2,42,9,5,5,0,5,0,5,0,False,False,False,0,3,2021-12-06T17:26:00.05,5,False,0.0
2021,13,3252,260,32,2675,2,26,10,5,6,1,6,0,6,0,False,False,False,0,2,2021-12-06T17:28:46.347,6,False,0.0
2021,13,3252,265,32,1427,13,7,2,23,0,0,0,0,0,0,True,False,False,0,1,2021-12-06T17:31:09.853,0,False,0.0
2021,13,3252,270,32,7807,2,12,9,-1,0,1,-1,1,-1,0,False,False,False,0,1,2022-02-24T18:04:48.77,0,False,
2021,13,3252,290,32,4084,2,4,4,3,5,2,4,1,4,0,False,False,False,0,1,2021-12-06T17:44:16.723,5,False,1.0
2021,13,3252,295,32,2675,13,26,5,9,0,0,0,0,0,0,False,False,False,0,3,2021-12-06T17:49:06.793,0,False,
2021,13,3252,340,23,7689,2,6,9,14,18,4,16,2,16,0,False,False,False,0,2,2021-12-08T20:49:14.897,18,False,2.0
2021,13,3252,345,23,7241,2,5,3,5,10,5,5,5,5,0,False,False,False,1,1,2021-12-06T18:12:00.243,10,False,5.0
2021,13,3252,350,23,7241,2,28,3,-6,-5,1,-5,0,-5,0,False,False,False,0,1,2021-12-06T18:14:48.873,-5,False,0.0
2021,13,3252,370,23,4949,2,4,5,3,5,2,5,0,5,0,False,False,False,0,2,2021-12-06T18:20:11.083,5,False,0.0
2021,13,3252,375,23,7689,13,19,2,36,0,0,0,0,0,0,False,False,False,0,2,2021-12-06T18:21:44.86,0,False,0.0
2021,13,3252,380,23,7241,2,51,5,-6,2,8,2,0,2,0,True,False,False,0,1,2021-12-06T18:23:29.727,2,True,0.0
2021,13,3252,420,23,7246,13,35,2,20,0,0,0,0,0,0,False,False,False,0,4,2021-12-06T18:43:49.323,0,False,0.0
2021,13,3252,450,32,1427,2,4,9,6,6,0,6,0,6,0,False,False,False,0,3,2021-12-06T18:53:08.017,6,False,0.0
2021,13,3252,460,32,7807,2,48,10,-4,0,4,1,-1,1,0,False,False,False,0,1,2021-12-06T18:56:13.617,0,False,-1.0
2021,13,3252,465,32,7128,13,6,7,16,0,0,0,0,0,0,False,False,False,0,2,2021-12-06T18:58:01.747,0,False,0.0
2021,13,3252,470,32,1427,13,12,6,19,0,0,0,0,0,0,False,False,False,0,4,2021-12-06T19:00:42.613,0,False,0.0
2021,13,3252,480,23,7250,2,6,10,12,15,3,15,0,15,0,False,False,False,0,3,2022-02-14T22:30:42.86,15,False,0.0
2021,13,3252,485,23,7241,2,4,4,2,9,7,8,1,8,0,False,False,False,0,1,2021-12-08T19:42:17.187,9,False,1.0
2021,13,3252,495,23,7246,2,17,1,17,34,17,23,11,23,0,False,False,False,1,3,2021-12-08T20:43:52.077,34,False,11.0
2021,13,3252,500,23,7689,2,42,4,3,7,4,6,1,6,0,False,False,False,0,3,2021-12-06T19:16:58.647,7,False,1.0
2021,13,3252,505,23,7246,13,17,7,18,0,0,0,0,0,0,True,False,False,0,3,2021-12-08T20:51:32.847,0,False,0.0
2021,13,3252,510,23,7250,13,5,3,3,0,0,0,0,0,0,False,False,False,0,3,2021-12-06T19:20:13.933,0,False,0.0
2021,13,3252,525,32,7807,2,28,10,3,10,7,10,0,10,0,False,False,False,0,1,2021-12-06T19:26:19.573,10,False,0.0
2021,13,3252,535,32,8528,2,48,10,-3,0,3,-2,2,-2,0,True,False,False,0,1,2022-02-22T20:26:18.04,0,False,
2021,13,3252,545,32,7128,13,4,9,10,0,0,0,0,0,0,False,False,False,0,2,2021-12-06T19:36:29.637,0,False,
2021,13,3252,550,32,1427,2,7,6,17,35,18,33,2,33,0,False,False,False,0,4,2021-12-06T19:41:05.257,35,False,2.0
2021,13,3252,560,32,2675,2,13,9,3,10,7,6,4,6,0,False,False,False,0,3,2021-12-06T19:44:08.91,10,False,4.0
2021,13,3252,580,32,7807,2,12,10,-1,3,4,0,3,0,0,False,False,False,0,1,2021-12-06T20:03:43.55,3,False,3.0
2021,13,3252,585,32,7807,2,47,5,3,4,1,4,0,4,6,False,False,False,0,1,2021-12-08T20:53:43.547,4,True,0.0
2021,13,3252,600,23,4949,2,44,3,-3,3,6,3,0,3,0,True,False,False,1,2,2021-12-06T20:09:40,3,False,0.0
2021,13,3252,605,23,7250,2,12,7,24,28,4,26,2,26,0,False,False,False,0,3,2021-12-06T20:12:28.547,28,False,2.0
2021,13,3252,610,23,7241,13,48,9,-5,0,0,0,0,0,0,False,False,False,0,1,2022-02-16T14:58:02.147,0,False,
2021,13,3252,615,23,967,2,12,3,13,14,1,14,0,14,0,False,False,False,0,3,2021-12-08T20:56:37.973,14,False,0.0
2021,13,3252,625,23,7250,13,20,4,10,0,0,0,0,0,0,False,False,False,0,3,2021-12-07T00:45:05,0,False,
2021,13,3252,665,32,8528,2,30,9,4,10,6,9,1,9,0,False,False,False,0,4,2021-12-06T20:36:57.51,10,False,1.0
2021,13,3252,680,32,7128,13,6,8,17,0,0,0,0,0,0,False,False,False,0,3,2022-02-22T19:53:48.05,0,False,0.0
2021,13,3252,685,23,4949,2,4,5,11,13,2,12,1,12,0,False,False,False,0,2,2021-12-06T20:48:16.213,13,False,1.0
2021,13,3252,690,23,7250,2,17,9,12,16,4,15,1,15,0,False,False,False,0,3,2021-12-08T19:42:17.187,16,False,1.0
2021,13,3252,710,23,3708,2,48,4,-3,2,5,0,2,0,0,False,False,False,0,1,2021-12-06T20:57:25.32,2,False,2.0
2021,13,3252,715,23,4949,13,7,6,18,0,0,0,0,0,0,False,False,False,0,3,2021-12-06T20:59:35.157,0,False,0.0
2021,13,3252,730,32,8528,2,12,5,9,9,0,9,0,9,0,False,False,False,0,4,2021-12-06T21:03:01.58,9,False,0.0
2021,13,3252,745,32,2675,2,4,5,10,10,0,10,0,10,0,False,False,False,0,3,2021-12-06T21:06:23.34,10,False,0.0
2021,13,3252,750,32,2675,2,4,3,9,12,3,12,0,12,0,False,False,False,0,3,2021-12-06T21:08:03.427,12,True,0.0
2021,13,3252,755,32,2675,13,4,10,10,0,0,0,0,0,0,False,False,False,0,3,2021-12-08T20:11:38.133,0,False,0.0
2021,13,3252,760,32,7807,2,50,3,-1,6,7,4,2,4,0,True,False,False,0,2,2021-12-08T20:57:54.56,6,False,2.0
2021,13,3252,795,23,4949,13,8,7,62,0,0,0,0,0,0,False,False,False,0,3,2021-12-08T20:58:24.393,0,False,0.0
2021,13,3252,800,23,7250,2,4,10,11,11,0,11,0,11,0,False,False,False,0,3,2021-12-06T21:19:40.823,11,False,0.0
2021,13,3252,810,23,7241,2,28,5,-1,7,8,7,0,7,0,False,False,False,0,1,2021-12-06T21:21:54.257,7,True,0.0
2021,13,3252,815,23,4949,13,19,2,56,0,0,0,0,0,0,False,False,False,0,2,2021-12-07T00:46:52.633,0,False,0.0
2021,13,3253,25,29,6266,2,45,5,-3,-1,2,-1,0,-1,0,False,False,False,0,1,2021-12-06T15:43:22.217,-1,False,0.0
2021,13,3253,30,29,8455,3,6,4,13,0,0,0,0,0,0,False,False,False,0,2,2021-12-06T15:46:20.46,0,False,0.0
2021,13,3253,55,29,3398,2,53,9,-4,7,11,0,7,0,0,False,False,False,0,4,2021-12-06T15:55:45.107,7,False,
2021,13,3253,60,29,1067,2,35,10,11,27,16,27,0,27,0,False,False,False,0,3,2021-12-06T15:58:38.327,27,False,0.0
2021,13,3253,65,29,4866,13,11,5,5,0,0,0,0,0,0,False,False,False,0,1,2021-12-08T03:32:17.6,0,False,0.0
2021,13,3253,85,15,4179,13,6,9,4,0,0,0,0,0,0,False,False,False,0,2,2021-12-06T16:07:11.247,0,False,0.0
2021,13,3253,95,15,7591,2,44,3,-6,3,9,1,2,1,0,True,False,False,0,1,2021-12-06T16:09:34.327,3,False,2.0
2021,13,3253,125,29,6266,2,46,9,2,4,2,2,2,2,0,False,False,False,2,1,2021-12-06T16:22:35.183,4,False,2.0
2021,13,3253,130,29,3398,13,32,5,1,0,0,0,0,0,0,False,False,False,0,4,2021-12-06T16:24:11.97,0,False,0.0
2021,13,3253,135,29,1067,13,8,1,20,0,0,0,0,0,0,False,False,False,0,3,2021-12-06T16:25:29.593,0,False,0.0
2021,13,3253,150,15,7591,13,2,9,9,0,0,0,0,0,0,False,False,False,0,3,2021-12-06T16:29:20.19,0,False,0.0
2021,13,3253,155,15,4179,2,2,9,10,28,18,20,8,20,0,False,False,False,2,3,2021-12-06T16:30:49.68,28,False,8.0
2021,13,3253,165,15,153,2,48,10,-4,-1,3,-1,0,-1,0,False,False,False,0,1,2021-12-06T16:33:10.437,-1,False,0.0
2021,13,3253,175,15,914,2,4,9,6,6,0,6,0,6,0,False,False,False,0,3,2021-12-06T16:36:25.277,6,False,0.0
2021,13,3253,235,29,8455,2,17,1,25,35,10,34,1,34,0,False,False,False,0,3,2021-12-06T17:06:46.437,35,False,1.0
2021,13,3253,245,29,3398,2,13,4,4,5,1,5,0,5,0,False,False,False,0,3,2021-12-06T17:10:19.933,5,False,0.0
2021,13,3253,250,29,3398,2,31,10,9,9,0,9,0,9,0,False,False,False,0,4,2021-12-06T17:12:14.093,9,False,0.0
2021,13,3253,260,29,7828,13,12,9,14,0,0,0,0,0,0,False,False,False,0,3,2021-12-06T17:14:57.103,0,False,0.0
2021,13,3253,290,15,2757,3,5,9,6,0,0,0,0,0,0,False,False,False,0,3,2021-12-06T17:21:32.883,0,False,0.0
2021,13,3253,310,29,3398,2,4,10,6,8,2,7,1,7,0,False,False,False,0,3,2021-12-06T17:27:38.97,8,False,1.0
2021,13,3253,320,29,4866,13,6,9,14,0,0,0,0,0,0,False,False,False,0,3,2021-12-08T14:58:55.713,0,False,0.0
2021,13,3253,325,29,1067,13,19,2,55,0,0,0,0,0,0,False,False,False,0,3,2021-12-06T17:32:31.7,0,False,0.0
2021,13,3253,335,15,4179,13,12,5,7,0,0,0,0,0,0,False,False,False,0,2,2021-12-08T16:20:14.32,0,False,
2021,13,3253,340,15,2757,2,4,9,5,6,1,5,1,5,0,False,False,False,0,2,2021-12-06T17:37:12.513,6,False,1.0
2021,13,3253,345,15,2757,3,4,4,0,0,0,0,0,0,0,False,False,False,0,4,2022-02-16T14:52:45.257,0,False,0.0
2021,13,3253,360,29,7828,2,5,3,5,7,2,7,0,7,0,True,False,False,0,3,2021-12-06T17:42:21.367,7,False,0.0
2021,13,3253,370,29,4866,2,51,5,-4,7,11,3,4,3,0,True,False,False,0,1,2021-12-06T17:43:58.64,7,False,4.0
2021,13,3253,375,29,4866,2,5,3,4,7,3,7,0,7,0,False,False,False,0,2,2021-12-06T17:45:08.463,7,False,0.0
2021,13,3253,380,29,3398,2,5,5,3,4,1,4,0,4,0,True,False,False,0,4,2021-12-06T17:48:15.303,4,False,0.0
2021,13,3253,385,29,1067,13,7,6,25,0,0,0,0,0,0,False,False,False,0,2,2021-12-06T17:50:12.11,0,False,
2021,13,3253,395,29,7828,2,8,8,16,19,3,19,0,19,0,False,False,False,0,3,2021-12-06T17:54:01.493,19,False,0.0
2021,13,3253,405,29,4866,2,5,5,7,8,1,8,0,8,0,False,False,False,0,3,2021-12-06T17:55:20.747,8,False,0.0
2021,13,3253,415,29,1067,13,9,2,20,0,0,0,0,0,0,False,False,False,0,3,2021-12-08T16:32:44.17,0,False,0.0
2021,13,3253,420,29,7828,3,2,9,4,0,0,0,0,0,0,False,False,False,0,3,2021-12-06T17:58:09,0,False,0.0
2021,13,3253,435,15,8099,2,48,10,-2,11,13,8,3,8,0,False,False,False,0,1,2021-12-08T16:11:40.24,11,False,3.0
2021,13,3253,445,15,8099,13,5,10,4,0,0,0,0,0,0,False,False,False,0,1,2021-12-06T18:01:52.813,0,False,0.0
2021,13,3253,450,15,8099,13,12,9,11,0,0,0,0,0,0,False,False,False,0,1,2021-12-06T18:03:16.38,0,False,0.0
2021,13,3253,465,15,8099,13,44,3,-3,0,0,0,0,0,0,False,False,False,0,1,2021-12-06T18:12:40.413,0,False,0.0
2021,13,3253,470,15,914,2,4,10,5,5,0,5,0,5,0,False,False,False,0,3,2021-12-07T23:25:56.617,5,False,0.0
2021,13,3253,485,29,7828,2,5,3,5,7,2,6,1,6,0,False,False,False,0,3,2021-12-06T18:18:18.77,7,False,1.0
2021,13,3253,490,29,4866,2,43,2,27,43,16,33,10,33,0,False,False,False,0,4,2021-12-06T20:18:36.017,43,False,10.0
2021,13,3253,500,29,4866,2,2,10,8,29,21,29,0,29,6,False,False,False,1,3,2021-12-06T18:32:50.627,29,True,0.0
2021,13,3253,515,15,7591,13,13,9,3,0,0,0,0,0,0,False,False,False,0,3,2021-12-06T18:35:27.8,0,False,0.0
2021,13,3253,520,15,4179,2,35,3,13,16,3,15,1,15,0,False,False,False,0,3,2021-12-08T16:20:29.65,16,False,1.0
2021,13,3253,530,15,4179,2,51,5,-2,9,11,4,5,4,0,False,False,False,0,3,2021-12-06T18:40:12.047,9,False,5.0
2021,13,3253,545,15,2757,13,4,10,4,0,0,0,0,0,0,False,False,False,0,2,2021-12-06T18:42:56.38,0,False,0.0
2021,13,3253,560,29,6266,13,12,10,2,0,0,0,0,0,0,False,False,False,0,1,2021-12-06T18:46:53.6,0,False,0.0
2021,13,3253,565,29,4866,2,13,10,4,8,4,7,1,7,0,False,False,False,0,3,2021-12-06T18:48:18.45,8,False,1.0
2021,13,3253,575,29,7828,2,5,5,3,3,0,3,0,3,0,False,False,False,0,3,2021-12-06T18:52:47.047,3,False,0.0
2021,13,3253,580,29,4866,2,35,6,19,19,0,19,0,19,0,True,False,False,0,3,2021-12-06T18:58:38.293,19,False,0.0
2021,13,3253,585,29,3398,2,7,6,18,22,4,19,3,19,0,False,False,False,0,4,2021-12-06T19:00:21.493,22,False,3.0
2021,13,3253,605,29,7828,2,6,4,2,2,0,2,0,2,6,False,False,False,0,2,2021-12-08T16:20:57.5,2,True,0.0
2021,13,3253,620,15,3823,2,45,5,-5,-2,3,-3,1,-3,0,True,False,False,0,3,2021-12-06T19:07:06.737,-2,False,1.0
2021,13,3253,625,15,957,13,3,5,6,0,0,0,0,0,0,False,False,False,0,2,2021-12-06T20:19:07.527,0,False,0.0
2021,13,3253,630,15,3823,2,4,5,12,12,0,12,0,12,0,False,False,False,0,2,2021-12-07T23:26:18.2,12,False,0.0
2021,13,3253,635,15,4179,2,51,3,-2,9,11,5,4,5,0,False,False,False,0,3,2021-12-06T19:10:26.583,9,False,4.0
2021,13,3253,650,29,7366,2,32,4,0,5,5,5,0,5,0,False,True,False,0,4,2021-12-08T14:58:55.713,6,False,0.0
2021,13,3253,660,29,6266,2,45,5,-5,5,10,-1,6,-1,0,True,False,False,1,1,2021-12-08T16:22:25.767,5,False,6.0
2021,13,3253,665,29,7828,2,30,3,2,3,1,3,0,3,0,False,False,False,0,3,2021-12-06T19:22:58.3,3,False,0.0
2021,13,3253,670,29,4866,2,4,3,6,8,2,7,1,7,0,False,False,False,0,2,2021-12-06T19:24:30.62,8,False,1.0
2021,13,3253,675,29,7366,3,29,3,13,0,0,0,0,0,0,False,False,False,0,3,2021-12-08T03:32:36.75,0,False,0.0
2021,13,3253,695,29,1067,2,9,5,1,1,0,1,0,1,6,False,False,False,0,2,2021-12-08T03:35:53.177,1,True,0.0
2021,13,3253,710,15,2757,2,39,9,5,7,2,6,1,6,0,False,False,False,0,4,2021-12-06T19:36:13.31,7,False,1.0
2021,13,3253,740,15,2757,13,12,6,18,0,0,0,0,0,0,True,False,False,0,3,2021-12-06T19:43:03.66,0,False,0.0
2021,13,3253,745,15,7591,2,6,4,3,17,14,14,3,14,0,False,False,False,0,3,2021-12-06T19:44:21.787,17,False,3.0
2021,13,3253,750,15,7591,2,6,4,7,10,3,8,2,8,0,False,False,False,0,3,2021-12-06T19:45:25.05,10,False,2.0
2021,13,3253,815,15,957,2,51,10,-3,9,12,0,9,0,0,True,False,False,3,3,2021-12-06T20:01:39.823,9,False,9.0
2021,13,3254,10,3,713,2,5,9,1,14,13,14,0,14,0,False,False,False,0,1,2021-12-06T20:26:35.573,14,False,0.0
2021,13,3254,35,3,6454,3,35,9,9,0,0,0,0,0,0,False,False,False,0,3,2021-12-06T20:38:37.913,0,False,0.0
2021,13,3254,40,3,306,2,38,9,3,16,13,16,0,16,0,True,False,False,0,3,2021-12-06T15:44:35.33,16,False,0.0
2021,13,3254,45,3,713,13,4,9,3,0,0,0,0,0,0,False,False,False,0,1,2021-12-06T15:46:41.753,0,False,0.0
2021,13,3254,65,3,306,2,28,10,3,18,15,17,1,17,0,False,False,False,1,1,2021-12-06T15:52:01.727,18,False,1.0
2021,13,3254,70,3,6454,13,35,10,10,0,0,0,0,0,0,False,False,False,0,3,2021-12-06T15:53:54.137,0,False,0.0
2021,13,3254,100,3,6454,3,5,9,9,0,0,0,0,0,0,False,False,False,0,3,2021-12-06T16:04:38.347,0,False,0.0
2021,13,3254,105,3,6936,2,49,9,0,0,0,0,0,0,0,False,False,False,0,2,2021-12-06T16:09:22.643,0,False,0.0
2021,13,3254,115,25,8421,2,47,5,1,3,2,3,0,3,0,False,False,False,0,3,2021-12-06T16:11:40.26,3,False,0.0
2021,13,3254,125,25,7666,13,9,2,22,0,0,0,0,0,0,False,False,False,0,2,2021-12-06T16:14:07.53,0,False,0.0
2021,13,3254,135,3,5017,2,47,5,0,9,9,4,5,4,0,False,False,False,1,1,2021-12-06T16:16:32.667,9,False,5.0
2021,13,3254,155,3,6454,2,38,9,1,9,8,7,2,7,0,False,False,False,0,3,2021-12-06T16:27:04.177,9,False,2.0
2021,13,3254,180,3,6936,13,2,9,9,0,0,0,0,0,0,False,False,False,0,3,2021-12-06T16:38:52.327,0,False,0.0
2021,13,3254,185,3,713,2,45,5,-1,8,9,8,0,8,0,True,False,False,0,2,2021-12-06T20:27:07.083,8,False,0.0
2021,13,3254,195,3,6454,2,4,9,3,2,-1,3,-1,3,0,False,False,False,0,3,2021-12-08T21:33:15.83,2,False,-1.0
2021,13,3254,200,3,6454,2,12,5,9,10,1,9,1,9,0,False,False,False,0,3,2021-12-08T21:09:42.113,10,False,1.0
2021,13,3254,220,3,6454,2,17,7,22,29,7,28,1,28,0,False,False,False,0,3,2021-12-06T16:55:15.243,29,False,1.0
2021,13,3254,240,25,8421,2,50,3,0,18,18,15,3,15,0,True,False,False,0,2,2021-12-07T20:02:49.637,18,False,3.0
2021,13,3254,245,25,7060,13,9,2,25,0,0,0,0,0,0,False,False,False,0,2,2021-12-06T17:00:23.23,0,False,0.0
2021,13,3254,255,25,6259,2,39,9,2,7,5,7,0,7,0,False,False,False,2,3,2021-12-08T21:36:34.037,7,False,0.0
2021,13,3254,265,3,7672,2,45,10,-4,3,7,1,2,1,0,True,False,False,0,3,2021-12-08T21:10:29.557,3,False,2.0
2021,13,3254,290,3,6936,2,2,9,4,10,6,8,2,8,0,False,False,False,0,2,2021-12-08T20:06:11.583,10,False,2.0
2021,13,3254,310,25,7666,2,29,3,9,12,3,10,2,10,0,False,False,False,0,2,2021-12-06T17:20:51.98,12,False,2.0
2021,13,3254,315,25,8421,2,48,10,-5,4,9,2,2,2,0,False,False,False,0,1,2021-12-06T17:22:17.2,4,False,2.0
2021,13,3254,320,25,8422,2,39,4,4,17,13,6,11,6,0,False,False,False,1,4,2021-12-06T17:37:35.387,17,False,11.0
2021,13,3254,330,25,8422,2,32,3,0,5,5,5,0,5,0,False,False,False,0,4,2021-12-06T17:26:03.88,5,False,0.0
2021,13,3254,335,25,7060,2,8,9,11,14,3,14,0,14,0,False,False,False,0,2,2021-12-06T17:27:31.06,14,False,0.0
2021,13,3254,345,25,7060,3,17,8,34,0,0,0,0,0,0,False,False,False,0,4,2021-12-06T17:30:52.713,0,False,0.0
2021,13,3254,355,25,7060,13,13,10,1,0,0,0,0,0,0,False,False,False,0,2,2021-12-08T21:58:50.287,0,False,0.0
2021,13,3254,370,3,8430,3,13,5,1,0,0,0,0,0,0,False,False,False,0,2,2021-12-08T21:12:07.877,0,False,0.0
2021,13,3254,425,25,6259,13,9,2,28,0,0,0,0,0,0,False,False,False,0,2,2022-02-16T15:29:08.81,0,False,0.0
2021,13,3254,430,25,7060,13,2,5,4,0,0,0,0,0,0,False,False,False,0,2,2021-12-06T18:09:52.713,0,False,0.0
2021,13,3254,435,25,6259,13,35,7,15,0,0,0,0,0,0,False,False,False,0,3,2021-12-06T18:11:49.477,0,False,0.0
2021,13,3254,445,3,121,2,2,9,12,15,3,13,2,13,0,False,False,False,0,3,2021-12-06T20:30:05.557,15,False,2.0
2021,13,3254,460,3,713,2,32,10,-5,15,20,10,5,10,0,False,False,False,2,3,2021-12-08T21:37:15.733,15,False,5.0
2021,13,3254,480,3,713,2,12,5,1,3,2,3,0,3,0,False,False,False,0,1,2021-12-06T20:28:26.387,3,False,0.0
2021,13,3254,485,3,713,13,4,5,5,0,0,0,0,0,0,False,False,False,0,2,2021-12-06T18:26:43.527,0,False,0.0
2021,13,3254,510,25,7060,2,50,5,1,7,6,7,0,7,0,False,False,False,0,2,2021-12-06T18:32:57.797,7,False,0.0
2021,13,3254,525,25,7060,2,2,9,3,7,4,4,3,4,0,False,False,False,1,2,2021-12-06T18:49:51.843,7,False,3.0
2021,13,3254,535,25,8422,13,5,10,11,0,0,0,0,0,0,False,False,False,0,4,2021-12-08T21:59:24.44,0,False,0.0
2021,13,3254,540,25,8422,2,52,10,2,4,2,4,0,4,0,False,False,False,0,3,2021-12-06T18:54:22.287,4,False,0.0
2021,13,3254,555,3,121,3,4,3,4,0,0,0,0,0,0,False,False,False,0,2,2021-12-08T01:10:05.83,0,False,0.0
2021,13,3254,560,3,6936,2,12,5,12,17,5,17,0,17,0,False,False,False,0,3,2021-12-06T19:00:05.123,17,True,0.0
2021,13,3254,575,3,713,13,12,5,5,0,0,0,0,0,0,False,False,False,0,1,2022-02-16T15:31:05.613,0,False,0.0
2021,13,3254,590,25,7060,2,2,5,3,9,6,8,1,8,0,False,False,False,1,2,2021-12-06T19:09:26.767,9,False,1.0
2021,13,3254,605,25,7666,2,35,7,15,40,25,26,14,26,0,False,False,False,0,3,2021-12-06T19:12:43.413,40,False,14.0
2021,13,3254,610,25,7060,2,8,7,22,29,7,29,0,29,6,False,False,False,0,2,2021-12-06T19:14:30.377,29,True,0.0
2021,13,3254,630,3,6936,13,19,2,41,0,0,0,0,0,0,False,False,False,0,2,2021-12-06T20:41:28.03,0,False,
2021,13,3254,635,3,6936,13,17,7,18,0,0,0,0,0,0,False,False,False,0,3,2021-12-06T19:22:56.897,0,False,0.0
2021,13,3254,640,3,6936,2,5,5,6,6,0,6,0,6,0,False,False,False,0,3,2021-12-08T01:10:19.1,6,False,0.0
2021,13,3254,665,25,7060,2,29,5,7,25,18,8,17,8,0,False,False,False,1,2,2021-12-08T21:37:32.433,25,False,17.0
2021,13,3254,680,25,8421,2,28,4,2,9,7,7,2,7,0,False,False,False,0,1,2021-12-06T19:32:49.043,9,False,2.0
2021,13,3254,700,25,8421,2,45,5,-5,2,7,2,0,2,0,False,False,False,0,1,2021-12-06T19:38:33.307,2,False,0.0
2021,13,3254,705,25,6486,13,9,2,17,0,0,0,0,0,0,False,False,False,0,2,2021-12-06T19:39:39.72,0,False,0.0
2021,13,3254,720,3,121,13,4,9,12,0,0,0,0,0,0,False,False,False,0,2,2022-02-16T15:31:37.287,0,False,0.0
2021,13,3254,730,3,6454,13,17,8,34,0,0,0,0,0,0,False,False,False,0,3,2021-12-08T21:20:12.27,0,False,0.0
2021,13,3254,750,25,7053,2,47,10,-1,5,6,2,3,2,0,False,False,False,0,4,2021-12-06T19:51:00.777,5,False,3.0
2021,13,3254,755,25,7060,2,5,3,5,9,4,9,0,9,0,False,False,False,0,2,2021-12-06T19:53:04.277,9,False,0.0
2021,13,3254,775,25,7060,13,4,5,2,0,0,0,0,0,0,False,False,False,0,2,2021-12-08T21:13:52.067,0,False,
2021,13,3254,805,25,7053,2,32,10,2,5,3,3,2,3,0,False,False,False,0,4,2021-12-06T20:04:24.033,5,False,2.0
2021,13,3254,815,25,7060,2,26,3,2,5,3,5,0,5,6,False,False,False,0,2,2021-12-06T20:06:35.62,5,True,0.0
2021,13,3254,835,3,713,2,4,9,3,5,2,4,1,4,0,False,False,False,0,1,2021-12-06T20:08:52.58,5,False,1.0
2021,13,3254,850,3,6936,2,6,8,18,22,4,21,1,21,0,False,False,False,0,3,2021-12-06T20:13:16.59,22,False,1.0
2021,13,3254,855,3,7672,2,2,10,7,18,11,17,1,17,0,False,False,False,0,3,2021-12-08T21:14:04.677,18,False,1.0
2021,13,3254,865,3,121,2,2,9,4,13,9,13,0,13,0,False,False,False,1,2,2021-12-06T20:30:27.63,13,False,0.0
2021,13,3254,870,3,6454,13,17,10,10,0,0,0,0,0,0,False,False,False,0,3,2021-12-06T20:19:07.177,0,False,0.0
2021,13,3254,875,3,121,2,5,3,5,5,0,5,0,5,0,False,False,False,0,2,2021-12-06T20:30:57.23,5,False,0.0
2021,13,3254,880,3,121,2,12,9,6,6,0,6,0,6,6,False,False,False,0,2,2021-12-06T20:21:48.187,6,True,0.0
2021,13,3255,10,27,7408,2,49,9,-3,-1,2,-2,1,-2,0,False,False,False,0,2,2021-12-06T12:25:23.037,-1,False,1.0
2021,13,3255,15,27,7852,2,4,9,4,4,0,4,0,4,0,False,False,False,0,3,2021-12-06T12:26:42.68,4,False,0.0
2021,13,3255,20,27,7404,2,49,10,-3,1,4,1,0,1,0,False,False,False,0,3,2021-12-06T12:29:00.28,1,False,0.0
2021,13,3255,50,28,4922,13,12,10,4,0,0,0,0,0,0,False,False,False,0,3,2021-12-06T12:38:32.587,0,False,0.0
2021,13,3255,65,27,4850,2,51,5,-3,0,3,0,0,0,0,True,True,True,0,3,2021-12-06T12:47:05.67,0,False,0.0
2021,13,3255,70,28,4922,2,8,8,24,24,0,24,0,24,6,False,False,False,0,4,2021-12-09T01:28:28.833,24,True,0.0
2021,13,3255,85,27,650,2,4,10,7,8,1,8,0,8,0,False,False,False,0,3,2021-12-06T12:51:56.113,8,False,0.0
2021,13,3255,95,27,7408,13,19,2,28,0,0,0,0,0,0,False,False,False,0,2,2021-12-06T12:57:23.543,0,False,0.0
2021,13,3255,110,28,6410,13,35,4,8,0,0,0,0,0,0,True,False,False,0,3,2021-12-07T21:30:30.77,0,False,0.0
2021,13,3255,160,28,262,13,11,6,19,0,0,0,0,0,0,True,False,False,0,3,2021-12-06T13:19:09.09,0,False,0.0
2021,13,3255,165,28,262,2,26,10,5,8,3,8,0,8,0,False,False,False,0,2,2021-12-09T01:28:50.363,8,False,0.0
2021,13,3255,170,28,4922,2,32,5,1,28,27,15,13,15,0,False,False,False,2,4,2021-12-09T00:50:28.44,28,False,13.0
2021,13,3255,210,27,650,2,2,10,7,10,3,10,0,10,0,False,False,False,0,3,2021-12-06T13:45:03.55,10,False,0.0
2021,13,3255,225,28,4922,2,31,4,2,12,10,7,5,7,0,False,False,False,0,4,2021-12-06T13:47:56.487,12,False,5.0
2021,13,3255,255,28,4922,3,6,9,4,0,0,0,0,0,0,False,False,False,0,3,2021-12-09T01:05:34.643,0,False,0.0
2021,13,3255,265,28,8471,2,48,9,-7,4,11,3,1,3,0,False,False,False,0,1,2021-12-06T14:04:44.103,4,False,1.0
2021,13,3255,270,28,6410,2,4,9,4,7,3,6,1,6,0,False,False,False,0,3,2021-12-06T14:06:24.817,7,False,1.0
2021,13,3255,285,27,7852,2,32,10,-1,7,8,5,2,5,0,False,False,False,0,3,2021-12-06T14:09:18.94,7,False,2.0
2021,13,3255,290,27,7408,2,2,9,10,12,2,12,0,12,0,False,False,False,0,2,2021-12-06T14:10:36.677,12,False,0.0
2021,13,3255,300,27,650,13,22,6,37,0,0,0,0,0,0,False,False,False,0,2,2022-02-16T15:36:17.117,0,False,0.0
2021,13,3255,315,27,7496,2,51,5,-1,-1,0,-1,0,-1,0,False,False,False,0,2,2021-12-06T14:24:37.117,-1,False,0.0
2021,13,3255,330,27,7408,2,19,2,31,33,2,33,0,33,0,False,False,False,0,2,2021-12-09T01:23:59.21,33,False,0.0
2021,13,3255,335,27,7852,13,7,5,4,0,0,0,0,0,0,False,False,False,0,3,2021-12-09T01:27:21.533,0,False,
2021,13,3255,355,28,4922,2,6,10,8,9,1,8,1,8,0,False,False,False,0,4,2021-12-09T01:02:04.727,9,False,1.0
2021,13,3255,370,28,7619,3,51,9,-4,0,0,0,0,0,0,True,False,False,0,3,2021-12-07T21:30:59.557,0,False,0.0
2021,13,3255,375,28,7753,2,26,9,3,8,5,6,2,6,0,False,False,False,1,3,2021-12-06T15:13:48.817,8,False,2.0
2021,13,3255,385,28,6410,2,26,10,4,9,5,6,3,6,0,False,False,False,0,2,2021-12-09T01:06:59.403,9,False,3.0
2021,13,3255,405,28,4922,2,13,9,3,48,45,18,30,18,6,False,False,False,0,4,2021-12-09T00:50:40.47,48,False,30.0
2021,13,3255,420,27,4850,2,39,4,4,5,1,5,0,5,0,True,False,False,0,3,2021-12-07T19:07:55.927,5,False,0.0
2021,13,3255,425,27,7408,2,5,5,8,9,1,8,1,8,0,False,False,False,0,2,2021-12-06T15:25:43.413,9,False,1.0
2021,13,3255,430,27,7404,2,4,10,2,2,0,2,0,2,0,False,False,False,0,1,2021-12-06T15:35:49.933,2,False,0.0
2021,13,3255,440,27,7404,2,4,4,4,4,0,4,0,4,0,False,False,False,0,1,2021-12-06T15:31:09.177,4,False,0.0
2021,13,3255,445,27,8472,2,46,3,6,11,5,7,4,7,0,False,False,False,1,3,2021-12-06T15:32:41.967,11,False,4.0
2021,13,3255,450,27,7408,13,9,6,15,0,0,0,0,0,0,False,False,False,0,2,2021-12-06T15:33:58.997,0,False,0.0
2021,13,3255,455,27,4850,13,17,7,15,0,0,0,0,0,0,False,False,False,0,3,2021-12-06T15:36:10.797,0,False,
2021,13,3255,460,27,8472,2,4,10,4,7,3,5,2,5,6,False,False,False,1,2,2021-12-06T15:39:48.457,7,False,2.0
2021,13,3255,490,27,650,2,30,5,-1,6,7,4,2,4,0,False,False,False,0,3,2021-12-06T15:55:08.483,6,False,2.0
2021,13,3255,500,27,7408,2,2,9,4,7,3,6,1,6,0,False,False,False,0,2,2021-12-06T15:57:56.727,7,False,1.0
2021,13,3255,515,27,4850,3,38,9,4,0,0,0,0,0,0,False,False,False,0,4,2021-12-06T16:04:46.317,0,False,0.0
2021,13,3255,540,27,650,2,3,6,16,16,0,16,0,16,0,False,False,False,0,2,2021-12-06T16:12:22.063,16,True,0.0
2021,13,3255,550,27,8472,2,35,6,17,17,0,17,0,17,0,False,False,False,0,3,2021-12-09T01:24:10.713,17,True,0.0
2021,13,3255,560,27,7408,13,19,6,31,0,0,0,0,0,0,False,False,False,0,2,2021-12-06T16:30:27.157,0,False,0.0
2021,13,3255,580,28,8471,2,4,9,3,3,0,3,0,3,0,False,False,False,0,1,2021-12-06T16:34:57.18,3,False,0.0
2021,13,3255,590,28,7619,2,17,4,14,21,7,17,4,17,0,False,False,False,0,3,2021-12-09T01:24:22.587,21,False,4.0
2021,13,3255,595,28,4922,13,6,1,23,0,0,0,0,0,0,False,False,False,0,3,2021-12-06T16:45:41.697,0,False,0.0
2021,13,3255,600,27,6397,2,47,5,0,5,5,3,2,3,0,True,False,False,0,4,2021-12-06T16:51:00.127,5,False,2.0
2021,13,3255,605,27,7852,2,18,3,-3,7,10,5,2,5,0,False,False,False,0,2,2021-12-06T16:52:23.42,7,False,2.0
2021,13,3255,615,27,6397,2,47,5,1,2,1,2,0,2,0,False,False,False,0,4,2021-12-06T16:55:07.927,2,False,0.0
2021,13,3255,620,27,650,2,7,5,12,12,0,12,0,12,6,False,False,False,0,3,2021-12-06T16:56:25.377,12,False,0.0
2021,13,3255,670,27,650,2,13,4,7,11,4,11,0,11,0,False,False,False,0,3,2021-12-06T17:10:38.757,11,False,0.0
2021,13,3255,685,27,7404,13,6,4,3,0,0,0,0,0,0,False,False,False,0,1,2021-12-09T01:24:33.463,0,False,0.0
2021,13,3255,695,28,262,2,43,9,11,13,2,11,2,11,0,False,False,False,0,4,2021-12-06T17:23:32.38,13,False,2.0
2021,13,3255,705,28,7619,13,2,9,9,0,0,0,0,0,0,False,False,False,0,2,2021-12-06T17:26:01.857,0,False,0.0
2021,13,3255,710,28,7619,13,5,7,19,0,0,0,0,0,0,False,False,False,0,3,2021-12-06T17:53:04.59,0,False,0.0
2021,13,3255,725,27,650,2,5,5,4,5,1,5,0,5,0,False,False,False,0,3,2021-12-07T19:07:16.463,5,False,0.0
2021,13,3255,730,27,4850,2,5,9,2,2,0,2,0,2,0,False,False,False,0,3,2021-12-09T01:24:44.257,2,False,0.0
2021,13,3255,740,27,4850,13,30,5,-1,0,0,0,0,0,0,True,False,False,0,4,2021-12-09T01:25:17.723,0,False,0.0
2021,13,3255,745,27,5226,2,48,9,-2,27,29,4,23,4,0,False,False,False,2,1,2021-12-09T00:50:54.63,27,False,23.0
2021,13,3255,765,27,7404,2,6,9,3,3,0,3,0,3,0,False,False,False,0,1,2021-12-09T01:25:31.433,3,False,0.0
2021,13,3255,785,27,4850,2,55,4,-2,0,2,0,0,0,0,False,True,True,0,4,2021-12-06T18:20:30.153,0,False,0.0
2021,13,3255,795,28,4922,2,9,6,15,29,14,17,12,17,0,False,False,False,1,4,2021-12-09T01:30:39.257,29,False,12.0
2021,13,3255,800,28,8471,2,48,9,-5,11,16,4,7,4,0,False,False,False,0,1,2021-12-09T00:51:09.19,11,False,7.0
2021,13,3255,810,28,7619,2,7,2,17,18,1,18,0,18,0,False,False,False,0,2,2021-12-06T18:34:13.283,18,True,0.0
2021,13,3255,820,28,4922,2,4,4,14,14,0,14,0,14,0,False,False,False,0,4,2021-12-09T01:31:29.64,14,False,0.0
2021,13,3255,830,28,4922,2,5,5,1,10,9,0,10,0,0,False,False,False,1,3,2021-12-09T01:32:20.28,10,False,10.0
2021,13,3255,835,28,4922,2,6,4,4,7,3,5,2,5,0,False,False,False,0,4,2021-12-06T18:42:19.94,7,False,2.0
2021,13,3255,840,28,7619,2,2,4,6,16,10,9,7,9,0,False,False,False,0,3,2021-12-09T00:51:21.47,16,False,7.0
2021,13,3255,865,28,6410,13,4,10,3,0,0,0,0,0,0,False,False,False,0,3,2021-12-06T18:54:49.7,0,False,0.0
2021,13,3255,875,28,6410,13,6,10,3,0,0,0,0,0,0,False,False,False,0,2,2021-12-06T18:57:22.803,0,False,0.0
2021,13,3256,40,4,6953,3,13,9,3,0,0,0,0,0,0,False,False,False,0,3,2021-12-07T11:33:05.937,0,False,0.0
2021,13,3256,70,4,213,2,50,10,-3,-3,0,-3,0,-3,0,False,False,False,0,2,2021-12-07T11:47:31.74,-3,False,0.0
2021,13,3256,85,4,4913,2,46,3,3,5,2,4,1,4,0,True,False,False,0,3,2021-12-07T11:52:53.957,5,False,1.0
2021,13,3256,120,4,2853,2,4,10,7,8,1,8,0,8,0,False,False,False,0,3,2021-12-07T12:04:48.56,8,False,0.0
2021,13,3256,140,4,594,2,12,2,15,15,0,15,0,15,0,False,False,False,0,3,2021-12-07T12:15:29.813,15,False,
2021,13,3256,145,4,213,13,6,7,17,0,0,0,0,0,0,False,False,False,0,3,2021-12-07T12:19:04.207,0,False,0.0
2021,13,3256,155,4,7646,2,2,10,12,14,2,12,2,12,6,True,False,False,0,3,2022-02-16T13:22:44.723,14,False,2.0
2021,13,3256,175,19,5096,2,32,5,8,12,4,12,0,12,0,False,False,False,0,4,2021-12-07T12:29:42.883,12,False,0.0
2021,13,3256,235,4,7646,2,4,9,5,16,11,16,0,16,0,False,False,False,1,2,2021-12-07T12:46:59.013,16,False,0.0
2021,13,3256,270,4,6953,3,12,2,27,0,0,0,0,0,0,False,False,False,0,3,2021-12-07T12:59:02.733,0,False,0.0
2021,13,3256,310,4,2853,2,4,5,6,6,0,6,0,6,0,False,False,False,0,2,2022-02-16T13:23:04.77,6,False,0.0
2021,13,3256,320,4,594,13,5,5,-4,0,0,0,0,0,0,False,False,False,0,3,2021-12-07T13:11:53.097,0,False,0.0
2021,13,3256,375,4,594,2,5,10,5,11,6,10,1,10,0,True,False,False,0,3,2021-12-07T13:24:24.923,11,False,1.0
2021,13,3256,385,4,213,13,4,5,6,0,0,0,0,0,0,False,False,False,0,2,2022-02-22T19:13:49.64,0,False,0.0
2021,13,3256,390,4,2853,13,4,5,5,0,0,0,0,0,0,False,False,False,0,2,2021-12-07T13:29:54.11,0,False,0.0
2021,13,3256,440,4,213,2,4,9,11,19,8,15,4,15,0,False,False,False,0,2,2021-12-07T13:46:54.983,19,False,4.0
2021,13,3256,445,4,2853,3,20,6,44,0,0,0,0,0,0,False,False,False,0,3,2022-02-22T19:12:48.22,0,False,0.0
2021,13,3256,465,4,7646,13,2,9,13,0,0,0,0,0,0,False,False,False,0,2,2022-02-16T13:23:21.763,0,False,0.0
2021,13,3256,470,4,594,13,12,5,9,0,0,0,0,0,0,False,False,False,0,3,2021-12-07T15:32:22.317,0,False,0.0
2021,13,3256,565,4,6953,2,46,3,-1,7,8,0,7,0,0,False,False,False,1,4,2021-12-07T14:26:00.163,7,False,7.0
2021,13,3256,575,4,2853,2,4,9,5,11,6,8,3,8,0,False,False,False,1,3,2021-12-07T14:28:40.083,11,False,3.0
2021,13,3256,580,4,213,13,12,6,18,0,0,0,0,0,0,False,False,False,0,3,2021-12-07T14:30:53.8,0,False,0.0
2021,13,3256,595,4,7645,2,12,3,2,7,5,5,2,5,0,False,False,False,0,1,2022-02-24T18:07:39.34,7,False,2.0
2021,13,3256,615,4,6953,13,17,8,15,0,0,0,0,0,0,False,False,False,0,3,2021-12-07T14:42:25.763,0,False,0.0
2021,13,3256,630,19,2256,13,5,5,9,0,0,0,0,0,0,False,False,False,0,2,2021-12-07T14:47:43.267,0,False,0.0
2021,13,3256,635,19,1212,2,48,10,-3,7,10,2,5,2,0,False,False,False,0,1,2021-12-07T14:49:24.533,7,False,5.0
2021,13,3256,645,4,2853,2,29,6,24,26,2,26,0,26,0,False,False,False,0,2,2021-12-07T14:54:26.387,26,True,0.0
2021,13,3256,650,4,7645,2,44,3,-2,5,7,2,3,2,0,False,False,False,0,1,2021-12-07T14:55:47.843,5,False,3.0
2021,13,3256,655,4,6953,2,39,4,5,7,2,6,1,6,0,False,False,False,0,3,2021-12-07T14:57:03.243,7,False,1.0
2021,13,3256,660,4,7645,13,44,3,11,0,0,0,0,0,0,False,False,False,0,1,2021-12-07T14:59:13.66,0,False,0.0
2021,13,3256,670,4,213,2,4,9,4,6,2,5,1,5,0,False,False,False,0,3,2021-12-07T15:02:36.827,6,False,1.0
2021,13,3256,690,4,2853,13,29,5,12,0,0,0,0,0,0,False,False,False,0,2,2021-12-07T15:07:13.833,0,False,0.0
2021,13,3256,700,4,6953,13,12,2,18,0,0,0,0,0,0,False,False,False,0,3,2021-12-07T15:10:45.96,0,False,0.0
2021,13,3256,710,4,7646,13,8,1,15,0,0,0,0,0,0,False,False,False,0,2,2021-12-07T15:14:06.793,0,False,0.0
2021,14,3257,10,18,7711,2,5,5,8,8,0,8,0,8,0,True,False,False,0,3,2021-12-15T15:05:37.533,8,False,0.0
2021,14,3257,15,18,7711,2,18,5,-1,5,6,3,2,3,0,False,False,False,0,2,2021-12-15T14:29:19.07,5,False,2.0
2021,14,3257,30,18,7711,13,7,6,38,0,0,0,0,0,0,False,False,False,0,2,2021-12-10T12:36:55.753,0,False,0.0
2021,14,3257,40,18,7712,2,2,10,8,8,0,8,0,8,0,False,False,False,0,2,2021-12-10T12:39:02.89,8,False,0.0
2021,14,3257,50,25,6259,2,2,4,5,7,2,5,2,5,0,False,False,False,0,3,2022-02-16T17:23:00.893,7,False,2.0
2021,14,3257,65,25,7666,2,30,10,-2,6,8,3,3,3,0,True,False,False,0,3,2022-02-16T17:23:16.523,6,False,3.0
2021,14,3257,70,25,6259,3,35,9,12,0,0,0,0,0,0,False,False,False,0,3,2022-02-16T17:23:38.77,0,False,0.0
2021,14,3257,75,25,7060,2,4,8,15,15,0,15,0,15,0,False,False,False,0,3,2021-12-10T12:54:41.327,15,False,0.0
2021,14,3257,95,25,7060,2,6,9,4,6,2,6,0,6,0,False,False,False,0,2,2021-12-10T13:06:09.693,6,False,0.0
2021,14,3257,105,18,7711,13,51,3,-2,0,0,0,0,0,0,True,False,False,0,3,2021-12-10T13:09:01.437,0,False,0.0
2021,14,3257,125,18,7711,2,35,10,14,14,0,14,0,14,6,False,False,False,0,3,2021-12-10T13:17:51.367,14,True,0.0
2021,14,3257,160,18,7711,2,2,9,10,18,8,16,2,16,0,False,False,False,0,2,2021-12-10T13:30:09.89,18,False,2.0
2021,14,3257,180,18,6900,13,4,4,4,0,0,0,0,0,0,False,False,False,0,1,2021-12-15T15:06:54.69,0,False,0.0
2021,14,3257,185,18,4572,3,48,5,-5,0,0,0,0,0,0,True,False,False,0,1,2022-02-16T17:24:44.78,0,False,0.0
2021,14,3257,190,18,7711,13,23,7,20,0,0,0,0,0,0,True,False,False,0,2,2021-12-15T14:02:45.713,0,False,0.0
2021,14,3257,215,25,6486,13,3,3,13,0,0,0,0,0,0,False,False,False,0,2,2021-12-10T14:14:29.3,0,False,0.0
2021,14,3257,225,18,7711,2,35,7,20,22,2,21,1,21,0,False,False,False,0,3,2021-12-15T14:42:42.413,22,False,1.0
2021,14,3257,240,18,6361,2,6,4,6,19,13,16,3,16,0,False,False,False,0,4,2021-12-10T14:25:36.943,19,False,3.0
2021,14,3257,265,25,7666,2,5,10,2,5,3,5,0,5,0,False,False,False,0,3,2021-12-10T14:34:42.343,5,False,0.0
2021,14,3257,285,18,7712,13,39,9,5,0,0,0,0,0,0,False,False,False,0,3,2021-12-10T14:42:13.507,0,False,0.0
2021,14,3257,295,18,7711,13,35,8,23,0,0,0,0,0,0,False,False,False,0,2,2021-12-10T14:46:48.787,0,False,0.0
2021,14,3257,310,18,6262,2,4,3,10,17,7,12,5,12,0,False,False,False,0,2,2021-12-10T14:55:40.843,17,False,5.0
2021,14,3257,320,18,7712,13,4,2,28,0,0,0,0,0,0,False,False,False,0,2,2021-12-10T14:58:34.76,0,False,0.0
2021,14,3257,330,18,7712,2,2,9,6,13,7,9,4,9,0,False,False,False,0,2,2021-12-10T15:01:22.423,13,False,4.0
2021,14,3257,365,25,7060,13,50,5,-1,0,0,0,0,0,0,False,False,False,0,2,2021-12-10T15:20:09.97,0,False,0.0
2021,14,3257,380,25,7666,2,5,5,5,6,1,6,0,6,0,False,False,False,0,3,2021-12-10T15:24:19.603,6,False,0.0
2021,14,3257,400,18,7711,2,18,3,-1,0,1,-1,1,-1,0,False,False,False,0,2,2021-12-15T14:29:41.957,0,False,1.0
2021,14,3257,405,18,7712,13,2,10,7,0,0,0,0,0,0,False,False,False,0,2,2021-12-10T15:29:39.06,0,False,0.0
2021,14,3257,425,25,7060,2,4,10,3,6,3,5,1,5,0,False,False,False,1,2,2021-12-10T15:35:57.29,6,False,1.0
2021,14,3257,440,25,8422,2,2,4,5,17,12,16,1,16,0,False,False,False,0,3,2021-12-10T15:37:49.59,17,False,1.0
2021,14,3257,460,25,7060,13,2,9,5,0,0,0,0,0,0,False,False,False,0,2,2021-12-10T15:44:26.407,0,False,0.0
2021,14,3257,465,25,8421,2,50,9,-2,4,6,-1,5,-1,0,False,False,False,1,3,2021-12-10T15:45:56.51,4,False,
2021,14,3257,485,18,6361,2,47,5,1,1,0,1,0,1,0,True,False,False,0,3,2021-12-11T20:19:31.12,1,False,0.0
2021,14,3257,505,18,4572,13,46,3,3,0,0,0,0,0,0,False,False,False,0,3,2021-12-15T14:02:45.727,0,False,0.0
2021,14,3257,510,18,7712,13,6,4,14,0,0,0,0,0,0,False,False,False,0,2,2021-12-15T15:07:48.32,0,False,0.0
2021,14,3257,535,25,7060,13,2,5,6,0,0,0,0,0,0,False,False,False,0,2,2022-02-16T17:25:09.87,0,False,0.0
2021,14,3257,550,18,7712,13,2,4,9,0,0,0,0,0,0,False,False,False,0,3,2021-12-15T15:08:18.633,0,False,
2021,14,3257,560,18,7711,13,5,5,7,0,0,0,0,0,0,False,False,False,0,2,2021-12-10T16:37:33.043,0,False,0.0
2021,14,3257,565,18,7711,13,4,10,7,0,0,0,0,0,0,False,False,False,0,3,2021-12-10T16:40:56.06,0,False,0.0
2021,14,3257,580,25,6259,13,50,3,-1,0,0,0,0,0,0,False,False,False,0,2,2021-12-10T16:43:17.093,0,False,0.0
2021,14,3257,595,25,6486,2,24,6,24,29,5,24,5,24,0,False,False,False,0,2,2021-12-10T16:48:18.823,29,False,5.0
2021,14,3257,600,25,6259,2,5,5,2,5,3,3,2,3,0,False,False,False,0,3,2021-12-10T16:50:34.57,5,False,2.0
2021,14,3257,605,25,6259,2,29,5,12,12,0,12,0,12,0,False,False,False,0,3,2021-12-15T15:17:48.857,12,False,
2021,14,3257,610,25,6486,2,50,3,-2,-2,0,-2,0,-2,0,False,False,False,0,2,2022-02-16T17:25:24.363,-2,False,0.0
2021,14,3257,620,25,6486,2,5,3,3,8,5,7,1,7,0,False,False,False,0,2,2021-12-10T17:02:13.907,8,False,1.0
2021,14,3257,625,25,7060,3,29,5,3,0,0,0,0,0,0,False,False,False,0,2,2021-12-10T17:03:41.98,0,False,0.0
2021,14,3257,630,25,8421,2,46,3,2,3,1,3,0,3,6,False,False,False,0,1,2021-12-10T17:06:15.37,3,True,0.0
2021,14,3257,645,18,7711,13,8,8,21,0,0,0,0,0,0,False,False,False,0,2,2021-12-15T14:31:45.93,0,False,0.0
2021,14,3257,660,25,7666,13,2,4,5,0,0,0,0,0,0,False,False,False,0,2,2021-12-10T17:20:06.34,0,False,0.0
2021,14,3257,670,25,7666,2,29,5,13,14,1,13,1,13,0,False,False,False,0,2,2021-12-10T17:22:40.97,14,False,1.0
2021,14,3257,675,25,6259,2,51,5,-2,1,3,1,0,1,0,False,False,False,0,3,2021-12-10T17:24:34.18,1,False,0.0
2021,14,3257,685,25,7060,13,12,5,8,0,0,0,0,0,0,False,False,False,0,3,2022-02-16T17:26:48.41,0,False,0.0
2021,14,3257,690,25,7060,13,5,9,8,0,0,0,0,0,0,False,False,False,0,3,2021-12-10T17:28:56.107,0,False,
2021,14,3257,720,18,7711,13,35,7,19,0,0,0,0,0,0,False,False,False,0,3,2021-12-15T14:43:12.437,0,False,0.0
2021,14,3257,735,25,7060,2,19,2,32,37,5,32,5,32,0,False,False,False,0,2,2021-12-10T18:04:53.597,37,False,5.0
2021,14,3257,740,25,6486,2,8,1,28,30,2,28,2,28,6,False,False,False,0,3,2021-12-10T18:07:31.247,30,False,2.0
2021,14,3257,765,18,7712,2,7,6,46,62,16,62,0,62,6,False,False,False,0,2,2021-12-10T18:20:24.737,62,True,0.0
2021,14,3257,830,18,7712,13,2,10,1,0,0,0,0,0,0,False,False,False,0,2,2021-12-15T14:32:41.147,0,False,0.0
2021,14,3257,835,25,6259,2,13,4,2,6,4,3,3,3,0,False,False,False,1,3,2021-12-10T18:41:30.843,6,False,3.0
2021,14,3257,840,25,8422,2,5,5,10,15,5,15,0,15,6,False,False,False,0,3,2021-12-15T15:09:44.88,15,True,0.0
2021,14,3257,860,18,7712,2,4,9,8,8,0,8,0,8,0,False,False,False,0,2,2021-12-10T18:51:47.163,8,False,
2021,14,3257,865,18,7711,2,2,4,5,12,7,7,5,7,0,False,False,False,0,3,2021-12-10T18:53:37.667,12,False,5.0
2021,14,3257,870,18,4572,2,17,10,12,17,5,13,4,13,0,False,False,False,0,1,2021-12-10T18:55:20.497,17,False,4.0
2021,14,3257,900,18,7712,13,5,3,10,0,0,0,0,0,0,False,False,False,0,3,2021-12-10T19:00:16.82,0,False,0.0
2021,14,3257,910,25,8421,2,5,3,2,6,4,3,3,3,0,False,False,False,0,3,2021-12-10T19:03:35.237,6,False,3.0
2021,14,3257,915,25,7666,2,19,2,37,38,1,37,1,37,0,False,False,False,0,2,2021-12-10T19:08:44.137,38,False,1.0
2021,14,3257,920,25,7666,2,50,3,-1,9,10,7,2,7,0,False,False,False,0,2,2021-12-10T19:09:34.327,2,False,2.0
2021,14,3257,930,25,8421,2,47,10,-3,1,4,-3,4,-3,0,False,False,False,1,1,2021-12-15T14:53:16.19,1,False,4.0
2021,14,3257,935,25,7666,2,4,10,13,13,0,13,0,13,0,False,False,False,0,2,2021-12-10T19:13:28.56,13,False,0.0
2021,14,3257,940,25,6259,2,26,4,1,3,2,1,2,1,0,False,False,False,0,3,2021-12-10T19:14:44.99,3,False,2.0
2021,14,3257,945,25,7666,2,2,10,4,9,5,6,3,6,0,False,False,False,0,2,2021-12-10T19:16:06.223,9,False,3.0
2021,14,3257,955,25,6259,2,13,9,3,10,7,10,0,10,0,False,False,False,0,3,2021-12-10T19:20:11.4,10,False,0.0
2021,14,3257,960,25,6486,13,19,2,24,0,0,0,0,0,0,False,False,False,0,2,2021-12-15T14:02:45.743,0,False,0.0
2021,14,3257,965,25,7060,2,6,4,3,12,9,11,1,11,0,False,False,False,1,2,2021-12-15T14:49:55.27,12,False,1.0
2021,14,3257,970,25,8422,13,17,4,12,0,0,0,0,0,0,False,False,False,0,4,2021-12-15T14:43:22.753,0,False,0.0
2021,14,3258,15,9,6446,2,5,5,4,4,0,4,0,4,0,False,False,False,0,4,2021-12-15T18:48:24.49,4,False,0.0
2021,14,3258,25,9,7816,3,50,10,-2,0,0,0,0,0,0,False,False,False,0,3,2021-12-13T10:34:50.393,0,False,0.0
2021,14,3258,30,9,7816,2,5,5,4,18,14,18,0,18,0,False,False,False,0,3,2021-12-13T10:36:59.723,18,False,0.0
2021,14,3258,35,9,6436,13,4,3,8,0,0,0,0,0,0,False,False,False,0,2,2021-12-13T10:38:42.587,0,False,0.0
2021,14,3258,40,9,322,2,4,9,7,7,0,7,0,7,0,True,False,False,0,3,2021-12-15T16:16:26.51,7,False,0.0
2021,14,3258,45,9,4202,2,11,3,0,15,15,12,3,12,0,False,False,False,0,1,2021-12-13T10:42:55.673,15,False,3.0
2021,14,3258,60,9,322,2,49,5,-2,3,5,-2,5,-2,0,False,False,False,2,2,2021-12-15T18:04:35.56,3,False,5.0
2021,14,3258,75,32,2675,2,5,5,12,14,2,12,2,12,0,False,False,False,0,3,2021-12-15T18:49:20.657,14,False,2.0
2021,14,3258,85,32,4803,13,5,5,9,0,0,0,0,0,0,False,False,False,0,3,2021-12-13T10:56:55.737,0,False,0.0
2021,14,3258,95,32,8527,13,21,2,35,0,0,0,0,0,0,False,False,False,0,2,2021-12-13T11:03:04.253,0,False,0.0
2021,14,3258,110,9,7816,2,2,10,5,12,7,8,4,8,0,False,False,False,0,3,2021-12-13T11:18:47.943,12,False,4.0
2021,14,3258,120,9,7816,13,35,7,21,0,0,0,0,0,0,False,False,False,0,3,2021-12-13T11:25:29.847,0,False,0.0
2021,14,3258,130,32,4788,13,5,10,5,0,0,0,0,0,0,False,False,False,0,3,2021-12-13T11:29:45.007,0,False,0.0
2021,14,3258,135,32,3562,13,50,9,-10,0,0,0,0,0,0,False,False,False,0,2,2021-12-15T17:49:11.72,0,False,0.0
2021,14,3258,145,9,6436,2,6,8,18,24,6,19,5,19,0,False,False,False,0,2,2021-12-13T11:40:05.14,24,False,5.0
2021,14,3258,155,9,4202,3,55,10,-3,0,0,0,0,0,0,False,False,False,0,1,2021-12-15T16:50:17.883,0,False,
2021,14,3258,160,9,4202,13,11,5,12,0,0,0,0,0,0,False,False,False,0,1,2021-12-13T11:45:07.417,0,False,0.0
2021,14,3258,165,9,322,2,26,9,5,8,3,7,1,7,0,False,False,False,0,2,2021-12-13T18:30:31.84,8,False,
2021,14,3258,170,9,322,2,2,10,7,7,0,7,0,7,6,False,False,False,0,3,2021-12-13T18:59:39.697,7,True,0.0
2021,14,3258,195,32,2675,13,24,6,25,0,0,0,0,0,0,True,False,False,0,3,2021-12-14T22:16:34.713,0,False,
2021,14,3258,205,32,7128,13,2,9,7,0,0,0,0,0,0,False,False,False,0,3,2021-12-13T12:03:46.29,0,False,0.0
2021,14,3258,210,32,2675,2,2,10,5,5,0,4,1,4,0,True,False,False,0,3,2021-12-13T12:05:20.96,5,False,1.0
2021,14,3258,245,32,4788,13,12,3,9,0,0,0,0,0,0,False,False,False,0,4,2022-02-24T18:22:08.913,0,False,0.0
2021,14,3258,260,9,6436,13,12,8,18,0,0,0,0,0,0,False,False,False,0,3,2022-02-24T18:22:19.747,0,False,0.0
2021,14,3258,270,9,6436,2,20,6,28,46,18,37,9,37,0,False,False,False,0,2,2021-12-13T19:03:32.55,46,False,
2021,14,3258,275,9,7816,2,50,3,0,4,4,3,1,3,0,False,False,False,0,2,2021-12-13T12:50:07.847,4,False,1.0
2021,14,3258,285,32,4803,13,35,5,11,0,0,0,0,0,0,False,False,False,0,3,2021-12-15T18:51:47.287,0,False,0.0
2021,14,3258,295,32,2675,13,2,9,5,0,0,0,0,0,0,False,False,False,0,3,2021-12-13T12:58:50.62,0,False,0.0
2021,14,3258,310,9,7816,2,46,3,0,0,0,0,0,0,0,False,False,False,0,3,2021-12-15T16:50:17.883,0,False,0.0
2021,14,3258,315,9,7816,2,51,10,-2,12,14,5,7,5,0,False,False,False,2,3,2021-12-13T13:11:53.713,12,False,7.0
2021,14,3258,330,9,6436,13,19,2,30,0,0,0,0,0,0,False,False,False,0,2,2021-12-13T18:32:26.23,0,False,
2021,14,3258,350,9,7816,13,8,7,19,0,0,0,0,0,0,False,False,False,0,2,2021-12-15T18:52:17.407,0,False,0.0
2021,14,3258,355,9,4202,13,48,10,0,0,0,0,0,0,0,False,False,False,0,1,2021-12-13T13:34:46.92,0,False,0.0
2021,14,3258,385,32,8528,2,26,10,6,10,4,8,2,8,0,False,False,False,0,3,2021-12-15T16:50:17.883,10,False,
2021,14,3258,390,32,7128,13,8,8,20,0,0,0,0,0,0,False,False,False,0,2,2021-12-13T14:31:34.79,0,False,0.0
2021,14,3258,395,32,7807,2,5,9,2,3,1,3,0,3,0,False,False,False,0,1,2021-12-13T19:03:54.21,3,False,
2021,14,3258,405,32,6430,13,6,7,16,0,0,0,0,0,0,False,False,False,0,2,2021-12-13T14:35:50.07,0,False,0.0
2021,14,3258,415,9,322,2,2,10,5,9,4,7,2,7,0,False,False,False,0,2,2021-12-13T19:04:37.213,9,False,
2021,14,3258,420,9,4202,13,44,3,-4,0,0,0,0,0,0,False,False,False,0,1,2021-12-13T14:41:50.81,0,False,0.0
2021,14,3258,430,9,6441,2,26,9,4,13,9,13,0,13,0,False,False,False,0,3,2021-12-13T14:45:55.48,13,False,0.0
2021,14,3258,440,9,6436,2,4,5,9,9,0,9,0,9,0,False,False,False,0,2,2021-12-13T14:49:07.297,9,True,0.0
2021,14,3258,445,9,322,2,2,10,9,14,5,12,2,12,0,False,False,False,0,2,2021-12-13T14:50:34.72,14,False,2.0
2021,14,3258,460,9,322,2,13,9,5,20,15,15,5,15,0,False,False,False,1,3,2021-12-13T14:56:51.59,20,False,5.0
2021,14,3258,480,9,6436,3,5,3,6,0,0,0,0,0,0,False,False,False,0,3,2021-12-15T18:53:53.087,0,False,0.0
2021,14,3258,485,9,4202,13,17,8,19,0,0,0,0,0,0,False,False,False,0,3,2021-12-15T18:55:06.823,0,False,0.0
2021,14,3258,515,32,4788,3,13,9,0,0,0,0,0,0,0,False,False,False,0,4,2021-12-15T17:27:21.173,0,False,0.0
2021,14,3258,520,32,7128,13,9,2,27,0,0,0,0,0,0,False,False,False,0,3,2021-12-13T15:10:52.537,0,False,0.0
2021,14,3258,525,32,2675,2,6,10,11,12,1,12,0,12,0,False,False,False,0,3,2021-12-13T15:13:29.743,12,False,0.0
2021,14,3258,530,32,3562,2,50,9,-1,2,3,1,1,1,0,False,False,False,0,2,2021-12-13T15:15:15.55,2,False,1.0
2021,14,3258,535,32,2675,2,30,3,2,3,1,3,0,3,0,False,False,False,0,4,2021-12-13T15:16:39.23,3,False,0.0
2021,14,3258,540,32,7128,13,12,2,47,0,0,0,0,0,0,False,False,False,0,3,2021-12-13T15:20:38.283,0,False,0.0
2021,14,3258,555,9,6436,2,3,5,12,12,0,12,0,12,0,False,False,False,0,2,2021-12-15T16:50:17.883,12,False,0.0
2021,14,3258,560,9,6436,2,2,10,5,5,0,5,0,5,0,False,False,False,0,2,2021-12-13T15:28:27.137,5,False,0.0
2021,14,3258,575,9,7816,2,4,10,11,11,0,11,0,11,0,False,False,False,0,2,2021-12-15T17:47:45.067,11,False,0.0
2021,14,3258,580,9,6441,2,6,9,5,5,0,5,0,5,0,False,False,False,0,3,2021-12-15T16:35:45.053,5,False,0.0
2021,14,3258,585,9,4202,3,4,10,3,0,0,0,0,0,0,False,False,False,0,1,2021-12-15T16:50:17.883,0,False,0.0
2021,14,3258,590,9,322,13,51,3,-1,0,0,0,0,0,0,False,False,False,0,3,2021-12-15T19:03:30.603,0,False,0.0
2021,14,3258,605,32,3562,13,29,2,23,0,0,0,0,0,0,False,False,False,0,2,2021-12-15T19:15:52.077,0,False,0.0
2021,14,3258,620,32,8528,2,53,9,-6,19,25,17,2,17,0,False,False,False,0,4,2021-12-13T15:51:39.593,19,False,2.0
2021,14,3258,630,32,8659,2,28,10,-2,9,11,6,3,6,0,False,False,False,0,1,2022-02-16T17:45:40.343,9,False,3.0
2021,14,3258,635,32,6430,2,12,6,43,43,0,43,0,43,6,False,False,False,0,2,2022-02-24T18:23:15.723,43,True,0.0
2021,14,3258,675,32,7807,2,48,10,-5,-1,4,-3,2,-3,0,False,False,False,0,1,2021-12-15T18:05:52.91,-1,False,2.0
2021,14,3258,680,32,7807,2,28,10,1,6,5,6,0,6,0,False,True,True,0,1,2021-12-13T16:15:31.987,6,False,0.0
2021,14,3258,685,9,6436,2,18,5,-1,10,11,3,7,3,0,False,False,False,0,2,2022-02-16T17:46:22.613,10,False,7.0
2021,14,3258,695,9,6446,13,38,9,5,0,0,0,0,0,0,False,False,False,0,4,2021-12-13T16:26:38.013,0,False,0.0
2021,14,3258,700,9,4385,2,46,3,1,2,1,1,1,1,0,False,False,False,0,1,2022-03-08T19:13:31.52,2,False,1.0
2021,14,3258,715,32,8659,2,5,3,1,0,-1,-1,1,-1,0,False,False,False,0,1,2021-12-15T17:48:17.33,0,False,
2021,14,3258,735,32,3562,2,51,10,2,10,8,7,3,7,0,False,False,False,1,3,2021-12-13T17:04:24.18,10,False,3.0
2021,14,3258,750,9,7816,2,5,3,4,4,0,4,0,4,0,False,False,False,0,3,2021-12-13T18:53:33.873,4,False,0.0
2021,14,3258,755,9,4385,13,46,3,1,0,0,0,0,0,0,False,False,False,0,1,2021-12-13T17:13:21.04,0,False,0.0
2021,14,3258,775,32,4788,2,13,10,2,8,6,8,0,8,0,False,False,False,0,3,2021-12-13T17:21:39.22,8,False,0.0
2021,14,3258,795,9,322,2,12,5,10,10,0,10,0,10,0,False,False,False,0,2,2021-12-15T18:06:15.31,10,False,
2021,14,3258,815,32,2675,3,13,10,5,0,0,0,0,0,0,False,False,False,0,3,2021-12-15T19:00:46.79,0,False,0.0
2021,14,3258,830,32,2675,13,13,10,4,0,0,0,0,0,0,False,False,False,0,3,2021-12-13T17:40:07.733,0,False,0.0
2021,14,3258,840,32,6430,2,7,6,19,19,0,19,0,19,0,False,False,False,0,2,2021-12-13T17:50:21.52,19,False,0.0
2021,14,3258,845,32,8528,13,5,10,5,0,0,0,0,0,0,False,False,False,0,3,2021-12-13T17:51:39.737,0,False,0.0
2021,14,3258,855,32,3634,2,16,10,1,19,18,15,4,15,0,False,False,False,1,1,2021-12-15T19:01:05.003,19,False,4.0
2021,14,3258,895,9,6446,13,35,10,5,0,0,0,0,0,0,False,False,False,0,4,2021-12-15T19:01:37.883,0,False,0.0
2021,14,3258,925,9,6436,13,2,9,5,0,0,0,0,0,0,False,False,False,0,2,2021-12-13T18:10:57.89,0,False,0.0
2021,14,3258,935,32,6430,2,13,10,3,7,4,4,3,4,0,False,False,False,0,2,2021-12-13T18:13:47.09,7,False,3.0
2021,14,3258,940,32,3562,3,19,2,31,0,0,0,0,0,0,False,False,False,0,2,2022-02-16T17:47:46.2,0,False,0.0
2021,14,3259,35,7,2631,3,4,9,4,0,0,0,0,0,0,False,False,False,0,3,2021-12-13T10:14:29.977,0,False,0.0
2021,14,3259,40,7,8317,3,6,9,14,0,0,0,0,0,0,False,False,False,0,2,2021-12-13T10:14:41.343,0,False,0.0
2021,14,3259,50,28,7619,2,45,5,-2,7,9,6,1,6,0,True,False,False,0,3,2021-12-15T00:05:29,7,False,1.0
2021,14,3259,55,28,4922,2,32,5,1,5,4,3,2,3,0,False,False,False,0,4,2021-12-13T10:20:55.99,5,False,2.0
2021,14,3259,60,28,7619,2,50,9,-3,4,7,4,0,4,0,False,False,False,0,2,2021-12-13T11:31:05.453,4,False,0.0
2021,14,3259,70,28,7619,13,5,9,10,0,0,0,0,0,0,False,False,False,0,2,2021-12-13T10:36:15.553,0,False,0.0
2021,14,3259,85,28,4922,2,13,9,2,2,0,2,0,2,0,False,False,False,0,4,2021-12-13T10:42:38.053,2,False,0.0
2021,14,3259,90,28,7751,2,6,10,7,7,0,7,0,7,0,False,False,False,0,2,2021-12-16T17:09:30.603,7,False,
2021,14,3259,95,28,7753,2,4,9,2,10,8,9,1,9,0,False,True,False,0,3,2021-12-13T14:19:47.803,12,False,1.0
2021,14,3259,120,7,6975,2,32,10,1,14,13,13,1,13,0,False,False,False,0,4,2021-12-13T11:02:13.733,14,False,1.0
2021,14,3259,130,7,7659,2,6,1,15,20,5,19,1,19,0,False,False,False,0,3,2021-12-13T11:09:49.847,20,False,1.0
2021,14,3259,135,7,3521,2,50,10,-4,0,4,-3,3,-3,0,False,True,False,2,3,2021-12-16T17:04:45.66,0,False,3.0
2021,14,3259,140,7,3521,2,5,3,5,10,5,10,0,10,0,False,False,False,0,3,2021-12-13T11:13:39.53,10,False,0.0
2021,14,3259,150,7,3521,13,30,10,-1,0,0,0,0,0,0,False,False,False,0,3,2021-12-13T12:52:26.613,0,False,0.0
2021,14,3259,160,7,4455,2,52,4,3,11,8,10,1,10,0,True,False,False,0,4,2021-12-16T17:01:50.687,11,False,1.0
2021,14,3259,180,28,7619,2,2,10,7,21,14,8,13,8,0,False,False,False,2,2,2021-12-13T11:25:09.74,21,False,13.0
2021,14,3259,225,7,3521,2,8,4,12,16,4,15,1,15,0,False,False,False,0,3,2021-12-13T11:47:30.137,16,False,1.0
2021,14,3259,250,28,4922,2,32,10,1,6,5,1,5,1,0,False,False,False,2,4,2021-12-13T11:53:31.587,6,False,5.0
2021,14,3259,260,28,4922,13,19,2,27,0,0,0,0,0,0,False,False,False,0,3,2021-12-13T11:57:42.987,0,False,0.0
2021,14,3259,285,7,8317,13,2,8,17,0,0,0,0,0,0,False,False,False,0,2,2021-12-16T15:45:10.027,0,False,
2021,14,3259,295,7,2631,2,4,9,4,9,5,4,5,4,0,False,False,False,1,4,2021-12-13T12:07:45.74,9,False,5.0
2021,14,3259,300,7,8317,3,19,2,37,0,0,0,0,0,0,False,False,False,0,2,2022-02-16T16:52:02.953,0,True,0.0
2021,14,3259,310,7,8317,2,12,10,10,12,2,10,2,10,0,False,False,False,0,2,2021-12-13T13:17:36.87,12,False,2.0
2021,14,3259,320,7,4455,2,48,10,-4,-4,0,-4,0,-4,0,False,False,False,0,1,2021-12-13T12:20:34.19,-4,False,0.0
2021,14,3259,330,7,4455,2,32,5,1,11,10,6,5,6,0,False,False,False,1,3,2021-12-13T12:22:20.707,11,False,5.0
2021,14,3259,350,28,7619,2,12,5,1,1,0,1,0,1,0,True,False,False,0,2,2021-12-13T12:27:08.57,1,True,0.0
2021,14,3259,355,28,7619,2,51,9,-3,5,8,4,1,4,0,True,False,False,0,3,2021-12-16T17:04:26.287,5,False,
2021,14,3259,360,28,7751,2,32,5,1,4,3,3,1,3,0,False,False,False,0,1,2021-12-13T12:30:32.103,4,False,1.0
2021,14,3259,365,28,408,13,9,6,49,0,0,0,0,0,0,False,False,False,0,3,2021-12-15T00:03:09.827,0,False,0.0
2021,14,3259,380,28,7751,2,4,9,3,3,0,3,0,3,0,False,False,False,0,1,2021-12-13T12:38:33.227,3,False,0.0
2021,14,3259,385,28,7619,13,5,6,16,0,0,0,0,0,0,False,False,False,0,2,2022-02-22T18:54:40.067,0,False,0.0
2021,14,3259,400,28,4922,2,35,9,12,14,2,13,1,13,6,True,False,False,0,3,2021-12-13T12:44:06.453,14,False,1.0
2021,14,3259,460,28,7224,2,6,8,18,22,4,18,4,18,0,False,False,False,1,2,2021-12-16T17:05:07.233,22,False,4.0
2021,14,3259,480,28,4922,2,2,10,8,20,12,9,11,9,0,False,False,False,1,4,2021-12-16T17:05:26.69,20,False,11.0
2021,14,3259,495,28,4922,2,2,9,10,16,6,12,4,12,0,False,False,False,0,3,2021-12-13T13:23:47.33,16,False,4.0
2021,14,3259,505,28,7619,13,5,5,6,0,0,6,-1005,6,0,False,False,False,0,2,2021-12-16T17:34:11.777,0,False,0.0
2021,14,3259,510,28,262,13,12,10,6,0,0,6,-1005,6,0,False,False,False,0,1,2021-12-13T13:30:46.467,0,False,0.0
2021,14,3259,535,7,2631,2,4,9,4,12,8,5,7,5,0,False,False,False,2,3,2021-12-16T17:07:48.01,12,False,7.0
2021,14,3259,540,7,4455,13,4,4,4,0,0,0,0,0,0,False,False,False,0,1,2021-12-16T17:16:04.587,0,False,0.0
2021,14,3259,545,7,7659,2,6,9,13,19,6,18,1,18,0,False,False,False,0,3,2021-12-16T17:18:08.663,19,False,1.0
2021,14,3259,555,7,8317,2,30,5,-1,3,4,2,1,2,0,True,False,False,0,4,2021-12-14T16:14:57.423,3,False,1.0
2021,14,3259,570,7,4679,2,46,3,1,5,4,1,4,1,0,False,False,False,1,1,2021-12-16T17:05:40.773,5,False,4.0
2021,14,3259,610,28,4922,2,4,4,10,10,0,10,0,10,0,False,False,False,0,4,2021-12-13T14:25:29.873,10,False,0.0
2021,14,3259,630,7,7659,2,7,2,23,27,4,27,0,27,0,False,False,False,0,3,2021-12-13T14:30:05.723,27,True,0.0
2021,14,3259,635,7,7659,13,3,3,9,0,0,0,0,0,0,False,False,False,0,2,2021-12-13T14:31:18.223,0,False,0.0
2021,14,3259,645,7,4455,2,45,5,-5,4,9,0,4,0,0,False,False,False,0,1,2021-12-13T14:33:51.833,4,False,4.0
2021,14,3259,650,7,8317,2,12,8,17,17,0,17,0,17,6,False,False,False,0,2,2021-12-13T15:51:46.85,17,True,0.0
2021,14,3259,665,28,4922,2,32,9,-1,13,14,10,3,10,0,False,False,False,0,4,2021-12-13T14:37:28.353,13,False,3.0
2021,14,3259,680,28,4922,13,4,4,13,0,0,0,0,0,0,True,False,False,0,4,2022-02-16T16:53:19.86,0,False,0.0
2021,14,3259,695,7,8317,2,2,10,4,13,9,8,5,8,0,False,False,False,0,2,2021-12-13T14:44:29.497,13,False,5.0
2021,14,3259,700,7,4679,2,48,10,-3,5,8,3,2,3,0,False,False,False,0,1,2021-12-13T14:45:43.523,5,False,2.0
2021,14,3259,705,7,8317,13,2,9,5,0,0,5,-1004,5,0,False,False,False,0,2,2021-12-13T14:47:14.177,0,False,0.0
2021,14,3259,745,28,4922,2,26,9,3,8,5,6,2,6,0,False,False,False,0,3,2021-12-13T14:56:15.25,8,False,2.0
2021,14,3259,765,7,2631,2,32,10,2,12,10,11,1,11,0,False,False,False,0,4,2021-12-16T17:32:22.707,12,False,1.0
2021,14,3259,775,7,7659,2,6,10,14,22,8,15,7,15,0,False,False,False,0,2,2021-12-13T15:00:34.703,22,False,7.0
2021,14,3259,780,7,2631,13,31,10,2,0,0,0,0,0,0,False,False,False,0,4,2021-12-13T15:02:22.297,0,False,0.0
2021,14,3259,785,7,7659,13,29,2,23,0,0,0,0,0,0,False,False,False,0,2,2021-12-13T15:03:49.873,0,False,0.0
2021,14,3259,790,7,3521,2,24,6,25,29,4,28,1,28,0,False,False,False,0,3,2021-12-16T17:34:51.817,29,False,1.0
2021,14,3259,795,7,8317,2,20,2,31,32,1,32,0,32,6,False,False,False,0,2,2021-12-14T23:16:58.003,32,True,0.0
2021,14,3259,810,28,7753,2,5,9,4,9,5,8,1,8,0,True,False,False,0,3,2021-12-13T15:10:07.83,9,False,1.0
2021,14,3259,815,28,262,2,16,9,3,5,2,4,1,4,0,False,False,False,0,1,2021-12-13T15:11:08.27,5,False,1.0
2021,14,3259,820,28,7753,13,2,9,6,0,0,0,0,0,0,False,False,False,0,3,2021-12-13T15:12:20.313,0,False,0.0
2021,14,3259,830,28,7619,2,5,8,15,17,2,16,1,16,0,False,False,False,1,3,2021-12-16T17:08:02,17,False,1.0
2021,14,3259,840,28,7753,13,26,9,2,0,0,0,0,0,0,False,False,False,0,3,2021-12-16T17:07:26.507,0,False,0.0
2021,14,3259,845,28,7619,13,6,10,12,0,0,0,0,0,0,False,False,False,0,2,2021-12-13T15:17:32.397,0,False,0.0
2021,14,3259,850,28,4922,2,7,7,16,19,3,19,0,19,0,False,False,False,0,3,2021-12-13T15:19:27.6,19,False,0.0
2021,14,3259,885,7,7659,2,6,4,14,26,12,25,1,25,0,False,False,False,0,2,2021-12-13T15:26:16.297,26,False,1.0
2021,14,3259,895,7,2631,2,33,10,4,23,19,11,12,11,0,False,False,False,1,4,2021-12-16T17:22:33.937,23,False,12.0
2021,14,3259,925,28,4922,2,28,4,7,8,1,8,0,8,0,False,False,False,0,4,2021-12-13T15:35:30.733,8,False,0.0
2021,14,3259,935,28,7753,2,29,2,20,25,5,20,5,20,0,False,False,False,0,3,2021-12-13T15:38:09.157,25,False,5.0
2021,14,3259,940,28,4922,2,17,8,17,21,4,20,1,20,0,True,False,False,0,4,2021-12-15T00:05:45.873,21,False,1.0
2021,14,3259,945,28,7751,2,16,4,3,3,0,3,0,3,0,False,False,False,0,1,2021-12-17T18:30:01.67,3,False,0.0
2021,14,3259,960,28,4922,2,2,9,7,9,2,8,1,8,0,False,False,False,0,3,2021-12-13T15:43:55.23,9,False,1.0
2021,14,3259,970,28,7619,2,30,9,-1,12,13,7,5,7,6,False,False,False,0,3,2021-12-13T15:47:25.457,12,False,5.0
2021,14,3260,10,31,2865,2,39,4,4,9,5,7,2,7,0,False,False,False,0,3,2021-12-13T10:30:36.183,9,False,2.0
2021,14,3260,25,31,4834,2,13,9,4,6,2,6,0,6,0,True,False,False,0,4,2021-12-15T17:52:12.09,6,False,0.0
2021,14,3260,35,31,661,13,39,9,5,0,0,0,0,0,0,False,False,False,0,3,2021-12-13T10:48:16.86,0,False,0.0
2021,14,3260,50,31,4844,2,46,9,2,11,9,8,3,8,0,False,False,False,0,1,2021-12-13T15:44:27.023,11,False,3.0
2021,14,3260,75,15,914,2,4,3,8,8,0,8,0,8,0,False,False,False,0,2,2021-12-13T15:44:05.197,8,False,0.0
2021,14,3260,80,15,7591,2,2,5,6,14,8,11,3,11,0,False,False,False,0,2,2021-12-13T11:08:00.637,14,False,3.0
2021,14,3260,90,15,7591,2,51,10,-6,3,9,3,0,3,0,True,False,False,0,3,2021-12-13T11:12:03.783,3,False,0.0
2021,14,3260,105,31,7913,2,46,3,3,15,12,7,8,7,0,True,False,False,0,4,2021-12-13T11:22:58.637,15,False,8.0
2021,14,3260,115,31,661,2,18,5,-1,1,2,0,1,0,0,False,False,False,0,2,2022-02-16T17:39:44.53,1,False,1.0
2021,14,3260,125,31,6722,13,48,9,-4,0,0,0,0,0,0,False,False,False,0,1,2021-12-13T11:30:22.35,0,False,0.0
2021,14,3260,130,31,661,2,4,1,16,16,0,16,0,16,0,False,False,False,0,3,2021-12-13T15:41:56.297,16,False,0.0
2021,14,3260,145,31,7913,2,2,9,5,9,4,6,3,6,0,False,False,False,0,3,2021-12-13T11:38:13.137,9,False,3.0
2021,14,3260,170,15,957,2,39,9,4,7,3,6,1,6,0,False,False,False,0,3,2021-12-13T11:44:52.797,7,False,1.0
2021,14,3260,175,15,2757,2,30,3,-6,5,11,3,2,3,0,False,False,False,0,4,2021-12-13T11:47:39.513,5,False,2.0
2021,14,3260,180,15,914,13,24,6,35,0,0,0,0,0,0,False,False,False,0,2,2021-12-17T19:04:04.27,0,False,
2021,14,3260,185,15,957,2,4,9,4,7,3,6,1,6,0,False,False,False,0,3,2021-12-13T11:58:39.62,7,False,1.0
2021,14,3260,210,31,661,2,5,3,11,12,1,12,0,12,0,False,False,False,0,3,2021-12-13T12:09:20.99,12,False,0.0
2021,14,3260,235,31,6724,2,39,4,4,5,1,4,1,4,0,False,False,False,0,4,2021-12-13T12:16:48.073,5,False,1.0
2021,14,3260,240,31,4844,2,18,5,-2,4,6,3,1,3,0,False,False,False,0,2,2021-12-14T18:19:28.927,4,False,1.0
2021,14,3260,250,31,6724,2,46,3,3,8,5,6,2,6,0,True,False,False,0,3,2021-12-14T18:20:28.557,8,False,2.0
2021,14,3260,265,31,661,13,13,4,3,0,0,0,0,0,0,False,False,False,0,3,2021-12-13T12:29:27.723,0,False,0.0
2021,14,3260,290,15,957,2,49,9,-3,3,6,1,2,1,0,False,False,False,0,2,2021-12-13T12:37:04.353,3,False,2.0
2021,14,3260,295,15,7591,2,5,10,11,12,1,11,1,11,0,False,False,False,0,3,2021-12-15T18:53:35.097,12,False,1.0
2021,14,3260,305,15,914,13,2,10,9,0,0,0,0,0,0,False,False,False,0,2,2022-02-16T17:41:00.667,0,False,0.0
2021,14,3260,310,15,914,2,5,5,3,3,0,3,0,3,0,False,False,False,0,3,2021-12-15T17:52:41.217,3,False,0.0
2021,14,3260,330,31,6724,2,39,4,4,11,7,6,5,6,0,True,False,False,0,3,2021-12-13T12:48:59.197,11,False,5.0
2021,14,3260,335,31,4545,13,28,4,3,0,0,0,0,0,0,False,False,False,0,1,2021-12-15T17:52:55.777,0,False,0.0
2021,14,3260,340,31,3911,2,4,3,7,7,0,7,0,7,0,False,False,False,0,3,2021-12-13T15:49:06.49,7,False,
2021,14,3260,345,31,6724,3,39,4,4,0,0,0,0,0,0,False,False,False,0,3,2021-12-13T12:54:22.367,0,False,0.0
2021,14,3260,365,15,914,2,19,3,11,31,20,31,0,31,0,False,False,False,0,2,2021-12-15T18:53:35.097,31,False,0.0
2021,14,3260,380,15,2757,2,51,10,-1,7,8,5,2,5,0,True,False,False,0,4,2021-12-13T13:06:26.283,7,False,2.0
2021,14,3260,390,15,914,2,5,3,13,14,1,14,0,14,0,False,False,False,0,3,2021-12-15T17:53:05.883,14,False,0.0
2021,14,3260,395,15,2757,13,11,2,19,0,0,0,0,0,0,True,False,False,0,4,2021-12-15T00:19:34.21,0,False,0.0
2021,14,3260,400,15,7591,3,52,10,12,0,0,0,0,0,0,True,False,False,0,3,2021-12-15T18:53:35.113,0,False,0.0
2021,14,3260,415,31,661,2,6,9,2,4,2,4,0,4,0,False,False,False,0,2,2021-12-15T18:27:05.39,4,False,0.0
2021,14,3260,430,15,4179,2,4,5,6,6,0,6,0,6,0,False,False,False,0,2,2022-02-14T22:36:39.567,6,False,0.0
2021,14,3260,435,15,7591,2,5,3,5,5,0,5,0,5,0,False,False,False,0,3,2021-12-13T13:29:00.493,5,False,0.0
2021,14,3260,440,15,914,2,5,3,4,5,1,5,0,5,0,False,False,False,0,3,2021-12-15T17:53:29.993,5,False,0.0
2021,14,3260,450,15,957,13,9,6,25,0,0,0,0,0,0,False,False,False,0,3,2021-12-15T18:37:21.527,0,False,0.0
2021,14,3260,470,31,6724,2,5,5,9,10,1,9,1,9,0,True,False,False,0,3,2021-12-14T18:20:42.223,10,False,1.0
2021,14,3260,480,31,2865,2,53,9,-5,24,29,4,20,4,0,False,False,False,0,4,2021-12-15T18:23:43.43,24,False,20.0
2021,14,3260,485,31,8333,2,34,4,-4,9,13,5,4,5,0,True,False,False,0,3,2021-12-13T13:47:58.773,9,False,4.0
2021,14,3260,490,31,2865,3,35,9,11,0,0,0,0,0,0,False,False,False,0,4,2021-12-13T13:51:09.47,0,False,0.0
2021,14,3260,500,31,2901,13,12,5,9,0,0,0,0,0,0,False,False,False,0,4,2022-02-16T17:42:22.05,0,False,0.0
2021,14,3260,525,15,4179,2,4,5,8,9,1,9,0,9,0,False,False,False,0,2,2021-12-13T13:59:38.363,9,False,0.0
2021,14,3260,530,15,914,2,4,3,8,9,1,9,0,9,0,False,False,False,0,2,2021-12-17T19:01:45.363,9,False,0.0
2021,14,3260,535,15,2757,13,4,4,9,0,0,0,0,0,0,False,False,False,0,3,2021-12-13T14:04:28.193,0,False,0.0
2021,14,3260,540,15,914,2,29,6,30,31,1,30,1,30,0,False,False,False,0,2,2022-02-22T19:23:23.987,31,False,
2021,14,3260,545,15,4179,2,19,2,37,41,4,38,3,38,0,False,False,False,0,2,2021-12-13T14:10:12.547,41,False,3.0
2021,14,3260,550,15,8099,2,28,4,-2,3,5,0,3,0,0,False,False,False,0,1,2021-12-15T18:21:05.677,3,False,
2021,14,3260,555,15,957,13,2,4,5,0,0,0,0,0,0,False,False,False,0,3,2022-02-22T19:22:04.687,0,False,0.0
2021,14,3260,560,31,2901,2,47,5,4,5,1,5,0,5,0,True,False,False,0,4,2021-12-14T18:20:55.467,5,False,0.0
2021,14,3260,580,31,3911,2,39,9,6,13,7,13,0,13,0,False,False,False,0,3,2021-12-15T18:39:46.343,13,False,0.0
2021,14,3260,595,15,2757,2,53,10,-4,6,10,3,3,3,0,False,False,False,0,4,2021-12-13T14:26:47.96,6,False,3.0
2021,14,3260,610,15,3823,13,12,6,51,0,0,0,0,0,0,False,False,False,0,3,2021-12-15T18:22:28.567,0,False,0.0
2021,14,3260,625,31,8333,13,9,2,20,0,0,0,0,0,0,False,False,False,0,2,2021-12-13T14:34:53.15,0,False,0.0
2021,14,3260,635,15,7591,13,5,10,11,0,0,0,0,0,0,False,False,False,0,3,2021-12-15T17:32:11.003,0,False,0.0
2021,14,3260,640,15,4179,13,4,3,7,0,0,0,0,0,0,False,False,False,0,2,2021-12-13T14:39:26.853,0,False,0.0
2021,14,3260,650,15,4179,2,4,10,12,12,0,12,0,12,0,False,False,False,0,3,2021-12-15T18:42:52.347,12,False,0.0
2021,14,3260,655,15,153,13,28,4,3,0,0,0,0,0,0,False,False,False,0,1,2021-12-15T18:21:48.743,0,False,0.0
2021,14,3260,660,15,153,2,28,4,3,6,3,4,2,4,0,False,False,False,0,1,2021-12-13T14:46:44.987,6,False,2.0
2021,14,3260,675,31,7913,2,47,5,2,7,5,6,1,6,0,True,False,False,0,3,2021-12-13T14:51:59.683,7,False,1.0
2021,14,3260,690,31,2901,13,11,6,16,0,0,0,0,0,0,False,False,False,0,3,2021-12-13T14:56:08.977,0,False,0.0
2021,14,3260,695,31,6722,3,48,10,-4,0,0,0,0,0,0,False,False,False,0,1,2021-12-13T14:57:41.477,0,False,0.0
2021,14,3260,710,15,2757,2,46,3,2,3,1,3,0,3,0,False,False,False,0,4,2021-12-13T15:03:11.33,3,False,0.0
2021,14,3260,715,15,4179,13,6,1,19,0,0,0,0,0,0,False,False,False,0,2,2021-12-15T18:44:29.667,0,False,0.0
2021,14,3260,735,31,2865,2,47,10,3,12,9,11,1,11,0,True,False,False,0,1,2021-12-14T18:21:09.68,12,False,1.0
2021,14,3260,765,15,7591,13,5,3,8,0,0,0,0,0,0,False,False,False,0,3,2021-12-15T18:45:18.01,0,False,0.0
2021,14,3260,770,15,4886,2,28,4,1,2,1,2,0,2,0,False,False,False,0,1,2021-12-13T15:21:36.68,2,False,0.0
2021,14,3260,780,15,4886,13,48,10,-1,0,0,0,0,0,0,False,False,False,0,1,2022-02-16T17:42:52.193,0,False,0.0
2021,14,3260,785,15,4886,2,44,9,-5,3,8,1,2,1,0,False,False,False,0,1,2021-12-13T15:25:57.387,3,False,2.0
2021,14,3261,15,13,876,2,49,10,-3,7,10,4,3,4,0,False,False,False,1,3,2021-12-13T10:13:42.113,7,False,3.0
2021,14,3261,20,13,6893,2,13,10,4,17,13,12,5,12,0,False,False,False,0,3,2021-12-15T21:21:51.147,17,False,5.0
2021,14,3261,30,13,2407,2,30,10,-4,13,17,4,9,4,0,False,False,False,1,3,2021-12-13T10:23:56.967,13,False,9.0
2021,14,3261,35,13,8417,2,6,8,18,30,12,27,3,27,0,False,False,False,1,2,2021-12-13T10:26:58.177,30,False,3.0
2021,14,3261,45,13,8418,2,12,5,5,5,0,5,0,5,6,False,False,False,0,4,2022-02-24T18:26:24.553,5,True,0.0
2021,14,3261,75,27,3656,2,46,3,1,1,0,1,0,1,0,False,False,False,0,1,2021-12-13T10:45:01.2,1,False,0.0
2021,14,3261,80,27,650,2,12,2,26,29,3,27,2,27,0,False,False,False,0,2,2022-02-24T18:26:37.297,29,False,2.0
2021,14,3261,85,27,650,2,4,5,5,5,0,5,0,5,0,False,False,False,0,2,2021-12-18T16:40:28.34,5,False,0.0
2021,14,3261,115,13,8418,2,5,9,5,10,5,8,2,8,0,False,False,False,0,4,2021-12-13T11:03:45.127,10,False,2.0
2021,14,3261,125,13,8417,2,12,5,7,7,0,7,0,7,0,False,False,False,0,2,2022-02-24T18:27:15.95,7,False,0.0
2021,14,3261,130,13,8418,2,47,5,-2,0,2,0,0,0,0,False,False,False,0,4,2021-12-13T11:09:53.303,0,False,0.0
2021,14,3261,145,27,6397,13,4,10,5,0,0,0,0,0,0,False,False,False,0,3,2021-12-13T11:16:24.963,0,False,0.0
2021,14,3261,150,27,7408,2,26,3,7,8,1,8,0,8,0,False,False,False,0,2,2021-12-13T11:18:58.6,8,False,0.0
2021,14,3261,155,27,650,2,21,6,21,24,3,24,0,24,0,False,False,False,0,3,2021-12-18T16:59:46.913,24,True,0.0
2021,14,3261,165,27,6397,2,35,9,11,25,14,16,9,16,0,False,False,False,0,4,2021-12-13T11:27:39.843,25,False,9.0
2021,14,3261,210,13,876,2,4,4,11,15,4,14,1,14,0,False,False,False,1,3,2021-12-15T21:21:51.147,15,False,1.0
2021,14,3261,220,13,876,2,51,10,-4,8,12,4,4,4,0,False,False,False,0,3,2021-12-13T12:00:42.907,8,False,4.0
2021,14,3261,235,13,1510,2,4,10,6,11,5,8,3,8,0,False,False,False,0,3,2021-12-13T12:07:55.48,11,False,3.0
2021,14,3261,240,13,876,2,29,6,15,15,0,15,0,15,0,False,False,False,0,2,2021-12-13T12:10:32.553,15,True,
2021,14,3261,245,13,8417,2,2,9,9,12,3,10,2,10,0,False,False,False,0,2,2021-12-13T12:14:47.77,12,False,2.0
2021,14,3261,255,13,4498,2,30,10,-1,6,7,5,1,5,0,False,False,False,0,1,2022-02-16T17:04:04.957,6,False,1.0
2021,14,3261,260,13,876,2,2,9,4,9,5,7,2,7,0,False,False,False,0,2,2021-12-13T12:25:26.267,9,False,2.0
2021,14,3261,270,13,8417,13,35,9,5,0,0,0,0,0,0,False,False,False,0,2,2022-02-16T17:04:17.483,0,False,0.0
2021,14,3261,280,13,8417,13,29,3,3,0,0,0,0,0,0,False,False,False,0,2,2021-12-13T12:38:56.097,0,False,0.0
2021,14,3261,300,27,7408,13,19,6,32,0,0,0,0,0,0,False,False,False,0,2,2021-12-18T17:54:42.25,0,False,
2021,14,3261,325,27,7496,2,13,10,7,16,9,16,0,16,0,False,False,False,0,3,2021-12-13T13:13:53.42,16,False,0.0
2021,14,3261,335,27,650,13,7,2,29,0,0,0,0,0,0,False,False,False,0,3,2021-12-13T13:17:24.557,0,False,0.0
2021,14,3261,340,27,650,13,11,6,22,0,0,0,0,0,0,False,False,False,0,3,2021-12-13T13:20:34.03,0,False,0.0
2021,14,3261,380,27,650,2,23,8,54,55,1,55,0,55,6,False,False,False,0,2,2021-12-15T21:21:51.147,55,True,0.0
2021,14,3261,395,13,8418,13,4,5,8,0,0,0,0,0,0,False,False,False,0,4,2021-12-13T13:36:31.747,0,False,0.0
2021,14,3261,400,13,876,2,35,10,14,18,4,18,0,18,0,False,False,False,0,3,2021-12-13T13:38:23.983,18,False,0.0
2021,14,3261,410,13,8418,13,32,9,1,0,0,0,0,0,0,False,False,False,0,4,2021-12-13T13:41:48.473,0,False,0.0
2021,14,3261,420,13,1510,2,2,9,7,7,0,7,0,7,0,False,False,False,0,2,2021-12-15T21:11:13.213,7,False,0.0
2021,14,3261,455,27,650,13,35,6,29,0,0,0,0,0,0,False,False,False,0,3,2021-12-19T15:44:03.723,0,False,0.0
2021,14,3261,460,27,7852,3,4,10,5,0,0,0,0,0,0,False,False,False,0,3,2021-12-13T14:00:47.823,0,False,0.0
2021,14,3261,465,27,7408,13,3,5,10,0,0,0,0,0,0,False,False,False,0,2,2021-12-15T21:21:51.147,0,False,0.0
2021,14,3261,485,13,6282,2,48,9,-4,11,15,8,3,8,0,False,False,False,0,1,2022-02-16T17:05:06.49,11,False,3.0
2021,14,3261,500,13,1510,2,53,9,-6,-2,4,-4,2,-4,0,True,False,False,0,4,2021-12-15T21:21:51.147,-2,False,2.0
2021,14,3261,510,27,7408,2,50,9,-2,7,9,4,3,4,0,False,False,False,0,2,2021-12-13T14:35:25.05,7,False,3.0
2021,14,3261,520,27,6397,2,12,5,10,13,3,11,2,11,0,False,False,False,0,4,2022-02-24T18:27:56.58,13,False,2.0
2021,14,3261,530,27,7408,2,2,10,6,22,16,8,14,8,0,False,False,False,1,2,2021-12-13T14:44:16.66,22,False,14.0
2021,14,3261,545,27,7408,2,35,2,23,23,0,23,0,23,6,False,False,False,0,3,2021-12-13T14:48:16.167,23,True,
2021,14,3261,550,27,7408,13,17,2,33,0,0,0,0,0,0,False,False,False,0,3,2021-12-13T14:51:09.44,0,False,0.0
2021,14,3261,570,13,8417,13,5,6,16,0,0,0,0,0,0,False,False,False,0,3,2021-12-13T15:01:05.23,0,False,0.0
2021,14,3261,575,13,876,2,51,10,-3,19,22,15,4,15,0,False,False,False,1,3,2021-12-15T21:03:52.297,19,False,4.0
2021,14,3261,580,13,1510,2,48,10,-6,10,16,8,2,8,0,False,False,False,0,1,2021-12-14T20:06:51.927,10,False,2.0
2021,14,3261,585,13,8417,13,9,3,12,0,0,0,0,0,0,False,False,False,0,2,2022-02-16T17:05:43.27,0,False,0.0
2021,14,3261,590,13,6282,13,46,9,0,0,0,0,0,0,0,False,False,False,0,1,2021-12-13T15:09:57.257,0,False,0.0
2021,14,3261,605,13,1116,13,26,9,5,0,0,0,0,0,0,False,False,False,0,3,2021-12-13T15:16:13.733,0,False,0.0
2021,14,3261,610,13,876,13,9,5,10,0,0,0,0,0,0,False,False,False,0,2,2021-12-13T15:17:56.11,0,False,0.0
2021,14,3261,630,27,8472,13,30,10,-2,0,0,0,0,0,0,False,False,False,0,3,2022-02-16T17:06:04.04,0,False,0.0
2021,14,3261,635,27,7408,13,12,6,18,0,0,0,0,0,0,False,False,False,0,2,2022-02-24T18:28:36.937,0,False,0.0
2021,14,3261,665,13,2407,2,50,10,-2,7,9,3,4,3,0,False,False,False,0,3,2021-12-13T15:49:28.037,7,False,4.0
2021,14,3261,680,13,8418,2,12,3,5,11,6,10,1,10,0,False,False,False,0,2,2021-12-15T21:02:07.463,11,False,1.0
2021,14,3261,700,27,4850,2,4,9,10,14,4,14,0,14,0,False,False,False,0,3,2021-12-19T16:44:23.443,14,False,0.0
2021,14,3261,705,27,650,13,4,5,8,0,0,0,0,0,0,False,False,False,0,2,2021-12-13T16:02:14.483,0,False,0.0
2021,14,3261,710,27,5226,2,46,3,0,1,1,1,0,1,0,False,False,False,0,1,2021-12-19T16:46:20.643,1,False,0.0
2021,14,3261,715,27,650,2,35,6,29,29,0,29,0,29,0,False,False,False,0,3,2021-12-13T16:08:02.943,29,True,0.0
2021,14,3261,720,27,7408,2,4,3,4,6,2,5,1,5,0,False,False,False,0,2,2021-12-13T16:09:41.697,6,False,1.0
2021,14,3261,725,27,7408,13,21,3,12,0,0,0,0,0,0,False,False,False,0,2,2021-12-13T16:12:20.627,0,False,
2021,14,3261,730,27,7408,13,2,9,5,0,0,0,0,0,0,False,False,False,0,2,2021-12-19T16:49:43.697,0,False,0.0
2021,14,3261,740,27,4850,2,30,9,0,1,1,1,0,1,6,False,False,False,0,4,2021-12-14T23:52:23.667,1,False,0.0
2021,14,3261,755,13,1116,2,4,9,5,9,4,7,2,7,0,False,False,False,0,3,2021-12-13T16:26:58.037,9,False,2.0
2021,14,3261,760,13,876,13,4,9,9,0,0,0,0,0,0,False,False,False,0,2,2021-12-13T16:28:54.01,0,False,
2021,14,3261,770,13,6282,13,5,3,4,0,0,0,0,0,0,False,False,False,0,3,2021-12-13T16:34:51.367,0,False,0.0
2021,14,3261,775,13,876,13,5,5,4,0,0,0,0,0,0,False,False,False,0,2,2022-02-16T17:07:31.943,0,False,0.0
2021,14,3261,780,13,8418,13,6,1,17,0,0,0,0,0,0,True,False,False,0,3,2021-12-15T21:15:14.953,0,False,0.0
2021,14,3261,805,13,6282,2,4,10,0,11,11,10,1,10,0,False,False,False,0,1,2021-12-13T16:46:21.663,11,False,1.0
2021,14,3261,810,13,6282,2,4,9,1,12,11,10,2,10,0,False,False,False,0,1,2021-12-13T16:47:39.887,12,False,2.0
2021,14,3261,815,13,8417,13,13,10,0,0,0,0,0,0,0,False,False,False,0,3,2021-12-13T16:49:10.003,0,False,0.0
2021,14,3261,825,13,1116,13,7,2,43,0,0,0,0,0,0,False,False,False,0,3,2021-12-13T16:55:11.397,0,False,0.0
2021,14,3261,830,13,876,13,12,7,34,0,0,0,0,0,0,False,False,False,0,3,2022-02-22T19:05:42.14,0,False,0.0
2021,14,3261,840,27,2335,2,30,5,1,4,3,2,2,2,0,False,False,False,0,1,2021-12-13T17:01:29.27,4,False,2.0
2021,14,3261,900,13,6282,2,46,3,-1,4,5,4,0,4,0,False,False,False,0,1,2021-12-13T17:31:21.86,4,False,0.0
2021,14,3261,905,13,876,2,50,10,-3,17,20,14,3,14,0,False,False,False,0,3,2021-12-13T17:32:43.333,17,False,3.0
2021,14,3261,910,13,6282,2,31,9,0,6,6,4,2,4,0,False,False,False,0,1,2021-12-13T17:33:51.36,6,False,2.0
2021,14,3261,915,13,8417,2,7,6,16,18,2,16,2,16,0,False,False,False,0,2,2021-12-13T17:35:20.077,18,False,2.0
2021,14,3261,925,13,6282,2,31,9,2,7,5,7,0,7,0,False,False,False,0,1,2021-12-13T17:39:26.47,7,False,0.0
2021,14,3261,930,13,8417,2,13,4,2,2,0,2,0,2,0,False,False,False,0,3,2021-12-13T17:40:36.597,2,False,0.0
2021,14,3261,935,13,6528,2,5,10,5,6,1,6,0,6,0,False,False,False,1,4,2021-12-13T17:42:02.6,6,False,0.0
2021,14,3261,940,13,876,2,13,9,4,8,4,8,0,8,0,False,False,False,0,3,2021-12-13T17:43:20.68,8,True,0.0
2021,14,3262,30,23,967,13,19,6,28,0,0,0,0,0,0,False,False,False,0,2,2021-12-13T10:58:48.603,0,False,0.0
2021,14,3262,35,23,7250,2,4,9,4,7,3,7,0,7,0,True,False,False,0,3,2021-12-15T16:09:46.083,7,False,0.0
2021,14,3262,45,23,7241,3,48,9,-4,0,0,0,0,0,0,False,False,False,0,1,2021-12-13T11:08:48.317,0,False,0.0
2021,14,3262,50,23,7250,2,4,10,4,8,4,7,1,7,0,True,False,False,0,3,2021-12-13T11:11:32.357,8,False,1.0
2021,14,3262,70,16,374,13,12,10,9,0,0,0,0,0,0,False,False,False,0,3,2022-02-24T18:31:05.173,0,False,0.0
2021,14,3262,90,23,7250,2,4,9,5,9,4,7,2,7,0,True,False,False,0,3,2021-12-13T11:31:05.01,9,False,2.0
2021,14,3262,100,23,7250,2,4,8,15,16,1,15,1,15,0,False,False,False,0,3,2021-12-13T11:35:15.347,16,False,1.0
2021,14,3262,125,16,7681,2,32,3,-3,6,9,5,1,5,0,False,False,False,0,1,2021-12-15T16:10:11.58,6,False,1.0
2021,14,3262,130,16,7176,2,21,6,33,44,11,38,6,38,0,False,False,False,0,2,2021-12-13T11:45:49.42,44,False,6.0
2021,14,3262,145,16,374,13,19,6,28,0,0,0,0,0,0,False,False,False,0,3,2021-12-15T16:50:21.33,0,False,
2021,14,3262,150,16,6499,2,11,3,0,23,23,21,2,21,6,False,False,False,1,1,2021-12-15T16:12:38.933,23,False,2.0
2021,14,3262,165,23,7241,2,6,10,3,14,11,13,1,13,0,False,False,False,0,1,2021-12-13T11:56:54.783,14,False,1.0
2021,14,3262,175,23,4949,2,13,10,2,2,0,2,0,2,0,False,False,False,0,3,2021-12-13T12:20:00.863,2,False,0.0
2021,14,3262,180,23,4949,13,13,9,4,0,0,0,0,0,0,False,False,False,0,3,2021-12-13T12:23:04.66,0,False,0.0
2021,14,3262,190,16,7176,2,51,10,-2,7,9,5,2,5,0,True,False,False,0,3,2021-12-13T12:25:29.473,7,False,
2021,14,3262,200,16,3938,2,13,4,4,10,6,1,9,1,0,False,False,False,1,3,2021-12-13T12:30:42.69,10,False,9.0
2021,14,3262,210,16,3938,2,4,7,18,19,1,19,0,19,0,False,False,False,0,3,2021-12-13T12:33:16.09,19,False,0.0
2021,14,3262,215,16,374,2,4,9,7,19,12,17,2,17,0,False,False,False,0,3,2021-12-13T12:47:39.31,19,False,2.0
2021,14,3262,225,16,6500,2,12,10,11,28,17,25,3,25,0,False,False,False,0,4,2021-12-15T16:23:38.063,28,False,3.0
2021,14,3262,245,23,7250,2,44,3,1,7,6,7,0,7,0,True,False,False,0,3,2021-12-13T13:02:16.387,7,False,0.0
2021,14,3262,250,23,7246,13,6,7,15,0,0,0,0,0,0,False,False,False,0,3,2021-12-15T16:12:14.053,0,False,0.0
2021,14,3262,260,16,374,2,5,10,6,7,1,7,0,7,0,True,False,False,0,3,2021-12-13T13:08:43.467,7,False,0.0
2021,14,3262,270,16,3938,2,4,3,2,9,7,7,2,7,0,True,False,False,0,2,2021-12-13T13:12:07.747,9,False,2.0
2021,14,3262,290,16,6499,2,55,10,-1,3,4,3,0,3,0,False,False,False,1,1,2021-12-13T13:21:01.177,3,False,0.0
2021,14,3262,295,16,1989,2,50,10,-1,1,2,1,0,1,6,True,False,False,0,2,2021-12-13T13:22:51.153,1,True,0.0
2021,14,3262,320,23,7250,2,6,8,16,19,3,19,0,19,0,False,True,True,0,3,2021-12-13T13:33:33.123,19,False,0.0
2021,14,3262,330,16,7417,2,47,10,-2,7,9,6,1,6,0,False,False,False,0,1,2021-12-13T13:37:37.81,7,False,1.0
2021,14,3262,340,16,3938,2,26,5,3,6,3,4,2,4,0,False,False,False,0,3,2021-12-13T13:39:31.99,6,False,
2021,14,3262,345,16,3938,13,7,2,40,0,0,0,0,0,0,False,False,False,0,3,2021-12-15T16:51:16.527,0,False,
2021,14,3262,355,16,374,13,12,9,12,0,0,0,0,0,0,False,False,False,0,3,2021-12-15T16:10:45.54,0,False,
2021,14,3262,405,23,7246,3,38,3,2,0,0,0,0,0,0,False,False,False,0,4,2021-12-13T14:09:43.093,0,False,0.0
2021,14,3262,410,23,7250,2,4,3,4,7,3,7,0,7,0,False,False,False,0,3,2021-12-13T14:10:51.97,7,False,0.0
2021,14,3262,415,23,7246,2,46,3,0,2,2,2,0,2,0,False,False,False,0,4,2021-12-13T14:11:58.52,2,False,0.0
2021,14,3262,435,23,7241,2,5,3,2,5,3,5,0,5,0,False,False,False,0,1,2021-12-13T14:24:17.517,5,True,0.0
2021,14,3262,440,23,7246,2,47,5,0,7,7,2,5,2,0,False,False,False,1,4,2021-12-15T16:47:25.517,7,False,5.0
2021,14,3262,450,23,7241,2,45,5,0,13,13,9,4,9,0,False,False,False,1,1,2021-12-15T16:11:06.737,13,False,4.0
2021,14,3262,460,23,4949,13,9,2,22,0,0,0,0,0,0,False,False,False,0,2,2021-12-13T14:42:03.51,0,False,0.0
2021,14,3262,465,23,7241,2,44,9,-3,10,13,7,3,7,0,False,False,False,0,1,2021-12-13T14:45:27.357,10,False,3.0
2021,14,3262,470,23,7250,2,5,3,3,6,3,6,0,6,0,False,False,False,0,3,2021-12-13T14:47:11.943,6,False,0.0
2021,14,3262,475,23,7250,13,29,3,7,0,0,0,0,0,0,False,False,False,0,2,2021-12-15T16:11:19.797,0,False,0.0
2021,14,3262,505,16,3938,2,12,2,38,38,0,38,0,38,0,False,False,False,0,3,2021-12-15T16:47:56.463,38,False,0.0
2021,14,3262,515,16,7176,2,51,10,-3,3,6,2,1,2,0,False,False,False,0,4,2021-12-15T16:14:42.777,3,False,
2021,14,3262,525,16,7176,2,12,5,11,15,4,15,0,15,0,False,False,False,0,3,2022-02-24T18:32:03.163,15,True,0.0
2021,14,3262,530,16,6499,2,32,9,-1,5,6,2,3,2,0,False,False,False,0,1,2022-02-16T17:11:36.82,5,False,3.0
2021,14,3262,535,16,3938,2,11,3,14,19,5,19,0,19,0,True,False,False,0,3,2021-12-13T15:23:20.39,19,False,
2021,14,3262,545,16,7681,2,48,3,-4,-3,1,-4,1,-4,0,True,False,False,0,1,2021-12-13T15:26:45.62,-3,False,1.0
2021,14,3262,560,23,7241,2,44,9,-6,4,10,1,3,1,0,False,False,False,0,1,2021-12-15T16:48:07.963,4,False,3.0
2021,14,3262,565,23,7250,2,51,10,-3,6,9,4,2,4,0,False,False,False,0,3,2021-12-13T15:30:46.83,6,False,2.0
2021,14,3262,570,23,7246,2,32,3,1,4,3,2,2,2,0,False,False,False,0,4,2021-12-15T16:19:08.587,4,False,2.0
2021,14,3262,575,23,967,2,17,9,14,19,5,19,0,19,0,False,False,False,0,3,2021-12-13T15:50:53.863,19,False,0.0
2021,14,3262,585,23,7689,13,43,6,21,0,0,0,0,0,0,False,False,False,0,3,2021-12-13T16:09:01.283,0,False,0.0
2021,14,3262,590,23,7250,2,12,9,3,19,16,17,2,17,0,False,False,False,0,4,2021-12-13T16:11:00.107,19,False,2.0
2021,14,3262,595,23,7246,13,7,5,14,0,0,0,0,0,0,False,False,False,0,3,2021-12-13T16:18:21.33,0,False,0.0
2021,14,3262,600,23,7250,2,45,5,-4,6,10,5,1,5,0,False,False,False,0,3,2021-12-13T16:21:01.12,6,False,1.0
2021,14,3262,605,23,7250,13,3,5,8,0,0,0,0,0,0,False,False,False,0,3,2021-12-13T16:23:20.273,0,False,
2021,14,3262,610,23,7250,2,26,5,2,4,2,4,0,4,6,False,False,False,0,2,2021-12-13T16:25:27.827,4,False,0.0
2021,14,3262,625,16,7681,2,45,5,-5,2,7,2,0,2,0,False,False,False,0,1,2021-12-13T16:28:24.377,2,False,0.0
2021,14,3262,635,16,3938,13,12,2,53,0,0,0,0,0,0,False,False,False,0,2,2021-12-13T16:41:58.207,0,False,
2021,14,3262,640,16,1989,2,5,5,6,8,2,7,1,7,0,False,False,False,0,3,2021-12-13T16:44:45.447,8,False,1.0
2021,14,3262,665,16,7417,2,48,10,-4,16,20,14,2,14,0,False,False,False,0,1,2021-12-13T16:51:05.11,16,False,2.0
2021,14,3262,670,16,1989,13,5,5,6,0,0,0,0,0,0,False,False,False,0,3,2021-12-13T16:52:38.153,0,False,0.0
2021,14,3262,680,16,1989,13,19,6,31,0,0,0,0,0,0,False,False,False,0,2,2021-12-13T16:57:10.383,0,False,
2021,14,3262,685,16,374,2,55,4,-2,1,3,0,1,0,0,False,False,False,0,4,2022-02-14T22:38:52.717,1,False,1.0
2021,14,3262,715,23,3708,2,4,5,-2,11,13,0,11,0,0,False,False,False,1,2,2021-12-15T17:02:34.173,11,False,11.0
2021,14,3262,725,23,4949,2,5,5,4,4,0,4,0,4,0,False,False,False,0,3,2021-12-15T16:48:20.65,4,False,0.0
2021,14,3262,730,23,3708,3,28,4,1,0,0,0,0,0,0,False,False,False,0,1,2021-12-13T17:19:37.21,0,False,0.0
2021,14,3262,735,23,3708,2,48,9,-2,2,4,1,1,1,0,False,False,False,0,1,2021-12-13T17:22:03.06,2,False,1.0
2021,14,3262,760,23,7250,2,50,3,-4,3,7,1,2,1,0,False,False,False,0,2,2021-12-13T17:30:36.193,3,False,2.0
2021,14,3262,775,23,4949,2,39,10,5,5,0,5,0,5,0,False,False,False,0,3,2021-12-15T16:25:34.253,5,False,0.0
2021,14,3262,780,23,4949,2,4,9,4,9,5,6,3,6,0,False,False,False,0,3,2021-12-13T17:36:21.213,9,False,3.0
2021,14,3262,785,23,7689,2,4,3,5,6,1,5,1,5,0,False,False,False,0,2,2021-12-13T17:37:19.427,6,False,1.0
2021,14,3262,790,23,8743,2,32,3,-2,2,4,0,2,0,0,False,False,False,0,3,2021-12-13T18:03:50.067,2,False,2.0
2021,14,3262,795,23,7689,2,12,5,7,18,11,15,3,15,0,False,False,False,0,2,2022-02-24T18:32:19.053,18,False,3.0
2021,14,3262,800,23,8743,2,45,10,-5,4,9,2,2,2,0,False,False,False,1,1,2021-12-13T17:42:41.267,4,False,2.0
2021,14,3262,805,23,4949,2,4,3,-1,5,6,5,0,5,0,False,True,True,0,2,2021-12-15T17:03:33.003,5,False,0.0
2021,14,3263,15,22,6812,3,44,9,-5,0,0,0,0,0,0,False,False,False,0,1,2021-12-13T10:19:38.78,0,False,0.0
2021,14,3263,20,22,6270,13,4,3,9,0,0,0,0,0,0,True,False,False,0,3,2021-12-13T10:26:48.1,0,False,0.0
2021,14,3263,40,20,3848,2,13,10,1,19,18,17,2,17,0,True,False,False,0,4,2021-12-15T23:38:00.987,19,False,2.0
2021,14,3263,70,20,3848,3,53,10,-5,0,0,0,0,0,0,False,False,False,0,4,2021-12-13T10:51:32.267,0,False,0.0
2021,14,3263,85,20,5140,2,5,5,4,4,0,4,0,4,0,False,False,False,0,1,2021-12-13T10:58:46.823,4,False,0.0
2021,14,3263,90,20,5140,2,4,9,2,2,0,2,0,2,0,True,False,False,0,1,2021-12-13T11:00:30.663,2,False,0.0
2021,14,3263,105,22,7610,13,35,5,12,0,0,0,0,0,0,False,False,False,0,3,2021-12-13T11:12:03.447,0,False,0.0
2021,14,3263,110,22,6270,2,51,9,-4,8,12,5,3,5,0,True,False,False,0,3,2021-12-13T11:13:52.8,8,False,3.0
2021,14,3263,115,22,6812,3,16,4,3,0,0,0,0,0,0,True,False,False,0,1,2022-02-16T17:33:34.5,0,False,0.0
2021,14,3263,130,20,5140,2,18,3,-3,4,7,0,4,0,0,False,False,False,0,2,2021-12-13T11:23:55.323,4,False,
2021,14,3263,140,20,8127,2,26,9,5,15,10,7,8,7,0,False,False,False,1,3,2021-12-13T11:29:31.25,15,False,8.0
2021,14,3263,155,20,8131,13,4,10,12,0,0,0,0,0,0,False,False,False,0,2,2021-12-15T23:44:46.347,0,False,0.0
2021,14,3263,175,22,6812,3,5,5,4,0,0,0,0,0,0,True,False,False,0,3,2021-12-14T20:03:41.037,0,False,0.0
2021,14,3263,180,22,6270,2,26,9,3,3,0,3,0,3,0,True,False,False,0,2,2021-12-14T20:03:51.497,3,False,0.0
2021,14,3263,210,20,3848,13,32,5,3,0,0,0,0,0,0,False,False,False,0,4,2021-12-13T12:11:17.333,0,False,0.0
2021,14,3263,230,22,2391,13,12,5,3,0,0,0,0,0,0,False,False,False,0,4,2022-02-24T18:35:19.673,0,False,0.0
2021,14,3263,235,22,3170,13,4,3,4,0,0,0,0,0,0,False,False,False,0,3,2021-12-14T20:05:08.75,0,False,0.0
2021,14,3263,240,22,6270,2,17,10,14,14,0,14,0,14,0,False,False,False,0,3,2021-12-14T20:04:11.157,14,False,0.0
2021,14,3263,255,22,7012,13,2,10,6,0,0,0,0,0,0,True,False,False,0,2,2021-12-13T12:30:59.783,0,False,0.0
2021,14,3263,295,22,4997,13,17,8,20,0,0,0,0,0,0,False,False,False,0,2,2021-12-14T20:04:36.457,0,False,0.0
2021,14,3263,300,22,6270,13,8,7,15,0,0,0,0,0,0,False,False,False,0,3,2021-12-16T18:36:04.133,0,False,0.0
2021,14,3263,310,20,5140,2,30,5,2,13,11,10,3,10,0,False,False,False,0,4,2021-12-13T12:53:44.35,13,False,3.0
2021,14,3263,315,20,6388,2,5,5,5,6,1,6,0,6,0,False,False,False,0,3,2021-12-16T00:02:51.037,6,False,0.0
2021,14,3263,360,22,3170,2,5,3,2,2,0,2,0,2,0,False,False,False,0,3,2021-12-14T18:51:07.35,2,False,0.0
2021,14,3263,375,22,2391,2,33,10,2,22,20,19,3,19,0,False,False,False,0,4,2021-12-16T18:36:04.133,22,False,3.0
2021,14,3263,385,22,6812,2,12,9,12,16,4,14,2,14,0,False,False,False,0,1,2021-12-13T13:43:21.933,16,False,2.0
2021,14,3263,395,22,3170,13,21,2,24,0,0,0,0,0,0,False,False,False,0,3,2021-12-13T13:38:41.317,0,False,
2021,14,3263,400,22,6270,2,4,9,4,9,5,9,0,9,0,False,False,False,0,3,2021-12-13T13:45:48.6,9,False,
2021,14,3263,410,22,3170,2,5,9,9,11,2,11,0,11,0,False,False,False,0,3,2021-12-16T00:03:53.51,11,False,0.0
2021,14,3263,455,22,6270,2,34,10,-4,9,13,9,0,9,0,True,False,False,0,3,2021-12-13T14:33:23.957,9,True,0.0
2021,14,3263,465,22,3170,13,12,5,12,0,0,0,0,0,0,False,False,False,0,3,2022-02-24T18:35:46.247,0,False,0.0
2021,14,3263,470,22,6270,13,51,9,-4,0,0,0,0,0,0,True,False,False,0,3,2021-12-13T14:42:53.467,0,False,0.0
2021,14,3263,480,22,6270,2,34,4,-5,1,6,1,0,1,0,True,False,False,0,3,2021-12-13T14:47:54.647,1,False,0.0
2021,14,3263,505,20,8131,2,4,9,7,8,1,7,1,7,0,False,False,False,1,3,2021-12-16T20:31:46.597,8,False,1.0
2021,14,3263,510,20,6388,2,2,10,6,6,0,6,0,6,0,False,False,False,0,3,2021-12-13T15:06:48.243,6,False,0.0
2021,14,3263,525,20,3848,2,35,9,12,18,6,16,2,16,0,False,False,False,0,4,2021-12-13T15:11:56.13,18,False,2.0
2021,14,3263,535,20,8126,2,48,9,-4,19,23,13,6,13,0,False,False,False,1,1,2021-12-16T20:11:05.163,19,False,6.0
2021,14,3263,545,20,5140,2,5,5,4,6,2,5,1,5,0,False,False,False,0,1,2021-12-15T23:36:19.93,6,False,1.0
2021,14,3263,560,20,5140,13,29,6,15,0,0,0,0,0,0,False,False,False,0,1,2021-12-15T23:33:00.94,0,False,0.0
2021,14,3263,590,22,3170,13,35,8,20,0,0,0,0,0,0,False,False,False,0,3,2021-12-13T15:38:47.72,0,False,0.0
2021,14,3263,620,20,8131,13,4,5,6,0,0,0,0,0,0,False,False,False,0,2,2021-12-13T15:44:20.663,0,False,0.0
2021,14,3263,625,20,6388,2,35,9,8,21,13,19,2,19,0,False,False,False,0,3,2021-12-14T20:49:49.597,21,False,2.0
2021,14,3263,635,20,3848,2,31,9,5,7,2,7,0,7,0,False,False,False,0,4,2021-12-13T15:50:22.087,7,False,0.0
2021,14,3263,640,20,3848,13,13,9,4,0,0,0,0,0,0,False,False,False,0,4,2021-12-16T00:04:34.597,0,False,0.0
2021,14,3263,660,22,4997,13,19,2,30,0,0,0,0,0,0,False,False,False,0,2,2021-12-13T17:38:20.71,0,False,
2021,14,3263,670,22,2391,2,47,5,2,6,4,5,1,5,0,False,False,False,0,4,2021-12-13T16:15:32.9,6,False,1.0
2021,14,3263,680,22,4997,13,35,7,21,0,0,0,0,0,0,False,False,False,0,3,2021-12-13T16:19:39.113,0,False,0.0
2021,14,3263,705,20,8131,2,46,3,1,26,25,6,20,6,0,False,False,False,3,3,2021-12-16T20:52:06.537,26,False,20.0
2021,14,3263,735,22,4997,13,13,10,4,0,0,0,0,0,0,False,False,False,0,2,2022-02-25T15:56:41.783,0,False,0.0
2021,14,3263,740,22,3170,2,13,9,4,6,2,6,0,6,0,False,False,False,0,3,2021-12-16T18:36:04.15,6,False,0.0
2021,14,3263,745,22,4997,2,29,6,23,27,4,27,0,27,0,False,False,False,0,3,2021-12-13T16:44:00.7,27,False,0.0
2021,14,3263,755,22,6812,2,46,3,2,3,1,3,0,3,0,False,False,False,0,1,2021-12-13T16:48:58.69,3,False,0.0
2021,14,3263,760,22,6270,2,2,4,9,17,8,17,0,17,0,False,False,False,0,3,2021-12-16T18:36:04.15,17,False,0.0
2021,14,3263,765,22,6538,13,7,6,18,0,0,0,0,0,0,False,False,False,0,2,2021-12-13T16:52:07.057,0,False,0.0
2021,14,3263,770,22,6270,13,2,4,5,0,0,0,0,0,0,False,False,False,0,3,2021-12-13T16:54:18.98,0,False,0.0
2021,14,3263,775,22,4997,3,26,10,5,0,0,0,0,0,0,False,False,False,0,2,2022-02-16T17:35:36.37,0,False,0.0
2021,14,3263,810,20,7845,2,50,10,-5,5,10,5,0,5,0,False,False,False,0,3,2021-12-13T17:04:47.237,5,False,0.0
2021,14,3263,830,22,7012,13,42,9,5,0,0,0,0,0,0,False,False,False,0,3,2021-12-13T17:13:29.127,0,False,0.0
2021,14,3263,835,22,7012,13,6,3,7,0,0,0,0,0,0,True,False,False,0,2,2021-12-15T23:37:23.417,0,False,0.0
2021,14,3263,840,22,7012,2,4,10,8,8,0,8,0,8,0,False,False,False,0,3,2021-12-13T17:15:37.973,8,False,0.0
2021,14,3263,880,22,7012,2,4,10,6,14,8,11,3,11,0,False,False,False,0,3,2021-12-13T17:23:29.89,14,False,3.0
2021,14,3263,885,22,7012,2,6,10,7,14,7,12,2,12,0,False,False,False,0,2,2021-12-13T17:24:45.47,14,False,2.0
2021,14,3263,890,22,6812,2,5,5,3,8,5,7,1,7,0,False,False,False,0,1,2021-12-13T17:25:57.317,8,False,1.0
2021,14,3263,895,22,6812,2,4,4,4,13,9,4,9,4,0,False,False,False,1,1,2021-12-13T17:28:07.357,13,False,9.0
2021,14,3264,10,2,811,2,50,9,-2,-2,0,-2,0,-2,0,False,False,False,0,2,2021-12-13T09:56:10.157,-2,False,0.0
2021,14,3264,20,2,8389,2,4,10,6,6,0,6,0,6,0,False,False,False,0,2,2021-12-13T09:59:40.683,6,False,0.0
2021,14,3264,30,5,5220,2,5,3,6,7,1,7,0,7,0,False,False,False,0,3,2021-12-13T10:05:03.247,7,False,0.0
2021,14,3264,40,5,5220,2,49,5,-2,11,13,9,2,9,0,False,False,False,0,2,2021-12-13T10:08:16.247,11,False,2.0
2021,14,3264,55,5,6372,2,51,9,-4,15,19,12,3,12,0,False,False,False,0,2,2021-12-13T10:20:05.43,15,False,3.0
2021,14,3264,90,2,6247,2,20,2,32,36,4,36,0,36,0,False,False,False,0,2,2021-12-13T10:27:45.58,36,False,0.0
2021,14,3264,100,2,811,13,4,10,11,0,0,0,0,0,0,False,False,False,0,2,2021-12-13T10:31:32.84,0,False,0.0
2021,14,3264,105,2,6247,2,2,9,7,9,2,9,0,9,0,False,False,False,0,3,2021-12-13T10:33:31.87,9,False,0.0
2021,14,3264,120,2,6247,13,2,9,5,0,0,0,0,0,0,False,False,False,0,2,2021-12-14T22:02:45.283,0,False,0.0
2021,14,3264,125,2,6247,2,2,10,9,13,4,11,2,11,0,False,False,False,0,2,2021-12-14T22:02:55.81,13,False,2.0
2021,14,3264,160,5,5220,13,2,9,4,0,0,0,0,0,0,False,False,False,0,2,2021-12-13T10:58:26.27,0,False,0.0
2021,14,3264,175,2,6247,3,8,9,14,0,0,0,0,0,0,False,False,False,0,3,2021-12-13T11:04:49.72,0,False,0.0
2021,14,3264,210,2,811,2,32,10,2,3,1,2,1,2,0,False,False,False,0,3,2021-12-13T11:12:53.847,3,False,1.0
2021,14,3264,225,5,5220,2,2,10,11,22,11,18,4,18,0,False,False,False,0,2,2021-12-13T11:17:57.993,22,False,4.0
2021,14,3264,230,5,5220,13,49,5,-2,0,0,0,0,0,0,False,False,False,0,2,2021-12-13T11:19:45.867,0,False,
2021,14,3264,235,5,3477,2,6,10,4,10,6,8,2,8,0,False,False,False,0,2,2021-12-13T11:21:26.87,10,False,2.0
2021,14,3264,250,5,5220,13,5,3,13,0,0,0,0,0,0,False,False,False,0,2,2021-12-13T11:25:55.197,0,False,0.0
2021,14,3264,255,5,3477,2,7,2,23,23,0,23,0,23,0,False,False,False,0,3,2021-12-13T11:27:51.51,23,False,0.0
2021,14,3264,270,5,3477,13,2,10,10,0,0,0,0,0,0,False,False,False,0,3,2021-12-13T11:31:57.513,0,False,0.0
2021,14,3264,275,5,566,13,16,4,2,0,0,0,0,0,0,True,False,False,0,1,2021-12-14T18:30:46.783,0,False,0.0
2021,14,3264,295,5,5220,13,17,3,8,0,0,0,0,0,0,False,False,False,0,3,2021-12-13T11:42:14.767,0,False,0.0
2021,14,3264,310,2,8389,13,29,6,25,0,0,0,0,0,0,False,False,False,0,2,2021-12-16T19:48:20.45,0,False,0.0
2021,14,3264,320,2,2554,2,48,9,-3,20,23,13,7,13,0,False,False,False,0,1,2021-12-16T19:48:29.55,20,False,7.0
2021,14,3264,340,2,811,13,20,5,13,0,0,0,0,0,0,False,False,False,0,2,2021-12-13T12:01:10.743,0,False,0.0
2021,14,3264,360,5,3477,2,3,3,9,9,0,9,0,9,0,False,False,False,0,3,2021-12-16T19:59:17.07,9,False,0.0
2021,14,3264,375,5,3477,13,7,6,25,0,0,0,0,0,0,False,False,False,0,3,2021-12-13T12:15:08.083,0,False,0.0
2021,14,3264,385,2,8389,2,47,5,4,4,0,4,0,4,0,False,False,False,0,4,2021-12-13T12:18:00.02,4,False,0.0
2021,14,3264,390,2,2554,2,31,4,4,4,0,4,0,4,0,True,False,False,0,3,2021-12-16T20:00:05.31,4,False,0.0
2021,14,3264,400,2,2554,2,12,4,3,5,2,4,1,4,0,True,False,False,0,3,2022-02-24T18:38:11.53,5,False,1.0
2021,14,3264,415,5,6372,2,13,5,5,8,3,8,0,8,0,False,False,False,0,3,2021-12-13T12:28:16.697,8,False,0.0
2021,14,3264,425,5,8408,2,39,4,6,14,8,9,5,9,0,False,False,False,1,3,2021-12-13T12:31:50.33,14,False,5.0
2021,14,3264,430,5,566,2,28,4,4,6,2,5,1,5,0,False,False,False,0,1,2021-12-13T12:34:13.463,6,False,1.0
2021,14,3264,440,5,6425,13,39,4,5,0,0,0,0,0,0,False,False,False,0,4,2021-12-13T12:38:22.25,0,False,0.0
2021,14,3264,465,2,3506,13,20,2,34,0,0,0,0,0,0,True,False,False,0,2,2021-12-13T12:47:38.347,0,False,0.0
2021,14,3264,470,2,8389,2,6,9,14,14,0,14,0,14,0,False,False,False,0,3,2021-12-13T12:49:37.793,14,False,0.0
2021,14,3264,480,2,1377,2,32,4,2,12,10,9,3,9,0,False,False,False,0,4,2021-12-16T18:44:45.503,12,False,3.0
2021,14,3264,490,2,3506,13,8,6,22,0,0,0,0,0,0,False,False,False,0,3,2022-02-16T16:47:52.147,0,False,
2021,14,3264,510,2,2554,13,12,10,8,0,0,0,0,0,0,True,False,False,0,4,2021-12-17T15:31:43.003,0,False,0.0
2021,14,3264,525,5,566,13,51,9,-5,0,0,0,0,0,0,True,False,False,0,1,2021-12-13T13:18:11.517,0,False,0.0
2021,14,3264,535,5,5220,2,2,4,14,18,4,15,3,15,0,True,False,False,1,2,2021-12-16T19:48:07.777,18,False,3.0
2021,14,3264,540,5,5220,2,5,3,7,7,0,7,0,7,0,False,False,False,0,2,2021-12-13T13:35:40.303,7,True,0.0
2021,14,3264,550,2,811,2,51,3,-5,6,11,1,5,1,0,False,False,False,0,1,2021-12-13T13:31:47.747,6,False,
2021,14,3264,555,2,811,13,4,3,5,0,0,0,0,0,0,False,False,False,0,2,2021-12-13T13:35:23.493,0,False,0.0
2021,14,3264,560,2,3506,2,46,3,1,7,6,7,0,7,0,True,False,False,0,3,2021-12-16T20:04:35.547,7,False,0.0
2021,14,3264,565,2,8389,2,4,9,14,14,0,14,0,14,0,False,False,False,0,3,2021-12-13T13:39:02.597,14,False,0.0
2021,14,3264,605,2,5214,2,32,10,2,3,1,3,0,3,6,False,False,False,0,4,2021-12-13T13:50:46.977,3,True,0.0
2021,14,3264,630,5,8408,2,26,9,4,9,5,5,4,5,0,False,False,False,0,3,2021-12-13T13:57:09.97,9,False,4.0
2021,14,3264,635,5,6372,2,18,3,-2,3,5,0,3,0,0,False,False,False,0,2,2021-12-14T18:29:36.463,3,False,3.0
2021,14,3264,640,5,3477,2,4,10,6,6,0,6,0,6,0,False,False,False,0,3,2021-12-13T14:00:30.917,6,False,0.0
2021,14,3264,645,5,5220,2,2,10,12,19,7,19,0,19,0,False,False,False,0,2,2021-12-13T14:02:45.983,19,False,0.0
2021,14,3264,660,5,6372,13,9,2,24,0,0,0,0,0,0,False,False,False,0,2,2021-12-16T18:44:45.503,0,False,0.0
2021,14,3264,675,2,2554,2,46,9,1,11,10,8,3,8,0,False,False,False,0,1,2021-12-16T18:44:45.503,11,False,3.0
2021,14,3264,685,2,6247,2,50,10,-3,6,9,5,1,5,0,False,False,False,0,3,2021-12-13T14:20:46.987,6,False,1.0
2021,14,3264,690,2,2554,2,31,4,2,2,0,2,0,2,0,True,False,False,0,3,2021-12-13T14:22:59.62,2,False,0.0
2021,14,3264,710,5,566,13,47,5,2,0,0,0,0,0,0,False,False,False,0,1,2021-12-13T14:30:43.567,0,False,
2021,14,3264,715,5,6372,2,17,7,17,19,2,17,2,17,0,False,False,False,0,3,2021-12-13T14:32:47.36,19,False,2.0
2021,14,3264,720,5,3477,13,4,4,10,0,0,0,0,0,0,False,False,False,0,3,2021-12-16T20:04:59.963,0,False,0.0
2021,14,3264,725,5,3477,13,6,7,17,0,0,0,0,0,0,False,False,False,0,2,2021-12-13T14:36:56.27,0,False,0.0
2021,14,3264,730,5,6425,13,4,9,5,0,0,0,0,0,0,False,False,False,0,3,2021-12-13T14:39:30.343,0,False,0.0
2021,14,3264,735,5,5220,13,5,6,17,0,0,0,0,0,0,False,False,False,0,2,2021-12-13T14:41:26.443,0,False,0.0
2021,14,3264,745,5,3477,13,2,10,6,0,0,0,0,0,0,False,False,False,0,2,2021-12-13T14:46:02.857,0,False,0.0
2021,14,3264,750,5,3477,2,5,5,13,13,0,13,0,13,0,False,False,False,0,2,2021-12-13T14:47:44.877,13,True,0.0
2021,14,3264,755,5,3477,2,5,2,18,18,0,18,0,18,0,False,False,False,0,2,2021-12-13T14:49:21.727,18,False,0.0
2021,14,3264,760,5,566,2,28,10,-4,11,15,8,3,8,0,False,False,False,0,1,2021-12-16T19:49:45.647,11,False,3.0
2021,14,3264,770,5,3477,2,9,5,5,5,0,5,0,5,6,False,False,False,0,2,2021-12-13T14:54:03.673,5,True,0.0
2021,14,3264,815,2,8389,2,30,9,0,23,23,20,3,20,0,True,False,False,0,2,2021-12-13T15:05:59.923,23,False,3.0
2021,14,3265,10,8,3883,3,32,3,3,0,0,0,0,0,0,True,False,False,0,4,2021-12-14T22:54:43.853,0,False,0.0
2021,14,3265,15,8,6439,2,53,4,-4,-1,3,-4,3,-4,0,False,False,False,0,4,2021-12-13T10:26:23.73,-1,False,3.0
2021,14,3265,20,8,5053,2,5,3,8,8,0,8,0,8,0,False,False,False,0,1,2021-12-16T18:17:58.657,8,False,0.0
2021,14,3265,30,3,6936,2,4,10,9,11,2,11,0,11,0,False,False,False,0,3,2022-03-11T18:51:13.457,11,False,0.0
2021,14,3265,65,8,232,2,47,5,1,3,2,3,0,3,0,False,False,False,0,3,2021-12-13T11:00:30.903,3,False,0.0
2021,14,3265,70,8,7651,13,5,2,17,0,0,0,0,0,0,False,False,False,0,3,2021-12-16T18:29:11.403,0,False,
2021,14,3265,80,8,3883,2,2,9,7,9,2,7,2,7,0,False,False,False,0,2,2021-12-13T16:22:57.64,9,False,2.0
2021,14,3265,85,8,232,13,43,6,29,0,0,0,0,0,0,True,False,False,0,4,2021-12-17T15:52:12.99,0,False,
2021,14,3265,95,8,6439,2,18,3,0,4,4,2,2,2,0,False,False,False,0,2,2021-12-13T11:16:35.197,4,False,2.0
2021,14,3265,120,3,713,2,28,10,1,2,1,2,0,2,0,False,False,False,0,1,2021-12-13T11:27:58.13,2,False,0.0
2021,14,3265,125,3,6454,2,32,3,-2,-1,1,-2,1,-2,0,False,False,False,0,4,2022-02-16T16:55:04.887,-1,False,1.0
2021,14,3265,155,8,7651,2,17,2,26,34,8,28,6,28,0,False,False,False,0,3,2021-12-13T16:23:11.25,34,False,6.0
2021,14,3265,160,8,3883,2,5,5,4,5,1,4,1,4,0,False,False,False,0,4,2021-12-16T18:21:25.863,5,False,1.0
2021,14,3265,170,8,5053,2,30,10,2,5,3,4,1,4,0,False,False,False,0,1,2021-12-16T15:36:57.78,5,False,1.0
2021,14,3265,180,8,232,2,5,5,3,9,6,6,3,6,6,False,False,False,0,3,2022-02-16T16:55:19.093,9,False,3.0
2021,14,3265,215,3,6454,2,53,5,-3,5,8,5,0,5,0,False,False,False,0,4,2021-12-16T14:56:27.807,5,False,0.0
2021,14,3265,220,3,121,13,21,5,14,0,0,0,0,0,0,False,False,False,0,2,2022-02-25T15:57:33.867,0,False,0.0
2021,14,3265,235,8,232,2,4,5,7,7,0,7,0,7,0,False,False,False,0,2,2021-12-13T11:58:33.573,7,False,0.0
2021,14,3265,250,8,3883,2,5,5,4,6,2,4,2,4,0,False,False,False,0,4,2021-12-13T12:13:24.47,6,False,2.0
2021,14,3265,260,8,7651,2,21,6,25,27,2,27,0,27,0,False,False,False,0,2,2021-12-16T18:22:50.957,27,False,0.0
2021,14,3265,265,8,3883,2,53,3,-1,9,10,6,3,6,0,True,False,False,0,4,2021-12-17T16:04:38.31,9,False,3.0
2021,14,3265,280,8,3883,13,5,3,3,0,0,0,0,0,0,False,False,False,0,3,2021-12-16T18:23:27.487,0,False,
2021,14,3265,285,8,3883,2,32,10,1,1,0,1,0,1,6,False,False,False,0,4,2021-12-13T16:23:59.42,1,True,0.0
2021,14,3265,330,8,7651,2,2,9,8,12,4,10,2,10,0,False,False,False,0,2,2021-12-13T16:24:13.123,12,False,2.0
2021,14,3265,335,8,232,13,5,2,16,0,0,0,0,0,0,True,False,False,0,3,2021-12-16T18:08:21.45,0,False,0.0
2021,14,3265,345,3,7672,2,51,10,-3,3,6,0,3,0,0,True,False,False,0,2,2021-12-16T18:06:14.937,3,False,3.0
2021,14,3265,350,3,6936,2,4,5,5,5,0,5,0,5,0,False,False,False,0,2,2021-12-13T12:49:35.93,5,False,0.0
2021,14,3265,375,8,232,2,4,5,5,5,0,5,0,5,0,False,False,False,0,2,2021-12-13T12:56:50.51,5,False,0.0
2021,14,3265,390,8,7651,13,12,8,15,0,0,0,0,0,0,False,False,False,0,3,2021-12-13T12:59:35.877,0,False,0.0
2021,14,3265,405,3,6454,2,5,5,4,4,0,4,0,4,0,False,False,False,0,3,2021-12-13T16:24:26.303,4,False,0.0
2021,14,3265,410,3,6936,13,4,5,0,0,0,0,0,0,0,False,False,False,0,2,2021-12-13T13:04:57.94,0,False,0.0
2021,14,3265,445,3,6936,2,5,5,9,9,0,9,0,9,0,False,False,False,0,3,2021-12-13T13:10:01.503,9,True,0.0
2021,14,3265,450,3,121,13,19,6,24,0,0,0,0,0,0,False,False,False,0,2,2021-12-13T13:11:02.85,0,False,0.0
2021,14,3265,455,3,713,2,4,10,4,4,0,4,0,4,0,False,False,False,0,1,2021-12-13T16:24:40.103,4,False,0.0
2021,14,3265,465,3,8430,2,4,3,6,20,14,14,6,14,0,False,False,False,1,2,2021-12-16T18:06:59.797,20,False,6.0
2021,14,3265,500,3,6454,2,4,10,6,10,4,7,3,7,0,False,False,False,0,3,2021-12-13T13:24:10.16,10,False,3.0
2021,14,3265,515,3,6454,2,35,9,9,32,23,12,20,12,0,False,False,False,1,3,2021-12-13T13:27:41.113,32,False,20.0
2021,14,3265,520,3,8430,2,4,3,4,4,0,4,0,4,0,False,False,False,0,2,2021-12-13T16:19:17.5,4,False,0.0
2021,14,3265,535,8,6439,13,28,9,3,0,0,0,0,0,0,False,False,False,0,1,2021-12-13T16:26:46.373,0,False,0.0
2021,14,3265,555,8,3883,13,12,3,3,0,0,0,0,0,0,False,False,False,0,4,2022-02-24T18:39:50.593,0,False,0.0
2021,14,3265,560,8,7009,2,48,10,-2,7,9,4,3,4,0,False,False,False,0,1,2021-12-16T18:03:47.877,7,False,3.0
2021,14,3265,570,8,232,13,21,10,0,0,0,0,0,0,0,False,False,False,0,2,2021-12-16T18:04:09.87,0,True,0.0
2021,14,3265,610,3,7672,13,4,9,4,0,0,0,0,0,0,False,False,False,0,3,2021-12-13T14:22:11.713,0,False,0.0
2021,14,3265,615,3,713,3,31,9,-2,0,0,0,0,0,0,False,False,False,0,1,2021-12-16T14:58:50.323,0,False,
2021,14,3265,630,3,6454,13,12,5,11,0,0,0,0,0,0,False,False,False,0,3,2021-12-16T14:59:13.893,0,False,
2021,14,3265,635,3,8430,13,29,5,14,0,0,0,0,0,0,False,False,False,0,2,2021-12-16T14:59:35.643,0,False,
2021,14,3265,650,3,6454,2,51,10,-1,8,9,5,3,5,0,False,False,False,0,3,2021-12-13T14:47:15.267,8,False,3.0
2021,14,3265,670,8,7651,2,2,9,6,13,7,9,4,9,0,False,False,False,0,2,2021-12-13T15:04:24.893,13,False,4.0
2021,14,3265,690,8,232,2,5,6,17,17,0,17,0,17,0,False,False,False,0,3,2021-12-13T15:08:38.18,17,False,0.0
2021,14,3265,715,8,7651,13,9,6,18,0,0,0,0,0,0,False,False,False,0,2,2021-12-13T15:17:30.09,0,False,0.0
2021,14,3265,720,8,232,13,3,5,13,0,0,0,0,0,0,False,False,False,0,2,2021-12-16T15:36:57.78,0,False,0.0
2021,14,3265,740,3,713,2,45,5,-4,-3,1,-3,0,-3,0,False,False,False,0,1,2021-12-13T15:20:46.86,-3,False,0.0
2021,14,3265,745,3,7672,13,12,5,11,0,0,0,0,0,0,False,False,False,0,3,2021-12-16T18:07:33.913,0,False,0.0
2021,14,3265,750,3,6454,2,17,10,7,13,6,13,0,13,0,False,False,False,0,3,2021-12-13T15:26:21.59,13,False,0.0
2021,14,3265,755,3,6454,2,17,2,18,20,2,20,0,20,0,False,False,False,0,3,2022-03-11T19:27:11.94,20,False,0.0
2021,14,3265,760,3,8430,2,9,6,22,36,14,29,7,29,0,False,False,False,0,2,2021-12-16T18:26:24.633,36,False,7.0
2021,14,3265,780,8,6439,2,48,9,-2,3,5,0,3,0,0,False,False,False,0,1,2021-12-13T15:35:44.893,3,False,3.0
2021,14,3265,785,8,4000,2,47,5,0,3,3,1,2,1,0,False,False,False,0,1,2021-12-13T15:37:11.883,3,False,2.0
2021,14,3265,790,8,232,13,12,5,1,0,0,0,0,0,0,False,False,False,0,3,2021-12-13T15:39:00.303,0,False,0.0
2021,14,3265,805,3,8430,13,2,9,2,0,0,0,0,0,0,False,False,False,0,2,2021-12-13T15:42:48.997,0,False,0.0
2021,14,3265,835,8,7651,2,4,3,6,4,-2,6,-2,6,0,False,False,False,0,2,2021-12-13T15:47:55.14,4,False,-2.0
2021,14,3265,845,3,6936,2,4,5,4,12,8,4,8,4,0,False,False,False,0,2,2021-12-13T15:53:01.227,12,False,8.0
2021,14,3265,850,3,713,2,47,5,0,3,3,3,0,3,0,False,False,False,0,1,2021-12-16T18:26:48.64,3,True,0.0
2021,14,3265,855,3,7672,2,6,4,5,11,6,8,3,8,0,False,False,False,0,3,2021-12-16T18:07:44.96,11,False,3.0
2021,14,3265,860,3,713,2,28,4,2,2,0,2,0,2,0,False,False,False,0,1,2021-12-13T15:57:02.923,2,False,0.0
2021,14,3265,865,3,6816,2,39,4,6,6,0,6,0,6,0,False,False,False,0,4,2021-12-13T15:58:26.723,6,False,0.0
2021,14,3265,875,3,6454,2,5,5,0,2,2,0,2,0,0,False,False,False,0,3,2021-12-13T16:00:17.657,2,False,2.0
2021,14,3265,880,3,8430,2,13,10,3,5,2,5,0,5,0,False,False,False,0,2,2021-12-16T18:29:43.707,5,False,0.0
2021,14,3265,885,3,8430,2,4,3,5,6,1,5,1,5,0,False,False,False,0,2,2021-12-13T16:02:05.283,6,False,1.0
2021,14,3265,895,3,6936,13,21,2,36,0,0,0,0,0,0,False,False,False,0,2,2021-12-13T16:04:01.283,0,False,0.0
2021,14,3265,905,3,6936,2,51,10,-4,4,8,2,2,2,0,False,False,False,0,3,2021-12-13T16:18:24.48,4,False,2.0
2021,14,3265,915,3,8430,2,9,6,26,30,4,28,2,28,0,False,False,False,0,2,2021-12-16T15:36:57.797,30,False,2.0
2021,14,3265,920,3,6454,2,17,10,8,8,0,8,0,8,6,False,False,False,0,3,2021-12-13T16:09:27.143,8,True,0.0
2021,14,3265,935,3,6936,13,19,2,31,0,0,0,0,0,0,False,False,False,0,2,2021-12-13T16:12:03.157,0,False,0.0
2021,14,3265,950,3,6454,2,6,9,14,14,0,14,0,14,0,False,False,False,0,3,2021-12-13T16:14:36.723,14,False,0.0
2021,14,3265,960,3,8430,2,2,9,1,2,1,2,0,2,0,False,False,False,0,2,2021-12-13T16:15:47.193,2,False,0.0
2021,14,3266,10,21,4492,2,5,5,5,5,0,5,0,5,0,True,False,False,0,3,2021-12-14T21:01:25.917,5,False,0.0
2021,14,3266,20,21,6228,2,48,10,-3,15,18,6,9,6,0,False,False,False,0,1,2021-12-16T21:54:35.877,15,False,9.0
2021,14,3266,25,21,7059,3,30,10,0,0,0,0,0,0,0,False,False,False,0,4,2021-12-13T10:44:55.98,0,False,0.0
2021,14,3266,35,21,4492,13,6,9,10,0,0,0,0,0,0,False,False,False,0,2,2021-12-13T10:51:29.313,0,False,0.0
2021,14,3266,45,26,4619,2,4,3,10,15,5,10,5,10,0,False,False,False,0,2,2021-12-16T21:54:46.1,15,False,5.0
2021,14,3266,50,26,8552,13,35,6,17,0,0,0,0,0,0,False,False,False,0,3,2021-12-13T11:01:52.573,0,False,0.0
2021,14,3266,60,26,6301,2,32,3,-9,7,16,0,7,0,0,False,False,False,1,1,2021-12-13T11:05:18.53,7,False,7.0
2021,14,3266,70,21,7090,13,4,9,14,0,0,0,0,0,0,False,False,False,0,3,2021-12-13T11:12:26.543,0,False,0.0
2021,14,3266,80,21,7090,13,29,6,18,0,0,0,0,0,0,False,False,False,0,2,2021-12-13T11:16:08.94,0,False,0.0
2021,14,3266,95,26,4619,2,30,10,-5,5,10,5,0,5,0,False,False,False,0,3,2022-02-16T17:13:13.4,5,False,0.0
2021,14,3266,105,26,7453,2,5,5,6,11,5,9,2,9,0,False,False,False,0,3,2021-12-13T11:25:18.457,11,False,2.0
2021,14,3266,150,21,813,2,6,4,5,6,1,6,0,6,0,False,False,False,0,3,2021-12-13T11:40:57.517,6,False,0.0
2021,14,3266,155,21,4422,13,5,5,5,0,0,0,0,0,0,False,False,False,0,3,2021-12-13T11:42:27.183,0,False,0.0
2021,14,3266,160,21,4422,13,12,6,36,0,0,0,0,0,0,False,False,False,0,3,2021-12-13T11:46:02.467,0,False,0.0
2021,14,3266,165,21,813,2,8,7,17,60,43,44,16,44,0,True,False,False,1,3,2021-12-16T21:54:58.1,60,False,16.0
2021,14,3266,175,21,4180,2,47,5,3,3,0,3,0,3,6,False,False,False,0,1,2021-12-13T11:53:33.707,3,False,0.0
2021,14,3266,190,26,8552,2,3,3,9,9,0,9,0,9,0,True,False,False,0,3,2021-12-13T11:58:19.787,9,False,0.0
2021,14,3266,215,26,7491,2,53,9,-4,-2,2,-2,0,-2,0,True,False,False,0,4,2022-02-16T17:14:06.11,-2,False,0.0
2021,14,3266,220,26,7491,2,4,9,13,15,2,14,1,14,0,False,False,False,0,4,2021-12-13T12:11:46.01,15,False,1.0
2021,14,3266,225,26,7491,13,17,8,19,0,0,0,0,0,0,False,False,False,0,4,2021-12-13T12:14:39.597,0,False,
2021,14,3266,235,26,958,13,30,5,3,0,0,0,0,0,0,False,False,False,0,4,2021-12-13T12:21:04.337,0,False,0.0
2021,14,3266,240,26,8552,2,5,5,6,12,6,12,0,12,6,False,False,False,0,3,2021-12-13T12:22:31.99,12,False,0.0
2021,14,3266,255,21,4674,2,4,5,4,7,3,5,2,5,0,False,False,False,1,2,2022-02-22T19:08:20.627,7,False,2.0
2021,14,3266,275,26,4616,2,4,9,1,10,9,8,2,8,0,False,False,False,0,1,2021-12-13T12:39:43.253,10,False,2.0
2021,14,3266,290,26,4619,2,13,10,2,25,23,25,0,25,0,False,False,False,0,3,2021-12-14T19:45:38.347,25,False,0.0
2021,14,3266,295,26,4616,13,21,2,30,0,0,0,0,0,0,True,False,False,0,2,2021-12-14T19:48:16.383,0,False,0.0
2021,14,3266,310,26,958,2,4,9,7,7,0,7,0,7,0,True,False,False,0,3,2021-12-13T13:00:25.23,7,False,0.0
2021,14,3266,315,26,8552,2,49,10,-3,2,5,1,1,1,0,False,False,False,0,2,2021-12-13T13:00:15.767,2,False,1.0
2021,14,3266,320,26,958,13,21,5,12,0,0,0,0,0,0,False,False,False,0,3,2021-12-13T13:03:37.21,0,False,0.0
2021,14,3266,325,26,4616,2,12,10,5,7,2,6,1,6,0,True,False,False,0,2,2021-12-13T13:05:26.857,7,False,1.0
2021,14,3266,385,26,7695,2,32,10,3,5,2,4,1,4,0,False,False,False,0,1,2021-12-16T21:07:48.047,5,False,1.0
2021,14,3266,400,21,3680,13,2,4,10,0,0,0,0,0,0,False,False,False,0,3,2021-12-13T13:27:26.27,0,False,0.0
2021,14,3266,405,21,6228,2,51,5,-5,-2,3,-2,0,-2,0,False,False,False,0,1,2022-02-22T19:07:42.963,-2,False,0.0
2021,14,3266,410,21,3957,13,6,4,3,0,0,0,0,0,0,False,False,False,0,1,2022-02-16T17:14:55.977,0,False,0.0
2021,14,3266,420,26,7453,2,5,3,12,17,5,15,2,15,0,False,False,False,0,2,2021-12-13T13:37:35.573,17,False,2.0
2021,14,3266,435,26,4616,13,5,10,4,0,0,0,0,0,0,False,False,False,0,1,2021-12-13T13:40:19.443,0,False,0.0
2021,14,3266,440,26,7453,2,19,1,57,59,2,58,1,58,6,False,False,False,0,3,2021-12-13T13:42:53.73,59,False,1.0
2021,14,3266,455,21,3957,2,48,9,-4,1,5,-1,2,-1,0,False,False,False,0,1,2022-03-03T13:52:51.637,1,False,2.0
2021,14,3266,465,21,4492,13,19,6,39,0,0,0,0,0,0,True,False,False,0,3,2022-02-16T17:15:24.103,0,False,0.0
2021,14,3266,470,21,3957,2,28,3,4,17,13,12,5,12,0,False,False,False,2,1,2021-12-13T13:49:41.32,17,False,5.0
2021,14,3266,490,26,8552,2,18,5,-1,7,8,3,4,3,0,False,False,False,0,2,2021-12-13T13:57:23.617,7,False,4.0
2021,14,3266,500,26,8552,2,43,6,30,36,6,32,4,32,0,True,False,False,0,4,2021-12-13T14:02:11.69,36,False,4.0
2021,14,3266,510,26,4619,2,4,9,5,5,0,5,0,5,0,False,False,False,0,2,2021-12-13T14:07:06.317,5,False,0.0
2021,14,3266,525,26,8552,13,29,3,5,0,0,0,0,0,0,True,False,False,0,3,2021-12-13T14:15:34.76,0,False,0.0
2021,14,3266,560,21,4422,13,4,10,5,0,0,0,0,0,0,False,False,False,0,3,2021-12-16T21:52:30.333,0,False,0.0
2021,14,3266,565,21,4492,13,7,6,17,0,0,0,0,0,0,False,False,False,0,3,2021-12-13T14:36:35.653,0,False,0.0
2021,14,3266,570,21,6272,13,4,5,12,0,0,0,0,0,0,False,False,False,0,2,2021-12-13T14:40:41.613,0,False,0.0
2021,14,3266,580,26,4050,2,30,5,1,11,10,10,1,10,0,True,False,False,0,4,2021-12-14T19:49:14.267,11,False,1.0
2021,14,3266,615,21,4492,13,35,5,13,0,0,0,0,0,0,False,False,False,0,3,2022-02-22T19:10:04.997,0,False,0.0
2021,14,3266,640,21,3680,2,47,5,0,3,3,0,3,0,0,False,False,False,2,3,2021-12-16T22:08:42.337,3,False,3.0
2021,14,3266,645,21,3957,2,28,10,-1,2,3,2,0,2,0,False,False,False,0,1,2022-02-24T18:40:50.893,2,False,
2021,14,3266,655,21,4492,13,2,10,9,0,0,0,0,0,0,False,False,False,0,2,2021-12-13T15:23:10.77,0,False,0.0
2021,14,3266,680,26,4619,2,4,9,6,8,2,7,1,7,0,False,False,False,0,3,2021-12-13T15:37:43.327,8,False,1.0
2021,14,3266,690,26,4619,2,4,10,3,3,0,3,0,3,0,False,False,False,0,3,2021-12-13T15:42:51.117,3,False,0.0
2021,14,3266,715,26,958,13,12,5,3,0,0,0,0,0,0,False,False,False,0,4,2022-02-24T18:41:08.493,0,False,0.0
2021,14,3266,730,26,958,2,7,5,1,1,0,1,0,1,6,False,False,False,0,4,2021-12-13T16:02:21.117,1,False,0.0
2021,14,3266,755,21,3957,2,6,9,3,9,6,5,4,5,0,False,False,False,0,2,2021-12-13T16:14:40.353,9,False,4.0
2021,14,3266,760,21,3680,2,4,3,3,3,0,3,0,3,0,False,False,False,0,2,2022-02-16T17:17:03.553,3,False,
2021,14,3266,770,21,3389,2,2,10,6,6,0,6,0,6,0,False,False,False,0,3,2021-12-16T21:07:48.047,6,False,0.0
2021,14,3266,780,21,7090,3,4,5,8,0,0,0,0,0,0,False,False,False,0,2,2021-12-13T16:31:11.123,0,False,0.0
2021,14,3266,795,21,6228,2,21,2,18,18,0,18,0,18,6,False,False,False,0,2,2021-12-13T16:41:50.32,18,False,0.0
2021,14,3266,855,21,3957,13,6,5,2,0,0,0,0,0,0,False,False,False,0,2,2021-12-16T21:54:04.853,0,False,
2021,14,3266,860,21,4492,2,38,9,3,10,7,5,5,5,0,False,False,False,0,3,2021-12-16T21:55:10.83,10,False,5.0
2021,14,3266,865,21,3957,2,45,5,-4,1,5,-1,2,-1,0,False,False,False,1,1,2021-12-13T17:04:27.483,1,False,2.0
2021,14,3266,870,21,4422,2,6,4,6,8,2,7,1,7,0,False,False,False,0,3,2021-12-16T21:07:48.063,8,False,1.0
2021,14,3266,905,21,4492,13,19,6,24,0,0,0,0,0,0,False,False,False,0,2,2021-12-16T22:14:44.377,0,False,0.0
2021,14,3266,910,21,3680,2,17,8,19,24,5,22,2,22,0,False,False,False,0,3,2021-12-13T17:17:01.89,24,False,2.0
2021,14,3266,920,21,3680,13,13,9,5,0,0,0,0,0,0,False,False,False,0,3,2021-12-16T21:54:12.07,0,False,0.0
2021,14,3267,15,10,7082,13,12,5,9,0,0,0,0,0,0,True,False,False,0,2,2021-12-13T10:05:53.72,0,False,0.0
2021,14,3267,35,10,4930,2,2,4,5,13,8,11,2,11,0,False,False,False,0,3,2021-12-13T10:14:23.04,13,False,2.0
2021,14,3267,45,10,7700,3,5,9,6,0,0,0,0,0,0,False,False,False,0,3,2021-12-13T10:25:07.207,0,False,0.0
2021,14,3267,50,10,6281,13,5,5,13,0,0,0,0,0,0,False,False,False,0,2,2021-12-13T10:27:38.487,0,False,
2021,14,3267,85,11,8359,13,5,5,8,0,0,0,0,0,0,True,False,False,0,3,2021-12-15T01:36:33.187,0,False,0.0
2021,14,3267,135,10,6840,2,21,2,28,32,4,31,1,31,0,False,False,False,0,4,2021-12-13T11:02:09.107,32,False,1.0
2021,14,3267,145,10,4930,2,2,10,6,8,2,7,1,7,0,False,False,False,0,2,2021-12-13T11:05:31.093,8,False,1.0
2021,14,3267,175,11,8359,2,30,10,0,1,1,0,1,0,0,True,False,False,0,4,2022-02-16T16:57:55.037,1,False,1.0
2021,14,3267,195,11,8359,2,5,5,12,13,1,13,0,13,0,False,False,False,0,2,2022-03-08T19:14:37.193,13,False,0.0
2021,14,3267,210,11,4037,2,44,3,-4,7,11,7,0,7,6,True,False,False,0,2,2021-12-13T11:29:12.59,7,True,0.0
2021,14,3267,235,10,4930,3,5,3,3,0,0,0,0,0,0,False,False,False,0,3,2021-12-13T11:37:02.573,0,False,0.0
2021,14,3267,240,10,4930,13,4,10,7,0,0,0,0,0,0,False,False,False,0,2,2021-12-13T11:39:05.6,0,False,0.0
2021,14,3267,250,11,6815,2,6,4,4,7,3,4,3,4,0,False,False,False,1,3,2021-12-13T11:46:25.5,7,False,3.0
2021,14,3267,265,11,8641,2,46,3,0,2,2,2,0,2,0,True,False,False,0,4,2021-12-15T19:46:25.983,2,False,0.0
2021,14,3267,275,11,4037,2,5,5,2,9,7,6,3,6,0,False,False,False,0,3,2021-12-13T11:56:49.343,9,False,3.0
2021,14,3267,280,11,4875,2,5,6,18,19,1,19,0,19,0,True,False,False,0,2,2021-12-13T11:58:45.163,19,True,0.0
2021,14,3267,290,11,8359,13,2,10,5,0,0,0,0,0,0,False,False,False,0,3,2022-02-16T16:58:45.483,0,False,0.0
2021,14,3267,295,11,8628,13,5,3,10,0,0,0,0,0,0,False,False,False,0,3,2021-12-13T12:04:04.727,0,False,0.0
2021,14,3267,310,10,6281,2,2,10,7,9,2,9,0,9,0,False,False,False,0,2,2021-12-13T12:08:22.557,9,False,0.0
2021,14,3267,330,10,7703,2,4,10,7,8,1,7,1,7,0,True,False,False,0,3,2021-12-13T12:12:31.26,8,False,1.0
2021,14,3267,345,11,4037,2,5,3,7,7,0,7,0,7,0,False,False,False,0,3,2021-12-13T12:16:04.403,7,True,0.0
2021,14,3267,360,11,8359,2,5,5,3,5,2,4,1,4,0,False,False,False,0,3,2022-03-08T19:15:13.753,5,False,1.0
2021,14,3267,370,11,8359,13,11,5,8,0,0,0,0,0,0,False,False,False,0,1,2021-12-13T12:23:05.923,0,False,0.0
2021,14,3267,380,10,7700,2,4,10,6,6,0,6,0,6,0,False,False,False,0,3,2022-03-08T19:15:38.313,6,False,0.0
2021,14,3267,390,10,6840,2,5,5,5,7,2,7,0,7,0,False,False,False,0,4,2021-12-13T12:28:30.643,7,False,0.0
2021,14,3267,395,10,6840,2,4,10,4,7,3,7,0,7,0,False,False,False,0,3,2021-12-13T12:31:03.65,7,False,0.0
2021,14,3267,400,10,6281,13,29,6,25,0,0,0,0,0,0,False,False,False,0,2,2021-12-13T12:30:53.003,0,False,0.0
2021,14,3267,405,10,7700,2,4,9,4,4,0,4,0,4,0,False,False,False,0,3,2021-12-13T12:32:21.29,4,False,0.0
2021,14,3267,415,10,4930,13,7,2,19,0,0,0,0,0,0,False,False,False,0,3,2021-12-13T12:37:29.29,0,False,0.0
2021,14,3267,420,10,7703,2,13,3,6,8,2,7,1,7,0,True,False,False,0,3,2021-12-13T12:41:51.9,8,False,1.0
2021,14,3267,430,10,7700,2,39,4,7,7,0,7,0,7,0,False,False,False,0,3,2021-12-13T12:43:28.94,7,True,0.0
2021,14,3267,480,10,7700,2,4,9,4,9,5,7,2,7,0,False,False,False,0,3,2021-12-13T13:20:59.953,9,False,2.0
2021,14,3267,490,10,8541,2,46,3,2,10,8,6,4,6,6,False,False,False,1,1,2021-12-13T13:23:32.117,10,False,4.0
2021,14,3267,515,11,4875,2,6,7,20,20,0,20,0,20,0,False,False,False,0,2,2021-12-13T13:30:15.683,20,False,0.0
2021,14,3267,520,11,8628,13,5,10,3,0,0,0,0,0,0,False,False,False,0,3,2021-12-15T19:54:52.253,0,False,0.0
2021,14,3267,555,11,8641,2,53,9,-5,11,16,8,3,8,0,False,False,False,0,4,2021-12-13T13:39:35.94,11,False,3.0
2021,14,3267,565,11,3372,2,12,9,-3,-2,1,-2,0,-2,0,False,False,False,0,5,2021-12-13T13:49:04.62,-2,False,0.0
2021,14,3267,580,11,8359,2,16,9,3,9,6,3,6,3,0,True,False,False,1,1,2021-12-13T13:56:13.54,9,False,6.0
2021,14,3267,585,11,8628,13,6,2,18,0,0,0,0,0,0,False,False,False,0,3,2021-12-13T13:58:32.327,0,False,0.0
2021,14,3267,595,11,4037,13,21,2,34,0,0,0,0,0,0,False,False,False,0,3,2021-12-15T19:49:55.347,0,False,0.0
2021,14,3267,600,11,8359,2,44,3,0,9,9,7,2,7,0,True,False,False,0,1,2021-12-15T01:37:10.017,9,False,2.0
2021,14,3267,615,11,8359,2,4,10,6,11,5,5,6,5,0,False,False,False,1,3,2021-12-13T14:08:15.54,11,False,6.0
2021,14,3267,625,11,8359,2,35,9,9,19,10,19,0,19,0,False,False,False,0,3,2021-12-15T01:34:05.13,19,False,0.0
2021,14,3267,640,11,8641,13,12,3,4,0,0,0,0,0,0,False,False,False,0,4,2022-02-24T18:42:23.86,0,False,0.0
2021,14,3267,645,11,8628,13,4,9,4,0,0,0,0,0,0,False,False,False,0,4,2021-12-13T14:24:01.543,0,False,0.0
2021,14,3267,660,10,8541,3,12,5,12,0,0,0,0,0,0,False,False,False,0,1,2022-02-16T16:59:17.02,0,False,0.0
2021,14,3267,670,11,4875,2,5,5,13,13,0,13,0,13,0,False,False,False,0,2,2022-03-08T19:16:24.513,13,False,0.0
2021,14,3267,675,11,8628,2,2,4,5,4,-1,4,0,4,0,False,False,False,0,4,2021-12-15T19:51:07.68,4,False,0.0
2021,14,3267,685,11,8359,2,4,10,5,6,1,5,1,5,0,False,False,False,0,3,2021-12-13T14:36:29.443,6,False,1.0
2021,14,3267,690,11,8641,13,5,5,8,0,0,0,0,0,0,False,False,False,0,4,2021-12-15T19:33:56.873,0,False,0.0
2021,14,3267,695,10,7703,2,30,10,1,16,15,10,6,10,0,False,False,False,1,4,2021-12-13T14:39:38.917,16,False,6.0
2021,14,3267,705,10,6840,2,32,5,3,5,2,4,1,4,0,False,False,False,0,4,2021-12-15T19:28:32.297,5,False,1.0
2021,14,3267,745,10,7703,2,30,9,-1,5,6,2,3,2,0,False,False,False,0,4,2021-12-13T14:49:57.107,5,False,3.0
2021,14,3267,750,10,7700,2,16,10,7,21,14,17,4,17,0,True,False,False,0,3,2021-12-13T14:53:33.95,21,False,4.0
2021,14,3267,780,10,7703,2,30,5,-2,4,6,-2,6,-2,6,True,False,False,1,4,2021-12-13T15:00:21.443,4,False,6.0
2021,14,3267,795,11,4875,13,3,3,10,0,0,0,0,0,0,False,False,False,0,2,2021-12-13T15:04:47.767,0,False,0.0
2021,14,3267,800,11,4875,13,19,6,30,0,0,0,0,0,0,False,False,False,0,2,2021-12-13T15:06:05.407,0,False,0.0
2021,14,3267,805,11,7493,2,5,3,4,14,10,14,0,14,0,False,False,False,0,1,2021-12-13T15:07:36.59,14,True,0.0
2021,14,3267,810,11,6633,13,19,6,31,0,0,0,0,0,0,False,False,False,0,2,2021-12-13T15:09:24.767,0,False,0.0
2021,14,3267,815,11,4037,2,26,9,6,8,2,7,1,7,0,False,False,False,2,3,2021-12-15T19:36:29.42,8,False,1.0
2021,14,3267,820,11,8628,2,17,4,13,14,1,14,0,14,0,False,False,False,0,3,2021-12-13T15:13:13.157,14,False,0.0
2021,14,3267,825,11,8641,2,13,9,4,7,3,7,0,7,0,False,False,False,0,3,2021-12-13T15:14:45.933,7,False,0.0
2021,14,3267,830,11,7493,2,28,10,2,2,0,2,0,2,0,False,False,False,0,1,2021-12-13T15:15:57.493,2,False,0.0
2021,14,3267,835,11,8359,13,4,9,4,0,0,0,0,0,0,False,False,False,0,3,2021-12-13T15:16:57.48,0,False,0.0
2021,14,3268,15,30,4516,2,13,10,4,6,2,5,1,5,0,False,False,False,0,2,2021-12-13T10:29:47.833,6,False,1.0
2021,14,3268,20,30,4516,2,50,9,1,15,14,15,0,15,0,False,False,False,0,3,2021-12-13T10:31:03.907,15,False,0.0
2021,14,3268,30,4,6983,2,44,3,-6,1,7,1,0,1,0,False,False,False,0,1,2021-12-13T10:35:05.677,1,False,0.0
2021,14,3268,35,4,6983,2,5,9,2,10,8,8,2,8,0,False,False,False,0,1,2021-12-13T10:37:00.29,10,False,2.0
2021,14,3268,40,4,6983,13,46,9,-3,0,0,0,0,0,0,False,False,False,0,1,2021-12-13T10:38:26.187,0,False,0.0
2021,14,3268,50,4,6983,2,12,4,7,11,4,11,0,11,0,False,False,False,0,1,2021-12-13T10:41:28.073,11,False,0.0
2021,14,3268,65,30,793,2,4,3,5,5,0,5,0,5,0,False,False,False,0,2,2021-12-13T10:44:30.57,5,False,0.0
2021,14,3268,70,30,4516,2,6,4,5,7,2,7,0,7,0,False,False,False,0,3,2021-12-13T10:46:10.3,7,False,0.0
2021,14,3268,75,30,4937,13,16,4,4,0,0,0,0,0,0,False,False,False,0,1,2021-12-13T10:49:46.017,0,False,0.0
2021,14,3268,80,30,793,13,17,2,18,0,0,0,0,0,0,False,False,False,0,3,2021-12-13T10:51:11.643,0,False,
2021,14,3268,100,4,2853,2,50,9,-3,5,8,2,3,2,0,True,False,False,0,3,2021-12-13T10:59:33.207,5,False,3.0
2021,14,3268,110,4,594,2,50,9,-3,3,6,3,0,3,0,True,False,False,0,2,2021-12-13T11:04:32.707,3,False,0.0
2021,14,3268,120,4,7646,13,4,3,13,0,0,0,0,0,0,False,False,False,0,2,2022-02-25T15:58:23.547,0,False,0.0
2021,14,3268,135,30,7893,2,5,5,5,5,0,5,0,5,0,False,False,False,0,3,2021-12-13T11:12:10.083,5,False,0.0
2021,14,3268,150,30,63,2,26,10,5,9,4,7,2,7,0,False,False,False,0,3,2021-12-13T11:16:35.69,9,False,2.0
2021,14,3268,160,30,4516,2,13,9,4,20,16,19,1,19,0,False,False,False,0,3,2021-12-13T11:18:55.45,20,False,1.0
2021,14,3268,165,30,63,13,24,8,30,0,0,0,0,0,0,False,False,False,0,4,2021-12-13T11:20:48.16,0,False,0.0
2021,14,3268,170,30,7893,2,47,10,1,8,7,6,2,6,0,True,False,False,1,3,2021-12-13T11:22:54.01,8,False,2.0
2021,14,3268,180,30,4937,2,51,9,-4,16,20,14,2,14,0,False,False,False,0,1,2021-12-13T11:25:32.857,16,False,2.0
2021,14,3268,200,30,4516,13,12,5,5,0,0,0,0,0,0,True,False,False,0,3,2021-12-15T19:08:58.37,0,False,0.0
2021,14,3268,215,4,213,2,4,7,21,25,4,24,1,24,0,False,False,False,0,2,2021-12-13T11:38:13.567,25,False,1.0
2021,14,3268,220,4,7646,2,46,3,3,6,3,6,0,6,0,False,False,False,0,3,2021-12-13T11:41:09.973,6,False,
2021,14,3268,225,4,2853,2,8,7,20,24,4,23,1,23,0,False,False,False,0,2,2021-12-14T22:10:13.733,24,False,1.0
2021,14,3268,230,4,7646,2,21,5,9,21,12,19,2,19,0,False,False,False,0,3,2021-12-13T11:45:06.11,21,False,2.0
2021,14,3268,245,4,7646,13,17,9,3,0,0,0,0,0,0,True,False,False,0,3,2021-12-14T22:01:28.327,0,False,0.0
2021,14,3268,260,30,4516,2,6,7,19,23,4,21,2,21,0,False,False,False,0,4,2021-12-13T11:56:04.82,23,False,2.0
2021,14,3268,265,30,63,2,26,4,5,18,13,8,10,8,0,False,False,False,1,3,2021-12-13T11:57:59.987,18,False,10.0
2021,14,3268,275,30,256,13,5,5,9,0,0,0,0,0,0,False,False,False,0,3,2021-12-13T12:00:47.85,0,False,0.0
2021,14,3268,280,30,63,13,9,5,14,0,0,0,0,0,0,False,False,False,0,3,2021-12-13T12:02:30.113,0,False,
2021,14,3268,285,30,4937,2,51,10,-6,5,11,4,1,4,0,False,False,False,0,1,2021-12-13T12:05:13.603,5,False,1.0
2021,14,3268,290,30,4937,3,16,10,4,0,0,0,0,0,0,False,False,False,0,1,2021-12-13T12:06:43.267,0,False,0.0
2021,14,3268,295,30,793,2,7,3,13,13,0,13,0,13,6,False,False,False,0,3,2021-12-15T18:41:36.2,13,True,0.0
2021,14,3268,310,4,6953,2,39,10,9,9,0,9,0,9,0,False,False,False,0,3,2021-12-14T22:10:13.733,9,False,0.0
2021,14,3268,315,4,5119,2,51,3,-4,5,9,5,0,5,0,True,False,False,0,3,2021-12-14T22:04:37.067,5,False,0.0
2021,14,3268,325,4,594,13,26,4,4,0,0,0,0,0,0,False,False,False,0,3,2021-12-13T12:22:37.367,0,False,0.0
2021,14,3268,330,4,6953,2,32,10,-3,6,9,6,0,6,0,False,False,False,0,3,2021-12-13T12:24:10.543,6,False,0.0
2021,14,3268,340,30,63,2,38,4,6,16,10,11,5,11,0,False,False,False,0,4,2021-12-15T18:41:50.6,16,False,5.0
2021,14,3268,350,30,4516,2,50,9,-2,13,15,9,4,9,0,False,False,False,0,2,2021-12-13T12:33:17.95,13,False,4.0
2021,14,3268,355,30,4516,2,4,10,7,7,0,7,0,7,0,False,False,False,0,3,2021-12-13T12:35:32.663,7,False,0.0
2021,14,3268,380,30,63,2,53,9,-5,5,10,3,2,3,0,False,False,False,0,4,2021-12-13T12:41:04.957,5,False,2.0
2021,14,3268,390,30,793,2,7,6,20,20,0,20,0,20,0,False,False,False,0,3,2021-12-13T12:43:58.17,20,False,0.0
2021,14,3268,420,4,594,2,4,9,4,10,6,10,0,10,0,False,False,False,0,3,2021-12-13T12:49:37.17,10,False,0.0
2021,14,3268,430,4,6953,13,12,5,5,0,0,0,0,0,0,False,False,False,0,3,2021-12-14T22:02:03.77,0,False,0.0
2021,14,3268,440,30,4937,2,2,9,2,5,3,5,0,5,0,False,False,False,0,3,2021-12-13T12:58:43.68,5,False,0.0
2021,14,3268,450,30,4516,13,26,4,6,0,0,0,0,0,0,True,False,False,0,3,2021-12-13T13:02:18.423,0,False,0.0
2021,14,3268,470,4,2853,13,19,8,31,0,0,0,0,0,0,False,False,False,0,2,2021-12-13T13:14:04.42,0,False,0.0
2021,14,3268,485,4,2853,13,12,6,34,0,0,0,0,0,0,False,False,False,0,3,2021-12-13T13:18:29.18,0,False,0.0
2021,14,3268,510,4,7646,2,4,3,9,12,3,12,0,12,0,False,False,False,0,2,2021-12-13T13:30:27.34,12,False,0.0
2021,14,3268,520,4,2853,2,4,3,5,6,1,6,0,6,0,False,False,False,0,2,2021-12-13T13:32:49.193,6,False,0.0
2021,14,3268,525,4,7646,2,47,5,0,1,1,1,0,1,0,False,False,False,0,3,2021-12-13T13:34:29.49,1,False,0.0
2021,14,3268,540,30,63,13,17,10,12,0,0,0,0,0,0,False,False,False,0,4,2021-12-13T13:43:36.087,0,False,0.0
2021,14,3268,545,30,2290,2,2,4,5,6,1,6,0,6,0,False,False,False,0,4,2021-12-13T13:43:28.623,6,False,0.0
2021,14,3268,550,30,2290,13,2,9,3,0,0,0,0,0,0,True,False,False,0,3,2021-12-15T18:42:27.83,0,False,0.0
2021,14,3268,560,4,2853,2,2,10,9,13,4,12,1,12,0,False,False,False,0,2,2021-12-15T18:42:39.28,13,False,1.0
2021,14,3268,570,4,594,13,2,9,4,0,0,0,0,0,0,False,False,False,0,3,2021-12-15T18:42:50.897,0,False,0.0
2021,14,3268,575,4,594,2,5,9,5,9,4,9,0,9,0,False,False,False,0,3,2021-12-13T14:01:22.693,9,False,0.0
2021,14,3268,585,4,6953,2,54,9,-2,-2,0,-2,0,-2,0,False,False,False,0,4,2021-12-15T18:16:35.223,-2,False,0.0
2021,14,3268,590,4,6983,2,51,10,-7,10,17,10,0,10,0,True,False,False,0,1,2021-12-14T22:01:38.49,10,False,0.0
2021,14,3268,630,30,63,13,7,8,26,0,0,0,0,0,0,False,False,False,0,4,2021-12-13T17:07:02.93,0,False,0.0
2021,14,3268,635,30,4516,13,6,4,14,0,0,0,0,0,0,False,False,False,0,3,2021-12-13T14:27:26.873,0,False,0.0
2021,14,3268,660,4,4913,13,31,4,2,0,0,0,0,0,0,False,False,False,0,1,2021-12-13T14:41:15.56,0,False,0.0
2021,14,3268,665,4,6983,2,45,5,-5,2,7,0,2,0,0,False,False,False,0,1,2021-12-13T14:42:49.343,2,False,2.0
2021,14,3268,680,30,793,2,17,1,17,24,7,21,3,21,0,False,False,False,1,3,2021-12-15T18:16:57.703,24,False,3.0
2021,14,3268,690,30,7893,2,18,5,-3,4,7,3,1,3,0,False,False,False,0,2,2021-12-13T14:51:12.453,4,False,1.0
2021,14,3268,700,30,256,13,5,6,16,0,0,0,0,0,0,False,False,False,0,2,2021-12-15T18:15:17.903,0,False,
2021,14,3268,705,30,793,2,6,4,14,18,4,16,2,16,0,False,False,False,0,3,2021-12-13T14:59:44.82,18,False,2.0
2021,14,3268,720,30,4516,2,50,5,-1,0,1,0,0,0,0,True,False,False,0,3,2021-12-13T15:04:52.803,0,False,0.0
2021,14,3268,725,30,2290,13,2,10,9,0,0,0,0,0,0,True,False,False,0,3,2021-12-15T18:44:28.747,0,False,0.0
2021,14,3268,730,30,4516,2,50,4,0,8,8,4,4,4,0,False,False,False,0,3,2021-12-13T15:08:43.137,8,False,4.0
2021,14,3268,750,4,6953,2,47,5,0,4,4,4,0,4,0,False,False,False,0,4,2021-12-13T15:14:44.183,4,False,0.0
2021,14,3268,755,4,2853,2,4,9,10,10,0,10,0,10,0,False,False,False,0,2,2021-12-13T15:15:49.4,10,False,0.0
2021,14,3268,760,4,594,13,5,5,8,0,0,0,0,0,0,False,False,False,0,3,2021-12-13T15:17:14.87,0,False,
2021,14,3268,775,4,6953,2,17,7,15,15,0,15,0,15,6,False,False,False,0,3,2021-12-13T17:07:50.083,15,True,0.0
2021,14,3268,795,30,63,13,9,2,19,0,0,0,0,0,0,False,False,False,0,2,2021-12-13T15:31:11.62,0,False,0.0
2021,14,3268,800,30,4516,13,17,1,17,0,0,0,0,0,0,True,False,False,0,3,2021-12-15T18:15:43.063,0,False,0.0
2021,14,3268,810,4,2853,13,2,10,8,0,0,0,0,0,0,True,False,False,0,3,2021-12-14T22:01:48.843,0,False,0.0
2021,14,3268,815,4,594,2,4,3,6,9,3,9,0,9,0,False,False,False,0,3,2021-12-13T15:38:17.467,9,False,0.0
2021,14,3268,830,4,594,2,2,4,4,12,8,11,1,11,0,False,False,False,0,3,2021-12-13T15:43:29.167,12,False,1.0
2021,14,3268,835,4,2853,2,3,5,12,12,0,12,0,12,0,False,False,False,0,2,2021-12-13T15:49:53.723,12,False,0.0
2021,14,3268,840,4,6983,2,28,4,2,3,1,3,0,3,0,False,False,False,0,1,2021-12-13T15:51:47.997,3,False,0.0
2021,14,3268,845,4,7646,13,46,3,3,0,0,0,0,0,0,False,False,False,0,3,2021-12-13T15:53:40.323,0,False,0.0
2021,14,3268,850,4,7646,2,2,4,4,4,0,4,0,4,6,False,False,False,0,3,2021-12-13T15:55:49.443,4,True,0.0
2021,14,3268,865,30,2290,2,4,4,5,5,0,5,0,5,0,False,False,False,0,4,2021-12-13T16:02:12.05,5,False,0.0
2021,14,3268,870,30,793,2,2,10,8,11,3,11,0,11,0,False,False,False,0,2,2021-12-13T16:04:25.043,11,False,0.0
2021,14,3268,885,30,4516,13,7,2,23,0,0,0,0,0,0,True,False,False,0,4,2021-12-15T18:15:52.353,0,False,0.0
2021,14,3268,890,30,4516,2,12,4,6,10,4,10,0,10,0,False,False,False,0,2,2021-12-15T18:45:36.477,10,False,
2021,14,3268,910,4,2853,2,3,5,4,4,0,4,0,4,0,False,False,False,0,2,2021-12-13T16:17:51.873,4,False,0.0
2021,14,3268,920,4,6953,2,32,3,3,4,1,4,0,4,0,False,False,False,0,4,2021-12-14T22:10:13.733,4,False,0.0
2021,14,3268,930,4,6983,13,12,4,3,0,0,0,0,0,0,False,False,False,0,1,2021-12-13T16:23:55.137,0,False,0.0
2021,14,3268,935,4,594,2,5,5,2,2,0,2,0,2,0,True,False,False,0,3,2021-12-14T22:05:29,2,False,0.0
2021,14,3268,945,4,7646,2,4,5,4,5,1,4,1,4,0,False,False,False,0,2,2021-12-14T22:10:13.733,5,False,1.0
2021,14,3268,950,4,2853,13,19,6,21,0,0,0,0,0,0,False,False,False,0,2,2021-12-14T22:10:13.733,0,False,0.0
2021,14,3268,955,4,594,2,2,9,7,15,8,8,7,8,0,True,False,False,0,3,2021-12-13T16:32:12.943,15,False,7.0
2021,14,3268,960,4,594,2,45,5,1,1,0,1,0,1,0,False,False,False,0,3,2021-12-13T16:33:34.703,1,False,0.0
2021,14,3268,970,4,6953,2,33,9,-3,24,27,21,3,21,0,False,False,False,1,3,2021-12-13T16:35:59.433,24,False,3.0
2021,14,3268,975,4,6953,13,47,5,3,0,0,0,0,0,0,False,False,False,0,3,2021-12-14T22:10:13.733,0,False,0.0
2021,14,3268,985,4,2853,13,9,3,7,0,0,0,0,0,0,False,False,False,0,2,2021-12-13T16:41:34.647,0,False,0.0
2021,14,3268,1020,4,594,2,4,5,1,3,2,3,0,3,0,False,False,False,0,3,2021-12-13T16:46:31.237,3,True,0.0
2021,14,3268,1025,4,2853,13,4,5,5,0,0,0,0,0,0,False,False,False,0,2,2021-12-13T16:48:25.773,0,False,0.0
2021,14,3268,1040,30,4516,2,39,4,4,6,2,5,1,5,0,False,False,False,0,3,2021-12-13T16:51:29.637,6,False,1.0
2021,14,3268,1050,30,793,13,19,6,20,0,0,0,0,0,0,False,False,False,0,2,2021-12-13T16:55:03.837,0,False,
2021,14,3268,1055,30,4937,2,51,10,-6,-7,-1,-6,-1,-6,0,True,False,False,0,1,2021-12-13T16:57:06.683,-7,False,-1.0
2021,14,3268,1060,30,63,2,47,5,2,14,12,12,2,12,0,False,False,False,0,1,2021-12-13T16:58:17.94,14,False,2.0
2021,14,3268,1065,30,256,2,13,10,6,58,52,19,39,19,6,False,False,False,0,3,2021-12-13T17:00:49.027,58,False,39.0
2021,14,3269,10,6,464,13,5,5,5,0,0,0,0,0,0,False,False,False,0,3,2021-12-13T10:33:07.79,0,False,0.0
2021,14,3269,25,6,7725,2,7,6,16,19,3,18,1,18,0,False,False,False,0,3,2021-12-13T10:39:22.13,19,False,1.0
2021,14,3269,40,6,7728,13,2,4,8,0,0,0,0,0,0,False,False,False,0,3,2021-12-13T16:03:33.797,0,False,0.0
2021,14,3269,50,12,6691,2,5,3,3,6,3,5,1,5,0,True,False,False,0,4,2021-12-13T10:50:39.697,6,False,1.0
2021,14,3269,60,12,7743,2,12,10,2,6,4,5,1,5,0,False,False,False,0,3,2022-02-24T18:43:15.34,6,False,1.0
2021,14,3269,70,6,7725,13,7,2,39,0,0,0,0,0,0,False,False,False,0,3,2022-02-22T19:02:02.407,0,False,0.0
2021,14,3269,80,6,464,2,4,10,7,8,1,7,1,7,0,False,False,False,0,3,2021-12-13T11:04:48.14,8,False,1.0
2021,14,3269,100,6,464,13,17,9,9,0,0,0,0,0,0,False,False,False,0,3,2021-12-13T11:13:16.753,0,False,
2021,14,3269,120,6,7728,13,39,4,5,0,0,0,0,0,0,False,False,False,0,3,2021-12-13T11:20:12.847,0,False,0.0
2021,14,3269,150,12,6691,2,35,2,28,32,4,30,2,30,0,False,False,False,0,3,2021-12-13T11:34:44.63,32,False,2.0
2021,14,3269,165,12,4537,2,12,5,0,0,0,0,0,0,0,False,False,False,0,1,2022-02-24T18:43:32.827,0,False,0.0
2021,14,3269,190,6,666,2,38,10,2,3,1,2,1,2,0,False,False,False,0,3,2021-12-13T11:49:32.953,3,False,1.0
2021,14,3269,200,6,7725,13,4,9,14,0,0,0,0,0,0,False,False,False,0,3,2021-12-13T11:53:52.72,0,False,
2021,14,3269,205,6,7728,2,55,4,0,6,6,4,2,4,0,False,False,False,0,4,2021-12-13T12:03:30.57,6,False,2.0
2021,14,3269,210,6,4305,2,34,4,-4,46,50,33,13,33,6,True,False,False,1,3,2021-12-15T21:55:04.203,46,False,13.0
2021,14,3269,230,12,4537,2,2,10,3,7,4,7,0,7,0,True,False,False,0,2,2021-12-14T20:33:11.96,7,False,0.0
2021,14,3269,235,12,556,2,2,10,2,12,10,12,0,12,0,False,False,False,0,2,2021-12-13T12:08:23.527,12,False,0.0
2021,14,3269,245,12,7743,2,46,3,4,25,21,24,1,24,0,True,False,False,0,4,2021-12-13T12:13:12.603,25,False,1.0
2021,14,3269,260,12,467,2,13,5,2,12,10,9,3,9,0,False,False,False,0,4,2021-12-13T12:18:50.967,12,False,3.0
2021,14,3269,270,12,556,13,2,10,2,0,0,0,0,0,0,False,False,False,0,3,2021-12-13T12:24:36.453,0,False,0.0
2021,14,3269,275,12,6357,13,7,3,2,0,0,0,0,0,0,False,False,False,0,2,2021-12-13T12:27:15.3,0,False,0.0
2021,14,3269,280,12,6691,2,2,9,2,2,0,2,0,2,6,False,False,False,0,3,2021-12-13T12:29:00.49,2,True,0.0
2021,14,3269,305,6,7725,13,5,3,7,0,0,0,0,0,0,False,False,False,0,2,2021-12-13T12:36:57.953,0,False,0.0
2021,14,3269,325,6,666,2,32,5,-2,6,8,5,1,5,0,False,False,False,0,3,2021-12-13T12:43:19.33,6,False,1.0
2021,14,3269,330,6,3233,2,16,4,4,54,50,54,0,54,6,False,False,False,0,1,2021-12-13T12:45:26.003,54,True,0.0
2021,14,3269,345,12,556,13,29,6,20,0,0,0,0,0,0,False,False,False,0,2,2021-12-13T12:49:52.76,0,False,0.0
2021,14,3269,350,12,467,2,12,8,18,20,2,20,0,20,0,False,False,False,0,4,2021-12-13T12:51:45.98,20,False,0.0
2021,14,3269,355,12,6357,2,5,5,4,6,2,6,0,6,0,True,False,False,0,3,2021-12-13T12:54:46.477,6,False,0.0
2021,14,3269,360,12,6357,13,19,2,25,0,0,0,0,0,0,False,False,False,0,2,2021-12-13T12:59:14.033,0,False,0.0
2021,14,3269,370,12,556,13,3,5,9,0,0,0,0,0,0,False,False,False,0,2,2021-12-13T13:01:39.32,0,False,0.0
2021,14,3269,390,12,7743,2,32,5,1,13,12,8,5,8,0,False,False,False,0,3,2021-12-13T13:07:44.763,13,False,5.0
2021,14,3269,395,12,556,2,5,3,5,6,1,5,1,5,0,False,False,False,0,3,2021-12-13T13:09:55.07,6,False,1.0
2021,14,3269,400,12,6691,2,17,4,4,18,14,10,8,10,0,False,False,False,1,3,2021-12-13T13:12:33.207,18,False,8.0
2021,14,3269,410,12,556,2,24,6,29,38,9,38,0,38,6,False,False,False,1,3,2021-12-15T21:54:23.463,38,True,0.0
2021,14,3269,425,6,7725,3,4,9,5,0,0,0,0,0,0,False,False,False,0,2,2021-12-13T13:19:13.493,0,False,0.0
2021,14,3269,430,6,7728,2,32,3,3,6,3,6,0,6,0,False,False,False,0,3,2021-12-13T13:21:56.54,6,True,0.0
2021,14,3269,450,6,6786,2,45,5,-3,2,5,2,0,2,0,False,False,False,0,1,2021-12-13T13:28:16.417,2,True,0.0
2021,14,3269,485,12,556,2,51,9,1,12,11,1,11,1,0,True,False,False,0,3,2021-12-13T13:39:36.663,12,False,11.0
2021,14,3269,490,12,556,2,30,10,-1,16,17,14,2,14,0,False,False,False,0,3,2021-12-13T13:41:09.847,16,False,2.0
2021,14,3269,500,12,6357,2,51,10,0,8,8,6,2,6,0,True,False,False,0,3,2021-12-13T13:44:07.46,8,False,2.0
2021,14,3269,540,12,4537,2,17,3,10,23,13,21,2,21,6,False,False,False,0,1,2021-12-15T21:53:49.637,23,False,2.0
2021,14,3269,565,6,666,13,12,3,8,0,0,0,0,0,0,False,False,False,0,3,2021-12-15T21:54:38.807,0,False,0.0
2021,14,3269,575,12,556,2,8,10,11,16,5,16,0,16,0,False,False,False,0,3,2021-12-13T14:11:54.917,16,False,0.0
2021,14,3269,585,12,467,2,38,4,3,12,9,8,4,8,0,False,False,False,1,4,2021-12-13T14:17:11.383,12,False,4.0
2021,14,3269,605,12,6357,2,5,5,4,6,2,6,0,6,0,True,False,False,0,2,2021-12-13T14:25:10.803,6,False,0.0
2021,14,3269,625,6,4305,13,12,6,15,0,0,0,0,0,0,False,False,False,0,3,2022-02-24T18:43:53.813,0,False,0.0
2021,14,3269,630,6,4305,2,49,3,-4,8,12,6,2,6,0,False,False,False,0,2,2021-12-13T14:32:03.713,8,False,
2021,14,3269,635,6,7728,2,5,9,5,5,0,5,0,5,0,False,False,False,0,4,2021-12-13T14:34:00.08,5,False,0.0
2021,14,3269,640,6,6786,13,28,9,3,0,0,0,0,0,0,False,False,False,0,1,2021-12-13T14:36:49.067,0,False,0.0
2021,14,3269,655,12,6691,2,5,10,6,6,0,6,0,6,0,False,False,False,0,3,2021-12-13T14:40:30.577,6,False,0.0
2021,14,3269,660,12,6691,13,9,2,17,0,0,0,0,0,0,False,False,False,0,3,2021-12-13T14:42:40.34,0,False,0.0
2021,14,3269,680,6,464,13,4,9,4,0,0,0,0,0,0,False,False,False,0,3,2021-12-13T14:47:37.32,0,False,0.0
2021,14,3269,685,6,464,2,4,9,5,6,1,6,0,6,0,False,False,False,0,3,2021-12-13T14:49:20.3,6,False,0.0
2021,14,3269,710,12,556,2,5,3,4,8,4,6,2,6,0,True,False,False,0,3,2021-12-13T14:56:05.31,8,False,2.0
2021,14,3269,735,12,6691,2,5,3,7,11,4,9,2,9,0,True,False,False,0,3,2021-12-13T15:05:54.77,11,False,2.0
2021,14,3269,745,12,556,2,4,9,4,6,2,6,0,6,0,False,False,False,1,3,2021-12-13T15:11:58.5,6,False,0.0
2021,14,3269,750,12,556,2,47,5,3,4,1,4,0,4,0,False,False,False,0,3,2021-12-13T15:13:27.09,4,False,0.0
2021,14,3269,760,12,467,2,30,9,0,7,7,6,1,6,0,False,False,False,0,4,2021-12-13T15:17:24.007,7,False,1.0
2021,14,3269,770,12,556,2,2,10,3,3,0,3,0,3,6,False,False,False,0,2,2021-12-15T21:53:11.57,3,True,0.0
2021,14,3269,790,6,6786,2,16,9,5,13,8,11,2,11,0,False,False,False,0,1,2021-12-13T15:27:08.787,13,False,2.0
2021,14,3269,800,6,4305,13,4,9,9,0,0,0,0,0,0,False,False,False,0,3,2021-12-13T15:29:44.057,0,False,0.0
2021,14,3269,805,6,6786,2,28,5,0,5,5,4,1,4,0,False,False,False,0,1,2021-12-13T15:31:12.827,5,False,1.0
2021,14,3269,815,6,6786,2,4,4,5,11,6,9,2,9,0,False,False,False,0,1,2021-12-13T15:34:57.913,11,False,2.0
2021,14,3269,820,6,6786,3,16,4,5,0,0,0,0,0,0,False,False,False,0,1,2021-12-13T15:37:12.533,0,False,
2021,14,3269,825,6,1400,2,32,5,0,4,4,3,1,3,0,False,False,False,1,3,2021-12-13T15:39:42.84,4,False,1.0
2021,14,3269,835,6,6786,2,31,4,1,3,2,1,2,1,0,False,False,False,0,1,2021-12-13T15:41:56.703,3,False,2.0
2021,14,3269,840,6,464,13,12,2,18,0,0,0,0,0,0,False,False,False,0,2,2021-12-13T15:43:41.743,0,False,0.0
2021,14,3269,855,6,3233,2,12,2,22,22,0,22,0,22,0,False,False,False,0,2,2021-12-13T15:47:27.993,22,True,0.0
2021,14,3269,870,6,6786,2,32,3,3,5,2,5,0,5,0,False,False,False,0,3,2021-12-13T15:50:43.38,5,False,0.0
2021,14,3269,880,6,464,13,19,2,27,0,0,0,0,0,0,False,False,False,0,2,2021-12-13T15:52:30.753,0,False,0.0
2021,14,3269,885,6,7725,13,6,1,18,0,0,0,0,0,0,False,False,False,0,3,2022-02-22T19:02:44.367,0,False,0.0
2021,14,3270,25,1,894,2,4,9,11,14,3,14,0,14,0,False,False,False,0,3,2021-12-14T10:29:39.687,14,False,0.0
2021,14,3270,35,1,4587,2,45,5,-1,6,7,3,3,3,0,True,False,False,0,1,2021-12-14T10:32:44.317,6,False,3.0
2021,14,3270,40,1,910,2,4,5,9,17,8,9,8,9,0,False,False,False,1,2,2021-12-14T10:34:25.913,17,False,8.0
2021,14,3270,50,1,6405,13,5,2,18,0,0,0,0,0,0,False,False,False,0,2,2021-12-16T20:43:52.477,0,False,0.0
2021,14,3270,55,1,910,13,19,2,34,0,0,0,0,0,0,False,False,False,0,2,2021-12-14T10:40:08.44,0,False,0.0
2021,14,3270,70,29,7366,13,26,4,1,0,0,0,0,0,0,False,False,False,0,4,2021-12-14T10:43:38.317,0,False,0.0
2021,14,3270,80,29,8455,13,6,4,13,0,0,0,0,0,0,False,False,False,0,3,2021-12-14T10:48:52.013,0,False,0.0
2021,14,3270,95,1,245,13,35,6,24,0,0,0,0,0,0,False,False,False,0,3,2021-12-14T10:53:04.067,0,False,0.0
2021,14,3270,100,1,245,2,5,5,11,11,0,11,0,11,0,False,False,False,0,2,2021-12-14T10:54:29.757,11,False,0.0
2021,14,3270,110,1,245,2,4,9,12,14,2,12,2,12,0,False,False,False,0,2,2021-12-14T10:57:33.433,14,False,2.0
2021,14,3270,115,1,894,2,38,9,2,5,3,3,2,3,0,False,False,False,0,4,2021-12-14T10:59:11.98,5,False,2.0
2021,14,3270,120,1,8439,2,49,10,-4,7,11,4,3,4,0,False,False,False,1,2,2021-12-16T20:49:46.717,7,False,3.0
2021,14,3270,135,1,4587,2,12,5,-5,2,7,2,0,2,0,False,False,False,0,1,2021-12-14T11:07:41.37,2,False,0.0
2021,14,3270,140,1,4587,2,16,10,7,18,11,13,5,13,0,False,False,False,0,1,2021-12-14T11:09:23.237,18,False,5.0
2021,14,3270,150,1,894,13,17,10,3,0,0,0,0,0,0,False,False,False,0,4,2021-12-16T20:51:11.023,0,False,0.0
2021,14,3270,155,29,1067,2,4,5,2,5,3,4,1,4,0,False,False,False,0,2,2021-12-14T11:16:21.047,5,False,1.0
2021,14,3270,160,29,4866,2,5,5,13,13,0,13,0,13,0,False,False,False,0,3,2021-12-14T11:17:55.903,13,True,0.0
2021,14,3270,170,29,4866,2,30,5,2,1,-1,1,0,1,0,True,False,False,0,3,2021-12-14T11:20:59.937,1,False,0.0
2021,14,3270,175,29,4866,2,4,9,6,7,1,7,0,7,0,False,False,False,0,3,2021-12-14T11:22:30.563,7,False,0.0
2021,14,3270,180,29,4866,2,5,3,4,11,7,11,0,11,0,True,False,False,0,1,2021-12-14T11:24:00.42,11,False,0.0
2021,14,3270,200,29,4866,2,5,3,6,8,2,8,0,8,0,False,False,False,0,3,2021-12-16T02:47:35.57,8,False,0.0
2021,14,3270,205,29,1067,2,2,9,2,2,0,2,0,2,6,False,False,False,0,2,2021-12-14T11:30:30.297,2,True,0.0
2021,14,3270,220,1,8439,2,34,4,-4,-2,2,-2,0,-2,0,True,False,False,0,2,2021-12-14T11:34:12.517,-2,False,0.0
2021,14,3270,230,1,910,2,12,2,26,26,0,26,0,26,0,False,False,False,0,2,2021-12-14T15:31:11.07,26,False,
2021,14,3270,250,29,4866,13,19,2,39,0,0,0,0,0,0,False,False,False,0,3,2021-12-14T11:44:34.913,0,False,0.0
2021,14,3270,255,29,4866,2,50,9,-3,4,7,4,0,4,0,False,False,False,0,2,2021-12-14T15:30:44.33,4,False,
2021,14,3270,265,29,1067,2,6,8,17,17,0,17,0,17,0,False,False,False,0,3,2021-12-14T11:50:21.29,17,False,0.0
2021,14,3270,280,29,1067,13,2,10,3,0,0,0,0,0,0,False,False,False,0,2,2021-12-14T11:54:44.15,0,False,0.0
2021,14,3270,285,29,6266,13,48,10,-4,0,0,0,0,0,0,False,False,False,0,1,2021-12-14T11:56:11.32,0,False,0.0
2021,14,3270,300,1,4587,2,48,9,-4,10,14,-2,12,-2,0,False,False,False,1,1,2021-12-14T11:59:36.8,10,False,12.0
2021,14,3270,310,1,6405,2,7,6,39,41,2,40,1,40,0,False,False,False,0,2,2021-12-16T20:44:06.367,41,False,1.0
2021,14,3270,320,1,4587,2,12,9,11,13,2,11,2,11,0,False,False,False,0,1,2021-12-16T20:53:28.013,13,False,2.0
2021,14,3270,325,1,245,13,5,3,4,0,0,0,0,0,0,False,False,False,0,2,2021-12-16T20:42:43.173,0,False,0.0
2021,14,3270,330,1,245,13,9,3,4,0,0,0,0,0,0,False,False,False,0,2,2021-12-14T12:12:46.02,0,False,0.0
2021,14,3270,335,1,894,2,4,10,3,3,0,3,0,3,0,False,False,False,0,3,2021-12-14T12:14:25.797,3,False,0.0
2021,14,3270,360,29,7828,2,50,10,-3,6,9,4,2,4,0,False,False,False,0,3,2021-12-14T12:20:51.9,6,False,2.0
2021,14,3270,370,29,1067,2,13,9,2,40,38,40,0,40,0,False,False,False,0,3,2021-12-14T12:22:20.523,40,False,0.0
2021,14,3270,380,29,7366,2,26,10,6,6,0,6,0,6,0,False,False,False,0,4,2021-12-16T20:54:27.15,6,False,0.0
2021,14,3270,385,29,4866,2,50,3,-1,2,3,2,0,2,0,False,False,False,0,2,2021-12-14T12:27:06.193,2,False,0.0
2021,14,3270,405,1,910,2,4,5,9,9,0,9,0,9,0,False,False,False,0,2,2021-12-14T12:29:51,9,False,0.0
2021,14,3270,435,1,245,13,7,6,26,0,0,0,0,0,0,False,False,False,0,2,2021-12-16T19:44:57.217,0,False,0.0
2021,14,3270,475,29,4866,2,45,5,-5,6,11,6,0,6,0,True,False,False,0,3,2021-12-14T13:00:08.677,6,False,0.0
2021,14,3270,480,29,7828,2,8,1,50,52,2,52,0,52,6,False,False,False,0,3,2021-12-14T13:03:04.65,52,True,0.0
2021,14,3270,495,1,8439,2,50,9,-4,0,4,-1,1,-1,0,False,False,False,0,3,2021-12-16T20:59:14.503,0,False,1.0
2021,14,3270,500,1,894,13,35,3,5,0,0,0,0,0,0,False,False,False,0,3,2022-02-16T16:43:47.86,0,False,0.0
2021,14,3270,510,29,4866,2,5,9,4,4,0,4,0,4,0,False,False,False,0,3,2021-12-14T13:11:40.75,4,False,0.0
2021,14,3270,530,29,7828,13,6,4,8,0,0,0,0,0,0,False,False,False,0,3,2021-12-14T13:18:05.223,0,False,
2021,14,3270,535,29,4866,13,9,3,4,0,0,0,0,0,0,False,False,False,0,2,2021-12-14T13:20:25.493,0,False,0.0
2021,14,3270,540,29,4866,2,5,5,4,4,0,4,0,4,6,False,False,False,0,3,2021-12-14T13:22:10.503,4,True,0.0
2021,14,3270,560,1,910,2,4,5,5,5,0,5,0,5,0,False,False,False,0,2,2021-12-14T13:26:02.653,5,False,0.0
2021,14,3270,565,1,4587,2,26,10,4,12,8,8,4,8,0,False,False,False,0,3,2021-12-14T13:27:19.66,12,False,4.0
2021,14,3270,570,1,910,2,49,5,-2,6,8,6,0,6,0,False,False,False,0,2,2021-12-14T13:28:51.607,6,False,0.0
2021,14,3270,575,1,910,2,5,5,6,6,0,6,0,6,0,False,False,False,0,2,2021-12-14T13:30:19.727,6,True,0.0
2021,14,3270,580,1,4587,2,44,9,-2,7,9,6,1,6,0,False,False,False,2,1,2021-12-16T20:45:14.247,7,False,1.0
2021,14,3270,595,1,910,13,9,2,16,0,0,0,0,0,0,False,False,False,0,2,2021-12-14T13:38:15.883,0,False,0.0
2021,14,3270,610,1,245,3,2,9,6,0,0,0,0,0,0,False,False,False,0,2,2021-12-14T13:41:48.453,0,False,0.0
2021,14,3270,615,29,7366,2,35,7,20,23,3,22,1,22,0,False,False,False,0,3,2021-12-14T13:47:19.477,23,False,1.0
2021,14,3270,620,29,4866,2,26,10,-1,4,5,4,0,4,0,False,False,False,0,4,2021-12-14T13:49:04.54,4,False,0.0
2021,14,3270,645,1,8439,13,11,6,32,0,0,0,0,0,0,True,False,False,0,3,2021-12-14T13:57:49.363,0,False,0.0
2021,14,3270,650,1,910,2,12,2,21,23,2,22,1,22,0,False,False,False,0,3,2021-12-16T20:45:36.583,23,False,1.0
2021,14,3270,655,1,245,2,18,3,0,11,11,11,0,11,0,False,False,False,1,2,2021-12-14T14:02:17.517,11,False,
2021,14,3270,665,1,245,2,4,2,15,15,0,15,0,15,0,False,False,False,0,2,2021-12-14T14:06:38.21,15,False,0.0
2021,14,3270,670,1,910,2,9,2,20,36,16,26,10,26,0,False,False,False,1,2,2021-12-16T20:45:46.9,36,False,10.0
2021,14,3270,695,29,1067,2,5,6,17,17,0,17,0,17,0,False,False,False,0,3,2021-12-14T14:18:11.537,17,True,0.0
2021,14,3270,700,29,4866,2,51,10,-3,5,8,5,0,5,0,False,False,False,0,3,2021-12-14T14:19:45.08,5,True,
2021,14,3270,705,29,4866,2,8,6,35,44,9,41,3,41,0,False,False,False,0,3,2021-12-14T14:24:02.233,44,False,3.0
2021,14,3270,720,29,7828,13,19,2,19,0,0,0,0,0,0,False,False,False,0,3,2021-12-14T14:28:34.343,0,False,
2021,14,3270,725,29,4866,2,51,9,-3,7,10,5,2,5,0,False,False,False,1,3,2021-12-14T14:31:13.583,7,False,2.0
2021,14,3270,730,29,4866,2,16,10,7,12,5,10,2,10,0,False,False,False,0,3,2021-12-16T21:00:35.923,12,False,2.0
2021,14,3270,740,29,7828,13,2,4,7,0,0,0,0,0,0,False,False,False,0,3,2021-12-14T14:39:48.963,0,False,0.0
2021,14,3270,760,1,4587,2,48,10,-3,17,20,10,7,10,0,False,False,False,2,1,2021-12-14T14:47:07.66,17,False,7.0
2021,14,3270,765,1,894,2,6,9,12,12,0,12,0,12,0,False,False,False,0,4,2022-02-16T16:44:22.583,12,False,0.0
2021,14,3270,775,1,894,2,4,9,5,8,3,8,0,8,0,False,False,False,0,3,2021-12-14T14:50:33.433,8,False,0.0
2021,14,3270,780,1,6405,13,9,2,18,0,0,0,0,0,0,False,False,False,0,3,2022-02-25T15:59:19.04,0,False,0.0
2021,14,3270,820,29,1067,2,50,10,-3,-4,-1,-4,0,-4,0,False,False,False,0,2,2021-12-16T20:56:59.94,-4,False,0.0
2021,14,3270,830,1,6405,2,18,3,-2,-2,0,-2,0,-2,0,False,False,False,0,2,2021-12-14T15:03:42.423,-2,False,0.0
2021,14,3270,835,1,6405,13,4,10,10,0,0,0,0,0,0,False,False,False,0,3,2021-12-14T15:04:59.613,0,False,0.0
2021,14,3270,840,1,245,2,13,4,3,3,0,3,0,3,0,False,False,False,0,2,2021-12-14T15:06:29.413,3,False,0.0
2021,14,3270,850,1,6405,2,35,7,42,47,5,44,3,44,0,False,False,False,0,3,2021-12-14T15:08:15.337,47,False,3.0
2021,14,3270,860,1,245,13,19,6,29,0,0,0,0,0,0,False,False,False,0,2,2022-02-16T16:44:57.93,0,False,0.0
2021,14,3270,865,1,910,13,12,10,8,0,0,0,0,0,0,False,False,False,0,2,2021-12-14T15:12:28.047,0,False,0.0
2021,14,3270,870,1,245,2,5,3,9,11,2,11,0,11,0,False,False,False,0,2,2021-12-14T15:13:31.463,11,False,0.0
2021,14,3270,885,1,245,13,7,6,27,0,0,0,0,0,0,False,False,False,0,2,2021-12-16T20:46:21.057,0,False,0.0
2021,14,3270,915,1,4587,2,12,9,4,9,5,6,3,6,0,False,False,False,0,1,2021-12-14T15:27:27.277,9,False,3.0
2021,15,3271,20,26,4619,13,9,3,5,0,0,0,0,0,0,False,False,False,0,2,2021-12-17T10:38:25.393,0,False,0.0
2021,15,3271,25,26,4619,13,12,3,5,0,0,0,0,0,0,False,False,False,0,2,2022-02-22T20:43:39.037,0,False,0.0
2021,15,3271,30,26,4619,13,2,9,3,0,0,0,0,0,0,False,False,False,0,2,2021-12-17T10:44:26.707,0,False,0.0
2021,15,3271,35,26,7491,3,35,3,5,0,0,0,0,0,0,False,False,False,0,3,2022-02-16T21:03:08.363,0,False,0.0
2021,15,3271,40,16,3938,2,47,5,-1,12,13,11,1,11,0,True,False,False,1,4,2021-12-17T10:54:39.903,12,False,1.0
2021,15,3271,55,16,374,2,5,3,9,14,5,9,5,9,0,True,False,False,1,3,2021-12-21T16:31:01.11,14,False,5.0
2021,15,3271,60,16,3938,2,3,5,7,5,-2,5,0,5,0,False,False,False,0,3,2021-12-17T11:03:41.74,5,False,0.0
2021,15,3271,65,16,6500,2,5,9,2,9,7,6,3,6,0,False,False,False,0,2,2021-12-17T11:05:38.65,9,False,3.0
2021,15,3271,70,16,568,2,48,10,-3,20,23,17,3,17,0,False,False,False,0,1,2021-12-17T11:07:56.257,20,False,3.0
2021,15,3271,80,16,3938,2,39,9,2,11,9,9,2,9,0,False,False,False,0,3,2021-12-17T11:12:45.873,11,False,2.0
2021,15,3271,85,16,374,13,5,3,9,0,0,0,0,0,0,False,False,False,0,3,2021-12-17T11:14:26.337,0,False,0.0
2021,15,3271,110,26,4616,2,47,10,1,9,8,8,1,8,0,False,False,False,0,1,2021-12-17T11:20:40.317,9,False,1.0
2021,15,3271,120,26,958,13,32,5,3,0,0,0,0,0,0,False,False,False,0,3,2022-02-16T21:01:10.997,0,False,0.0
2021,15,3271,125,26,8553,2,4,9,4,4,0,4,0,4,0,False,False,False,0,4,2021-12-17T11:27:55.977,4,False,0.0
2021,15,3271,130,26,4050,2,6,9,12,12,0,12,0,12,0,False,False,False,0,4,2021-12-17T11:29:51.537,12,False,0.0
2021,15,3271,135,26,309,13,4,9,4,0,0,0,0,0,0,False,False,False,0,3,2021-12-17T11:32:02.2,0,False,0.0
2021,15,3271,145,16,7681,2,2,9,4,12,8,8,4,8,0,True,False,False,0,2,2021-12-17T11:39:19.617,12,False,4.0
2021,15,3271,155,16,374,2,53,4,-2,-1,1,-1,0,-1,0,True,False,False,0,4,2022-02-16T21:05:28.543,-1,False,0.0
2021,15,3271,170,16,374,2,12,10,10,17,7,14,3,14,0,False,False,False,1,3,2021-12-21T16:42:07.943,17,False,3.0
2021,15,3271,180,16,3938,2,50,10,-3,4,7,-3,7,-3,0,False,False,False,0,3,2021-12-17T11:54:10.623,4,False,7.0
2021,15,3271,190,16,6499,13,12,3,11,0,0,0,0,0,0,False,False,False,0,1,2022-02-22T20:49:57.043,0,False,0.0
2021,15,3271,215,26,958,2,35,9,7,12,5,9,3,9,0,False,False,False,0,4,2021-12-17T12:03:46.313,12,False,3.0
2021,15,3271,225,26,6301,2,12,5,5,13,8,9,4,9,0,False,False,False,0,1,2021-12-17T12:08:09.223,13,False,4.0
2021,15,3271,240,26,309,2,2,4,5,15,10,12,3,12,0,False,False,False,0,3,2021-12-17T12:13:01.647,15,False,3.0
2021,15,3271,270,16,4143,13,5,3,6,0,0,0,0,0,0,False,False,False,0,3,2022-02-16T21:05:41.19,0,False,0.0
2021,15,3271,275,16,7176,13,24,2,30,0,0,0,0,0,0,False,False,False,0,2,2021-12-17T12:23:45.29,0,False,0.0
2021,15,3271,325,26,7453,2,4,10,4,4,0,4,0,4,6,False,False,False,0,3,2021-12-17T12:41:08.943,4,True,0.0
2021,15,3271,340,16,3938,2,47,5,-1,3,4,2,1,2,0,True,False,False,0,4,2021-12-17T12:44:37.42,3,False,1.0
2021,15,3271,345,16,7681,2,44,3,-3,6,9,6,0,6,0,False,False,False,0,1,2021-12-17T12:46:13.083,6,False,0.0
2021,15,3271,365,26,4616,2,51,3,-5,2,7,1,1,1,0,True,False,False,0,1,2021-12-17T12:55:08.347,2,False,1.0
2021,15,3271,370,26,4619,2,29,2,23,27,4,23,4,23,0,False,False,False,0,2,2021-12-17T12:58:55.333,27,False,4.0
2021,15,3271,385,26,309,2,5,3,5,7,2,7,0,7,0,False,False,False,0,3,2021-12-17T13:04:33.907,7,True,0.0
2021,15,3271,400,26,958,3,47,10,0,0,0,0,0,0,0,True,False,False,0,3,2021-12-17T13:07:47.187,0,False,0.0
2021,15,3271,420,26,309,13,47,5,0,0,0,0,0,0,0,False,False,False,0,3,2021-12-17T13:12:05.857,0,False,0.0
2021,15,3271,435,16,3938,13,12,2,36,0,0,0,0,0,0,False,False,False,0,3,2021-12-17T13:18:28.97,0,False,
2021,15,3271,440,16,7176,2,4,3,4,5,1,5,0,5,0,False,False,False,0,2,2021-12-17T13:20:27.193,5,False,0.0
2021,15,3271,450,16,3938,2,7,6,20,23,3,23,0,23,0,False,False,False,0,3,2021-12-17T13:24:11.453,23,False,0.0
2021,15,3271,460,16,3938,13,44,3,-5,0,0,0,0,0,0,True,False,False,0,3,2021-12-17T13:28:00.673,0,False,0.0
2021,15,3271,465,16,6500,13,26,9,1,0,0,0,0,0,0,False,False,False,0,2,2021-12-17T13:29:58.72,0,False,0.0
2021,15,3271,480,26,4619,2,30,5,-1,5,6,5,0,5,0,False,False,False,0,3,2022-02-16T21:06:09.137,5,False,0.0
2021,15,3271,490,26,309,3,4,9,10,0,0,0,0,0,0,False,False,False,0,3,2021-12-17T13:36:33.313,0,False,0.0
2021,15,3271,495,26,4616,2,28,4,2,4,2,4,0,4,0,False,False,False,0,1,2021-12-17T13:38:58.65,4,False,0.0
2021,15,3271,505,26,4619,2,35,6,17,17,0,17,0,17,0,False,False,False,0,3,2022-02-16T21:06:21.553,17,False,0.0
2021,15,3271,515,26,4619,13,19,2,17,0,0,0,0,0,0,False,False,False,0,2,2021-12-17T13:47:34.943,0,False,0.0
2021,15,3271,520,26,7453,2,3,5,6,6,0,6,0,6,0,False,False,False,0,2,2021-12-17T13:49:23.553,6,False,0.0
2021,15,3271,525,26,958,13,5,9,4,0,0,0,0,0,0,False,False,False,0,3,2021-12-17T13:50:48.873,0,False,0.0
2021,15,3271,530,16,374,2,4,10,9,10,1,10,0,10,0,False,False,False,0,4,2021-12-17T13:53:13.94,10,False,0.0
2021,15,3271,535,16,2568,13,32,9,1,0,0,0,0,0,0,False,False,False,0,4,2021-12-17T13:56:07.493,0,False,0.0
2021,15,3271,540,16,4143,13,12,2,17,0,0,0,0,0,0,False,False,False,0,2,2021-12-17T13:57:41.68,0,False,0.0
2021,15,3271,545,16,3938,2,24,6,39,40,1,40,0,40,0,False,False,False,0,3,2021-12-17T14:00:53.303,40,False,0.0
2021,15,3271,555,16,3938,2,13,4,1,5,4,3,2,3,0,False,False,False,0,2,2021-12-17T14:03:59.857,5,False,2.0
2021,15,3271,560,16,6500,2,46,3,-1,3,4,2,1,2,0,False,False,False,0,3,2022-02-16T21:06:43.733,3,False,1.0
2021,15,3271,565,16,374,2,6,9,9,9,0,9,0,9,0,False,False,False,0,3,2022-02-16T21:07:04.703,9,False,0.0
2021,15,3271,575,16,568,2,55,4,-2,0,2,-1,1,-1,0,False,False,False,0,4,2022-02-16T21:07:26.513,0,False,1.0
2021,15,3271,580,16,7176,13,46,3,2,0,0,0,0,0,0,True,False,False,0,3,2021-12-17T14:14:32.187,0,False,0.0
2021,15,3271,610,26,309,2,11,6,28,29,1,29,0,29,0,True,False,False,0,3,2021-12-21T16:31:16.687,29,True,0.0
2021,15,3271,615,26,4050,13,11,3,14,0,0,0,0,0,0,True,False,False,0,1,2021-12-17T14:28:23.713,0,False,
2021,15,3271,620,26,4619,13,21,10,14,0,0,0,0,0,0,False,False,False,0,2,2021-12-17T14:30:47.787,0,False,0.0
2021,15,3271,630,26,4616,2,47,5,2,8,6,2,6,2,0,False,False,False,1,3,2021-12-21T16:01:17.157,8,False,6.0
2021,15,3271,655,16,7176,2,46,3,3,6,3,5,1,5,0,False,False,False,0,3,2021-12-21T15:37:34.347,6,False,1.0
2021,15,3271,665,16,7681,13,45,10,-5,0,0,0,0,0,0,False,False,False,0,1,2021-12-17T14:53:57.327,0,False,0.0
2021,15,3271,690,16,374,13,5,3,5,0,0,0,0,0,0,True,False,False,0,3,2021-12-17T14:58:57.42,0,False,0.0
2021,15,3271,695,16,374,2,7,2,20,69,49,35,34,35,0,True,False,False,2,3,2021-12-17T15:06:21.873,69,False,34.0
2021,15,3271,705,16,3938,2,35,9,1,1,0,1,0,1,6,False,False,False,0,3,2021-12-17T15:06:07.3,1,True,0.0
2021,15,3271,725,26,309,2,5,5,5,5,0,5,0,5,0,True,False,False,0,3,2021-12-21T17:01:03.183,5,False,0.0
2021,15,3271,740,26,8552,2,35,5,13,15,2,14,1,14,0,False,False,False,0,3,2021-12-17T15:17:35.41,15,False,1.0
2021,15,3271,750,26,958,2,30,10,4,15,11,10,5,10,0,False,False,False,1,4,2021-12-21T16:45:04.093,15,False,5.0
2021,15,3271,770,26,309,2,4,10,8,8,0,8,0,8,6,False,False,False,0,3,2021-12-21T17:01:59.933,8,True,0.0
2021,15,3271,785,16,374,2,4,10,5,5,0,5,0,5,0,True,False,False,0,4,2021-12-17T15:30:07.347,5,False,0.0
2021,15,3271,790,16,3938,2,2,10,7,10,3,8,2,8,0,False,False,False,0,2,2021-12-17T15:31:38.18,10,False,2.0
2021,15,3271,805,16,7681,13,44,3,-1,0,0,0,0,0,0,False,False,False,0,1,2021-12-17T15:34:23.753,0,False,0.0
2021,15,3271,810,16,3938,2,12,2,18,20,2,20,0,20,0,False,False,False,0,3,2021-12-17T15:36:09.017,20,False,0.0
2021,15,3271,825,16,374,2,12,5,7,7,0,7,0,7,6,False,False,False,0,3,2021-12-17T15:43:12.287,7,True,0.0
2021,15,3271,840,26,958,2,39,4,5,5,0,5,0,5,0,False,False,False,0,3,2021-12-17T15:44:57.733,5,False,0.0
2021,15,3271,845,26,309,2,12,3,14,14,0,14,0,14,0,False,False,False,0,3,2021-12-17T15:47:17.423,14,False,0.0
2021,15,3271,850,26,4619,13,19,6,16,0,0,0,0,0,0,False,False,False,0,2,2021-12-17T15:48:43.65,0,False,0.0
2021,15,3271,860,26,958,13,7,6,20,0,0,0,0,0,0,False,False,False,0,3,2021-12-17T15:51:55.38,0,False,0.0
2021,15,3271,865,26,309,13,19,2,53,0,0,0,0,0,0,False,False,False,0,2,2021-12-17T15:54:12.06,0,False,0.0
2021,15,3271,875,16,6500,2,35,5,8,10,2,10,0,10,0,False,False,False,0,3,2021-12-17T15:57:58.737,10,False,0.0
2021,15,3271,905,16,374,13,30,10,-3,0,0,0,0,0,0,False,False,False,0,4,2022-02-16T21:08:49.077,0,False,0.0
2021,15,3271,910,16,374,2,7,3,13,27,14,24,3,24,0,True,False,False,0,3,2021-12-17T16:04:52.507,27,False,3.0
2021,15,3271,920,16,3938,2,5,5,11,14,3,14,0,14,0,False,False,False,0,2,2021-12-21T17:05:47.353,14,False,0.0
2021,15,3271,925,16,374,2,13,9,5,34,29,34,0,34,6,False,False,False,2,3,2021-12-21T16:42:44.46,34,True,0.0
2021,15,3272,10,9,6436,2,4,5,8,9,1,8,1,8,0,False,False,False,0,2,2021-12-20T09:58:21.573,9,False,1.0
2021,15,3272,20,9,4467,2,31,10,1,11,10,6,5,6,0,False,False,False,0,4,2021-12-20T10:04:10.157,11,False,5.0
2021,15,3272,35,9,6436,2,2,10,4,4,0,4,0,4,0,False,False,False,0,2,2021-12-20T10:12:25.927,4,False,0.0
2021,15,3272,50,9,322,13,35,10,12,0,0,0,0,0,0,False,False,False,0,3,2021-12-22T15:50:18.213,0,False,0.0
2021,15,3272,65,9,322,13,3,5,13,0,0,0,0,0,0,False,False,False,0,2,2022-02-22T21:23:06.41,0,False,0.0
2021,15,3272,85,21,4422,2,13,9,4,8,4,6,2,6,0,False,False,False,0,3,2021-12-20T17:30:35.183,8,False,2.0
2021,15,3272,90,21,7090,13,24,2,33,0,0,0,0,0,0,False,False,False,0,2,2021-12-21T22:49:10.597,0,False,0.0
2021,15,3272,100,21,3680,13,21,6,2,0,0,0,0,0,0,True,False,False,0,3,2021-12-22T14:57:57.81,0,False,0.0
2021,15,3272,105,9,4202,13,49,3,-3,0,0,0,0,0,0,True,False,False,0,2,2021-12-22T14:29:29.883,0,False,0.0
2021,15,3272,155,21,6228,2,31,10,-6,2,8,-5,7,-5,0,False,False,False,1,1,2021-12-22T15:35:02.687,2,False,7.0
2021,15,3272,170,21,4492,13,9,5,13,0,0,0,0,0,0,False,False,False,0,3,2021-12-20T17:42:28.313,0,False,0.0
2021,15,3272,185,9,7183,2,51,10,-7,2,9,0,2,0,0,False,False,False,0,1,2022-02-16T21:25:37.69,2,False,2.0
2021,15,3272,200,9,6436,2,6,1,18,19,1,18,1,18,0,False,False,False,0,2,2021-12-20T11:41:31.37,19,False,1.0
2021,15,3272,210,9,7816,2,6,9,5,4,-1,4,0,4,0,False,False,False,0,3,2021-12-20T11:53:49.137,4,False,0.0
2021,15,3272,215,9,7816,2,12,3,9,9,0,9,0,9,0,False,False,False,0,3,2021-12-21T18:58:50.74,9,True,0.0
2021,15,3272,225,9,7816,3,51,5,-1,0,0,0,0,0,0,False,False,False,0,3,2021-12-20T12:07:38.22,0,False,0.0
2021,15,3272,245,21,7592,2,35,10,13,16,3,16,0,16,0,False,False,False,0,2,2021-12-22T14:06:43.047,16,False,0.0
2021,15,3272,260,21,3957,2,28,10,1,4,3,3,1,3,0,False,False,False,0,1,2021-12-22T14:52:02.34,4,False,1.0
2021,15,3272,275,9,6446,2,4,4,6,9,3,7,2,7,0,False,False,False,0,4,2021-12-20T13:05:52.717,9,False,2.0
2021,15,3272,285,9,4202,2,45,5,-1,6,7,1,5,1,0,False,False,False,1,1,2021-12-20T13:13:52.363,6,False,5.0
2021,15,3272,310,9,322,2,4,5,6,5,-1,5,0,5,0,False,False,False,0,2,2021-12-20T13:33:56.713,5,False,0.0
2021,15,3272,315,9,7816,2,2,4,8,11,3,10,1,10,0,False,False,False,0,3,2021-12-20T13:34:09.307,11,False,1.0
2021,15,3272,320,9,7816,3,35,10,13,0,0,0,0,0,0,False,False,False,0,3,2021-12-20T13:33:02.08,0,False,0.0
2021,15,3272,335,9,322,2,49,3,-2,3,5,1,2,1,0,False,False,False,0,2,2021-12-22T15:35:43.867,3,False,2.0
2021,15,3272,345,9,4202,2,47,5,0,3,3,2,1,2,0,True,False,False,0,4,2021-12-21T18:57:15.513,3,False,1.0
2021,15,3272,370,21,6228,2,48,9,-6,15,21,13,2,13,0,False,False,False,0,1,2021-12-20T13:50:05.287,15,False,2.0
2021,15,3272,375,21,6228,2,48,9,-7,0,7,-2,2,-2,0,False,False,False,0,1,2021-12-20T13:49:46.363,0,False,2.0
2021,15,3272,385,9,322,13,2,9,4,0,0,0,0,0,0,False,False,False,0,2,2021-12-20T13:54:36.48,0,False,0.0
2021,15,3272,390,9,6712,2,39,4,6,6,0,6,0,6,0,False,False,False,0,3,2021-12-20T13:56:08.89,6,False,0.0
2021,15,3272,400,9,6446,2,39,10,6,7,1,6,1,6,0,False,False,False,0,3,2021-12-22T15:39:59.407,7,False,1.0
2021,15,3272,410,9,6446,2,5,3,13,15,2,14,1,14,0,False,False,False,0,3,2021-12-20T14:01:24.06,15,False,1.0
2021,15,3272,415,9,6446,2,5,3,9,9,0,9,0,9,0,False,False,False,0,4,2021-12-20T14:03:52.88,9,False,0.0
2021,15,3272,450,21,4422,3,2,9,9,0,0,0,0,0,0,False,False,False,0,3,2022-02-16T21:24:56.637,0,False,0.0
2021,15,3272,455,21,4422,2,2,10,4,3,-1,3,0,3,0,False,False,False,0,2,2021-12-20T14:12:22.97,3,False,0.0
2021,15,3272,470,21,6228,13,47,10,1,0,0,0,0,0,0,False,False,False,0,1,2022-02-25T16:00:10.45,0,False,0.0
2021,15,3272,475,21,6228,13,48,10,-6,0,0,0,0,0,0,False,False,False,0,1,2021-12-20T14:27:19.837,0,False,0.0
2021,15,3272,500,9,7816,2,5,9,3,3,0,3,0,3,0,False,False,False,0,3,2021-12-20T14:33:17.43,3,False,0.0
2021,15,3272,505,9,7183,2,28,3,-2,7,9,3,4,3,0,False,False,False,1,1,2021-12-22T15:17:09.453,7,False,4.0
2021,15,3272,510,9,7183,2,28,3,-4,3,7,1,2,1,0,False,True,False,1,1,2021-12-20T17:35:40.86,4,False,2.0
2021,15,3272,520,9,7816,3,35,7,15,0,0,0,0,0,0,False,False,False,0,3,2021-12-20T14:42:34.167,0,False,0.0
2021,15,3272,525,9,6446,2,4,4,9,10,1,10,0,10,0,False,False,False,0,3,2021-12-20T14:44:28.8,10,False,0.0
2021,15,3272,540,9,6436,13,19,2,34,0,0,0,0,0,0,False,False,False,0,2,2021-12-20T14:51:31.29,0,False,0.0
2021,15,3272,555,21,3957,2,6,10,4,4,0,4,0,4,0,False,False,False,0,2,2021-12-20T14:57:03.537,4,False,0.0
2021,15,3272,560,21,3680,13,2,9,5,0,0,0,0,0,0,False,False,False,0,3,2021-12-20T14:59:32.953,0,False,
2021,15,3272,565,21,4492,13,2,9,6,0,0,0,0,0,0,False,False,False,0,2,2021-12-20T15:02:14.617,0,False,0.0
2021,15,3272,580,21,7090,2,4,3,9,9,0,9,0,9,0,False,False,False,0,2,2021-12-20T15:06:59.333,9,False,0.0
2021,15,3272,595,9,7816,2,4,9,3,16,13,8,8,8,0,False,False,False,1,3,2021-12-20T15:12:45.883,16,False,8.0
2021,15,3272,605,9,4467,2,26,10,4,10,6,7,3,7,0,False,False,False,0,4,2021-12-20T15:15:46.883,10,False,3.0
2021,15,3272,615,9,6446,2,6,9,1,1,0,1,0,1,6,True,False,False,0,4,2021-12-21T18:57:27.757,1,True,0.0
2021,15,3272,635,21,6228,3,46,5,1,0,0,0,0,0,0,False,False,False,0,1,2021-12-20T15:26:23.867,0,False,0.0
2021,15,3272,640,21,4422,2,6,10,13,15,2,13,2,13,0,True,False,False,0,3,2021-12-21T22:48:04.72,15,False,2.0
2021,15,3272,655,21,3680,13,23,8,31,0,0,0,0,0,0,False,False,False,0,3,2021-12-22T14:58:18.14,0,False,0.0
2021,15,3272,660,9,4202,2,46,9,1,11,10,7,4,7,0,False,False,False,0,1,2021-12-22T14:29:29.93,11,False,4.0
2021,15,3272,675,9,6446,2,31,9,5,7,2,6,1,6,0,True,False,False,0,4,2021-12-22T14:55:38.683,7,False,1.0
2021,15,3272,690,21,813,2,4,3,6,9,3,7,2,7,0,False,False,False,0,4,2021-12-20T16:03:07.143,9,False,2.0
2021,15,3272,705,21,4422,2,39,4,5,7,2,6,1,6,0,False,False,False,0,4,2021-12-20T17:33:06.54,7,False,1.0
2021,15,3272,710,21,4492,2,4,5,7,7,0,7,0,7,0,False,False,False,0,2,2021-12-20T16:06:52.193,7,False,0.0
2021,15,3272,730,21,6228,13,2,3,7,0,0,0,0,0,0,False,False,False,0,2,2022-02-25T16:00:28.983,0,False,0.0
2021,15,3272,735,21,4492,13,12,6,27,0,0,0,0,0,0,False,False,False,0,3,2021-12-20T21:48:48.553,0,False,0.0
2021,15,3272,745,9,6446,2,5,10,3,9,6,7,2,7,0,False,False,False,0,4,2022-02-16T21:25:23.867,9,False,2.0
2021,15,3272,750,9,7816,2,4,10,5,7,2,4,3,4,0,False,False,False,1,3,2021-12-22T16:00:25.147,7,False,3.0
2021,15,3272,780,9,6436,13,3,6,18,0,0,0,0,0,0,False,False,False,0,2,2021-12-20T16:44:47.427,0,False,0.0
2021,15,3272,790,21,3680,2,4,9,4,8,4,8,0,8,0,False,False,False,0,3,2021-12-20T16:47:38.563,8,False,0.0
2021,15,3272,795,21,7090,2,5,3,14,14,0,14,0,14,0,False,False,False,0,2,2021-12-20T16:49:29.923,14,True,0.0
2021,15,3272,805,21,6228,2,28,4,0,7,7,5,2,5,0,False,False,False,0,1,2021-12-20T16:53:37.977,7,False,2.0
2021,15,3272,810,21,3680,2,2,9,5,7,2,6,1,6,0,False,False,False,1,3,2021-12-22T15:21:51.787,7,False,1.0
2021,15,3272,830,21,3680,13,4,10,7,0,0,0,0,0,0,False,False,False,0,3,2021-12-20T16:58:25.213,0,False,0.0
2021,15,3272,835,21,3680,3,6,10,10,0,0,0,0,0,0,False,False,False,0,3,2021-12-20T17:00:18.347,0,False,0.0
2021,15,3272,840,21,4492,2,5,5,11,10,-1,11,-1,11,0,False,False,False,0,2,2021-12-20T17:02:54.277,10,False,-1.0
2021,15,3272,845,21,4492,2,19,2,30,36,6,32,4,32,0,False,False,False,0,2,2021-12-20T17:05:41.147,36,False,4.0
2021,15,3272,850,21,4492,13,21,5,14,0,0,0,0,0,0,False,False,False,0,2,2021-12-20T17:08:47.81,0,False,0.0
2021,15,3272,855,21,4492,13,12,3,14,0,0,0,0,0,0,False,False,False,0,2,2022-02-24T19:09:56.857,0,False,0.0
2021,15,3272,870,21,3389,13,6,9,5,0,0,0,0,0,0,False,False,False,0,3,2021-12-20T17:13:59.807,0,False,0.0
2021,15,3272,875,21,3389,13,5,3,4,0,0,0,0,0,0,False,False,False,0,3,2021-12-20T17:15:31.143,0,False,0.0
2021,15,3273,15,13,2407,13,4,9,7,0,0,0,0,0,0,False,False,False,0,3,2021-12-23T15:39:30.83,0,False,0.0
2021,15,3273,25,13,1116,2,4,9,7,10,3,10,0,10,0,False,False,False,0,3,2021-12-20T10:24:44.86,10,False,0.0
2021,15,3273,50,13,876,2,4,9,6,5,-1,5,0,5,0,False,False,False,0,3,2021-12-23T15:40:02.463,5,False,0.0
2021,15,3273,60,13,876,2,2,10,5,6,1,5,1,5,0,False,False,False,0,2,2021-12-20T10:43:20.07,6,False,1.0
2021,15,3273,75,13,2455,2,13,4,3,3,0,3,0,3,0,False,False,False,0,3,2021-12-20T10:51:36.007,3,False,0.0
2021,15,3273,85,13,8417,2,5,3,7,7,0,7,0,7,0,False,False,False,0,3,2021-12-20T10:56:45.42,7,False,0.0
2021,15,3273,90,13,876,2,2,4,11,22,11,19,3,19,6,False,False,False,0,2,2021-12-20T11:00:18.797,22,False,3.0
2021,15,3273,115,15,2757,2,11,3,11,30,19,27,3,27,0,False,False,False,0,4,2021-12-20T11:18:08.353,30,False,3.0
2021,15,3273,125,15,3750,2,38,10,2,11,9,10,1,10,0,False,False,False,0,4,2021-12-20T11:23:37.167,11,False,1.0
2021,15,3273,135,15,914,13,35,5,11,0,0,0,0,0,0,False,False,False,0,3,2021-12-20T11:23:20.997,0,False,0.0
2021,15,3273,180,15,4179,13,35,3,14,0,0,0,0,0,0,False,False,False,0,3,2021-12-20T11:45:28.023,0,False,0.0
2021,15,3273,185,15,2757,2,4,9,10,12,2,11,1,11,0,False,False,False,0,3,2021-12-20T11:47:26.467,12,False,1.0
2021,15,3273,205,15,4179,2,6,3,14,21,7,14,7,14,0,False,False,False,1,4,2021-12-20T11:59:09.44,21,False,7.0
2021,15,3273,215,15,914,2,2,9,7,9,2,8,1,8,0,False,False,False,0,2,2021-12-20T12:04:47.357,9,False,1.0
2021,15,3273,250,13,876,2,45,5,0,7,7,7,0,7,0,True,False,False,0,4,2021-12-23T15:50:18.323,7,True,0.0
2021,15,3273,255,13,8417,2,12,10,7,7,0,7,0,7,0,False,False,False,0,2,2022-02-24T19:11:16.73,7,False,0.0
2021,15,3273,275,15,7591,13,50,3,-1,0,0,0,0,0,0,False,False,False,0,2,2021-12-20T12:39:59.743,0,False,0.0
2021,15,3273,310,13,2407,2,50,9,-5,1,6,1,0,1,0,False,False,False,0,3,2021-12-20T12:56:56.277,1,False,0.0
2021,15,3273,315,13,876,2,4,9,5,7,2,7,0,7,0,False,False,False,0,3,2021-12-20T13:00:19.54,7,False,0.0
2021,15,3273,345,15,4179,2,2,9,6,8,2,7,1,7,0,False,False,False,0,3,2021-12-20T13:09:33.94,8,False,1.0
2021,15,3273,360,15,8099,2,28,4,0,3,3,3,0,3,0,False,False,False,0,1,2021-12-20T13:22:16.253,3,False,0.0
2021,15,3273,380,13,6528,2,4,10,6,6,0,6,0,6,0,False,False,False,0,4,2021-12-20T13:27:36.757,6,False,0.0
2021,15,3273,390,13,1510,3,38,10,2,0,0,0,0,0,0,False,False,False,0,1,2021-12-20T13:33:43.127,0,False,0.0
2021,15,3273,395,13,876,2,2,4,3,12,9,8,4,8,0,False,False,False,0,3,2021-12-20T13:33:26.677,12,False,4.0
2021,15,3273,410,13,2407,2,2,10,7,11,4,8,3,8,0,False,False,False,0,2,2021-12-20T13:36:47.247,11,False,3.0
2021,15,3273,440,15,4179,2,4,10,4,6,2,5,1,5,0,False,False,False,0,3,2021-12-23T15:54:00.623,6,False,1.0
2021,15,3273,460,13,876,13,35,2,23,0,0,0,0,0,0,False,False,False,0,3,2021-12-20T13:50:02.877,0,False,0.0
2021,15,3273,465,13,1116,2,7,6,22,33,11,28,5,28,0,False,False,False,0,3,2021-12-20T13:54:17.273,33,False,5.0
2021,15,3273,475,13,1510,13,5,10,4,0,0,0,0,0,0,False,False,False,0,3,2022-02-25T16:01:10.53,0,False,0.0
2021,15,3273,480,13,8417,13,7,5,7,0,0,0,0,0,0,False,False,False,0,3,2021-12-20T14:00:57.463,0,False,0.0
2021,15,3273,495,15,8099,2,44,3,-4,0,4,-1,1,-1,0,False,False,False,0,1,2021-12-20T14:44:09.327,0,False,
2021,15,3273,500,15,4886,2,2,9,4,5,1,5,0,5,0,False,False,False,0,2,2021-12-23T15:54:00.623,5,False,0.0
2021,15,3273,505,15,7591,2,51,5,-2,10,12,2,8,2,0,False,False,False,1,3,2021-12-20T14:18:51.917,10,False,8.0
2021,15,3273,510,15,7591,2,4,9,5,11,6,5,6,5,0,False,False,False,2,3,2021-12-20T14:21:42.26,11,False,6.0
2021,15,3273,525,15,4179,2,30,3,-2,2,4,1,1,1,0,True,False,False,0,4,2021-12-20T14:28:49.817,2,False,1.0
2021,15,3273,530,15,914,13,19,2,33,0,0,0,0,0,0,False,False,False,0,2,2021-12-20T14:31:58.693,0,False,0.0
2021,15,3273,535,15,7591,2,51,10,-3,11,14,3,8,3,0,False,False,False,1,3,2021-12-20T14:43:10.837,11,False,8.0
2021,15,3273,540,15,4179,2,2,9,1,4,3,3,1,3,0,False,False,False,1,2,2021-12-23T15:33:54.923,4,False,
2021,15,3273,545,15,7591,2,4,5,7,7,0,7,0,7,0,False,False,False,0,2,2021-12-20T14:49:21.087,7,False,0.0
2021,15,3273,550,15,4179,2,4,9,4,5,1,5,0,5,0,False,False,False,0,3,2022-01-06T18:23:26.567,5,False,0.0
2021,15,3273,555,15,957,13,12,6,20,0,0,0,0,0,0,False,False,False,0,3,2022-02-24T19:11:51.023,0,False,0.0
2021,15,3273,570,13,8417,13,5,3,12,0,0,0,0,0,0,False,False,False,0,3,2021-12-20T15:11:32.883,0,False,0.0
2021,15,3273,580,13,876,13,26,10,5,0,0,0,0,0,0,False,False,False,0,3,2021-12-20T15:16:07.453,0,False,0.0
2021,15,3273,595,15,8099,3,48,9,-1,0,0,0,0,0,0,False,False,False,0,1,2021-12-20T15:22:40.563,0,False,0.0
2021,15,3273,605,15,8099,2,32,5,2,5,3,4,1,4,0,False,False,False,0,3,2021-12-20T15:24:52.213,5,False,1.0
2021,15,3273,645,13,4662,2,46,3,1,2,1,1,1,1,0,False,False,False,0,4,2021-12-20T15:41:14.08,2,False,1.0
2021,15,3273,650,13,6528,13,5,3,8,0,0,0,0,0,0,False,False,False,0,4,2021-12-20T15:43:47.387,0,False,0.0
2021,15,3273,665,15,2757,2,31,4,5,7,2,6,1,6,0,False,False,False,0,4,2022-02-22T20:35:02.933,7,False,1.0
2021,15,3273,685,13,2407,13,4,10,4,0,0,0,0,0,0,False,False,False,0,3,2021-12-20T15:56:47.017,0,False,0.0
2021,15,3273,690,13,1510,2,38,4,3,6,3,4,2,4,0,False,False,False,0,1,2021-12-20T15:58:28.9,6,False,2.0
2021,15,3273,710,15,7591,3,2,3,6,0,0,0,0,0,0,False,False,False,0,2,2021-12-20T16:08:32.467,0,False,0.0
2021,15,3273,715,15,4179,13,4,5,13,0,0,0,0,0,0,False,False,False,0,3,2021-12-20T16:08:44.16,0,False,0.0
2021,15,3273,730,13,6528,2,6,7,18,18,0,18,0,18,0,False,False,False,0,4,2021-12-20T16:14:19.927,18,False,0.0
2021,15,3273,735,13,4662,2,46,3,0,3,3,0,3,0,0,False,False,False,1,4,2021-12-20T16:16:30.6,3,False,3.0
2021,15,3273,740,13,876,13,35,6,36,0,0,0,0,0,0,True,False,False,0,3,2022-02-22T20:38:38.93,0,False,0.0
2021,15,3273,745,13,1116,13,6,9,8,0,0,0,0,0,0,False,False,False,0,2,2022-02-25T16:01:42.34,0,False,0.0
2021,15,3273,770,15,4179,3,4,3,8,0,0,0,0,0,0,False,False,False,0,2,2021-12-20T16:32:10.507,0,False,0.0
2021,15,3273,815,13,876,2,50,9,-3,43,46,43,0,43,6,False,False,False,0,3,2021-12-23T15:33:07.05,43,True,0.0
2021,15,3273,830,15,914,2,4,3,5,5,0,5,0,5,0,False,False,False,0,2,2021-12-20T17:01:39.64,5,False,0.0
2021,15,3273,835,15,7591,3,5,3,4,0,0,0,0,0,0,False,False,False,0,3,2021-12-20T17:02:01.54,0,False,0.0
2021,15,3273,845,15,7591,2,6,3,3,6,3,5,1,5,0,False,False,False,0,2,2021-12-23T15:45:32.48,6,False,
2021,15,3273,850,15,8099,2,32,5,0,5,5,5,0,5,0,False,False,False,0,1,2021-12-20T17:07:39.283,5,False,0.0
2021,15,3273,855,15,4179,2,6,9,14,15,1,14,1,14,0,False,False,False,0,2,2021-12-20T17:16:01.78,15,False,1.0
2021,15,3273,870,15,4886,13,12,3,3,0,0,0,0,0,0,False,False,False,0,1,2022-02-24T19:12:12.42,0,False,0.0
2021,15,3273,880,15,957,2,12,3,11,11,0,11,0,11,0,False,False,False,0,2,2022-02-24T19:12:33.847,11,False,0.0
2021,15,3273,885,15,957,3,46,3,3,0,0,0,0,0,0,False,False,False,0,3,2021-12-20T17:24:29.407,0,False,0.0
2021,15,3273,890,15,2757,2,32,5,3,11,8,6,5,6,0,False,False,False,1,4,2021-12-20T17:27:08.68,11,False,5.0
2021,15,3274,10,25,7060,2,35,10,8,16,8,14,2,14,0,False,False,False,1,3,2021-12-20T11:23:19.78,16,False,2.0
2021,15,3274,20,25,8421,13,55,10,-5,0,0,0,0,0,0,False,False,False,0,1,2021-12-20T10:26:59.3,0,False,0.0
2021,15,3274,25,25,7666,13,29,2,18,0,0,0,0,0,0,False,False,False,0,2,2021-12-20T10:28:27.92,0,False,0.0
2021,15,3274,45,31,4545,2,48,10,-4,7,11,3,4,3,0,False,False,False,0,1,2021-12-20T10:59:56.72,7,False,4.0
2021,15,3274,55,25,6259,13,4,9,5,0,0,0,0,0,0,False,False,False,0,4,2021-12-20T11:06:56.597,0,False,0.0
2021,15,3274,60,25,6486,13,12,8,23,0,0,0,0,0,0,False,False,False,0,2,2021-12-22T17:15:39.74,0,False,0.0
2021,15,3274,65,25,7060,2,6,9,4,4,0,2,2,2,0,False,False,False,1,2,2021-12-20T11:11:10.667,4,False,2.0
2021,15,3274,80,31,6722,2,4,3,5,5,0,5,0,5,0,False,False,False,0,2,2022-02-22T21:36:29.643,5,False,0.0
2021,15,3274,90,31,2865,13,4,4,10,0,0,0,0,0,0,False,False,False,0,3,2021-12-20T17:35:04.18,0,False,0.0
2021,15,3274,95,31,4545,2,47,5,2,11,9,8,3,8,0,False,False,False,1,1,2021-12-22T17:16:01.687,11,False,3.0
2021,15,3274,125,25,8421,13,48,9,-2,0,0,0,0,0,0,False,False,False,0,1,2021-12-20T11:45:13.427,0,False,0.0
2021,15,3274,135,31,7913,2,6,4,12,12,0,12,0,12,0,False,False,False,0,3,2021-12-20T11:49:26.8,12,False,0.0
2021,15,3274,150,31,2901,2,30,5,1,1,0,1,0,1,0,False,False,False,0,4,2021-12-20T11:55:03.483,1,False,0.0
2021,15,3274,160,31,4844,3,48,10,-4,0,0,0,0,0,0,False,False,False,0,1,2021-12-20T12:00:31.367,0,False,0.0
2021,15,3274,175,31,6722,3,16,10,3,0,0,0,0,0,0,True,False,False,0,1,2022-02-22T21:40:12.65,0,False,0.0
2021,15,3274,185,31,6722,2,6,9,3,4,1,4,0,4,0,False,False,False,0,1,2021-12-20T12:14:26.23,4,False,0.0
2021,15,3274,210,25,7060,2,49,5,-3,6,9,1,5,1,0,False,False,False,1,2,2021-12-20T12:25:31.797,6,False,5.0
2021,15,3274,225,25,8421,2,28,9,0,3,3,1,2,1,0,False,False,False,3,1,2021-12-20T12:31:15.827,3,False,2.0
2021,15,3274,245,31,6724,2,4,10,5,8,3,7,1,7,0,True,True,True,0,3,2021-12-20T12:42:23.903,8,False,1.0
2021,15,3274,250,25,6259,2,34,4,-4,-6,-2,-6,0,-6,0,True,False,False,0,3,2021-12-22T15:57:15.817,0,False,0.0
2021,15,3274,265,25,8422,2,5,10,5,11,6,6,5,6,0,False,False,False,2,4,2021-12-22T15:59:36.973,11,False,5.0
2021,15,3274,270,25,6259,13,9,2,17,0,0,0,0,0,0,False,False,False,0,3,2021-12-20T12:57:53.167,0,False,0.0
2021,15,3274,285,31,7913,3,19,2,38,0,0,0,0,0,0,False,False,False,0,2,2021-12-20T13:02:33.21,0,False,0.0
2021,15,3274,295,31,4834,2,13,9,4,5,1,5,0,5,0,False,False,False,0,3,2021-12-20T13:05:26.71,5,False,0.0
2021,15,3274,305,31,4844,2,47,5,5,18,13,15,3,15,0,False,False,False,0,3,2021-12-21T17:58:11.163,18,False,3.0
2021,15,3274,315,31,4545,2,4,4,3,7,4,6,1,6,0,False,False,False,0,1,2021-12-20T13:12:49.073,7,False,1.0
2021,15,3274,325,31,7913,13,19,2,30,0,0,0,0,0,0,False,False,False,0,2,2021-12-26T15:48:28.51,0,False,0.0
2021,15,3274,335,31,4844,2,45,10,-5,9,14,4,5,4,0,False,False,False,1,1,2021-12-20T13:28:59.527,9,False,5.0
2021,15,3274,345,31,2865,13,12,6,18,0,0,0,0,0,0,False,False,False,0,4,2022-02-24T19:14:06.093,0,False,
2021,15,3274,355,31,3911,2,50,9,-4,13,17,7,6,7,0,True,False,False,0,3,2021-12-22T17:18:38.53,13,False,6.0
2021,15,3274,365,31,6724,2,4,4,9,11,2,10,1,10,0,False,False,False,0,3,2021-12-20T13:43:53.583,11,False,1.0
2021,15,3274,370,31,661,13,16,10,4,0,0,0,0,0,0,False,False,False,0,3,2021-12-20T13:45:47.077,0,False,0.0
2021,15,3274,380,31,7913,2,5,10,5,5,0,5,0,5,0,False,False,False,0,3,2021-12-20T14:26:20.97,5,False,0.0
2021,15,3274,405,25,8422,2,4,4,6,14,8,12,2,12,0,False,False,False,0,4,2021-12-20T13:52:02.693,14,False,2.0
2021,15,3274,415,25,8422,2,4,10,4,7,3,7,0,7,0,False,False,False,0,4,2021-12-20T13:54:10.897,7,False,0.0
2021,15,3274,430,25,6486,2,5,2,17,19,2,19,0,19,0,False,False,False,0,2,2021-12-20T13:55:47.7,19,True,0.0
2021,15,3274,465,31,6722,2,48,10,-4,-4,0,-4,0,-4,0,False,False,False,0,1,2022-02-16T21:36:08.72,-4,False,0.0
2021,15,3274,490,25,7666,13,19,2,35,0,0,0,0,0,0,False,False,False,0,2,2021-12-20T14:33:52.443,0,False,
2021,15,3274,495,25,7666,3,50,3,-1,0,0,0,0,0,0,False,False,False,0,2,2021-12-20T14:35:34.423,0,False,0.0
2021,15,3274,500,25,8421,2,28,9,-4,5,9,4,1,4,0,False,False,False,0,1,2021-12-20T14:36:53.66,5,False,1.0
2021,15,3274,520,31,4834,13,21,6,49,0,0,0,0,0,0,False,False,False,0,3,2021-12-22T17:14:41.653,0,False,0.0
2021,15,3274,525,31,3911,2,50,10,-5,-3,2,-3,0,-3,0,True,False,False,0,3,2021-12-20T14:46:02.723,-3,False,0.0
2021,15,3274,540,25,7060,13,19,2,38,0,0,0,0,0,0,False,False,False,0,2,2022-02-16T21:37:27.577,0,False,
2021,15,3274,555,25,8422,2,13,9,5,5,0,5,0,5,0,False,False,False,1,4,2021-12-22T16:48:09.21,5,False,0.0
2021,15,3274,560,25,7053,2,53,9,-3,17,20,9,8,9,0,False,False,False,2,4,2021-12-22T17:51:04.027,17,False,8.0
2021,15,3274,570,25,7666,13,29,3,10,0,0,0,0,0,0,False,False,False,0,2,2021-12-20T15:18:01.233,0,False,
2021,15,3274,625,31,7913,13,7,8,18,0,0,0,0,0,0,False,False,False,0,4,2021-12-20T15:29:16.143,0,False,0.0
2021,15,3274,630,31,8333,2,13,9,3,3,0,3,0,3,0,False,True,True,0,3,2021-12-20T15:31:49.507,-1,False,0.0
2021,15,3274,640,25,6486,2,5,5,10,12,2,11,1,11,0,False,False,False,0,2,2021-12-20T15:36:34.52,12,False,1.0
2021,15,3274,650,25,8421,13,48,10,-2,0,0,0,0,0,0,True,False,False,0,1,2021-12-20T15:38:37.183,0,False,0.0
2021,15,3274,655,25,6486,2,4,9,5,7,2,7,0,7,0,False,True,True,0,2,2021-12-20T15:43:37.127,7,False,
2021,15,3274,670,25,6486,2,4,9,4,5,1,5,0,5,0,False,False,False,0,2,2021-12-20T15:51:04.807,5,False,0.0
2021,15,3274,675,25,6486,13,36,4,10,0,0,0,0,0,0,False,False,False,0,3,2021-12-20T15:53:28.433,0,False,0.0
2021,15,3274,705,31,2865,2,5,5,5,5,0,5,0,5,0,False,False,False,0,3,2021-12-20T16:08:44.173,5,False,0.0
2021,15,3274,710,31,3911,2,4,4,9,12,3,10,2,10,0,False,False,False,0,3,2021-12-26T16:26:03.377,12,False,2.0
2021,15,3274,725,31,6722,13,46,9,-4,0,0,0,0,0,0,False,False,False,0,1,2021-12-20T16:18:50.38,0,False,0.0
2021,15,3274,730,25,7060,2,50,5,-3,8,11,6,2,6,0,False,False,False,0,2,2021-12-20T16:22:03.16,8,False,2.0
2021,15,3274,775,25,7060,2,13,10,-2,4,6,4,0,4,0,False,False,False,0,2,2021-12-20T16:38:52.777,4,False,0.0
2021,15,3274,815,31,6722,2,4,4,5,5,0,5,0,5,0,False,False,False,0,1,2021-12-20T16:51:17.593,5,False,0.0
2021,15,3274,835,31,7913,2,4,9,8,9,1,8,1,8,0,False,False,False,0,3,2021-12-22T17:52:06.42,9,False,1.0
2021,15,3274,860,31,3911,2,5,3,8,8,0,8,0,8,0,False,False,False,0,3,2021-12-20T17:17:51.463,8,False,0.0
2021,15,3274,870,31,7913,2,4,10,4,6,2,6,0,6,0,False,False,False,0,2,2021-12-22T17:29:32.94,6,False,0.0
2021,15,3275,15,3,6936,2,30,3,-3,3,6,3,0,3,0,True,False,False,0,4,2021-12-20T12:40:44.803,3,False,0.0
2021,15,3275,20,3,6454,2,2,9,6,43,37,7,36,7,0,False,False,False,1,3,2021-12-22T17:30:38.527,43,False,36.0
2021,15,3275,35,3,6936,2,4,9,5,5,0,5,0,5,0,False,False,False,0,3,2021-12-22T17:40:29.383,5,False,0.0
2021,15,3275,40,3,7672,2,5,3,5,5,0,5,0,5,0,False,False,False,0,2,2021-12-20T12:48:57.31,5,True,0.0
2021,15,3275,60,3,6454,2,5,5,1,4,3,2,2,2,0,False,False,False,0,3,2021-12-20T12:56:24.58,4,False,2.0
2021,15,3275,70,3,6936,13,13,5,3,0,0,0,0,0,0,False,False,False,0,3,2021-12-20T12:59:57.383,0,False,0.0
2021,15,3275,75,3,306,13,12,5,2,0,0,0,0,0,0,False,False,False,0,1,2021-12-22T01:04:32.39,0,False,0.0
2021,15,3275,95,12,556,13,20,6,22,0,0,0,0,0,0,False,False,False,0,2,2021-12-20T13:07:51.293,0,False,0.0
2021,15,3275,105,3,6454,13,4,10,5,0,0,0,0,0,0,False,False,False,0,2,2021-12-20T13:12:28.333,0,False,0.0
2021,15,3275,110,3,6454,2,35,9,14,22,8,16,6,16,0,False,False,False,0,3,2021-12-20T13:14:49.94,22,False,6.0
2021,15,3275,125,3,7673,2,2,10,7,8,1,8,0,8,0,False,False,False,0,3,2021-12-20T13:19:34.913,8,False,0.0
2021,15,3275,130,3,6936,2,46,3,-2,4,6,4,0,4,0,True,False,False,0,3,2021-12-20T13:21:02.957,4,False,0.0
2021,15,3275,135,3,6454,2,12,10,8,8,0,8,0,8,6,False,False,False,0,4,2021-12-22T01:05:24.847,8,True,0.0
2021,15,3275,155,12,6691,2,2,10,6,17,11,13,4,13,0,False,False,False,1,3,2021-12-20T13:28:53.93,17,False,4.0
2021,15,3275,170,12,6691,2,5,5,5,6,1,5,1,5,0,False,False,False,0,3,2021-12-20T13:33:03.853,6,False,1.0
2021,15,3275,180,12,556,2,51,9,-1,11,12,8,3,8,0,False,False,False,0,3,2021-12-20T13:35:55.527,11,False,3.0
2021,15,3275,185,12,6357,2,7,2,28,31,3,31,0,31,0,False,False,False,0,3,2021-12-22T17:33:25.927,31,False,0.0
2021,15,3275,190,12,7743,13,9,6,18,0,0,0,0,0,0,False,False,False,0,2,2021-12-20T13:41:14.327,0,False,
2021,15,3275,195,12,467,2,32,3,3,7,4,4,3,4,0,False,False,False,0,4,2021-12-20T13:44:12.893,7,False,3.0
2021,15,3275,215,3,6454,13,12,2,25,0,0,0,0,0,0,False,False,False,0,4,2021-12-22T01:04:46.087,0,False,0.0
2021,15,3275,230,3,8430,13,21,6,39,0,0,0,0,0,0,False,False,False,0,2,2021-12-22T16:29:36.027,0,False,0.0
2021,15,3275,235,3,6936,2,4,5,5,7,2,6,1,6,0,False,False,False,0,2,2021-12-20T14:04:14.013,7,False,1.0
2021,15,3275,240,3,6454,2,52,9,1,9,8,4,5,4,0,False,False,False,0,2,2021-12-22T17:34:57.263,9,False,5.0
2021,15,3275,250,3,713,2,47,5,1,2,1,2,0,2,0,True,False,False,0,1,2021-12-20T14:08:26.14,2,False,0.0
2021,15,3275,255,3,7672,2,2,10,4,7,3,5,2,5,0,False,False,False,0,2,2021-12-20T14:10:10.227,7,False,2.0
2021,15,3275,260,3,7672,2,34,4,-4,1,5,-1,2,-1,0,True,False,False,0,3,2021-12-20T14:11:43.243,1,False,2.0
2021,15,3275,265,3,6454,2,35,3,9,9,0,9,0,9,6,False,False,False,0,3,2021-12-22T17:19:44.193,9,True,0.0
2021,15,3275,285,12,7593,2,17,1,16,22,6,18,4,18,0,False,False,False,0,4,2022-02-16T19:05:31.843,22,False,4.0
2021,15,3275,295,12,467,2,12,3,4,10,6,5,5,5,0,False,False,False,1,4,2022-02-24T19:17:59.59,10,False,5.0
2021,15,3275,305,12,4537,2,47,5,-1,3,4,2,1,2,0,False,False,False,0,1,2021-12-20T14:24:42.01,3,False,1.0
2021,15,3275,315,12,7742,2,46,3,0,13,13,5,8,5,0,False,False,False,1,1,2021-12-20T14:27:52.54,13,False,8.0
2021,15,3275,325,12,7743,13,13,3,2,0,0,0,0,0,0,False,False,False,0,4,2021-12-22T01:05:38.957,0,False,0.0
2021,15,3275,335,12,556,2,5,3,3,3,0,3,0,3,6,False,False,False,0,3,2021-12-20T14:34:10.7,3,True,0.0
2021,15,3275,350,3,6936,13,4,5,5,0,0,0,0,0,0,False,False,False,0,2,2021-12-22T17:29:37.823,0,False,0.0
2021,15,3275,375,12,6357,2,17,1,17,24,7,18,6,18,0,False,False,False,0,3,2021-12-20T14:42:41.003,24,False,6.0
2021,15,3275,395,12,7743,3,5,5,9,0,0,0,0,0,0,False,False,False,0,3,2021-12-20T14:45:51.107,0,False,0.0
2021,15,3275,400,12,6357,13,8,6,31,0,0,0,0,0,0,False,False,False,0,3,2021-12-20T14:47:27.09,0,False,0.0
2021,15,3275,430,12,6357,13,8,1,49,0,0,0,0,0,0,False,False,False,0,3,2021-12-20T15:30:23.163,0,False,0.0
2021,15,3275,435,12,556,2,5,3,3,6,3,5,1,5,0,True,False,False,0,3,2021-12-20T15:31:42.207,6,False,1.0
2021,15,3275,455,12,7743,2,47,10,1,1,0,1,0,1,0,True,False,False,0,4,2021-12-22T17:37:02.23,1,False,0.0
2021,15,3275,470,12,556,2,8,10,12,16,4,15,1,15,0,False,False,False,0,2,2021-12-20T15:47:48.25,16,False,1.0
2021,15,3275,480,12,6872,13,5,5,10,0,0,0,0,0,0,False,False,False,0,2,2021-12-20T15:50:51.08,0,False,0.0
2021,15,3275,485,12,6691,3,5,5,12,0,0,0,0,0,0,True,False,False,0,3,2021-12-20T15:53:17.103,0,False,
2021,15,3275,490,12,4537,2,12,3,9,9,0,9,0,9,6,False,False,False,0,1,2022-02-24T19:18:22.693,9,True,0.0
2021,15,3275,525,3,6454,2,4,3,9,12,3,9,3,9,0,False,False,False,0,2,2021-12-20T16:08:20.11,12,False,3.0
2021,15,3275,535,3,6936,13,26,10,6,0,0,0,0,0,0,False,False,False,0,2,2021-12-22T01:04:05.46,0,False,0.0
2021,15,3275,540,3,8430,2,4,9,5,5,0,5,0,5,0,False,False,False,0,2,2021-12-20T16:13:00.13,5,False,0.0
2021,15,3275,565,12,6357,2,4,3,1,7,6,5,2,5,0,False,False,False,0,2,2021-12-20T16:20:44.783,7,False,2.0
2021,15,3275,570,12,7743,2,30,3,0,6,6,3,3,3,0,False,False,False,0,4,2021-12-20T18:40:03.15,6,False,3.0
2021,15,3275,585,12,7743,2,54,9,-1,9,10,6,3,6,0,False,False,False,0,4,2021-12-22T16:29:36.06,9,False,3.0
2021,15,3275,610,12,6357,2,6,4,14,25,11,23,2,23,0,True,False,False,0,2,2021-12-20T16:36:54.457,25,False,2.0
2021,15,3275,615,12,556,2,13,10,3,14,11,14,0,14,0,False,False,False,0,3,2021-12-22T17:39:36.877,14,True,0.0
2021,15,3275,620,12,6691,13,35,5,11,0,0,0,0,0,0,False,False,False,0,3,2021-12-20T16:41:07.627,0,False,0.0
2021,15,3275,625,12,6357,2,2,9,7,11,4,8,3,8,6,False,False,False,0,2,2021-12-20T16:43:12.613,11,False,3.0
2021,15,3275,645,3,6936,13,5,6,17,0,0,0,0,0,0,False,False,False,0,2,2021-12-20T16:55:43.207,0,False,0.0
2021,15,3275,655,3,6454,13,35,7,17,0,0,0,0,0,0,False,False,False,0,3,2021-12-20T16:58:43.28,0,False,0.0
2021,15,3275,660,3,306,3,12,10,-7,0,0,0,0,0,0,False,False,False,0,1,2022-02-16T19:06:52.78,0,False,0.0
2021,15,3275,665,12,467,2,32,3,0,23,23,7,16,7,0,False,False,False,4,4,2021-12-22T17:27:38.793,23,False,16.0
2021,15,3275,680,12,556,2,30,3,-10,-6,4,-7,1,-7,0,False,False,False,0,3,2021-12-20T17:06:41.78,-6,False,1.0
2021,15,3275,690,12,6691,13,9,5,11,0,0,0,0,0,0,False,False,False,0,3,2021-12-20T17:08:25.877,0,False,0.0
2021,15,3275,705,3,6936,13,6,8,16,0,0,0,0,0,0,False,False,False,0,3,2021-12-22T17:51:07.96,0,False,
2021,15,3275,710,3,8434,2,5,3,5,5,0,5,0,5,0,False,False,False,0,3,2021-12-20T17:24:10.897,5,False,0.0
2021,15,3275,715,3,6936,2,5,5,3,3,0,3,0,3,0,False,False,False,0,3,2021-12-20T17:25:22.303,3,False,0.0
2021,15,3275,725,3,6936,2,4,5,5,5,0,5,0,5,0,False,False,False,0,2,2021-12-20T17:28:59.407,5,False,0.0
2021,15,3275,735,3,6936,2,4,5,4,5,1,4,1,4,0,False,False,False,0,2,2021-12-20T17:36:01.46,5,False,1.0
2021,15,3275,745,3,6936,2,5,5,5,5,0,5,0,5,0,False,False,False,0,2,2021-12-20T17:39:00.997,5,False,0.0
2021,15,3275,750,3,6936,2,2,10,2,6,4,6,0,6,0,False,False,False,0,2,2021-12-22T16:29:36.06,6,False,
2021,15,3275,755,3,6936,2,42,4,3,3,0,3,0,3,0,False,False,False,0,3,2021-12-20T17:41:57.05,3,False,0.0
2021,15,3275,760,3,8434,13,13,9,3,0,0,0,0,0,0,False,False,False,0,3,2021-12-20T17:43:18.217,0,False,0.0
2021,15,3275,765,3,6454,2,2,4,6,11,5,6,5,6,0,False,False,False,0,3,2021-12-20T17:45:05.643,11,False,5.0
2021,15,3275,815,3,6936,2,4,5,3,3,0,3,0,3,0,False,False,False,0,2,2021-12-20T18:06:48.16,3,False,0.0
2021,15,3275,830,3,6454,2,2,10,5,6,1,6,0,6,0,False,False,False,0,3,2021-12-20T18:13:07.873,6,False,0.0
2021,15,3275,835,3,6454,2,4,10,12,12,0,12,0,12,0,False,False,False,0,3,2021-12-22T17:29:57.807,12,False,0.0
2021,15,3275,845,3,306,2,47,5,-1,3,4,1,2,1,0,False,False,False,0,1,2021-12-20T18:17:16.393,3,False,2.0
2021,15,3276,20,11,8359,2,4,10,4,4,0,4,0,4,0,False,False,False,0,3,2021-12-21T23:11:31.077,4,False,0.0
2021,15,3276,25,11,8359,2,5,5,5,5,0,5,0,5,0,False,False,False,0,4,2021-12-20T10:42:23.627,5,False,0.0
2021,15,3276,40,11,8641,13,31,4,2,0,0,0,0,0,0,False,False,False,0,3,2021-12-23T19:08:52.49,0,False,0.0
2021,15,3276,45,11,4037,2,6,10,7,15,8,13,2,13,0,False,False,False,0,3,2021-12-23T18:52:32.127,15,False,2.0
2021,15,3276,55,11,4037,2,46,3,5,5,0,5,0,5,0,True,False,False,0,3,2022-02-22T20:14:23.483,5,False,0.0
2021,15,3276,60,11,4875,2,6,4,13,13,0,13,0,13,0,False,False,False,0,2,2021-12-23T19:17:14.177,13,False,0.0
2021,15,3276,75,11,8359,2,5,10,5,5,0,5,0,5,0,False,False,False,0,1,2021-12-23T18:52:44.023,5,False,0.0
2021,15,3276,100,1,6933,2,2,9,5,6,1,6,0,6,0,False,False,False,0,2,2021-12-20T11:08:32.443,6,False,0.0
2021,15,3276,110,1,8439,2,32,10,-2,-1,1,-2,1,-2,0,False,False,False,0,3,2021-12-20T11:10:22.097,-1,False,1.0
2021,15,3276,120,11,8359,13,35,10,14,0,0,0,0,0,0,False,False,False,0,3,2021-12-20T11:20:03.98,0,False,0.0
2021,15,3276,130,11,6571,2,28,9,-6,13,19,5,8,5,0,True,False,False,1,1,2021-12-20T11:22:17.297,13,False,8.0
2021,15,3276,140,11,4875,2,4,9,5,5,0,5,0,5,0,False,False,False,0,3,2021-12-20T11:24:42.733,5,False,0.0
2021,15,3276,160,11,8359,2,43,6,21,37,16,37,0,37,6,False,False,False,0,3,2021-12-23T19:07:32.24,37,True,0.0
2021,15,3276,175,1,894,13,6,7,15,0,0,0,0,0,0,False,False,False,0,4,2021-12-20T11:34:34.163,0,False,0.0
2021,15,3276,225,1,6933,13,4,9,11,0,0,0,0,0,0,False,False,False,0,2,2021-12-20T11:44:21.46,0,False,0.0
2021,15,3276,230,1,894,2,4,10,8,14,6,12,2,12,0,True,False,False,0,1,2021-12-20T11:45:47.557,14,False,2.0
2021,15,3276,240,1,894,2,53,10,-3,13,16,13,0,13,0,False,False,False,0,4,2021-12-20T11:48:39.97,13,False,0.0
2021,15,3276,250,1,894,2,12,10,1,2,1,1,1,1,0,False,False,False,0,3,2022-02-24T19:19:25.99,2,False,1.0
2021,15,3276,275,11,8359,13,5,5,5,0,0,0,0,0,0,True,False,False,0,3,2021-12-20T11:55:52.263,0,False,0.0
2021,15,3276,280,11,7493,2,32,5,0,5,5,3,2,3,0,False,False,False,0,1,2021-12-20T11:57:07.37,5,False,2.0
2021,15,3276,290,1,6405,2,6,9,4,5,1,5,0,5,0,False,False,False,0,2,2021-12-20T12:03:24.73,5,False,0.0
2021,15,3276,295,1,6405,2,12,2,21,24,3,23,1,23,0,False,False,False,0,2,2022-02-16T20:38:45.23,24,False,1.0
2021,15,3276,300,1,8439,2,51,9,-5,10,15,6,4,6,0,True,False,False,0,2,2022-02-16T20:38:54.71,10,False,4.0
2021,15,3276,310,1,4587,2,48,4,-4,15,19,13,2,13,0,False,False,False,0,1,2021-12-21T20:51:06.967,15,False,2.0
2021,15,3276,315,1,8439,2,51,9,-5,0,5,0,0,0,0,False,False,False,0,3,2021-12-20T12:14:12.33,0,False,0.0
2021,15,3276,320,1,6405,2,34,4,-3,3,6,-3,6,-3,0,True,False,False,2,3,2021-12-23T19:07:44.66,3,False,6.0
2021,15,3276,325,1,910,13,12,5,3,0,0,0,0,0,0,False,False,False,0,3,2021-12-20T12:18:33.937,0,False,0.0
2021,15,3276,330,1,6933,13,2,9,1,0,0,0,0,0,0,False,False,False,0,2,2021-12-20T12:20:10.117,0,False,0.0
2021,15,3276,350,11,4875,2,5,3,14,15,1,15,0,15,0,False,False,False,0,2,2021-12-20T12:27:25.29,15,True,0.0
2021,15,3276,360,11,8359,2,5,5,6,14,8,13,1,13,0,True,False,False,1,3,2021-12-20T12:31:16.393,14,False,1.0
2021,15,3276,370,11,8359,13,5,3,6,0,0,0,0,0,0,False,False,False,0,3,2021-12-20T12:34:38.637,0,False,0.0
2021,15,3276,375,11,8359,2,4,9,6,8,2,7,1,7,0,True,False,False,0,3,2021-12-20T12:38:05.827,8,False,1.0
2021,15,3276,385,11,8359,2,51,10,-6,6,12,2,4,2,0,True,False,False,0,1,2021-12-20T12:38:15.083,6,False,4.0
2021,15,3276,395,11,4875,2,17,8,22,22,0,22,0,22,6,False,False,False,0,3,2021-12-20T12:40:26.233,22,True,0.0
2021,15,3276,430,1,6405,2,50,9,-3,9,12,6,3,6,0,False,False,False,0,3,2021-12-20T13:38:06.73,9,False,3.0
2021,15,3276,460,1,910,13,9,5,11,0,0,0,0,0,0,False,False,False,0,2,2021-12-20T13:46:45.293,0,False,0.0
2021,15,3276,490,11,8628,2,8,4,10,16,6,15,1,15,0,False,False,False,0,3,2021-12-20T13:52:20.94,16,False,1.0
2021,15,3276,505,1,910,13,12,5,10,0,0,0,0,0,0,False,False,False,0,2,2021-12-20T13:57:51.61,0,False,0.0
2021,15,3276,510,11,6629,2,32,10,3,6,3,6,0,6,6,False,False,False,0,4,2021-12-20T13:59:40.687,6,True,0.0
2021,15,3276,525,1,894,2,17,10,14,20,6,17,3,17,0,False,False,False,0,4,2021-12-20T14:07:43.43,20,False,3.0
2021,15,3276,535,1,6405,3,3,2,15,0,0,0,0,0,0,False,False,False,0,2,2021-12-20T14:12:01.973,0,False,0.0
2021,15,3276,540,1,910,2,12,8,18,19,1,18,1,18,0,False,False,False,0,2,2021-12-20T14:14:52.34,19,False,1.0
2021,15,3276,550,1,6405,13,7,6,22,0,0,0,0,0,0,False,False,False,0,3,2022-02-16T20:40:44.447,0,False,0.0
2021,15,3276,555,1,910,2,4,5,7,27,20,7,20,7,0,False,False,False,3,2,2021-12-23T19:08:07.06,27,False,20.0
2021,15,3276,570,1,894,13,2,10,7,0,0,0,0,0,0,False,False,False,0,3,2021-12-23T19:17:14.177,0,False,0.0
2021,15,3276,595,11,4875,2,13,9,5,5,0,5,0,5,0,False,False,False,0,3,2021-12-20T14:32:07.26,5,False,0.0
2021,15,3276,605,11,4037,13,8,8,35,0,0,0,0,0,0,False,False,False,0,3,2021-12-20T14:38:21.16,0,False,
2021,15,3276,610,11,4875,2,50,10,-1,8,9,5,3,5,0,False,False,False,0,2,2021-12-20T14:42:02.437,8,False,3.0
2021,15,3276,635,11,4037,13,5,2,15,0,0,0,0,0,0,False,False,False,0,2,2021-12-23T19:18:32.64,0,False,0.0
2021,15,3276,640,11,8359,2,4,9,7,11,4,10,1,10,0,False,False,False,0,1,2021-12-20T14:55:00.227,11,False,1.0
2021,15,3276,655,1,894,3,26,9,4,0,0,0,0,0,0,False,False,False,0,4,2021-12-20T14:59:33.34,0,False,0.0
2021,15,3276,665,1,6933,13,4,7,20,0,0,0,0,0,0,False,False,False,0,2,2021-12-20T15:31:52.8,0,False,
2021,15,3276,670,1,4587,2,48,4,-1,16,17,5,11,5,0,False,False,False,1,1,2021-12-20T15:33:35.21,16,False,11.0
2021,15,3276,680,1,6933,13,12,10,3,0,0,0,0,0,0,False,False,False,0,2,2021-12-20T15:35:51.06,0,False,0.0
2021,15,3276,690,1,6933,13,19,6,29,0,0,0,0,0,0,False,False,False,0,2,2021-12-20T15:38:05.22,0,False,0.0
2021,15,3276,715,11,6571,2,49,10,-4,-2,2,-3,1,-3,0,False,False,False,1,2,2021-12-20T16:09:39.577,-2,False,1.0
2021,15,3276,725,1,6405,2,4,10,5,5,0,5,0,5,0,False,False,False,0,3,2021-12-23T19:17:14.177,5,False,0.0
2021,15,3276,730,1,910,2,4,10,6,7,1,7,0,7,0,False,False,False,0,3,2021-12-20T16:12:18.783,7,False,0.0
2021,15,3276,745,1,6933,2,4,3,-2,6,8,-1,7,-1,0,False,False,False,1,2,2021-12-20T16:25:24.753,6,False,7.0
2021,15,3276,750,1,910,13,4,10,8,0,0,0,0,0,0,False,False,False,0,2,2021-12-20T16:26:25.447,0,False,0.0
2021,15,3276,755,1,6933,2,2,9,4,7,3,4,3,4,0,False,False,False,0,2,2021-12-20T16:27:22.613,7,False,3.0
2021,15,3276,760,1,894,2,6,4,12,13,1,13,0,13,0,False,False,False,0,3,2021-12-20T16:28:13.52,13,False,0.0
2021,15,3276,765,1,910,2,4,5,8,11,3,11,0,11,0,False,False,False,1,2,2021-12-20T16:29:09.003,11,False,0.0
2021,15,3276,770,1,6405,13,5,5,5,0,0,0,0,0,0,False,False,False,0,3,2022-02-16T20:42:20.43,0,False,0.0
2021,15,3276,775,1,894,13,7,6,25,0,0,0,0,0,0,False,False,False,0,3,2021-12-20T16:31:18.457,0,False,0.0
2021,15,3276,780,1,6405,2,8,1,26,26,0,26,0,26,6,False,False,False,0,3,2021-12-20T16:33:39.93,26,True,0.0
2021,15,3276,815,11,4875,13,4,6,15,0,0,0,0,0,0,False,False,False,0,2,2021-12-20T16:39:09.97,0,False,
2021,15,3276,855,1,6405,2,4,4,5,5,0,5,0,5,0,False,False,False,0,3,2021-12-23T19:17:14.177,5,False,0.0
2021,15,3276,860,1,7782,13,4,4,5,0,0,0,0,0,0,False,False,False,0,1,2021-12-23T19:19:01.417,0,False,0.0
2021,15,3276,865,1,6405,2,6,4,6,9,3,6,3,6,0,False,False,False,0,3,2021-12-20T16:57:00.02,9,False,3.0
2021,15,3276,880,1,7315,2,4,5,6,13,7,11,2,11,0,False,False,False,0,2,2021-12-20T16:59:18.77,13,False,2.0
2021,15,3276,885,1,7782,2,48,10,-6,9,15,7,2,7,0,False,False,False,0,1,2021-12-23T19:17:14.177,9,False,2.0
2021,15,3276,890,1,894,2,35,9,13,12,-1,11,1,11,0,False,False,False,1,3,2021-12-20T17:02:52.353,12,False,1.0
2021,15,3276,895,1,894,13,5,5,1,0,0,0,0,0,0,False,False,False,0,3,2021-12-23T19:17:14.177,0,False,0.0
2021,15,3276,900,1,6405,2,49,10,-2,8,10,7,1,7,0,False,False,False,0,3,2021-12-20T17:04:32.47,8,False,1.0
2021,15,3276,905,1,6933,13,2,9,9,0,0,0,0,0,0,False,False,False,0,2,2021-12-20T17:05:48.633,0,False,0.0
2021,15,3277,10,7,7659,2,6,10,4,6,2,5,1,5,0,False,False,False,0,2,2021-12-20T10:21:44.5,6,False,1.0
2021,15,3277,15,7,8317,13,8,4,13,0,0,0,0,0,0,False,False,False,0,2,2021-12-20T10:24:16.643,0,False,0.0
2021,15,3277,20,7,3521,2,51,9,-2,2,4,2,0,2,0,False,False,False,0,3,2021-12-20T10:26:45.95,2,False,0.0
2021,15,3277,30,10,6281,2,39,4,5,5,0,5,0,5,0,False,False,False,0,3,2021-12-22T17:11:05.817,5,False,0.0
2021,15,3277,55,10,6281,3,6,9,6,0,0,0,0,0,0,False,False,False,0,2,2021-12-22T16:09:03.593,0,False,0.0
2021,15,3277,70,7,2631,2,47,5,0,6,6,1,5,1,0,False,False,False,1,4,2021-12-20T10:49:48.697,6,False,5.0
2021,15,3277,80,7,7659,2,6,10,5,17,12,16,1,16,0,False,False,False,0,2,2021-12-20T10:55:28.18,17,False,1.0
2021,15,3277,85,7,4679,2,46,3,0,2,2,2,0,2,0,False,False,False,0,1,2021-12-20T10:56:24.06,2,False,0.0
2021,15,3277,95,7,8317,13,6,4,3,0,0,0,0,0,0,False,False,False,0,3,2021-12-22T16:09:14.773,0,False,0.0
2021,15,3277,110,10,6281,13,35,5,13,0,0,0,0,0,0,False,False,False,0,3,2021-12-22T17:06:52.563,0,False,0.0
2021,15,3277,115,10,8541,2,16,10,3,8,5,4,4,4,0,False,False,False,0,1,2021-12-20T11:05:39.29,8,False,4.0
2021,15,3277,145,7,7659,13,5,3,5,0,0,0,0,0,0,True,False,False,0,2,2021-12-22T16:09:25.687,0,False,0.0
2021,15,3277,150,7,8317,2,12,8,40,46,6,44,2,44,0,False,False,False,0,2,2021-12-20T11:17:05,46,False,
2021,15,3277,155,7,2631,13,12,5,8,0,0,0,0,0,0,False,False,False,0,4,2021-12-22T16:09:34.83,0,False,0.0
2021,15,3277,180,10,6281,2,4,5,6,7,1,6,1,6,0,True,False,False,0,3,2021-12-22T17:07:02.93,7,False,1.0
2021,15,3277,195,7,6975,2,38,9,-1,2,3,0,2,0,0,False,False,False,0,4,2021-12-20T11:33:22.39,2,False,2.0
2021,15,3277,220,7,4455,2,28,9,0,9,9,7,2,7,0,False,False,False,0,1,2021-12-20T11:40:06.237,9,False,2.0
2021,15,3277,235,10,6840,2,12,3,7,28,21,22,6,22,0,False,False,False,1,4,2022-02-24T19:20:44.05,28,False,6.0
2021,15,3277,245,10,6281,13,19,2,34,0,0,0,0,0,0,False,False,False,0,2,2022-02-22T19:56:25.083,0,False,0.0
2021,15,3277,250,10,8541,2,44,3,-2,-1,1,-2,1,-2,0,False,False,False,0,1,2021-12-20T11:49:05.493,-1,False,1.0
2021,15,3277,280,7,2631,2,31,10,3,8,5,5,3,5,0,False,False,False,0,4,2021-12-20T11:55:40.29,8,False,3.0
2021,15,3277,295,10,7703,2,32,10,-5,10,15,4,6,4,0,False,False,False,1,4,2022-02-16T20:09:02.78,10,False,6.0
2021,15,3277,305,10,4930,13,7,6,22,0,0,0,0,0,0,True,False,False,0,3,2021-12-20T12:03:42.033,0,False,0.0
2021,15,3277,310,10,7700,13,6,1,15,0,0,0,0,0,0,False,False,False,0,2,2021-12-20T12:05:36.077,0,False,0.0
2021,15,3277,325,7,2631,2,12,5,4,4,0,4,0,4,0,False,False,False,0,4,2021-12-22T16:10:10.58,4,False,0.0
2021,15,3277,365,10,8541,2,4,10,2,3,1,2,1,2,0,False,False,False,0,1,2021-12-22T17:07:15.747,3,False,1.0
2021,15,3277,370,10,6840,2,4,10,7,11,4,9,2,9,0,False,False,False,0,4,2021-12-20T12:29:25.873,11,False,2.0
2021,15,3277,385,10,8541,2,45,10,-5,-1,4,-2,1,-2,0,False,False,False,0,1,2021-12-20T12:33:09.457,-1,False,1.0
2021,15,3277,390,10,282,2,4,10,3,8,5,4,4,4,0,False,False,False,0,1,2021-12-20T12:34:38.687,8,False,4.0
2021,15,3277,400,10,7703,3,4,10,7,0,0,0,0,0,0,False,False,False,0,4,2021-12-20T12:36:30.7,0,False,0.0
2021,15,3277,405,10,4930,2,4,3,9,9,0,9,0,9,0,False,False,False,0,2,2021-12-20T12:38:21.927,9,False,0.0
2021,15,3277,415,10,7938,13,2,9,5,0,0,0,0,0,0,False,False,False,0,2,2021-12-20T12:39:48.957,0,False,0.0
2021,15,3277,430,7,3521,2,6,8,17,19,2,18,1,18,0,False,False,False,0,3,2021-12-20T12:41:56.817,19,False,1.0
2021,15,3277,475,10,7700,13,17,9,9,0,0,0,0,0,0,False,False,False,0,3,2022-02-25T16:02:30.853,0,False,0.0
2021,15,3277,480,10,6840,2,12,3,4,11,7,10,1,10,0,False,False,False,0,4,2021-12-20T12:53:56.947,11,False,1.0
2021,15,3277,495,7,3521,13,26,4,3,0,0,0,0,0,0,False,False,False,0,3,2021-12-20T12:57:15.797,0,False,0.0
2021,15,3277,535,7,8317,2,6,9,3,3,0,3,0,3,0,False,False,False,0,3,2021-12-20T13:17:10.707,3,False,0.0
2021,15,3277,570,10,4930,2,5,3,7,8,1,7,1,7,0,True,False,False,0,3,2022-02-16T20:09:39.06,8,False,1.0
2021,15,3277,590,10,4930,2,9,6,25,25,0,25,0,25,6,False,False,False,0,2,2021-12-20T13:34:13.923,25,True,0.0
2021,15,3277,610,7,3521,2,43,7,22,56,34,56,0,56,6,False,False,False,1,3,2021-12-20T13:39:24.193,56,True,0.0
2021,15,3277,625,10,6840,2,30,5,1,2,1,2,0,2,0,False,False,False,0,4,2021-12-20T13:42:53.35,2,False,0.0
2021,15,3277,640,10,7703,2,5,3,9,24,15,13,11,13,0,True,False,False,0,3,2021-12-22T17:10:17.187,24,False,11.0
2021,15,3277,650,10,6840,13,39,4,6,0,0,0,0,0,0,False,False,False,0,4,2021-12-20T13:52:09.28,0,False,0.0
2021,15,3277,655,10,6281,13,35,2,22,0,0,0,0,0,0,False,False,False,0,3,2021-12-20T13:54:04.7,0,False,
2021,15,3277,665,10,4930,13,9,6,26,0,0,0,0,0,0,False,False,False,0,2,2021-12-20T13:57:27.46,0,False,0.0
2021,15,3277,695,7,3521,2,13,10,3,4,1,3,1,3,0,True,False,False,0,3,2021-12-21T20:53:49.727,4,False,1.0
2021,15,3277,715,7,8317,13,9,2,36,0,0,0,0,0,0,False,False,False,0,3,2021-12-22T14:57:13.21,0,False,0.0
2021,15,3277,720,7,4455,2,45,10,-5,4,9,0,4,0,0,False,False,False,1,1,2021-12-22T17:10:28.163,4,False,4.0
2021,15,3277,740,10,7703,2,35,4,12,24,12,18,6,18,0,False,False,False,0,4,2021-12-20T14:27:34.443,24,False,6.0
2021,15,3277,750,10,4930,13,35,6,20,0,0,0,0,0,0,False,False,False,0,3,2021-12-22T17:07:41.17,0,False,
2021,15,3277,755,10,6840,2,53,9,-5,5,10,-3,8,-3,0,False,False,False,1,4,2021-12-20T14:35:09.217,5,False,8.0
2021,15,3277,760,10,6281,13,6,7,17,0,0,0,0,0,0,False,False,False,0,3,2021-12-20T14:37:27.81,0,False,0.0
2021,15,3277,790,7,3521,2,6,4,14,15,1,15,0,15,0,False,False,False,0,3,2021-12-20T14:47:10.823,15,False,0.0
2021,15,3277,830,10,6281,13,6,9,11,0,0,0,0,0,0,False,False,False,0,2,2021-12-22T17:07:51.12,0,False,
2021,15,3277,835,10,7700,13,4,4,13,0,0,0,0,0,0,False,False,False,0,3,2022-02-25T16:02:45.653,0,False,0.0
2021,15,3277,845,10,7700,2,18,10,2,9,7,9,0,9,0,False,False,False,0,3,2021-12-20T15:00:43.757,9,False,
2021,15,3277,850,10,7700,13,12,2,29,0,0,0,0,0,0,False,False,False,0,3,2021-12-22T17:08:02.347,0,False,0.0
2021,15,3277,855,10,6281,13,19,2,30,0,0,0,0,0,0,False,False,False,0,2,2021-12-20T15:04:29.95,0,False,0.0
2021,15,3278,15,2,8389,2,30,9,-2,7,9,4,3,4,0,False,False,False,0,4,2021-12-22T22:01:09.107,7,False,3.0
2021,15,3278,25,2,1377,13,7,5,1,0,0,0,0,0,0,False,False,False,0,4,2021-12-22T18:55:29.63,0,False,0.0
2021,15,3278,40,2,8389,13,47,5,1,0,0,0,0,0,0,False,False,False,0,3,2021-12-22T21:51:46.367,0,False,0.0
2021,15,3278,50,28,7753,3,39,10,5,0,0,0,0,0,0,False,False,False,0,3,2022-02-16T21:45:14.087,0,False,0.0
2021,15,3278,55,28,262,2,4,9,5,6,1,6,0,6,0,False,False,False,0,1,2021-12-20T15:56:30.05,6,False,0.0
2021,15,3278,95,2,8389,2,38,9,6,7,1,7,0,7,0,False,False,False,0,4,2021-12-20T11:09:08.66,7,False,0.0
2021,15,3278,100,2,6247,13,2,10,5,0,0,0,0,0,0,False,False,False,0,3,2021-12-22T21:47:17.73,0,False,0.0
2021,15,3278,115,28,4922,2,51,5,-3,25,28,7,18,7,0,False,False,False,1,3,2021-12-20T11:15:03.233,25,False,18.0
2021,15,3278,130,28,6624,2,12,10,-5,6,11,4,2,4,0,False,False,False,0,1,2022-02-24T19:21:37.577,6,False,2.0
2021,15,3278,145,28,4922,2,17,8,27,28,1,27,1,27,0,False,False,False,0,4,2021-12-20T11:26:51.477,28,False,1.0
2021,15,3278,150,28,6410,13,35,9,8,0,0,0,0,0,0,False,False,False,0,2,2021-12-21T17:19:14.73,0,False,0.0
2021,15,3278,160,28,7751,2,47,10,0,3,3,2,1,2,0,True,False,False,0,1,2021-12-21T17:20:18.757,3,False,1.0
2021,15,3278,190,2,6247,2,6,10,11,14,3,11,3,11,0,False,False,False,1,3,2021-12-22T22:01:56.403,14,False,3.0
2021,15,3278,200,2,6247,13,4,8,15,0,0,0,0,0,0,False,False,False,0,3,2022-02-16T21:42:16.227,0,False,0.0
2021,15,3278,225,28,7619,2,2,10,11,36,25,32,4,32,0,False,False,False,0,2,2021-12-20T11:57:28.753,36,False,4.0
2021,15,3278,245,28,7753,2,5,3,2,9,7,6,3,6,0,False,False,False,0,3,2021-12-20T12:05:06.087,9,False,3.0
2021,15,3278,250,28,7619,13,21,2,15,0,0,0,0,0,0,False,False,False,0,2,2021-12-22T21:52:56.44,0,False,0.0
2021,15,3278,255,28,4922,2,4,9,5,9,4,5,4,5,0,True,False,False,0,3,2021-12-22T21:49:34.4,9,False,4.0
2021,15,3278,275,2,6247,2,26,5,2,5,3,5,0,5,0,False,False,False,0,2,2021-12-20T12:20:47.28,5,False,0.0
2021,15,3278,280,2,811,2,50,9,-3,0,3,-2,2,-2,0,True,False,False,0,2,2021-12-20T12:22:25.08,0,False,2.0
2021,15,3278,300,2,6247,2,6,9,12,13,1,12,1,12,0,False,False,False,0,3,2022-03-08T19:18:35.38,13,False,1.0
2021,15,3278,310,2,6247,3,6,10,13,0,0,0,0,0,0,False,False,False,0,3,2021-12-20T12:35:26.407,0,False,0.0
2021,15,3278,325,2,6247,2,9,2,20,20,0,20,0,20,6,False,False,False,0,2,2021-12-20T12:55:50.4,20,True,0.0
2021,15,3278,340,28,7224,2,35,7,16,30,14,17,13,17,0,False,False,False,1,3,2021-12-20T13:02:05.103,30,False,13.0
2021,15,3278,345,28,4922,2,26,9,3,3,0,3,0,3,0,True,False,False,0,4,2021-12-21T17:20:45.763,3,False,0.0
2021,15,3278,360,28,7619,13,29,3,14,0,0,0,0,0,0,False,False,False,0,2,2021-12-22T19:38:37.24,0,False,
2021,15,3278,370,28,7753,2,12,9,6,15,9,8,7,8,0,False,False,False,1,3,2021-12-22T21:49:48.073,15,False,7.0
2021,15,3278,390,2,8389,13,19,2,36,0,0,0,0,0,0,False,False,False,0,2,2022-02-22T21:50:00.2,0,False,0.0
2021,15,3278,415,2,6247,2,4,9,6,10,4,8,2,8,0,False,False,False,0,3,2021-12-21T21:29:11.19,10,False,2.0
2021,15,3278,430,28,4922,2,8,9,13,13,0,13,0,13,0,False,False,False,1,3,2022-02-16T21:42:55.39,13,False,0.0
2021,15,3278,435,28,7224,2,2,9,7,21,14,14,7,14,0,False,False,False,0,3,2021-12-22T21:48:11.47,21,False,7.0
2021,15,3278,465,2,6247,2,29,2,18,21,3,19,2,19,0,False,False,False,0,2,2021-12-21T21:29:38.563,21,False,2.0
2021,15,3278,480,2,7303,2,8,7,43,49,6,43,6,43,0,False,False,False,0,2,2021-12-20T14:18:46.14,49,False,6.0
2021,15,3278,490,2,2554,13,12,5,0,0,0,0,0,0,0,False,False,False,0,1,2021-12-20T14:21:47.74,0,False,0.0
2021,15,3278,495,2,3506,13,13,10,3,0,0,0,0,0,0,True,False,False,0,3,2021-12-20T14:23:16.03,0,False,0.0
2021,15,3278,515,28,7753,13,4,10,13,0,0,0,0,0,0,False,False,False,0,3,2021-12-20T14:28:45.95,0,True,0.0
2021,15,3278,520,28,4922,2,5,3,5,15,10,12,3,12,0,True,False,False,0,3,2022-03-08T19:19:27.727,15,False,3.0
2021,15,3278,550,28,6624,2,55,9,0,3,3,3,0,3,0,False,False,False,0,1,2021-12-22T21:56:57.173,3,False,0.0
2021,15,3278,555,28,7753,2,5,3,4,4,0,4,0,4,6,False,False,False,0,3,2021-12-22T21:57:17.833,4,True,0.0
2021,15,3278,570,2,5214,2,53,9,-4,2,6,-1,3,-1,0,False,False,False,1,4,2021-12-22T21:57:41.48,2,False,3.0
2021,15,3278,575,2,5214,2,46,3,4,4,0,4,0,4,0,False,False,False,0,4,2021-12-22T19:12:34.32,4,True,0.0
2021,15,3278,615,2,8389,2,19,2,30,49,19,31,18,31,0,False,False,False,1,2,2021-12-20T15:02:22.867,49,False,18.0
2021,15,3278,625,2,8389,3,30,10,3,0,0,0,0,0,0,True,False,False,0,4,2021-12-20T15:05:31.833,0,False,0.0
2021,15,3278,630,2,6247,2,16,9,5,5,0,5,0,5,0,True,False,False,0,3,2022-02-22T21:54:12.223,5,False,0.0
2021,15,3278,640,28,7753,3,4,10,12,0,0,0,0,0,0,False,False,False,0,3,2021-12-20T15:09:54.657,0,False,0.0
2021,15,3278,650,28,7224,13,6,10,9,0,0,0,0,0,0,False,False,False,0,2,2021-12-22T22:02:32.74,0,False,0.0
2021,15,3278,665,2,8389,2,2,10,12,14,2,14,0,14,0,False,False,False,0,3,2021-12-20T15:15:13.37,14,False,0.0
2021,15,3278,670,2,6247,2,12,3,3,3,0,3,0,3,0,False,False,False,0,3,2022-02-24T19:22:13.717,3,True,0.0
2021,15,3278,680,2,7303,2,4,9,4,4,0,4,0,4,0,True,False,False,0,3,2021-12-20T15:22:32.457,4,False,0.0
2021,15,3278,685,2,811,2,13,9,3,5,2,3,2,3,0,False,False,False,0,3,2021-12-22T19:39:31.99,5,False,2.0
2021,15,3278,700,2,7296,2,46,3,3,4,1,4,0,4,0,False,False,False,0,1,2022-03-08T19:20:22.607,4,False,0.0
2021,15,3278,710,2,6240,13,6,9,1,0,0,0,0,0,0,False,False,False,0,2,2021-12-20T15:36:12.593,0,False,0.0
2021,15,3278,730,28,7224,2,50,9,-5,8,13,4,4,4,0,True,False,False,0,3,2021-12-21T17:20:59.903,8,False,4.0
2021,15,3278,775,28,7224,2,50,10,-5,1,6,-1,2,-1,0,False,False,False,0,3,2021-12-20T15:50:07.86,1,False,2.0
2021,15,3279,20,29,1067,2,2,10,5,7,2,6,1,6,0,False,False,False,0,2,2021-12-22T12:09:24.97,7,False,1.0
2021,15,3279,25,29,4866,2,51,3,-4,0,4,-3,3,-3,0,True,False,False,0,1,2021-12-22T12:18:08.833,0,False,3.0
2021,15,3279,35,29,6266,2,46,9,2,16,14,13,3,13,0,False,False,False,1,1,2021-12-26T14:24:40.893,16,False,
2021,15,3279,40,29,7378,2,45,5,-1,1,2,0,1,0,0,False,False,False,0,1,2021-12-22T12:19:46.02,1,False,1.0
2021,15,3279,45,29,8455,2,31,9,9,14,5,13,1,13,0,False,False,False,0,4,2021-12-22T12:21:33.973,14,False,1.0
2021,15,3279,50,29,1067,2,13,10,1,7,6,4,3,4,0,False,False,False,0,3,2021-12-22T12:23:10.313,7,False,
2021,15,3279,80,27,4850,2,2,10,6,6,0,6,0,6,0,False,False,False,0,3,2021-12-22T12:31:47.023,6,False,0.0
2021,15,3279,90,27,7408,2,2,9,6,7,1,6,1,6,0,False,False,False,0,2,2021-12-22T12:36:44.013,7,False,1.0
2021,15,3279,105,27,7850,2,48,4,-5,-5,0,-5,0,-5,0,False,False,False,0,1,2021-12-22T12:40:14.83,-5,False,0.0
2021,15,3279,120,29,7366,13,39,4,5,0,0,0,0,0,0,False,False,False,0,3,2021-12-26T14:25:00.857,0,False,0.0
2021,15,3279,125,29,7828,2,6,8,16,18,2,18,0,18,0,False,False,False,0,3,2021-12-22T12:47:28.92,18,False,0.0
2021,15,3279,135,29,4866,2,31,4,0,5,5,4,1,4,0,False,False,False,0,3,2021-12-26T13:29:36.623,5,False,1.0
2021,15,3279,140,29,1067,13,19,6,26,0,0,0,0,0,0,False,False,False,0,3,2021-12-26T13:29:36.623,0,False,
2021,15,3279,145,29,4866,13,51,10,-2,0,0,0,0,0,0,False,False,False,0,3,2021-12-22T12:55:00.847,0,False,0.0
2021,15,3279,150,29,8455,2,6,4,10,11,1,10,1,10,0,False,False,False,0,3,2021-12-22T12:56:32.943,11,False,1.0
2021,15,3279,155,29,8455,2,31,4,2,12,10,11,1,11,0,False,False,False,0,4,2021-12-22T12:58:16.46,12,False,1.0
2021,15,3279,165,29,4866,13,17,6,26,0,0,0,0,0,0,False,False,False,0,3,2022-02-22T20:59:20.603,0,False,0.0
2021,15,3279,175,27,4850,2,38,10,7,9,2,8,1,8,0,False,False,False,0,3,2021-12-26T14:26:53.193,9,False,1.0
2021,15,3279,205,29,7825,2,13,10,3,9,6,5,4,5,0,False,False,False,0,3,2022-02-22T21:00:00.45,9,False,4.0
2021,15,3279,215,29,4866,2,4,9,5,9,4,8,1,8,0,False,False,False,0,3,2021-12-22T13:33:42.08,9,False,1.0
2021,15,3279,225,29,7378,2,6,10,1,3,2,3,0,3,0,False,False,False,0,1,2022-02-22T21:00:25.27,3,False,0.0
2021,15,3279,240,29,4866,2,45,5,-3,2,5,-2,4,-2,0,True,False,False,0,1,2021-12-24T01:29:22.607,2,False,4.0
2021,15,3279,245,29,8455,3,4,10,7,0,0,0,0,0,0,False,False,False,0,3,2021-12-22T13:46:31.137,0,False,0.0
2021,15,3279,260,27,8472,13,12,6,18,0,0,0,0,0,0,True,False,False,0,3,2021-12-26T14:30:33.923,0,False,0.0
2021,15,3279,265,27,7408,2,45,5,-5,4,9,3,1,3,0,True,False,False,0,3,2021-12-22T13:53:35.143,4,False,1.0
2021,15,3279,270,27,7408,13,7,6,19,0,0,0,0,0,0,False,False,False,0,2,2021-12-22T14:29:45.843,0,False,0.0
2021,15,3279,290,29,4866,2,19,6,40,42,2,40,2,40,0,False,False,False,0,2,2021-12-22T14:15:44.62,42,False,2.0
2021,15,3279,300,29,1067,13,30,5,3,0,0,0,0,0,0,False,False,False,0,3,2021-12-22T14:10:26.597,0,False,0.0
2021,15,3279,310,29,8455,2,39,4,5,5,0,5,0,5,0,False,False,False,0,3,2021-12-22T14:12:19.257,5,False,0.0
2021,15,3279,320,29,4866,13,39,4,6,0,0,6,-1005,6,0,False,False,False,0,3,2021-12-22T14:30:01.637,0,False,0.0
2021,15,3279,325,27,4850,2,4,10,7,11,4,7,4,7,0,False,False,False,0,3,2021-12-26T14:27:31.17,11,False,4.0
2021,15,3279,330,27,7850,2,28,4,1,9,8,8,1,8,0,False,False,False,0,1,2021-12-22T14:17:17.157,9,False,1.0
2021,15,3279,335,27,4850,2,8,8,32,34,2,32,2,32,0,False,False,False,0,3,2021-12-22T14:21:17.78,34,False,2.0
2021,15,3279,345,27,8472,13,8,7,16,0,0,0,0,0,0,False,False,False,0,3,2021-12-22T14:24:05.05,0,False,0.0
2021,15,3279,410,27,7408,2,4,5,4,9,5,7,2,7,0,False,False,False,0,2,2021-12-22T15:01:51.177,9,False,2.0
2021,15,3279,415,27,7852,2,4,3,4,25,21,5,20,5,0,False,False,False,1,2,2021-12-22T15:05:18.337,25,False,20.0
2021,15,3279,430,27,7408,3,4,5,4,0,0,0,0,0,0,False,False,False,0,2,2021-12-22T15:08:45.843,0,False,0.0
2021,15,3279,440,27,7408,2,4,10,10,12,2,11,1,11,0,False,False,False,0,2,2021-12-22T15:11:27.12,12,False,1.0
2021,15,3279,470,29,4866,13,12,10,13,0,0,0,0,0,0,False,False,False,0,2,2021-12-22T15:18:56.94,0,False,0.0
2021,15,3279,475,29,4866,2,7,8,29,32,3,30,2,30,0,True,False,False,0,3,2021-12-26T14:31:01.85,32,False,2.0
2021,15,3279,490,29,4866,2,4,10,6,6,0,6,0,6,6,False,False,False,0,3,2021-12-22T17:43:24.59,6,True,0.0
2021,15,3279,525,27,8472,13,12,6,44,0,0,0,0,0,0,False,False,False,0,2,2021-12-22T15:33:12.833,0,False,0.0
2021,15,3279,540,29,6266,2,48,9,-2,-1,1,-2,1,-2,0,False,False,False,0,1,2021-12-22T15:44:37.997,-1,False,1.0
2021,15,3279,545,29,1067,13,17,7,38,0,0,0,0,0,0,False,False,False,0,3,2021-12-22T15:46:22.12,0,False,0.0
2021,15,3279,560,27,6397,2,5,5,2,3,1,2,1,2,0,False,False,False,0,3,2021-12-23T16:19:21.75,3,False,1.0
2021,15,3279,565,27,7408,13,6,10,10,0,0,0,0,0,0,False,False,False,0,2,2021-12-22T15:50:26.167,0,False,0.0
2021,15,3279,590,29,8455,2,32,9,1,8,7,7,1,7,0,False,False,False,1,4,2021-12-26T14:25:36.747,8,False,
2021,15,3279,595,29,6266,2,48,9,-3,24,27,0,24,0,0,False,False,False,1,1,2021-12-22T16:23:48.957,24,False,24.0
2021,15,3279,600,29,7828,2,5,3,5,5,0,5,0,5,0,True,False,False,0,3,2021-12-22T16:25:07.287,5,False,0.0
2021,15,3279,615,29,4866,2,31,4,-2,11,13,5,6,5,0,False,False,False,1,3,2021-12-26T13:29:36.67,11,False,6.0
2021,15,3279,620,29,4866,2,8,1,18,29,11,29,0,29,6,False,False,False,0,3,2021-12-22T17:44:08.337,29,True,0.0
2021,15,3279,640,27,5226,2,47,5,-1,3,4,2,1,2,0,False,False,False,0,1,2021-12-22T16:34:22.497,3,False,1.0
2021,15,3279,645,27,8472,13,35,2,25,0,0,0,0,0,0,False,False,False,0,3,2021-12-22T16:35:58.803,0,False,
2021,15,3279,655,27,5226,2,48,9,-7,2,9,-1,3,-1,0,False,False,False,1,1,2021-12-22T16:39:36.103,2,False,3.0
2021,15,3279,660,27,8472,2,2,9,5,11,6,8,3,8,0,False,False,False,1,3,2021-12-26T14:28:38.43,11,False,
2021,15,3279,665,27,7408,13,19,6,39,0,0,0,0,0,0,False,False,False,0,2,2021-12-22T16:43:33.387,0,False,0.0
2021,15,3279,720,27,7850,13,11,6,16,0,0,0,0,0,0,False,False,False,0,1,2021-12-26T14:26:01.407,0,False,0.0
2021,15,3279,770,27,7408,2,4,3,10,9,-1,9,0,9,0,False,False,False,0,2,2021-12-26T13:29:36.67,9,False,0.0
2021,15,3279,775,27,7850,2,4,4,1,7,6,7,0,7,0,False,False,False,0,1,2021-12-22T17:28:22.677,7,False,0.0
2021,15,3279,780,27,8472,13,12,2,54,0,0,0,0,0,0,False,False,False,0,3,2021-12-26T14:26:23.563,0,False,0.0
2021,15,3279,790,27,7408,13,3,2,19,0,0,0,0,0,0,False,False,False,0,2,2021-12-22T17:31:44.62,0,False,0.0
2021,15,3279,795,27,7408,2,18,5,5,11,6,11,0,11,0,False,False,False,0,2,2021-12-26T19:55:46.94,11,True,0.0
2021,15,3279,805,27,7408,13,19,6,52,0,0,0,0,0,0,False,False,False,0,2,2021-12-22T17:34:39.36,0,False,0.0
2021,15,3280,10,20,8131,2,4,9,5,8,3,7,1,7,0,False,False,False,0,2,2021-12-20T10:20:21.13,8,False,1.0
2021,15,3280,35,20,6388,13,12,5,9,0,0,0,0,0,0,False,False,False,0,2,2022-02-24T19:23:33.913,0,False,0.0
2021,15,3280,45,30,7893,13,6,9,4,0,0,0,0,0,0,False,False,False,0,2,2021-12-20T10:32:17.217,0,False,0.0
2021,15,3280,50,30,4937,2,4,9,4,5,1,4,1,4,0,False,False,False,0,1,2021-12-20T10:33:51.96,5,False,1.0
2021,15,3280,55,30,4937,2,46,3,0,7,7,2,5,2,0,False,False,False,0,1,2021-12-20T10:35:10.197,7,False,5.0
2021,15,3280,60,30,4516,2,4,10,4,7,3,6,1,6,0,False,False,False,0,3,2021-12-20T10:36:38.03,7,False,1.0
2021,15,3280,65,30,4937,2,47,5,-2,-2,0,-2,0,-2,0,False,False,False,0,1,2021-12-20T10:38:01.83,-2,False,0.0
2021,15,3280,70,30,4937,2,46,9,-1,3,4,0,3,0,0,False,False,False,0,1,2021-12-20T10:39:55.19,3,False,3.0
2021,15,3280,80,20,6388,2,5,5,7,9,2,7,2,7,0,True,True,False,1,3,2022-03-11T18:32:57.203,9,False,2.0
2021,15,3280,95,20,5140,2,5,3,4,7,3,5,2,5,0,False,False,False,0,3,2021-12-20T10:48:28.73,7,False,2.0
2021,15,3280,100,20,8131,2,35,6,28,40,12,28,12,28,0,False,False,False,0,3,2021-12-20T10:50:11.09,40,False,12.0
2021,15,3280,115,20,8131,13,2,10,7,0,0,0,0,0,0,False,False,False,0,2,2021-12-20T10:58:06.287,0,False,0.0
2021,15,3280,130,30,4516,13,35,6,18,0,0,0,0,0,0,False,False,False,0,3,2021-12-22T15:22:52.007,0,False,0.0
2021,15,3280,135,30,4516,2,11,2,16,23,7,21,2,21,0,False,False,False,0,3,2021-12-20T11:03:31.95,23,False,2.0
2021,15,3280,140,30,4516,2,6,4,5,5,0,5,0,5,0,False,False,False,0,3,2021-12-20T11:04:45.163,5,False,0.0
2021,15,3280,145,30,7893,13,13,9,3,0,0,0,0,0,0,False,False,False,0,3,2021-12-20T11:06:19.383,0,False,0.0
2021,15,3280,165,20,5140,2,4,4,2,6,4,5,1,5,0,False,False,False,0,1,2021-12-20T11:11:45.4,6,False,1.0
2021,15,3280,170,20,8131,2,4,9,5,7,2,7,0,7,0,False,False,False,0,2,2021-12-20T11:14:05.867,7,False,0.0
2021,15,3280,180,20,8131,2,8,7,33,33,0,33,0,33,0,False,False,False,0,3,2022-03-11T18:37:49.82,33,False,0.0
2021,15,3280,185,20,5140,3,2,9,5,0,0,0,0,0,0,True,False,False,0,3,2021-12-22T15:27:15.467,0,False,0.0
2021,15,3280,190,20,5140,13,9,6,18,0,0,0,0,0,0,False,False,False,0,3,2021-12-20T11:23:26.677,0,False,0.0
2021,15,3280,195,20,6388,2,2,10,8,8,0,8,0,8,0,False,False,False,0,3,2021-12-20T11:24:45.68,8,False,0.0
2021,15,3280,225,30,4516,2,3,5,7,8,1,8,0,8,0,False,False,False,0,3,2021-12-20T11:31:17.387,8,False,0.0
2021,15,3280,230,30,63,3,2,4,9,0,0,0,0,0,0,True,False,False,0,3,2021-12-20T11:32:38.797,0,False,0.0
2021,15,3280,235,30,4516,2,51,3,-2,1,3,0,1,0,0,False,False,False,0,3,2021-12-22T15:20:27.23,1,False,1.0
2021,15,3280,240,30,4516,2,2,9,5,5,0,5,0,5,0,False,False,False,0,3,2021-12-20T11:35:56.953,5,False,0.0
2021,15,3280,260,20,5140,3,50,9,-2,0,0,0,0,0,0,False,False,False,0,2,2021-12-20T11:40:30.697,0,False,0.0
2021,15,3280,280,30,4937,2,2,3,2,5,3,4,1,4,0,False,False,False,0,2,2021-12-20T11:48:21.657,5,False,1.0
2021,15,3280,285,30,2290,13,6,3,14,0,0,0,0,0,0,False,False,False,0,4,2022-02-16T21:48:45.523,0,False,0.0
2021,15,3280,290,30,2290,2,5,3,6,6,0,6,0,6,0,False,False,False,0,3,2021-12-20T11:51:02.163,6,False,0.0
2021,15,3280,295,30,793,2,35,9,12,14,2,12,2,12,0,False,False,False,0,3,2022-03-11T18:41:00.873,14,False,2.0
2021,15,3280,305,30,63,13,42,9,5,0,0,0,0,0,0,False,False,False,0,4,2021-12-20T11:58:02.707,0,False,0.0
2021,15,3280,335,20,7888,2,26,9,4,4,0,4,0,4,0,False,False,False,0,3,2021-12-22T14:36:19.127,4,False,0.0
2021,15,3280,340,20,5140,13,16,10,5,0,0,0,0,0,0,False,False,False,0,3,2021-12-20T12:09:01.673,0,False,0.0
2021,15,3280,360,30,63,2,7,5,14,19,5,19,0,19,0,False,False,False,0,4,2021-12-20T12:15:23.017,19,True,0.0
2021,15,3280,375,30,4937,2,44,3,-3,7,10,3,4,3,0,True,False,False,0,1,2021-12-21T17:09:35.153,7,False,4.0
2021,15,3280,380,30,7268,2,2,4,4,5,1,5,0,5,0,False,False,False,0,3,2022-03-11T18:41:58.017,5,False,0.0
2021,15,3280,390,30,2290,3,5,5,5,0,0,0,0,0,0,False,False,False,0,3,2021-12-20T12:23:46.64,0,False,0.0
2021,15,3280,440,30,4937,2,44,9,-4,8,12,4,4,4,0,False,False,False,0,1,2021-12-20T13:07:11.29,8,False,4.0
2021,15,3280,450,30,6414,2,47,5,-2,5,7,5,0,5,0,False,False,False,0,1,2021-12-20T13:10:41.263,5,False,0.0
2021,15,3280,455,30,8307,13,19,6,36,0,0,0,0,0,0,False,False,False,0,2,2021-12-22T15:22:10.937,0,False,0.0
2021,15,3280,475,20,8131,13,39,4,4,0,0,0,0,0,0,False,False,False,0,3,2021-12-20T13:19:09.583,0,False,0.0
2021,15,3280,495,30,63,13,6,10,13,0,0,0,0,0,0,False,False,False,0,4,2021-12-20T13:28:11.407,0,False,0.0
2021,15,3280,505,20,8131,13,2,9,8,0,0,0,0,0,0,False,False,False,0,2,2021-12-20T13:31:55.31,0,False,0.0
2021,15,3280,525,30,2290,2,6,10,14,16,2,16,0,16,0,True,False,False,0,3,2021-12-20T13:37:59.803,16,False,0.0
2021,15,3280,530,30,4523,13,6,10,12,0,0,0,0,0,0,False,False,False,0,4,2021-12-22T15:18:45.15,0,False,0.0
2021,15,3280,540,30,7893,2,13,10,4,6,2,4,2,4,0,False,False,False,0,3,2021-12-20T13:41:50.607,6,False,2.0
2021,15,3280,545,30,63,13,9,2,20,0,0,0,0,0,0,False,False,False,0,3,2021-12-20T13:43:23.163,0,False,0.0
2021,15,3280,555,20,902,2,4,4,3,3,0,3,0,3,0,False,False,False,0,1,2021-12-22T15:29:03.63,3,False,0.0
2021,15,3280,560,20,7888,13,17,8,20,0,0,0,0,0,0,False,False,False,0,4,2021-12-20T13:49:46.17,0,False,0.0
2021,15,3280,585,30,7891,3,44,3,-3,0,0,0,0,0,0,False,False,False,0,1,2021-12-20T13:56:25.073,0,False,0.0
2021,15,3280,590,30,63,2,2,9,5,10,5,7,3,7,0,False,False,False,0,2,2021-12-20T13:58:10.863,10,False,3.0
2021,15,3280,595,30,63,3,11,2,17,0,0,0,0,0,0,False,False,False,0,4,2021-12-20T13:59:38.117,0,False,0.0
2021,15,3280,640,30,6414,2,46,3,-2,3,5,-2,5,-2,0,False,False,False,1,1,2021-12-20T14:11:50.93,3,False,5.0
2021,15,3280,660,20,8131,2,13,10,1,17,16,17,0,17,0,False,False,False,0,3,2021-12-20T14:28:07.013,17,True,0.0
2021,15,3280,670,20,3848,3,17,8,22,0,0,0,0,0,0,False,False,False,0,3,2021-12-20T14:31:14.41,0,False,0.0
2021,15,3280,675,20,902,2,28,10,0,5,5,4,1,4,0,False,False,False,0,1,2021-12-20T14:32:42.39,5,False,1.0
2021,15,3280,680,20,8131,2,2,9,3,7,4,3,4,3,0,False,False,False,0,2,2021-12-22T15:20:57.193,7,False,4.0
2021,15,3280,695,20,2408,13,19,2,19,0,0,0,0,0,0,False,False,False,0,3,2021-12-20T14:41:24.673,0,False,0.0
2021,15,3280,715,30,63,13,4,9,10,0,0,0,0,0,0,False,False,False,0,3,2021-12-22T15:22:23.797,0,False,0.0
2021,15,3280,720,30,63,13,13,4,0,0,0,0,0,0,0,False,False,False,0,3,2021-12-20T14:55:38.747,0,False,0.0
2021,15,3280,745,20,2408,13,38,9,2,0,0,0,0,0,0,False,False,False,0,4,2021-12-22T15:32:19.533,0,False,0.0
2021,15,3280,755,30,7893,3,5,9,6,0,0,0,0,0,0,False,False,False,0,3,2021-12-20T15:11:15.947,0,False,0.0
2021,15,3280,760,30,63,13,5,5,5,0,0,0,0,0,0,False,False,False,0,4,2021-12-20T15:13:15.537,0,False,0.0
2021,15,3280,765,30,7893,2,13,4,3,6,3,4,2,4,0,False,False,False,0,3,2021-12-20T15:14:38.947,6,False,2.0
2021,15,3280,770,30,63,13,26,9,6,0,0,0,0,0,0,False,False,False,0,3,2021-12-20T15:16:40.07,0,False,
2021,15,3280,775,30,8307,13,19,6,39,0,0,0,0,0,0,False,False,False,0,3,2021-12-20T15:20:42.027,0,False,0.0
2021,15,3280,780,30,7893,2,12,5,13,18,5,13,5,13,0,False,False,False,0,3,2022-03-11T18:48:20.07,18,False,5.0
2021,15,3280,785,30,7891,13,4,4,5,0,0,0,0,0,0,False,False,False,0,1,2021-12-20T15:26:02.723,0,False,0.0
2021,15,3280,790,30,63,13,24,5,13,0,0,0,0,0,0,False,False,False,0,4,2021-12-20T15:27:35.63,0,False,0.0
2021,15,3280,795,30,7268,13,12,5,10,0,0,0,0,0,0,False,False,False,0,3,2022-02-24T19:23:48.61,0,False,0.0
2021,15,3280,870,30,7893,2,13,4,4,11,7,8,3,8,0,False,False,False,0,3,2021-12-20T15:52:40.443,11,False,3.0
2021,15,3280,875,30,7268,2,3,3,13,13,0,13,0,13,0,False,False,False,0,2,2021-12-20T16:01:46.15,13,False,0.0
2021,15,3280,880,30,8307,13,3,5,12,0,0,0,0,0,0,False,False,False,0,2,2021-12-22T14:36:19.127,0,False,0.0
2021,15,3281,20,18,7712,2,4,5,4,5,1,5,0,5,0,False,False,False,0,3,2021-12-21T11:14:02.41,5,False,0.0
2021,15,3281,30,18,4152,2,32,9,1,3,2,2,1,2,0,False,False,False,0,4,2021-12-21T11:16:47.783,3,False,1.0
2021,15,3281,35,18,6361,13,19,6,33,0,0,0,0,0,0,False,False,False,0,2,2021-12-21T11:18:10.87,0,False,0.0
2021,15,3281,55,6,7728,3,5,9,5,0,0,0,0,0,0,False,False,False,0,4,2022-02-16T19:41:27.903,0,False,0.0
2021,15,3281,65,6,7728,2,32,3,0,12,12,8,4,8,0,False,False,False,1,3,2021-12-21T11:24:53.28,12,False,4.0
2021,15,3281,80,18,4572,2,48,10,-4,0,4,-2,2,-2,0,False,False,False,0,1,2021-12-21T11:26:47.5,0,False,2.0
2021,15,3281,85,18,4572,2,45,10,-7,2,9,1,1,1,0,False,False,False,0,1,2021-12-21T16:08:01.447,2,False,1.0
2021,15,3281,90,18,7711,2,6,4,14,18,4,17,1,17,0,False,False,False,0,3,2021-12-21T11:29:39.23,18,False,1.0
2021,15,3281,115,18,7711,2,7,3,12,12,0,12,0,12,6,False,False,False,0,3,2021-12-21T11:37:51.84,12,False,0.0
2021,15,3281,175,18,6361,13,17,1,17,0,0,0,0,0,0,False,False,False,0,4,2021-12-21T16:11:33.94,0,False,
2021,15,3281,195,18,6361,13,23,10,12,0,0,0,0,0,0,False,False,False,0,4,2021-12-21T11:52:24.837,0,False,0.0
2021,15,3281,240,6,7725,2,35,2,16,27,11,26,1,26,0,False,False,False,0,3,2021-12-21T12:00:15.933,27,False,1.0
2021,15,3281,245,6,3233,3,35,3,14,0,0,0,0,0,0,False,False,False,0,3,2021-12-21T12:03:12.607,0,False,
2021,15,3281,260,6,7725,2,4,10,5,6,1,6,0,6,0,False,False,False,0,3,2021-12-21T12:06:57.343,6,False,0.0
2021,15,3281,275,18,7711,2,30,10,-2,4,6,3,1,3,0,False,False,False,0,3,2021-12-21T12:12:13.287,4,False,1.0
2021,15,3281,285,18,8386,13,9,2,24,0,0,0,0,0,0,False,False,False,0,3,2021-12-21T12:14:38.613,0,False,0.0
2021,15,3281,315,6,8365,2,45,5,4,8,4,7,1,7,0,False,False,False,0,1,2021-12-21T12:20:34.223,8,False,1.0
2021,15,3281,330,6,7725,2,13,9,3,9,6,4,5,4,0,False,False,False,1,3,2021-12-26T12:40:16.46,9,False,5.0
2021,15,3281,345,6,6786,2,11,3,11,12,1,11,1,11,0,True,False,False,0,1,2021-12-21T12:29:52.4,12,False,1.0
2021,15,3281,365,6,6786,2,49,3,-4,0,4,-3,3,-3,0,False,False,False,0,2,2021-12-21T12:34:13.61,0,False,3.0
2021,15,3281,375,6,3233,2,3,5,11,11,0,11,0,11,0,False,False,False,0,2,2021-12-21T12:36:03.233,11,False,0.0
2021,15,3281,395,18,7712,2,47,5,5,9,4,9,0,9,0,True,False,False,0,3,2021-12-21T12:38:06.753,9,False,0.0
2021,15,3281,405,18,7711,13,8,8,32,0,0,0,0,0,0,False,False,False,0,3,2021-12-26T12:38:25.723,0,False,0.0
2021,15,3281,410,6,6786,2,46,3,3,6,3,5,1,5,0,False,False,False,0,1,2021-12-26T12:40:30.67,6,False,1.0
2021,15,3281,415,6,6786,2,46,3,1,2,1,2,0,2,0,False,False,False,0,1,2021-12-21T12:43:34.867,2,False,0.0
2021,15,3281,425,6,6786,13,4,3,7,0,0,0,0,0,0,False,False,False,0,2,2021-12-21T12:45:06.313,0,False,0.0
2021,15,3281,435,18,6361,2,32,3,3,7,4,7,0,7,0,False,False,False,0,4,2021-12-21T12:46:56.73,7,False,0.0
2021,15,3281,445,18,7711,13,7,6,29,0,0,0,0,0,0,False,False,False,0,3,2021-12-26T12:36:23.923,0,False,0.0
2021,15,3281,485,6,7728,2,32,10,2,9,7,9,0,9,0,True,False,False,0,1,2022-02-22T19:41:20.78,9,False,0.0
2021,15,3281,510,18,7711,13,7,6,23,0,0,0,0,0,0,False,False,False,0,3,2021-12-21T13:47:16.93,0,False,0.0
2021,15,3281,530,18,4572,13,28,10,0,0,0,0,0,0,0,False,False,False,0,1,2021-12-26T12:37:37.807,0,False,0.0
2021,15,3281,535,18,7712,2,4,5,5,7,2,6,1,6,0,False,False,False,0,2,2021-12-21T13:54:53.46,7,False,1.0
2021,15,3281,555,18,8386,2,7,5,7,7,0,7,0,7,6,False,False,False,0,3,2021-12-21T14:00:12.9,7,True,0.0
2021,15,3281,585,6,7728,2,32,9,4,11,7,7,4,7,0,True,False,False,0,1,2021-12-21T14:17:15.657,11,False,4.0
2021,15,3281,625,6,7725,2,4,5,7,8,1,8,0,8,0,False,False,False,0,2,2021-12-21T14:26:32.023,8,False,0.0
2021,15,3281,645,18,7711,13,12,4,12,0,0,0,0,0,0,False,False,False,0,2,2022-02-24T19:24:57.303,0,False,0.0
2021,15,3281,660,18,7711,13,6,4,13,0,0,0,0,0,0,False,False,False,0,3,2021-12-21T14:33:03.823,0,False,0.0
2021,15,3281,680,18,7712,2,32,3,3,7,4,7,0,7,0,False,False,False,0,3,2021-12-21T14:46:45.32,7,False,
2021,15,3281,720,6,3233,2,4,3,7,12,5,10,2,10,0,False,False,False,0,2,2021-12-21T14:57:15.41,12,False,2.0
2021,15,3281,725,6,3233,2,6,9,11,11,0,11,0,11,0,False,False,False,0,3,2021-12-21T14:58:15.01,11,False,0.0
2021,15,3281,730,6,7728,2,17,1,19,23,4,20,3,20,0,False,False,False,0,3,2021-12-21T14:59:20.697,23,False,3.0
2021,15,3281,735,6,3233,2,4,3,11,11,0,11,0,11,0,False,False,False,0,2,2021-12-21T15:00:18.863,11,False,0.0
2021,15,3281,740,6,7728,2,2,4,5,6,1,6,0,6,0,False,False,False,0,3,2021-12-21T15:01:23.563,6,False,0.0
2021,15,3281,755,6,7728,13,12,9,9,0,0,0,0,0,0,False,False,False,0,4,2021-12-21T15:09:20.22,0,False,0.0
2021,15,3281,760,6,666,3,12,3,9,0,0,0,0,0,0,False,False,False,0,2,2022-02-22T19:46:26.493,0,False,0.0
2021,15,3281,765,6,7725,13,7,5,9,0,0,0,0,0,0,True,False,False,0,3,2021-12-26T12:37:58.71,0,False,0.0
2021,15,3281,790,18,7711,13,5,3,9,0,0,0,0,0,0,False,False,False,0,3,2021-12-21T15:19:22.853,0,False,0.0
2021,15,3281,805,6,7728,3,5,9,6,0,0,0,0,0,0,False,False,False,0,3,2021-12-21T15:28:58.357,0,False,0.0
2021,15,3281,815,6,8366,13,12,3,9,0,0,0,0,0,0,False,False,False,0,2,2021-12-26T12:39:16.03,0,False,0.0
2021,15,3281,820,6,7725,2,5,5,12,13,1,13,0,13,0,False,False,False,0,3,2021-12-26T12:38:10.277,13,True,0.0
2021,15,3281,825,6,6786,2,47,5,-1,3,4,2,1,2,0,False,False,False,0,1,2021-12-21T15:33:46.61,3,False,1.0
2021,15,3281,835,6,7725,13,9,3,14,0,0,0,0,0,0,False,False,False,0,3,2021-12-21T15:38:03.69,0,False,0.0
2021,15,3281,840,6,3233,3,5,5,6,0,0,0,0,0,0,False,False,False,0,3,2021-12-21T15:39:32.987,0,False,0.0
2021,15,3281,865,18,7711,2,35,5,13,13,0,13,0,13,0,False,False,False,0,3,2021-12-26T12:41:11.833,13,False,0.0
2021,15,3281,900,6,8365,2,4,4,5,16,11,13,3,13,0,False,False,False,0,1,2021-12-21T15:51:52.803,16,False,3.0
2021,15,3281,905,6,8365,2,4,4,3,10,7,8,2,8,0,False,False,False,0,1,2021-12-21T15:53:25.29,10,False,2.0
2021,15,3281,915,6,7728,2,5,5,5,10,5,8,2,8,0,False,False,False,0,3,2021-12-21T15:54:48.05,10,False,2.0
2021,15,3281,920,6,8365,3,5,5,4,0,0,0,0,0,0,False,False,False,0,1,2021-12-26T12:41:40.66,0,False,0.0
2021,15,3281,930,6,666,2,4,4,10,13,3,13,0,13,0,False,False,False,0,3,2021-12-21T15:57:46.083,13,False,0.0
2021,15,3281,940,6,3233,2,18,5,3,17,14,17,0,17,0,False,False,False,0,2,2021-12-26T11:46:47.147,17,True,0.0
2021,15,3281,945,6,6782,2,12,6,19,19,0,19,0,19,6,False,False,False,0,3,2021-12-21T16:01:16.89,19,False,0.0
2021,15,3282,35,22,2391,2,32,5,2,16,14,14,2,14,0,False,False,False,0,4,2021-12-23T14:41:16.227,16,False,2.0
2021,15,3282,45,22,8451,2,51,3,-4,2,6,-1,3,-1,0,True,False,False,0,1,2021-12-23T16:27:47.367,2,False,3.0
2021,15,3282,50,22,3170,2,5,3,6,14,8,11,3,11,0,True,False,False,0,3,2021-12-23T17:34:20.11,14,False,3.0
2021,15,3282,60,22,7121,2,13,5,3,19,16,11,8,11,0,False,False,False,0,4,2021-12-23T16:32:59.283,19,False,8.0
2021,15,3282,70,22,6270,2,51,3,-7,4,11,3,1,3,0,True,False,False,0,3,2021-12-23T14:24:25.28,4,False,1.0
2021,15,3282,90,17,6274,13,7,6,18,0,0,0,0,0,0,False,False,False,0,4,2021-12-20T11:32:08.457,0,False,0.0
2021,15,3282,100,22,2629,2,46,3,2,11,9,2,9,2,0,False,False,False,1,4,2021-12-20T11:35:10.603,11,False,9.0
2021,15,3282,110,22,8460,13,11,3,8,0,0,0,0,0,0,False,False,False,0,6,2021-12-23T16:54:47.043,0,False,0.0
2021,15,3282,135,17,364,13,11,6,35,0,0,0,0,0,0,True,False,False,0,3,2021-12-23T14:27:37.39,0,False,0.0
2021,15,3282,140,17,2253,13,8,7,15,0,0,0,0,0,0,False,False,False,0,2,2022-01-31T18:40:21.88,0,False,0.0
2021,15,3282,155,22,3170,13,12,3,4,0,0,0,0,0,0,True,False,False,0,3,2022-02-16T21:15:26.103,0,False,0.0
2021,15,3282,160,22,4997,13,6,4,10,0,0,0,0,0,0,False,False,False,0,2,2021-12-20T11:57:56.323,0,False,0.0
2021,15,3282,170,17,2253,2,5,5,5,5,0,5,0,5,0,False,False,False,0,3,2021-12-21T22:05:03.287,5,False,0.0
2021,15,3282,185,17,6274,2,47,5,1,1,0,1,0,1,0,False,False,False,0,4,2021-12-23T16:34:01.483,1,False,0.0
2021,15,3282,190,17,364,2,4,4,11,9,-2,11,-2,11,0,False,False,False,1,2,2021-12-23T17:35:36.093,9,False,-2.0
2021,15,3282,200,17,2253,2,7,6,31,37,6,33,4,33,0,False,False,False,0,2,2021-12-23T17:33:10.86,37,False,4.0
2021,15,3282,230,22,4997,13,9,6,29,0,0,0,0,0,0,False,False,False,0,3,2021-12-23T17:33:10.86,0,False,
2021,15,3282,240,22,3170,2,4,5,6,6,0,6,0,6,0,False,False,False,0,2,2021-12-20T13:22:36.16,6,False,0.0
2021,15,3282,250,22,2391,2,12,3,5,23,18,20,3,20,0,False,False,False,1,4,2021-12-20T13:25:20.88,23,False,3.0
2021,15,3282,295,17,2253,2,4,9,9,15,6,13,2,13,0,False,False,False,0,2,2021-12-20T14:01:17.957,15,False,2.0
2021,15,3282,340,17,6274,2,2,10,11,12,1,12,0,12,0,False,False,False,0,3,2021-12-23T14:31:10.62,12,False,0.0
2021,15,3282,345,17,6276,2,26,3,3,4,1,4,0,4,0,False,False,False,0,4,2021-12-20T14:17:53.573,4,False,0.0
2021,15,3282,350,17,6274,13,7,5,6,0,0,0,0,0,0,False,False,False,0,3,2021-12-23T17:36:02.48,0,False,0.0
2021,15,3282,355,17,4383,13,17,10,6,0,0,0,0,0,0,False,False,False,0,3,2021-12-23T14:31:31.303,0,False,0.0
2021,15,3282,385,22,3170,13,4,9,6,0,0,0,0,0,0,True,False,False,0,3,2021-12-20T14:29:42.58,0,False,0.0
2021,15,3282,390,22,3170,2,52,9,5,1,-4,1,0,1,0,False,False,False,0,3,2021-12-23T14:25:04.85,1,False,0.0
2021,15,3282,405,22,3170,13,2,9,8,0,0,0,0,0,0,True,False,False,0,3,2022-02-16T21:16:12.89,0,False,0.0
2021,15,3282,470,17,4752,2,9,6,24,27,3,26,1,26,0,False,False,False,0,3,2021-12-23T17:33:10.893,27,False,1.0
2021,15,3282,475,17,404,2,48,4,-8,20,28,4,16,4,0,False,False,False,3,1,2021-12-23T16:28:33.307,20,False,16.0
2021,15,3282,495,17,6274,2,5,10,10,20,10,19,1,19,0,True,False,False,0,3,2021-12-21T22:06:40.42,20,False,1.0
2021,15,3282,540,22,3170,2,4,9,5,9,4,7,2,7,0,False,False,False,0,3,2021-12-23T14:48:31.33,9,False,2.0
2021,15,3282,555,17,2253,13,3,3,9,0,0,0,0,0,0,False,False,False,0,2,2021-12-23T14:33:55.41,0,False,0.0
2021,15,3282,565,17,4752,2,5,3,3,7,4,4,3,4,0,False,False,False,0,1,2021-12-20T15:47:55.807,7,False,3.0
2021,15,3282,615,17,2253,13,9,3,8,0,0,0,0,0,0,False,False,False,0,3,2021-12-23T16:56:03.787,0,False,
2021,15,3282,620,17,7086,2,46,3,1,1,0,1,0,1,6,False,False,False,0,1,2021-12-23T16:56:14.217,1,True,0.0
2021,15,3282,635,22,2629,2,53,10,-3,24,27,10,14,10,0,False,False,False,1,4,2021-12-23T15:09:30.873,24,False,14.0
2021,15,3282,660,17,4752,2,4,10,9,17,8,14,3,14,0,False,False,False,0,3,2021-12-20T16:18:52.707,17,False,3.0
2021,15,3282,680,22,7610,13,19,2,27,0,0,0,0,0,0,False,False,False,0,2,2021-12-20T16:28:34.1,0,False,0.0
2021,15,3282,705,17,8487,13,4,3,4,0,0,0,0,0,0,False,False,False,0,2,2021-12-20T16:36:14.663,0,False,0.0
2021,15,3282,720,17,6274,2,30,9,-3,9,12,6,3,6,0,False,False,False,0,1,2021-12-23T14:28:56.673,9,False,3.0
2021,15,3282,730,17,6274,13,35,3,13,0,0,0,0,0,0,False,False,False,0,2,2021-12-23T15:13:34.267,0,False,0.0
2021,15,3282,755,17,2253,13,9,3,11,0,0,0,0,0,0,False,False,False,0,2,2021-12-23T14:36:49.937,0,False,0.0
2021,15,3282,760,17,2253,2,2,9,5,11,6,9,2,9,6,False,False,False,0,2,2021-12-23T16:56:27.167,11,False,2.0
2021,15,3282,785,22,8451,13,46,9,-3,0,0,0,0,0,0,False,False,False,0,1,2021-12-23T17:33:10.923,0,False,0.0
2021,15,3282,800,17,6274,2,30,3,-1,1,2,1,0,1,0,False,False,False,0,1,2021-12-23T15:14:17.673,1,False,0.0
2021,15,3282,820,17,2253,13,2,9,3,0,0,0,0,0,0,False,False,False,0,2,2021-12-21T22:08:27.923,0,False,0.0
2021,15,3282,835,22,7610,13,13,4,4,0,0,0,0,0,0,False,False,False,0,3,2021-12-23T17:33:10.923,0,False,0.0
2021,15,3282,840,22,7610,13,4,10,10,0,0,0,0,0,0,False,False,False,0,3,2021-12-23T16:56:53.28,0,False,0.0
2021,15,3282,845,22,3170,2,39,4,8,10,2,10,0,10,0,False,False,False,0,4,2021-12-20T17:08:39.153,10,False,0.0
2021,15,3282,855,22,4997,2,5,3,9,9,0,9,0,9,0,False,False,False,0,3,2021-12-23T15:14:44.093,9,False,0.0
2021,15,3283,10,32,7807,2,45,5,-4,19,23,17,2,17,0,False,False,False,1,1,2021-12-22T10:18:12.983,19,False,2.0
2021,15,3283,25,32,2675,2,26,10,6,7,1,7,0,7,0,False,False,False,0,3,2021-12-22T10:25:50.763,7,False,0.0
2021,15,3283,40,24,8509,2,5,5,4,5,1,5,0,5,0,False,False,False,0,3,2021-12-22T10:29:35.02,5,False,0.0
2021,15,3283,45,24,6373,3,47,5,4,0,0,0,0,0,0,False,False,False,0,4,2021-12-26T15:52:26.237,0,False,0.0
2021,15,3283,70,32,7807,2,47,5,4,6,2,6,0,6,0,False,False,False,0,1,2021-12-22T10:45:43.807,6,False,0.0
2021,15,3283,100,24,6937,2,51,10,-6,-1,5,-2,1,-2,0,True,False,False,0,1,2021-12-26T15:51:28.357,-1,False,1.0
2021,15,3283,105,24,6373,2,35,8,17,19,2,17,2,17,0,False,False,False,0,2,2021-12-22T11:00:29.003,19,False,2.0
2021,15,3283,115,24,8509,2,12,2,28,28,0,28,0,28,0,False,False,False,0,2,2021-12-22T11:06:39.413,28,False,0.0
2021,15,3283,130,32,7128,2,19,6,46,46,0,46,0,46,0,False,False,False,0,2,2021-12-22T11:18:11.863,46,False,0.0
2021,15,3283,135,32,4788,13,13,5,7,0,0,0,0,0,0,False,False,False,0,4,2021-12-22T11:20:27.697,0,False,0.0
2021,15,3283,145,32,2675,13,12,3,4,0,0,0,0,0,0,False,False,False,0,3,2021-12-26T15:50:11.207,0,False,0.0
2021,15,3283,170,24,6937,2,46,3,2,16,14,16,0,16,0,False,False,False,0,1,2021-12-22T11:30:08.487,16,False,0.0
2021,15,3283,175,24,6373,2,53,9,-6,9,15,8,1,8,0,False,False,False,0,4,2021-12-22T11:31:51.937,9,False,
2021,15,3283,220,32,7128,13,39,10,4,0,0,0,0,0,0,False,False,False,0,3,2021-12-22T11:54:41.867,0,False,0.0
2021,15,3283,235,24,6373,2,24,6,45,45,0,45,0,45,0,False,False,False,0,4,2021-12-22T12:04:09.677,45,False,0.0
2021,15,3283,250,24,7798,2,49,5,-2,6,8,5,1,5,0,False,False,False,0,2,2021-12-26T15:50:26.227,6,False,1.0
2021,15,3283,265,24,8509,13,5,5,2,0,0,0,0,0,0,False,False,False,0,3,2021-12-22T12:14:25.32,0,False,0.0
2021,15,3283,280,32,3562,2,44,3,1,5,4,4,1,4,0,True,False,False,0,3,2021-12-22T12:20:01.41,5,False,1.0
2021,15,3283,300,24,8509,13,23,1,61,0,0,0,0,0,0,False,False,False,0,2,2021-12-22T12:28:52.827,0,False,0.0
2021,15,3283,305,24,6373,2,4,10,5,5,0,5,0,5,0,False,False,False,0,3,2021-12-22T12:30:35.97,5,False,0.0
2021,15,3283,310,24,6373,2,39,4,5,8,3,8,0,8,0,False,False,False,0,3,2021-12-22T12:32:56.293,8,False,0.0
2021,15,3283,315,24,7798,2,35,6,15,17,2,17,0,17,0,False,False,False,0,3,2021-12-22T12:35:43.02,17,True,0.0
2021,15,3283,330,24,6373,2,35,6,20,21,1,21,0,21,0,False,False,False,0,3,2021-12-22T12:41:14.25,21,False,0.0
2021,15,3283,385,32,7807,2,51,10,-6,1,7,1,0,1,0,False,False,False,0,1,2021-12-22T13:02:55.143,1,False,0.0
2021,15,3283,390,32,4788,2,13,9,2,7,5,6,1,6,0,False,False,False,0,3,2021-12-26T15:59:10.293,7,False,1.0
2021,15,3283,395,32,7128,2,4,9,5,5,0,5,0,5,0,False,False,False,0,3,2021-12-22T13:05:55.187,5,False,0.0
2021,15,3283,405,32,4788,2,31,10,0,9,9,7,2,7,0,False,False,False,0,4,2021-12-22T13:07:31.457,9,False,2.0
2021,15,3283,440,24,6373,2,4,10,6,20,14,12,8,12,0,False,False,False,1,3,2021-12-22T13:45:51.3,20,False,8.0
2021,15,3283,445,24,4382,13,5,3,1,0,0,0,0,0,0,False,False,False,0,3,2021-12-23T23:44:04.403,0,False,0.0
2021,15,3283,465,32,7807,13,48,9,-5,0,0,0,0,0,0,False,False,False,0,1,2022-02-16T21:31:36,0,False,0.0
2021,15,3283,475,32,2675,13,13,3,4,0,0,0,0,0,0,False,False,False,0,3,2021-12-22T13:58:14.67,0,False,0.0
2021,15,3283,505,24,6373,3,53,10,-5,0,0,0,0,0,0,False,False,False,0,4,2021-12-22T16:26:03.9,0,False,0.0
2021,15,3283,520,32,3562,2,30,10,0,7,7,5,2,5,0,False,False,False,0,3,2021-12-26T15:52:39.56,7,False,2.0
2021,15,3283,525,32,4788,13,5,3,12,0,0,0,0,0,0,True,False,False,0,3,2021-12-22T14:18:59.787,0,False,0.0
2021,15,3283,535,32,7128,13,24,6,41,0,0,0,0,0,0,False,False,False,0,2,2021-12-26T15:59:30.087,0,False,0.0
2021,15,3283,550,24,7800,2,5,5,5,5,0,5,0,5,0,False,False,False,0,3,2021-12-22T14:28:12.437,5,False,0.0
2021,15,3283,565,24,4382,2,49,5,-2,9,11,5,4,5,0,False,False,False,0,2,2021-12-26T15:52:52.017,9,False,4.0
2021,15,3283,590,24,8509,2,4,4,7,7,0,7,0,7,0,False,False,False,0,3,2021-12-22T14:40:09.66,7,False,0.0
2021,15,3283,615,32,7807,2,47,5,1,5,4,4,1,4,0,False,False,False,0,1,2022-02-16T21:32:11.61,5,False,1.0
2021,15,3283,620,32,2675,13,9,6,22,0,0,0,0,0,0,False,False,False,0,3,2021-12-22T14:51:52.197,0,False,
2021,15,3283,635,32,4788,2,5,5,12,12,0,12,0,12,0,False,False,False,0,3,2021-12-22T15:01:15.643,12,False,0.0
2021,15,3283,640,32,8528,2,33,7,15,29,14,29,0,29,0,False,False,False,0,4,2021-12-22T16:24:35.053,29,False,0.0
2021,15,3283,665,24,7800,2,4,10,9,9,0,9,0,9,0,False,False,False,0,2,2021-12-22T15:12:54.607,9,False,0.0
2021,15,3283,670,24,8666,2,13,9,5,7,2,7,0,7,0,True,False,False,0,4,2021-12-22T15:17:49.853,7,False,0.0
2021,15,3283,680,24,8513,3,50,9,-1,0,0,0,0,0,0,False,False,False,0,2,2021-12-22T15:20:53.197,0,False,0.0
2021,15,3283,690,24,7798,2,50,5,0,34,34,12,22,12,0,False,False,False,0,2,2021-12-26T15:50:56.03,34,False,22.0
2021,15,3283,695,24,4382,2,29,2,19,19,0,19,0,19,6,False,False,False,0,3,2021-12-26T15:53:18.337,19,True,0.0
2021,15,3283,710,32,4788,13,11,2,22,0,0,0,0,0,0,True,False,False,0,4,2021-12-22T15:31:30.937,0,False,0.0
2021,15,3283,715,32,7807,2,45,5,-5,5,10,-4,9,-4,0,False,False,False,1,1,2021-12-26T15:53:05.213,5,False,9.0
2021,15,3283,720,32,2675,2,5,3,5,6,1,6,0,6,0,False,False,False,0,3,2021-12-26T15:59:38.347,6,False,0.0
2021,15,3283,725,32,4788,2,38,9,0,1,1,1,0,1,0,False,False,False,0,4,2021-12-22T15:36:41.713,1,False,0.0
2021,15,3283,730,32,6430,2,6,9,13,13,0,13,0,13,0,False,False,False,0,2,2021-12-22T15:38:49.043,13,False,0.0
2021,15,3283,735,32,2675,13,4,5,6,0,0,0,0,0,0,False,False,False,0,3,2021-12-22T15:40:55.483,0,False,0.0
2021,15,3283,745,32,2675,2,5,5,10,10,0,10,0,10,0,True,False,False,0,3,2021-12-22T15:43:48.363,10,False,0.0
2021,15,3283,750,32,7807,2,44,3,-2,3,5,2,1,2,0,False,False,False,0,1,2021-12-22T15:45:02.467,3,False,1.0
2021,15,3283,755,32,3562,13,4,10,6,0,0,0,0,0,0,False,False,False,0,2,2021-12-22T15:46:18.243,0,False,0.0
2021,15,3283,760,32,8533,2,12,5,-2,-2,0,-2,0,-2,0,False,False,False,0,2,2021-12-22T15:48:27.963,-2,False,0.0
2021,15,3283,790,24,6373,2,47,5,2,17,15,17,0,17,0,False,False,False,0,4,2021-12-26T15:11:09.37,17,False,0.0
2021,15,3284,15,8,3606,2,4,10,5,5,0,5,0,5,0,False,False,False,0,3,2021-12-21T10:31:58.39,5,False,0.0
2021,15,3284,20,8,4976,2,30,3,1,10,9,8,2,8,0,False,False,False,0,4,2021-12-21T10:33:30.453,10,False,2.0
2021,15,3284,30,8,7651,2,4,3,5,6,1,6,0,6,0,False,False,False,0,2,2021-12-21T10:35:21.203,6,False,0.0
2021,15,3284,55,23,7122,2,32,9,-2,-1,1,-1,0,-1,0,False,False,False,0,4,2021-12-21T10:41:44.24,-1,False,0.0
2021,15,3284,60,23,7250,2,5,10,3,12,9,9,3,9,0,True,False,False,0,3,2021-12-21T10:48:03.547,12,False,3.0
2021,15,3284,75,23,7246,2,6,10,12,14,2,14,0,14,0,False,False,False,0,4,2022-02-16T19:53:52.623,14,False,0.0
2021,15,3284,80,23,967,2,6,9,11,11,0,11,0,11,0,False,False,False,0,3,2021-12-23T18:06:48.653,11,False,0.0
2021,15,3284,90,23,7241,2,47,5,2,17,15,17,0,17,0,False,False,False,0,1,2021-12-21T10:53:06.167,17,False,0.0
2021,15,3284,95,23,3708,2,16,10,5,12,7,12,0,12,0,False,False,False,0,1,2021-12-21T10:55:33.33,12,False,0.0
2021,15,3284,110,23,7250,2,42,4,5,7,2,7,0,7,0,False,False,False,0,3,2021-12-23T17:59:50.68,7,False,0.0
2021,15,3284,120,23,7689,2,29,5,5,5,0,5,0,5,6,False,False,False,0,2,2021-12-21T11:03:00.223,5,True,0.0
2021,15,3284,140,8,4976,2,39,9,6,6,0,6,0,6,0,False,False,False,0,4,2021-12-23T18:27:14.007,6,False,0.0
2021,15,3284,145,8,6439,2,47,10,0,2,2,2,0,2,0,False,False,False,0,1,2022-02-16T19:54:37.457,2,False,0.0
2021,15,3284,150,8,7651,13,21,2,32,0,0,0,0,0,0,False,False,False,0,2,2021-12-21T11:14:15.313,0,False,0.0
2021,15,3284,155,8,8354,2,26,9,3,4,1,4,0,4,0,False,False,False,0,2,2021-12-23T18:07:21.27,4,False,0.0
2021,15,3284,170,23,4949,2,4,3,2,5,3,5,0,5,0,False,False,False,0,2,2021-12-21T11:18:51.387,5,False,0.0
2021,15,3284,180,23,7246,13,46,3,1,0,0,0,0,0,0,False,False,False,0,4,2021-12-21T11:21:12.097,0,False,0.0
2021,15,3284,185,23,4949,13,12,7,46,0,0,0,0,0,0,False,False,False,0,3,2022-02-24T19:26:55.317,0,False,
2021,15,3284,195,23,7246,2,53,10,-4,10,14,8,2,8,0,False,False,False,0,4,2021-12-21T11:26:40.073,10,False,2.0
2021,15,3284,200,23,7689,2,4,3,3,5,2,4,1,4,0,False,True,False,2,2,2021-12-21T11:28:04.443,-5,False,1.0
2021,15,3284,205,23,7246,3,4,4,8,0,0,0,0,0,0,False,False,False,0,3,2021-12-21T11:30:36.597,0,False,0.0
2021,15,3284,230,8,7009,2,2,10,3,3,0,3,0,3,0,False,False,False,0,2,2021-12-21T11:35:27.4,3,False,0.0
2021,15,3284,265,23,967,13,19,2,35,0,0,0,0,0,0,False,False,False,0,3,2021-12-21T11:43:35.187,0,False,0.0
2021,15,3284,280,8,7651,13,12,8,16,0,0,0,0,0,0,False,False,False,0,3,2022-02-24T19:27:07.377,0,False,0.0
2021,15,3284,290,8,7009,2,48,10,-4,4,8,3,1,3,0,False,False,False,0,1,2021-12-21T11:54:17.16,4,False,1.0
2021,15,3284,320,23,7250,2,4,10,12,13,1,13,0,13,0,False,False,False,0,3,2021-12-23T18:27:14.007,13,False,0.0
2021,15,3284,355,23,7689,2,2,10,6,8,2,7,1,7,0,False,False,False,0,2,2021-12-21T12:07:44.807,8,False,1.0
2021,15,3284,365,23,7250,13,4,9,3,0,0,0,0,0,0,False,False,False,0,3,2022-02-25T16:06:39.08,0,False,0.0
2021,15,3284,370,23,7250,13,12,3,6,0,0,0,0,0,0,False,False,False,0,3,2022-02-24T19:27:19.26,0,False,0.0
2021,15,3284,400,8,7651,13,29,6,20,0,0,0,0,0,0,False,False,False,0,2,2021-12-21T12:17:38.747,0,False,0.0
2021,15,3284,405,8,7009,2,46,3,2,4,2,4,0,4,0,False,False,False,0,1,2021-12-21T12:19:06.34,4,True,0.0
2021,15,3284,410,8,8354,2,4,10,7,9,2,9,0,9,0,False,False,False,0,3,2021-12-21T12:20:18.077,9,False,0.0
2021,15,3284,420,8,7651,13,4,5,13,0,0,0,0,0,0,False,False,False,0,3,2021-12-21T12:22:35.54,0,False,0.0
2021,15,3284,425,8,3606,2,2,10,8,13,5,12,1,12,0,False,False,False,0,2,2021-12-21T12:23:46.987,13,False,1.0
2021,15,3284,435,8,7651,13,6,10,14,0,0,0,0,0,0,False,False,False,0,2,2021-12-21T12:25:57.457,0,False,
2021,15,3284,440,8,3606,2,5,5,5,6,1,6,0,6,0,False,False,False,0,2,2021-12-21T12:27:40.56,6,True,0.0
2021,15,3284,445,8,3606,13,29,2,19,0,0,0,0,0,0,False,False,False,0,2,2021-12-23T18:27:14.007,0,False,0.0
2021,15,3284,475,23,7689,3,5,3,6,0,0,0,0,0,0,False,False,False,0,3,2021-12-21T12:49:49.333,0,False,0.0
2021,15,3284,480,23,967,3,4,8,18,0,0,0,0,0,0,False,False,False,0,2,2021-12-21T12:51:26.863,0,False,0.0
2021,15,3284,500,8,7651,2,5,5,6,6,0,6,0,6,0,False,False,False,0,3,2021-12-21T12:57:53.467,6,False,0.0
2021,15,3284,515,23,7246,2,4,9,5,6,1,5,1,5,0,True,False,False,0,3,2021-12-21T13:02:12.933,6,False,1.0
2021,15,3284,540,23,7241,2,4,4,4,16,12,11,5,11,0,False,False,False,1,1,2021-12-21T13:09:28.387,16,False,5.0
2021,15,3284,550,8,4976,2,53,10,-2,13,15,8,5,8,0,True,False,False,0,4,2021-12-21T13:13:26.737,13,False,5.0
2021,15,3284,575,8,4976,13,35,3,4,0,0,0,0,0,0,False,False,False,0,4,2021-12-21T13:21:37.74,0,False,0.0
2021,15,3284,600,23,7246,2,32,10,0,14,14,12,2,12,0,False,False,False,1,4,2021-12-21T13:25:48.573,14,False,2.0
2021,15,3284,620,23,4949,2,5,6,15,16,1,16,0,16,0,False,False,False,0,3,2022-02-22T19:51:32.9,16,True,0.0
2021,15,3284,645,23,4949,13,7,2,16,0,0,0,0,0,0,False,False,False,0,3,2021-12-21T13:48:04.407,0,False,0.0
2021,15,3284,680,8,8354,3,46,3,1,0,0,0,0,0,0,False,False,False,0,3,2021-12-21T13:50:51.027,0,False,0.0
2021,15,3284,685,8,4976,13,19,8,30,0,0,0,0,0,0,False,False,False,0,3,2021-12-21T13:52:28.2,0,False,0.0
2021,15,3284,700,23,4949,13,7,6,47,0,0,0,0,0,0,False,False,False,0,3,2021-12-21T14:08:26.533,0,False,0.0
2021,15,3284,710,23,4949,2,4,10,10,12,2,12,0,12,0,False,False,False,0,2,2021-12-21T14:11:11.15,12,False,0.0
2021,15,3284,735,8,7652,2,4,9,5,5,0,5,0,5,0,False,False,False,0,3,2021-12-21T15:13:34.443,5,False,0.0
2021,15,3284,750,8,7651,2,35,8,15,25,10,24,1,24,0,True,False,False,0,3,2021-12-21T14:21:42.033,25,False,1.0
2021,15,3284,765,8,3606,13,26,3,3,0,0,0,0,0,0,True,False,False,0,3,2022-02-24T19:27:32.74,0,False,0.0
2021,15,3284,770,8,7651,2,6,10,10,11,1,11,0,11,0,False,False,False,0,2,2021-12-21T14:30:19.537,11,False,0.0
2021,15,3284,780,8,8354,2,50,9,-1,3,4,2,1,2,0,False,False,False,0,3,2021-12-21T14:33:37.203,3,False,1.0
2021,15,3284,790,8,7009,2,48,10,-3,6,9,5,1,5,0,False,False,False,4,1,2021-12-23T18:02:34.653,6,False,1.0
2021,15,3284,795,8,7652,2,12,9,6,6,0,6,0,6,6,False,False,False,0,2,2022-02-24T19:27:42.737,6,True,0.0
2021,15,3284,815,23,7246,2,32,9,-2,6,8,2,4,2,0,False,False,False,0,4,2021-12-21T14:41:22.48,6,False,4.0
2021,15,3284,820,23,4949,2,5,5,5,7,2,7,0,7,0,False,False,False,0,3,2021-12-21T14:42:37.883,7,False,0.0
2021,15,3284,825,23,4949,13,8,8,46,0,0,0,0,0,0,False,False,False,0,2,2021-12-21T14:46:49.427,0,False,0.0
2021,15,3284,865,23,7241,3,4,10,5,0,0,0,0,0,0,False,False,False,0,1,2021-12-21T14:56:38.013,0,False,0.0
2021,15,3284,870,23,7246,2,32,5,1,3,2,3,0,3,0,False,False,False,0,4,2021-12-21T14:58:27.653,3,False,0.0
2021,15,3284,875,23,4949,2,2,10,11,12,1,12,0,12,0,False,False,False,0,2,2021-12-21T14:59:39.55,12,False,0.0
2021,15,3284,880,23,7241,2,16,10,4,9,5,9,0,9,0,False,False,False,0,1,2021-12-21T15:00:31.96,9,False,0.0
2021,15,3284,885,23,4949,2,17,8,15,17,2,17,0,17,0,False,False,False,0,2,2021-12-21T15:02:03.52,17,False,
2021,15,3284,890,23,7246,2,32,10,1,12,11,7,5,7,0,False,False,False,1,4,2021-12-23T18:08:03.843,12,False,5.0
2021,15,3284,895,23,4949,2,35,5,12,15,3,14,1,14,0,False,False,False,0,3,2021-12-21T15:08:53.64,15,False,1.0
2021,15,3285,15,5,3477,13,5,10,7,0,0,0,0,0,0,False,False,False,0,3,2022-02-16T19:13:55.16,0,False,0.0
2021,15,3285,20,5,8409,2,48,10,-7,1,8,-2,3,-2,0,True,False,False,0,1,2021-12-21T19:44:56.81,1,False,3.0
2021,15,3285,30,4,594,13,47,5,2,0,0,0,0,0,0,False,False,False,0,3,2021-12-26T20:52:47.97,0,False,0.0
2021,15,3285,35,4,6953,2,46,3,3,7,4,5,2,5,0,False,False,False,0,4,2022-02-16T19:14:23.493,7,False,
2021,15,3285,40,4,594,13,2,4,5,0,0,0,0,0,0,False,False,False,0,3,2022-02-16T19:14:56.107,0,False,0.0
2021,15,3285,60,5,5220,2,4,5,4,9,5,6,3,6,0,False,False,False,0,2,2022-02-16T19:33:54.237,9,False,3.0
2021,15,3285,85,5,5220,13,4,9,9,0,0,0,0,0,0,False,False,False,0,3,2021-12-20T13:49:08.197,0,False,0.0
2021,15,3285,90,5,2688,13,23,7,17,0,0,0,0,0,0,False,False,False,0,3,2021-12-22T19:44:07.09,0,False,0.0
2021,15,3285,100,4,7646,2,4,9,12,12,0,12,0,12,0,True,False,False,0,2,2021-12-21T18:43:26.073,12,False,0.0
2021,15,3285,110,4,6953,2,12,5,2,9,7,8,1,8,0,False,False,False,0,3,2022-02-24T19:28:30.22,9,False,1.0
2021,15,3285,140,5,6372,2,2,10,5,8,3,5,3,5,0,False,False,False,0,2,2022-02-16T19:17:59.743,8,False,3.0
2021,15,3285,155,5,3477,13,51,9,-3,0,0,0,0,0,0,False,False,False,0,3,2022-02-16T19:18:52.617,0,False,0.0
2021,15,3285,160,4,7646,13,19,6,46,0,0,0,0,0,0,False,False,False,0,2,2021-12-20T14:22:57.943,0,False,0.0
2021,15,3285,170,4,6953,2,33,10,13,15,2,15,0,15,0,True,False,False,0,4,2021-12-20T14:25:50.893,15,False,0.0
2021,15,3285,185,4,2853,2,4,3,9,9,0,9,0,9,0,True,False,False,0,2,2021-12-21T18:42:23.23,9,False,0.0
2021,15,3285,205,5,3477,13,2,10,6,0,0,0,0,0,0,False,False,False,0,2,2021-12-20T14:43:18.513,0,False,0.0
2021,15,3285,230,4,6953,2,35,4,8,10,2,8,2,8,0,False,False,False,0,4,2022-02-16T19:19:16.167,10,False,2.0
2021,15,3285,235,4,594,2,5,5,4,12,8,10,2,10,0,False,False,False,0,3,2021-12-26T20:57:53.99,12,False,2.0
2021,15,3285,250,4,2853,2,29,5,9,11,2,9,2,9,6,False,False,False,0,3,2021-12-20T18:35:49.677,11,False,2.0
2021,15,3285,280,5,8408,2,47,5,2,8,6,6,2,6,0,False,False,False,0,4,2021-12-20T15:14:44.007,8,False,2.0
2021,15,3285,285,5,5220,13,2,4,9,0,0,0,0,0,0,False,False,False,0,2,2021-12-20T15:15:58.517,0,False,0.0
2021,15,3285,290,5,566,2,4,10,3,9,6,5,4,5,0,False,False,False,1,1,2021-12-20T15:30:03.03,9,False,4.0
2021,15,3285,300,5,5220,13,19,2,35,0,0,0,0,0,0,False,False,False,0,2,2021-12-20T15:32:24.39,0,False,0.0
2021,15,3285,310,5,5220,2,13,4,3,4,1,4,0,4,0,False,False,False,0,3,2021-12-22T19:44:25.7,4,False,0.0
2021,15,3285,335,4,6953,2,38,5,3,4,1,3,1,3,0,False,False,False,0,3,2021-12-21T18:50:04.83,4,False,1.0
2021,15,3285,340,4,2853,13,5,8,15,0,0,0,0,0,0,False,False,False,0,2,2021-12-20T15:43:05.81,0,False,0.0
2021,15,3285,390,4,6983,2,4,4,1,10,9,8,2,8,0,False,False,False,1,1,2021-12-20T15:56:44.897,10,False,2.0
2021,15,3285,395,4,594,2,5,5,5,9,4,8,1,8,0,False,False,False,0,3,2021-12-20T15:57:04.107,9,False,1.0
2021,15,3285,400,4,5119,2,4,9,6,7,1,6,1,6,0,False,False,False,0,3,2021-12-20T15:59:15.053,7,False,1.0
2021,15,3285,405,4,7646,2,5,3,11,11,0,11,0,11,0,False,False,False,0,2,2021-12-22T19:13:04.233,11,True,0.0
2021,15,3285,410,4,6953,13,19,1,34,0,0,0,0,0,0,False,False,False,0,3,2021-12-22T16:33:50.19,0,True,
2021,15,3285,415,4,594,2,2,4,7,7,0,7,0,7,0,False,False,False,0,3,2021-12-20T16:05:14.673,7,False,0.0
2021,15,3285,435,4,2853,2,6,10,5,7,2,6,1,6,0,False,False,False,0,2,2021-12-22T19:02:30.577,7,False,1.0
2021,15,3285,445,4,594,2,5,3,5,7,2,7,0,7,0,False,False,False,0,3,2021-12-20T16:11:14.71,7,False,0.0
2021,15,3285,480,4,594,13,4,4,5,0,0,0,0,0,0,False,False,False,0,3,2021-12-20T16:19:16.127,0,False,0.0
2021,15,3285,485,4,6983,13,12,10,3,0,0,0,0,0,0,False,False,False,0,1,2021-12-22T19:04:24.15,0,False,0.0
2021,15,3285,500,4,6990,3,35,10,10,0,0,0,0,0,0,False,False,False,0,4,2021-12-20T16:29:34.937,0,False,0.0
2021,15,3285,505,4,594,13,5,5,7,0,0,0,0,0,0,False,False,False,0,3,2021-12-20T16:32:55.95,0,False,0.0
2021,15,3285,520,5,8408,13,29,2,20,0,0,0,0,0,0,False,False,False,0,2,2021-12-22T17:19:17.993,0,False,0.0
2021,15,3285,525,5,3477,2,3,3,11,11,0,11,0,11,0,False,False,False,0,2,2021-12-20T16:40:44.473,11,False,0.0
2021,15,3285,550,4,2853,2,4,5,5,8,3,8,0,8,0,False,False,False,0,2,2021-12-20T16:48:13.77,8,False,0.0
2021,15,3285,560,4,7646,13,35,4,9,0,0,0,0,0,0,False,False,False,0,3,2021-12-22T19:38:42.337,0,False,0.0
2021,15,3285,575,4,6953,13,7,2,24,0,0,0,0,0,0,False,False,False,0,4,2021-12-20T16:58:20.407,0,False,0.0
2021,15,3285,580,4,7646,2,8,9,13,28,15,14,14,14,0,False,False,False,1,2,2022-02-16T19:20:26.663,28,False,14.0
2021,15,3285,595,4,7646,2,20,1,20,20,0,20,0,20,6,True,False,False,0,2,2021-12-20T17:05:02.33,20,True,0.0
2021,15,3285,615,5,6425,13,4,9,6,0,0,0,0,0,0,False,False,False,0,4,2022-02-16T19:21:03.407,0,False,
2021,15,3285,620,5,3477,2,5,5,13,13,0,13,0,13,0,True,False,False,0,3,2022-02-16T19:21:15.497,13,False,0.0
2021,15,3285,630,5,5220,2,4,10,6,9,3,7,2,7,0,False,False,False,0,2,2021-12-20T19:07:00.127,9,False,2.0
2021,15,3285,640,5,3477,13,4,3,6,0,0,0,0,0,0,False,False,False,0,2,2021-12-20T17:17:21.813,0,False,0.0
2021,15,3285,655,5,6372,2,35,10,9,9,0,9,0,9,0,False,False,False,0,4,2022-02-16T19:22:18.177,9,False,0.0
2021,15,3285,665,5,6372,13,2,10,8,0,0,0,0,0,0,False,False,False,0,2,2022-02-16T19:22:44.67,0,False,0.0
2021,15,3285,675,5,3477,13,2,9,10,0,0,0,0,0,0,False,False,False,0,2,2022-02-16T19:23:44.663,0,False,0.0
2021,15,3285,680,5,6372,13,4,9,10,0,0,0,0,0,0,False,False,False,0,3,2021-12-22T19:40:24.243,0,False,0.0
2021,15,3285,700,5,5220,13,26,10,5,0,0,0,0,0,0,False,False,False,0,3,2021-12-22T19:44:42.27,0,False,0.0
2021,15,3285,730,5,5220,2,50,9,1,16,15,16,0,16,0,False,False,False,0,2,2021-12-22T19:44:57.027,16,False,0.0
2021,15,3285,735,5,8198,13,17,8,17,0,0,0,0,0,0,False,False,False,0,1,2022-02-22T19:34:36.45,0,False,0.0
2021,15,3285,740,5,5220,2,13,4,4,4,0,4,0,4,0,False,False,False,0,3,2021-12-22T19:16:12.007,4,False,0.0
2021,15,3285,745,5,566,2,16,4,5,23,18,20,3,20,6,False,False,False,1,1,2021-12-22T19:19:18.01,23,False,3.0
2021,15,3285,770,4,2853,13,12,6,18,0,0,0,0,0,0,False,False,False,0,2,2021-12-21T18:45:44.25,0,False,0.0
2021,15,3285,780,5,3477,2,46,3,0,5,5,4,1,4,0,False,False,False,0,3,2021-12-22T17:19:18.027,5,False,1.0
2021,15,3285,785,5,8408,13,2,4,3,0,0,0,0,0,0,False,False,False,0,4,2021-12-20T17:58:08.123,0,False,0.0
2021,15,3285,790,5,5220,2,5,3,5,6,1,5,1,5,0,False,False,False,0,3,2021-12-21T19:49:01.68,6,False,1.0
2021,15,3285,805,5,5220,13,21,6,25,0,0,0,0,0,0,False,False,False,0,2,2021-12-22T17:19:18.027,0,False,0.0
2021,15,3285,815,5,566,2,4,4,5,8,3,8,0,8,0,False,False,False,0,1,2021-12-22T19:11:17.59,8,False,0.0
2021,15,3285,885,4,7646,2,33,10,12,14,2,14,0,14,6,True,False,False,0,4,2021-12-21T18:46:21.12,14,True,0.0
2021,15,3285,900,5,6425,2,5,10,5,5,0,5,0,5,0,False,False,False,0,3,2021-12-20T18:21:27.167,5,False,0.0
2021,15,3285,910,5,6425,3,38,3,2,0,0,0,0,0,0,False,False,False,0,4,2021-12-20T18:23:48.983,0,False,
2021,15,3285,915,5,8408,13,6,9,6,0,0,0,0,0,0,False,False,False,0,4,2021-12-20T18:25:26.043,0,False,0.0
2021,15,3285,920,5,566,2,4,4,4,8,4,8,0,8,0,False,False,False,0,1,2021-12-20T18:26:31.267,8,False,0.0
2021,15,3285,925,5,8406,13,4,3,8,0,0,0,0,0,0,False,False,False,0,2,2021-12-20T18:27:41.607,0,False,0.0
2021,15,3286,10,14,7584,2,5,5,5,7,2,6,1,6,0,True,False,False,0,4,2021-12-22T15:29:08.223,7,False,1.0
2021,15,3286,15,14,7584,13,4,5,3,0,0,0,0,0,0,False,False,False,0,3,2022-02-24T19:29:29.31,0,False,0.0
2021,15,3286,20,14,7584,13,19,2,30,0,0,0,0,0,0,False,False,False,0,2,2021-12-19T14:40:47.207,0,False,0.0
2021,15,3286,35,19,8493,2,45,5,-5,4,9,2,2,2,0,False,False,False,0,1,2021-12-19T14:44:10.723,4,False,2.0
2021,15,3286,40,19,7175,2,6,4,9,10,1,9,1,9,0,True,False,False,0,2,2021-12-19T14:54:41.253,10,False,1.0
2021,15,3286,55,19,5096,2,53,10,-5,14,19,-1,15,-1,0,False,False,False,1,4,2021-12-19T14:58:46.57,14,False,
2021,15,3286,115,14,6543,2,55,9,-4,8,12,-1,9,-1,6,False,False,False,0,3,2021-12-22T15:29:45.81,8,False,9.0
2021,15,3286,135,19,4912,2,4,5,6,9,3,6,3,6,0,False,False,False,0,3,2021-12-19T15:16:54.93,9,False,3.0
2021,15,3286,140,19,7175,2,26,5,2,4,2,3,1,3,0,True,False,False,0,3,2021-12-20T15:47:12.037,4,False,1.0
2021,15,3286,155,19,7175,3,19,6,28,0,0,0,0,0,0,False,False,False,0,2,2021-12-19T15:23:10.157,0,False,0.0
2021,15,3286,175,19,5096,2,32,5,3,3,0,3,0,3,0,False,False,False,0,4,2021-12-19T15:26:12.023,3,False,0.0
2021,15,3286,185,19,2256,2,5,5,5,5,0,5,0,5,0,False,False,False,0,3,2021-12-22T15:30:37.453,5,False,0.0
2021,15,3286,220,14,4449,2,35,2,21,23,2,22,1,22,0,False,False,False,0,3,2021-12-19T15:37:26.943,23,False,1.0
2021,15,3286,265,14,5197,13,17,9,7,0,0,0,0,0,0,False,False,False,0,3,2022-02-16T20:46:43.003,0,False,0.0
2021,15,3286,280,19,4912,2,35,2,15,15,0,15,0,15,0,False,False,False,0,3,2021-12-19T15:55:31.303,15,False,0.0
2021,15,3286,290,19,5096,13,17,7,17,0,0,0,0,0,0,False,False,False,0,4,2021-12-19T15:58:41.12,0,False,0.0
2021,15,3286,295,19,4282,2,7,8,19,25,6,21,4,21,0,False,False,False,0,4,2021-12-19T16:00:04.413,25,False,4.0
2021,15,3286,325,19,4282,13,35,9,9,0,0,0,0,0,0,False,False,False,0,4,2021-12-19T16:05:41.363,0,False,0.0
2021,15,3286,360,19,7175,2,5,5,7,7,0,7,0,7,0,False,False,False,0,3,2021-12-19T16:48:59.55,7,False,0.0
2021,15,3286,365,19,1212,13,5,5,2,0,0,0,0,0,0,False,False,False,0,1,2021-12-19T16:50:06.073,0,False,0.0
2021,15,3286,370,14,1119,2,46,3,0,0,0,0,0,0,0,True,False,False,0,4,2021-12-19T16:52:16.203,0,False,0.0
2021,15,3286,375,14,7584,13,35,5,13,0,0,0,0,0,0,False,False,False,0,3,2021-12-19T16:53:42.883,0,False,0.0
2021,15,3286,415,19,2256,13,24,2,27,0,0,0,0,0,0,False,False,False,0,3,2021-12-19T17:01:55.7,0,False,0.0
2021,15,3286,425,19,2256,2,3,3,9,9,0,9,0,9,0,False,False,False,0,2,2021-12-19T17:04:59.627,9,False,0.0
2021,15,3286,430,19,2256,2,3,3,10,10,0,10,0,10,0,False,False,False,0,2,2021-12-19T17:06:33.12,10,False,0.0
2021,15,3286,435,19,2256,13,7,3,13,0,0,0,0,0,0,False,False,False,0,2,2022-02-25T16:08:44.867,0,False,0.0
2021,15,3286,440,14,7584,13,35,2,14,0,0,0,0,0,0,False,False,False,0,3,2022-02-22T20:22:18.54,0,False,0.0
2021,15,3286,460,14,6543,13,4,5,8,0,0,0,0,0,0,True,False,False,0,2,2021-12-19T17:16:00.813,0,False,0.0
2021,15,3286,480,19,4282,2,6,10,14,14,0,14,0,14,0,False,False,False,0,3,2021-12-19T17:22:39.527,14,False,0.0
2021,15,3286,485,19,2256,2,6,4,10,10,0,10,0,10,0,False,False,False,0,2,2021-12-22T15:31:36.793,10,False,0.0
2021,15,3286,495,19,5096,13,17,1,17,0,0,0,0,0,0,False,False,False,0,4,2021-12-19T17:27:31.54,0,False,0.0
2021,15,3286,500,19,4282,2,6,9,6,8,2,6,2,6,0,False,False,False,0,3,2021-12-19T17:29:28.093,8,False,2.0
2021,15,3286,505,19,4282,2,5,9,5,11,6,8,3,8,0,True,False,False,0,3,2021-12-19T17:31:29.847,11,False,3.0
2021,15,3286,520,19,1212,2,48,10,-3,13,16,7,6,7,0,False,False,False,0,1,2021-12-19T17:35:24.487,13,False,6.0
2021,15,3286,530,19,4282,2,6,9,12,12,0,12,0,12,6,False,False,False,0,4,2021-12-22T14:59:36.427,12,True,0.0
2021,15,3286,550,14,1114,2,13,10,5,19,14,9,10,9,0,False,False,False,1,4,2021-12-22T14:23:24.927,19,False,10.0
2021,15,3286,555,14,4449,13,35,10,7,0,0,0,0,0,0,False,False,False,0,3,2021-12-19T17:42:42.797,0,False,0.0
2021,15,3286,560,19,7175,13,35,6,16,0,0,0,0,0,0,True,False,False,0,3,2021-12-20T15:47:27.6,0,False,0.0
2021,15,3286,565,19,7173,3,4,3,10,0,0,0,0,0,0,False,False,False,0,2,2022-02-16T20:48:25.967,0,False,0.0
2021,15,3286,570,19,1212,2,44,3,-2,12,14,8,4,8,0,False,False,False,0,1,2021-12-19T17:48:18.487,12,False,4.0
2021,15,3286,575,19,7175,13,38,3,11,0,0,0,0,0,0,False,False,False,0,4,2021-12-22T14:23:24.927,0,False,0.0
2021,15,3286,580,19,7173,2,6,4,7,9,2,9,0,9,0,False,False,False,0,2,2021-12-19T17:55:20.76,9,False,0.0
2021,15,3286,590,19,7175,2,42,4,3,10,7,8,2,8,0,True,False,False,0,3,2021-12-19T17:57:39.567,10,False,2.0
2021,15,3286,600,19,7175,13,7,10,4,0,0,0,0,0,0,False,False,False,0,3,2021-12-19T18:01:09.13,0,False,0.0
2021,15,3286,615,19,4282,13,12,3,7,0,0,0,0,0,0,False,False,False,0,3,2021-12-19T18:03:45.77,0,False,0.0
2021,15,3286,690,19,4912,2,6,8,19,20,1,20,0,20,0,False,False,False,0,3,2021-12-19T18:27:15.26,20,False,0.0
2021,15,3286,700,19,7175,2,13,10,4,4,0,4,0,4,0,False,False,False,0,3,2021-12-19T18:30:21.05,4,False,0.0
2021,15,3286,705,19,4282,2,5,5,9,12,3,11,1,11,0,False,False,False,0,3,2021-12-19T18:33:42.013,12,False,
2021,15,3286,710,19,7173,2,8,7,40,43,3,40,3,40,0,False,False,False,0,2,2021-12-19T18:36:59.277,43,False,3.0
2021,15,3286,715,19,7175,13,16,10,7,0,0,0,0,0,0,False,False,False,0,3,2021-12-22T14:23:24.927,0,False,0.0
2021,15,3286,725,19,4282,2,4,9,7,7,0,7,0,7,6,False,False,False,0,4,2021-12-22T15:33:01.223,7,True,0.0
2021,15,3286,765,19,7175,2,6,10,7,9,2,9,0,9,0,False,False,False,0,3,2021-12-19T18:48:12.487,9,False,0.0
2021,15,3286,775,19,1212,2,48,9,-1,16,17,9,7,9,0,False,False,False,1,1,2021-12-19T18:49:50.557,16,False,7.0
2021,15,3286,780,19,7173,13,6,1,21,0,0,0,0,0,0,False,False,False,0,2,2022-02-22T20:23:38.09,0,False,0.0
2021,15,3286,790,19,7175,13,5,3,11,0,0,0,0,0,0,False,False,False,0,3,2021-12-22T15:00:59.487,0,False,0.0
2021,15,3286,800,19,7177,13,3,5,13,0,0,0,0,0,0,False,False,False,0,2,2021-12-19T18:57:46.017,0,False,0.0
2021,16,3287,10,28,7619,2,4,9,4,4,0,4,0,4,0,False,False,False,0,3,2021-12-29T21:32:19.15,4,False,0.0
2021,16,3287,15,28,7224,2,5,5,5,10,5,8,2,8,0,False,False,False,0,3,2021-12-24T13:34:59.003,10,False,2.0
2021,16,3287,30,28,4922,2,5,5,4,5,1,4,1,4,0,True,False,False,0,3,2021-12-25T18:44:16.03,5,False,1.0
2021,16,3287,35,28,7619,2,30,10,-2,17,19,17,0,17,0,False,False,False,0,3,2021-12-24T13:39:26.27,17,False,0.0
2021,16,3287,45,28,7224,2,6,9,8,23,15,15,8,15,0,False,False,False,0,3,2021-12-24T13:41:06.067,23,False,8.0
2021,16,3287,65,31,6722,2,48,4,-8,-8,0,-8,0,-8,0,False,False,False,0,1,2021-12-24T13:44:32.38,-8,False,0.0
2021,16,3287,75,31,7913,2,4,4,14,14,0,14,0,14,0,False,False,False,0,3,2021-12-24T16:49:32.403,14,False,0.0
2021,16,3287,85,31,3911,2,51,10,-3,3,6,1,2,1,0,False,False,False,0,3,2021-12-24T14:00:00.227,3,False,2.0
2021,16,3287,110,28,6624,2,46,3,3,3,0,3,0,3,0,False,False,False,0,1,2021-12-24T16:59:16.12,3,False,0.0
2021,16,3287,115,28,262,2,48,3,-3,26,29,-2,28,-2,0,True,False,False,0,1,2021-12-25T18:44:29.367,26,False,28.0
2021,16,3287,125,28,4922,2,6,4,12,16,4,15,1,15,0,False,False,False,0,4,2021-12-29T22:15:47.633,16,False,1.0
2021,16,3287,135,28,4922,13,4,10,8,0,0,0,0,0,0,False,False,False,0,4,2021-12-24T14:10:28.61,0,False,0.0
2021,16,3287,145,31,661,2,4,3,4,7,3,5,2,5,0,False,False,False,0,3,2021-12-24T14:12:38.717,7,False,2.0
2021,16,3287,150,31,6793,2,34,4,-4,-3,1,-3,0,-3,0,True,False,False,0,3,2021-12-24T16:59:41.357,-3,False,0.0
2021,16,3287,165,28,6624,2,48,9,-7,11,18,8,3,8,0,False,False,False,0,1,2021-12-24T14:16:03.563,11,False,3.0
2021,16,3287,180,28,262,13,9,2,29,0,0,0,0,0,0,False,False,False,0,3,2021-12-24T14:18:50.353,0,False,0.0
2021,16,3287,185,28,7751,2,4,9,4,6,2,6,0,6,0,False,False,False,0,1,2021-12-29T21:33:14.637,6,False,0.0
2021,16,3287,195,28,7224,2,12,5,10,11,1,11,0,11,0,False,False,False,0,3,2022-02-17T21:40:54.563,11,True,0.0
2021,16,3287,205,28,6624,2,48,10,-7,-2,5,-4,2,-4,0,False,False,False,0,1,2021-12-24T14:23:59.76,-2,False,2.0
2021,16,3287,215,28,7224,2,50,9,-2,6,8,-2,8,-2,0,False,False,False,2,2,2021-12-29T21:40:43.823,6,False,8.0
2021,16,3287,240,31,6793,2,4,9,11,11,0,11,0,11,0,False,False,False,0,2,2021-12-24T14:31:59.767,11,False,0.0
2021,16,3287,245,31,6793,2,5,5,4,4,0,4,0,4,0,False,False,False,0,3,2021-12-24T14:33:05.123,4,True,0.0
2021,16,3287,260,31,6793,13,6,10,4,0,0,0,0,0,0,False,False,False,0,3,2021-12-24T14:35:47.58,0,False,0.0
2021,16,3287,270,28,7224,13,6,4,13,0,0,0,0,0,0,False,False,False,0,2,2021-12-29T22:16:35.97,0,False,0.0
2021,16,3287,295,31,2865,2,32,5,0,0,0,0,0,0,0,False,False,False,0,4,2021-12-24T14:42:35.827,0,False,0.0
2021,16,3287,310,31,6793,2,5,3,11,12,1,12,0,12,0,False,False,False,0,3,2022-02-17T21:35:19.78,12,False,0.0
2021,16,3287,320,31,6793,13,19,2,39,0,0,0,0,0,0,False,False,False,0,2,2021-12-24T14:47:31.187,0,False,0.0
2021,16,3287,325,31,7913,13,2,10,8,0,0,0,0,0,0,False,False,False,0,2,2021-12-24T14:48:21.607,0,False,0.0
2021,16,3287,330,31,6793,2,52,9,1,0,-1,0,0,0,0,False,False,False,0,2,2021-12-24T14:49:22.09,0,False,0.0
2021,16,3287,350,28,7753,13,8,1,45,0,0,0,0,0,0,False,False,False,0,4,2021-12-24T14:52:53.977,0,False,0.0
2021,16,3287,355,28,7751,2,50,5,-3,8,11,5,3,5,0,True,False,False,0,2,2021-12-24T14:55:04.793,8,False,3.0
2021,16,3287,380,31,6793,3,2,9,12,0,0,0,0,0,0,False,False,False,0,2,2022-02-16T19:29:16.713,0,False,0.0
2021,16,3287,390,31,7913,2,4,1,16,24,8,17,7,17,0,False,False,False,0,3,2021-12-24T16:49:51.243,24,False,7.0
2021,16,3287,395,31,6793,13,29,2,17,0,0,0,0,0,0,True,False,False,0,3,2021-12-24T15:09:32.9,0,False,0.0
2021,16,3287,405,31,6793,2,5,3,9,18,9,9,9,9,0,False,False,False,1,3,2022-02-17T21:53:51.01,18,False,9.0
2021,16,3287,410,31,6888,2,30,10,-3,-1,2,-1,0,-1,0,False,False,False,0,1,2021-12-29T21:57:18.413,-1,False,0.0
2021,16,3287,420,31,6793,2,4,9,13,13,0,13,0,13,0,False,False,False,0,2,2021-12-25T18:34:40.08,13,False,0.0
2021,16,3287,430,31,6722,2,51,10,-7,2,9,1,1,1,0,False,False,False,0,1,2021-12-24T15:18:34.377,2,False,1.0
2021,16,3287,435,31,4545,13,48,10,-6,0,0,0,0,0,0,False,False,False,0,1,2021-12-24T15:19:42.38,0,False,0.0
2021,16,3287,450,28,7224,13,6,9,14,0,0,0,0,0,0,False,False,False,0,3,2021-12-24T15:21:49.2,0,False,0.0
2021,16,3287,465,31,6793,13,9,5,3,0,0,0,0,0,0,False,False,False,0,3,2021-12-29T21:58:07.207,0,False,0.0
2021,16,3287,485,28,262,2,30,10,0,4,4,3,1,3,0,False,False,False,0,1,2021-12-24T15:32:45.173,4,False,1.0
2021,16,3287,500,28,7753,2,4,10,10,11,1,10,1,10,0,False,False,False,0,3,2021-12-29T21:38:58.02,11,False,1.0
2021,16,3287,505,28,7619,2,35,9,5,17,12,12,5,12,0,False,False,False,2,3,2021-12-29T21:44:37.727,17,False,5.0
2021,16,3287,530,28,7619,13,13,10,4,0,0,0,0,0,0,False,False,False,0,3,2021-12-24T15:43:02.49,0,False,0.0
2021,16,3287,540,31,2901,2,32,3,1,9,8,1,8,1,0,False,False,False,2,4,2021-12-29T21:48:01.343,9,False,
2021,16,3287,550,31,6793,2,19,2,41,42,1,41,1,41,0,False,False,False,0,3,2021-12-25T18:35:47.21,42,False,1.0
2021,16,3287,570,31,6793,2,12,3,7,12,5,8,4,8,0,False,False,False,0,3,2021-12-24T15:59:17.973,12,False,4.0
2021,16,3287,575,31,6793,2,8,7,18,18,0,18,0,18,6,False,False,False,0,2,2022-02-17T21:55:27.473,18,True,0.0
2021,16,3287,590,28,7753,3,39,4,5,0,0,0,0,0,0,False,False,False,0,3,2021-12-24T16:01:52.363,0,False,0.0
2021,16,3287,600,28,7224,2,6,4,12,19,7,17,2,17,0,False,False,False,0,3,2021-12-24T16:03:56.313,19,False,2.0
2021,16,3287,615,28,7753,2,26,9,4,8,4,8,0,8,0,False,False,False,0,3,2022-02-24T19:31:05.59,8,False,0.0
2021,16,3287,620,28,7224,2,52,4,2,12,10,10,2,10,0,True,False,False,0,3,2021-12-25T18:44:48.07,12,False,2.0
2021,16,3287,630,31,6793,2,8,9,12,18,6,17,1,17,0,True,False,False,0,2,2021-12-25T18:34:53.11,18,False,1.0
2021,16,3287,645,31,6724,2,38,4,4,13,9,11,2,11,0,False,False,False,0,3,2021-12-24T16:12:04.007,13,False,2.0
2021,16,3287,655,31,8333,13,7,2,27,0,0,0,0,0,0,False,False,False,0,2,2022-02-17T22:12:24.197,0,False,0.0
2021,16,3287,670,28,262,2,6,10,4,15,11,10,5,10,0,False,False,False,0,2,2021-12-24T16:20:09.08,15,False,5.0
2021,16,3287,675,28,7753,13,5,2,21,0,0,0,0,0,0,True,False,False,0,4,2021-12-29T22:01:12.49,0,False,0.0
2021,16,3287,680,28,7224,2,4,9,4,6,2,5,1,5,0,False,True,False,0,3,2021-12-24T16:22:21.94,6,False,1.0
2021,16,3287,685,28,7751,2,5,10,4,12,8,8,4,8,0,False,True,False,0,1,2021-12-29T22:02:21.693,12,False,4.0
2021,16,3287,690,28,262,13,12,9,7,0,0,0,0,0,0,False,False,False,0,2,2021-12-24T16:25:29.723,0,False,0.0
2021,16,3287,695,28,7224,2,6,4,10,56,46,47,9,47,0,False,False,False,0,3,2021-12-24T16:27:50.987,56,False,9.0
2021,16,3287,705,28,7619,2,6,4,2,2,0,2,0,2,6,False,False,False,0,3,2021-12-24T16:31:27.887,2,True,0.0
2021,16,3287,720,31,2865,2,38,4,3,6,3,5,1,5,0,True,False,False,0,4,2021-12-29T21:37:34.917,6,False,1.0
2021,16,3287,735,31,2865,2,5,10,2,4,2,3,1,3,0,False,False,False,0,3,2021-12-24T16:34:32.51,4,False,1.0
2021,16,3287,740,31,2865,13,2,10,6,0,0,0,0,0,0,False,False,False,0,3,2021-12-24T16:35:12.65,0,False,
2021,16,3287,795,28,7224,2,50,9,-4,16,20,16,0,16,0,False,True,False,1,3,2021-12-29T21:52:09.883,16,False,0.0
2021,16,3288,10,8,232,2,39,4,6,7,1,6,1,6,0,False,False,False,0,3,2021-12-29T23:11:16.383,7,False,1.0
2021,16,3288,15,8,6439,2,48,10,-3,40,43,7,33,7,0,False,False,False,1,1,2021-12-26T10:46:05.83,40,False,33.0
2021,16,3288,25,8,232,2,2,10,7,12,5,8,4,8,0,False,False,False,0,2,2022-02-17T20:58:41.637,12,False,4.0
2021,16,3288,45,12,467,2,47,5,0,1,1,1,0,1,0,True,False,False,0,4,2021-12-26T09:53:59.543,1,False,0.0
2021,16,3288,50,12,4537,13,48,5,0,0,0,0,0,0,0,False,False,False,0,1,2021-12-26T09:55:38.693,0,False,0.0
2021,16,3288,55,12,4537,2,28,4,3,8,5,7,1,7,0,False,False,False,0,1,2021-12-26T09:57:11.353,8,False,1.0
2021,16,3288,70,12,556,2,5,9,3,4,1,3,1,3,0,False,False,False,0,3,2021-12-26T10:01:21.88,4,False,1.0
2021,16,3288,75,12,6691,13,13,10,4,0,0,0,0,0,0,False,False,False,0,3,2021-12-26T10:03:33.553,0,False,0.0
2021,16,3288,85,8,7651,13,17,7,45,0,0,0,0,0,0,False,False,False,0,3,2021-12-29T23:00:59.363,0,False,0.0
2021,16,3288,95,12,556,2,19,2,22,33,11,24,9,24,0,False,False,False,0,2,2021-12-26T10:13:26.373,33,False,9.0
2021,16,3288,100,12,556,2,51,9,1,13,12,12,1,12,0,True,False,False,0,3,2021-12-29T22:45:34.767,13,False,
2021,16,3288,105,12,7743,2,53,4,-2,4,6,3,1,3,0,False,False,False,0,4,2021-12-26T10:17:22.113,4,False,1.0
2021,16,3288,110,12,7742,2,46,3,1,6,5,4,2,4,0,False,False,False,0,4,2021-12-26T12:22:44.597,6,False,2.0
2021,16,3288,115,12,6691,2,5,5,4,11,7,9,2,9,6,False,False,False,0,3,2021-12-26T10:20:31,11,False,2.0
2021,16,3288,135,8,232,13,6,9,3,0,0,0,0,0,0,True,False,False,0,3,2021-12-26T10:46:50.447,0,False,0.0
2021,16,3288,140,8,7009,2,5,5,5,8,3,7,1,7,0,False,False,False,0,1,2021-12-26T10:27:46.533,8,False,1.0
2021,16,3288,145,8,7651,2,6,9,4,5,1,4,1,4,0,False,False,False,0,2,2021-12-26T10:29:49.93,5,False,1.0
2021,16,3288,150,8,3606,2,13,10,8,8,0,8,0,8,0,False,False,False,0,3,2021-12-26T10:32:37.51,8,False,0.0
2021,16,3288,170,8,7651,13,4,5,6,0,0,0,0,0,0,False,False,False,0,2,2021-12-26T10:38:51.297,0,False,0.0
2021,16,3288,175,8,232,13,4,8,15,0,0,0,0,0,0,False,False,False,0,3,2021-12-29T23:01:42.81,0,False,0.0
2021,16,3288,180,12,6691,2,19,2,30,34,4,30,4,30,0,False,False,False,0,2,2021-12-26T10:43:06.02,34,False,4.0
2021,16,3288,195,12,467,2,47,5,1,1,0,1,0,1,0,False,False,False,0,4,2021-12-29T23:14:32.813,1,False,0.0
2021,16,3288,220,12,6691,13,2,10,9,0,0,0,0,0,0,False,False,False,0,3,2021-12-26T11:26:12.35,0,False,0.0
2021,16,3288,225,12,556,13,26,9,4,0,0,0,0,0,0,False,False,False,0,3,2021-12-26T11:27:40.533,0,False,0.0
2021,16,3288,230,12,556,2,2,4,9,9,0,9,0,9,6,False,False,False,0,3,2022-02-17T21:02:04.373,9,True,0.0
2021,16,3288,250,8,3883,2,13,10,3,11,8,10,1,10,0,True,False,False,0,3,2021-12-27T19:29:36.863,11,False,1.0
2021,16,3288,255,8,232,2,7,9,9,24,15,12,12,12,0,False,False,False,1,3,2021-12-26T11:34:56.09,24,False,12.0
2021,16,3288,265,8,3606,2,6,9,9,14,5,13,1,13,0,False,False,False,0,2,2021-12-26T11:37:27.503,14,False,1.0
2021,16,3288,270,8,7652,2,32,10,1,1,0,1,0,1,6,False,False,False,0,4,2021-12-26T11:39:08.743,1,True,0.0
2021,16,3288,285,12,7742,2,45,10,-5,2,7,2,0,2,0,False,False,False,1,1,2021-12-29T23:05:01.813,2,False,0.0
2021,16,3288,295,12,4537,2,32,9,-2,-2,0,-2,0,-2,0,False,False,False,0,4,2021-12-26T11:44:56.447,-2,False,0.0
2021,16,3288,305,8,6439,2,48,9,-2,-1,1,-1,0,-1,0,False,False,False,0,1,2021-12-26T11:47:49.003,-1,False,
2021,16,3288,320,8,3606,2,6,8,17,16,-1,16,0,16,0,False,False,False,0,2,2021-12-26T11:52:41.71,16,False,0.0
2021,16,3288,330,8,232,13,11,6,20,0,0,0,0,0,0,False,False,False,0,3,2021-12-29T23:02:08.133,0,False,0.0
2021,16,3288,340,12,556,2,51,9,1,10,9,9,1,9,0,False,False,False,0,3,2021-12-29T22:45:34.767,10,False,1.0
2021,16,3288,345,12,556,2,4,5,7,9,2,8,1,8,0,False,False,False,0,2,2021-12-26T12:09:11.3,9,False,1.0
2021,16,3288,360,12,556,2,29,3,8,12,4,11,1,11,0,False,False,False,0,2,2022-02-16T16:48:14.563,12,False,1.0
2021,16,3288,365,12,4537,2,46,3,0,1,1,1,0,1,0,False,False,False,0,1,2021-12-26T12:13:07.74,1,False,0.0
2021,16,3288,370,12,556,2,5,5,7,10,3,9,1,9,0,False,False,False,0,2,2021-12-26T12:14:23.97,10,False,1.0
2021,16,3288,375,12,467,13,32,5,1,0,0,0,0,0,0,False,False,False,0,4,2021-12-29T22:58:01.277,0,False,0.0
2021,16,3288,380,12,556,2,5,3,1,1,0,1,0,1,6,False,False,False,0,3,2021-12-26T12:17:46.29,1,True,0.0
2021,16,3288,420,12,556,2,2,9,4,17,13,10,7,10,0,False,False,False,1,2,2021-12-26T12:58:04.017,17,False,7.0
2021,16,3288,425,12,6872,13,12,2,17,0,0,0,0,0,0,False,False,False,0,2,2021-12-29T23:16:01.13,0,False,0.0
2021,16,3288,430,12,4537,2,51,10,0,10,10,7,3,7,0,True,False,False,1,3,2021-12-26T13:02:36.18,10,False,3.0
2021,16,3288,450,12,7743,2,51,5,-1,1,2,1,0,1,0,True,False,False,0,3,2021-12-26T13:06:58.953,1,False,0.0
2021,16,3288,455,12,7743,3,12,5,14,0,0,0,0,0,0,False,False,False,0,3,2021-12-29T22:59:14.33,0,False,0.0
2021,16,3288,475,8,3883,2,5,10,4,5,1,5,0,5,0,False,False,False,0,4,2021-12-26T13:12:16.863,5,False,0.0
2021,16,3288,500,8,3883,13,13,9,7,0,0,0,0,0,0,False,False,False,0,4,2021-12-26T13:18:45.317,0,False,0.0
2021,16,3288,510,8,4000,2,32,3,1,3,2,3,0,3,0,False,False,False,0,1,2021-12-26T13:21:58.54,3,False,0.0
2021,16,3288,525,8,3606,3,5,5,7,0,0,0,0,0,0,False,False,False,0,3,2021-12-26T13:24:47.47,0,False,0.0
2021,16,3288,530,8,3883,2,6,10,8,10,2,10,0,10,0,False,False,False,0,4,2021-12-26T13:26:23.57,10,False,0.0
2021,16,3288,555,12,6691,13,4,3,13,0,0,0,0,0,0,False,False,False,0,3,2021-12-29T23:18:50.55,0,False,0.0
2021,16,3288,560,12,556,2,52,4,3,9,6,7,2,7,0,False,False,False,0,2,2021-12-29T22:45:34.767,9,False,2.0
2021,16,3288,585,8,3883,13,35,7,16,0,0,0,0,0,0,False,False,False,0,4,2021-12-26T14:35:31.257,0,False,0.0
2021,16,3288,590,8,3606,2,5,3,9,10,1,10,0,10,0,False,False,False,0,3,2021-12-29T23:27:42.157,10,False,0.0
2021,16,3288,595,8,7651,3,8,8,34,0,0,0,0,0,0,False,False,False,0,2,2021-12-26T14:38:48.053,0,False,0.0
2021,16,3288,605,8,232,2,2,10,7,12,5,10,2,10,0,False,False,False,0,3,2021-12-26T14:41:36.703,12,False,2.0
2021,16,3288,610,8,4000,2,46,3,2,3,1,3,0,3,0,False,False,False,0,1,2021-12-26T14:42:54.527,3,False,0.0
2021,16,3288,670,8,6439,2,48,9,-5,11,16,10,1,10,0,False,False,False,0,1,2021-12-26T14:59:48.113,11,False,1.0
2021,16,3288,675,8,3606,2,4,9,6,10,4,9,1,9,0,False,False,False,0,3,2021-12-29T23:28:03.23,10,False,1.0
2021,16,3288,680,8,7651,13,19,2,31,0,0,0,0,0,0,False,False,False,0,2,2021-12-26T14:59:54.85,0,False,0.0
2021,16,3288,685,8,6439,13,5,3,6,0,0,0,0,0,0,False,False,False,0,1,2021-12-26T15:02:04.31,0,False,0.0
2021,16,3288,695,8,8349,2,9,9,5,5,0,5,0,5,6,False,False,False,0,2,2021-12-26T15:04:54.59,5,True,0.0
2021,16,3288,710,12,7742,2,47,10,0,7,7,5,2,5,0,False,False,False,0,1,2021-12-26T15:22:03.34,7,False,2.0
2021,16,3288,720,12,556,13,2,10,3,0,0,0,0,0,0,False,False,False,0,2,2021-12-26T15:24:41.9,0,False,0.0
2021,16,3288,725,12,4537,2,48,10,-3,4,7,-2,6,-2,0,False,False,False,1,1,2021-12-26T15:25:51.13,4,False,6.0
2021,16,3288,730,12,556,3,19,6,16,0,0,0,0,0,0,False,False,False,0,2,2021-12-26T15:27:12.533,0,False,0.0
2021,16,3288,760,8,4976,3,5,9,8,0,0,0,0,0,0,False,False,False,0,3,2022-02-16T17:00:14.447,0,False,0.0
2021,16,3288,765,8,6439,2,46,3,1,7,6,5,2,5,0,False,False,False,0,1,2021-12-26T15:33:21.987,7,False,2.0
2021,16,3288,770,8,4976,13,7,5,14,0,0,0,0,0,0,False,False,False,0,3,2022-02-17T21:03:35.423,0,False,0.0
2021,16,3288,775,8,7009,13,48,9,0,0,0,0,0,0,0,False,False,False,0,1,2021-12-26T15:36:05.19,0,False,0.0
2021,16,3288,780,8,7651,13,6,9,10,0,0,0,0,0,0,False,False,False,0,2,2021-12-26T15:38:01.087,0,False,0.0
2021,16,3289,25,1,894,2,32,10,1,3,2,0,3,0,0,False,False,False,0,4,2021-12-26T12:19:47.997,3,False,3.0
2021,16,3289,35,1,894,2,17,9,3,10,7,9,1,9,0,False,False,False,0,3,2021-12-26T12:21:42.51,10,False,1.0
2021,16,3289,45,1,6406,2,45,5,-3,5,8,3,2,3,0,True,False,False,0,2,2021-12-28T21:29:04.797,5,False,2.0
2021,16,3289,50,1,894,2,5,3,4,10,6,9,1,9,0,False,False,False,0,3,2021-12-26T12:27:19.89,10,False,1.0
2021,16,3289,55,1,6933,2,50,3,-1,5,6,4,1,4,0,False,False,False,0,2,2021-12-26T12:28:39.487,5,False,1.0
2021,16,3289,65,1,6405,3,9,2,25,0,0,0,0,0,0,False,False,False,0,3,2021-12-26T12:31:50.537,0,False,0.0
2021,16,3289,85,14,7584,2,49,9,-4,9,13,7,2,7,0,False,False,False,0,2,2021-12-28T21:15:43.587,9,False,2.0
2021,16,3289,100,14,1114,2,13,9,1,1,0,1,0,1,6,False,False,False,0,3,2021-12-26T12:44:25.027,1,True,0.0
2021,16,3289,115,1,6406,13,16,9,3,0,0,0,0,0,0,False,False,False,0,1,2021-12-26T12:47:04.557,0,False,0.0
2021,16,3289,120,1,6405,2,4,3,8,8,0,8,0,8,0,False,False,False,0,2,2021-12-26T12:49:39.417,8,False,0.0
2021,16,3289,130,1,6406,2,48,10,-2,13,15,13,0,13,0,False,False,False,0,1,2021-12-26T12:51:50.07,13,True,0.0
2021,16,3289,160,14,7582,13,48,9,-4,0,0,0,0,0,0,False,False,False,0,1,2021-12-26T13:13:51.643,0,False,0.0
2021,16,3289,165,14,8400,2,5,3,6,6,0,6,0,6,0,False,False,False,0,3,2021-12-26T13:14:55.49,6,False,0.0
2021,16,3289,170,14,7495,2,6,6,20,23,3,23,0,23,0,False,False,False,0,4,2021-12-28T21:30:14.253,23,False,0.0
2021,16,3289,205,14,5197,13,4,9,4,0,0,0,0,0,0,False,False,False,0,4,2021-12-26T13:22:51.88,0,False,0.0
2021,16,3289,220,1,6406,2,28,10,0,7,7,6,1,6,0,False,False,False,0,1,2021-12-26T13:25:48.03,7,False,1.0
2021,16,3289,225,1,894,2,2,9,5,11,6,5,6,5,0,False,False,False,0,3,2021-12-26T13:26:57.89,11,False,6.0
2021,16,3289,230,1,894,2,48,10,-3,4,7,3,1,3,0,False,False,False,0,1,2021-12-26T13:28:39.39,4,False,1.0
2021,16,3289,250,1,894,13,11,3,13,0,0,0,0,0,0,False,False,False,0,3,2021-12-28T21:16:04.203,0,True,0.0
2021,16,3289,265,14,7584,2,13,9,5,10,5,10,0,10,0,False,False,False,0,3,2021-12-26T13:40:58.863,10,True,0.0
2021,16,3289,285,14,6543,2,4,3,7,7,0,7,0,7,0,False,False,False,0,2,2021-12-26T13:47:36.323,7,False,0.0
2021,16,3289,295,14,1114,2,49,10,-3,3,6,3,0,3,0,False,False,False,0,2,2021-12-26T13:49:51.757,3,False,0.0
2021,16,3289,310,1,2071,2,32,5,0,3,3,0,3,0,0,False,False,False,0,1,2021-12-26T13:53:53.94,3,False,3.0
2021,16,3289,345,14,7584,2,5,3,10,12,2,12,0,12,0,False,False,False,0,2,2021-12-26T14:07:09.97,12,False,0.0
2021,16,3289,350,14,7584,2,4,3,5,14,9,12,2,12,0,False,False,False,0,2,2021-12-26T14:08:28.663,14,False,2.0
2021,16,3289,355,14,7584,2,4,3,5,7,2,6,1,6,0,False,False,False,0,3,2021-12-26T14:10:15.437,7,False,1.0
2021,16,3289,360,14,7584,13,9,3,13,0,0,0,0,0,0,False,False,False,0,2,2021-12-26T14:11:36.293,0,False,
2021,16,3289,375,14,5197,2,39,4,5,5,0,5,0,5,0,False,False,False,0,3,2021-12-26T14:15:52.06,5,False,0.0
2021,16,3289,385,14,5197,2,53,10,-3,7,10,6,1,6,0,False,False,False,0,4,2021-12-26T14:18:32.86,7,False,
2021,16,3289,400,14,5197,13,17,10,5,0,0,0,0,0,0,False,False,False,0,3,2021-12-26T14:21:33.087,0,False,0.0
2021,16,3289,425,14,7584,13,4,5,8,0,0,0,0,0,0,False,False,False,0,2,2021-12-26T14:33:10.503,0,False,0.0
2021,16,3289,430,14,1114,13,4,9,5,0,0,0,0,0,0,False,False,False,0,3,2022-02-16T15:04:59.657,0,False,
2021,16,3289,435,14,7495,3,13,9,4,0,0,0,0,0,0,True,False,False,0,3,2021-12-26T14:35:59.093,0,False,0.0
2021,16,3289,450,14,7584,13,5,3,6,0,0,0,0,0,0,True,False,False,0,3,2021-12-26T14:40:27.43,0,False,0.0
2021,16,3289,465,1,6406,2,50,3,-2,11,13,7,4,7,0,False,False,False,1,2,2021-12-26T14:51:53.663,11,False,4.0
2021,16,3289,470,1,6405,2,34,4,-4,-10,-6,-10,0,-10,0,True,False,False,0,3,2021-12-27T20:14:50.33,0,False,0.0
2021,16,3289,475,1,6933,2,9,6,24,24,0,24,0,24,6,False,False,False,0,2,2021-12-26T14:57:02.683,24,True,0.0
2021,16,3289,490,14,7584,2,49,10,-4,5,9,0,5,0,0,True,False,False,0,2,2021-12-26T15:03:29.473,5,False,5.0
2021,16,3289,505,14,1114,13,9,2,20,0,0,0,0,0,0,False,False,False,0,2,2021-12-26T15:06:40.067,0,False,0.0
2021,16,3289,530,14,7584,13,2,10,4,0,0,0,0,0,0,False,False,False,0,2,2021-12-26T15:11:27.657,0,False,0.0
2021,16,3289,535,1,894,13,17,10,8,0,0,0,0,0,0,False,False,False,0,3,2021-12-26T15:12:51.907,0,False,0.0
2021,16,3289,540,1,910,13,5,5,10,0,0,0,0,0,0,False,False,False,0,3,2021-12-26T15:20:06.627,0,False,0.0
2021,16,3289,555,14,7584,2,4,5,5,5,0,5,0,5,0,False,False,False,0,2,2021-12-26T15:22:34.05,5,False,0.0
2021,16,3289,565,14,5197,2,13,9,5,37,32,37,0,37,0,False,False,False,1,2,2022-02-16T15:05:45.963,37,False,0.0
2021,16,3289,570,14,7582,13,12,9,4,0,0,0,0,0,0,False,False,False,0,1,2021-12-26T15:29:12.303,0,False,0.0
2021,16,3289,580,14,1114,2,4,5,8,8,0,8,0,8,0,False,False,False,0,2,2021-12-26T15:32:03.747,8,False,0.0
2021,16,3289,595,14,7584,13,2,10,5,0,0,0,0,0,0,False,False,False,0,2,2021-12-26T15:34:50.107,0,False,0.0
2021,16,3289,625,1,6405,2,4,9,3,3,0,3,0,3,0,False,False,False,0,3,2021-12-26T15:49:41.47,3,False,0.0
2021,16,3289,640,1,6405,13,8,6,33,0,0,0,0,0,0,False,False,False,0,3,2021-12-26T15:56:26.327,0,False,0.0
2021,16,3289,645,1,910,2,19,2,20,33,13,30,3,30,0,False,False,False,0,2,2021-12-26T16:00:52.79,33,False,3.0
2021,16,3289,660,1,894,13,12,3,3,0,0,0,0,0,0,True,False,False,0,4,2021-12-26T16:04:27.8,0,False,0.0
2021,16,3289,675,14,1114,13,12,3,8,0,0,0,0,0,0,False,False,False,0,2,2021-12-26T16:11:53.99,0,False,
2021,16,3289,680,14,7584,2,5,6,17,20,3,20,0,20,0,False,False,False,0,2,2021-12-28T21:40:06.48,20,True,0.0
2021,16,3289,690,14,1114,2,7,2,31,39,8,39,0,39,0,False,False,False,0,3,2021-12-26T16:16:21.83,39,False,0.0
2021,16,3289,705,14,7583,2,12,3,14,14,0,14,0,14,6,False,False,False,0,2,2021-12-26T16:19:01.45,14,True,0.0
2021,16,3289,730,1,6406,2,2,10,3,4,1,4,0,4,0,False,False,False,0,2,2021-12-26T16:26:34.173,4,False,0.0
2021,16,3289,735,1,894,13,9,6,18,0,0,0,0,0,0,False,False,False,0,3,2021-12-26T16:27:36.187,0,False,0.0
2021,16,3289,740,1,910,13,6,7,20,0,0,0,0,0,0,False,False,False,0,2,2021-12-26T16:28:52.07,0,False,0.0
2021,16,3289,775,1,6405,2,42,4,5,5,0,5,0,5,0,False,False,False,0,3,2021-12-26T16:37:15.723,5,False,0.0
2021,16,3289,780,1,894,2,4,10,5,7,2,7,0,7,0,False,False,False,1,3,2021-12-26T16:38:16.147,7,False,0.0
2021,16,3289,790,1,6406,2,31,9,2,16,14,14,2,14,0,False,False,False,1,1,2021-12-26T16:40:42.393,16,False,2.0
2021,16,3289,795,1,6406,2,4,4,2,7,5,7,0,7,0,False,False,False,0,1,2021-12-26T16:43:21.26,7,False,0.0
2021,16,3289,800,1,6405,2,47,5,4,4,0,4,0,4,0,False,False,False,0,3,2021-12-26T16:44:34.967,4,False,0.0
2021,16,3289,805,1,894,2,5,3,3,7,4,6,1,6,0,False,False,False,0,3,2021-12-26T16:45:35.587,7,False,1.0
2021,16,3289,815,1,6405,2,32,5,3,14,11,14,0,14,0,False,False,False,0,3,2021-12-27T21:10:34.113,14,False,0.0
2021,16,3289,830,1,894,2,13,10,3,2,-1,2,0,2,0,False,False,False,0,3,2021-12-26T16:50:41.31,2,False,0.0
2021,16,3289,835,1,6405,2,12,9,14,14,0,14,0,14,0,False,False,False,0,3,2021-12-26T16:52:18.153,14,False,0.0
2021,16,3289,840,1,6933,13,9,3,14,0,0,0,0,0,0,False,False,False,0,2,2021-12-26T16:53:43.697,0,False,0.0
2021,16,3289,845,1,6406,2,16,9,4,8,4,8,0,8,0,False,False,False,0,1,2021-12-26T16:55:06.967,8,False,0.0
2021,16,3289,860,1,894,13,17,4,10,0,0,0,0,0,0,False,False,False,0,3,2021-12-26T16:57:07.36,0,False,0.0
2021,16,3289,865,1,6933,13,7,3,10,0,0,0,0,0,0,False,False,False,0,3,2021-12-26T16:58:27.163,0,False,0.0
2021,16,3290,10,24,6373,3,4,9,5,0,0,0,0,0,0,False,False,False,0,4,2021-12-27T10:08:12.68,0,False,0.0
2021,16,3290,15,24,8509,2,4,10,6,6,0,6,0,6,0,False,False,False,0,3,2021-12-29T01:54:37.037,6,False,0.0
2021,16,3290,20,24,6373,13,12,5,3,0,0,0,0,0,0,True,False,False,0,4,2021-12-29T02:56:21.33,0,False,0.0
2021,16,3290,35,21,6228,2,51,10,-7,-4,3,-4,0,-4,0,True,False,False,0,2,2021-12-27T10:19:20.523,-4,False,0.0
2021,16,3290,40,21,7090,13,5,2,15,0,0,0,0,0,0,False,False,False,0,2,2021-12-28T20:09:20.117,0,False,0.0
2021,16,3290,55,24,8509,13,50,3,-3,0,0,0,0,0,0,False,False,False,0,2,2022-02-16T19:07:10.797,0,False,0.0
2021,16,3290,65,24,6937,3,32,3,4,0,0,0,0,0,0,False,False,False,0,1,2021-12-27T10:28:02.347,0,False,0.0
2021,16,3290,80,21,8518,13,4,9,5,0,0,0,0,0,0,False,False,False,0,3,2021-12-28T20:09:42.787,0,False,0.0
2021,16,3290,95,21,7090,13,5,5,6,0,0,0,0,0,0,False,False,False,0,3,2021-12-27T10:36:42.387,0,False,0.0
2021,16,3290,125,24,7798,2,12,9,3,2,-1,2,0,2,0,True,False,False,0,3,2022-02-24T19:36:08.43,2,False,0.0
2021,16,3290,155,24,6937,13,46,3,3,0,0,0,0,0,0,False,False,False,0,1,2021-12-27T10:57:23.11,0,False,0.0
2021,16,3290,170,24,6937,2,47,5,3,3,0,3,0,3,0,True,False,False,0,1,2021-12-28T21:43:45.743,3,False,0.0
2021,16,3290,175,24,7798,13,5,5,14,0,0,0,0,0,0,False,False,False,0,2,2021-12-29T01:46:48.563,0,False,0.0
2021,16,3290,180,24,3476,13,48,9,-3,0,0,0,0,0,0,False,False,False,0,1,2021-12-29T02:56:34.653,0,False,0.0
2021,16,3290,195,21,3389,13,2,4,9,0,0,0,0,0,0,False,False,False,0,3,2021-12-27T11:08:08.18,0,False,0.0
2021,16,3290,200,21,3957,2,47,5,4,8,4,6,2,6,0,True,False,False,0,4,2021-12-28T20:10:32.053,8,False,2.0
2021,16,3290,205,21,8518,13,2,9,4,0,0,0,0,0,0,False,False,False,0,3,2021-12-27T11:11:03.233,0,False,0.0
2021,16,3290,215,21,8518,2,49,9,-3,8,11,5,3,5,0,False,False,False,1,3,2021-12-29T02:38:50.887,8,False,3.0
2021,16,3290,220,21,8518,2,2,10,7,8,1,8,0,8,0,False,False,False,0,3,2021-12-27T11:16:01.857,8,False,0.0
2021,16,3290,235,21,4492,13,20,2,24,0,0,0,0,0,0,False,False,False,0,2,2021-12-29T02:56:51.063,0,False,0.0
2021,16,3290,240,21,7090,13,8,9,12,0,0,0,0,0,0,False,False,False,0,2,2021-12-29T01:46:48.563,0,False,0.0
2021,16,3290,270,24,8509,2,12,2,20,23,3,23,0,23,0,False,False,False,0,2,2021-12-29T02:30:08.623,23,False,0.0
2021,16,3290,280,24,7798,2,5,3,13,13,0,13,0,13,0,False,False,False,0,3,2021-12-27T11:31:15.703,13,True,0.0
2021,16,3290,285,24,8509,13,21,2,20,0,0,0,0,0,0,False,False,False,0,3,2021-12-29T02:57:03.1,0,False,0.0
2021,16,3290,290,24,7798,3,50,5,-1,0,0,0,0,0,0,False,False,False,0,2,2021-12-27T11:33:54.933,0,False,0.0
2021,16,3290,300,24,7798,2,50,5,-1,9,10,7,2,7,0,False,False,False,1,2,2021-12-27T11:35:38.48,9,False,
2021,16,3290,335,24,3476,3,47,5,0,0,0,0,0,0,0,False,False,False,0,1,2021-12-28T21:44:41.8,0,False,0.0
2021,16,3290,340,24,8509,2,19,2,36,46,10,44,2,44,0,False,False,False,0,2,2021-12-27T11:51:31.75,46,False,2.0
2021,16,3290,350,24,3476,13,12,5,-1,0,0,0,0,0,0,False,False,False,0,1,2022-02-24T19:36:23.38,0,False,
2021,16,3290,365,24,7800,2,13,4,2,1,-1,1,0,1,0,True,False,False,0,2,2021-12-27T11:57:37.86,1,False,0.0
2021,16,3290,385,21,4422,2,53,3,-5,-2,3,-4,2,-4,0,False,False,False,0,4,2022-03-03T14:00:16.68,-2,False,2.0
2021,16,3290,395,21,8518,13,49,10,-3,0,0,0,0,0,0,False,False,False,0,2,2021-12-27T12:05:37.267,0,False,0.0
2021,16,3290,435,21,8518,13,5,3,7,0,0,0,0,0,0,False,False,False,0,3,2022-02-16T19:11:27.983,0,False,0.0
2021,16,3290,470,21,4492,13,6,9,20,0,0,0,0,0,0,False,False,False,0,2,2021-12-29T02:12:45.027,0,False,0.0
2021,16,3290,475,24,6373,2,49,3,-4,21,25,21,0,21,0,False,False,False,0,2,2021-12-29T01:55:01.013,12,True,0.0
2021,16,3290,480,24,3476,2,46,3,2,9,7,8,1,8,0,False,False,False,0,1,2021-12-27T12:27:46.723,9,False,1.0
2021,16,3290,520,21,7090,2,4,3,6,7,1,6,1,6,0,False,False,False,0,2,2021-12-27T12:34:55.923,7,False,1.0
2021,16,3290,530,24,8509,2,49,3,-2,1,3,1,0,1,0,False,False,False,0,2,2021-12-27T12:39:22.107,1,False,0.0
2021,16,3290,545,24,8513,2,5,3,4,6,2,6,0,6,0,True,False,False,0,1,2021-12-28T21:43:56.497,6,False,0.0
2021,16,3290,565,21,4492,2,4,3,6,6,0,6,0,6,0,False,False,False,0,2,2021-12-27T12:51:07.167,6,False,0.0
2021,16,3290,575,21,4492,13,6,8,15,0,0,0,0,0,0,False,False,False,0,2,2021-12-27T14:37:10.123,0,False,0.0
2021,16,3290,590,24,7800,2,23,7,38,39,1,39,0,39,0,False,False,False,0,3,2021-12-29T02:57:23.997,39,False,0.0
2021,16,3290,605,24,8509,2,30,5,4,4,0,4,0,4,6,True,False,False,0,3,2021-12-29T02:44:03.717,4,True,0.0
2021,16,3290,630,21,8518,2,5,3,5,8,3,7,1,7,0,False,False,False,0,3,2021-12-28T20:11:09.707,8,False,1.0
2021,16,3290,635,21,4422,2,46,3,2,2,0,2,0,2,0,True,False,False,0,4,2021-12-29T02:57:33.81,2,False,0.0
2021,16,3290,640,21,7090,3,8,9,12,0,0,0,0,0,0,False,False,False,0,3,2021-12-29T02:44:33.72,0,False,0.0
2021,16,3290,645,21,4422,13,13,10,5,0,0,0,0,0,0,False,False,False,0,3,2021-12-27T14:37:43.77,0,False,0.0
2021,16,3290,660,24,7800,2,47,5,3,3,0,3,0,3,0,True,False,False,0,4,2021-12-28T21:42:59.68,3,False,0.0
2021,16,3290,665,24,6373,2,47,5,1,16,15,13,3,13,0,False,False,False,0,1,2021-12-27T13:24:06.227,16,False,3.0
2021,16,3290,675,24,8665,13,6,8,17,0,0,0,0,0,0,False,False,False,0,4,2021-12-29T02:44:49.393,0,False,0.0
2021,16,3290,680,24,3476,2,4,4,5,10,5,8,2,8,0,False,False,False,0,1,2021-12-27T13:30:56.263,10,False,2.0
2021,16,3290,705,24,906,2,31,5,4,5,1,5,0,5,6,False,False,False,0,4,2022-02-24T18:56:08.79,5,True,0.0
2021,16,3290,720,21,3957,2,4,3,4,9,5,6,3,6,0,True,False,False,0,2,2021-12-27T13:40:06.257,9,False,3.0
2021,16,3290,735,21,8518,13,2,9,6,0,0,0,0,0,0,False,False,False,0,3,2022-01-31T18:52:46.64,0,False,0.0
2021,16,3290,755,21,4492,13,2,10,9,0,0,0,0,0,0,False,False,False,0,3,2021-12-29T02:57:55.817,0,False,0.0
2021,16,3290,760,21,4492,2,2,10,8,11,3,8,3,8,0,False,False,False,0,2,2021-12-27T13:48:47.15,11,False,3.0
2021,16,3290,770,21,6981,2,4,9,5,5,0,5,0,5,0,False,False,False,0,3,2021-12-29T02:58:07.65,5,False,0.0
2021,16,3290,780,21,3957,2,4,4,2,2,0,2,0,2,0,False,False,False,0,1,2021-12-27T13:55:16.493,2,False,0.0
2021,16,3290,785,21,3957,2,44,3,-5,0,5,-1,1,-1,0,True,False,False,0,1,2021-12-28T20:08:53.4,0,False,1.0
2021,16,3290,795,21,8518,2,4,10,4,4,0,4,0,4,0,False,False,False,0,3,2021-12-27T14:36:14.04,4,False,0.0
2021,16,3290,805,21,4180,2,44,3,-4,4,8,3,1,3,0,False,False,False,1,1,2021-12-27T14:05:36.57,4,False,1.0
2021,16,3290,810,21,813,13,35,1,15,0,0,0,0,0,0,False,False,False,0,3,2021-12-29T02:58:26.717,0,False,0.0
2021,16,3290,815,21,4422,2,13,5,5,8,3,7,1,7,0,False,False,False,0,3,2021-12-27T14:08:26.917,8,False,1.0
2021,16,3290,820,21,4492,13,7,3,14,0,0,0,0,0,0,False,False,False,0,2,2021-12-27T14:10:14.313,0,False,0.0
2021,16,3290,830,21,8518,13,42,9,9,0,0,0,0,0,0,False,False,False,0,3,2021-12-29T01:47:46.07,0,False,
2021,16,3290,835,21,4492,2,39,4,4,5,1,5,0,5,0,False,False,False,0,2,2021-12-29T02:45:06.63,5,False,0.0
2021,16,3290,840,21,4492,13,12,5,14,0,0,0,0,0,0,False,False,False,0,2,2022-02-16T19:13:28.913,0,False,
2021,16,3290,845,21,4422,2,17,4,9,9,0,9,0,9,6,False,False,False,0,3,2021-12-27T14:16:39.543,9,True,0.0
2021,16,3290,920,21,7059,2,38,4,4,6,2,5,1,5,0,False,False,False,0,3,2021-12-27T14:27:44.817,6,False,1.0
2021,16,3290,925,21,4180,2,31,10,3,4,1,4,0,4,0,False,False,False,0,1,2021-12-29T01:46:48.623,4,False,0.0
2021,16,3290,930,21,7059,3,5,5,3,0,0,0,0,0,0,False,False,False,0,3,2021-12-27T14:29:57.77,0,False,0.0
2021,16,3290,940,21,4180,2,16,9,3,8,5,6,2,6,0,False,False,False,0,1,2021-12-27T14:32:21.91,8,False,2.0
2021,16,3290,945,21,4180,2,32,3,-5,2,7,2,0,2,0,False,False,False,1,1,2021-12-29T03:07:38.71,2,False,0.0
2021,16,3291,15,18,6361,2,39,4,5,6,1,5,1,5,0,False,False,False,0,4,2021-12-27T14:26:47.003,6,False,1.0
2021,16,3291,20,18,6900,2,46,3,1,1,0,1,0,1,0,False,False,False,0,1,2021-12-27T14:28:52.06,1,False,0.0
2021,16,3291,40,29,7828,13,6,2,16,0,0,0,0,0,0,False,False,False,0,3,2021-12-27T14:33:59.36,0,False,0.0
2021,16,3291,45,29,4866,2,4,3,4,5,1,5,0,5,0,True,False,False,0,1,2021-12-27T14:35:11.067,5,False,0.0
2021,16,3291,50,29,3398,2,6,10,4,4,0,4,0,4,0,False,False,False,0,2,2021-12-27T14:37:12.57,4,False,0.0
2021,16,3291,60,29,4866,2,9,6,17,19,2,19,0,19,0,False,False,False,0,3,2021-12-27T14:40:46.393,19,False,0.0
2021,16,3291,75,29,3398,2,53,10,-2,11,13,8,3,8,0,False,False,False,0,4,2021-12-27T14:44:01.353,11,False,3.0
2021,16,3291,120,18,6361,2,4,10,7,9,2,8,1,8,0,False,False,False,0,4,2021-12-27T14:52:25.307,9,False,1.0
2021,16,3291,125,18,7711,2,4,10,9,9,0,9,0,9,0,False,False,False,0,2,2021-12-29T18:33:46.767,9,False,0.0
2021,16,3291,135,18,6900,2,48,10,-2,14,16,13,1,13,0,False,False,False,0,1,2021-12-27T14:56:52.953,14,False,1.0
2021,16,3291,140,18,1381,2,12,7,16,25,9,24,1,24,0,False,False,False,0,3,2021-12-27T15:00:16.95,25,False,1.0
2021,16,3291,160,18,7712,13,6,9,8,0,0,0,0,0,0,False,False,False,0,2,2021-12-27T15:04:31.99,0,False,0.0
2021,16,3291,165,29,4866,13,4,9,4,0,0,0,0,0,0,False,False,False,0,4,2021-12-29T18:12:13.38,0,False,0.0
2021,16,3291,170,29,7828,13,6,9,14,0,0,0,0,0,0,False,False,False,0,2,2021-12-27T15:07:13.87,0,False,0.0
2021,16,3291,180,29,1067,2,50,3,-2,8,10,1,7,1,0,False,False,False,0,2,2021-12-27T15:08:25.207,8,False,7.0
2021,16,3291,200,18,8383,2,48,9,-2,-1,1,-2,1,-2,0,False,False,False,0,1,2021-12-27T15:11:50.747,-1,False,1.0
2021,16,3291,220,29,4866,2,4,10,3,6,3,5,1,5,0,True,False,False,0,1,2021-12-27T15:14:51.737,6,False,1.0
2021,16,3291,245,29,3398,2,30,3,1,4,3,4,0,4,0,False,False,False,0,4,2021-12-27T15:20:23.653,4,False,0.0
2021,16,3291,250,29,4866,2,30,5,2,3,1,3,0,3,0,True,False,False,0,3,2021-12-27T15:21:36.413,3,False,0.0
2021,16,3291,255,29,1067,13,9,5,14,0,0,0,0,0,0,False,False,False,0,2,2021-12-29T18:38:32.637,0,False,0.0
2021,16,3291,270,18,4152,2,4,10,3,4,1,3,1,3,0,False,False,False,0,4,2021-12-27T15:25:56.023,4,False,1.0
2021,16,3291,280,18,7711,13,21,6,35,0,0,0,0,0,0,False,False,False,0,2,2021-12-29T18:33:34.997,0,False,0.0
2021,16,3291,295,29,6266,3,28,4,0,0,0,0,0,0,0,False,False,False,0,1,2021-12-27T15:32:10.133,0,False,0.0
2021,16,3291,300,29,6266,13,12,5,1,0,0,0,0,0,0,False,False,False,0,1,2021-12-27T18:45:02.77,0,False,0.0
2021,16,3291,310,18,7711,2,50,10,-1,5,6,4,1,4,0,False,False,False,0,3,2021-12-27T15:36:21.817,5,False,1.0
2021,16,3291,315,18,1381,2,5,5,5,9,4,8,1,8,0,True,False,False,0,3,2021-12-27T15:38:05.043,9,False,1.0
2021,16,3291,335,29,7828,2,39,10,6,6,0,6,0,6,0,False,False,False,0,3,2021-12-29T18:09:07.58,6,False,0.0
2021,16,3291,345,29,1067,2,13,4,5,6,1,5,1,5,0,False,False,False,0,3,2021-12-27T15:44:31.287,6,False,1.0
2021,16,3291,350,29,3398,2,5,5,4,10,6,10,0,10,0,False,False,False,0,3,2021-12-27T15:45:26.19,10,False,0.0
2021,16,3291,355,29,6266,2,32,3,-3,4,7,2,2,2,0,False,False,False,1,1,2021-12-27T15:50:11.69,4,False,2.0
2021,16,3291,360,29,4866,2,5,3,4,7,3,7,0,7,0,False,False,False,0,3,2021-12-27T15:51:22.63,7,False,0.0
2021,16,3291,365,29,1067,2,6,9,14,16,2,16,0,16,0,False,False,False,0,3,2021-12-27T15:52:46.727,16,False,0.0
2021,16,3291,370,29,7828,13,5,2,19,0,0,0,0,0,0,False,False,False,0,3,2021-12-27T15:54:24.007,0,False,0.0
2021,16,3291,375,29,4866,2,35,9,9,11,2,10,1,10,0,False,False,False,0,3,2021-12-27T15:55:29.03,11,False,1.0
2021,16,3291,385,29,4866,13,7,3,13,0,0,0,0,0,0,True,False,False,0,1,2021-12-27T15:57:39.993,0,False,0.0
2021,16,3291,390,29,7828,13,9,5,13,0,0,0,0,0,0,False,False,False,0,3,2021-12-27T15:58:51.127,0,False,0.0
2021,16,3291,395,29,1067,13,9,3,13,0,0,0,0,0,0,False,False,False,0,2,2021-12-29T18:38:54.9,0,False,0.0
2021,16,3291,410,18,7711,13,6,8,19,0,0,0,0,0,0,False,False,False,0,2,2021-12-27T16:04:47.503,0,False,0.0
2021,16,3291,420,18,7712,2,2,3,6,8,2,7,1,7,0,False,False,False,0,2,2021-12-27T16:06:04.807,8,False,1.0
2021,16,3291,430,18,7711,13,19,2,48,0,0,0,0,0,0,False,False,False,0,2,2021-12-29T18:39:17.367,0,False,0.0
2021,16,3291,450,29,7828,13,8,7,47,0,0,0,0,0,0,False,False,False,0,3,2021-12-27T18:45:25.403,0,False,0.0
2021,16,3291,460,18,1381,2,4,5,5,6,1,6,0,6,0,False,False,False,0,2,2021-12-27T16:18:13.973,6,False,0.0
2021,16,3291,465,18,7711,2,6,4,9,9,0,9,0,9,0,False,False,False,0,3,2021-12-27T16:19:28.337,9,False,0.0
2021,16,3291,475,18,6361,13,39,9,5,0,0,0,0,0,0,True,False,False,0,4,2021-12-27T16:22:59.58,0,False,0.0
2021,16,3291,480,18,7712,13,19,6,35,0,0,0,0,0,0,False,False,False,0,3,2021-12-27T16:32:47.567,0,False,0.0
2021,16,3291,490,29,6266,13,12,4,2,0,0,0,0,0,0,False,False,False,0,1,2022-02-24T19:38:02.5,0,False,0.0
2021,16,3291,495,29,3398,13,4,10,-2,0,0,0,0,0,0,False,False,False,0,3,2021-12-27T16:36:36.43,0,False,0.0
2021,16,3291,525,29,1067,13,35,2,29,0,0,0,0,0,0,False,False,False,0,2,2021-12-29T18:13:41.427,0,False,0.0
2021,16,3291,535,18,7711,13,35,2,15,0,0,0,0,0,0,False,False,False,0,2,2021-12-27T16:56:00.173,0,False,0.0
2021,16,3291,540,18,7711,2,4,9,6,6,0,6,0,6,0,False,False,False,0,2,2021-12-27T17:08:16.643,6,False,0.0
2021,16,3291,575,18,7711,2,6,10,12,21,9,18,3,18,0,False,False,False,0,2,2021-12-29T18:14:06.063,21,False,3.0
2021,16,3291,595,18,7711,2,2,10,13,34,21,19,15,19,0,False,False,False,1,3,2021-12-27T17:23:22.837,34,False,15.0
2021,16,3291,605,18,4152,2,6,9,4,9,5,7,2,7,0,False,False,False,0,2,2021-12-27T17:25:48.86,9,False,2.0
2021,16,3291,610,18,7712,2,18,3,0,5,5,4,1,4,0,False,False,False,0,2,2021-12-27T17:27:38.153,5,False,1.0
2021,16,3291,620,18,6900,13,47,5,1,0,0,0,0,0,0,False,False,False,0,1,2021-12-27T17:31:12.29,0,False,0.0
2021,16,3291,655,29,4866,2,5,5,4,8,4,6,2,6,0,False,False,False,0,3,2021-12-27T17:36:48.68,8,False,2.0
2021,16,3291,670,29,1067,13,35,10,11,0,0,0,0,0,0,False,False,False,0,3,2021-12-27T17:43:18.82,0,False,0.0
2021,16,3291,675,29,3398,2,4,5,9,12,3,9,3,9,0,False,False,False,0,2,2021-12-29T18:37:14.273,12,False,3.0
2021,16,3291,685,29,4866,13,2,10,5,0,0,0,0,0,0,False,False,False,0,3,2021-12-27T17:54:23.133,0,False,0.0
2021,16,3291,690,29,1067,2,7,5,7,7,0,7,0,7,6,False,False,False,0,3,2021-12-27T17:55:35.957,7,True,0.0
2021,16,3291,705,18,6361,2,53,9,-5,19,24,18,1,18,0,False,False,False,0,4,2021-12-27T18:02:58.313,19,False,1.0
2021,16,3291,710,18,7712,2,35,7,17,19,2,19,0,19,0,False,False,False,0,3,2021-12-27T18:03:04.643,19,False,0.0
2021,16,3291,715,18,6900,2,48,3,-6,14,20,11,3,11,0,False,False,False,0,1,2021-12-27T18:04:11.517,14,False,3.0
2021,16,3291,720,18,8383,2,44,3,-4,6,10,4,2,4,0,False,False,False,0,1,2021-12-27T18:06:30.557,6,False,2.0
2021,16,3291,725,18,6361,2,6,4,5,10,5,9,1,9,0,False,False,False,0,4,2021-12-29T18:33:23.2,10,False,1.0
2021,16,3291,735,18,7712,2,35,9,6,6,0,6,0,6,6,False,False,False,0,3,2021-12-27T18:12:13.087,6,True,0.0
2021,16,3291,760,29,4866,2,5,3,11,37,26,28,9,28,0,False,False,False,1,3,2021-12-29T18:33:02.743,37,False,9.0
2021,16,3291,770,29,4866,2,26,5,3,6,3,5,1,5,0,False,False,False,0,3,2021-12-27T18:19:57.37,6,False,1.0
2021,16,3291,800,29,4866,2,50,5,0,7,7,4,3,4,0,False,False,False,0,2,2021-12-27T18:27:34.923,7,False,3.0
2021,16,3291,850,18,7712,2,8,1,27,30,3,29,1,29,0,False,False,False,0,3,2021-12-27T18:36:11.107,30,False,1.0
2021,16,3291,855,18,7711,3,6,10,11,0,0,0,0,0,0,False,False,False,0,3,2021-12-27T18:37:10.287,0,False,0.0
2021,16,3291,865,18,7711,2,3,3,14,16,2,14,2,14,0,False,False,False,1,2,2021-12-27T18:39:59.8,16,False,2.0
2021,16,3291,875,18,7711,2,2,9,12,16,4,13,3,13,0,False,False,False,0,3,2021-12-27T18:41:30.23,16,False,3.0
2021,16,3292,15,19,7172,13,47,10,0,0,0,0,0,0,0,False,False,False,0,1,2021-12-29T16:59:02.577,0,False,0.0
2021,16,3292,30,4,2853,3,4,5,6,0,0,0,0,0,0,False,False,False,0,2,2021-12-29T16:59:25.323,0,False,0.0
2021,16,3292,35,4,6983,2,46,3,0,11,11,4,7,4,0,False,False,False,1,1,2021-12-29T16:34:30.897,11,False,7.0
2021,16,3292,45,4,6983,2,4,4,2,8,6,6,2,6,0,False,False,False,0,1,2021-12-27T10:16:51.34,8,False,2.0
2021,16,3292,60,4,5119,2,13,5,5,7,2,6,1,6,0,False,False,False,0,3,2021-12-27T14:58:58.447,7,False,1.0
2021,16,3292,70,4,2630,2,12,10,8,13,5,11,2,11,0,False,False,False,0,3,2022-02-24T19:39:06.443,13,False,2.0
2021,16,3292,75,4,6983,2,16,10,2,7,5,6,1,6,0,False,False,False,0,1,2021-12-29T16:46:24.507,7,False,1.0
2021,16,3292,85,4,2853,13,35,9,3,0,0,0,0,0,0,False,False,False,0,3,2021-12-27T10:31:02.163,0,False,0.0
2021,16,3292,95,4,5119,2,2,9,3,3,0,3,0,3,6,False,False,False,0,3,2021-12-27T14:58:42.09,3,True,0.0
2021,16,3292,145,19,7456,2,38,4,4,9,5,7,2,7,0,False,False,False,0,1,2022-02-16T18:19:47.54,9,False,2.0
2021,16,3292,150,19,1212,2,12,10,-3,19,22,13,6,13,0,False,False,False,1,1,2022-02-24T19:39:18.107,19,False,
2021,16,3292,155,19,7175,2,5,5,6,13,7,12,1,12,0,False,False,False,0,3,2021-12-27T10:52:02.783,13,False,1.0
2021,16,3292,160,19,7173,2,50,9,-1,5,6,2,3,2,0,False,False,False,0,2,2021-12-29T15:59:28.43,5,False,3.0
2021,16,3292,195,4,7937,2,32,5,-2,8,10,6,2,6,0,True,False,False,0,3,2021-12-29T16:46:34.507,8,False,2.0
2021,16,3292,205,4,6983,2,4,4,2,12,10,10,2,10,0,False,False,False,0,1,2021-12-27T11:06:16.92,12,False,2.0
2021,16,3292,210,4,5119,2,34,4,-4,9,13,9,0,9,0,True,False,False,0,2,2021-12-28T16:20:14.793,9,True,0.0
2021,16,3292,235,4,2853,2,45,10,0,4,4,2,2,2,0,True,False,False,0,1,2021-12-27T11:16:36.203,4,False,2.0
2021,16,3292,240,4,213,13,2,10,7,0,0,0,0,0,0,False,False,False,0,2,2021-12-27T15:16:49.4,0,False,0.0
2021,16,3292,255,19,1212,2,32,4,5,14,9,9,5,9,0,False,False,False,0,1,2021-12-27T11:22:43.167,14,False,5.0
2021,16,3292,260,19,7173,3,3,6,15,0,0,0,0,0,0,False,False,False,0,2,2021-12-27T11:24:57.443,0,False,0.0
2021,16,3292,265,19,7173,13,2,7,22,0,0,0,0,0,0,False,False,False,0,2,2021-12-29T15:56:09.967,0,False,0.0
2021,16,3292,270,4,7645,2,4,10,2,13,11,9,4,9,0,False,False,False,0,1,2021-12-27T11:34:48.81,13,False,4.0
2021,16,3292,275,4,5119,2,34,4,-4,3,7,-5,8,-5,0,True,False,False,2,3,2021-12-28T16:20:35.227,3,False,8.0
2021,16,3292,280,4,2853,2,4,4,8,10,2,9,1,9,0,False,False,False,0,3,2021-12-27T11:38:35.507,10,False,1.0
2021,16,3292,295,4,6953,13,30,10,1,0,0,0,0,0,0,True,False,False,0,4,2021-12-28T16:18:02.877,0,False,0.0
2021,16,3292,300,4,213,3,12,10,1,0,0,0,0,0,0,False,False,False,0,3,2022-02-16T18:21:35.053,0,False,0.0
2021,16,3292,310,19,7175,2,13,10,3,6,3,6,0,6,0,False,False,False,0,3,2021-12-27T11:48:43.26,6,False,0.0
2021,16,3292,315,19,7175,13,6,10,12,0,0,0,0,0,0,True,False,False,0,2,2021-12-29T15:53:02.92,0,False,0.0
2021,16,3292,325,4,2853,13,7,6,17,0,0,0,0,0,0,False,False,False,0,3,2021-12-27T11:52:56.71,0,False,0.0
2021,16,3292,335,4,6983,2,44,3,-3,1,4,0,1,0,0,False,False,False,0,1,2021-12-27T11:56:13.437,1,False,1.0
2021,16,3292,350,4,2853,2,6,9,7,23,16,9,14,9,0,False,False,False,1,2,2021-12-29T16:35:31.513,23,False,14.0
2021,16,3292,370,4,2853,13,17,10,12,0,0,0,0,0,0,False,False,False,0,3,2022-02-16T18:26:25.217,0,False,0.0
2021,16,3292,375,4,2853,2,17,4,12,12,0,12,0,12,6,False,False,False,0,3,2021-12-27T12:03:12.913,12,True,0.0
2021,16,3292,390,19,1212,3,6,4,4,0,0,0,0,0,0,False,False,False,0,1,2021-12-29T16:56:54.127,0,False,0.0
2021,16,3292,395,19,4282,13,7,6,17,0,0,0,0,0,0,False,False,False,0,4,2021-12-27T12:07:29.953,0,False,0.0
2021,16,3292,400,19,4912,13,6,1,19,0,0,0,0,0,0,False,False,False,0,2,2021-12-29T15:53:37.533,0,False,
2021,16,3292,415,19,4282,13,32,5,3,0,0,0,0,0,0,False,False,False,0,4,2021-12-27T12:14:13.427,0,False,0.0
2021,16,3292,420,19,1212,13,31,4,4,0,0,0,0,0,0,False,False,False,0,1,2021-12-27T12:15:35.27,0,False,0.0
2021,16,3292,430,4,213,13,19,6,27,0,0,0,0,0,0,False,False,False,0,2,2021-12-27T12:17:39.277,0,False,
2021,16,3292,455,4,5119,2,47,5,4,9,5,9,0,9,0,True,False,False,0,3,2021-12-28T16:18:13.773,9,False,0.0
2021,16,3292,465,4,5119,3,35,2,25,0,0,0,0,0,0,False,False,False,0,3,2021-12-29T16:46:46.18,0,False,0.0
2021,16,3292,470,4,5119,2,46,3,3,11,8,10,1,10,0,True,False,False,0,2,2021-12-28T16:20:55.667,11,False,1.0
2021,16,3292,475,4,5119,2,35,6,17,18,1,17,1,17,0,False,False,False,0,3,2021-12-27T15:01:22.75,18,False,1.0
2021,16,3292,480,4,213,2,4,5,5,9,4,9,0,9,0,False,False,False,0,2,2021-12-27T12:38:14.49,9,False,0.0
2021,16,3292,490,4,2853,13,5,5,9,0,0,0,0,0,0,False,False,False,0,2,2021-12-29T15:59:54.01,0,False,0.0
2021,16,3292,495,4,2630,3,7,6,23,0,0,0,0,0,0,False,False,False,0,3,2021-12-27T12:44:31.377,0,False,0.0
2021,16,3292,500,4,213,2,12,4,7,11,4,10,1,10,0,False,False,False,0,3,2021-12-29T17:00:01.153,11,False,1.0
2021,16,3292,505,4,6953,2,33,5,6,12,6,11,1,11,6,False,False,False,0,4,2021-12-27T12:48:07.193,12,False,
2021,16,3292,515,4,2853,2,12,5,11,11,0,11,0,11,0,True,False,False,0,2,2021-12-28T16:18:31.753,11,False,0.0
2021,16,3292,520,4,2630,13,5,9,8,0,0,0,0,0,0,False,False,False,0,2,2021-12-29T15:54:30.97,0,False,0.0
2021,16,3292,555,19,7173,2,50,9,1,10,9,7,3,7,0,False,False,False,0,2,2021-12-27T13:06:14.023,10,False,3.0
2021,16,3292,560,19,7173,13,8,7,32,0,0,0,0,0,0,False,False,False,0,3,2022-02-16T18:31:43.623,0,False,0.0
2021,16,3292,570,19,7175,2,13,10,5,9,4,8,1,8,0,True,False,False,0,3,2021-12-28T19:17:03.553,9,False,1.0
2021,16,3292,585,19,7175,2,13,9,3,3,0,3,0,3,0,False,False,False,0,3,2021-12-27T13:19:20.23,3,False,0.0
2021,16,3292,590,19,1212,2,5,3,2,6,4,2,4,2,0,False,False,False,0,1,2021-12-29T16:56:54.127,6,False,4.0
2021,16,3292,595,19,7175,2,12,4,7,7,0,7,0,7,0,False,False,False,0,3,2021-12-29T16:47:16.24,7,False,0.0
2021,16,3292,625,4,2853,2,4,10,6,6,0,6,0,6,0,False,False,False,0,2,2021-12-27T13:27:21.443,6,False,0.0
2021,16,3292,635,4,5119,2,46,3,3,5,2,5,0,5,0,False,False,False,0,3,2021-12-27T15:02:16.72,5,True,0.0
2021,16,3292,645,4,5119,2,35,6,25,28,3,25,3,25,0,False,False,False,0,3,2021-12-29T16:50:35.713,28,False,3.0
2021,16,3292,660,4,6953,2,13,5,3,9,6,7,2,7,0,False,False,False,1,3,2021-12-29T16:35:10.987,9,False,2.0
2021,16,3292,685,19,4282,2,5,5,9,9,0,9,0,9,0,False,False,False,0,4,2021-12-29T16:47:29.147,9,False,0.0
2021,16,3292,695,19,4282,13,35,5,12,0,0,0,0,0,0,False,False,False,0,3,2021-12-29T16:47:39.067,0,False,0.0
2021,16,3292,700,19,7175,13,7,6,17,0,0,0,0,0,0,True,False,False,0,3,2021-12-27T14:00:53.263,0,False,
2021,16,3292,705,19,4282,13,5,10,4,0,0,0,0,0,0,False,False,False,0,4,2021-12-27T14:03:13.547,0,False,0.0
2021,16,3292,710,19,4912,2,3,5,14,13,-1,13,0,13,0,False,False,False,0,3,2021-12-27T14:04:19.15,13,True,0.0
2021,16,3292,715,19,7175,2,26,9,9,21,12,18,3,18,0,False,False,False,0,3,2021-12-27T14:06:00.48,21,False,3.0
2021,16,3292,750,4,2853,13,2,5,6,0,0,0,0,0,0,False,False,False,0,2,2022-02-25T16:10:07.107,0,False,0.0
2021,16,3292,760,4,5119,2,35,3,11,17,6,17,0,17,0,True,False,False,0,3,2021-12-28T16:21:53.107,17,True,0.0
2021,16,3292,765,4,5119,2,35,6,15,15,0,15,0,15,0,False,False,False,0,3,2021-12-29T16:47:50.17,15,True,0.0
2021,16,3292,800,4,6983,13,45,5,-4,0,0,0,0,0,0,False,False,False,0,1,2021-12-27T14:30:23.867,0,False,0.0
2021,16,3292,805,4,2853,2,12,9,7,19,12,9,10,9,0,False,False,False,2,2,2021-12-27T14:31:42.923,19,False,10.0
2021,16,3292,820,4,6953,2,4,9,2,2,0,2,0,2,6,False,False,False,0,3,2021-12-27T14:35:43.567,2,True,0.0
2021,16,3292,840,19,7173,13,6,7,18,0,0,0,0,0,0,False,False,False,0,2,2021-12-27T14:39:02.223,0,False,0.0
2021,16,3292,855,19,4282,13,7,7,15,0,0,0,0,0,0,False,False,False,0,4,2022-02-25T16:10:21.48,0,False,0.0
2021,16,3292,865,19,4912,2,12,9,14,20,6,17,3,17,0,False,False,False,0,2,2021-12-27T14:44:10.007,20,False,3.0
2021,16,3292,870,19,4912,13,6,8,17,0,0,0,0,0,0,False,False,False,0,2,2021-12-27T14:45:04.703,0,False,0.0
2021,16,3292,875,19,1212,13,31,9,3,0,0,0,0,0,0,False,False,False,0,1,2021-12-27T14:46:28.207,0,False,0.0
2021,16,3292,880,19,4912,13,4,9,7,0,0,0,0,0,0,False,False,False,0,3,2021-12-29T16:48:10.25,0,False,0.0
2021,16,3292,885,19,7175,13,12,1,46,0,0,0,0,0,0,False,False,False,0,3,2022-02-24T19:39:59.727,0,False,0.0
2021,16,3293,15,30,37,2,5,5,5,4,-1,4,0,4,0,False,False,False,0,2,2021-12-27T11:44:32.883,4,True,0.0
2021,16,3293,30,30,37,13,5,9,13,0,0,0,0,0,0,False,False,False,0,3,2021-12-27T11:46:47.73,0,False,0.0
2021,16,3293,35,30,37,13,24,3,1,0,0,0,0,0,0,False,False,False,0,3,2021-12-27T11:47:52.983,0,False,0.0
2021,16,3293,45,5,8408,2,47,10,3,14,11,10,4,10,0,False,False,False,0,4,2021-12-27T11:50:35.33,14,False,4.0
2021,16,3293,55,5,3477,2,2,10,7,8,1,8,0,8,0,False,False,False,0,2,2021-12-27T11:52:18.87,8,False,0.0
2021,16,3293,65,5,5220,2,5,3,9,10,1,9,1,9,0,True,False,False,0,3,2021-12-27T11:53:34.027,10,False,1.0
2021,16,3293,90,5,566,13,46,9,1,0,0,0,0,0,0,False,False,False,0,1,2022-02-16T15:31:38.897,0,False,0.0
2021,16,3293,110,30,6414,2,16,4,3,3,0,3,0,3,0,False,False,False,0,1,2021-12-27T12:10:06.4,3,False,0.0
2021,16,3293,115,30,37,2,5,5,4,4,0,4,0,4,0,False,False,False,0,3,2021-12-27T12:11:08.347,4,False,0.0
2021,16,3293,125,30,6414,2,48,9,-2,13,15,9,4,9,0,False,False,False,0,1,2021-12-27T12:18:47.05,13,False,4.0
2021,16,3293,145,5,3477,2,49,10,-2,5,7,5,0,5,0,False,False,False,0,3,2022-02-16T15:34:21.773,5,False,0.0
2021,16,3293,155,5,5220,2,2,10,7,15,8,11,4,11,0,False,False,False,0,3,2021-12-27T12:24:50.6,15,False,4.0
2021,16,3293,160,5,3477,13,2,9,4,0,0,0,0,0,0,False,False,False,0,2,2021-12-27T12:26:10.027,0,False,0.0
2021,16,3293,170,5,8408,13,5,9,6,0,0,0,0,0,0,False,False,False,0,3,2021-12-28T20:55:40.583,0,False,0.0
2021,16,3293,180,30,4523,2,51,10,0,12,12,6,6,6,0,True,False,False,0,3,2021-12-27T12:32:11.483,12,False,
2021,16,3293,185,30,37,2,50,9,-1,7,8,5,2,5,0,False,False,False,0,2,2021-12-27T12:33:31.267,7,False,2.0
2021,16,3293,195,30,37,2,4,6,19,19,0,19,0,19,0,False,False,False,0,2,2021-12-27T12:35:46.887,19,False,0.0
2021,16,3293,220,30,2290,13,9,2,25,0,0,0,0,0,0,False,False,False,0,4,2021-12-27T12:43:46.507,0,False,0.0
2021,16,3293,230,30,2290,2,5,5,4,7,3,6,1,6,0,False,False,False,0,3,2021-12-27T12:45:49.063,7,False,1.0
2021,16,3293,250,5,8413,2,12,2,24,63,39,63,0,63,0,False,False,False,0,2,2021-12-29T14:59:34.807,63,False,0.0
2021,16,3293,265,5,566,2,51,3,-4,0,4,0,0,0,0,True,False,False,0,1,2021-12-27T12:53:27.04,0,False,0.0
2021,16,3293,290,30,37,2,49,3,-1,1,2,1,0,1,0,False,False,False,0,2,2021-12-29T14:58:57.363,1,False,0.0
2021,16,3293,300,30,37,2,2,9,7,10,3,10,0,10,0,False,False,False,0,3,2021-12-29T15:18:26.003,10,False,0.0
2021,16,3293,305,30,37,2,5,6,22,22,0,22,0,22,0,False,False,False,0,2,2021-12-27T13:01:41.013,22,True,0.0
2021,16,3293,325,30,2290,13,6,10,3,0,0,0,0,0,0,True,False,False,0,2,2021-12-27T13:07:02.243,0,False,0.0
2021,16,3293,350,5,6425,2,5,5,4,4,0,4,0,4,0,True,False,False,0,3,2021-12-28T20:56:48.793,4,False,0.0
2021,16,3293,360,5,8406,2,5,3,3,6,3,3,3,3,0,True,False,False,0,3,2021-12-27T16:15:39.353,6,False,3.0
2021,16,3293,375,30,5056,2,24,2,34,62,28,60,2,60,0,False,False,False,0,3,2021-12-27T13:15:15.567,62,False,2.0
2021,16,3293,390,30,6414,3,47,5,0,0,0,0,0,0,0,False,False,False,0,1,2021-12-27T13:27:12.09,0,False,0.0
2021,16,3293,395,30,2290,2,2,10,4,4,0,4,0,4,6,True,False,False,0,3,2021-12-27T13:28:09.783,4,True,0.0
2021,16,3293,415,5,8408,3,38,4,3,0,0,0,0,0,0,False,False,False,0,4,2022-02-16T15:40:27.923,0,False,
2021,16,3293,420,5,566,2,28,9,0,2,2,2,0,2,0,False,False,False,0,1,2021-12-27T13:32:56.08,2,False,0.0
2021,16,3293,425,5,3477,13,5,3,14,0,0,0,0,0,0,False,False,False,0,2,2021-12-27T13:34:02.27,0,False,0.0
2021,16,3293,430,5,5220,13,4,3,13,0,0,0,0,0,0,False,False,False,0,2,2021-12-27T13:36:16.793,0,False,0.0
2021,16,3293,460,5,5220,2,4,9,5,9,4,9,0,9,0,False,False,False,0,3,2021-12-27T13:42:34.887,9,False,0.0
2021,16,3293,475,5,3477,13,20,8,47,0,0,0,0,0,0,False,False,False,0,3,2021-12-27T13:45:16.36,0,False,0.0
2021,16,3293,480,5,4341,13,4,3,8,0,0,0,0,0,0,False,False,False,0,2,2021-12-27T13:46:27.13,0,False,0.0
2021,16,3293,500,30,37,13,5,3,8,0,0,0,0,0,0,False,False,False,0,2,2022-02-16T15:43:23.49,0,False,0.0
2021,16,3293,505,30,37,2,2,10,10,13,3,13,0,13,0,False,False,False,0,3,2021-12-27T13:51:53.02,13,False,0.0
2021,16,3293,520,30,63,2,9,8,17,23,6,23,0,23,0,False,False,False,0,4,2021-12-27T14:03:32.763,23,False,0.0
2021,16,3293,545,30,63,13,7,3,3,0,0,0,0,0,0,False,False,False,0,3,2021-12-27T14:09:58.393,0,False,0.0
2021,16,3293,570,5,8413,13,5,3,10,0,0,0,0,0,0,False,False,False,0,2,2021-12-27T14:17:01.143,0,False,0.0
2021,16,3293,590,30,37,2,5,3,8,11,3,10,1,10,0,False,False,False,0,3,2021-12-27T14:23:01.027,11,False,1.0
2021,16,3293,610,30,5056,2,5,3,7,12,5,11,1,11,0,False,False,False,0,3,2021-12-27T14:31:11.963,12,False,1.0
2021,16,3293,635,5,3477,13,7,2,20,0,0,0,0,0,0,False,False,False,0,3,2021-12-27T14:41:47.553,0,False,0.0
2021,16,3293,640,5,5220,2,5,3,11,19,8,19,0,19,0,False,False,False,0,3,2021-12-29T15:00:06.157,19,False,0.0
2021,16,3293,645,5,5220,13,19,6,26,0,0,0,0,0,0,False,False,False,0,2,2021-12-27T14:41:31.14,0,False,0.0
2021,16,3293,650,5,8408,2,46,3,3,8,5,5,3,5,0,False,False,False,0,3,2021-12-27T14:42:48.507,8,False,3.0
2021,16,3293,665,5,566,2,4,10,4,6,2,6,0,6,0,False,False,False,0,1,2021-12-27T14:53:28.24,6,False,0.0
2021,16,3293,675,5,3477,2,4,9,4,13,9,10,3,10,0,False,False,False,1,3,2021-12-27T14:55:33.147,13,False,3.0
2021,16,3293,680,5,5220,2,49,10,-2,2,4,2,0,2,0,False,False,False,0,2,2021-12-27T14:56:54.433,2,False,0.0
2021,16,3293,690,5,566,13,11,5,14,0,0,0,0,0,0,True,False,False,0,1,2021-12-28T20:57:04.59,0,False,0.0
2021,16,3293,700,5,5220,13,29,5,11,0,0,0,0,0,0,False,False,False,0,2,2021-12-27T15:02:43.187,0,False,0.0
2021,16,3293,715,30,37,13,4,7,17,0,0,0,0,0,0,False,False,False,0,2,2021-12-27T15:19:59.247,0,False,0.0
2021,16,3293,725,5,5220,13,29,6,19,0,0,0,0,0,0,False,False,False,0,2,2021-12-27T16:19:30.29,0,False,0.0
2021,16,3293,730,5,3477,13,7,8,25,0,0,0,0,0,0,False,False,False,0,3,2022-02-17T20:26:09.663,0,False,0.0
2021,16,3293,735,5,566,3,16,9,4,0,0,0,0,0,0,False,False,False,0,1,2021-12-27T15:29:03.97,0,False,0.0
2021,16,3293,755,30,37,13,4,2,30,0,0,0,0,0,0,False,False,False,0,2,2021-12-27T15:32:11.753,0,False,0.0
2021,16,3293,760,30,7891,3,47,5,0,0,0,0,0,0,0,False,False,False,0,1,2021-12-27T15:33:16.457,0,False,0.0
2021,16,3293,775,5,5220,13,8,10,14,0,0,0,0,0,0,False,False,False,0,2,2021-12-27T15:34:48.91,0,False,0.0
2021,16,3293,785,5,8409,13,12,5,-3,0,0,0,0,0,0,False,False,False,0,1,2021-12-27T15:36:34.867,0,False,0.0
2021,16,3293,805,30,5056,2,49,5,-2,7,9,6,1,6,0,False,False,False,0,2,2021-12-27T15:40:09.173,7,False,1.0
2021,16,3293,810,30,37,2,4,5,10,10,0,10,0,10,0,False,False,False,0,2,2021-12-27T15:41:36.363,10,False,0.0
2021,16,3293,830,30,7268,13,4,2,19,0,0,0,0,0,0,False,False,False,0,2,2021-12-27T15:46:16.787,0,False,0.0
2021,16,3293,850,5,3477,2,51,9,-5,18,23,18,0,18,0,False,False,False,0,3,2021-12-29T15:16:20.01,18,False,0.0
2021,16,3293,855,5,3477,2,5,3,14,14,0,14,0,14,0,False,False,False,0,2,2021-12-29T15:01:19.203,14,False,0.0
2021,16,3293,860,5,8198,13,25,9,13,0,0,0,0,0,0,False,False,False,0,3,2021-12-27T16:01:47.95,0,False,0.0
2021,16,3293,865,5,8413,2,4,5,6,6,0,5,1,5,0,False,False,False,1,2,2021-12-29T15:16:42.707,6,False,1.0
2021,16,3293,870,5,6573,2,32,5,0,6,6,4,2,4,0,False,False,False,0,1,2021-12-29T14:23:09.51,6,False,2.0
2021,16,3293,875,5,8413,2,6,8,15,17,2,18,-1,18,0,False,False,False,0,2,2021-12-27T16:04:50.943,17,False,-1.0
2021,16,3293,890,5,7853,3,32,9,-1,0,0,0,0,0,0,False,False,False,0,4,2021-12-28T20:56:16.93,0,False,0.0
2021,16,3293,895,5,6573,2,28,10,2,6,4,5,1,5,0,False,False,False,0,1,2021-12-27T16:07:52.387,6,False,1.0
2021,16,3293,910,5,8406,13,12,10,11,0,0,0,0,0,0,False,False,False,0,3,2021-12-27T16:09:52.42,0,False,
2021,16,3293,915,5,8198,13,4,5,6,0,0,0,0,0,0,False,False,False,0,3,2021-12-27T16:11:30.003,0,False,0.0
2021,16,3293,920,5,5220,13,12,5,6,0,0,0,0,0,0,False,False,False,0,2,2021-12-27T16:12:20.213,0,False,0.0
2021,16,3294,10,15,957,2,51,10,-2,1,3,0,1,0,0,True,False,False,0,4,2021-12-29T16:34:26.26,1,False,1.0
2021,16,3294,15,15,914,2,5,5,4,4,0,4,0,4,0,False,False,False,0,3,2021-12-27T10:12:10.923,4,False,0.0
2021,16,3294,35,15,2757,2,4,9,7,12,5,10,2,10,0,True,False,False,1,3,2021-12-27T10:21:57.51,12,False,2.0
2021,16,3294,50,15,4179,13,7,6,37,0,0,0,0,0,0,False,False,False,0,2,2021-12-27T10:27:20.897,0,False,
2021,16,3294,85,22,6270,2,51,9,-5,4,9,-1,5,-1,0,True,False,False,1,3,2021-12-27T10:39:56.997,4,False,5.0
2021,16,3294,95,22,7610,13,19,6,19,0,0,0,0,0,0,False,False,False,0,2,2021-12-29T16:35:04.747,0,False,0.0
2021,16,3294,100,22,4997,2,6,3,11,19,8,14,5,14,0,False,False,False,0,3,2021-12-27T10:49:04.697,19,False,5.0
2021,16,3294,105,22,2629,2,53,9,-2,2,4,-2,4,-2,0,False,False,False,1,4,2021-12-27T10:51:13.353,2,False,4.0
2021,16,3294,140,15,4886,2,47,5,2,9,7,9,0,9,0,False,False,False,0,1,2021-12-27T11:03:59.757,9,False,0.0
2021,16,3294,150,15,4835,2,46,3,2,9,7,7,2,7,0,False,False,False,0,4,2021-12-27T11:06:52.437,9,False,2.0
2021,16,3294,155,15,4179,13,8,1,39,0,0,0,0,0,0,False,False,False,0,2,2021-12-29T15:41:19.25,0,False,0.0
2021,16,3294,165,15,4179,2,35,6,18,20,2,20,0,20,0,False,False,False,0,3,2022-03-08T19:22:11.357,20,False,0.0
2021,16,3294,185,15,914,2,4,9,6,8,2,6,2,6,0,False,False,False,0,3,2021-12-29T16:26:46.213,8,False,2.0
2021,16,3294,225,15,4886,3,46,3,2,0,0,0,0,0,0,True,False,False,0,4,2021-12-27T11:32:00.013,0,False,0.0
2021,16,3294,230,15,957,2,5,2,15,17,2,15,2,15,0,False,False,False,0,3,2021-12-27T11:33:59.223,17,False,2.0
2021,16,3294,245,15,914,2,6,4,8,10,2,8,2,8,0,False,False,False,0,3,2021-12-27T11:39:36.33,10,False,2.0
2021,16,3294,250,15,4835,2,32,10,-1,11,12,6,5,6,0,False,False,False,0,4,2021-12-27T11:42:15.61,11,False,5.0
2021,16,3294,260,15,914,13,21,2,28,0,0,0,0,0,0,False,False,False,0,3,2021-12-27T11:45:33.813,0,False,0.0
2021,16,3294,265,15,957,2,46,3,1,1,0,1,0,1,0,False,False,False,0,3,2021-12-27T11:47:52.943,1,False,0.0
2021,16,3294,280,22,2629,13,31,10,-4,0,0,0,0,0,0,False,False,False,0,4,2021-12-27T11:51:36.747,0,False,0.0
2021,16,3294,290,22,7118,3,8,9,14,0,0,0,0,0,0,False,False,False,0,3,2021-12-29T15:41:19.25,0,False,0.0
2021,16,3294,300,15,957,2,26,3,3,7,4,7,0,7,0,False,False,False,0,3,2021-12-27T11:59:37.803,7,True,0.0
2021,16,3294,315,15,914,13,4,10,13,0,0,0,0,0,0,False,False,False,0,3,2021-12-27T12:03:19.02,0,False,0.0
2021,16,3294,370,22,6270,2,13,4,4,10,6,7,3,7,0,False,False,False,0,3,2021-12-27T12:20:37.553,10,False,3.0
2021,16,3294,380,22,8451,13,16,9,3,0,0,0,0,0,0,False,False,False,0,1,2021-12-27T12:28:47.78,0,False,0.0
2021,16,3294,385,22,8451,2,5,3,2,4,2,4,0,4,0,True,False,False,0,3,2021-12-29T16:36:52.14,4,False,0.0
2021,16,3294,420,22,7610,13,12,4,2,0,0,0,0,0,0,False,False,False,0,4,2022-02-24T19:40:57.05,0,False,0.0
2021,16,3294,440,22,6270,2,32,10,3,4,1,4,0,4,0,False,False,False,0,4,2021-12-27T12:49:41.923,4,False,0.0
2021,16,3294,470,22,2629,13,4,10,5,0,0,0,0,0,0,False,False,False,0,4,2021-12-27T12:59:13.25,0,False,0.0
2021,16,3294,475,22,4997,2,2,9,4,6,2,5,1,5,0,False,False,False,0,2,2021-12-27T15:44:19.38,6,False,1.0
2021,16,3294,500,15,4179,2,13,5,1,5,4,4,1,4,0,False,False,False,0,3,2021-12-27T13:08:04.007,5,False,1.0
2021,16,3294,505,15,914,2,35,5,9,10,1,10,0,10,0,False,False,False,0,3,2021-12-29T15:41:19.25,10,False,0.0
2021,16,3294,520,22,743,2,46,3,0,4,4,2,2,2,0,False,False,False,0,3,2021-12-27T13:16:18.677,4,False,2.0
2021,16,3294,555,15,957,2,35,2,25,25,0,25,0,25,0,False,False,False,0,3,2021-12-29T15:41:19.25,25,False,0.0
2021,16,3294,560,15,914,2,35,6,20,19,-1,19,0,19,0,False,False,False,0,3,2021-12-27T13:37:33.447,19,False,0.0
2021,16,3294,570,15,914,3,4,10,4,0,0,0,0,0,0,False,False,False,0,3,2021-12-27T13:40:26.043,0,False,0.0
2021,16,3294,575,15,957,13,12,6,32,0,0,0,0,0,0,False,False,False,0,3,2021-12-27T13:42:19.897,0,False,0.0
2021,16,3294,580,15,4179,2,5,5,8,11,3,10,1,10,0,False,False,False,0,2,2022-03-08T19:23:19.747,11,False,1.0
2021,16,3294,605,22,2629,2,35,7,18,22,4,18,4,18,0,False,False,False,1,4,2021-12-27T13:51:39.323,22,False,4.0
2021,16,3294,650,22,8451,2,47,5,1,2,1,2,0,2,0,False,False,False,0,1,2021-12-29T15:41:19.25,2,False,0.0
2021,16,3294,655,22,4878,2,12,5,1,1,0,1,0,1,6,False,False,False,0,4,2021-12-27T14:19:54.863,1,True,0.0
2021,16,3294,670,15,914,2,4,9,9,13,4,10,3,10,0,True,False,False,0,3,2021-12-27T14:23:14.3,13,False,3.0
2021,16,3294,685,15,2757,2,6,7,17,22,5,20,2,20,0,False,False,False,0,2,2021-12-27T14:32:31.99,22,False,2.0
2021,16,3294,690,15,914,13,35,6,31,0,0,0,0,0,0,False,False,False,0,3,2021-12-27T14:36:20.233,0,False,0.0
2021,16,3294,695,15,4179,2,6,8,16,18,2,17,1,17,0,False,False,False,0,2,2021-12-27T14:38:46.663,18,False,1.0
2021,16,3294,705,15,2757,13,17,7,16,0,0,0,0,0,0,False,False,False,0,4,2021-12-27T14:41:05.91,0,False,
2021,16,3294,730,22,6270,2,51,10,-5,7,12,4,3,4,0,True,False,False,0,3,2021-12-27T14:48:37.983,7,False,3.0
2021,16,3294,745,22,6270,2,6,9,12,12,0,12,0,12,0,False,False,False,0,2,2021-12-29T16:59:12.173,12,False,0.0
2021,16,3294,785,22,2629,2,4,10,5,5,0,5,0,5,0,True,False,False,0,3,2021-12-27T15:08:53.233,5,False,0.0
2021,16,3294,805,15,957,2,5,2,15,17,2,17,0,17,0,True,False,False,0,3,2021-12-27T15:11:32.723,17,True,0.0
2021,16,3294,810,15,2757,2,4,10,6,8,2,8,0,8,0,False,False,False,0,4,2021-12-29T16:28:29.33,8,False,0.0
2021,16,3294,815,15,2757,2,5,5,7,7,0,7,0,7,0,False,False,False,0,3,2022-03-08T19:24:03.803,7,False,0.0
2021,16,3294,825,15,914,2,4,5,6,6,0,6,0,6,0,False,False,False,0,2,2021-12-27T15:17:14.66,6,True,0.0
2021,16,3294,830,15,4886,2,28,4,1,6,5,6,0,6,0,False,False,False,0,1,2021-12-27T15:18:53.883,6,True,0.0
2021,16,3294,845,15,4886,13,46,3,1,0,0,0,0,0,0,False,False,False,0,1,2021-12-27T15:22:08.607,0,False,0.0
2021,16,3294,850,15,914,2,4,10,4,4,0,4,0,4,0,False,False,False,0,3,2021-12-29T16:47:13.807,4,False,0.0
2021,16,3294,860,15,914,13,13,5,1,0,0,0,0,0,0,False,False,False,0,3,2021-12-27T15:30:28.573,0,False,0.0
2021,16,3295,15,2,811,2,28,10,-4,-1,3,-1,0,-1,0,False,False,False,0,1,2021-12-27T05:35:55.807,-1,False,0.0
2021,16,3295,20,2,8389,2,4,4,12,13,1,12,1,12,0,False,False,False,0,3,2021-12-29T16:28:00.773,13,False,1.0
2021,16,3295,45,11,4875,2,4,10,4,13,9,5,8,5,0,False,False,False,1,3,2021-12-28T20:29:10.837,13,False,8.0
2021,16,3295,50,11,8359,2,51,9,-4,0,4,-5,5,-5,0,False,False,False,1,1,2021-12-29T16:19:28.643,0,False,5.0
2021,16,3295,55,11,6629,2,46,3,3,4,1,3,1,3,0,False,False,False,0,1,2021-12-27T05:50:42.807,4,False,1.0
2021,16,3295,60,11,8359,2,5,10,6,8,2,7,1,7,0,True,False,False,0,3,2021-12-27T13:45:52,8,False,1.0
2021,16,3295,85,11,8641,2,53,10,-5,-3,2,-3,0,-3,0,False,False,False,0,4,2021-12-27T06:02:15.277,-3,False,0.0
2021,16,3295,90,11,8359,2,5,3,11,12,1,12,0,12,0,False,False,False,0,3,2021-12-27T13:46:15.137,12,True,0.0
2021,16,3295,105,11,4875,13,29,9,8,0,0,0,0,0,0,False,False,False,0,2,2021-12-27T06:08:54.187,0,False,0.0
2021,16,3295,130,2,7303,13,26,9,5,0,0,0,0,0,0,False,False,False,0,3,2021-12-27T13:57:04.483,0,False,0.0
2021,16,3295,145,11,6629,2,46,3,2,2,0,2,0,2,0,False,False,False,0,1,2021-12-27T06:20:35.307,2,False,0.0
2021,16,3295,150,11,4875,13,6,8,15,0,0,0,0,0,0,False,False,False,0,2,2021-12-27T13:57:16.45,0,False,0.0
2021,16,3295,160,2,5214,2,4,10,5,9,4,7,2,7,0,True,False,False,0,3,2021-12-28T21:19:28.337,9,False,2.0
2021,16,3295,175,2,6247,2,4,10,14,15,1,14,1,14,0,False,False,False,0,3,2021-12-27T06:31:16.033,15,False,1.0
2021,16,3295,185,2,3820,2,6,4,5,10,5,9,1,9,0,False,False,False,0,3,2021-12-27T06:34:46.827,10,False,1.0
2021,16,3295,195,2,8389,2,47,5,2,8,6,2,6,2,0,False,False,False,0,3,2021-12-27T06:37:25.273,8,False,6.0
2021,16,3295,240,11,7493,2,6,4,3,14,11,3,11,3,0,False,False,False,2,1,2021-12-27T11:55:26.743,14,False,11.0
2021,16,3295,275,11,6633,2,4,5,8,21,13,10,11,10,0,False,False,False,1,2,2021-12-29T16:16:37.597,21,False,11.0
2021,16,3295,285,11,4875,13,35,9,9,0,0,0,0,0,0,False,False,False,0,3,2021-12-27T14:00:37.387,0,False,0.0
2021,16,3295,290,11,8359,2,4,5,9,20,11,9,11,9,6,False,False,False,0,3,2021-12-27T13:57:30.45,20,False,11.0
2021,16,3295,305,2,7303,2,4,9,6,17,11,15,2,15,0,False,False,False,0,3,2021-12-27T07:05:27.533,17,False,2.0
2021,16,3295,315,2,7303,2,4,9,6,15,9,10,5,10,0,False,False,False,0,3,2021-12-27T07:06:41.77,15,False,5.0
2021,16,3295,330,2,811,13,4,3,4,0,0,0,0,0,0,True,False,False,0,2,2021-12-28T21:29:52.473,0,False,0.0
2021,16,3295,350,11,8359,2,39,4,6,8,2,8,0,8,0,False,False,False,0,3,2021-12-27T07:12:33.38,8,False,0.0
2021,16,3295,355,11,8359,2,5,3,6,6,0,6,0,6,0,False,False,False,0,3,2021-12-27T07:13:35.91,6,True,0.0
2021,16,3295,360,11,4875,3,4,7,17,0,0,0,0,0,0,False,False,False,0,2,2021-12-27T07:18:00.737,0,False,0.0
2021,16,3295,365,11,4037,13,5,2,20,0,0,0,0,0,0,False,False,False,0,2,2021-12-27T07:16:33.183,0,False,0.0
2021,16,3295,370,11,6815,2,31,10,7,8,1,7,1,7,0,False,False,False,0,3,2021-12-29T16:07:24.467,8,False,1.0
2021,16,3295,380,11,8359,13,19,2,25,0,0,0,0,0,0,False,False,False,0,2,2021-12-28T20:29:54.837,0,False,0.0
2021,16,3295,395,11,8641,2,32,9,-1,2,3,2,0,2,0,False,False,False,0,4,2021-12-29T16:32:22.473,2,False,0.0
2021,16,3295,405,11,4875,13,29,6,16,0,0,0,0,0,0,False,False,False,0,3,2021-12-29T16:32:58.873,0,False,0.0
2021,16,3295,415,2,8389,2,4,9,5,9,4,7,2,7,0,False,False,False,0,3,2021-12-29T16:33:33.63,9,False,2.0
2021,16,3295,425,2,8389,2,2,4,12,18,6,15,3,15,0,True,False,False,0,3,2021-12-28T21:30:12.243,18,False,3.0
2021,16,3295,435,2,8389,2,19,2,30,35,5,35,0,35,0,False,False,False,0,2,2021-12-27T13:58:41.68,35,True,0.0
2021,16,3295,440,2,7303,13,39,4,6,0,0,0,0,0,0,False,False,False,0,3,2021-12-29T16:02:45.543,0,False,0.0
2021,16,3295,445,2,6240,2,26,9,5,5,0,5,0,5,0,True,False,False,0,3,2021-12-27T11:52:05.757,5,False,0.0
2021,16,3295,475,11,4037,2,39,4,5,6,1,6,0,6,0,False,False,False,0,3,2021-12-27T12:00:54.347,6,False,0.0
2021,16,3295,485,11,7493,2,48,9,-5,4,9,3,1,3,0,False,False,False,0,1,2021-12-27T12:04:01.467,4,False,1.0
2021,16,3295,500,11,8359,2,5,6,18,24,6,24,0,24,0,False,False,False,0,2,2021-12-27T12:11:48.967,24,True,0.0
2021,16,3295,525,11,8359,13,11,3,5,0,0,0,0,0,0,False,False,False,0,3,2021-12-27T12:16:43.547,0,False,0.0
2021,16,3295,550,2,2554,2,32,10,-4,7,11,2,5,2,0,False,False,False,2,1,2021-12-29T16:18:00.257,7,False,5.0
2021,16,3295,560,2,6247,3,6,10,10,0,0,0,0,0,0,False,False,False,0,3,2021-12-27T12:25:20.27,0,False,0.0
2021,16,3295,565,2,6247,2,5,3,13,13,0,13,0,13,0,False,False,False,0,3,2021-12-27T12:27:03.73,13,True,0.0
2021,16,3295,575,2,6247,2,12,5,6,7,1,7,0,7,0,False,False,False,0,3,2021-12-27T12:29:27.217,7,True,0.0
2021,16,3295,585,2,8389,2,2,9,11,19,8,15,4,15,0,False,False,False,1,2,2021-12-27T12:32:18.837,19,False,4.0
2021,16,3295,590,2,5214,2,11,5,12,12,0,12,0,12,6,True,False,False,0,4,2021-12-27T12:34:40.213,12,True,0.0
2021,16,3295,605,11,4037,2,49,10,-3,2,5,1,1,1,0,False,False,False,0,2,2021-12-27T12:40:47.447,2,False,1.0
2021,16,3295,610,11,4875,2,8,8,20,23,3,21,2,21,0,False,False,False,0,2,2021-12-29T16:11:24.627,23,False,2.0
2021,16,3295,635,11,8359,2,4,9,5,5,0,5,0,5,0,True,False,False,0,2,2021-12-27T12:50:17.777,5,False,0.0
2021,16,3295,660,11,7493,13,11,5,8,0,0,0,0,0,0,False,False,False,0,1,2021-12-27T12:57:52.2,0,False,0.0
2021,16,3295,665,11,7493,2,44,3,-5,4,9,2,2,2,0,True,False,False,0,1,2021-12-27T12:59:52.087,4,False,2.0
2021,16,3295,670,11,4037,2,13,9,3,4,1,4,0,4,0,False,False,False,0,3,2021-12-27T13:03:55.4,4,False,0.0
2021,16,3295,680,11,8359,2,5,5,6,8,2,7,1,7,0,False,False,False,0,3,2022-02-17T20:18:21.537,8,False,1.0
2021,16,3295,720,2,6247,2,50,3,-3,4,7,4,0,4,0,False,True,True,0,2,2021-12-27T13:17:59.523,4,False,0.0
2021,16,3295,740,11,8641,2,39,4,5,5,0,5,0,5,0,False,False,False,0,4,2021-12-27T13:23:04.923,5,False,0.0
2021,16,3295,755,11,6815,2,4,10,7,8,1,7,1,7,0,False,False,False,0,3,2021-12-27T13:29:37.527,8,False,1.0
2021,16,3295,765,11,4037,13,17,4,8,0,0,0,0,0,0,False,False,False,0,2,2021-12-27T13:52:58.037,0,False,0.0
2021,16,3296,10,26,309,2,39,4,5,7,2,6,1,6,0,False,False,False,0,3,2021-12-27T10:37:12.827,7,False,1.0
2021,16,3296,20,26,8552,2,2,10,4,10,6,9,1,9,0,False,False,False,0,2,2021-12-27T10:42:55.647,10,False,1.0
2021,16,3296,25,26,7133,2,13,10,6,16,10,15,1,15,0,False,False,False,0,3,2021-12-28T15:34:46.257,16,False,1.0
2021,16,3296,30,26,6301,2,28,4,0,0,0,0,0,0,0,False,False,False,0,1,2021-12-29T18:14:02.523,0,False,
2021,16,3296,45,26,309,13,2,4,7,0,0,0,0,0,0,False,False,False,0,3,2021-12-27T10:58:22.637,0,False,0.0
2021,16,3296,65,13,1116,2,5,3,7,7,0,7,0,7,0,False,False,False,0,3,2021-12-27T11:06:04.993,7,True,0.0
2021,16,3296,80,13,3586,2,34,4,-4,4,8,3,1,3,0,True,False,False,0,2,2021-12-27T11:11:30.683,4,False,1.0
2021,16,3296,85,13,8417,2,13,9,5,11,6,11,0,11,0,False,False,False,0,3,2021-12-27T11:15:31.63,11,False,0.0
2021,16,3296,90,13,8417,13,21,2,34,0,0,0,0,0,0,False,False,False,0,2,2021-12-27T11:18:21.097,0,False,
2021,16,3296,120,26,6301,2,47,10,-1,9,10,4,5,4,0,False,False,False,0,1,2021-12-27T11:36:24.36,9,False,5.0
2021,16,3296,125,26,8552,2,18,5,-2,12,14,1,11,1,0,False,False,False,1,3,2021-12-29T17:30:25.26,12,False,11.0
2021,16,3296,135,26,6301,2,48,9,-6,25,31,16,9,16,0,False,False,False,1,1,2021-12-29T17:17:16.7,25,False,9.0
2021,16,3296,150,26,958,2,4,10,6,9,3,9,0,9,0,True,False,False,0,3,2021-12-27T11:54:59.39,9,False,0.0
2021,16,3296,155,26,958,13,5,3,13,0,0,0,0,0,0,False,False,False,0,3,2021-12-27T11:57:24.637,0,False,0.0
2021,16,3296,180,13,1510,2,48,9,-6,-4,2,-4,0,-4,0,True,False,False,0,1,2021-12-28T14:17:12.897,-4,False,0.0
2021,16,3296,205,26,958,2,17,10,11,18,7,16,2,16,0,False,False,False,0,3,2021-12-29T17:33:08.017,18,False,2.0
2021,16,3296,210,26,8552,2,35,5,9,12,3,12,0,12,0,False,False,False,0,2,2021-12-27T12:32:19.477,12,True,0.0
2021,16,3296,220,26,7133,13,29,6,27,0,0,0,0,0,0,False,False,False,0,2,2021-12-27T12:36:51.74,0,False,0.0
2021,16,3296,225,26,309,2,13,9,4,15,11,10,5,10,0,False,False,False,0,3,2021-12-27T12:38:40.477,15,False,5.0
2021,16,3296,250,13,8418,2,30,10,-3,11,14,5,6,5,0,False,False,False,2,4,2021-12-29T17:32:19.443,11,False,6.0
2021,16,3296,265,13,1510,2,4,9,4,4,0,4,0,4,0,True,False,False,0,2,2021-12-27T12:51:52.007,4,False,0.0
2021,16,3296,280,13,3586,2,51,5,-3,14,17,4,10,4,0,False,False,False,1,3,2021-12-27T12:58:29.807,14,False,10.0
2021,16,3296,285,13,1116,13,43,2,26,0,0,0,0,0,0,True,False,False,0,3,2021-12-28T14:19:00.107,0,False,0.0
2021,16,3296,290,13,2407,2,51,9,-4,5,9,-2,7,-2,0,False,False,False,1,3,2021-12-27T13:16:57.38,1,False,7.0
2021,16,3296,300,13,8417,13,2,10,7,0,0,0,0,0,0,False,False,False,0,2,2021-12-27T13:12:16.533,0,False,0.0
2021,16,3296,320,26,7133,2,4,9,5,16,11,14,2,14,0,False,False,False,0,3,2021-12-29T17:34:00.66,16,False,2.0
2021,16,3296,325,26,8552,13,8,7,40,0,0,0,0,0,0,False,False,False,0,3,2021-12-29T17:34:25.62,0,False,0.0
2021,16,3296,355,13,1116,2,9,2,36,36,0,36,0,36,0,False,False,False,0,2,2021-12-29T18:13:28.73,36,False,0.0
2021,16,3296,365,13,4662,2,5,9,5,6,1,5,1,5,0,False,False,False,0,4,2021-12-27T13:41:15.807,6,False,1.0
2021,16,3296,380,13,2407,2,19,2,38,41,3,39,2,39,6,False,False,False,0,2,2021-12-27T13:49:49.213,41,False,2.0
2021,16,3296,425,13,2407,2,2,4,8,18,10,10,8,10,0,False,False,False,1,3,2021-12-29T17:18:12.563,18,False,8.0
2021,16,3296,430,13,4662,13,35,9,13,0,0,0,0,0,0,False,False,False,0,4,2022-02-16T17:11:24.727,0,False,0.0
2021,16,3296,440,13,1116,2,5,5,8,12,4,12,0,12,0,False,False,False,0,3,2021-12-27T14:43:20.337,12,False,0.0
2021,16,3296,445,13,1116,13,5,3,10,0,0,0,0,0,0,False,False,False,0,3,2021-12-27T14:44:58.563,0,False,0.0
2021,16,3296,460,26,309,13,5,2,16,0,0,0,0,0,0,False,False,False,0,2,2021-12-29T16:58:04.527,0,False,0.0
2021,16,3296,470,26,7695,2,46,3,4,14,10,5,9,5,0,False,False,False,1,1,2021-12-28T15:35:01.147,14,False,9.0
2021,16,3296,480,26,6301,2,4,9,0,6,6,6,0,6,0,False,False,False,0,1,2021-12-29T17:36:09.52,6,False,0.0
2021,16,3296,485,26,8553,2,30,10,2,12,10,11,1,11,0,False,False,False,0,4,2021-12-29T18:13:28.73,12,False,1.0
2021,16,3296,525,13,8417,2,2,9,2,9,7,6,3,6,0,False,False,False,0,2,2021-12-27T15:24:35.56,9,False,3.0
2021,16,3296,540,13,8418,2,4,10,5,6,1,5,1,5,0,False,False,False,0,3,2021-12-27T15:28:48.56,6,False,1.0
2021,16,3296,545,13,1116,13,3,3,13,0,0,0,0,0,0,False,False,False,0,2,2021-12-27T15:31:46.82,0,False,0.0
2021,16,3296,555,13,8418,2,5,3,4,27,23,27,0,27,0,False,False,False,0,4,2021-12-27T15:37:07.66,27,False,0.0
2021,16,3296,605,26,958,2,30,5,0,17,17,2,15,2,0,False,False,False,1,4,2021-12-27T17:20:33.103,17,False,15.0
2021,16,3296,615,13,3586,2,34,4,-4,-1,3,-1,0,-1,0,True,False,False,0,3,2021-12-27T15:57:43.097,-1,False,0.0
2021,16,3296,625,13,8418,2,6,5,12,12,0,12,0,12,0,False,False,False,0,3,2021-12-27T16:03:29.683,12,False,0.0
2021,16,3296,630,13,3586,2,35,8,21,23,2,21,2,21,0,False,False,False,0,3,2021-12-27T16:05:19.027,23,False,2.0
2021,16,3296,645,13,6528,3,2,10,2,0,0,0,0,0,0,True,False,False,0,2,2021-12-27T16:09:49.65,0,False,0.0
2021,16,3296,660,26,6301,2,4,9,4,11,7,9,2,9,0,False,False,False,0,1,2021-12-27T16:13:56.973,11,False,2.0
2021,16,3296,665,26,6301,2,16,9,6,9,3,8,1,8,0,False,False,False,0,1,2021-12-29T17:13:02.113,9,False,1.0
2021,16,3296,670,26,6301,2,4,4,2,17,15,5,12,5,0,False,False,False,2,1,2021-12-29T17:20:10.433,17,False,12.0
2021,16,3296,680,26,4050,2,32,10,2,7,5,4,3,4,0,False,False,False,0,4,2021-12-27T16:20:23.157,7,False,3.0
2021,16,3296,690,26,309,2,4,9,5,7,2,7,0,7,0,False,False,False,0,3,2021-12-27T16:25:32.973,7,False,0.0
2021,16,3296,720,13,4662,2,30,10,-1,4,5,0,4,0,0,False,False,False,0,4,2021-12-27T16:35:23.613,4,False,4.0
2021,16,3296,760,13,8417,2,2,10,5,13,8,11,2,11,6,False,False,False,0,2,2021-12-27T16:47:07.47,13,False,2.0
2021,16,3296,775,26,8552,2,4,10,9,6,-3,6,0,6,0,False,False,False,0,2,2021-12-27T16:51:21.71,6,False,0.0
2021,16,3296,785,26,309,2,5,3,5,6,1,6,0,6,0,False,False,False,0,3,2021-12-27T16:54:32.097,6,False,0.0
2021,16,3296,795,26,958,13,35,5,10,0,0,0,0,0,0,False,False,False,0,3,2022-02-25T16:11:43.713,0,False,0.0
2021,16,3296,810,26,7133,2,5,6,20,24,4,24,0,24,0,False,False,False,0,2,2021-12-27T16:59:52.777,24,False,0.0
2021,16,3296,815,26,6301,2,4,9,4,13,9,12,1,12,0,False,False,False,0,1,2021-12-27T17:01:01.41,13,False,1.0
2021,16,3296,820,26,6301,2,46,3,3,8,5,8,0,8,0,False,False,False,0,1,2021-12-27T17:02:08.48,8,True,0.0
2021,16,3296,825,26,4050,2,35,7,20,27,7,27,0,27,0,False,False,False,0,3,2021-12-29T17:39:53.48,27,False,0.0
2021,16,3296,835,26,8552,2,6,4,3,3,0,3,0,3,6,False,False,False,0,2,2021-12-27T17:08:55.653,3,True,0.0
2021,16,3297,10,7,7659,2,12,3,10,10,0,10,0,10,0,True,False,False,0,3,2021-12-27T10:28:13.953,10,False,0.0
2021,16,3297,20,7,7659,2,2,9,7,18,11,14,4,14,0,False,False,False,0,2,2021-12-27T10:29:52.36,18,False,4.0
2021,16,3297,25,7,7659,2,35,8,15,20,5,19,1,19,0,False,False,False,0,3,2021-12-29T20:52:55.963,20,False,1.0
2021,16,3297,30,7,4679,2,47,5,-1,3,4,1,2,1,0,False,False,False,0,1,2021-12-27T10:32:19.73,3,False,2.0
2021,16,3297,45,7,8325,13,9,5,12,0,0,0,0,0,0,False,False,False,0,2,2021-12-27T10:36:41.82,0,False,0.0
2021,16,3297,60,3,8430,2,2,9,9,11,2,11,0,11,0,False,False,False,0,2,2021-12-27T10:39:11.743,11,False,0.0
2021,16,3297,65,3,6454,2,11,5,7,17,10,17,0,17,0,False,False,False,0,4,2021-12-27T10:40:13.723,17,False,0.0
2021,16,3297,70,3,8430,2,4,3,5,5,0,5,0,5,0,False,False,False,0,2,2021-12-27T10:41:03.567,5,False,0.0
2021,16,3297,90,3,6936,2,2,9,7,15,8,13,2,13,0,False,False,False,0,3,2021-12-27T10:44:46.003,15,False,2.0
2021,16,3297,100,3,8430,2,4,10,3,6,3,4,2,4,0,True,False,False,0,3,2021-12-27T10:47:25.817,6,False,2.0
2021,16,3297,110,3,6936,13,7,3,4,0,0,0,0,0,0,False,False,False,0,3,2021-12-27T10:49:32.067,0,False,0.0
2021,16,3297,115,3,8430,2,2,9,4,4,0,4,0,4,6,False,False,False,0,3,2021-12-27T10:50:38.953,4,True,0.0
2021,16,3297,130,7,7659,2,4,5,10,11,1,11,0,11,0,False,False,False,0,2,2021-12-27T10:52:58.057,11,False,0.0
2021,16,3297,140,7,2631,2,47,10,4,16,12,14,2,14,0,False,False,False,0,4,2021-12-29T20:53:08.13,16,False,2.0
2021,16,3297,150,7,2631,13,12,2,21,0,0,0,0,0,0,False,False,False,0,4,2021-12-27T10:59:02.503,0,False,
2021,16,3297,160,7,6975,2,6,4,4,5,1,5,0,5,0,False,False,False,0,4,2021-12-27T11:01:15.253,5,False,0.0
2021,16,3297,165,7,8317,2,9,2,17,17,0,17,0,17,0,False,False,False,0,2,2021-12-27T11:02:16.17,17,False,0.0
2021,16,3297,175,7,2631,13,7,3,2,0,0,0,0,0,0,False,False,False,0,4,2021-12-27T11:04:34.597,0,False,0.0
2021,16,3297,200,3,8430,13,46,3,1,0,0,0,0,0,0,True,False,False,0,3,2021-12-27T12:11:48.993,0,False,0.0
2021,16,3297,205,3,7673,2,2,9,9,9,0,9,0,9,0,False,False,False,0,3,2021-12-27T12:12:41.453,9,False,0.0
2021,16,3297,225,7,4679,2,46,3,-2,3,5,0,3,0,0,False,False,False,0,1,2021-12-27T12:18:42.707,3,False,3.0
2021,16,3297,230,7,3521,2,24,8,17,68,51,68,0,68,6,False,False,False,0,3,2021-12-29T17:15:38.013,68,True,0.0
2021,16,3297,255,3,6936,2,51,3,-2,-1,1,-1,0,-1,0,False,False,False,0,3,2021-12-27T12:23:19.76,-1,False,0.0
2021,16,3297,280,7,8317,2,13,10,4,20,16,20,0,20,0,False,False,False,1,3,2021-12-27T12:27:35.3,20,False,0.0
2021,16,3297,285,7,7659,2,2,10,13,17,4,17,0,17,0,False,False,False,1,3,2021-12-27T12:29:40.51,17,False,0.0
2021,16,3297,295,7,4679,2,6,9,1,9,8,7,2,7,6,False,False,False,0,1,2021-12-29T17:15:38.027,9,False,2.0
2021,16,3297,320,3,7673,2,17,9,14,16,2,16,0,16,0,False,False,False,0,3,2021-12-27T12:35:14.417,16,False,0.0
2021,16,3297,325,3,6454,2,5,5,5,12,7,6,6,6,0,False,False,False,1,3,2021-12-29T20:54:54.98,12,False,6.0
2021,16,3297,330,3,6454,2,4,10,3,10,7,3,7,3,0,False,False,False,1,3,2021-12-27T12:37:12.453,10,False,7.0
2021,16,3297,340,3,713,2,48,5,-2,-1,1,-1,0,-1,0,False,False,False,0,1,2022-02-16T16:02:53.287,-1,False,0.0
2021,16,3297,350,3,8434,2,2,9,5,18,13,8,10,8,0,False,False,False,2,3,2021-12-27T12:40:55.943,18,False,10.0
2021,16,3297,355,3,6454,13,2,10,11,0,0,0,0,0,0,False,False,False,0,3,2021-12-27T12:42:13.267,0,False,0.0
2021,16,3297,360,3,6936,13,4,5,4,0,0,0,0,0,0,False,False,False,0,2,2021-12-27T12:42:59.823,0,False,0.0
2021,16,3297,370,3,6454,2,17,8,19,28,9,28,0,28,0,False,False,False,0,3,2021-12-28T21:20:54.87,28,False,0.0
2021,16,3297,380,3,6935,13,12,5,11,0,0,0,0,0,0,False,False,False,0,2,2022-02-24T19:46:07.913,0,False,
2021,16,3297,410,7,2631,2,46,5,1,11,10,11,0,11,0,True,False,False,0,4,2021-12-28T20:30:44.673,11,False,0.0
2021,16,3297,415,7,8317,2,4,10,4,15,11,15,0,15,0,False,False,False,0,3,2021-12-27T12:50:35.52,15,False,0.0
2021,16,3297,430,7,4455,2,28,10,0,3,3,1,2,1,0,False,False,False,0,1,2021-12-29T20:53:30.45,3,False,2.0
2021,16,3297,440,7,7659,2,19,6,49,52,3,52,0,52,0,False,False,False,0,2,2021-12-27T12:53:57.723,52,False,0.0
2021,16,3297,445,7,7659,3,2,10,1,0,0,0,0,0,0,False,False,False,0,2,2021-12-27T12:55:13.913,0,False,0.0
2021,16,3297,450,7,8317,13,7,5,3,0,0,0,0,0,0,False,False,False,0,2,2021-12-27T12:57:44.247,0,False,
2021,16,3297,460,7,7659,2,26,3,1,1,0,1,0,1,6,True,False,False,0,3,2021-12-27T13:00:05.607,1,True,0.0
2021,16,3297,475,3,6454,2,4,10,4,11,7,8,3,8,0,False,False,False,0,4,2021-12-27T13:02:03.12,11,False,3.0
2021,16,3297,490,3,6936,2,4,5,3,11,8,11,0,11,0,False,False,False,0,2,2021-12-27T13:03:41.847,11,True,0.0
2021,16,3297,505,3,6454,2,4,5,4,4,0,4,0,4,0,False,False,False,0,3,2021-12-27T13:51:08.793,4,False,0.0
2021,16,3297,510,3,6936,13,21,2,34,0,0,0,0,0,0,False,False,False,0,2,2021-12-27T13:51:57.717,0,False,0.0
2021,16,3297,515,3,7673,2,26,9,3,7,4,7,0,7,0,False,False,False,0,3,2021-12-27T13:53:07.84,7,False,0.0
2021,16,3297,525,3,306,2,4,4,2,12,10,10,2,10,0,False,False,False,0,1,2021-12-27T13:54:54.657,12,False,2.0
2021,16,3297,540,3,6936,13,2,10,5,0,0,0,0,0,0,False,False,False,0,2,2021-12-27T13:56:45.5,0,False,0.0
2021,16,3297,560,7,3521,13,5,10,5,0,0,0,0,0,0,True,False,False,0,3,2021-12-28T20:31:14.147,0,False,0.0
2021,16,3297,575,7,8317,2,6,10,13,19,6,17,2,17,0,False,False,False,0,2,2021-12-29T20:57:35.16,19,False,2.0
2021,16,3297,580,7,4679,2,44,3,-2,2,4,0,2,0,0,False,False,False,0,1,2021-12-27T14:08:16.513,2,False,
2021,16,3297,585,7,4679,2,46,9,-1,3,4,1,2,1,0,True,False,False,0,1,2021-12-28T20:31:52.753,3,False,2.0
2021,16,3297,590,7,8317,2,4,3,4,18,14,7,11,7,0,False,False,False,0,2,2021-12-27T14:10:55.233,18,False,11.0
2021,16,3297,600,7,7659,2,5,5,8,9,1,9,0,9,0,False,False,False,0,3,2021-12-29T21:03:40.537,9,False,0.0
2021,16,3297,610,7,4455,2,45,5,-5,3,8,3,0,3,0,False,False,False,0,1,2021-12-27T14:16:21.017,3,False,0.0
2021,16,3297,615,7,8317,13,2,10,9,0,0,0,0,0,0,False,False,False,0,2,2021-12-27T14:17:15.533,0,False,0.0
2021,16,3297,620,7,7659,2,3,3,10,13,3,7,6,7,0,False,False,False,1,2,2022-02-17T20:41:09.94,13,False,6.0
2021,16,3297,630,7,2631,2,30,10,1,2,1,1,1,1,0,True,False,False,0,4,2021-12-28T20:32:17.837,2,False,1.0
2021,16,3297,640,7,3521,2,4,10,5,5,0,5,0,5,0,False,False,False,0,3,2021-12-29T20:59:44.22,5,False,0.0
2021,16,3297,650,7,2631,3,2,9,5,0,0,0,0,0,0,False,False,False,0,3,2021-12-27T14:23:56.717,0,False,0.0
2021,16,3297,670,3,7673,2,12,1,17,17,0,17,0,17,0,False,False,False,0,3,2021-12-28T21:21:22.65,17,False,0.0
2021,16,3297,675,3,6454,3,17,1,18,0,0,0,0,0,0,False,False,False,0,3,2021-12-27T14:31:36.04,0,False,0.0
2021,16,3297,680,3,6454,2,11,2,25,25,0,25,0,25,0,False,False,False,0,4,2021-12-27T14:32:53.097,25,False,0.0
2021,16,3297,690,3,6454,2,35,6,15,18,3,16,2,16,6,False,False,False,0,4,2021-12-27T14:34:26.003,18,False,2.0
2021,16,3297,705,7,8317,2,4,3,3,14,11,11,3,11,0,False,False,False,1,2,2021-12-27T14:40:33.75,14,False,3.0
2021,16,3297,710,7,7659,2,6,4,12,13,1,13,0,13,0,False,False,False,0,2,2021-12-27T14:41:22.477,13,False,0.0
2021,16,3297,715,7,4679,2,45,5,-5,0,5,-3,3,-3,0,False,False,False,0,1,2021-12-27T14:42:18.61,0,False,3.0
2021,16,3297,720,7,3521,2,51,9,-1,12,13,9,3,9,0,False,False,False,0,3,2021-12-27T14:43:20.003,12,False,3.0
2021,16,3297,725,7,2631,2,4,9,4,4,0,4,0,4,0,False,False,False,0,3,2021-12-27T14:44:39.1,4,False,0.0
2021,16,3297,730,7,8317,2,6,10,5,22,17,21,1,21,0,False,False,False,2,3,2021-12-27T14:45:37.23,22,False,1.0
2021,16,3297,740,7,2631,2,46,3,0,3,3,1,2,1,0,False,False,False,1,4,2021-12-27T14:46:43.737,3,False,2.0
2021,16,3297,745,7,7659,2,2,10,10,10,0,10,0,10,6,False,False,False,0,2,2021-12-27T14:47:31.203,10,True,0.0
2021,16,3297,760,3,6936,13,12,10,13,0,0,0,0,0,0,False,False,False,0,4,2021-12-29T21:10:12.08,0,False,
2021,16,3297,765,3,7673,2,5,3,6,14,8,12,2,12,0,False,False,False,0,3,2021-12-29T17:15:38.027,14,False,2.0
2021,16,3297,770,3,713,2,28,9,2,4,2,4,0,4,0,False,False,False,0,1,2021-12-29T21:03:16.783,4,False,0.0
2021,16,3297,790,7,8317,13,6,9,11,0,0,0,0,0,0,False,False,False,0,2,2021-12-27T15:34:24.253,0,False,0.0
2021,16,3297,795,7,7659,2,4,5,12,20,8,17,3,17,0,False,False,False,0,2,2021-12-27T15:35:30.007,20,False,3.0
2021,16,3297,805,7,3521,13,12,7,32,0,0,0,0,0,0,False,False,False,0,3,2021-12-27T15:37:50.733,0,True,0.0
2021,16,3297,810,7,8317,13,12,8,29,0,0,0,0,0,0,False,False,False,0,2,2021-12-29T20:55:32.143,0,False,0.0
2021,16,3297,820,3,7673,2,4,10,6,6,0,6,0,6,0,False,False,False,0,3,2021-12-27T15:40:53.01,6,False,0.0
2021,16,3297,825,3,7673,2,2,9,7,7,0,7,0,7,0,False,False,False,0,3,2021-12-27T15:41:38.587,7,False,0.0
2021,16,3297,830,3,6936,2,13,10,2,14,12,14,0,14,0,False,False,False,0,2,2021-12-27T15:42:36.367,14,False,0.0
2021,16,3297,835,3,6936,2,4,10,3,5,2,5,0,5,0,False,False,False,0,3,2021-12-27T15:43:44.753,5,False,0.0
2021,16,3297,840,3,8434,13,6,10,5,0,0,0,0,0,0,False,False,False,0,3,2021-12-27T15:44:37.617,0,False,0.0
2021,16,3297,850,3,7673,13,2,4,7,0,0,0,0,0,0,False,False,False,0,3,2021-12-27T15:45:44.833,0,False,0.0
2021,16,3297,860,7,6975,2,47,5,0,4,4,2,2,2,0,False,False,False,0,4,2021-12-27T15:47:24.933,4,False,2.0
2021,16,3297,870,7,4679,2,19,2,48,52,4,52,0,52,0,False,False,False,0,2,2021-12-27T15:48:30.997,52,False,0.0
2021,16,3298,15,27,7408,13,2,9,6,0,0,0,0,0,0,False,False,False,0,2,2021-12-27T10:19:51.143,0,False,0.0
2021,16,3298,35,6,7728,2,47,5,2,4,2,4,0,4,0,False,False,False,0,4,2021-12-27T10:26:33.973,4,False,0.0
2021,16,3298,45,6,7725,13,4,10,7,0,0,0,0,0,0,True,False,False,0,3,2021-12-27T10:34:47.337,0,False,0.0
2021,16,3298,60,27,650,2,51,3,-1,7,8,7,0,7,0,False,False,False,0,3,2021-12-27T10:42:23.88,7,True,0.0
2021,16,3298,85,27,7408,2,19,2,31,41,10,41,0,41,6,False,False,False,0,2,2021-12-29T22:29:39.333,41,True,0.0
2021,16,3298,105,6,7725,2,51,9,-6,1,7,0,1,0,0,True,False,False,0,2,2021-12-27T10:53:22.007,1,False,1.0
2021,16,3298,110,6,3233,13,4,9,5,0,0,0,0,0,0,False,False,False,0,2,2021-12-27T10:55:25.95,0,False,0.0
2021,16,3298,115,6,8366,2,26,5,5,10,5,5,5,5,0,False,False,False,1,2,2021-12-27T10:57:44.68,10,False,5.0
2021,16,3298,120,6,6786,2,48,10,-6,0,6,-2,2,-2,0,False,False,False,0,1,2021-12-27T10:59:22.95,0,False,2.0
2021,16,3298,130,6,1378,2,39,4,7,8,1,7,1,7,0,False,False,False,0,3,2021-12-29T22:24:18.813,8,False,1.0
2021,16,3298,145,6,7725,13,19,2,26,0,0,0,0,0,0,False,False,False,0,3,2021-12-27T11:07:38.42,0,False,
2021,16,3298,170,6,3233,13,12,5,4,0,0,0,0,0,0,True,False,False,0,3,2021-12-27T11:19:06.073,0,False,0.0
2021,16,3298,175,6,6786,2,47,5,2,2,0,2,0,2,0,False,False,False,0,1,2021-12-27T11:20:29.33,2,False,0.0
2021,16,3298,190,27,7408,2,18,3,0,0,0,0,0,0,0,False,False,False,0,2,2021-12-27T11:28:40.19,0,False,0.0
2021,16,3298,200,27,7408,13,9,6,25,0,0,0,0,0,0,False,False,False,0,2,2021-12-29T21:22:56.777,0,False,0.0
2021,16,3298,215,6,1378,2,4,5,7,15,8,15,0,15,0,False,False,False,0,2,2021-12-27T11:36:11.83,15,False,0.0
2021,16,3298,225,6,6786,2,12,10,8,9,1,8,1,8,0,False,False,False,0,2,2021-12-27T11:40:58.43,9,False,1.0
2021,16,3298,260,27,4850,2,47,5,3,9,6,9,0,9,0,False,False,False,0,3,2021-12-29T22:29:59.303,9,False,0.0
2021,16,3298,265,27,650,2,5,5,5,8,3,8,0,8,0,False,False,False,0,3,2021-12-27T11:52:13.97,8,False,0.0
2021,16,3298,270,27,4850,13,19,3,12,0,0,0,0,0,0,False,False,False,0,2,2021-12-27T11:54:42.44,0,False,0.0
2021,16,3298,275,27,4850,2,26,10,5,9,4,9,0,9,0,False,False,False,0,3,2021-12-28T22:44:19.503,9,False,0.0
2021,16,3298,300,27,7849,13,17,1,18,0,0,0,0,0,0,False,False,False,0,4,2021-12-27T12:05:57.447,0,False,0.0
2021,16,3298,305,27,8472,2,34,4,-4,13,17,10,3,10,0,True,False,False,0,3,2021-12-27T12:07:46.853,13,False,3.0
2021,16,3298,330,6,6786,13,5,5,2,0,0,0,0,0,0,False,False,False,0,1,2021-12-27T12:19:36.007,0,False,0.0
2021,16,3298,335,6,7728,2,12,9,4,15,11,13,2,13,0,False,False,False,0,4,2022-02-24T19:47:55.19,15,False,2.0
2021,16,3298,340,6,7725,13,35,6,24,0,0,0,0,0,0,False,False,False,0,3,2021-12-27T12:26:19.49,0,False,0.0
2021,16,3298,360,6,8365,2,32,10,-2,7,9,6,1,6,0,False,False,False,0,3,2021-12-27T12:34:44.39,7,False,1.0
2021,16,3298,370,27,7850,2,12,5,2,13,11,13,0,13,0,False,False,False,0,1,2021-12-27T12:38:19.99,13,False,0.0
2021,16,3298,380,27,4850,2,5,5,11,26,15,26,0,26,0,False,False,False,0,3,2021-12-29T22:25:09.09,26,True,0.0
2021,16,3298,385,27,7850,2,48,10,-4,3,7,0,3,0,0,True,False,False,0,1,2021-12-27T12:42:43.02,3,False,3.0
2021,16,3298,395,27,8472,13,9,6,20,0,0,0,0,0,0,False,False,False,0,2,2021-12-27T12:45:22.68,0,False,0.0
2021,16,3298,400,27,7850,2,32,5,0,3,3,3,0,3,0,True,False,False,0,3,2021-12-29T22:30:21.87,3,False,0.0
2021,16,3298,450,6,8366,13,13,9,1,0,0,0,0,0,0,False,False,False,0,3,2021-12-27T13:17:30.317,0,False,0.0
2021,16,3298,460,27,650,13,7,6,42,0,0,0,0,0,0,False,False,False,0,3,2021-12-27T13:20:29.29,0,False,0.0
2021,16,3298,470,27,7408,13,5,9,5,0,0,0,0,0,0,False,False,False,0,3,2021-12-27T13:23:19.25,0,False,0.0
2021,16,3298,480,6,1378,13,19,6,35,0,0,0,0,0,0,False,False,False,0,3,2021-12-27T13:26:39.443,0,False,
2021,16,3298,490,6,7725,2,26,10,-2,5,7,3,2,3,0,False,False,False,0,3,2022-02-16T19:19:39.987,5,False,2.0
2021,16,3298,505,6,6786,2,48,10,-6,16,22,16,0,16,0,False,False,False,0,1,2021-12-27T13:36:12.82,16,False,0.0
2021,16,3298,515,6,7725,13,21,6,24,0,0,0,0,0,0,False,False,False,0,3,2021-12-27T13:39:48.79,0,False,0.0
2021,16,3298,525,6,1400,2,48,4,-2,2,4,0,2,0,0,False,False,False,0,1,2021-12-27T13:42:15.14,2,False,2.0
2021,16,3298,560,27,4850,2,7,2,21,24,3,24,0,24,6,False,False,False,0,4,2021-12-27T13:54:02.373,24,True,0.0
2021,16,3298,575,6,666,2,4,9,5,15,10,11,4,11,0,False,False,False,0,4,2021-12-27T13:57:04.723,15,False,4.0
2021,16,3298,580,6,7725,2,2,4,8,16,8,13,3,13,0,False,False,False,0,3,2021-12-27T13:59:04.06,16,False,3.0
2021,16,3298,585,6,6786,2,4,4,3,10,7,5,5,5,0,False,False,False,1,1,2021-12-27T14:00:52.39,10,False,5.0
2021,16,3298,595,6,7728,2,47,10,0,16,16,1,15,1,0,True,False,False,1,1,2021-12-27T14:05:33.703,16,False,15.0
2021,16,3298,610,6,7728,2,4,4,14,14,0,14,0,14,0,False,False,False,0,3,2021-12-27T14:17:00.27,14,False,0.0
2021,16,3298,640,6,6786,3,4,3,6,0,0,0,0,0,0,False,False,False,0,2,2022-02-16T19:23:47.117,0,False,0.0
2021,16,3298,660,27,5226,13,28,10,0,0,0,0,0,0,0,False,False,False,0,1,2021-12-27T14:36:13.94,0,False,0.0
2021,16,3298,690,6,3233,2,2,9,7,11,4,11,0,11,0,False,False,False,0,2,2021-12-27T14:49:26.743,11,False,0.0
2021,16,3298,700,6,7725,2,4,9,4,5,1,5,0,5,0,False,False,False,0,3,2021-12-27T14:54:41.313,5,False,0.0
2021,16,3298,705,6,7725,13,4,3,6,0,0,0,0,0,0,False,False,False,0,2,2021-12-27T14:57:19.087,0,False,0.0
2021,16,3298,710,6,1400,13,12,6,23,0,0,0,0,0,0,False,False,False,0,1,2021-12-27T14:59:46.33,0,False,0.0
2021,16,3298,720,27,7852,2,5,5,4,9,5,9,0,9,0,True,False,False,0,3,2021-12-27T15:04:04.51,9,False,0.0
2021,16,3298,735,27,8472,2,34,4,-5,-3,2,-5,2,-5,0,True,False,False,0,3,2021-12-29T22:27:31.197,-3,False,2.0
2021,16,3298,745,27,7852,13,2,10,9,0,0,0,0,0,0,False,False,False,0,2,2021-12-27T15:14:15.79,0,False,0.0
2021,16,3298,760,6,7725,2,4,4,12,30,18,14,16,14,0,False,False,False,2,3,2021-12-29T22:27:40.823,30,False,16.0
2021,16,3298,765,6,6786,2,44,9,-3,10,13,5,5,5,0,True,False,False,1,1,2021-12-29T22:27:50.107,10,False,5.0
2021,16,3298,770,6,6786,2,16,9,2,14,12,13,1,13,0,False,False,False,0,1,2021-12-27T15:23:50.2,14,False,1.0
2021,16,3298,785,6,7728,13,17,1,15,0,0,0,0,0,0,False,False,False,0,3,2021-12-27T15:35:48.677,0,False,0.0
2021,16,3298,790,6,666,2,9,6,15,15,0,15,0,15,6,False,False,False,0,2,2021-12-27T15:37:50.76,15,True,0.0
2021,16,3298,805,27,7850,2,45,10,-6,4,10,4,0,4,0,False,False,False,0,1,2021-12-27T15:40:24.513,4,True,0.0
2021,16,3298,820,27,650,13,5,5,11,0,0,0,0,0,0,False,False,False,0,2,2021-12-27T15:43:43.07,0,False,0.0
2021,16,3298,825,27,650,2,4,5,10,15,5,13,2,13,0,False,False,False,1,2,2021-12-27T15:45:35.473,15,False,2.0
2021,16,3298,845,27,650,13,35,5,9,0,0,0,0,0,0,False,False,False,0,3,2021-12-27T15:51:21.47,0,False,0.0
2021,16,3299,15,25,7060,2,9,5,14,18,4,15,3,15,0,False,False,False,0,2,2021-12-27T10:24:13.133,18,False,3.0
2021,16,3299,25,25,6486,13,12,6,15,0,0,0,0,0,0,False,False,False,0,3,2021-12-27T10:27:19.433,0,False,0.0
2021,16,3299,50,16,3938,2,4,9,10,10,0,10,0,10,0,False,False,False,0,3,2021-12-27T10:34:42.88,10,False,0.0
2021,16,3299,55,16,6500,2,26,4,3,11,8,8,3,8,0,False,False,False,0,3,2021-12-27T10:35:49.97,11,False,3.0
2021,16,3299,60,16,2568,2,6,10,11,11,0,11,0,11,0,False,False,False,1,3,2021-12-27T10:38:10.93,11,False,0.0
2021,16,3299,70,16,3938,2,5,5,4,9,5,9,0,9,0,False,False,False,0,2,2021-12-27T10:39:57.39,9,True,0.0
2021,16,3299,75,16,6499,2,4,4,5,13,8,7,6,7,0,False,False,False,0,1,2021-12-27T10:41:50.62,13,False,6.0
2021,16,3299,80,16,6499,2,45,5,-5,-1,4,-1,0,-1,0,False,False,False,0,1,2021-12-27T10:42:53.897,-1,False,0.0
2021,16,3299,85,16,7176,13,2,4,7,0,0,0,0,0,0,True,False,False,0,3,2021-12-30T01:58:30.653,0,False,0.0
2021,16,3299,90,16,6499,13,9,3,13,0,0,0,0,0,0,False,False,False,0,2,2021-12-27T10:45:49.77,0,False,
2021,16,3299,95,16,8537,2,26,10,4,5,1,4,1,4,0,False,False,False,0,3,2021-12-30T02:00:06.533,5,False,1.0
2021,16,3299,125,25,6259,13,19,2,24,0,0,0,0,0,0,False,False,False,0,3,2021-12-30T02:05:11.987,0,False,0.0
2021,16,3299,135,16,6500,13,35,7,20,0,0,0,0,0,0,False,False,False,0,3,2021-12-27T11:14:32.56,0,False,0.0
2021,16,3299,145,16,6500,2,5,5,10,18,8,17,1,17,0,False,False,False,0,3,2021-12-27T12:04:44.183,18,False,1.0
2021,16,3299,155,16,6499,2,46,3,-1,18,19,17,1,17,0,False,False,False,0,1,2021-12-27T11:20:28.98,18,False,1.0
2021,16,3299,160,16,6500,2,12,9,5,5,0,5,0,5,6,False,False,False,0,4,2021-12-27T11:22:32.52,5,True,0.0
2021,16,3299,180,25,7060,2,50,10,-1,9,10,2,7,2,0,False,False,False,0,2,2021-12-27T11:25:54.08,9,False,7.0
2021,16,3299,190,25,8421,2,47,5,0,5,5,4,1,4,0,False,False,False,0,1,2021-12-27T11:27:01.983,5,False,1.0
2021,16,3299,200,25,6259,13,4,10,3,0,0,0,0,0,0,False,False,False,0,3,2021-12-27T11:29:15.067,0,False,0.0
2021,16,3299,215,16,8537,2,4,4,5,7,2,6,1,6,0,False,False,False,0,4,2021-12-27T12:01:10.677,7,False,1.0
2021,16,3299,230,16,6500,2,4,4,3,3,0,3,0,3,0,False,False,False,0,3,2021-12-27T12:06:05.61,3,False,0.0
2021,16,3299,235,16,7176,2,13,10,3,14,11,12,2,12,0,False,False,False,0,3,2021-12-27T12:15:25.497,14,False,2.0
2021,16,3299,240,16,1989,13,7,6,23,0,0,0,0,0,0,False,False,False,0,4,2021-12-27T12:17:26.55,0,False,0.0
2021,16,3299,250,16,1989,3,12,2,17,0,0,0,0,0,0,False,False,False,0,2,2021-12-27T12:20:33.373,0,False,0.0
2021,16,3299,275,25,6259,2,51,5,-3,-3,0,-3,0,-3,0,False,False,False,0,3,2021-12-27T12:24:23.443,-3,False,0.0
2021,16,3299,280,25,7666,2,17,7,21,24,3,24,0,24,0,False,False,False,0,3,2021-12-27T12:26:05.72,24,False,0.0
2021,16,3299,285,25,7666,2,29,3,8,10,2,8,2,8,0,False,False,False,0,2,2021-12-27T12:27:22.09,10,False,2.0
2021,16,3299,290,25,6259,13,2,4,5,0,0,0,0,0,0,False,False,False,0,3,2021-12-27T12:28:26.017,0,False,0.0
2021,16,3299,295,25,7060,13,13,10,3,0,0,0,0,0,0,False,False,False,0,2,2021-12-27T12:29:23.277,0,False,0.0
2021,16,3299,300,25,8421,2,50,10,-3,0,3,-1,1,-1,0,False,False,False,1,2,2021-12-27T12:30:52.637,0,False,1.0
2021,16,3299,310,16,7417,2,44,3,-3,8,11,4,4,4,0,False,False,False,1,1,2021-12-27T12:43:06.687,8,False,4.0
2021,16,3299,325,16,7417,2,12,2,30,50,20,38,12,38,0,False,False,False,0,2,2021-12-27T12:49:58.66,50,False,12.0
2021,16,3299,330,16,7417,2,47,5,-1,3,4,2,1,2,0,False,False,False,0,1,2021-12-27T12:52:11.9,3,False,1.0
2021,16,3299,340,16,7176,2,51,9,-3,8,11,7,1,7,6,False,False,False,1,3,2021-12-27T12:54:32.81,8,False,1.0
2021,16,3299,365,25,8421,2,44,3,-3,1,4,0,1,0,0,False,False,False,0,1,2021-12-30T02:05:47.94,1,False,1.0
2021,16,3299,370,25,6259,2,13,9,3,3,0,3,0,3,0,False,False,False,0,3,2021-12-27T12:59:23.73,3,False,0.0
2021,16,3299,385,16,4143,2,4,10,10,9,-1,9,0,9,0,False,False,False,0,2,2021-12-27T13:01:41.407,9,False,0.0
2021,16,3299,410,16,7681,2,44,3,-4,4,8,2,2,2,0,False,False,False,0,1,2021-12-30T02:06:09.363,4,False,2.0
2021,16,3299,415,16,1989,13,12,2,21,0,0,0,0,0,0,False,False,False,0,2,2021-12-27T13:07:33.343,0,False,0.0
2021,16,3299,425,25,8421,2,5,10,1,5,4,2,3,2,0,False,False,False,1,1,2021-12-27T13:10:32.177,5,False,3.0
2021,16,3299,435,25,7053,2,39,4,7,10,3,7,3,7,0,False,False,False,0,4,2021-12-27T13:11:51.58,10,False,3.0
2021,16,3299,445,25,8421,2,28,4,-4,6,10,0,6,0,0,False,False,False,0,1,2021-12-30T02:00:45.17,6,False,6.0
2021,16,3299,475,16,7176,13,8,7,29,0,0,0,0,0,0,False,False,False,0,2,2021-12-30T02:07:47.45,0,False,0.0
2021,16,3299,490,25,7060,2,26,9,-1,2,3,2,0,2,0,False,True,True,0,2,2021-12-27T13:50:33.477,2,False,0.0
2021,16,3299,500,16,4143,2,4,9,2,6,4,3,3,3,0,False,False,False,0,2,2021-12-27T14:00:09.347,6,False,3.0
2021,16,3299,510,16,7176,2,51,10,-2,9,11,-1,10,-1,0,False,False,False,0,3,2021-12-27T14:02:03.723,9,False,10.0
2021,16,3299,525,16,6500,2,2,9,7,16,9,8,8,8,6,False,False,False,3,2,2021-12-30T02:01:47.473,16,False,8.0
2021,16,3299,545,25,6259,2,2,9,5,17,12,16,1,16,0,False,False,False,0,3,2021-12-27T14:22:34.913,17,False,1.0
2021,16,3299,560,25,7666,2,12,3,4,4,0,4,0,4,0,False,False,False,0,2,2021-12-27T14:25:26.387,4,True,0.0
2021,16,3299,575,25,7060,3,8,10,12,0,0,0,0,0,0,False,False,False,0,2,2021-12-27T14:29:59.937,0,False,
2021,16,3299,580,25,6259,2,5,5,8,8,0,8,0,8,0,False,False,False,0,3,2021-12-27T14:32:19.857,8,False,0.0
2021,16,3299,590,25,7666,13,9,2,17,0,0,0,0,0,0,False,False,False,0,2,2021-12-27T14:35:03.017,0,False,0.0
2021,16,3299,595,25,8421,13,5,10,0,0,0,0,0,0,0,False,False,False,0,1,2021-12-27T14:36:35.187,0,False,0.0
2021,16,3299,600,25,7666,13,19,6,26,0,0,0,0,0,0,False,False,False,0,3,2021-12-27T14:37:37.067,0,False,
2021,16,3299,605,25,7060,13,5,3,6,0,0,0,0,0,0,False,False,False,0,3,2021-12-27T14:40:21.443,0,False,0.0
2021,16,3299,610,25,6259,13,5,5,8,0,0,0,0,0,0,False,False,False,0,3,2021-12-27T14:42:09.01,0,False,0.0
2021,16,3299,615,25,8421,13,24,3,11,0,0,0,0,0,0,False,False,False,0,1,2021-12-27T14:43:55.64,0,False,0.0
2021,16,3299,675,16,6500,2,29,2,21,22,1,22,0,22,0,False,False,False,0,3,2021-12-27T15:28:10.293,22,True,0.0
2021,16,3299,760,25,7060,2,5,5,2,2,0,2,0,2,0,False,False,False,0,2,2021-12-27T15:43:39.477,2,False,0.0
2021,16,3299,770,25,7060,2,2,10,4,5,1,4,1,4,0,False,False,False,0,2,2021-12-27T15:45:17.887,5,False,1.0
2021,16,3299,775,25,7666,3,2,9,4,0,0,0,0,0,0,False,False,False,0,2,2021-12-27T15:46:59.19,0,False,0.0
2021,16,3299,780,25,7984,2,26,4,1,6,5,5,1,5,0,False,False,False,0,3,2021-12-27T15:48:01.327,6,False,1.0
2021,16,3299,785,25,7984,2,47,5,1,6,5,5,1,5,0,False,False,False,0,3,2021-12-27T15:48:59.087,6,False,1.0
2021,16,3299,800,25,7060,13,19,8,21,0,0,0,0,0,0,False,False,False,0,2,2021-12-27T15:51:15.693,0,False,0.0
2021,16,3299,805,25,7053,2,47,5,0,3,3,2,1,2,0,False,False,False,0,4,2021-12-27T15:52:19.497,3,False,1.0
2021,16,3299,810,25,7666,2,13,9,3,3,0,3,0,3,0,False,False,False,0,3,2021-12-27T15:53:27.037,3,False,0.0
2021,16,3299,815,25,7060,2,2,9,2,15,13,15,0,15,6,False,False,False,1,2,2021-12-27T15:55:20.58,15,True,0.0
2021,16,3299,865,25,7073,2,32,3,6,7,1,7,0,7,0,False,False,False,0,4,2021-12-27T16:02:21.14,7,False,0.0
2021,16,3299,875,25,7984,2,26,10,2,4,2,3,1,3,0,False,False,False,0,3,2021-12-27T16:04:03.807,4,False,1.0
2021,16,3299,880,25,7073,13,6,9,5,0,0,0,0,0,0,False,False,False,0,4,2021-12-27T16:05:42.403,0,False,0.0
2021,16,3299,890,25,6486,13,12,5,10,0,0,0,0,0,0,False,False,False,0,2,2021-12-27T16:09:37.36,0,False,0.0
2021,16,3299,895,25,7081,2,32,5,-4,6,10,6,0,6,0,False,False,False,0,1,2021-12-27T16:09:28.96,6,True,0.0
2021,16,3299,905,25,7053,2,6,9,6,6,0,6,0,6,0,False,False,False,0,4,2021-12-27T16:11:53.837,6,False,0.0
2021,16,3299,915,25,7053,2,4,10,5,12,7,10,2,10,0,False,False,False,0,4,2021-12-27T16:13:19.083,12,False,2.0
2021,16,3300,15,10,6281,2,4,10,5,5,0,5,0,5,0,False,False,False,0,3,2021-12-27T10:15:05.887,5,False,0.0
2021,16,3300,25,10,6281,13,35,2,28,0,0,0,0,0,0,False,False,False,0,2,2021-12-27T10:19:48.477,0,False,0.0
2021,16,3300,35,10,6840,2,13,5,2,2,0,2,0,2,0,False,False,False,0,4,2021-12-27T10:23:39.78,2,False,0.0
2021,16,3300,45,23,967,2,4,3,4,8,4,6,2,6,0,False,False,False,0,2,2021-12-27T10:29:25.963,8,False,2.0
2021,16,3300,55,23,967,2,4,5,4,5,1,5,0,5,0,False,False,False,0,2,2021-12-27T10:33:49.077,5,False,0.0
2021,16,3300,60,23,7246,2,38,9,2,16,14,8,8,8,0,False,False,False,0,3,2021-12-27T10:38:50.077,16,False,8.0
2021,16,3300,65,23,4949,13,35,10,10,0,0,0,0,0,0,False,False,False,0,3,2021-12-29T14:46:16.48,0,False,0.0
2021,16,3300,70,23,7250,2,35,9,14,18,4,18,0,18,0,False,False,False,0,3,2021-12-27T10:40:29.407,18,False,0.0
2021,16,3300,85,23,4949,13,13,3,5,0,0,0,0,0,0,False,False,False,0,3,2021-12-29T15:36:07.81,0,False,0.0
2021,16,3300,100,10,8541,2,5,4,2,7,5,2,5,2,0,False,False,False,1,1,2021-12-27T10:48:55.983,7,False,5.0
2021,16,3300,110,10,7703,13,8,2,27,0,0,0,0,0,0,False,False,False,0,4,2021-12-27T10:52:59.813,0,False,0.0
2021,16,3300,115,10,7700,13,7,6,17,0,0,0,0,0,0,False,False,False,0,3,2021-12-28T16:54:06.993,0,False,
2021,16,3300,130,10,8541,2,48,10,-8,1,9,-2,3,-2,0,False,False,False,0,1,2021-12-27T11:00:04.627,1,False,3.0
2021,16,3300,145,23,967,13,6,9,7,0,0,0,0,0,0,False,False,False,0,2,2021-12-29T14:46:16.48,0,False,0.0
2021,16,3300,155,23,7241,13,28,3,-5,0,0,0,0,0,0,False,False,False,0,1,2022-02-16T17:49:58.523,0,False,0.0
2021,16,3300,165,23,4949,2,5,9,3,6,3,5,1,5,0,False,False,False,0,2,2021-12-27T11:13:22.273,6,False,1.0
2021,16,3300,170,23,4949,2,12,5,0,4,4,1,3,1,0,False,False,False,3,2,2022-03-11T18:24:37.437,4,False,3.0
2021,16,3300,195,23,3708,2,44,3,-6,0,6,0,0,0,0,False,False,False,0,1,2021-12-27T11:22:56.163,0,False,0.0
2021,16,3300,200,23,7246,13,5,5,11,0,0,0,0,0,0,False,False,False,0,3,2021-12-29T15:36:20.26,0,False,
2021,16,3300,205,23,4949,2,6,9,14,15,1,15,0,15,0,False,False,False,0,3,2021-12-27T15:03:49.103,15,False,0.0
2021,16,3300,215,23,7250,2,7,3,10,10,0,10,0,10,6,False,False,False,0,3,2021-12-27T11:30:10.443,10,False,0.0
2021,16,3300,230,10,7700,2,35,2,19,40,21,37,3,37,0,False,False,False,0,3,2021-12-27T11:32:34.417,40,False,3.0
2021,16,3300,235,10,8541,2,46,3,-3,11,14,-2,13,-2,0,True,False,False,2,3,2021-12-29T15:38:21.953,11,False,
2021,16,3300,250,10,282,2,45,5,-4,4,8,1,3,1,0,False,False,False,0,1,2021-12-29T15:36:29.403,4,False,3.0
2021,16,3300,255,10,7700,2,5,3,14,14,0,14,0,14,0,False,False,False,0,2,2021-12-27T11:44:42.01,14,False,0.0
2021,16,3300,270,23,7246,2,17,8,15,20,5,18,2,18,0,False,False,False,0,4,2021-12-29T15:44:58.027,20,False,2.0
2021,16,3300,280,23,7241,2,45,5,-5,-5,0,-5,0,-5,0,False,False,False,0,1,2021-12-27T11:50:44.803,-5,False,0.0
2021,16,3300,285,23,3843,2,32,9,1,5,4,5,0,5,0,False,False,False,0,1,2021-12-29T15:36:38.61,5,False,0.0
2021,16,3300,295,10,4930,13,21,2,29,0,0,0,0,0,0,False,False,False,0,2,2021-12-29T15:36:52.083,0,False,0.0
2021,16,3300,305,10,7700,2,4,9,6,6,0,6,0,6,0,False,False,False,0,3,2021-12-27T12:02:58.57,6,False,0.0
2021,16,3300,315,23,4949,2,46,3,-3,7,10,3,4,3,0,True,False,False,0,3,2021-12-27T12:15:51.367,7,False,4.0
2021,16,3300,330,10,6281,2,4,3,8,8,0,8,0,8,0,False,False,False,0,2,2021-12-27T12:21:52.453,8,False,0.0
2021,16,3300,340,10,7700,3,12,5,11,0,0,0,0,0,0,False,False,False,0,3,2021-12-29T14:46:53.007,0,False,0.0
2021,16,3300,355,23,7241,13,48,9,-4,0,0,0,0,0,0,False,False,False,0,1,2021-12-29T15:37:57.033,0,False,0.0
2021,16,3300,405,23,967,2,5,3,7,13,6,13,0,13,0,False,False,False,0,2,2021-12-27T12:59:38.27,13,False,0.0
2021,16,3300,445,10,6840,2,24,2,19,20,1,20,0,20,0,False,False,False,0,4,2021-12-27T13:11:52.543,20,False,0.0
2021,16,3300,455,10,4930,2,5,5,5,5,0,5,0,5,0,True,False,False,0,3,2021-12-27T13:15:11.2,5,False,0.0
2021,16,3300,460,10,6840,13,13,9,2,0,0,0,0,0,0,False,False,False,0,4,2022-02-16T18:01:33.377,0,False,0.0
2021,16,3300,475,23,4949,2,2,10,11,12,1,12,0,12,0,False,False,False,0,2,2021-12-27T13:22:56.617,12,False,0.0
2021,16,3300,485,23,7250,2,2,10,11,12,1,12,0,12,0,False,False,False,0,3,2021-12-27T13:25:40.57,12,False,0.0
2021,16,3300,490,23,967,2,6,2,16,18,2,16,2,16,0,False,False,False,0,3,2021-12-27T13:31:36.01,18,False,2.0
2021,16,3300,515,10,4930,2,12,5,13,13,0,13,0,13,0,False,False,False,0,2,2021-12-29T14:47:05.01,13,True,0.0
2021,16,3300,530,10,6281,2,4,10,6,4,-2,4,0,4,0,False,False,False,0,2,2021-12-27T13:49:15.5,4,False,0.0
2021,16,3300,550,23,4949,2,5,3,6,6,0,6,0,6,0,False,False,False,0,3,2021-12-27T13:52:28.147,6,False,0.0
2021,16,3300,580,23,7246,2,47,5,1,3,2,1,2,1,0,False,False,False,0,4,2021-12-27T13:58:29.88,3,False,2.0
2021,16,3300,620,10,6840,2,4,9,5,8,3,6,2,6,0,False,False,False,0,4,2021-12-27T14:18:41.787,8,False,2.0
2021,16,3300,635,10,6281,2,35,10,14,16,2,16,0,16,0,False,False,False,0,3,2022-03-11T18:30:00.747,16,False,0.0
2021,16,3300,640,10,4930,3,5,5,5,0,0,0,0,0,0,True,False,False,0,3,2021-12-27T14:39:16.997,0,False,0.0
2021,16,3300,645,10,7703,3,7,2,27,0,0,0,0,0,0,False,False,False,0,4,2021-12-27T14:40:46.277,0,False,0.0
2021,16,3300,690,23,7246,2,7,8,17,28,11,23,5,23,0,False,False,False,0,4,2022-03-11T18:30:33.66,28,False,5.0
2021,16,3301,10,9,322,2,5,5,6,7,1,7,0,7,0,True,False,False,0,2,2021-12-29T23:03:28.647,7,False,0.0
2021,16,3301,35,9,6441,2,52,4,4,7,3,7,0,7,0,False,True,False,0,3,2021-12-29T21:16:11.543,6,False,0.0
2021,16,3301,45,32,7128,13,19,2,43,0,0,0,0,0,0,False,False,False,0,2,2022-02-16T16:15:03.837,0,False,0.0
2021,16,3301,60,9,322,2,5,5,5,5,0,5,0,5,0,False,False,False,0,3,2021-12-27T12:09:14.903,5,False,0.0
2021,16,3301,65,9,6446,2,5,9,5,10,5,7,3,7,0,False,False,False,0,4,2021-12-27T12:10:38.387,10,False,3.0
2021,16,3301,75,9,322,2,17,8,21,24,3,24,0,24,0,False,False,False,0,3,2021-12-27T13:03:53.093,24,False,0.0
2021,16,3301,85,9,6446,2,4,9,5,6,1,5,1,5,0,False,False,False,0,4,2021-12-27T12:19:24.427,6,False,1.0
2021,16,3301,90,9,4202,2,47,10,2,5,3,5,0,5,6,True,False,False,0,1,2021-12-27T12:20:52.833,5,True,0.0
2021,16,3301,110,32,8533,2,30,4,4,14,10,14,0,14,0,False,False,False,0,3,2021-12-29T23:21:48.937,14,True,0.0
2021,16,3301,120,32,7128,13,35,5,13,0,0,0,0,0,0,False,False,False,0,3,2022-02-16T16:15:55.507,0,False,0.0
2021,16,3301,140,9,7183,2,46,3,0,7,7,5,2,5,0,False,False,False,0,1,2021-12-27T12:36:37.917,7,False,2.0
2021,16,3301,145,9,7816,2,6,9,14,14,0,14,0,14,0,False,False,False,0,3,2021-12-27T17:29:41.557,14,False,0.0
2021,16,3301,150,9,7816,2,17,8,20,22,2,21,1,21,0,False,False,False,0,3,2021-12-27T13:04:45.633,22,False,1.0
2021,16,3301,155,9,6441,2,51,9,-4,4,8,2,2,2,0,False,False,False,0,3,2022-02-16T16:21:02.79,4,False,2.0
2021,16,3301,160,9,7183,13,4,5,9,0,0,0,0,0,0,True,False,False,0,2,2021-12-28T20:38:29.28,0,False,0.0
2021,16,3301,165,9,322,2,2,9,7,10,3,8,2,8,0,False,False,False,0,2,2021-12-27T12:45:33.157,10,False,2.0
2021,16,3301,170,9,6446,2,32,10,3,9,6,9,0,9,6,False,False,False,0,4,2021-12-27T17:27:39.733,9,True,0.0
2021,16,3301,190,32,7807,3,47,5,2,0,0,0,0,0,0,False,False,False,0,1,2021-12-28T18:39:02.547,0,False,0.0
2021,16,3301,195,32,3634,13,2,10,-3,0,0,0,0,0,0,False,False,False,0,2,2021-12-27T12:54:00.393,0,False,0.0
2021,16,3301,210,32,8527,2,8,1,45,48,3,45,3,45,0,False,False,False,0,2,2021-12-28T18:39:27.07,48,False,3.0
2021,16,3301,220,32,8528,13,17,9,13,0,0,0,0,0,0,False,False,False,0,4,2022-02-16T16:22:11.683,0,False,
2021,16,3301,235,32,2675,13,12,5,5,0,0,0,0,0,0,False,False,False,0,3,2021-12-27T13:08:23.987,0,False,0.0
2021,16,3301,240,32,7807,2,28,3,-3,8,11,5,3,5,6,False,False,False,0,1,2021-12-27T13:10:01.863,8,False,3.0
2021,16,3301,260,9,7816,2,4,9,5,5,0,5,0,5,0,False,False,False,0,3,2021-12-29T22:58:18.227,5,False,0.0
2021,16,3301,265,9,6436,2,12,2,28,40,12,39,1,39,0,False,False,False,0,2,2021-12-27T13:16:33.933,40,False,1.0
2021,16,3301,285,9,322,2,39,4,5,8,3,4,4,4,0,False,False,False,1,3,2021-12-29T23:07:27.52,8,False,4.0
2021,16,3301,310,32,3562,2,51,3,-5,9,14,9,0,9,0,True,False,False,0,1,2021-12-28T18:41:48.787,9,True,
2021,16,3301,330,32,3634,2,48,10,-5,2,7,-2,4,-2,0,False,False,False,0,1,2021-12-27T13:44:24.493,2,False,4.0
2021,16,3301,340,9,7183,2,47,10,2,9,7,7,2,7,0,False,False,False,0,1,2021-12-29T23:10:42.153,9,False,2.0
2021,16,3301,350,9,7816,2,35,2,21,25,4,23,2,23,0,False,False,False,0,3,2021-12-27T17:28:17.673,25,False,2.0
2021,16,3301,355,9,6446,2,17,10,13,16,3,14,2,14,0,False,False,False,0,3,2021-12-27T13:54:16.45,16,False,2.0
2021,16,3301,365,9,6436,2,2,9,10,13,3,10,3,10,0,False,False,False,0,2,2021-12-27T13:58:38.513,13,False,3.0
2021,16,3301,370,9,6436,13,29,5,4,0,0,0,0,0,0,False,False,False,0,2,2021-12-27T14:00:52.443,0,False,0.0
2021,16,3301,385,9,8246,2,32,10,1,1,0,1,0,1,6,False,False,False,0,4,2021-12-27T14:04:12.34,1,True,0.0
2021,16,3301,400,32,7807,2,16,10,7,21,14,19,2,19,0,False,False,False,0,1,2021-12-27T14:07:10.987,21,False,2.0
2021,16,3301,415,32,6430,13,5,3,7,0,0,0,0,0,0,False,False,False,0,3,2021-12-27T14:10:08.74,0,False,0.0
2021,16,3301,420,32,7128,13,19,2,31,0,0,0,0,0,0,False,False,False,0,3,2021-12-27T14:11:55.07,0,False,0.0
2021,16,3301,430,9,322,3,2,10,7,0,0,0,0,0,0,False,False,False,0,3,2021-12-27T14:14:30.253,0,False,0.0
2021,16,3301,435,9,322,2,7,6,18,18,0,18,0,18,0,False,False,False,0,2,2021-12-28T20:39:46.91,18,False,0.0
2021,16,3301,440,9,322,13,21,6,28,0,0,0,0,0,0,False,False,False,0,2,2021-12-29T21:16:11.56,0,False,0.0
2021,16,3301,445,9,6436,13,6,9,13,0,0,0,0,0,0,False,False,False,0,2,2022-02-17T20:52:43.223,0,False,0.0
2021,16,3301,450,9,6446,2,38,9,4,11,7,11,0,11,0,False,False,False,0,1,2021-12-27T14:22:42.967,11,False,0.0
2021,16,3301,465,9,6712,2,6,9,6,12,6,8,4,8,0,False,False,False,0,2,2021-12-29T22:58:30.993,12,False,4.0
2021,16,3301,470,9,6446,2,5,3,6,8,2,8,0,8,0,False,False,False,0,3,2021-12-29T22:58:45.427,8,True,0.0
2021,16,3301,475,9,6436,13,8,8,34,0,0,0,0,0,0,False,False,False,0,2,2021-12-27T14:29:55.457,0,False,0.0
2021,16,3301,480,9,6441,13,9,2,31,0,0,0,0,0,0,False,False,False,0,3,2021-12-27T14:32:24.487,0,False,0.0
2021,16,3301,485,9,6446,2,6,4,14,14,0,14,0,14,0,False,False,False,0,3,2021-12-29T23:12:29.283,14,False,0.0
2021,16,3301,490,9,322,2,5,3,13,13,0,13,0,13,6,False,False,False,0,3,2021-12-29T22:52:14.027,13,True,0.0
2021,16,3301,525,32,7807,13,5,5,5,0,0,0,0,0,0,True,False,False,0,3,2022-02-16T16:26:55.26,0,False,0.0
2021,16,3301,530,32,6430,13,12,2,15,0,0,0,0,0,0,False,False,False,0,2,2021-12-29T22:52:48.213,0,False,0.0
2021,16,3301,560,32,4788,2,26,5,-4,-4,0,-4,0,-4,0,True,False,False,0,4,2022-02-16T16:27:25.023,-4,False,0.0
2021,16,3301,570,32,2675,13,2,9,4,0,0,0,0,0,0,True,False,False,0,3,2021-12-27T15:18:29.82,0,False,0.0
2021,16,3301,580,9,322,3,4,10,14,0,0,0,0,0,0,True,False,False,0,3,2022-02-16T16:28:43.49,0,False,0.0
2021,16,3301,585,9,6446,2,30,9,-1,8,9,7,1,7,0,False,False,False,0,4,2021-12-29T23:20:07.363,8,False,1.0
2021,16,3301,595,9,322,13,19,2,40,0,0,0,0,0,0,False,False,False,0,2,2021-12-27T15:27:37.897,0,False,0.0
2021,16,3301,605,9,6446,13,6,4,12,0,0,0,0,0,0,False,False,False,0,3,2021-12-27T17:28:58.803,0,False,0.0
2021,16,3301,625,32,2675,13,4,5,10,0,0,0,0,0,0,False,False,False,0,3,2022-02-16T16:30:59.9,0,False,0.0
2021,16,3301,655,32,8528,2,5,5,7,32,25,13,19,13,0,False,False,False,2,3,2021-12-29T22:59:29.613,32,False,19.0
2021,16,3301,670,32,2675,13,35,2,25,0,0,0,0,0,0,False,False,False,0,2,2021-12-27T16:04:22.587,0,False,
2021,16,3301,680,32,2675,13,2,4,8,0,0,0,0,0,0,False,False,False,0,3,2021-12-27T16:08:29.563,0,False,0.0
2021,16,3301,695,9,6712,2,26,10,5,61,56,3,58,3,0,False,False,False,7,3,2021-12-29T23:00:31.643,61,False,58.0
2021,16,3301,710,9,6712,2,32,10,5,9,4,6,3,6,6,True,False,False,0,4,2021-12-27T16:21:47.71,9,False,3.0
2021,16,3301,730,32,7128,2,2,10,8,15,7,14,1,14,0,False,False,False,0,2,2021-12-27T16:27:25.55,15,False,1.0
2021,16,3301,745,32,3562,13,4,9,5,0,0,0,0,0,0,False,False,False,0,3,2021-12-27T17:18:29.303,0,False,0.0
2021,16,3301,760,9,7816,13,18,3,-2,0,0,0,0,0,0,False,False,False,0,2,2022-02-16T16:33:08.147,0,False,0.0
2021,16,3301,780,32,2675,2,51,5,-2,-2,0,-2,0,-2,0,True,False,False,0,3,2022-02-16T16:35:51.07,-2,False,0.0
2021,16,3301,785,32,7128,2,12,2,19,19,0,19,0,19,0,False,False,False,0,2,2021-12-29T22:57:47.86,19,False,0.0
2021,16,3301,795,32,8527,2,2,3,5,5,0,5,0,5,0,False,False,False,0,2,2021-12-27T16:46:52.86,5,False,0.0
2021,16,3301,805,32,6430,13,5,5,13,0,0,0,0,0,0,False,False,False,0,2,2021-12-29T22:58:00.03,0,False,0.0
2021,16,3301,815,32,3562,2,13,9,5,5,0,5,0,5,0,True,False,False,0,3,2021-12-27T17:17:15.377,5,False,0.0
2021,16,3301,820,32,2675,2,26,3,4,6,2,5,1,5,0,False,False,False,0,2,2021-12-27T17:17:29.677,6,False,1.0
2021,16,3301,825,32,7128,2,39,9,6,6,0,6,0,6,0,False,False,False,0,3,2021-12-27T17:17:44.207,6,False,0.0
2021,16,3301,830,32,8528,2,5,10,6,12,6,7,5,7,0,False,True,False,0,3,2021-12-29T18:31:38.147,13,False,5.0
2021,16,3302,10,17,6274,2,47,10,-1,4,5,2,2,2,0,False,False,False,0,4,2021-12-28T10:56:29.613,4,False,2.0
2021,16,3302,15,17,8483,2,5,9,4,4,0,4,0,4,0,False,False,False,0,3,2021-12-28T10:59:12.677,4,False,0.0
2021,16,3302,20,17,8483,2,30,10,-3,5,8,3,2,3,0,True,False,False,0,1,2021-12-28T11:01:51.733,5,False,2.0
2021,16,3302,35,17,7024,13,13,9,2,0,0,0,0,0,0,False,False,False,0,3,2021-12-28T11:07:40.557,0,False,0.0
2021,16,3302,50,20,6759,2,46,3,1,4,3,3,1,3,0,False,False,False,0,4,2021-12-28T11:14:05.857,4,False,1.0
2021,16,3302,55,20,7356,13,5,5,5,0,0,0,0,0,0,False,False,False,0,3,2022-02-16T18:08:47.013,0,False,0.0
2021,16,3302,70,20,3848,3,13,10,2,0,0,0,0,0,0,False,False,False,0,4,2021-12-28T11:20:37.017,0,False,0.0
2021,16,3302,95,17,8483,13,2,4,5,0,0,0,0,0,0,False,False,False,0,3,2021-12-28T11:30:54.18,0,False,
2021,16,3302,105,17,8483,2,50,10,-1,-1,0,-1,0,-1,0,False,False,False,0,3,2021-12-28T11:34:22.343,-1,False,0.0
2021,16,3302,110,17,8483,2,5,9,13,18,5,14,4,14,0,True,False,False,0,3,2021-12-28T11:37:39.04,18,False,4.0
2021,16,3302,115,17,6276,2,13,3,3,7,4,6,1,6,0,False,False,False,0,4,2021-12-28T11:39:23.173,7,False,1.0
2021,16,3302,135,17,6276,2,30,3,1,11,10,10,1,10,0,False,False,False,0,4,2022-01-01T18:38:31.307,11,False,1.0
2021,16,3302,140,17,3747,13,11,5,11,0,0,0,0,0,0,True,False,False,0,4,2021-12-28T11:51:38.563,0,False,0.0
2021,16,3302,145,17,6274,2,13,4,3,6,3,3,3,3,0,False,False,False,1,4,2021-12-28T11:53:31.613,6,False,3.0
2021,16,3302,195,17,3747,2,34,4,-4,7,11,6,1,6,0,True,False,False,0,2,2021-12-28T12:10:27.75,7,False,1.0
2021,16,3302,205,17,7024,2,44,3,-3,6,9,6,0,6,0,False,False,False,0,1,2021-12-28T12:13:53.057,6,False,0.0
2021,16,3302,220,20,8131,2,5,3,12,17,5,16,1,16,0,False,False,False,0,3,2021-12-28T12:18:46.37,17,False,1.0
2021,16,3302,225,20,7356,2,4,5,3,8,5,6,2,6,0,True,False,False,0,2,2021-12-28T12:20:36.64,8,False,2.0
2021,16,3302,255,17,8483,2,16,4,5,9,4,8,1,8,0,False,False,False,0,1,2021-12-28T12:30:03.77,9,False,
2021,16,3302,270,20,8131,2,13,4,2,11,9,3,8,3,0,False,False,False,1,3,2021-12-28T12:35:41.957,11,False,8.0
2021,16,3302,285,20,5140,2,30,9,-3,12,15,12,0,12,0,False,False,False,0,1,2021-12-28T12:40:56.953,12,True,0.0
2021,16,3302,340,17,8483,2,2,10,6,10,4,7,3,7,0,False,False,False,1,3,2021-12-28T12:55:49.717,10,False,3.0
2021,16,3302,350,17,8483,2,45,5,0,9,9,9,0,9,0,True,False,False,0,1,2021-12-28T12:58:12.747,9,True,0.0
2021,16,3302,355,17,8483,2,5,3,9,17,8,16,1,16,0,False,False,False,0,3,2021-12-28T12:59:38.323,17,False,1.0
2021,16,3302,365,17,2253,13,9,2,19,0,0,0,0,0,0,False,False,False,0,2,2021-12-28T13:02:14.743,0,False,
2021,16,3302,370,17,6276,2,6,4,13,13,0,13,0,13,0,False,False,False,0,3,2022-01-01T18:35:41.973,13,False,0.0
2021,16,3302,375,17,8483,13,19,6,30,0,0,0,0,0,0,False,False,False,0,2,2021-12-28T13:07:19.837,0,False,0.0
2021,16,3302,410,20,6759,2,30,10,1,4,3,3,1,3,0,False,False,False,0,4,2021-12-28T13:16:13.703,4,False,1.0
2021,16,3302,420,20,5140,13,4,9,4,0,0,0,0,0,0,False,False,False,0,3,2021-12-28T13:19:17.337,0,False,0.0
2021,16,3302,440,17,4383,13,17,1,39,0,0,0,0,0,0,False,False,False,0,2,2022-01-01T18:39:16.347,0,False,0.0
2021,16,3302,450,20,8131,2,6,9,14,14,0,14,0,14,0,False,False,False,0,2,2021-12-28T13:41:32.39,14,False,0.0
2021,16,3302,480,17,8483,13,2,9,6,0,0,0,0,0,0,False,False,False,0,3,2021-12-28T13:49:21.42,0,False,0.0
2021,16,3302,490,17,4383,2,19,2,38,40,2,39,1,39,0,False,False,False,0,2,2021-12-28T13:55:44.45,40,False,1.0
2021,16,3302,495,17,8483,2,35,2,16,24,8,24,0,24,0,False,False,False,0,2,2021-12-28T13:55:32.947,24,True,0.0
2021,16,3302,515,17,6274,13,12,9,3,0,0,0,0,0,0,False,False,False,0,3,2022-01-01T18:42:16.73,0,False,
2021,16,3302,525,17,8483,2,55,4,-4,1,5,1,0,1,6,False,False,False,0,3,2021-12-28T15:54:49.553,1,True,0.0
2021,16,3302,550,20,5140,2,12,3,-4,-5,-1,-5,0,-5,0,False,False,False,0,1,2022-01-01T18:35:55.26,-5,False,0.0
2021,16,3302,555,20,7356,2,31,10,2,6,4,5,1,5,0,False,False,False,0,4,2021-12-28T14:21:47.197,6,False,1.0
2021,16,3302,585,20,2136,2,5,5,4,4,0,4,0,4,0,False,False,False,0,3,2021-12-28T14:31:23.95,4,True,0.0
2021,16,3302,600,20,8131,2,13,9,4,4,0,4,0,4,0,False,False,False,0,3,2021-12-28T14:44:58.203,4,False,0.0
2021,16,3302,610,17,8483,2,34,4,-4,5,9,4,1,4,0,True,False,False,0,2,2021-12-28T14:48:52.44,5,False,1.0
2021,16,3302,615,17,6274,2,5,3,6,12,6,12,0,12,0,False,False,False,0,4,2022-01-01T18:38:11.64,12,False,0.0
2021,16,3302,620,17,6274,13,9,2,17,0,0,0,0,0,0,False,False,False,0,2,2021-12-28T14:54:45.53,0,False,0.0
2021,16,3302,630,17,7024,13,2,10,3,0,0,0,0,0,0,False,False,False,0,2,2021-12-28T14:57:26.323,0,False,0.0
2021,16,3302,665,20,5140,2,4,10,3,3,0,3,0,3,0,False,False,False,0,1,2022-01-01T17:55:04.913,3,False,
2021,16,3302,730,20,7356,2,19,6,20,56,36,49,7,49,0,False,False,False,0,2,2022-01-01T18:36:11.873,56,False,7.0
2021,16,3302,740,20,7356,13,12,5,4,0,0,0,0,0,0,False,False,False,0,4,2022-01-01T18:36:21.607,0,False,0.0
2021,16,3302,745,20,5140,3,31,10,-4,0,0,0,0,0,0,False,False,False,0,1,2021-12-28T15:39:15.297,0,False,0.0
2021,16,3302,755,20,8131,13,12,2,15,0,0,0,0,0,0,False,False,False,0,2,2021-12-28T15:42:01.64,0,False,0.0
2021,17,3303,20,32,6430,2,35,7,16,16,0,16,0,16,0,False,False,False,0,3,2022-01-03T02:03:40.06,16,False,0.0
2021,17,3303,25,32,2675,2,13,5,6,10,4,10,0,10,0,False,False,False,0,3,2022-01-03T02:06:04.76,10,True,0.0
2021,17,3303,30,32,8528,2,7,2,19,24,5,24,0,24,0,False,False,False,0,4,2022-01-03T02:08:55.677,24,True,0.0
2021,17,3303,55,24,8509,2,4,8,18,30,12,30,0,30,0,False,False,False,1,3,2022-01-03T02:16:03.54,30,False,0.0
2021,17,3303,80,24,7800,2,4,5,3,5,2,5,0,5,0,False,False,False,0,2,2022-01-03T02:24:53.72,5,False,0.0
2021,17,3303,100,32,4788,2,28,3,4,8,4,7,1,7,0,False,False,False,0,4,2022-01-03T02:32:13.283,8,False,1.0
2021,17,3303,105,32,8527,2,6,8,19,25,6,22,3,22,0,True,False,False,0,2,2022-01-04T21:47:09.79,25,False,3.0
2021,17,3303,110,32,7128,2,13,9,2,12,10,3,9,3,0,False,False,False,1,3,2022-01-05T14:59:39.7,12,False,9.0
2021,17,3303,115,32,4788,13,12,5,12,0,0,0,0,0,0,False,False,False,0,2,2022-01-06T00:21:04.91,0,False,
2021,17,3303,130,32,6430,2,13,9,2,2,0,2,0,2,0,False,False,False,0,2,2022-01-03T02:45:28.31,2,False,0.0
2021,17,3303,150,24,8509,2,4,10,13,12,-1,12,0,12,0,False,False,False,0,2,2022-01-03T02:52:53.827,12,False,0.0
2021,17,3303,160,24,6373,2,6,9,14,14,0,14,0,14,0,False,False,False,1,4,2022-01-03T02:57:22.833,14,False,0.0
2021,17,3303,170,24,6389,2,4,3,4,5,1,4,1,4,0,False,False,False,0,1,2022-01-03T02:59:19.14,5,False,1.0
2021,17,3303,175,24,6389,2,16,9,1,19,18,17,2,17,0,False,False,False,0,1,2022-01-03T03:04:43.783,19,False,2.0
2021,17,3303,180,24,6373,2,12,2,17,18,1,16,2,16,0,False,False,False,0,4,2022-01-03T03:04:55.003,18,False,2.0
2021,17,3303,195,24,8509,13,5,5,2,0,0,0,0,0,0,False,False,False,0,3,2022-01-03T03:09:29.367,0,False,0.0
2021,17,3303,215,32,7128,2,50,10,0,12,12,10,2,10,0,True,False,False,0,2,2022-01-03T15:09:18.11,12,False,2.0
2021,17,3303,235,32,8659,2,4,10,2,12,10,11,1,11,0,False,False,False,1,1,2022-01-05T14:54:41.133,12,False,1.0
2021,17,3303,240,32,3634,2,44,3,-1,11,12,7,4,7,0,False,False,False,1,1,2022-01-03T03:32:01.927,11,False,4.0
2021,17,3303,260,32,7128,2,4,10,4,5,1,4,1,4,0,False,False,False,0,2,2022-01-03T03:36:40.43,5,False,1.0
2021,17,3303,265,32,4788,13,12,2,21,0,0,0,0,0,0,False,False,False,0,4,2022-01-03T03:40:09.66,0,False,0.0
2021,17,3303,280,24,6373,2,32,3,3,5,2,4,1,4,0,False,False,False,0,4,2022-01-03T03:43:45.1,5,False,1.0
2021,17,3303,300,24,4382,2,4,10,5,8,3,7,1,7,0,False,False,False,0,3,2022-01-03T03:56:37.503,8,False,1.0
2021,17,3303,340,32,4084,2,45,5,-2,6,8,6,0,6,0,False,False,False,0,1,2022-01-03T04:11:33.17,6,False,0.0
2021,17,3303,365,32,6430,2,6,7,17,18,1,17,1,17,0,False,False,False,0,2,2022-01-03T04:17:00.527,18,False,1.0
2021,17,3303,375,32,7128,2,2,9,8,9,1,9,0,9,0,False,False,False,0,2,2022-01-03T15:05:58.18,9,False,0.0
2021,17,3303,415,24,6373,2,53,10,-2,8,10,5,3,5,0,False,False,False,0,4,2022-01-03T04:27:07.697,8,False,3.0
2021,17,3303,425,24,7800,13,51,9,-5,0,0,0,0,0,0,False,False,False,0,3,2022-01-03T04:33:27.493,0,False,0.0
2021,17,3303,430,24,6389,2,44,3,3,18,15,18,0,18,0,False,False,False,0,1,2022-01-05T14:34:13.397,18,False,0.0
2021,17,3303,435,24,8509,13,21,6,42,0,0,0,0,0,0,False,False,False,0,2,2022-01-04T20:48:58.287,0,False,0.0
2021,17,3303,445,24,6373,2,5,5,14,13,-1,13,0,13,0,False,False,False,0,3,2022-01-05T14:34:13.397,13,True,0.0
2021,17,3303,455,24,6389,2,48,5,-6,-3,3,-3,0,-3,0,False,False,False,0,1,2022-01-03T04:53:38.223,-3,False,0.0
2021,17,3303,465,24,4382,2,12,2,27,27,0,27,0,27,0,False,False,False,0,3,2022-01-03T04:55:57.86,27,False,0.0
2021,17,3303,505,32,7128,2,13,3,2,4,2,4,0,4,0,False,False,False,0,3,2022-01-03T05:16:46.957,4,False,0.0
2021,17,3303,525,24,7800,13,24,6,18,0,0,0,0,0,0,False,False,False,0,4,2022-01-05T14:34:13.397,0,False,0.0
2021,17,3303,530,24,8509,13,6,7,19,0,0,0,0,0,0,True,False,False,0,3,2022-01-05T14:34:13.397,0,False,0.0
2021,17,3303,550,32,7128,2,2,9,5,11,6,5,6,5,0,False,False,False,1,2,2022-01-05T14:56:01.413,11,False,6.0
2021,17,3303,570,32,3634,13,45,10,-4,0,0,0,0,0,0,False,False,False,0,1,2022-01-03T05:45:24.287,0,False,0.0
2021,17,3303,590,24,8509,2,3,5,12,12,0,12,0,12,0,False,False,False,0,2,2022-01-05T14:50:25.15,12,False,0.0
2021,17,3303,610,24,6373,2,5,3,12,13,1,13,0,13,0,False,False,False,0,4,2022-01-03T05:58:20.63,13,False,0.0
2021,17,3303,620,24,6373,13,13,10,2,0,0,0,0,0,0,False,False,False,0,4,2022-01-03T06:00:20.517,0,False,0.0
2021,17,3303,630,24,7800,2,6,4,10,10,0,10,0,10,0,False,False,False,0,3,2022-01-03T06:02:14.373,10,False,0.0
2021,17,3303,645,32,8528,2,53,10,-6,1,7,-1,2,-1,0,False,False,False,0,4,2022-01-03T06:04:11.453,1,False,2.0
2021,17,3303,660,32,7128,13,35,10,14,0,0,0,0,0,0,False,False,False,0,3,2022-01-03T15:10:00.22,0,False,
2021,17,3303,665,32,3634,2,48,10,-5,-4,1,-4,0,-4,0,False,False,False,0,1,2022-01-03T06:11:09.103,-4,False,0.0
2021,17,3303,670,32,2675,2,13,10,2,2,0,2,0,2,0,False,False,False,0,3,2022-01-03T06:12:28.57,2,False,0.0
2021,17,3303,675,32,7128,2,13,9,3,8,5,7,1,7,0,False,False,False,0,3,2022-01-04T21:47:41.107,8,False,1.0
2021,17,3303,680,32,8533,13,5,5,3,0,0,0,0,0,0,False,False,False,0,3,2022-01-03T06:15:09.18,0,False,0.0
2021,17,3303,730,24,7798,13,12,5,14,0,0,0,0,0,0,True,False,False,0,3,2022-01-03T06:29:52.403,0,False,0.0
2021,17,3303,745,32,7128,13,13,10,3,0,0,0,0,0,0,False,False,False,0,3,2022-01-03T06:31:43.983,0,False,0.0
2021,17,3303,750,32,4084,13,45,5,-5,0,0,0,0,0,0,True,False,False,0,1,2022-01-03T06:32:54.197,0,False,0.0
2021,17,3303,755,32,8528,2,13,9,5,10,5,8,2,8,0,False,False,False,0,3,2022-01-03T06:34:00.433,10,False,2.0
2021,17,3303,765,32,4084,2,5,3,4,4,0,4,0,4,0,False,False,False,0,1,2022-01-03T06:35:55.957,4,False,0.0
2021,17,3303,775,32,8659,2,48,3,-6,5,11,5,0,5,0,False,False,False,0,1,2022-01-03T06:37:25.667,5,False,0.0
2021,17,3303,780,32,8659,2,28,10,-1,9,10,3,6,3,0,False,False,False,0,1,2022-01-03T06:38:39.793,9,False,6.0
2021,17,3303,785,32,6430,2,4,5,5,12,7,11,1,11,0,False,False,False,0,2,2022-01-03T06:39:54.903,12,False,1.0
2021,17,3303,790,32,6430,13,7,2,18,0,0,0,0,0,0,False,False,False,0,2,2022-01-03T06:41:17.067,0,False,0.0
2021,17,3303,795,32,8659,2,45,5,-4,5,9,4,1,4,0,False,False,False,0,1,2022-01-03T06:43:00.007,5,False,1.0
2021,17,3303,800,32,8659,2,4,10,4,10,6,8,2,8,0,False,False,False,0,1,2022-01-03T06:45:25.197,10,False,2.0
2021,17,3303,810,32,8528,13,35,7,20,0,0,0,0,0,0,False,False,False,0,3,2022-01-05T14:53:57.027,0,False,0.0
2021,17,3304,20,5,5220,2,2,9,5,6,1,5,1,5,0,False,False,False,0,2,2022-01-03T10:47:34.763,6,False,1.0
2021,17,3304,25,5,566,2,48,9,-6,17,23,-1,18,-1,0,False,False,False,2,1,2022-01-05T16:36:13.843,17,False,18.0
2021,17,3304,30,5,6425,2,13,10,4,21,17,18,3,18,0,False,False,False,0,4,2022-01-03T13:55:18.897,21,False,3.0
2021,17,3304,35,5,8406,2,5,5,5,8,3,7,1,7,0,True,False,False,0,3,2022-01-03T10:52:25.513,8,False,1.0
2021,17,3304,60,5,566,2,32,10,-7,-1,6,-6,5,-6,0,False,False,False,1,1,2022-03-08T19:26:33.507,-1,False,5.0
2021,17,3304,80,20,5140,2,48,9,-8,29,37,16,13,16,0,False,False,False,1,1,2022-01-03T12:55:16.47,29,False,13.0
2021,17,3304,90,20,5140,2,2,10,6,14,8,9,5,9,0,False,False,False,0,2,2022-01-03T11:16:04.843,14,False,5.0
2021,17,3304,105,20,8131,3,6,3,4,0,0,0,0,0,0,False,False,False,0,2,2022-01-03T11:19:26.027,0,False,0.0
2021,17,3304,115,20,5140,2,50,5,-3,7,10,4,3,4,0,False,False,False,0,2,2022-01-03T11:21:24.713,7,False,3.0
2021,17,3304,160,5,566,2,51,9,-6,10,16,8,2,8,0,True,False,False,0,1,2022-01-03T16:33:15.657,10,False,2.0
2021,17,3304,165,5,5220,2,50,3,1,3,2,2,1,2,0,False,False,False,0,2,2022-01-03T11:35:33.807,3,False,1.0
2021,17,3304,175,5,3477,2,5,5,7,7,0,7,0,7,0,False,False,False,0,3,2022-03-08T19:26:54.207,7,False,0.0
2021,17,3304,180,5,8409,2,47,5,2,17,15,11,6,11,0,False,False,False,0,1,2022-01-05T15:57:31.08,17,False,6.0
2021,17,3304,210,20,5140,2,4,10,4,6,2,5,1,5,0,False,False,False,0,3,2022-03-08T19:30:53.92,6,False,1.0
2021,17,3304,230,5,8409,3,48,10,-5,0,0,0,0,0,0,False,False,False,0,1,2022-01-03T11:56:06.867,0,False,0.0
2021,17,3304,245,20,8127,2,2,9,2,4,2,4,0,4,0,False,False,False,0,2,2022-01-03T12:00:03.897,4,False,0.0
2021,17,3304,250,20,5140,13,29,3,6,0,0,0,0,0,0,False,False,False,0,3,2022-02-22T19:14:50.357,0,False,0.0
2021,17,3304,270,5,5220,13,4,5,6,0,0,0,0,0,0,False,False,False,0,2,2022-01-03T12:06:24.623,0,False,0.0
2021,17,3304,285,20,8131,2,5,3,5,7,2,7,0,7,0,False,False,False,0,3,2022-01-03T16:28:51.32,7,False,0.0
2021,17,3304,295,20,8131,2,35,7,24,30,6,26,4,26,0,False,False,False,0,3,2022-01-03T12:16:39.707,30,False,4.0
2021,17,3304,305,20,8131,3,4,3,14,0,0,0,0,0,0,False,False,False,0,2,2022-01-03T12:18:49.11,0,False,0.0
2021,17,3304,375,20,8131,2,9,6,24,28,4,26,2,26,0,False,False,False,0,2,2022-01-03T12:34:40.247,28,False,2.0
2021,17,3304,380,20,7356,2,6,4,14,18,4,16,2,16,0,False,False,False,0,3,2022-03-08T19:31:58.27,18,False,2.0
2021,17,3304,395,20,8131,2,6,9,12,15,3,15,0,15,0,False,False,False,0,3,2022-03-08T19:32:19.043,15,False,0.0
2021,17,3304,405,20,7356,2,4,10,6,8,2,6,2,6,0,False,False,False,0,3,2022-02-22T19:07:37.037,8,False,2.0
2021,17,3304,440,20,8131,2,6,9,4,8,4,6,2,6,0,False,False,False,0,2,2022-01-03T12:58:22.983,8,False,2.0
2021,17,3304,445,20,8131,2,4,5,5,9,4,6,3,6,0,False,False,False,0,2,2022-01-05T16:37:01.547,9,False,3.0
2021,17,3304,465,20,7353,2,5,3,14,14,0,14,0,14,0,False,False,False,0,2,2022-01-03T13:10:23.803,14,False,0.0
2021,17,3304,500,5,8409,2,28,4,1,1,0,1,0,1,0,False,False,False,0,1,2022-01-03T13:22:20.153,1,False,0.0
2021,17,3304,525,20,8131,13,6,8,20,0,0,0,0,0,0,False,False,False,0,2,2022-02-25T16:12:51.957,0,False,0.0
2021,17,3304,545,5,8409,2,44,9,-7,-5,2,-5,0,-5,0,True,False,False,1,1,2022-01-04T17:06:17.363,-5,False,0.0
2021,17,3304,570,20,8131,3,5,5,5,0,0,0,0,0,0,False,False,False,0,3,2022-01-03T13:44:26.773,0,False,0.0
2021,17,3304,575,20,8127,13,13,9,5,0,0,0,0,0,0,False,False,False,0,2,2022-01-05T16:07:02.897,0,False,0.0
2021,17,3304,590,5,5220,2,2,10,13,20,7,19,1,19,0,False,False,False,1,2,2022-01-03T13:50:08.327,20,False,1.0
2021,17,3304,600,5,566,2,5,3,5,5,0,5,0,5,0,False,False,False,0,1,2022-01-03T13:53:23.75,5,False,0.0
2021,17,3304,605,5,8406,2,12,5,8,8,0,8,0,8,0,False,False,False,0,2,2022-01-04T19:04:03.107,8,False,0.0
2021,17,3304,615,5,6425,2,6,9,7,9,2,7,2,7,0,False,False,False,0,4,2022-01-05T16:16:48.897,9,False,2.0
2021,17,3304,630,5,5220,13,2,4,10,0,0,0,0,0,0,False,False,False,0,3,2022-01-03T14:02:51.433,0,False,0.0
2021,17,3304,635,5,3477,2,4,9,5,3,-2,3,0,3,0,False,False,False,0,3,2022-02-16T21:51:25.08,3,False,0.0
2021,17,3304,650,20,7353,2,4,9,3,9,6,8,1,8,0,False,False,False,0,3,2022-03-08T19:33:03.103,9,False,1.0
2021,17,3304,655,20,8728,2,47,10,0,4,4,1,3,1,0,False,False,False,0,1,2022-01-03T14:09:52.947,4,False,3.0
2021,17,3304,675,20,5140,2,47,5,0,12,12,10,2,10,6,False,False,False,0,1,2022-01-03T14:15:27.203,12,False,2.0
2021,17,3304,695,5,5220,3,5,5,9,0,0,0,0,0,0,False,False,False,0,2,2022-01-03T16:30:07.173,0,False,0.0
2021,17,3304,755,5,6425,2,32,5,3,3,0,3,0,3,0,False,False,False,0,4,2022-01-03T14:44:47.387,3,False,0.0
2021,17,3304,775,5,5220,13,6,8,17,0,0,0,0,0,0,False,False,False,0,2,2022-02-22T19:16:35.367,0,False,0.0
2021,17,3304,780,5,5220,13,7,2,19,0,0,0,0,0,0,False,False,False,0,2,2022-01-03T14:52:16.47,0,False,
2021,17,3304,795,5,5220,13,6,7,15,0,0,0,0,0,0,False,False,False,0,2,2022-01-03T14:57:07.323,0,False,0.0
2021,17,3305,10,22,8451,2,28,10,0,8,8,6,2,6,0,False,False,False,0,1,2022-01-05T17:02:13.823,8,False,
2021,17,3305,15,22,6270,13,4,4,5,0,0,0,0,0,0,False,False,False,0,3,2022-01-03T08:06:21.897,0,False,0.0
2021,17,3305,30,22,6270,2,50,5,-1,9,10,7,2,7,0,False,False,False,0,2,2022-01-03T08:17:08.51,9,False,2.0
2021,17,3305,60,30,6414,2,18,3,1,1,0,1,0,1,0,False,False,False,0,2,2022-01-03T08:31:11.81,1,False,0.0
2021,17,3305,65,30,793,2,5,3,4,4,0,4,0,4,0,False,False,False,0,3,2022-01-03T08:32:55.283,4,False,0.0
2021,17,3305,70,30,63,13,11,6,26,0,0,0,0,0,0,False,False,False,0,4,2022-01-03T08:36:26.813,0,False,0.0
2021,17,3305,75,30,7893,2,6,4,5,9,4,7,2,7,0,False,False,False,0,3,2022-01-03T08:38:06.507,9,False,2.0
2021,17,3305,90,30,37,13,4,7,16,0,0,0,0,0,0,False,False,False,0,3,2022-02-25T16:13:51.31,0,False,0.0
2021,17,3305,95,30,34,2,13,4,3,15,12,5,10,5,0,True,False,False,1,2,2022-01-03T08:50:49.977,15,False,10.0
2021,17,3305,100,30,63,2,32,5,-5,7,12,-1,8,-1,0,False,False,False,1,4,2022-01-03T08:53:02.907,7,False,8.0
2021,17,3305,115,30,793,2,29,3,4,4,0,4,0,4,6,False,False,False,0,2,2022-01-03T09:00:20.36,4,True,0.0
2021,17,3305,135,22,8451,2,31,4,2,9,7,7,2,7,0,True,False,False,0,4,2022-01-03T09:14:10.793,9,False,2.0
2021,17,3305,140,22,7118,2,6,10,13,13,0,13,0,13,0,False,False,False,0,2,2022-01-03T09:10:56.05,13,False,0.0
2021,17,3305,160,22,3320,2,5,3,5,5,0,5,0,5,0,True,False,False,0,4,2022-01-05T17:02:13.823,5,False,0.0
2021,17,3305,165,22,6270,2,16,9,6,9,3,7,2,7,0,True,False,False,0,3,2022-01-03T09:20:58.22,9,False,2.0
2021,17,3305,170,22,7118,13,51,10,-7,0,0,0,0,0,0,True,False,False,0,3,2022-01-03T09:23:55.747,0,False,0.0
2021,17,3305,175,22,7118,3,35,9,9,0,0,0,0,0,0,False,False,False,0,3,2022-02-16T22:22:21.317,0,False,0.0
2021,17,3305,180,22,8801,2,2,9,10,12,2,11,1,11,0,False,False,False,0,3,2022-01-03T09:29:05.737,12,False,1.0
2021,17,3305,195,22,6812,2,48,9,-6,5,11,3,2,3,0,False,False,False,0,1,2022-01-03T09:33:28.467,5,False,2.0
2021,17,3305,200,22,6270,2,5,5,4,9,5,9,0,9,6,False,False,False,0,3,2022-01-05T16:11:57.823,9,True,0.0
2021,17,3305,215,30,37,13,50,9,-1,0,0,0,0,0,0,False,False,False,0,2,2022-01-03T09:39:48.38,0,False,0.0
2021,17,3305,220,30,793,2,9,6,23,31,8,31,0,31,0,False,False,False,0,3,2022-01-03T10:06:09.247,31,True,0.0
2021,17,3305,225,30,37,2,4,2,16,21,5,21,0,21,0,False,False,False,0,2,2022-01-03T10:05:31.537,21,False,0.0
2021,17,3305,235,30,37,2,18,5,-2,3,5,2,1,2,0,False,False,False,0,2,2022-01-03T10:05:17.45,3,False,1.0
2021,17,3305,245,30,7891,13,48,10,-3,0,0,0,0,0,0,False,False,False,0,1,2022-01-03T10:04:56.577,0,False,0.0
2021,17,3305,260,22,3320,2,38,3,3,24,21,21,3,21,0,False,False,False,0,4,2022-02-16T22:23:11.543,24,False,3.0
2021,17,3305,265,22,6270,2,49,5,-1,11,12,9,2,9,0,False,False,False,0,2,2022-01-03T09:57:20.487,11,False,2.0
2021,17,3305,270,22,6270,13,9,6,28,0,0,0,0,0,0,False,False,False,0,3,2022-02-16T22:23:54.557,0,False,0.0
2021,17,3305,275,22,4997,13,7,6,42,0,0,0,0,0,0,False,False,False,0,3,2022-02-24T19:54:55.58,0,False,0.0
2021,17,3305,310,30,37,2,50,3,-1,2,3,-1,3,-1,0,False,False,False,2,2,2022-01-03T10:16:37.193,2,False,3.0
2021,17,3305,315,30,63,2,35,10,4,21,17,8,13,8,0,False,False,False,0,4,2022-01-03T10:18:43.777,21,False,13.0
2021,17,3305,330,30,63,2,4,10,11,14,3,12,2,12,0,False,False,False,0,3,2022-01-03T10:22:39.28,14,False,2.0
2021,17,3305,360,22,8801,2,8,1,21,24,3,24,0,24,0,False,False,False,0,3,2022-01-03T10:31:33.417,24,False,0.0
2021,17,3305,375,22,4997,3,5,3,13,0,0,0,0,0,0,False,False,False,0,3,2022-01-03T10:35:58.227,0,False,0.0
2021,17,3305,390,30,7891,2,46,3,3,6,3,6,0,6,0,False,False,False,0,1,2022-01-03T10:40:02.067,6,True,0.0
2021,17,3305,395,30,63,2,17,1,22,24,2,22,2,22,0,False,False,False,0,4,2022-01-03T10:41:48.893,24,False,2.0
2021,17,3305,405,30,63,2,32,10,-1,14,15,8,6,8,0,False,False,False,0,4,2022-01-03T10:44:23.993,14,False,6.0
2021,17,3305,415,30,793,13,20,6,28,0,0,0,0,0,0,False,False,False,0,2,2022-01-05T16:06:28.57,0,False,0.0
2021,17,3305,420,22,6812,2,47,5,0,19,19,19,0,19,0,False,False,False,0,1,2022-01-05T17:02:13.823,19,False,0.0
2021,17,3305,425,22,7118,13,5,5,11,0,0,0,0,0,0,False,False,False,0,3,2022-01-05T16:18:04.36,0,False,0.0
2021,17,3305,465,30,5056,2,4,9,4,9,5,7,2,7,0,False,False,False,0,3,2022-01-03T11:05:56.563,9,False,2.0
2021,17,3305,475,30,63,13,35,4,8,0,0,0,0,0,0,False,False,False,0,4,2022-01-03T11:09:34.22,0,False,0.0
2021,17,3305,480,30,793,13,21,6,43,0,0,0,0,0,0,False,False,False,0,2,2022-01-03T11:12:52.76,0,False,0.0
2021,17,3305,500,22,6270,2,34,4,-4,2,6,1,1,1,0,True,False,False,0,3,2022-01-05T16:12:57.833,2,False,1.0
2021,17,3305,510,22,6812,2,48,9,-5,23,28,23,0,23,0,False,False,False,0,1,2022-01-03T11:25:45.037,23,False,0.0
2021,17,3305,515,22,6270,2,2,9,9,11,2,11,0,11,0,False,False,False,0,3,2022-02-16T22:25:08.767,11,False,0.0
2021,17,3305,520,22,4997,2,8,8,17,21,4,19,2,19,0,False,False,False,0,2,2022-01-03T11:30:36.47,21,False,2.0
2021,17,3305,545,30,7891,2,46,3,6,8,2,8,0,8,0,False,False,False,0,1,2022-01-03T11:46:17.347,8,False,0.0
2021,17,3305,555,30,5056,2,3,2,20,20,0,20,0,20,0,False,False,False,0,2,2022-01-03T11:50:03.523,20,True,0.0
2021,17,3305,565,30,63,2,35,10,9,14,5,9,5,9,0,False,False,False,1,4,2022-01-03T11:52:50.897,14,False,5.0
2021,17,3305,575,30,2290,2,51,3,0,1,1,1,0,1,0,True,False,False,0,3,2022-01-03T11:56:24.23,1,False,0.0
2021,17,3305,580,30,793,2,13,4,4,8,4,7,1,7,0,False,False,False,0,3,2022-01-06T19:26:27,8,False,1.0
2021,17,3305,585,30,256,2,35,2,26,32,6,29,3,29,0,False,False,False,0,2,2022-02-16T22:25:34.343,32,False,3.0
2021,17,3305,590,30,256,13,8,9,7,0,0,0,0,0,0,False,False,False,0,2,2022-01-06T19:26:32.94,0,False,0.0
2021,17,3305,600,30,63,13,17,10,4,0,0,0,0,0,0,False,False,False,0,3,2022-02-16T22:26:43.51,0,False,0.0
2021,17,3305,605,30,2290,2,16,9,4,4,0,4,0,4,6,True,False,False,0,4,2022-01-03T12:12:08.32,4,True,0.0
2021,17,3305,630,22,6812,13,51,5,-5,0,0,0,0,0,0,False,False,False,0,1,2022-01-06T19:26:41.487,0,False,0.0
2021,17,3305,645,30,256,2,18,3,-1,9,10,7,2,7,0,False,False,False,0,2,2022-01-03T12:38:45.653,9,False,2.0
2021,17,3305,660,30,793,13,9,2,22,0,0,0,0,0,0,False,False,False,0,3,2022-01-05T16:01:03.073,0,False,0.0
2021,17,3305,665,30,5056,13,9,2,30,0,0,0,0,0,0,False,False,False,0,3,2022-01-03T12:46:45.493,0,False,0.0
2021,17,3305,680,22,4997,13,4,5,5,0,0,0,0,0,0,False,False,False,0,2,2022-02-22T19:25:07.047,0,False,0.0
2021,17,3305,685,22,6270,13,16,9,4,0,0,0,0,0,0,False,False,False,0,1,2022-01-03T12:54:35.563,0,False,0.0
2021,17,3305,695,30,63,2,35,9,9,21,12,16,5,16,0,False,False,False,0,4,2022-01-03T12:58:03.117,21,False,5.0
2021,17,3305,705,30,34,2,46,3,3,3,0,3,0,3,0,True,False,False,0,3,2022-01-03T13:00:47.81,3,False,0.0
2021,17,3305,710,30,34,2,46,3,0,12,12,12,0,12,0,False,False,False,0,1,2022-01-03T13:02:28.93,12,False,0.0
2021,17,3305,725,30,7893,3,6,9,8,0,0,0,0,0,0,False,False,False,0,3,2022-01-05T17:02:13.837,0,False,0.0
2021,17,3305,740,22,4997,2,2,4,11,14,3,13,1,13,0,True,False,False,0,3,2022-01-05T16:09:40.633,14,False,1.0
2021,17,3305,745,22,6270,13,35,5,14,0,0,0,0,0,0,False,False,False,0,3,2022-01-03T13:15:21.65,0,False,0.0
2021,17,3305,795,22,6270,2,5,5,4,4,0,4,0,4,0,True,False,False,0,3,2022-01-05T16:06:10.92,4,False,0.0
2021,17,3305,810,30,7893,2,2,4,4,8,4,5,3,5,0,False,False,False,0,3,2022-01-03T13:39:47.703,8,False,3.0
2021,17,3305,820,30,5056,2,2,10,1,3,2,2,1,2,0,False,False,False,0,2,2022-01-03T13:41:15.097,3,False,1.0
2021,17,3305,825,30,5056,13,4,5,10,0,0,0,0,0,0,False,False,False,0,2,2022-01-05T16:01:18.797,0,False,0.0
2021,17,3305,830,30,5056,2,4,10,4,6,2,6,0,6,0,False,False,False,0,3,2022-01-03T13:45:32.853,6,False,0.0
2021,17,3305,835,30,7893,2,4,9,4,6,2,6,0,6,0,False,False,False,0,2,2022-01-03T13:46:45.573,6,False,0.0
2021,17,3305,840,30,7893,13,17,8,34,0,0,0,0,0,0,False,False,False,0,3,2022-01-03T13:48:27.593,0,False,0.0
2021,17,3305,845,30,7893,2,4,8,20,27,7,25,2,25,0,False,False,False,0,3,2022-01-05T16:24:16.8,27,False,2.0
2021,17,3305,850,30,5056,2,4,5,10,10,0,10,0,10,0,False,False,False,0,2,2022-01-03T13:54:22.177,10,False,0.0
2021,17,3305,855,30,5056,2,19,2,29,33,4,33,0,33,6,False,False,False,0,2,2022-01-05T17:02:13.837,33,True,0.0
2021,17,3305,875,22,6270,2,50,3,-5,10,15,10,0,10,0,False,True,True,0,3,2022-01-03T14:00:32.627,10,False,0.0
2021,17,3306,10,17,2253,2,8,7,17,20,3,19,1,19,0,False,False,False,0,3,2022-01-05T19:11:06.847,20,False,1.0
2021,17,3306,15,17,7024,2,48,10,-1,14,15,13,1,13,0,False,False,False,0,1,2022-01-03T10:07:41.493,14,False,
2021,17,3306,30,17,8483,2,34,4,-4,0,4,0,0,0,0,True,False,False,1,2,2022-01-05T19:08:12.933,0,False,0.0
2021,17,3306,50,31,6793,13,6,10,11,0,0,0,0,0,0,True,False,False,0,2,2022-01-03T10:19:27.997,0,False,0.0
2021,17,3306,55,31,7913,13,8,8,16,0,0,0,0,0,0,False,False,False,0,2,2022-01-04T18:28:37.873,0,False,0.0
2021,17,3306,65,17,8483,13,7,2,20,0,0,0,0,0,0,False,False,False,0,3,2022-01-03T10:25:34.48,0,False,0.0
2021,17,3306,75,17,4383,13,5,6,15,0,0,0,0,0,0,False,False,False,0,2,2022-01-05T19:12:28.583,0,False,0.0
2021,17,3306,110,17,2253,13,2,9,4,0,0,0,0,0,0,False,False,False,0,2,2022-01-03T10:44:05.01,0,False,0.0
2021,17,3306,125,31,6793,13,35,10,10,0,0,0,0,0,0,False,False,False,0,3,2022-01-03T10:48:18.07,0,False,0.0
2021,17,3306,135,31,6793,2,6,8,16,25,9,20,5,20,0,False,False,False,1,2,2022-01-03T10:50:27.197,25,False,5.0
2021,17,3306,145,31,6722,2,18,3,-2,2,4,0,2,0,0,True,False,False,0,2,2022-01-03T10:54:52.303,2,False,2.0
2021,17,3306,150,31,6724,2,31,4,2,4,2,4,0,4,0,False,False,False,0,3,2022-01-03T10:57:31.16,4,False,0.0
2021,17,3306,170,31,2865,2,32,10,1,1,0,1,0,1,6,True,False,False,0,4,2022-01-03T11:02:40.573,1,True,0.0
2021,17,3306,185,17,2253,13,6,10,14,0,0,0,0,0,0,False,False,False,0,2,2022-01-03T11:07:45.337,0,False,0.0
2021,17,3306,210,31,6724,2,38,4,2,5,3,5,0,5,0,False,False,False,0,4,2022-01-03T11:18:00.333,5,False,0.0
2021,17,3306,240,17,6481,2,44,3,-1,8,9,8,0,8,0,False,False,False,0,1,2022-01-03T11:27:13.437,8,False,0.0
2021,17,3306,250,17,6276,2,30,9,0,15,15,15,0,15,0,False,False,False,0,4,2022-01-05T19:04:44.087,15,False,0.0
2021,17,3306,255,17,8483,13,5,3,5,0,0,0,0,0,0,False,False,False,0,3,2022-02-16T22:55:44.973,0,False,0.0
2021,17,3306,290,31,2865,2,32,5,3,5,2,5,0,5,0,False,False,False,0,4,2022-01-03T11:46:02.6,5,False,0.0
2021,17,3306,295,31,6793,2,4,1,16,16,0,16,0,16,0,False,False,False,0,3,2022-01-03T11:48:01.21,16,False,0.0
2021,17,3306,310,31,3911,13,5,3,11,0,0,0,0,0,0,False,False,False,0,3,2022-01-03T11:57:21.7,0,False,
2021,17,3306,335,31,7913,13,43,6,15,0,0,0,0,0,0,False,False,False,0,3,2022-02-16T22:57:57.193,0,False,0.0
2021,17,3306,355,17,6274,13,8,9,13,0,0,0,0,0,0,False,False,False,0,4,2022-01-03T12:12:31.14,0,False,0.0
2021,17,3306,365,17,6274,2,5,3,11,14,3,12,2,12,0,True,False,False,0,3,2022-01-03T12:16:58.683,14,False,2.0
2021,17,3306,375,17,6274,2,12,3,14,14,0,14,0,14,0,False,False,False,0,3,2022-02-24T19:55:48.52,14,False,0.0
2021,17,3306,380,17,6274,13,7,8,19,0,0,0,0,0,0,False,False,False,0,3,2022-01-03T12:21:46.213,0,False,0.0
2021,17,3306,385,17,2253,13,4,5,10,0,0,0,0,0,0,False,False,False,0,2,2022-01-31T18:55:14.433,0,False,0.0
2021,17,3306,390,17,2253,13,6,9,14,0,0,0,0,0,0,False,False,False,0,2,2022-01-03T12:25:18.69,0,False,0.0
2021,17,3306,430,31,2865,2,53,4,-5,3,8,-2,5,-2,0,False,False,False,1,4,2022-01-05T19:09:25.35,3,False,5.0
2021,17,3306,435,31,3911,2,5,3,7,7,0,7,0,7,0,False,False,False,0,3,2022-01-03T12:46:08.27,7,True,0.0
2021,17,3306,450,31,6722,2,48,9,-5,52,57,50,2,50,0,False,False,False,0,1,2022-01-03T12:51:36.867,28,False,2.0
2021,17,3306,460,31,6793,13,12,8,35,0,0,0,0,0,0,False,False,False,0,2,2022-02-24T19:56:12.803,0,False,0.0
2021,17,3306,475,17,4752,13,12,4,11,0,0,0,0,0,0,False,False,False,0,3,2022-02-24T19:56:27.06,0,False,0.0
2021,17,3306,480,17,2253,2,2,10,9,11,2,9,2,9,0,False,False,False,0,2,2022-01-03T13:06:34.903,11,False,2.0
2021,17,3306,495,17,8483,13,8,7,43,0,0,0,0,0,0,False,False,False,0,3,2022-01-03T13:23:58.633,0,False,
2021,17,3306,500,17,6274,2,2,10,10,15,5,15,0,15,0,False,False,False,0,3,2022-01-03T13:23:48.193,15,False,0.0
2021,17,3306,505,17,6276,2,2,4,13,21,8,16,5,16,0,False,False,False,0,4,2022-01-05T19:06:29.143,21,False,5.0
2021,17,3306,510,17,8483,13,30,10,-6,0,0,0,0,0,0,False,False,False,0,3,2022-01-03T13:28:06.427,0,False,0.0
2021,17,3306,515,17,4752,2,30,3,-3,0,3,0,0,0,0,True,False,False,0,3,2022-01-03T13:29:50.403,0,False,0.0
2021,17,3306,535,31,3911,2,45,5,-2,6,8,3,3,3,0,True,False,False,0,2,2022-01-03T13:35:54.563,6,False,3.0
2021,17,3306,550,31,6793,13,6,10,13,0,0,0,0,0,0,False,False,False,0,3,2022-01-03T13:43:00.597,0,False,
2021,17,3306,560,31,6722,2,48,10,-4,3,7,0,3,0,0,False,False,False,1,1,2022-01-03T13:49:01.707,3,False,3.0
2021,17,3306,585,17,2253,13,2,10,12,0,0,0,0,0,0,False,False,False,0,3,2022-01-03T13:57:55.653,0,False,0.0
2021,17,3306,590,17,404,2,5,5,5,10,5,7,3,7,0,False,False,False,0,1,2022-01-03T13:59:34.223,10,False,3.0
2021,17,3306,595,17,7024,13,11,2,23,0,0,0,0,0,0,True,False,False,0,2,2022-02-16T22:59:16.817,0,False,0.0
2021,17,3306,600,17,404,2,28,5,-1,6,7,3,3,3,0,False,False,False,0,1,2022-01-03T14:04:59.267,6,False,3.0
2021,17,3306,605,17,2253,2,2,4,4,6,2,6,0,6,0,False,False,False,0,3,2022-01-03T14:07:56.443,6,False,0.0
2021,17,3306,610,17,8483,2,7,6,41,45,4,45,0,45,0,False,False,False,0,2,2022-01-03T14:09:52.853,45,False,0.0
2021,17,3306,620,17,6276,2,30,3,1,1,0,1,0,1,0,False,False,False,0,4,2022-01-03T14:14:59.433,1,False,0.0
2021,17,3306,625,17,2253,13,8,8,23,0,0,0,0,0,0,False,False,False,0,2,2022-02-25T16:14:43.237,0,False,0.0
2021,17,3306,630,17,2253,13,6,8,16,0,0,0,0,0,0,False,False,False,0,2,2022-01-03T14:18:13.083,0,False,0.0
2021,17,3306,655,31,6724,2,7,8,15,15,0,15,0,15,6,False,False,False,0,4,2022-01-03T14:33:24.113,15,True,0.0
2021,17,3306,670,17,8483,2,50,10,-5,2,7,0,2,0,0,True,False,False,0,2,2022-01-03T14:38:07.943,2,False,2.0
2021,17,3306,675,17,8483,3,2,10,9,0,0,0,0,0,0,False,False,False,0,2,2022-01-03T14:39:32.727,0,False,0.0
2021,17,3306,680,17,2253,2,3,5,9,9,0,9,0,9,0,False,False,False,0,2,2022-01-03T14:41:17.337,9,False,0.0
2021,17,3306,685,17,404,3,28,4,3,0,0,0,0,0,0,False,False,False,0,1,2022-01-03T14:42:36.813,0,False,0.0
2021,17,3306,690,17,2253,13,2,9,6,0,0,0,0,0,0,False,False,False,0,2,2022-01-03T14:45:11.693,0,False,0.0
2021,17,3306,695,17,6274,2,4,9,6,8,2,8,0,8,0,False,False,False,0,3,2022-01-03T14:47:11.683,8,False,0.0
2021,17,3306,700,17,2253,13,4,3,9,0,0,0,0,0,0,False,False,False,0,2,2022-02-25T16:15:01.58,0,False,0.0
2021,17,3306,770,17,6274,3,6,4,13,0,0,0,0,0,0,False,False,False,0,3,2022-01-03T15:07:50.283,0,False,0.0
2021,17,3307,10,15,8343,2,46,3,0,7,7,3,4,3,0,True,False,False,0,4,2022-02-16T21:35:28.807,7,False,4.0
2021,17,3307,20,15,4179,2,2,4,5,9,4,8,1,8,0,False,False,False,0,3,2022-01-03T01:57:26.11,9,False,1.0
2021,17,3307,30,19,7175,2,5,5,7,8,1,8,0,8,0,False,False,False,0,3,2022-01-05T15:46:09.47,8,True,0.0
2021,17,3307,40,19,7914,2,4,3,5,7,2,6,1,6,0,False,False,False,1,2,2022-01-03T02:07:26.32,7,False,1.0
2021,17,3307,50,19,7172,2,45,5,-4,12,16,9,3,9,0,False,False,False,0,1,2022-01-05T15:40:19.85,12,False,3.0
2021,17,3307,55,19,7175,2,6,5,5,6,1,5,1,5,0,False,False,False,0,3,2022-01-05T15:39:46.58,6,False,1.0
2021,17,3307,70,19,7175,2,5,9,8,14,6,13,1,13,0,False,False,False,0,3,2022-01-05T15:32:17.967,14,False,1.0
2021,17,3307,105,15,3750,13,38,10,6,0,0,0,0,0,0,False,False,False,0,4,2022-01-03T02:29:28.38,0,False,0.0
2021,17,3307,115,15,4179,2,35,8,37,40,3,37,3,37,0,False,False,False,0,3,2022-01-03T02:32:57.217,40,False,3.0
2021,17,3307,125,15,7591,2,51,9,-4,2,6,0,2,0,0,False,False,False,0,3,2022-01-03T02:35:45.04,2,False,2.0
2021,17,3307,130,15,914,13,7,5,11,0,0,0,0,0,0,False,False,False,0,3,2022-01-03T02:37:20.867,0,False,0.0
2021,17,3307,145,19,7914,2,4,10,5,9,4,7,2,7,0,False,False,False,0,3,2022-01-03T02:44:48.243,9,False,2.0
2021,17,3307,185,19,4282,2,5,3,9,17,8,16,1,16,0,False,False,False,0,4,2022-01-03T02:57:48.297,17,False,1.0
2021,17,3307,215,15,4179,2,4,9,7,8,1,7,1,7,0,False,False,False,0,3,2022-01-05T15:46:41.367,8,False,1.0
2021,17,3307,220,15,914,2,35,7,17,24,7,24,0,24,0,False,False,False,0,3,2022-01-05T15:42:29.35,24,False,0.0
2021,17,3307,230,15,6814,3,5,9,4,0,0,0,0,0,0,False,False,False,0,1,2022-01-05T15:43:10.05,0,False,0.0
2021,17,3307,235,19,4282,13,7,2,17,0,0,0,0,0,0,False,False,False,0,3,2022-01-03T03:14:16.203,0,False,0.0
2021,17,3307,245,19,1212,2,44,3,-1,8,9,3,5,3,0,False,False,False,1,1,2022-01-05T15:35:00.083,8,False,5.0
2021,17,3307,265,19,7914,2,35,10,6,6,0,6,0,6,6,False,False,False,0,3,2022-01-03T03:30:31.66,6,True,0.0
2021,17,3307,290,15,7591,2,26,3,6,11,5,8,3,8,0,False,False,False,0,3,2022-01-05T15:47:49.507,11,False,3.0
2021,17,3307,300,15,957,13,4,9,3,0,0,0,0,0,0,False,False,False,0,2,2022-01-05T15:31:51.86,0,False,0.0
2021,17,3307,310,19,7175,2,5,5,7,8,1,8,0,8,0,False,False,False,0,3,2022-01-03T03:46:32.263,8,False,0.0
2021,17,3307,335,19,4912,2,4,10,5,8,3,7,1,7,0,True,False,False,0,3,2022-01-03T04:02:41.017,8,False,1.0
2021,17,3307,355,19,7175,2,7,3,4,4,0,4,0,4,6,False,False,False,0,3,2022-01-03T04:06:29.563,4,True,0.0
2021,17,3307,370,15,914,2,12,2,22,22,0,22,0,22,0,True,False,False,0,2,2022-01-05T15:30:32.253,22,False,0.0
2021,17,3307,375,15,4179,2,4,3,5,5,0,5,0,5,0,False,False,False,0,2,2022-01-03T04:10:55.197,5,False,0.0
2021,17,3307,400,19,4282,2,6,9,9,12,3,10,2,10,0,False,False,False,0,4,2022-01-03T14:33:12.543,12,False,2.0
2021,17,3307,405,19,5096,2,53,9,-4,20,24,16,4,16,0,False,False,False,0,4,2022-01-03T14:35:15.32,20,False,4.0
2021,17,3307,425,19,7914,2,21,6,20,20,0,20,0,20,6,False,False,False,0,2,2022-02-16T21:36:15.44,20,True,0.0
2021,17,3307,440,15,957,2,50,9,-2,4,6,4,0,4,0,False,False,False,0,2,2022-02-16T21:37:05.15,4,True,0.0
2021,17,3307,445,15,957,2,26,5,2,3,1,3,0,3,0,False,False,False,0,2,2022-01-03T14:57:53.827,3,False,0.0
2021,17,3307,450,15,957,2,18,3,-1,-5,-4,-1,-4,-1,0,False,False,False,1,2,2022-01-05T15:35:13.573,-5,False,-4.0
2021,17,3307,455,15,4886,2,28,3,-3,4,7,2,2,2,0,False,False,False,0,1,2022-01-03T15:03:21.363,4,False,2.0
2021,17,3307,460,15,957,13,12,2,26,0,0,0,0,0,0,False,False,False,0,2,2022-01-03T15:07:50.283,0,False,0.0
2021,17,3307,470,19,7175,2,2,9,12,17,5,15,2,15,0,True,False,False,1,3,2022-02-16T21:37:40.577,17,False,2.0
2021,17,3307,480,19,7175,2,5,10,8,8,0,8,0,8,0,False,False,False,0,3,2022-01-03T15:20:53.207,8,False,0.0
2021,17,3307,485,19,4282,2,32,5,6,8,2,7,1,7,0,True,False,False,0,4,2022-01-05T15:48:10.94,8,False,1.0
2021,17,3307,495,19,4282,13,26,4,3,0,0,0,0,0,0,False,False,False,0,4,2022-01-03T15:29:47.33,0,False,0.0
2021,17,3307,500,19,7914,13,4,10,5,0,0,0,0,0,0,False,False,False,0,3,2022-01-03T15:31:33.16,0,False,0.0
2021,17,3307,535,15,914,13,4,10,13,0,0,0,0,0,0,False,False,False,0,2,2022-01-03T15:40:26.673,0,False,0.0
2021,17,3307,565,15,7591,13,13,9,3,0,0,0,0,0,0,False,False,False,0,3,2022-01-03T15:49:45.413,0,False,0.0
2021,17,3307,575,19,7175,2,5,5,8,8,0,8,0,8,0,False,False,False,0,2,2022-01-05T15:33:56.073,8,False,0.0
2021,17,3307,590,19,7914,13,19,2,35,0,0,0,0,0,0,False,False,False,0,2,2022-01-03T15:55:49.327,0,False,0.0
2021,17,3307,595,19,4912,2,44,3,1,7,6,6,1,6,0,True,False,False,0,3,2022-02-16T21:38:35.463,7,False,1.0
2021,17,3307,600,19,4912,2,47,5,3,7,4,4,3,4,0,False,False,False,0,3,2022-01-03T15:59:21.817,7,False,3.0
2021,17,3307,605,19,7914,13,7,6,41,0,0,0,0,0,0,False,False,False,0,3,2022-01-03T16:01:36.247,0,False,0.0
2021,17,3307,610,19,1212,2,50,9,-2,13,15,5,8,5,0,True,False,False,1,2,2022-01-05T15:35:47.183,13,False,8.0
2021,17,3307,620,19,7914,13,29,5,12,0,0,0,0,0,0,False,False,False,0,2,2022-01-03T16:41:03.223,0,False,0.0
2021,17,3307,625,19,1212,3,46,9,-3,0,0,0,0,0,0,False,False,False,0,1,2022-01-05T14:39:53.253,0,False,0.0
2021,17,3307,640,15,914,13,5,5,5,0,0,0,0,0,0,True,False,False,0,2,2022-02-16T21:39:36.447,0,False,0.0
2021,17,3307,650,15,8343,13,30,5,4,0,0,0,0,0,0,False,False,False,0,4,2022-02-16T21:40:46.19,0,False,0.0
2021,17,3307,665,19,4912,13,5,5,6,0,0,0,0,0,0,False,False,False,0,3,2022-01-03T16:58:23.44,0,False,0.0
2021,17,3307,670,19,4912,2,50,3,-1,46,47,18,28,18,0,False,False,False,1,2,2022-02-16T21:41:48.557,46,False,28.0
2021,17,3307,685,19,4912,2,13,10,2,8,6,4,4,4,0,False,False,False,1,3,2022-01-03T17:03:42.22,8,False,4.0
2021,17,3307,710,15,4179,2,8,9,12,16,4,12,4,12,0,False,False,False,0,2,2022-01-05T14:39:53.253,16,False,4.0
2021,17,3307,720,15,6814,2,4,4,2,6,4,5,1,5,0,False,False,False,0,1,2022-01-05T14:39:53.253,6,False,1.0
2021,17,3307,725,15,4179,2,4,5,7,9,2,8,1,8,0,False,False,False,0,2,2022-01-03T17:22:17.417,9,False,1.0
2021,17,3307,735,15,914,13,4,5,7,0,0,0,0,0,0,False,False,False,0,2,2022-01-03T17:29:22.163,0,False,0.0
2021,17,3307,740,15,4886,2,48,9,-5,28,33,-2,30,-2,6,False,False,False,0,1,2022-01-03T17:31:40.837,28,False,30.0
2021,17,3307,760,19,7177,2,13,9,4,9,5,7,2,7,0,True,False,False,0,3,2022-01-03T17:35:53.413,9,False,2.0
2021,17,3308,15,23,7250,2,2,4,4,14,10,6,8,6,0,False,False,False,0,3,2022-01-03T10:45:13.533,14,False,8.0
2021,17,3308,25,23,4949,2,5,5,5,5,0,5,0,5,0,False,False,False,0,3,2022-01-03T10:48:31.47,5,True,0.0
2021,17,3308,30,23,7250,2,5,3,3,7,4,7,0,7,0,True,False,False,0,3,2022-01-03T10:50:43.923,7,False,0.0
2021,17,3308,35,23,7250,2,46,3,3,3,0,3,0,3,0,True,False,False,0,3,2022-01-03T10:52:42.507,3,False,0.0
2021,17,3308,50,23,7241,2,45,5,-5,11,16,5,6,5,0,False,False,False,1,1,2022-01-05T17:06:46.903,11,False,6.0
2021,17,3308,90,14,7583,13,6,4,12,0,0,0,0,0,0,False,False,False,0,3,2022-01-05T17:11:07.207,0,False,0.0
2021,17,3308,100,23,7241,2,46,9,-2,-2,0,-2,0,-2,0,False,False,False,0,1,2022-01-05T17:02:34.233,-2,False,0.0
2021,17,3308,110,23,967,13,19,2,44,0,0,0,0,0,0,False,False,False,0,2,2022-01-05T17:02:48.743,0,False,0.0
2021,17,3308,125,14,7582,13,48,9,-4,0,0,0,0,0,0,False,False,False,0,1,2022-02-16T21:09:09.207,0,False,0.0
2021,17,3308,130,14,1114,13,4,3,8,0,0,0,0,0,0,False,False,False,0,2,2022-01-03T11:34:01.867,0,False,0.0
2021,17,3308,155,23,4949,2,4,3,7,11,4,8,3,8,0,True,False,False,0,2,2022-01-03T11:45:18.69,11,False,3.0
2021,17,3308,210,14,6543,2,34,4,-4,8,12,1,7,1,0,True,False,False,1,3,2022-01-03T12:00:22,8,False,
2021,17,3308,215,14,7584,2,4,10,5,8,3,6,2,6,0,False,False,False,0,3,2022-01-03T12:02:37.57,8,False,2.0
2021,17,3308,220,14,5197,13,32,3,0,0,0,0,0,0,0,False,False,False,1,3,2022-01-05T17:07:47.883,0,False,0.0
2021,17,3308,235,23,7241,2,46,3,4,4,0,4,0,4,0,False,False,False,0,1,2022-01-03T12:09:39.647,4,False,0.0
2021,17,3308,245,23,967,13,12,5,12,0,0,0,0,0,0,False,False,False,0,3,2022-01-05T17:04:11.143,0,False,0.0
2021,17,3308,265,14,5197,2,4,9,10,10,0,10,0,10,0,False,False,False,0,3,2022-01-03T12:20:04.077,10,False,
2021,17,3308,270,14,4449,13,3,6,20,0,0,0,0,0,0,False,False,False,0,2,2022-02-16T21:11:28.267,0,False,0.0
2021,17,3308,280,23,4949,2,6,7,24,26,2,25,1,25,0,False,False,False,0,3,2022-01-03T12:26:38.277,26,False,1.0
2021,17,3308,300,23,7250,2,4,9,4,12,8,8,4,8,0,False,False,False,1,3,2022-01-05T17:33:25.323,12,False,4.0
2021,17,3308,355,14,6543,2,28,4,4,5,1,5,0,5,0,False,False,False,0,1,2022-01-03T12:43:35.59,5,False,0.0
2021,17,3308,360,14,5197,2,7,2,16,17,1,17,0,17,0,False,False,False,0,3,2022-01-03T12:45:26.47,17,False,0.0
2021,17,3308,365,14,7584,2,6,5,4,7,3,5,2,5,0,False,False,False,1,2,2022-01-05T16:07:28.697,7,False,2.0
2021,17,3308,370,14,6543,2,47,5,3,6,3,4,2,4,0,False,False,False,0,1,2022-01-03T12:49:47.08,6,False,2.0
2021,17,3308,375,14,4449,2,39,4,6,8,2,6,2,6,0,False,False,False,0,3,2022-01-03T12:51:21.303,8,False,2.0
2021,17,3308,380,14,5197,2,47,5,4,4,0,4,0,4,0,False,False,False,0,3,2022-01-03T12:52:44.62,4,True,0.0
2021,17,3308,385,14,7584,2,2,10,10,12,2,11,1,11,0,False,False,False,0,3,2022-01-03T12:54:25.473,12,False,1.0
2021,17,3308,400,14,7495,13,35,5,1,0,0,0,0,0,0,False,False,False,0,3,2022-01-03T12:57:55.137,0,False,0.0
2021,17,3308,445,14,5197,2,32,5,2,7,5,7,0,7,0,True,True,False,0,4,2022-01-03T13:15:44.6,7,False,0.0
2021,17,3308,460,14,1114,2,12,2,45,45,0,45,0,45,6,False,False,False,0,2,2022-01-03T13:25:03.237,45,True,0.0
2021,17,3308,475,23,4949,2,5,5,5,5,0,5,0,5,0,False,False,False,0,3,2022-01-03T13:27:25.22,5,False,0.0
2021,17,3308,485,23,4949,2,5,3,0,4,4,3,1,3,0,True,False,False,0,3,2022-01-05T17:17:18.35,4,False,1.0
2021,17,3308,505,23,4949,13,6,9,14,0,0,0,0,0,0,False,False,False,0,3,2022-01-03T14:21:24.26,0,False,0.0
2021,17,3308,520,14,7584,2,44,3,-4,5,9,5,0,5,0,False,False,False,0,3,2022-01-05T17:16:59.423,5,False,0.0
2021,17,3308,545,23,967,2,47,5,2,5,3,4,1,4,0,False,False,False,0,3,2022-01-03T14:37:23.22,5,False,1.0
2021,17,3308,550,23,3843,2,28,10,1,19,18,6,13,6,0,False,False,False,3,1,2022-01-05T17:05:18.86,19,False,13.0
2021,17,3308,555,23,7250,13,35,2,33,0,0,0,0,0,0,False,False,False,0,3,2022-01-03T14:41:15.88,0,False,0.0
2021,17,3308,560,23,4949,2,5,3,6,13,7,13,0,13,0,False,False,False,0,2,2022-01-03T14:44:37.52,13,False,0.0
2021,17,3308,565,23,4949,13,24,10,10,0,0,0,0,0,0,False,False,False,0,3,2022-01-03T14:46:52.903,0,False,0.0
2021,17,3308,575,23,3708,2,4,9,4,7,3,5,2,5,0,False,False,False,0,1,2022-01-03T14:51:46.477,7,False,2.0
2021,17,3308,580,23,7689,13,8,4,13,0,0,0,0,0,0,False,False,False,0,2,2022-01-03T14:53:31.837,0,False,0.0
2021,17,3308,590,14,7584,2,50,10,-4,3,7,1,2,1,0,False,False,False,0,2,2022-01-04T21:39:24.44,3,False,2.0
2021,17,3308,600,14,7582,13,12,10,2,0,0,0,0,0,0,False,False,False,0,1,2022-02-24T19:58:52.963,0,False,0.0
2021,17,3308,605,14,1114,13,9,6,17,0,0,0,0,0,0,False,False,False,0,2,2022-01-03T15:00:07.113,0,False,0.0
2021,17,3308,620,23,4949,2,8,6,36,42,6,42,0,42,0,False,False,False,0,3,2022-02-16T21:13:14.57,42,False,0.0
2021,17,3308,630,23,3708,2,46,3,2,2,0,2,0,2,0,False,False,False,0,1,2022-01-03T15:07:09.97,2,False,0.0
2021,17,3308,635,23,7250,2,5,9,5,5,0,5,0,5,0,False,False,False,0,1,2022-01-03T15:09:04.967,5,False,0.0
2021,17,3308,640,23,7250,2,8,10,11,11,0,11,0,11,6,False,False,False,0,2,2022-01-03T15:11:16.297,11,True,0.0
2021,17,3308,675,14,7584,2,6,10,6,12,6,7,5,7,0,False,False,False,0,2,2022-01-03T15:22:26.333,12,False,5.0
2021,17,3308,685,14,5197,13,12,4,10,0,0,0,0,0,0,False,False,False,0,4,2022-01-05T17:09:34.987,0,False,0.0
2021,17,3308,695,14,4449,13,4,10,11,0,0,0,0,0,0,False,False,False,0,3,2022-01-03T15:29:09.07,0,False,
2021,17,3308,710,14,7582,2,28,4,3,6,3,3,3,3,0,False,False,False,0,1,2022-01-03T15:33:24.943,6,False,3.0
2021,17,3308,720,14,6543,2,50,9,-4,0,4,-3,3,-3,0,True,False,False,1,3,2022-01-05T17:09:52.867,0,False,3.0
2021,17,3308,725,14,6543,2,32,10,-2,3,5,0,3,0,0,False,False,False,0,1,2022-01-04T21:41:16.347,3,False,3.0
2021,17,3308,745,23,7246,2,5,5,4,9,5,6,3,6,0,False,False,False,0,3,2022-01-03T15:42:13.17,9,False,3.0
2021,17,3308,750,23,7241,2,28,10,0,4,4,3,1,3,0,False,False,False,0,1,2022-01-03T15:43:50.943,4,False,1.0
2021,17,3308,755,23,4949,2,8,10,12,14,2,12,2,12,0,False,False,False,0,2,2022-01-03T15:46:18.803,14,False,2.0
2021,17,3308,765,23,7250,13,12,2,16,0,0,0,0,0,0,False,False,False,0,3,2022-01-03T15:48:27.703,0,False,0.0
2021,17,3308,770,23,7689,13,6,10,10,0,0,0,0,0,0,False,False,False,0,2,2022-01-03T15:51:21.027,0,False,0.0
2021,17,3308,775,23,7250,2,12,8,18,24,6,19,5,19,0,False,False,False,0,3,2022-02-24T19:59:16.893,24,True,5.0
2021,17,3309,15,16,374,2,39,4,2,8,6,6,2,6,0,False,False,False,0,3,2022-01-03T10:19:00.147,8,False,2.0
2021,17,3309,35,7,2631,2,47,5,2,11,9,9,2,9,0,False,False,False,0,4,2022-01-03T10:23:55.18,11,False,2.0
2021,17,3309,40,7,8317,2,12,5,4,4,0,4,0,4,0,False,False,False,0,3,2022-02-24T20:00:25.45,4,False,0.0
2021,17,3309,50,16,374,13,12,2,37,0,0,0,0,0,0,False,False,False,0,4,2022-02-24T20:00:35.977,0,False,
2021,17,3309,60,16,3938,2,39,4,5,6,1,4,2,4,0,False,False,False,0,3,2022-01-05T17:53:38.377,6,False,2.0
2021,17,3309,65,16,6499,2,11,9,0,1,1,1,0,1,0,False,False,False,0,1,2022-01-03T10:36:17.83,1,False,0.0
2021,17,3309,75,16,4143,2,23,8,29,29,0,29,0,29,6,False,False,False,0,2,2022-01-03T10:44:31.067,29,True,0.0
2021,17,3309,100,7,4679,2,51,5,-5,3,8,3,0,3,0,True,False,False,0,1,2022-01-03T10:49:34.297,3,False,0.0
2021,17,3309,105,7,4455,2,28,5,2,10,8,9,1,9,0,True,False,False,0,1,2022-01-04T17:10:44.187,10,False,1.0
2021,17,3309,115,16,374,2,30,9,-2,7,9,7,0,7,0,False,False,False,0,4,2022-01-03T10:56:35.3,7,False,0.0
2021,17,3309,120,16,3938,2,2,4,10,17,7,17,0,17,0,False,False,False,0,3,2022-01-03T10:57:55.15,17,False,0.0
2021,17,3309,125,16,374,2,17,1,18,19,1,18,1,18,0,False,False,False,0,3,2022-01-03T11:00:14.24,19,False,
2021,17,3309,130,16,2568,2,12,8,16,24,8,22,2,22,0,False,False,False,0,3,2022-02-24T20:01:12.097,24,False,2.0
2021,17,3309,145,16,3938,13,35,5,3,0,0,0,0,0,0,False,False,False,0,3,2022-01-04T19:48:18.673,0,False,0.0
2021,17,3309,150,16,374,2,38,9,3,3,0,3,0,3,6,False,False,False,0,4,2022-01-03T11:09:40.603,3,True,0.0
2021,17,3309,170,7,8317,2,5,3,11,72,61,72,0,72,6,False,False,False,1,3,2022-01-05T17:34:30.673,72,True,0.0
2021,17,3309,190,16,6500,2,39,4,3,3,0,3,0,3,0,False,False,False,0,3,2022-01-03T11:18:53.563,3,False,0.0
2021,17,3309,200,16,5039,13,7,2,18,0,0,0,0,0,0,False,False,False,0,2,2022-01-03T11:21:36.133,0,False,0.0
2021,17,3309,210,16,3938,13,9,6,27,0,0,0,0,0,0,False,False,False,0,3,2022-01-03T11:31:56.327,0,False,0.0
2021,17,3309,215,16,7176,2,7,6,35,53,18,53,0,53,0,False,False,False,0,3,2022-01-03T11:33:46.67,53,False,0.0
2021,17,3309,220,16,2568,2,53,9,-3,7,10,5,2,5,0,False,False,False,0,4,2022-01-03T11:35:21.027,7,False,2.0
2021,17,3309,225,16,374,2,26,5,3,3,0,3,0,3,0,True,False,False,0,2,2022-01-03T11:36:43.89,3,False,0.0
2021,17,3309,245,7,8317,2,3,3,10,8,-2,8,0,8,0,False,False,False,0,2,2022-01-03T11:40:28.25,8,False,0.0
2021,17,3309,255,7,4679,2,4,4,3,8,5,6,2,6,0,False,False,False,1,1,2022-01-03T11:42:56.77,8,False,2.0
2021,17,3309,265,7,8317,2,49,3,-1,9,10,-2,11,-2,0,False,False,False,2,2,2022-01-03T11:45:09.073,9,False,11.0
2021,17,3309,280,7,8317,13,2,3,5,0,0,0,0,0,0,False,False,False,0,2,2022-01-03T11:49:43.393,0,False,
2021,17,3309,285,7,8317,13,19,2,33,0,0,0,0,0,0,False,False,False,0,2,2022-01-03T11:51:16.36,0,False,0.0
2021,17,3309,290,7,3521,2,7,2,16,17,1,17,0,17,0,False,False,False,0,3,2022-01-05T17:35:00.843,17,False,0.0
2021,17,3309,295,7,8317,2,29,2,18,18,0,18,0,18,6,False,False,False,0,2,2022-01-03T11:54:11.837,18,True,0.0
2021,17,3309,320,16,3938,2,46,3,-2,2,4,1,1,1,0,True,False,False,0,4,2022-01-03T12:12:53.443,2,False,1.0
2021,17,3309,325,16,374,2,6,4,4,4,0,4,0,4,0,False,False,False,0,3,2022-01-05T16:43:01.73,4,False,0.0
2021,17,3309,330,16,6500,2,35,2,25,27,2,27,0,27,0,True,False,False,0,3,2022-01-04T19:49:27.28,27,False,0.0
2021,17,3309,335,16,6499,2,32,3,-2,7,9,5,2,5,0,False,False,False,0,1,2022-01-03T12:18:43.233,7,False,2.0
2021,17,3309,365,7,3521,13,49,9,-1,0,0,0,0,0,0,False,False,False,0,2,2022-01-03T12:25:05.3,0,False,0.0
2021,17,3309,370,7,4679,2,45,5,-3,6,9,4,2,4,0,False,False,False,0,1,2022-01-03T12:26:37.88,6,False,2.0
2021,17,3309,380,7,2631,2,5,5,4,7,3,7,0,7,0,False,False,False,0,3,2022-01-03T12:27:50.913,7,False,0.0
2021,17,3309,385,7,7659,2,13,9,3,6,3,3,3,3,0,False,False,False,1,3,2022-01-05T17:49:08.127,6,False,3.0
2021,17,3309,390,7,3521,13,2,4,9,0,0,0,0,0,0,False,False,False,0,3,2022-01-03T12:30:14.01,0,False,0.0
2021,17,3309,395,7,8317,13,29,3,14,0,0,0,0,0,0,False,False,False,0,2,2022-01-03T12:31:27.99,0,False,
2021,17,3309,400,7,2631,2,4,10,5,4,-1,4,0,4,0,False,False,False,0,4,2022-01-03T12:33:07.293,4,False,0.0
2021,17,3309,405,7,2631,2,47,5,2,10,8,7,3,7,0,False,False,False,0,4,2022-01-03T12:34:10.503,10,False,3.0
2021,17,3309,410,7,2631,13,5,5,11,0,0,0,0,0,0,False,False,False,0,3,2022-01-03T12:35:44.403,0,False,0.0
2021,17,3309,420,7,2631,13,31,9,3,0,0,0,0,0,0,False,False,False,0,1,2022-01-03T12:39:54.18,0,False,0.0
2021,17,3309,440,16,7417,2,48,9,-5,8,13,4,4,4,0,True,False,False,1,1,2022-01-05T17:49:21.463,8,False,4.0
2021,17,3309,450,16,3938,13,12,7,59,0,0,0,0,0,0,False,False,False,0,3,2022-02-24T20:02:32.563,0,False,0.0
2021,17,3309,480,7,3521,2,51,10,-1,5,6,1,4,1,0,False,False,False,1,3,2022-01-05T17:47:35.183,5,False,4.0
2021,17,3309,485,7,8317,2,19,6,24,69,45,69,0,69,6,False,False,False,0,2,2022-01-03T12:51:34.413,69,True,0.0
2021,17,3309,500,16,6500,2,6,10,5,5,0,5,0,5,0,False,False,False,0,2,2022-01-03T13:25:20.75,5,False,0.0
2021,17,3309,520,16,374,13,12,5,13,0,0,0,0,0,0,False,False,False,0,3,2022-01-03T13:30:33.133,0,False,0.0
2021,17,3309,525,16,6500,13,5,3,8,0,0,0,0,0,0,False,False,False,0,3,2022-01-03T13:32:20.4,0,False,0.0
2021,17,3309,535,7,4679,2,48,10,0,22,22,20,2,20,0,False,False,False,0,1,2022-01-03T15:17:20.9,15,False,2.0
2021,17,3309,555,7,4679,3,51,10,-4,0,0,0,0,0,0,True,False,False,0,3,2022-01-04T17:09:26.273,0,False,0.0
2021,17,3309,560,7,8317,2,3,3,7,6,-1,6,0,6,0,False,False,False,0,2,2022-01-03T13:49:01.483,6,False,0.0
2021,17,3309,570,7,7659,2,50,10,-3,17,20,5,12,5,0,False,False,False,2,3,2022-01-05T17:50:25.567,17,False,12.0
2021,17,3309,575,7,7659,13,2,5,6,0,0,0,0,0,0,False,False,False,0,2,2022-01-03T13:52:03.87,0,False,0.0
2021,17,3309,595,16,6499,2,32,10,-1,11,12,10,1,10,0,False,False,False,0,1,2022-01-03T15:14:09.617,11,False,1.0
2021,17,3309,600,16,374,13,4,4,13,0,0,0,0,0,0,False,False,False,0,3,2022-01-03T13:58:42.417,0,False,0.0
2021,17,3309,620,16,2568,2,12,10,11,11,0,11,0,11,0,False,False,False,0,4,2022-01-05T19:09:14.95,11,False,
2021,17,3309,625,16,8537,2,32,3,4,6,2,6,0,6,0,False,False,False,0,4,2022-01-05T17:38:43.223,6,False,0.0
2021,17,3309,635,7,4679,2,6,3,4,4,0,4,0,4,0,False,False,False,0,2,2022-01-03T14:08:00.643,4,False,0.0
2021,17,3309,650,7,7659,13,9,6,18,0,0,0,0,0,0,False,False,False,0,3,2022-01-05T17:39:04.243,0,False,
2021,17,3309,655,7,7659,2,19,2,35,39,4,37,2,37,0,False,False,False,0,2,2022-01-03T14:17:55.287,39,False,2.0
2021,17,3309,660,7,8317,2,50,3,-1,10,11,6,4,6,0,False,False,False,0,2,2022-01-03T14:19:03.01,10,False,4.0
2021,17,3309,680,7,8317,2,44,3,-5,5,10,-3,8,-3,0,True,False,False,0,3,2022-01-03T14:22:20.16,5,False,8.0
2021,17,3309,685,7,4679,2,51,10,-6,2,8,2,0,2,0,False,False,False,0,1,2022-01-03T14:24:05.237,2,False,0.0
2021,17,3309,690,7,3521,2,5,3,5,5,0,5,0,5,6,False,False,False,0,3,2022-01-03T14:28:27.01,5,False,0.0
2021,17,3309,710,16,1989,2,4,3,5,5,0,5,0,5,0,False,False,False,0,2,2022-01-03T14:32:54.97,5,False,0.0
2021,17,3309,720,16,3938,2,39,4,5,6,1,6,0,6,0,False,False,False,0,3,2022-01-03T14:35:02.547,6,False,0.0
2021,17,3309,730,16,2568,2,46,3,-1,4,5,3,1,3,0,False,False,False,0,4,2022-01-03T14:39:36.84,4,False,1.0
2021,17,3309,735,16,3938,2,5,3,8,8,0,8,0,8,0,False,False,False,0,3,2022-01-03T14:40:35.56,8,False,0.0
2021,17,3309,740,16,3938,2,13,4,1,1,0,1,0,1,0,True,False,False,0,3,2022-01-03T14:41:38.22,1,False,0.0
2021,17,3309,745,16,4143,2,18,3,2,4,2,4,0,4,0,False,False,False,0,2,2022-01-05T16:49:59.007,4,False,0.0
2021,17,3309,750,16,3938,13,5,5,11,0,0,0,0,0,0,False,False,False,0,3,2022-01-05T18:01:13.717,0,False,0.0
2021,17,3309,765,7,3521,2,6,10,5,9,4,7,2,7,0,False,False,False,0,3,2022-01-03T14:46:37.247,9,False,2.0
2021,17,3309,775,7,4679,2,5,10,0,2,2,1,1,1,0,False,False,False,0,1,2022-01-03T14:48:22.587,2,False,1.0
2021,17,3309,780,7,8317,2,9,2,23,35,12,24,11,24,0,False,False,False,0,2,2022-01-03T14:49:41.467,35,False,11.0
2021,17,3309,795,7,7659,13,29,6,25,0,0,0,0,0,0,False,False,False,0,2,2022-01-03T14:53:44.06,0,False,0.0
2021,17,3309,800,7,8317,2,29,2,23,30,7,27,3,27,0,False,False,False,0,2,2022-01-03T14:54:48.883,30,False,3.0
2021,17,3309,860,7,4679,2,28,3,-7,0,7,-3,3,-3,0,False,False,False,0,1,2022-01-05T17:44:20.293,0,False,
2021,17,3309,865,7,3521,13,5,9,1,0,0,0,0,0,0,False,False,False,0,3,2022-01-03T15:05:32.843,0,False,
2021,17,3310,55,21,4492,13,2,1,10,0,0,0,0,0,0,False,False,False,0,2,2022-01-05T20:34:05.543,0,False,0.0
2021,17,3310,65,6,7725,2,51,10,-3,3,6,1,2,1,0,False,False,False,0,3,2022-01-03T11:28:45.773,3,False,2.0
2021,17,3310,70,6,6786,2,28,4,4,11,7,7,4,7,0,True,False,False,2,1,2022-01-03T11:30:49.07,11,False,4.0
2021,17,3310,80,6,7725,13,47,5,1,0,0,0,0,0,0,True,False,False,0,3,2022-02-16T20:02:13.497,0,False,0.0
2021,17,3310,85,6,7728,2,5,10,7,8,1,8,0,8,0,False,False,False,0,4,2022-01-03T11:37:01.057,8,False,0.0
2021,17,3310,90,6,7725,2,35,10,4,4,0,4,0,4,6,False,False,False,0,2,2022-01-03T11:38:50.063,4,True,0.0
2021,17,3310,155,6,2714,2,32,3,2,4,2,3,1,3,0,False,False,False,0,4,2022-01-05T20:28:45.96,4,False,1.0
2021,17,3310,190,21,3957,2,12,4,-8,4,12,3,1,3,0,True,False,False,0,1,2022-01-04T21:45:21.727,4,False,1.0
2021,17,3310,205,6,7728,13,30,5,0,0,0,0,0,0,0,True,False,False,0,4,2022-01-03T12:12:43.363,0,False,0.0
2021,17,3310,215,6,7725,13,19,6,26,0,0,0,0,0,0,False,False,False,0,3,2022-01-03T12:17:02.543,0,False,0.0
2021,17,3310,290,6,6786,2,4,10,3,6,3,5,1,5,0,True,False,False,0,1,2022-01-03T12:43:33.02,6,False,1.0
2021,17,3310,315,6,3233,2,11,6,15,23,8,21,2,21,0,True,False,False,0,3,2022-01-05T21:03:23.4,23,False,2.0
2021,17,3310,320,6,464,13,4,5,4,0,0,0,0,0,0,False,False,False,0,2,2022-01-04T21:24:04.993,0,False,0.0
2021,17,3310,350,6,1378,13,35,5,10,0,0,0,0,0,0,False,False,False,0,3,2022-01-03T13:03:08.747,0,False,0.0
2021,17,3310,360,6,1378,13,35,10,3,0,0,0,0,0,0,False,False,False,0,3,2022-01-03T16:25:40.267,0,False,0.0
2021,17,3310,405,6,7725,2,4,8,15,18,3,15,3,15,0,False,False,False,1,3,2022-01-05T20:39:51.85,18,False,3.0
2021,17,3310,415,6,7725,13,8,2,42,0,0,0,0,0,0,False,False,False,0,3,2022-01-05T21:08:08.807,0,False,0.0
2021,17,3310,420,6,7725,2,4,3,13,17,4,16,1,16,0,False,False,False,0,3,2022-01-03T13:38:32.347,17,False,1.0
2021,17,3310,430,6,1400,3,16,9,4,0,0,0,0,0,0,False,False,False,0,1,2022-01-03T13:51:26.253,0,False,0.0
2021,17,3310,435,6,464,2,4,9,4,4,0,4,0,4,0,False,False,False,0,3,2022-01-03T13:52:59.887,4,False,0.0
2021,17,3310,470,6,7728,2,55,4,-2,6,8,3,3,3,0,True,False,False,0,4,2022-01-05T20:01:55.237,6,False,3.0
2021,17,3310,475,6,7725,2,2,10,7,16,9,16,0,16,0,False,False,False,0,3,2022-01-05T21:04:12.323,16,False,0.0
2021,17,3310,485,6,7725,2,51,5,-3,8,11,3,5,3,0,False,False,False,1,3,2022-01-05T21:04:30.287,8,False,5.0
2021,17,3310,490,6,464,2,5,5,7,8,1,8,0,8,0,False,False,False,0,3,2022-01-05T21:04:46.513,8,False,0.0
2021,17,3310,495,6,666,13,24,2,25,0,0,0,0,0,0,False,False,False,0,4,2022-01-05T20:58:08.01,0,False,0.0
2021,17,3310,515,6,7728,13,5,3,14,0,0,0,0,0,0,False,False,False,0,4,2022-01-03T16:23:52.213,0,False,
2021,17,3310,560,21,3957,13,11,5,11,0,0,0,0,0,0,False,False,False,0,1,2022-01-03T14:52:12.207,0,False,0.0
2021,17,3310,580,6,7725,13,4,2,21,0,0,0,0,0,0,False,False,False,0,2,2022-01-05T20:58:39.277,0,False,0.0
2021,17,3310,585,6,7725,13,2,10,7,0,0,0,0,0,0,False,False,False,0,3,2022-01-03T15:00:50.857,0,False,0.0
2021,17,3310,590,6,7728,2,53,10,-1,11,12,7,4,7,0,False,False,False,0,3,2022-01-05T21:05:39.427,11,False,4.0
2021,17,3310,610,21,4422,2,30,10,-2,12,14,11,1,11,0,False,False,False,0,4,2022-01-03T15:08:17.447,12,False,1.0
2021,17,3310,635,6,464,13,6,7,23,0,0,0,0,0,0,False,False,False,0,2,2022-01-04T21:24:52.223,0,False,0.0
2021,17,3310,650,21,3389,13,13,9,7,0,0,0,0,0,0,True,False,False,0,3,2022-04-27T19:53:57.73,0,False,0.0
2021,17,3310,675,6,464,2,2,10,5,10,5,8,2,8,0,False,False,False,0,2,2022-01-05T20:41:46.977,10,False,2.0
2021,17,3310,680,6,7725,2,51,3,-3,3,6,1,2,1,0,False,False,False,0,3,2022-01-03T15:26:45.68,3,False,2.0
2021,17,3310,685,6,3233,13,18,5,-1,0,0,0,0,0,0,False,False,False,0,2,2022-01-03T15:27:59.38,0,False,0.0
2021,17,3310,690,6,464,2,2,9,3,13,10,8,5,8,0,False,False,False,0,3,2022-01-05T21:06:31.403,13,False,5.0
2021,17,3310,700,6,7725,13,2,10,-3,0,0,0,0,0,0,False,False,False,0,3,2022-01-05T20:52:01.967,0,False,0.0
2021,17,3310,725,21,6981,2,35,3,10,12,2,12,0,12,0,False,False,False,0,3,2022-01-05T20:33:46.933,12,False,0.0
2021,17,3310,740,21,3957,2,48,9,-4,-4,0,-4,0,-4,0,False,False,False,0,1,2022-03-03T14:05:00.063,-4,False,0.0
2021,17,3310,745,21,4422,3,6,10,5,0,0,0,0,0,0,False,False,False,0,4,2022-01-03T15:48:46.823,0,False,0.0
2021,17,3310,770,21,6228,3,48,9,-6,0,0,0,0,0,0,False,False,False,0,1,2022-01-04T21:43:41.313,0,False,0.0
2021,17,3310,775,21,813,13,6,10,14,0,0,0,0,0,0,False,False,False,0,3,2022-01-03T15:57:10.817,0,False,0.0
2021,17,3310,815,21,3389,13,16,9,8,0,0,0,0,0,0,False,False,False,0,3,2022-01-03T16:07:38.447,0,False,0.0
2021,17,3310,840,6,7728,13,33,4,9,0,0,0,0,0,0,False,False,False,0,4,2022-01-05T20:27:19.02,0,False,0.0
2021,17,3311,10,2,8389,2,53,9,-4,8,12,4,4,4,0,False,False,False,0,4,2022-01-03T10:20:03.23,8,False,4.0
2021,17,3311,20,2,811,2,50,9,-2,15,17,4,11,4,0,False,False,False,1,2,2022-01-05T16:29:58.85,15,False,11.0
2021,17,3311,30,2,7303,2,45,5,0,0,0,0,0,0,0,True,False,False,0,3,2022-01-03T10:26:41.43,0,False,0.0
2021,17,3311,35,2,8389,13,19,2,24,0,0,0,0,0,0,False,False,False,0,2,2022-01-05T16:26:10.667,0,False,0.0
2021,17,3311,55,2,6247,13,20,6,35,0,0,0,0,0,0,False,False,False,0,3,2022-01-03T10:39:09.727,0,False,0.0
2021,17,3311,70,4,594,2,4,10,9,13,4,13,0,13,0,False,False,False,0,3,2022-01-03T10:44:08.827,13,False,0.0
2021,17,3311,75,4,7646,2,4,10,5,15,10,15,0,15,0,False,False,False,0,3,2022-01-03T10:45:17.567,15,False,0.0
2021,17,3311,80,4,6983,3,4,10,2,0,0,0,0,0,0,False,False,False,0,1,2022-01-03T10:47:18.233,0,False,0.0
2021,17,3311,85,4,2853,2,3,5,11,11,0,11,0,11,0,False,False,False,0,2,2022-01-03T10:48:41.89,11,False,0.0
2021,17,3311,90,4,6953,13,31,10,-6,0,0,0,0,0,0,False,False,False,0,3,2022-01-03T10:50:47.85,0,False,0.0
2021,17,3311,95,4,594,3,4,4,6,0,0,0,0,0,0,False,False,False,0,3,2022-01-03T10:52:23.813,0,False,0.0
2021,17,3311,100,4,7646,2,6,7,15,15,0,15,0,15,0,False,False,False,0,2,2022-02-16T19:48:23.703,15,False,0.0
2021,17,3311,115,4,2853,2,13,5,4,5,1,5,0,5,0,False,False,False,0,3,2022-01-03T10:57:46.613,5,False,0.0
2021,17,3311,120,4,6953,13,17,10,4,0,0,0,0,0,0,False,False,False,0,3,2022-01-04T18:33:34.787,0,False,
2021,17,3311,125,4,5119,2,50,3,-1,6,7,4,2,4,0,False,False,False,0,2,2022-01-03T11:01:37.117,6,False,2.0
2021,17,3311,130,4,2853,13,12,5,3,0,0,0,0,0,0,False,False,False,0,3,2022-02-24T20:04:25.993,0,False,0.0
2021,17,3311,135,4,2853,3,2,9,3,0,0,0,0,0,0,False,False,False,0,3,2022-01-03T11:05:05.493,0,False,0.0
2021,17,3311,140,4,2853,13,2,10,3,0,0,0,0,0,0,False,False,False,0,2,2022-01-03T11:06:28.163,0,False,
2021,17,3311,145,4,4947,13,33,9,1,0,0,0,0,0,0,False,False,False,0,4,2022-01-03T11:09:56.553,0,False,0.0
2021,17,3311,175,4,594,13,12,3,4,0,0,0,0,0,0,False,False,False,0,3,2022-01-03T11:18:31.453,0,False,0.0
2021,17,3311,185,4,7646,2,19,3,10,10,0,10,0,10,0,False,False,False,0,2,2022-01-04T18:33:34.787,10,False,0.0
2021,17,3311,215,2,811,2,51,3,-6,9,15,8,1,8,0,False,False,False,0,1,2022-01-03T11:33:03.627,9,False,1.0
2021,17,3311,240,2,7540,2,12,10,1,10,9,8,2,8,0,True,False,False,0,4,2022-02-24T20:04:41.977,10,False,2.0
2021,17,3311,250,2,8389,13,26,4,1,0,0,0,0,0,0,False,False,False,0,4,2022-01-05T16:35:00.017,0,False,0.0
2021,17,3311,255,2,811,2,51,10,0,2,2,2,0,2,0,True,False,False,0,4,2022-01-03T11:44:19.8,2,False,
2021,17,3311,290,4,6953,13,9,2,22,0,0,0,0,0,0,False,False,False,0,3,2022-01-03T11:56:18.09,0,False,0.0
2021,17,3311,295,4,2853,2,12,10,12,13,1,12,1,12,0,False,False,False,0,3,2022-01-05T16:27:14.893,13,False,1.0
2021,17,3311,340,4,594,13,12,5,8,0,0,0,0,0,0,False,False,False,0,3,2022-01-05T16:30:38.733,0,False,0.0
2021,17,3311,345,2,8389,2,35,7,18,61,43,19,42,19,0,True,False,False,1,3,2022-01-03T12:21:34.48,61,False,42.0
2021,17,3311,395,4,594,13,17,8,26,0,0,0,0,0,0,False,False,False,0,3,2022-01-03T12:32:40.153,0,False,0.0
2021,17,3311,415,2,7303,13,46,3,3,0,0,0,0,0,0,True,False,False,0,4,2022-01-03T12:37:20.657,0,False,
2021,17,3311,420,2,8397,13,19,6,33,0,0,0,0,0,0,False,False,False,0,2,2022-02-22T18:55:15.653,0,False,0.0
2021,17,3311,425,2,2554,2,4,4,3,15,12,9,6,9,0,False,False,False,1,1,2022-01-03T12:43:42.997,15,False,6.0
2021,17,3311,435,2,6247,2,50,10,-3,24,27,20,4,20,0,False,False,False,0,3,2022-01-03T12:45:25.527,24,False,4.0
2021,17,3311,475,4,5119,13,5,10,7,0,0,0,0,0,0,False,False,False,0,3,2022-01-03T13:10:07.203,0,False,0.0
2021,17,3311,485,4,2853,13,6,10,11,0,0,0,0,0,0,False,False,False,0,2,2022-01-04T18:33:34.787,0,False,0.0
2021,17,3311,505,2,2554,3,12,9,-2,0,0,0,0,0,0,False,False,False,0,1,2022-01-03T13:19:21.96,0,False,0.0
2021,17,3311,545,4,594,2,4,10,5,9,4,8,1,8,0,False,False,False,0,3,2022-01-03T13:28:20.75,9,False,1.0
2021,17,3311,590,2,7540,2,38,10,3,4,1,4,0,4,0,False,False,False,0,4,2022-01-03T13:40:16.413,4,False,0.0
2021,17,3311,605,2,7303,13,5,5,13,0,0,0,0,0,0,False,False,False,0,4,2022-01-05T16:37:58.85,0,False,0.0
2021,17,3311,615,4,2853,2,4,3,7,15,8,8,7,8,0,False,False,False,2,2,2022-02-16T19:54:16.34,15,False,7.0
2021,17,3311,620,4,2853,13,12,8,50,0,0,0,0,0,0,False,False,False,0,2,2022-01-03T14:12:49.703,0,False,0.0
2021,17,3311,660,4,2853,2,12,5,8,8,0,8,0,8,0,False,False,False,0,2,2022-01-03T14:32:04.867,8,False,0.0
2021,17,3311,700,2,7303,2,5,3,8,8,0,8,0,8,0,False,False,False,0,3,2022-01-03T14:42:14.31,8,False,0.0
2021,17,3311,705,2,6247,13,6,10,8,0,0,0,0,0,0,False,False,False,0,3,2022-01-03T14:44:06.47,0,False,
2021,17,3311,715,2,6247,2,6,10,13,15,2,15,0,15,0,False,False,False,0,3,2022-01-05T16:39:30.393,15,False,0.0
2021,17,3311,725,2,7540,2,12,10,7,17,10,15,2,15,0,False,False,False,0,4,2022-01-03T14:50:26.757,17,False,2.0
2021,17,3311,730,2,6247,2,17,10,10,11,1,11,0,11,0,True,False,False,0,3,2022-01-03T14:53:23.693,11,False,0.0
2021,17,3311,745,2,6247,13,24,6,16,0,0,0,0,0,0,False,False,False,0,3,2022-01-03T14:58:32.267,0,False,0.0
2021,17,3311,750,2,6240,13,12,2,16,0,0,0,0,0,0,False,False,False,0,3,2022-01-03T15:26:26.68,0,False,0.0
2021,17,3311,775,4,2853,2,18,3,-1,2,3,-1,3,-1,0,False,False,False,1,2,2022-01-03T15:13:25.387,2,False,
2021,17,3312,10,9,6436,2,4,4,5,9,4,7,2,7,0,False,False,False,0,3,2022-01-05T15:28:24.19,9,False,2.0
2021,17,3312,15,9,6436,2,45,10,-2,6,8,3,3,3,0,False,False,False,0,3,2022-01-05T15:24:09.87,6,False,3.0
2021,17,3312,25,9,6446,2,2,10,7,7,0,7,0,7,0,True,False,False,0,4,2022-01-05T15:24:21.327,7,False,0.0
2021,17,3312,35,9,6446,2,32,3,1,7,6,2,5,2,0,False,False,False,1,4,2022-01-05T03:09:07.86,7,False,5.0
2021,17,3312,40,9,4202,2,28,10,-1,2,3,-3,5,-3,0,False,False,False,1,1,2022-01-05T15:24:44.767,2,False,
2021,17,3312,70,1,910,13,4,9,5,0,0,0,0,0,0,False,False,False,0,3,2022-01-05T02:05:16.847,0,False,0.0
2021,17,3312,75,1,910,2,21,2,35,42,7,37,5,37,0,False,False,False,0,2,2022-01-03T11:06:22.887,42,False,5.0
2021,17,3312,85,1,910,13,2,10,1,0,0,0,0,0,0,False,False,False,0,2,2022-01-03T11:10:23.66,0,False,0.0
2021,17,3312,110,9,7816,13,50,10,-3,0,0,0,0,0,0,False,False,False,0,2,2022-01-03T11:18:45.15,0,False,0.0
2021,17,3312,120,9,4202,2,28,9,-1,14,15,8,6,8,0,False,False,False,1,1,2022-01-03T11:23:42.593,14,False,6.0
2021,17,3312,125,9,6446,2,53,9,-2,11,13,2,9,2,0,False,False,False,2,4,2022-01-03T11:25:23.85,11,False,9.0
2021,17,3312,130,9,7816,2,5,5,5,9,4,8,1,8,0,False,False,False,0,3,2022-01-05T15:24:55.773,9,False,1.0
2021,17,3312,145,9,6446,2,33,3,5,14,9,13,1,13,0,False,False,False,0,4,2022-01-03T11:32:21.813,14,False,1.0
2021,17,3312,150,9,7183,13,48,9,-2,0,0,0,0,0,0,False,False,False,0,1,2022-01-03T11:41:33.947,0,False,0.0
2021,17,3312,155,9,7183,2,46,3,-1,6,7,5,1,5,0,False,False,False,0,1,2022-01-03T11:43:03.517,6,False,1.0
2021,17,3312,165,9,322,13,4,10,10,0,0,0,0,0,0,False,False,False,0,3,2022-01-03T11:44:57.77,0,False,0.0
2021,17,3312,180,1,894,2,5,10,3,4,1,3,1,3,0,False,False,False,0,4,2022-01-03T11:48:41.91,4,False,1.0
2021,17,3312,185,1,6933,13,29,6,21,0,0,0,0,0,0,False,False,False,0,2,2022-01-03T11:50:19.163,0,False,0.0
2021,17,3312,230,1,6405,13,22,2,36,0,0,0,0,0,0,False,False,False,0,2,2022-01-03T12:00:09.383,0,False,0.0
2021,17,3312,235,1,6406,2,12,9,8,17,9,16,1,16,0,False,False,False,0,1,2022-01-03T12:02:33.697,17,False,1.0
2021,17,3312,245,1,894,2,53,9,1,3,2,3,0,3,0,False,False,False,0,4,2022-01-03T12:16:15.463,3,False,0.0
2021,17,3312,250,1,6933,2,26,3,3,3,0,3,0,3,0,False,False,False,0,2,2022-01-03T12:16:05.067,3,False,0.0
2021,17,3312,255,1,7782,2,17,8,19,23,4,19,4,19,0,False,False,False,0,4,2022-01-03T12:27:31.027,23,False,4.0
2021,17,3312,265,1,894,2,16,10,3,3,0,3,0,3,0,False,False,False,0,4,2022-01-03T12:24:50.283,3,False,0.0
2021,17,3312,270,1,894,13,9,6,18,0,0,0,0,0,0,False,False,False,0,3,2022-01-05T15:25:10.567,0,False,
2021,17,3312,280,1,910,2,8,1,15,20,5,20,0,20,0,False,False,False,0,2,2022-01-03T12:34:04.6,20,False,0.0
2021,17,3312,295,1,7103,2,50,10,-4,10,14,6,4,6,0,False,False,False,0,3,2022-01-05T03:09:18.293,10,False,4.0
2021,17,3312,300,1,6406,2,47,5,1,5,4,3,2,3,0,True,False,False,0,1,2022-01-04T19:50:53.02,5,False,2.0
2021,17,3312,310,1,6933,2,32,9,1,1,0,1,0,1,6,True,False,False,0,3,2022-01-05T15:28:38.757,1,True,0.0
2021,17,3312,330,9,322,2,3,5,9,9,0,9,0,9,0,False,False,False,0,2,2022-01-03T13:11:10.117,9,False,0.0
2021,17,3312,335,9,6446,2,5,5,7,7,0,7,0,7,0,False,False,False,0,4,2022-01-05T02:05:38.23,7,False,0.0
2021,17,3312,350,9,6441,2,6,4,5,7,2,6,1,6,0,False,False,False,1,3,2022-01-03T13:25:33.68,7,False,1.0
2021,17,3312,355,9,6441,2,4,10,7,11,4,9,2,9,0,False,False,False,0,3,2022-02-24T20:05:29.94,11,False,2.0
2021,17,3312,365,9,322,13,2,10,14,0,0,0,0,0,0,False,False,False,0,2,2022-01-05T02:34:25.13,0,False,
2021,17,3312,370,9,322,13,2,10,6,0,0,0,0,0,0,False,False,False,0,2,2022-01-05T02:06:35.913,0,False,0.0
2021,17,3312,375,9,7816,13,4,9,10,0,0,0,0,0,0,False,False,False,0,3,2022-01-03T13:38:29.69,0,False,
2021,17,3312,380,9,6446,13,4,9,3,0,0,0,0,0,0,True,False,False,0,4,2022-01-03T13:40:10.23,0,False,0.0
2021,17,3312,385,9,6436,13,5,5,5,0,0,0,0,0,0,False,False,False,0,3,2022-01-03T13:41:36.91,0,False,0.0
2021,17,3312,390,9,322,13,9,2,26,0,0,0,0,0,0,False,False,False,0,2,2022-01-03T13:43:33.997,0,False,
2021,17,3312,395,9,6436,2,29,6,20,21,1,21,0,21,6,False,False,False,0,2,2022-01-05T15:25:35,21,False,0.0
2021,17,3312,410,1,6406,2,48,9,-6,3,9,3,0,3,0,False,False,False,0,1,2022-01-03T13:48:52.873,3,True,0.0
2021,17,3312,415,1,894,2,39,4,4,4,0,4,0,4,0,False,False,False,0,3,2022-01-03T13:50:13.593,4,False,0.0
2021,17,3312,430,1,894,2,5,5,5,9,4,7,2,7,0,False,False,False,0,3,2022-01-03T13:52:45.76,9,False,2.0
2021,17,3312,435,1,6405,2,46,3,3,4,1,4,0,4,0,False,False,False,0,3,2022-01-03T13:53:56.173,4,True,0.0
2021,17,3312,440,1,6405,2,4,10,5,5,0,5,0,5,0,False,False,False,0,3,2022-01-05T02:06:52.22,5,False,0.0
2021,17,3312,450,1,910,13,19,2,30,0,0,0,0,0,0,False,False,False,0,2,2022-01-03T13:56:37.663,0,False,0.0
2021,17,3312,505,1,6405,2,39,4,4,5,1,3,2,3,0,False,False,False,0,3,2022-01-05T02:33:24.71,5,False,2.0
2021,17,3312,510,1,6406,2,32,9,-1,11,12,5,6,5,0,False,False,False,1,3,2022-01-05T15:28:58.39,11,False,6.0
2021,17,3312,520,1,6405,2,7,6,34,43,9,36,7,36,0,False,False,False,0,3,2022-01-03T14:12:46.237,43,False,7.0
2021,17,3312,525,1,6406,2,44,3,-7,-7,0,-7,0,-7,0,False,False,False,0,1,2022-01-03T14:14:41.707,-7,False,0.0
2021,17,3312,530,1,6405,2,51,3,2,6,4,5,1,5,0,False,False,False,0,3,2022-01-04T19:51:37.993,6,False,1.0
2021,17,3312,540,1,6933,2,9,6,18,19,1,19,0,19,6,False,False,False,0,3,2022-01-03T14:27:26.37,19,False,0.0
2021,17,3312,555,9,6446,13,12,10,-1,0,0,0,0,0,0,False,False,False,0,4,2022-01-03T14:40:51.853,0,False,0.0
2021,17,3312,560,9,322,13,4,3,8,0,0,0,0,0,0,False,False,False,0,2,2022-01-03T14:46:58.61,0,False,0.0
2021,17,3312,570,9,6446,13,12,2,19,0,0,0,0,0,0,False,False,False,0,3,2022-01-03T14:52:11.437,0,False,0.0
2021,17,3312,580,1,6405,2,18,3,-1,16,17,14,2,14,0,False,False,False,1,2,2022-01-03T14:54:14.637,16,False,2.0
2021,17,3312,590,1,894,2,53,9,-5,7,12,5,2,5,0,False,False,False,0,4,2022-01-03T14:56:49.717,7,False,2.0
2021,17,3312,620,1,894,13,7,5,8,0,0,0,0,0,0,False,False,False,0,3,2022-01-03T15:14:30.2,0,False,0.0
2021,17,3312,645,9,4202,3,5,5,4,0,0,0,0,0,0,False,False,False,0,3,2022-01-03T15:18:46.587,0,False,0.0
2021,17,3312,650,9,322,13,6,1,16,0,0,0,0,0,0,False,False,False,0,3,2022-01-03T15:21:22.307,0,False,0.0
2021,17,3312,660,1,6406,13,32,10,-7,0,0,0,0,0,0,False,False,False,0,1,2022-02-16T20:37:46.133,0,False,0.0
2021,17,3312,685,9,7183,2,46,3,2,12,10,12,0,12,0,False,False,False,0,1,2022-01-03T15:38:51.423,12,False,0.0
2021,17,3312,695,9,7183,3,6,9,3,0,0,0,0,0,0,False,False,False,0,1,2022-01-03T15:48:29.467,0,False,0.0
2021,17,3312,715,9,6446,13,32,3,2,0,0,0,0,0,0,False,False,False,0,4,2022-01-03T15:54:58.96,0,False,0.0
2021,17,3312,720,9,322,2,5,3,4,5,1,4,1,4,0,False,False,False,0,3,2022-01-03T15:56:00.42,5,False,1.0
2021,17,3312,725,9,6441,2,35,3,2,2,0,2,0,2,6,False,False,False,0,3,2022-02-16T20:39:21.76,2,True,0.0
2021,17,3312,745,1,910,2,3,5,12,12,0,12,0,12,0,False,False,False,0,2,2022-01-03T16:01:43.117,12,False,0.0
2021,17,3312,770,9,7816,2,8,1,20,26,6,23,3,23,0,False,False,False,0,2,2022-01-03T16:13:33.297,26,False,3.0
2021,17,3312,795,1,894,13,9,2,16,0,0,0,0,0,0,False,False,False,0,3,2022-01-03T16:29:30.153,0,False,0.0
2021,17,3312,800,1,6933,2,4,3,7,7,0,7,0,7,0,False,False,False,0,2,2022-01-05T02:07:00.583,7,False,0.0
2021,17,3312,815,9,6441,2,44,3,-7,0,7,-3,3,-3,0,True,False,False,0,3,2022-01-03T16:38:15.867,0,False,3.0
2021,17,3312,820,9,6446,2,5,3,5,8,3,7,1,7,0,False,False,False,0,3,2022-01-03T16:39:26.57,8,False,1.0
2021,17,3312,830,9,6441,2,46,3,2,7,5,7,0,7,0,True,False,False,0,3,2022-01-03T16:42:30.01,7,True,0.0
2021,17,3312,835,9,7183,2,21,8,15,31,16,30,1,30,0,False,False,False,0,1,2022-01-03T16:44:40.217,31,False,1.0
2021,17,3312,840,9,7816,2,4,3,13,16,3,15,1,15,0,False,False,False,0,2,2022-01-05T02:33:56.303,16,False,1.0
2021,17,3312,845,9,6441,2,2,9,7,8,1,8,0,8,0,False,False,False,0,3,2022-01-05T15:26:14.567,8,False,0.0
2021,17,3312,850,9,322,2,12,9,4,4,0,4,0,4,6,False,False,False,0,3,2022-01-03T16:52:06.03,4,True,0.0
2021,17,3312,865,1,6405,13,35,2,27,0,0,0,0,0,0,False,False,False,0,3,2022-01-03T16:55:09.077,0,False,0.0
2021,17,3312,880,1,894,2,5,3,11,11,0,11,0,11,0,False,False,False,0,4,2022-01-03T17:04:23.32,11,False,0.0
2021,17,3313,15,13,1510,2,4,4,3,6,3,5,1,5,0,False,False,False,0,1,2022-01-03T10:23:10.443,6,False,1.0
2021,17,3313,20,13,1510,2,28,4,2,3,1,3,0,3,0,False,False,False,0,1,2022-01-03T10:25:41.763,3,False,0.0
2021,17,3313,70,28,8471,2,12,5,3,3,0,3,0,3,0,True,False,False,0,2,2022-01-03T10:45:51.163,3,False,0.0
2021,17,3313,90,28,262,2,30,5,0,3,3,3,0,3,0,False,False,False,0,1,2022-01-03T10:55:14.823,3,False,0.0
2021,17,3313,110,13,4662,2,39,4,5,9,4,6,3,6,0,False,False,False,1,3,2022-01-05T19:33:01.863,9,False,3.0
2021,17,3313,120,13,6282,13,46,3,0,0,0,0,0,0,0,False,False,False,0,1,2022-02-16T22:48:51.787,0,False,0.0
2021,17,3313,125,13,2407,2,50,10,-3,-2,1,-2,0,-2,0,False,False,False,0,3,2022-01-03T11:09:00.673,-2,False,0.0
2021,17,3313,130,13,876,13,52,4,3,0,0,0,0,0,0,True,False,False,0,2,2022-01-05T19:57:33.083,0,False,0.0
2021,17,3313,145,28,7619,2,12,5,11,12,1,12,0,12,0,False,False,False,0,2,2022-01-03T11:18:23.627,12,False,0.0
2021,17,3313,155,28,6410,2,35,3,11,12,1,11,1,11,0,False,False,False,0,3,2022-01-05T19:52:40.29,12,False,1.0
2021,17,3313,195,28,7753,2,4,4,12,12,0,12,0,12,0,False,False,False,0,3,2022-01-03T11:39:53.44,12,False,0.0
2021,17,3313,205,13,876,2,51,10,-4,2,6,2,0,2,0,False,False,False,0,3,2022-01-03T11:43:42.763,2,False,0.0
2021,17,3313,215,13,8417,13,4,5,5,0,0,0,0,0,0,True,False,False,0,2,2022-01-05T01:33:48.66,0,False,0.0
2021,17,3313,225,28,4922,13,43,6,22,0,0,0,0,0,0,False,False,False,0,4,2022-01-05T19:47:49.993,0,False,0.0
2021,17,3313,230,13,876,2,5,5,7,8,1,8,0,8,0,False,False,False,0,3,2022-01-05T19:51:37.193,8,False,0.0
2021,17,3313,240,13,876,13,8,2,38,0,0,0,0,0,0,False,False,False,0,3,2022-01-03T12:00:28.113,0,False,0.0
2021,17,3313,245,13,876,2,4,9,5,6,1,6,0,6,0,False,False,False,0,3,2022-01-03T12:02:06.307,6,False,0.0
2021,17,3313,255,13,8417,2,5,6,15,15,0,15,0,15,0,False,False,False,0,2,2022-01-03T12:05:35.14,15,True,0.0
2021,17,3313,270,13,876,2,9,6,21,24,3,24,0,24,0,False,False,False,0,3,2022-01-03T12:12:21.377,24,True,0.0
2021,17,3313,290,13,1510,2,47,5,-1,0,1,0,0,0,0,False,False,False,0,1,2022-01-03T12:20:22.017,0,False,0.0
2021,17,3313,305,13,876,2,17,4,8,8,0,8,0,8,6,False,False,False,0,3,2022-01-05T16:52:46.497,8,True,0.0
2021,17,3313,330,28,7224,2,48,3,-6,1,7,-1,2,-1,0,False,False,False,0,1,2022-01-03T12:29:01.777,1,False,2.0
2021,17,3313,340,28,262,2,32,3,4,6,2,6,0,6,0,True,False,False,0,1,2022-01-04T19:44:14.117,6,False,0.0
2021,17,3313,380,28,7224,2,2,10,9,17,8,14,3,14,0,False,False,False,0,2,2022-01-03T12:40:40.073,17,False,3.0
2021,17,3313,385,28,7224,13,12,2,20,0,0,0,0,0,0,False,False,False,0,2,2022-01-03T12:43:55.85,0,False,0.0
2021,17,3313,390,28,7619,2,17,8,17,27,10,23,4,23,0,False,False,False,1,3,2022-01-03T12:46:39.993,27,False,4.0
2021,17,3313,395,28,7619,13,9,2,26,0,0,0,0,0,0,False,False,False,0,2,2022-01-03T12:50:53.053,0,False,0.0
2021,17,3313,405,28,7619,2,29,5,12,12,0,12,0,12,0,False,False,False,0,2,2022-01-03T15:44:57.337,12,True,0.0
2021,17,3313,435,28,7619,2,2,4,10,43,33,12,31,12,0,True,False,False,2,3,2022-01-05T19:34:34.433,43,False,31.0
2021,17,3313,440,28,6410,13,6,8,17,0,0,0,0,0,0,False,False,False,0,3,2022-01-03T13:03:16.6,0,False,0.0
2021,17,3313,455,28,7619,13,5,6,16,0,0,0,0,0,0,False,False,False,0,3,2022-01-03T13:08:20.977,0,False,0.0
2021,17,3313,485,13,2407,13,39,10,5,0,0,0,0,0,0,False,False,False,0,3,2022-01-05T18:26:12.967,0,False,0.0
2021,17,3313,490,28,7619,13,8,1,37,0,0,0,0,0,0,False,False,False,0,3,2022-01-03T13:27:21.163,0,False,
2021,17,3313,505,28,7751,2,5,9,2,6,4,6,0,6,0,False,False,False,0,1,2022-01-03T13:32:47.497,6,False,0.0
2021,17,3313,510,28,8471,2,47,5,1,8,7,8,0,8,6,False,False,False,0,1,2022-01-03T13:34:56.14,8,True,0.0
2021,17,3313,525,13,1510,2,47,5,1,6,5,5,1,5,0,False,False,False,0,3,2022-01-03T13:38:14.327,6,False,1.0
2021,17,3313,555,28,7224,3,8,4,12,0,0,0,0,0,0,False,False,False,0,3,2022-01-05T20:04:49.34,0,False,0.0
2021,17,3313,580,13,876,2,19,8,45,50,5,47,3,47,0,False,False,False,0,2,2022-01-03T13:54:02.45,50,False,
2021,17,3313,590,13,1510,2,4,9,6,9,3,8,1,8,0,False,False,False,0,3,2022-01-03T13:57:16.003,9,False,1.0
2021,17,3313,595,13,876,13,3,5,8,0,0,0,0,0,0,False,False,False,0,2,2022-01-03T13:58:50.103,0,False,0.0
2021,17,3313,600,13,876,13,24,6,33,0,0,0,0,0,0,False,False,False,0,2,2022-01-03T14:01:18.873,0,False,
2021,17,3313,610,13,876,13,19,6,23,0,0,0,0,0,0,False,False,False,0,2,2022-01-03T14:03:45.213,0,False,
2021,17,3313,645,28,7753,2,5,3,13,13,0,13,0,13,0,False,False,False,0,3,2022-01-03T14:23:49.453,13,True,0.0
2021,17,3313,650,28,7224,2,8,6,33,45,12,35,10,35,6,False,False,False,1,3,2022-01-03T14:26:23.787,45,False,10.0
2021,17,3313,665,13,6282,13,5,4,3,0,0,0,0,0,0,False,False,False,0,1,2022-01-03T14:33:59.97,0,False,
2021,17,3313,670,13,876,2,13,10,4,4,0,4,0,4,0,False,False,False,0,3,2022-01-03T14:36:06.027,4,False,0.0
2021,17,3313,695,13,876,13,4,3,9,0,0,0,0,0,0,False,False,False,0,2,2022-01-03T14:46:24.637,0,False,0.0
2021,17,3313,725,28,4922,2,17,7,26,29,3,29,0,29,0,True,False,False,0,3,2022-01-03T14:59:25.36,29,False,0.0
2021,17,3313,760,28,7224,13,51,5,-3,0,0,0,0,0,0,True,False,False,0,1,2022-01-03T15:10:18.773,0,False,0.0
2021,17,3313,775,13,1510,2,28,10,-1,8,9,7,1,7,0,False,False,False,0,1,2022-01-03T15:13:29.427,8,False,1.0
2021,17,3313,785,13,8417,13,13,10,4,0,0,0,0,0,0,False,False,False,0,3,2022-01-05T19:30:17.697,0,False,0.0
2021,17,3313,790,13,8417,13,2,9,2,0,0,0,0,0,0,False,False,False,0,2,2022-01-03T15:18:12.473,0,False,0.0
2021,17,3313,835,13,6490,2,32,3,1,3,2,3,0,3,0,False,False,False,0,1,2022-01-03T15:27:44.953,3,False,0.0
2021,17,3313,840,13,8417,2,7,6,20,20,0,20,0,20,0,False,False,False,0,2,2022-01-03T15:29:14.187,20,True,0.0
2021,17,3313,845,13,8418,2,31,4,3,9,6,8,1,8,0,False,False,False,0,3,2022-01-03T15:31:29.49,9,False,1.0
2021,17,3313,850,13,6490,2,5,3,1,5,4,5,0,5,0,False,False,False,0,1,2022-01-03T15:33:11.477,5,True,0.0
2021,17,3313,855,13,6490,2,31,9,-4,6,10,6,0,6,0,False,False,False,1,1,2022-01-03T15:34:49.46,6,True,0.0
2021,17,3313,860,13,876,2,5,3,6,14,8,7,7,7,0,False,False,False,1,2,2022-01-05T19:29:46.273,14,False,7.0
2021,17,3314,20,26,7453,13,19,6,30,0,0,0,0,0,0,False,False,False,0,3,2022-01-05T17:26:58.297,0,False,
2021,17,3314,30,26,309,2,4,10,4,10,6,7,3,7,0,False,False,False,0,2,2022-01-03T09:47:57.117,10,False,3.0
2021,17,3314,60,10,7938,2,5,6,15,15,0,15,0,15,0,False,False,False,0,3,2022-01-03T09:56:37.773,15,True,0.0
2021,17,3314,70,10,282,2,5,3,0,0,0,0,0,0,0,False,False,False,0,1,2022-01-04T19:58:00.583,0,False,0.0
2021,17,3314,85,10,6281,13,35,2,18,0,0,0,0,0,0,False,False,False,0,3,2022-02-16T21:18:18.697,0,False,0.0
2021,17,3314,105,26,4619,13,12,6,22,0,0,0,0,0,0,False,False,False,0,2,2022-02-16T21:18:49.867,0,False,0.0
2021,17,3314,115,26,309,13,4,10,10,0,0,0,0,0,0,False,False,False,0,2,2022-01-04T21:13:53.33,0,True,0.0
2021,17,3314,125,10,6281,13,19,6,44,0,0,0,0,0,0,False,False,False,0,2,2022-01-03T10:19:40.633,0,False,
2021,17,3314,135,10,7938,13,8,1,19,0,0,0,0,0,0,False,False,False,0,3,2022-01-03T10:23:46.9,0,False,0.0
2021,17,3314,140,10,7938,13,6,9,5,0,0,0,0,0,0,False,False,False,0,2,2022-01-05T17:08:31.96,0,False,0.0
2021,17,3314,155,26,309,13,6,4,13,0,0,0,0,0,0,True,False,False,0,3,2022-01-05T14:46:24.397,0,False,0.0
2021,17,3314,160,26,309,3,6,4,11,0,0,0,0,0,0,False,False,False,0,3,2022-01-05T14:41:27.593,0,False,0.0
2021,17,3314,185,10,6281,13,5,6,15,0,0,0,0,0,0,False,False,False,0,3,2022-01-03T10:37:30.1,0,False,0.0
2021,17,3314,200,26,8552,13,13,10,2,0,0,0,0,0,0,False,False,False,0,3,2022-01-05T17:39:48.983,0,False,0.0
2021,17,3314,205,26,6301,2,6,9,1,8,7,6,2,6,0,False,False,False,0,1,2022-01-03T10:44:34.303,8,False,2.0
2021,17,3314,215,26,309,2,12,5,10,10,0,10,0,10,0,False,False,False,0,2,2022-02-24T20:07:57.513,10,False,0.0
2021,17,3314,235,26,4619,2,2,4,5,11,6,7,4,7,0,False,False,False,0,3,2022-01-03T10:51:32.277,11,False,4.0
2021,17,3314,245,26,8552,2,5,5,5,8,3,7,1,7,0,False,False,False,0,2,2022-01-03T10:54:31.637,8,False,1.0
2021,17,3314,260,26,8552,2,2,9,2,3,1,3,0,3,0,False,False,False,0,2,2022-01-03T10:58:25.413,3,False,0.0
2021,17,3314,275,10,6281,2,7,6,39,44,5,40,4,40,0,False,False,False,0,3,2022-02-16T21:24:29.457,44,False,4.0
2021,17,3314,300,10,6840,2,46,3,3,18,15,13,5,13,0,False,False,False,0,4,2022-01-03T11:07:15.707,18,False,5.0
2021,17,3314,305,10,7703,2,30,3,-2,-1,1,-1,0,-1,0,False,False,False,0,4,2022-01-03T11:08:48.447,-1,False,0.0
2021,17,3314,325,10,6857,2,45,10,-5,1,6,-1,2,-1,0,False,False,False,0,6,2022-02-16T21:25:09.827,1,False,2.0
2021,17,3314,335,26,8553,2,32,10,2,6,4,4,2,4,0,False,False,False,1,4,2022-01-03T11:17:19.463,6,False,2.0
2021,17,3314,355,26,8553,2,46,3,1,8,7,4,4,4,0,False,False,False,0,4,2022-01-05T17:40:00.913,8,False,4.0
2021,17,3314,380,26,4616,2,51,3,-4,11,15,11,0,11,0,True,False,False,0,1,2022-01-05T17:10:09.47,11,True,0.0
2021,17,3314,385,26,4616,2,44,3,-5,3,8,0,3,0,0,True,False,False,0,1,2022-01-03T11:37:39.95,3,False,3.0
2021,17,3314,390,26,7453,2,4,5,4,5,1,4,1,4,0,False,False,False,0,2,2022-01-03T11:40:06.783,5,False,1.0
2021,17,3314,410,26,6301,2,5,3,5,9,4,8,1,8,0,False,False,False,0,1,2022-01-03T11:43:07.093,9,False,1.0
2021,17,3314,415,26,6301,2,44,3,-4,3,7,3,0,3,0,False,False,False,0,1,2022-01-03T11:45:07.527,3,True,0.0
2021,17,3314,425,26,309,2,26,10,7,8,1,8,0,8,6,False,False,False,0,4,2022-01-03T11:48:11.347,8,True,0.0
2021,17,3314,440,10,282,2,6,10,5,24,19,22,2,22,0,False,False,False,0,1,2022-01-03T11:51:18.463,24,False,2.0
2021,17,3314,445,10,7938,2,2,4,6,8,2,8,0,8,0,False,False,False,0,3,2022-01-03T11:52:50.827,8,False,0.0
2021,17,3314,485,10,4702,3,35,5,9,0,0,0,0,0,0,False,False,False,0,4,2022-01-03T12:00:21.933,0,False,0.0
2021,17,3314,490,10,7938,13,4,5,13,0,0,0,0,0,0,False,False,False,0,3,2022-01-03T12:02:19.967,0,False,0.0
2021,17,3314,500,26,4619,2,30,10,-2,7,9,6,1,6,0,False,False,False,0,3,2022-02-16T21:26:51.76,7,False,1.0
2021,17,3314,510,26,4616,2,6,9,0,40,40,3,37,3,0,False,False,False,2,1,2022-01-05T17:10:40.457,40,False,37.0
2021,17,3314,520,26,309,2,38,2,16,16,0,16,0,16,0,False,False,False,0,4,2022-01-05T17:33:09.267,16,False,0.0
2021,17,3314,535,26,309,13,29,5,11,0,0,0,0,0,0,False,False,False,0,2,2022-01-03T12:16:44.917,0,False,0.0
2021,17,3314,545,26,7453,2,13,10,4,5,1,4,1,4,0,False,False,False,0,3,2022-01-05T17:10:59.11,5,False,1.0
2021,17,3314,555,26,8552,3,2,5,3,0,0,0,0,0,0,False,False,False,0,2,2022-01-03T12:22:43.187,0,False,0.0
2021,17,3314,560,26,309,13,12,9,5,0,0,0,0,0,0,False,False,False,0,3,2022-01-03T12:24:07.7,0,False,0.0
2021,17,3314,575,10,6840,2,47,5,5,35,30,30,5,30,0,False,False,False,2,4,2022-01-03T12:28:26.2,35,False,5.0
2021,17,3314,595,10,6281,2,4,5,3,7,4,7,0,7,0,False,False,False,1,2,2022-01-03T12:32:25.97,7,True,0.0
2021,17,3314,600,10,6281,2,26,9,5,9,4,6,3,6,0,False,False,False,0,3,2022-01-05T17:46:57.703,9,False,3.0
2021,17,3314,615,10,8546,3,9,2,19,0,0,0,0,0,0,False,False,False,0,2,2022-02-16T21:30:02.737,0,False,
2021,17,3314,630,10,282,2,4,4,3,5,2,4,1,4,0,False,False,False,0,1,2022-01-03T12:42:56.69,5,False,1.0
2021,17,3314,665,10,6840,2,32,10,-1,11,12,5,6,5,0,True,False,False,1,4,2022-01-05T17:09:14.69,11,False,6.0
2021,17,3314,675,10,7703,2,47,5,1,6,5,2,4,2,0,False,False,False,0,4,2022-01-03T12:55:05.583,6,False,4.0
2021,17,3314,685,10,8541,2,47,5,-1,2,3,1,1,1,0,False,False,False,0,1,2022-01-03T12:59:10.763,2,False,1.0
2021,17,3314,690,10,282,3,4,9,3,0,0,0,0,0,0,False,False,False,0,1,2022-01-03T13:00:32.86,0,False,0.0
2021,17,3314,695,10,6840,13,13,10,6,0,0,0,0,0,0,True,False,False,0,3,2022-01-05T17:08:54.12,0,False,0.0
2021,17,3314,705,26,8552,2,39,9,5,5,0,5,0,5,0,False,False,False,0,3,2022-01-05T17:48:29.197,5,False,0.0
2021,17,3314,710,26,4619,2,19,6,40,45,5,45,0,45,6,False,False,False,0,3,2022-01-03T13:09:56.48,45,True,0.0
2021,17,3314,725,10,6840,2,35,9,11,16,5,15,1,15,0,True,False,False,0,3,2022-01-03T13:12:33.547,16,False,1.0
2021,17,3314,730,10,6840,2,39,4,5,7,2,7,0,7,0,False,False,False,0,3,2022-01-03T13:13:56.747,7,False,0.0
2021,17,3314,745,10,8546,2,19,2,29,34,5,29,5,29,0,False,False,False,0,2,2022-01-03T13:18:39.997,34,False,5.0
2021,17,3314,750,10,8541,2,44,3,-4,0,4,-3,3,-3,0,False,False,False,0,1,2022-01-03T13:20:28.71,0,False,
2021,17,3314,755,10,6840,2,13,9,5,5,0,5,0,5,6,False,False,False,0,3,2022-01-03T13:22:39.977,5,True,0.0
2021,17,3314,775,26,4050,2,53,9,-3,8,11,7,1,7,0,False,False,False,0,4,2022-01-03T13:27:28.187,8,False,1.0
2021,17,3314,810,26,8553,2,13,4,3,8,5,6,2,6,0,False,False,False,0,4,2022-01-05T17:32:17.547,8,False,2.0
2021,17,3315,15,3,8430,2,12,5,14,15,1,15,0,15,0,False,False,False,0,2,2022-01-03T11:39:36.03,15,False,0.0
2021,17,3315,25,3,6936,2,2,4,10,13,3,13,0,13,0,False,False,False,0,3,2022-01-03T11:42:28.56,13,False,0.0
2021,17,3315,35,3,8430,2,6,9,5,5,0,5,0,5,0,False,False,False,0,2,2022-01-05T19:15:29.263,5,False,0.0
2021,17,3315,60,29,7828,2,12,10,10,10,0,10,0,10,0,False,False,False,0,3,2022-01-03T11:49:02.81,10,False,0.0
2021,17,3315,65,29,6266,3,32,9,-1,0,0,0,0,0,0,False,False,False,0,3,2022-01-03T11:50:23.963,0,False,0.0
2021,17,3315,70,29,3398,2,6,10,12,18,6,18,0,18,0,False,False,False,0,3,2022-01-05T19:16:12.913,18,False,0.0
2021,17,3315,75,29,3398,2,30,9,1,7,6,5,2,5,0,False,False,False,0,4,2022-01-03T11:52:29.837,7,False,2.0
2021,17,3315,80,29,3398,2,7,8,16,19,3,19,0,19,0,False,False,False,0,4,2022-01-03T11:53:59.887,19,False,0.0
2021,17,3315,90,29,4866,2,51,3,-5,6,11,5,1,5,0,True,False,False,0,1,2022-01-03T15:23:36.94,6,False,1.0
2021,17,3315,95,29,7828,13,6,10,14,0,0,0,0,0,0,False,False,False,0,3,2022-01-03T11:58:11.97,0,False,0.0
2021,17,3315,100,29,3398,13,5,5,10,0,0,0,0,0,0,False,False,False,0,4,2022-01-05T19:18:33.893,0,False,0.0
2021,17,3315,115,3,713,2,45,5,-5,1,6,0,1,0,0,False,False,False,0,1,2022-01-03T12:01:53.917,1,False,1.0
2021,17,3315,120,3,7672,2,6,4,6,14,8,4,10,4,0,True,False,False,1,3,2022-01-05T18:47:47.057,14,False,10.0
2021,17,3315,135,29,1067,2,4,5,3,4,1,3,1,3,0,False,False,False,0,2,2022-01-05T19:20:30.53,4,False,1.0
2021,17,3315,140,29,3398,13,5,9,1,0,0,0,0,0,0,False,False,False,0,3,2022-01-03T12:12:02.747,0,False,0.0
2021,17,3315,155,29,7828,2,30,9,1,9,8,7,2,7,0,True,False,False,0,4,2022-01-03T12:14:01.193,9,False,2.0
2021,17,3315,170,29,1067,13,50,5,0,0,0,0,0,0,0,False,False,False,0,2,2022-01-03T12:17:21.413,0,False,0.0
2021,17,3315,180,29,4866,2,6,4,13,22,9,16,6,16,0,False,False,False,1,3,2022-01-03T12:19:09.123,22,False,6.0
2021,17,3315,200,29,1067,13,8,7,39,0,0,0,0,0,0,False,False,False,0,3,2022-01-03T12:22:35.62,0,False,0.0
2021,17,3315,210,3,8430,13,19,2,28,0,0,0,0,0,0,False,False,False,0,2,2022-01-03T12:28:23.67,0,False,0.0
2021,17,3315,215,3,8430,2,6,9,5,9,4,7,2,7,0,False,False,False,0,3,2022-01-05T19:28:37.187,9,False,2.0
2021,17,3315,225,3,6454,2,17,7,15,18,3,17,1,17,0,False,False,False,0,3,2022-01-03T12:31:43.05,18,False,1.0
2021,17,3315,235,3,8430,2,4,9,5,5,0,5,0,5,0,False,False,False,0,2,2022-01-05T19:29:17.187,5,False,0.0
2021,17,3315,240,3,6454,2,11,2,22,33,11,29,4,29,0,False,False,False,1,4,2022-01-03T12:34:44.85,33,False,4.0
2021,17,3315,270,3,2976,2,13,4,2,2,0,2,0,2,0,False,False,False,0,4,2022-01-05T18:48:57.57,2,False,0.0
2021,17,3315,275,3,7672,13,2,9,5,0,0,0,0,0,0,False,False,False,0,3,2022-01-03T12:43:32.483,0,False,0.0
2021,17,3315,295,29,6266,3,28,4,1,0,0,0,0,0,0,False,False,False,0,1,2022-01-05T19:59:39.33,0,False,0.0
2021,17,3315,300,29,1067,2,12,10,3,11,8,10,1,10,0,False,False,False,0,3,2022-01-03T12:47:58.23,6,False,1.0
2021,17,3315,305,29,4866,13,4,10,3,0,0,0,0,0,0,False,False,False,0,3,2022-01-03T12:49:19.807,0,False,0.0
2021,17,3315,310,29,1067,2,4,8,17,17,0,17,0,17,0,False,False,False,0,3,2022-01-05T19:30:59.167,17,False,0.0
2021,17,3315,345,3,6936,13,20,2,35,0,0,0,0,0,0,False,False,False,0,2,2022-01-03T12:55:21.89,0,False,0.0
2021,17,3315,350,29,6266,2,47,10,2,11,9,9,2,9,0,False,False,False,1,1,2022-01-03T12:56:15.12,11,False,2.0
2021,17,3315,355,29,3398,13,4,5,3,0,0,0,0,0,0,False,False,False,0,4,2022-01-03T12:57:25.39,0,False,0.0
2021,17,3315,360,29,4866,2,2,10,8,18,10,17,1,17,6,True,False,False,0,3,2022-01-03T12:58:30.467,18,False,1.0
2021,17,3315,375,3,8430,13,5,3,8,0,0,0,0,0,0,False,False,False,0,2,2022-01-03T13:15:57.627,0,False,0.0
2021,17,3315,390,3,8430,2,5,3,12,14,2,14,0,14,0,False,False,False,0,2,2022-01-03T13:18:57.747,14,True,0.0
2021,17,3315,405,3,6454,2,2,4,8,15,7,13,2,13,0,False,False,False,0,3,2022-01-03T13:20:23.843,15,False,2.0
2021,17,3315,425,3,6936,3,5,5,7,0,0,0,0,0,0,False,False,False,0,2,2022-01-04T23:22:45.8,0,False,0.0
2021,17,3315,460,29,6266,2,28,4,1,2,1,2,0,2,0,False,False,False,0,1,2022-01-03T13:43:59.39,2,False,0.0
2021,17,3315,465,29,7828,2,8,7,34,35,1,35,0,35,0,False,False,False,0,3,2022-01-03T13:45:17.117,35,False,0.0
2021,17,3315,470,29,6266,2,4,4,2,12,10,8,4,8,0,False,False,False,1,1,2022-01-05T20:01:35.87,12,False,4.0
2021,17,3315,505,3,6936,2,4,9,4,4,0,4,0,4,0,False,False,False,0,3,2022-01-05T19:44:07.623,4,False,0.0
2021,17,3315,510,3,6936,13,12,2,32,0,0,0,0,0,0,False,False,False,0,3,2022-01-05T20:02:49.563,0,False,0.0
2021,17,3315,520,3,6454,2,4,10,4,15,11,4,11,4,0,False,False,False,1,3,2022-01-05T18:49:54.96,15,False,11.0
2021,17,3315,550,3,6936,13,12,5,6,0,0,0,0,0,0,False,False,False,0,2,2022-01-03T14:11:50.913,0,False,0.0
2021,17,3315,555,3,8430,13,5,5,11,0,0,0,0,0,0,False,False,False,0,2,2022-01-03T14:12:45.263,0,False,0.0
2021,17,3315,570,29,7828,2,5,5,5,9,4,8,1,8,0,False,False,False,0,3,2022-01-03T14:15:31.81,9,False,1.0
2021,17,3315,580,29,3398,2,13,10,1,2,1,2,0,2,0,False,False,False,0,3,2022-01-03T14:17:03.08,2,False,0.0
2021,17,3315,590,3,8430,2,4,5,7,7,0,7,0,7,0,False,False,False,0,2,2022-01-03T14:18:27.05,7,False,0.0
2021,17,3315,620,29,3398,2,30,3,1,8,7,7,1,7,0,False,False,False,0,4,2022-01-05T19:49:00.45,8,False,1.0
2021,17,3315,635,29,8455,2,30,5,0,3,3,2,1,2,0,True,False,False,0,4,2022-01-03T14:27:20.397,3,False,1.0
2021,17,3315,640,29,4866,2,44,3,-4,21,25,12,9,12,0,True,False,False,2,1,2022-01-03T14:28:24.747,21,False,9.0
2021,17,3315,675,3,6936,2,2,4,9,11,2,10,1,10,0,False,False,False,1,3,2022-01-05T18:51:25.527,11,False,1.0
2021,17,3315,735,29,3398,2,8,10,13,15,2,15,0,15,0,False,False,False,0,3,2022-01-03T14:50:55.507,15,False,0.0
2021,17,3315,740,29,4866,2,35,7,19,24,5,23,1,23,0,False,False,False,0,3,2022-01-05T19:49:51.84,24,False,1.0
2021,17,3315,745,29,4866,2,47,5,2,4,2,4,0,4,0,False,False,False,0,3,2022-01-03T14:52:56.29,4,False,0.0
2021,17,3315,750,29,8455,2,8,10,10,15,5,15,0,15,0,False,False,False,0,3,2022-01-05T18:50:16.533,15,False,0.0
2021,17,3315,780,29,1067,2,4,10,5,5,0,5,0,5,0,False,False,False,0,3,2022-01-03T15:00:30.88,5,False,0.0
2021,17,3315,790,29,1067,2,5,5,6,7,1,7,0,7,6,False,False,False,0,3,2022-01-03T15:01:05.61,7,True,0.0
2021,17,3315,805,3,6454,2,4,10,4,4,0,4,0,4,0,False,False,False,0,3,2022-01-03T15:05:38.977,4,False,0.0
2021,17,3315,810,3,7672,2,2,4,5,5,0,5,0,5,0,False,False,False,0,3,2022-01-05T19:59:53.55,5,False,0.0
2021,17,3315,815,3,6936,13,4,5,5,0,0,0,0,0,0,False,False,False,0,2,2022-01-05T20:00:14.94,0,False,0.0
2021,17,3315,825,3,6454,2,6,4,4,4,0,4,0,4,0,False,False,False,0,3,2022-01-03T15:10:14.987,4,False,0.0
2021,17,3315,855,3,8430,2,4,9,2,3,1,3,0,3,0,False,False,False,0,2,2022-01-03T15:13:06.927,3,False,0.0
2021,17,3316,20,27,7408,13,19,2,25,0,0,0,0,0,0,False,False,False,0,2,2022-02-22T20:40:19.89,0,False,0.0
2021,17,3316,30,11,4561,2,48,10,-3,6,9,5,1,5,0,False,False,False,0,1,2022-01-04T20:45:12.45,6,False,1.0
2021,17,3316,40,11,8359,2,4,10,6,12,6,10,2,10,0,False,False,False,0,3,2022-01-05T17:43:22.54,12,False,2.0
2021,17,3316,45,11,8359,2,13,9,3,15,12,12,3,12,0,False,False,False,0,4,2022-01-03T10:16:47.023,15,False,3.0
2021,17,3316,80,27,4850,2,6,9,10,12,2,11,1,11,0,False,False,False,0,3,2022-01-03T17:05:23.853,12,False,1.0
2021,17,3316,85,27,7408,13,50,9,-3,0,0,0,0,0,0,False,False,False,0,2,2022-01-05T16:52:28.003,0,False,0.0
2021,17,3316,90,27,7852,2,34,4,-4,7,11,3,4,3,0,True,False,False,0,3,2022-01-03T10:39:03.093,7,False,4.0
2021,17,3316,95,27,5226,2,47,5,-1,4,5,2,2,2,0,False,False,False,0,1,2022-01-03T10:41:32.263,4,False,2.0
2021,17,3316,110,27,7408,2,5,3,4,8,4,6,2,6,0,False,False,False,0,3,2022-01-03T10:51:43.617,8,False,2.0
2021,17,3316,130,11,6633,2,2,9,11,13,2,13,0,13,0,False,False,False,0,2,2022-02-22T20:38:25.203,13,False,0.0
2021,17,3316,135,11,6633,13,4,9,5,0,0,0,0,0,0,False,False,False,0,3,2022-01-03T11:01:01.543,0,False,0.0
2021,17,3316,145,11,6633,13,29,6,20,0,0,0,0,0,0,False,False,False,0,2,2022-02-22T20:28:11.49,0,False,0.0
2021,17,3316,160,27,4850,2,30,10,-2,9,11,0,9,0,0,False,False,False,1,4,2022-01-03T11:19:41.333,9,False,9.0
2021,17,3316,175,27,650,2,51,3,-10,-5,5,-6,1,-6,0,True,False,False,0,2,2022-01-05T15:19:01.217,-5,False,1.0
2021,17,3316,180,27,8472,13,49,5,3,0,0,0,0,0,0,False,False,False,0,2,2022-01-03T11:33:24.44,0,False,0.0
2021,17,3316,210,11,3153,13,13,10,5,0,0,0,0,0,0,False,False,False,0,3,2022-01-05T15:19:57.383,0,True,0.0
2021,17,3316,220,27,7852,2,43,6,20,58,38,55,3,55,0,True,False,False,0,3,2022-01-03T11:48:05.45,58,False,3.0
2021,17,3316,245,11,8359,2,39,9,7,16,9,13,3,13,0,False,False,False,0,3,2022-01-04T20:45:26.067,16,False,3.0
2021,17,3316,275,27,7408,2,4,9,5,11,6,9,2,9,0,False,False,False,0,3,2022-01-03T12:11:12.157,11,False,2.0
2021,17,3316,285,27,4850,3,47,5,1,0,0,0,0,0,0,False,False,False,0,4,2022-01-03T12:15:15.08,0,False,0.0
2021,17,3316,290,27,650,2,9,6,25,28,3,28,0,28,0,False,False,False,0,3,2022-01-03T12:17:38.03,28,True,0.0
2021,17,3316,300,27,7496,2,39,4,3,6,3,4,2,4,0,False,False,False,0,3,2022-01-03T12:20:24.357,6,False,2.0
2021,17,3316,305,27,8472,2,5,3,6,7,1,7,0,7,0,False,False,False,0,3,2022-01-03T12:22:23.63,7,False,0.0
2021,17,3316,315,27,7408,13,2,9,9,0,0,0,0,0,0,False,False,False,0,2,2022-01-03T12:26:48.817,0,False,0.0
2021,17,3316,325,27,7408,2,20,4,13,13,0,13,0,13,6,True,False,False,0,3,2022-01-03T12:32:15.223,13,True,0.0
2021,17,3316,340,11,6831,3,5,3,6,0,0,0,0,0,0,True,False,False,0,3,2022-01-03T12:37:17.403,0,False,0.0
2021,17,3316,345,11,6831,13,13,9,4,0,0,0,0,0,0,False,False,False,0,3,2022-01-03T12:39:12.58,0,False,0.0
2021,17,3316,350,11,8359,13,6,9,10,0,0,0,0,0,0,False,False,False,0,3,2022-01-04T20:45:45.707,0,False,0.0
2021,17,3316,395,27,6397,2,35,9,8,8,0,8,0,8,0,False,False,False,0,4,2022-01-05T17:43:37.877,8,False,0.0
2021,17,3316,420,27,650,2,55,4,-3,1,4,1,0,1,6,False,False,False,0,4,2022-01-03T13:11:19.13,1,True,0.0
2021,17,3316,440,11,7732,2,28,9,1,1,0,1,0,1,0,False,False,False,0,1,2022-01-03T13:17:23.553,1,False,0.0
2021,17,3316,450,11,8359,2,5,3,6,6,0,6,0,6,0,False,False,False,0,3,2022-01-03T13:21:17.02,6,False,0.0
2021,17,3316,470,11,6633,13,4,9,3,0,0,0,0,0,0,False,False,False,0,2,2022-01-03T13:28:45.82,0,False,0.0
2021,17,3316,480,27,7408,2,9,3,13,13,0,13,0,13,6,False,False,False,0,2,2022-01-03T13:32:28.98,13,False,0.0
2021,17,3316,495,11,7732,13,5,3,12,0,0,0,0,0,0,False,False,False,0,4,2022-02-16T22:44:22.09,0,False,0.0
2021,17,3316,500,11,7732,13,48,9,-4,0,0,0,0,0,0,False,False,False,0,1,2022-01-05T01:18:09.79,0,False,
2021,17,3316,510,11,8359,2,35,7,16,20,4,18,2,18,0,False,False,False,0,3,2022-01-03T13:44:40.78,20,False,2.0
2021,17,3316,515,11,6815,13,39,4,5,0,0,0,0,0,0,True,False,False,0,3,2022-01-04T20:46:26.24,0,False,0.0
2021,17,3316,520,11,6633,2,19,2,42,42,0,42,0,42,0,False,False,False,0,2,2022-01-03T13:49:01.94,42,False,0.0
2021,17,3316,540,11,8359,2,4,9,7,7,0,7,0,7,6,False,False,False,0,3,2022-01-03T13:55:09.863,7,False,0.0
2021,17,3316,555,11,6633,2,50,5,-1,16,17,12,4,12,0,False,False,False,0,2,2022-01-03T14:10:56.413,6,False,4.0
2021,17,3316,560,11,4561,2,46,9,1,11,10,7,4,7,0,False,False,False,1,1,2022-01-03T14:16:44.26,11,False,4.0
2021,17,3316,575,11,4561,2,4,10,2,5,3,3,2,3,0,False,False,False,0,1,2022-01-03T14:22:40.69,5,False,2.0
2021,17,3316,585,11,8359,2,6,4,12,31,19,27,4,27,0,False,False,False,0,3,2022-01-03T14:31:20.5,31,False,4.0
2021,17,3316,590,11,6822,13,32,3,5,0,0,0,0,0,0,False,False,False,0,4,2022-01-03T14:35:26.967,0,False,0.0
2021,17,3316,600,11,7732,2,16,10,1,6,5,4,2,4,0,False,False,False,0,1,2022-01-03T14:40:27.793,6,False,2.0
2021,17,3316,605,11,3372,2,32,9,6,6,0,6,0,6,6,False,False,False,0,4,2022-02-24T18:56:48.27,6,False,0.0
2021,17,3316,625,27,5226,2,30,10,-2,11,13,9,2,9,0,False,False,False,0,1,2022-01-03T14:49:12.17,11,False,2.0
2021,17,3316,635,27,4850,13,11,6,21,0,0,0,0,0,0,True,False,False,0,1,2022-01-03T14:52:06.977,0,False,0.0
2021,17,3316,640,27,7849,2,31,10,5,12,7,6,6,6,0,False,False,False,1,3,2022-01-05T17:32:05.33,12,False,6.0
2021,17,3316,655,27,7408,2,2,10,10,17,7,15,2,15,0,False,False,False,0,2,2022-01-03T15:01:24.017,17,False,2.0
2021,17,3316,690,27,7408,2,12,10,1,1,0,1,0,1,6,False,False,False,0,3,2022-01-03T15:11:06.493,1,False,0.0
2021,17,3316,710,11,6831,2,13,9,4,8,4,8,0,8,0,False,False,False,0,3,2022-02-16T22:45:36.377,8,False,0.0
2021,17,3316,715,11,7493,2,48,9,-3,9,12,7,2,7,0,False,False,False,0,1,2022-01-03T15:35:13.38,9,False,2.0
2021,17,3316,720,11,6815,13,12,4,5,0,0,0,0,0,0,False,False,False,0,2,2022-01-03T15:37:12.047,0,False,0.0
2021,17,3316,725,11,8359,13,26,10,5,0,0,0,0,0,0,False,False,False,0,3,2022-01-05T01:41:34.077,0,False,0.0
2021,17,3316,730,11,6633,2,4,9,3,11,8,9,2,9,0,False,False,False,0,3,2022-01-03T15:41:17.183,11,False,2.0
2021,17,3316,735,11,6831,2,35,7,16,23,7,21,2,21,0,False,False,False,0,3,2022-01-04T20:46:03.44,23,False,2.0
2021,17,3316,740,11,6633,2,2,9,3,4,1,4,0,4,0,False,False,False,0,2,2022-01-03T15:45:35.663,4,False,0.0
2021,17,3316,755,11,6633,13,9,5,1,0,0,0,0,0,0,False,False,False,0,2,2022-01-03T15:51:00.983,0,False,0.0
2021,17,3316,775,27,4850,2,5,6,15,15,0,15,0,15,0,False,False,False,0,4,2022-01-05T17:12:38.843,15,False,0.0
2021,17,3316,795,27,5226,13,47,10,-2,0,0,0,0,0,0,False,False,False,0,1,2022-01-03T16:03:56.44,0,False,0.0
2021,17,3316,810,11,8359,2,50,9,-1,4,5,2,2,2,0,False,False,False,0,3,2022-01-03T16:07:43.46,4,False,2.0
2021,17,3316,815,11,6815,13,4,10,5,0,0,0,0,0,0,False,False,False,0,3,2022-01-03T16:10:15.63,0,False,0.0
2021,17,3316,840,27,8472,13,9,6,23,0,0,0,0,0,0,False,False,False,0,2,2022-01-03T16:15:54.79,0,False,0.0
2021,17,3316,855,11,8359,13,9,6,22,0,0,0,0,0,0,False,False,False,0,3,2022-01-03T16:20:07.73,0,False,0.0
2021,17,3317,15,12,556,2,29,5,13,19,6,16,3,16,0,False,False,False,0,2,2022-01-03T10:07:59.227,19,False,3.0
2021,17,3317,25,12,4537,3,13,10,2,0,0,0,0,0,0,False,False,False,0,2,2022-01-03T10:12:45.067,0,False,0.0
2021,17,3317,30,12,556,2,9,6,28,30,2,29,1,29,0,False,False,False,0,3,2022-01-03T10:15:16.72,30,False,1.0
2021,17,3317,35,12,6356,13,2,4,5,0,0,0,0,0,0,False,False,False,0,3,2022-02-22T18:57:28.61,0,False,0.0
2021,17,3317,40,12,7743,3,17,1,17,0,0,0,0,0,0,False,False,False,0,3,2022-01-03T10:21:06.723,0,False,0.0
2021,17,3317,45,12,7593,2,32,10,0,0,0,0,0,0,0,True,False,False,0,4,2022-01-03T10:23:27.367,0,False,0.0
2021,17,3317,60,18,6361,2,32,9,4,12,8,8,4,8,0,False,False,False,0,3,2022-01-05T02:18:56.06,12,False,4.0
2021,17,3317,75,18,6361,2,35,5,12,24,12,20,4,20,0,False,False,False,0,4,2022-01-03T10:39:38.81,24,False,
2021,17,3317,80,18,6361,2,31,9,5,6,1,5,1,5,0,False,False,False,0,4,2022-01-03T10:43:27.43,6,False,1.0
2021,17,3317,85,18,4152,13,47,5,4,0,0,0,0,0,0,False,False,False,0,1,2022-01-05T03:26:04.617,0,False,0.0
2021,17,3317,105,12,4537,2,34,4,-5,4,9,0,4,0,0,True,False,False,0,3,2022-01-03T10:58:36.92,4,False,4.0
2021,17,3317,115,12,4537,2,51,10,-1,0,1,-1,1,-1,0,False,False,False,1,4,2022-01-05T03:16:20.993,0,False,1.0
2021,17,3317,120,12,556,13,26,3,11,0,0,0,0,0,0,False,False,False,0,3,2022-01-05T03:26:12.933,0,False,0.0
2021,17,3317,125,18,7711,3,34,4,-4,0,0,0,0,0,0,True,False,False,0,2,2022-01-03T11:15:21.203,0,False,0.0
2021,17,3317,135,18,7711,2,2,10,4,7,3,6,1,6,0,False,False,False,0,3,2022-01-03T11:19:11.97,7,False,1.0
2021,17,3317,150,12,4537,2,44,3,-4,6,10,3,3,3,0,True,False,False,0,1,2022-01-03T11:24:19.817,6,False,3.0
2021,17,3317,175,18,4572,2,48,9,-6,0,6,-2,2,-2,0,False,False,False,0,1,2022-01-03T11:31:01.183,0,False,2.0
2021,17,3317,180,18,4572,2,28,4,1,1,0,1,0,1,0,False,False,False,0,1,2022-01-03T11:33:11.893,1,False,0.0
2021,17,3317,190,12,4537,2,4,10,3,12,9,9,3,9,0,False,False,False,0,4,2022-01-03T11:50:46.783,12,False,3.0
2021,17,3317,200,12,6691,2,6,10,13,13,0,13,0,13,0,False,False,False,0,3,2022-01-05T02:19:12.51,13,False,0.0
2021,17,3317,210,12,556,2,51,5,1,2,1,2,0,2,0,False,False,False,0,3,2022-01-03T11:59:20.937,2,False,0.0
2021,17,3317,215,12,7743,2,53,4,-3,4,7,3,1,3,0,False,False,False,0,4,2022-01-03T12:01:20.193,4,False,1.0
2021,17,3317,220,12,556,13,2,9,6,0,0,0,0,0,0,False,False,False,0,2,2022-01-03T12:03:03.457,0,False,0.0
2021,17,3317,240,18,6361,13,4,9,5,0,0,0,0,0,0,False,False,False,0,3,2022-01-03T12:07:30.583,0,False,0.0
2021,17,3317,265,12,556,2,51,10,0,15,15,15,0,15,0,False,False,False,0,3,2022-01-03T12:15:00.447,15,False,0.0
2021,17,3317,270,12,6691,2,8,10,12,17,5,17,0,17,0,False,False,False,0,3,2022-01-05T16:08:26.677,17,False,0.0
2021,17,3317,275,12,556,2,51,9,1,5,4,3,2,3,0,True,False,False,0,3,2022-01-03T12:18:52.457,5,False,2.0
2021,17,3317,280,12,6691,2,21,2,20,20,0,20,0,20,6,True,False,False,0,3,2022-01-03T12:20:57.843,20,True,0.0
2021,17,3317,315,12,556,2,6,4,11,19,8,16,3,16,0,False,False,False,0,3,2022-01-05T02:19:28.34,19,False,3.0
2021,17,3317,325,12,4537,2,32,5,3,8,5,6,2,6,0,False,False,False,1,1,2022-01-03T12:32:25.287,8,False,2.0
2021,17,3317,330,12,6357,2,18,5,2,3,1,2,1,2,0,False,False,False,0,2,2022-01-03T12:34:20.693,3,False,1.0
2021,17,3317,340,12,6691,2,4,5,5,6,1,6,0,6,0,False,False,False,0,2,2022-01-03T12:36:56.653,6,False,0.0
2021,17,3317,345,12,556,2,29,5,12,17,5,14,3,14,0,False,False,False,0,2,2022-01-03T12:38:40.203,17,False,3.0
2021,17,3317,350,12,556,2,20,4,11,11,0,11,0,11,6,False,False,False,0,3,2022-01-03T12:40:25.647,11,True,0.0
2021,17,3317,365,18,7712,2,4,3,5,6,1,5,1,5,0,False,False,False,0,2,2022-01-03T12:43:08.147,6,False,1.0
2021,17,3317,370,18,6361,13,5,3,10,0,0,0,0,0,0,False,False,False,0,4,2022-01-03T12:45:26.763,0,False,0.0
2021,17,3317,375,18,7711,2,26,9,7,7,0,7,0,7,0,False,False,False,0,2,2022-01-03T12:46:55.2,7,False,0.0
2021,17,3317,385,18,6361,2,38,4,1,2,1,1,1,1,0,False,False,False,0,4,2022-01-03T12:48:41.053,2,False,1.0
2021,17,3317,395,18,7711,2,5,3,14,16,2,16,0,16,0,False,False,False,0,3,2022-01-03T12:50:46.09,16,False,0.0
2021,17,3317,410,18,7712,13,5,3,13,0,0,0,0,0,0,False,False,False,0,3,2022-01-03T12:54:19.733,0,False,0.0
2021,17,3317,450,18,4152,2,47,5,1,1,0,1,0,1,0,False,False,False,0,4,2022-01-04T15:59:49.287,1,False,0.0
2021,17,3317,455,18,7712,13,25,2,27,0,0,0,0,0,0,False,False,False,0,2,2022-01-05T16:08:53.83,0,False,0.0
2021,17,3317,465,12,556,13,13,9,3,0,0,0,0,0,0,True,False,False,0,3,2022-01-05T02:19:39.99,0,False,
2021,17,3317,470,12,6691,2,17,10,8,9,1,8,1,8,0,False,False,False,0,3,2022-01-05T03:17:40.397,9,False,1.0
2021,17,3317,480,12,556,13,26,10,6,0,0,0,0,0,0,False,False,False,0,3,2022-01-03T13:33:28.32,0,False,0.0
2021,17,3317,515,18,4940,2,46,3,2,4,2,3,1,3,0,False,False,False,0,3,2022-01-03T13:44:14.643,4,False,1.0
2021,17,3317,520,18,6361,2,32,5,2,15,13,9,6,9,0,False,False,False,1,4,2022-01-05T03:26:46.203,15,False,6.0
2021,17,3317,530,18,7711,13,6,10,14,0,0,0,0,0,0,False,False,False,0,3,2022-01-05T02:19:48.21,0,False,0.0
2021,17,3317,535,18,6361,2,31,9,3,12,9,11,1,11,0,False,False,False,0,4,2022-01-03T13:56:40.353,12,False,1.0
2021,17,3317,540,18,7711,13,13,10,3,0,0,0,0,0,0,False,False,False,0,2,2022-01-03T13:58:42.987,0,False,0.0
2021,17,3317,545,12,7742,13,28,5,8,0,0,0,0,0,0,False,False,False,0,1,2022-02-16T20:57:31.46,0,False,0.0
2021,17,3317,550,12,556,2,6,4,13,13,0,13,0,13,0,False,False,False,0,3,2022-01-03T14:03:07.187,13,False,0.0
2021,17,3317,555,12,7593,2,30,5,2,9,7,8,1,8,0,False,False,False,0,4,2022-01-03T14:05:04.66,9,False,1.0
2021,17,3317,575,12,6357,13,21,6,19,0,0,0,0,0,0,False,False,False,0,2,2022-01-03T14:11:29.417,0,False,0.0
2021,17,3317,590,18,7711,2,6,9,11,11,0,11,0,11,0,False,False,False,0,3,2022-01-03T14:14:12.607,11,False,0.0
2021,17,3317,595,18,6361,13,28,5,2,0,0,0,0,0,0,False,False,False,0,4,2022-01-03T14:16:09.073,0,False,0.0
2021,17,3317,600,18,4572,2,50,9,-4,-1,3,-2,1,-2,0,True,False,False,0,3,2022-01-03T14:18:20.72,-1,False,1.0
2021,17,3317,605,18,7711,2,26,10,5,10,5,8,2,8,0,False,False,False,0,3,2022-01-03T14:20:47.177,10,False,2.0
2021,17,3317,615,18,6900,2,6,9,3,7,4,5,2,5,0,False,False,False,0,1,2022-01-05T02:19:59.257,7,False,2.0
2021,17,3317,620,18,6890,2,12,4,-5,21,26,9,12,9,0,False,False,False,1,5,2022-01-03T14:27:52.433,21,False,12.0
2021,17,3317,625,18,7712,2,2,9,13,14,1,13,1,13,6,False,False,False,0,3,2022-01-05T03:17:40.397,14,False,1.0
2021,17,3317,645,12,7742,2,46,3,4,11,7,8,3,8,0,False,False,False,0,1,2022-01-03T14:45:53.173,11,False,3.0
2021,17,3317,660,12,8279,13,32,3,-1,0,0,0,0,0,0,False,False,False,0,4,2022-01-05T16:10:09.533,0,False,0.0
2021,17,3317,665,12,6356,2,4,10,5,14,9,10,4,10,0,False,False,False,0,3,2022-01-05T15:54:31.66,14,False,4.0
2021,17,3317,670,12,556,2,51,9,-1,5,6,4,1,4,0,True,False,False,0,3,2022-01-03T14:56:50.693,5,False,1.0
2021,17,3317,680,12,7742,2,46,3,3,9,6,8,1,8,0,False,False,False,0,1,2022-01-03T14:59:54.503,9,False,1.0
2021,17,3317,685,12,7743,2,4,5,4,7,3,6,1,6,0,False,False,False,0,2,2022-01-03T15:01:44.063,7,False,1.0
2021,17,3317,690,12,556,2,30,9,-1,0,1,0,0,0,0,False,False,False,0,3,2022-01-05T02:20:08.197,0,False,0.0
2021,17,3317,720,18,6900,2,46,9,-3,6,9,4,2,4,0,False,False,False,0,1,2022-01-03T15:09:01.83,6,False,2.0
2021,17,3317,725,18,6900,2,47,10,-1,-1,0,-1,0,-1,0,False,False,False,0,1,2022-01-05T16:10:35.037,-1,False,0.0
2021,17,3317,730,18,7712,13,2,10,7,0,0,0,0,0,0,False,False,False,0,2,2022-01-03T15:12:44.72,0,False,0.0
2021,17,3317,755,12,6691,2,51,10,-1,7,8,6,1,6,0,False,False,False,0,3,2022-01-03T15:19:59.41,7,False,1.0
2021,17,3317,760,12,6872,2,51,3,2,12,10,7,5,7,0,False,False,False,0,3,2022-01-03T15:21:32.403,12,False,5.0
2021,17,3317,770,12,6872,13,35,3,13,0,0,0,0,0,0,False,False,False,0,3,2022-01-05T02:20:16.87,0,False,0.0
2021,17,3317,795,12,6357,13,5,5,11,0,0,0,0,0,0,False,False,False,0,2,2022-01-03T15:31:27.933,0,False,0.0
2021,17,3317,805,18,7712,13,26,4,7,0,0,0,0,0,0,True,False,False,0,3,2022-01-03T15:34:45.817,0,False,
2021,17,3317,810,18,7711,2,50,10,-2,7,9,5,2,5,0,False,False,False,0,3,2022-01-03T15:37:14.363,7,False,2.0
2021,17,3317,815,18,7711,13,29,2,17,0,0,0,0,0,0,False,False,False,0,2,2022-01-05T02:20:25.317,0,False,0.0
2021,17,3317,820,18,7712,2,9,6,29,30,1,30,0,30,0,False,False,False,0,2,2022-01-03T15:41:09.897,30,False,0.0
2021,17,3317,825,18,6361,13,8,9,14,0,0,0,0,0,0,False,False,False,0,4,2022-01-03T15:43:34.527,0,False,0.0
2021,17,3317,830,18,6900,2,47,5,-1,1,2,1,0,1,0,False,False,False,0,3,2022-01-05T03:27:03.457,1,False,0.0
2021,17,3317,835,18,6900,13,6,9,4,0,0,0,0,0,0,False,False,False,0,1,2022-01-03T15:47:47.553,0,False,0.0
2021,17,3317,840,18,7711,13,19,2,37,0,0,0,0,0,0,False,False,False,0,2,2022-01-05T02:20:41.007,0,False,0.0
2021,17,3318,15,25,7666,2,5,5,4,6,2,5,1,5,0,False,False,False,0,3,2022-01-04T15:28:10.557,6,False,1.0
2021,17,3318,20,25,8422,2,30,5,-4,-4,0,-4,0,-4,0,False,False,False,0,4,2022-01-04T15:30:04.277,-4,False,0.0
2021,17,3318,25,25,7060,3,4,5,9,0,0,0,0,0,0,False,False,False,0,2,2022-02-16T22:31:11.583,0,False,0.0
2021,17,3318,30,25,7666,2,52,4,2,8,6,6,2,6,0,False,False,False,0,2,2022-01-06T19:58:01.193,8,False,2.0
2021,17,3318,45,8,232,2,26,9,5,20,15,20,0,20,0,False,False,False,0,3,2022-01-04T15:37:23.187,20,False,0.0
2021,17,3318,50,8,3883,13,7,6,15,0,0,0,0,0,0,False,False,False,0,3,2022-01-04T15:39:34.243,0,False,0.0
2021,17,3318,55,8,8349,13,2,9,7,0,0,0,0,0,0,False,False,False,0,2,2022-01-04T15:41:05.54,0,False,0.0
2021,17,3318,60,8,3883,3,32,5,3,0,0,0,0,0,0,False,False,False,0,4,2022-01-06T19:58:01.193,0,False,0.0
2021,17,3318,85,25,7666,13,2,5,7,0,0,0,0,0,0,False,False,False,0,2,2022-01-04T15:48:12.603,0,False,0.0
2021,17,3318,95,25,8421,2,5,5,-1,-2,-1,-2,0,-2,0,False,False,False,0,1,2022-01-04T15:49:38.337,-2,False,0.0
2021,17,3318,125,8,232,13,35,3,8,0,0,0,0,0,0,False,False,False,0,3,2022-01-06T20:46:14.407,0,False,0.0
2021,17,3318,130,8,232,13,35,9,7,0,0,0,0,0,0,True,False,False,0,3,2022-01-05T19:26:52.687,0,False,0.0
2021,17,3318,140,25,7060,2,39,10,5,6,1,6,0,6,0,False,False,False,0,2,2022-01-06T20:50:53.623,6,False,0.0
2021,17,3318,145,25,7060,13,19,2,43,0,0,0,0,0,0,False,False,False,0,2,2022-01-04T16:02:46.047,0,False,0.0
2021,17,3318,165,25,7060,2,51,5,-3,0,3,0,0,0,0,False,False,False,0,2,2022-01-04T16:07:31.15,0,False,0.0
2021,17,3318,170,25,6486,13,19,6,36,0,0,0,0,0,0,False,False,False,0,2,2022-01-04T16:08:36.373,0,False,0.0
2021,17,3318,175,25,7060,2,13,10,2,5,3,3,2,3,0,False,False,False,0,2,2022-01-04T16:09:54.617,5,False,2.0
2021,17,3318,180,25,8422,13,17,9,9,0,0,0,0,0,0,False,False,False,0,3,2022-01-04T16:11:53.137,0,False,0.0
2021,17,3318,190,8,232,13,4,5,5,0,0,0,0,0,0,False,False,False,0,2,2022-01-04T16:14:04.15,0,False,0.0
2021,17,3318,215,25,6259,2,4,5,10,11,1,10,1,10,0,False,False,False,0,3,2022-01-06T19:58:01.193,11,False,1.0
2021,17,3318,225,25,6259,2,39,10,4,8,4,6,2,6,0,False,False,False,0,3,2022-01-06T20:51:22.913,8,False,
2021,17,3318,230,25,8421,2,4,10,2,7,5,5,2,5,0,False,False,False,0,1,2022-01-04T16:24:43.787,7,False,2.0
2021,17,3318,235,25,6259,13,2,10,5,0,0,0,0,0,0,False,False,False,0,3,2022-01-06T20:45:56.857,0,False,0.0
2021,17,3318,240,25,7060,3,6,9,8,0,0,0,0,0,0,False,False,False,0,2,2022-01-04T16:28:07.087,0,False,0.0
2021,17,3318,245,25,7666,2,50,10,-2,3,5,-1,4,-1,0,False,False,False,0,2,2022-01-06T20:48:21.87,3,False,4.0
2021,17,3318,260,25,7060,2,2,10,4,5,1,4,1,4,6,False,False,False,0,2,2022-01-04T16:32:46.81,5,False,1.0
2021,17,3318,280,8,8349,13,8,10,11,0,0,0,0,0,0,False,False,False,0,3,2022-01-06T19:58:01.193,0,False,0.0
2021,17,3318,285,8,7009,3,53,9,-5,0,0,0,0,0,0,False,False,False,0,4,2022-01-04T16:37:13.8,0,False,0.0
2021,17,3318,295,25,7053,2,54,10,-2,0,2,-1,1,-1,0,False,False,False,0,4,2022-02-16T22:32:13.637,0,False,1.0
2021,17,3318,305,25,8421,2,52,4,1,13,12,10,3,10,0,False,False,False,0,1,2022-01-06T19:58:01.193,13,False,3.0
2021,17,3318,315,8,7651,13,7,6,17,0,0,0,0,0,0,True,False,False,0,4,2022-01-04T16:47:54.987,0,False,0.0
2021,17,3318,320,25,7666,13,8,1,36,0,0,0,0,0,0,True,False,False,0,3,2022-01-04T16:50:37.447,0,False,0.0
2021,17,3318,330,25,7060,2,4,3,3,1,-2,1,0,1,0,False,False,False,0,2,2022-01-04T16:53:20.09,1,False,0.0
2021,17,3318,335,25,8422,2,12,3,2,12,10,8,4,8,0,False,False,False,0,4,2022-01-06T20:46:27.977,12,False,4.0
2021,17,3318,340,25,6259,2,51,5,-3,3,6,3,0,3,0,False,False,False,0,3,2022-01-04T16:56:05.717,3,False,0.0
2021,17,3318,345,25,6259,13,5,9,3,0,0,0,0,0,0,False,False,False,0,3,2022-01-04T16:57:21.22,0,False,0.0
2021,17,3318,350,25,6259,2,36,4,8,9,1,9,0,9,0,False,False,False,0,3,2022-01-04T16:58:56.54,9,False,0.0
2021,17,3318,355,25,6259,13,5,3,4,0,0,0,0,0,0,False,False,False,0,3,2022-01-06T20:46:45.947,0,False,0.0
2021,17,3318,360,25,7666,13,2,9,4,0,0,0,0,0,0,False,False,False,0,2,2022-01-04T17:05:45.157,0,False,0.0
2021,17,3318,365,25,7053,13,13,10,3,0,0,0,0,0,0,False,False,False,0,4,2022-01-06T20:51:53.98,0,False,0.0
2021,17,3318,390,8,232,2,12,3,9,9,0,9,0,9,0,False,False,False,0,1,2022-01-06T20:46:56.753,9,False,0.0
2021,17,3318,405,8,3606,13,4,3,8,0,0,0,0,0,0,False,False,False,0,2,2022-01-04T17:12:54.59,0,False,0.0
2021,17,3318,415,8,7651,2,8,8,21,22,1,22,0,22,0,False,False,False,0,2,2022-01-06T20:47:07.787,22,False,0.0
2021,17,3318,425,8,232,2,5,5,5,7,2,7,0,7,0,False,False,False,0,3,2022-01-04T17:17:22.71,7,False,0.0
2021,17,3318,455,25,7060,2,18,3,-2,1,3,0,1,0,0,False,False,False,2,2,2022-01-04T17:21:05.113,1,False,1.0
2021,17,3318,460,25,8422,2,46,3,-1,8,9,8,0,8,0,False,False,False,1,4,2022-01-04T17:22:31.31,8,True,0.0
2021,17,3318,465,25,8422,2,5,3,3,4,1,3,1,3,0,False,False,False,0,3,2022-01-04T17:24:24.057,4,False,1.0
2021,17,3318,470,25,7060,13,9,2,16,0,0,0,0,0,0,False,False,False,0,2,2022-01-04T17:26:22.023,0,False,0.0
2021,17,3318,480,25,7666,13,12,10,9,0,0,0,0,0,0,False,False,False,0,2,2022-01-04T17:28:00.8,0,False,0.0
2021,17,3318,515,25,7060,13,3,2,16,0,0,0,0,0,0,False,False,False,0,2,2022-01-04T17:35:32.873,0,False,0.0
2021,17,3318,530,25,7060,2,5,3,3,3,0,3,0,3,0,False,False,False,0,3,2022-01-04T17:40:04.457,3,False,0.0
2021,17,3318,535,25,7666,13,19,2,36,0,0,0,0,0,0,False,False,False,0,2,2022-01-04T17:41:37.593,0,False,
2021,17,3318,540,25,7060,2,4,3,9,10,1,10,0,10,0,False,False,False,0,2,2022-01-06T19:58:01.193,10,False,0.0
2021,17,3318,550,25,6259,2,13,9,2,12,10,11,1,11,0,False,False,False,0,3,2022-01-04T17:46:04.697,12,False,1.0
2021,17,3318,555,25,7060,13,13,4,1,0,0,0,0,0,0,False,False,False,0,2,2022-01-06T20:52:39.78,0,False,0.0
2021,17,3318,560,25,6259,13,47,5,2,0,0,0,0,0,0,False,False,False,0,3,2022-01-04T17:48:54.34,0,False,0.0
2021,17,3318,565,25,8422,2,46,3,-1,2,3,0,2,0,0,False,False,False,1,4,2022-01-06T20:53:05.15,2,False,2.0
2021,17,3318,580,8,232,2,5,9,6,7,1,7,0,7,0,False,False,False,0,3,2022-01-06T20:47:28.597,7,False,0.0
2021,17,3318,595,8,232,13,4,5,8,0,0,0,0,0,0,False,False,False,0,2,2022-01-04T17:56:40.473,0,False,0.0
2021,17,3318,630,8,7651,2,6,7,16,39,23,32,7,32,0,False,False,False,0,3,2022-01-04T18:04:35.79,39,False,7.0
2021,17,3318,645,8,4976,2,29,5,3,3,0,3,0,3,6,False,False,False,0,2,2022-01-04T18:08:06.54,3,True,0.0
2021,17,3318,665,25,6259,13,13,9,3,0,0,0,0,0,0,False,False,False,0,2,2022-02-22T19:47:36.373,0,False,0.0
2021,17,3318,675,25,6259,13,5,5,2,0,0,0,0,0,0,False,False,False,0,3,2022-01-04T18:13:03.967,0,False,0.0
2021,17,3318,695,8,3883,2,2,4,5,21,16,19,2,19,0,False,False,False,0,4,2022-01-04T18:18:34.103,21,False,2.0
2021,17,3318,705,8,232,13,5,3,11,0,0,0,0,0,0,False,False,False,0,3,2022-01-04T18:21:44.697,0,False,0.0
2021,17,3318,715,8,7651,13,4,3,12,0,0,0,0,0,0,False,False,False,0,3,2022-01-04T18:24:29.497,0,False,0.0
2021,17,3318,745,25,7666,13,9,3,9,0,0,0,0,0,0,False,False,False,0,2,2022-01-04T18:34:33.907,0,False,0.0
2021,17,3318,755,25,7060,13,3,3,10,0,0,0,0,0,0,False,False,False,0,2,2022-01-04T18:37:27.003,0,False,0.0
2021,17,3318,815,25,7666,13,29,3,9,0,0,0,0,0,0,False,False,False,0,2,2022-01-04T18:49:05.157,0,False,0.0
2021,17,3318,830,8,4976,2,39,9,5,8,3,6,2,6,0,False,False,False,0,3,2022-01-04T19:08:38.933,8,False,2.0
2021,17,3318,840,8,4976,2,4,10,7,8,1,8,0,8,0,False,False,False,0,3,2022-01-04T19:10:40.82,8,False,0.0
2021,17,3318,860,8,3606,13,24,2,25,0,0,0,0,0,0,False,False,False,0,3,2022-01-04T19:14:13.957,0,False,
2021,17,3318,865,8,3606,3,13,9,2,0,0,0,0,0,0,False,False,False,0,3,2022-01-04T19:15:43.047,0,False,0.0
2021,17,3318,870,8,6439,13,47,5,4,0,0,0,0,0,0,False,False,False,0,3,2022-01-04T19:17:35.957,0,False,0.0
2021,17,3318,885,8,7009,2,48,10,-4,1,5,-3,4,-3,0,False,False,False,1,1,2022-01-04T19:21:45.907,1,False,4.0
2021,17,3318,895,8,3606,2,5,5,5,8,3,8,0,8,0,True,False,False,0,3,2022-01-04T19:23:50.393,8,True,0.0
2021,17,3318,900,8,7651,2,7,2,15,15,0,15,0,15,0,False,False,False,0,3,2022-01-04T19:25:08.883,15,True,0.0
2021,17,3318,905,8,3606,13,19,2,22,0,0,0,0,0,0,False,False,False,0,2,2022-01-04T19:26:07.493,0,False,0.0
2021,17,3318,910,8,4976,2,4,9,6,9,3,8,1,8,0,False,False,False,0,3,2022-01-04T19:27:12.81,9,False,1.0
2021,17,3318,925,8,232,13,11,5,11,0,0,0,0,0,0,False,False,False,0,2,2022-01-05T19:26:22.287,0,False,0.0
2021,17,3318,930,8,232,13,12,5,11,0,0,0,0,0,0,False,False,False,0,3,2022-01-04T19:31:05.82,0,False,
2021,17,3318,935,8,7652,2,7,9,1,1,0,1,0,1,6,True,False,False,0,4,2022-01-04T19:32:56.193,1,True,0.0
2021,17,3318,985,8,7009,3,6,4,4,0,0,0,0,0,0,False,False,False,0,1,2022-01-04T19:38:49.843,0,False,0.0
2021,17,3318,990,8,3883,2,5,9,4,7,3,5,2,5,0,False,False,False,0,3,2022-01-04T19:39:46.553,7,False,2.0
2021,17,3318,995,8,3606,13,17,8,17,0,0,0,0,0,0,False,False,False,0,3,2022-01-04T19:41:09.147,0,False,0.0
2021,17,3318,1000,8,3883,13,2,4,10,0,0,0,0,0,0,False,False,False,0,4,2022-01-06T20:48:02.913,0,False,0.0
2021,18,3319,10,20,8728,2,46,3,-1,2,3,1,1,1,0,False,False,False,0,1,2022-01-10T13:06:15.29,2,False,1.0
2021,18,3319,15,20,6388,2,5,5,4,8,4,6,2,6,0,False,False,False,0,3,2022-01-11T23:12:40.66,8,False,2.0
2021,18,3319,35,20,3848,2,53,10,-5,10,15,3,7,3,0,False,False,False,1,4,2022-02-17T16:07:35.817,10,False,7.0
2021,18,3319,55,20,7888,2,43,3,14,18,4,16,2,16,6,False,False,False,0,4,2022-01-10T13:19:24.987,18,False,2.0
2021,18,3319,75,2,5214,3,38,9,7,0,0,0,0,0,0,False,False,False,0,4,2022-01-12T15:51:05.697,0,False,
2021,18,3319,85,2,811,2,50,5,-4,1,5,0,1,0,0,False,False,False,0,2,2022-01-12T15:51:52,1,False,1.0
2021,18,3319,90,2,6247,2,7,2,24,26,2,24,2,24,0,False,False,False,0,3,2022-01-10T13:33:35.187,26,False,2.0
2021,18,3319,95,2,8389,13,6,9,11,0,0,0,0,0,0,False,False,False,0,3,2022-01-10T13:36:07.657,0,False,0.0
2021,18,3319,100,2,6247,2,5,5,7,9,2,8,1,8,0,False,False,False,0,3,2022-01-12T15:51:18.777,9,False,1.0
2021,18,3319,110,2,8389,2,54,9,0,1,1,1,0,1,0,False,False,False,0,4,2022-01-10T13:43:27.327,1,False,0.0
2021,18,3319,135,20,7356,2,6,6,19,26,7,21,5,21,0,False,False,False,0,3,2022-01-10T13:50:53.543,26,False,5.0
2021,18,3319,150,20,7353,13,8,1,35,0,0,0,0,0,0,False,False,False,0,3,2022-01-11T23:12:53.833,0,False,0.0
2021,18,3319,155,20,7353,2,2,9,6,9,3,7,2,7,0,False,False,False,0,2,2022-01-11T23:13:29.77,9,False,2.0
2021,18,3319,180,20,8131,13,9,2,16,0,0,0,0,0,0,False,False,False,0,3,2022-01-11T23:14:20.987,0,False,0.0
2021,18,3319,190,2,2835,2,46,3,3,3,0,3,0,3,0,True,False,False,0,4,2022-01-10T14:05:39.42,3,False,0.0
2021,18,3319,200,2,7303,2,7,7,26,28,2,26,2,26,0,False,False,False,0,3,2022-01-10T14:08:20.283,28,False,2.0
2021,18,3319,215,2,6247,13,2,4,7,0,0,0,0,0,0,False,False,False,0,2,2022-01-10T14:12:29,0,False,0.0
2021,18,3319,240,20,6388,2,6,4,9,34,25,14,20,14,0,False,False,False,1,3,2022-01-12T15:54:49.363,34,False,20.0
2021,18,3319,265,20,2408,3,17,8,24,0,0,0,0,0,0,False,False,False,0,3,2022-01-10T14:31:42.473,0,False,0.0
2021,18,3319,270,20,6388,13,5,3,11,0,0,0,0,0,0,False,False,False,0,2,2022-01-10T14:34:47.12,0,False,
2021,18,3319,275,20,6388,2,9,3,13,13,0,13,0,13,6,False,False,False,0,2,2022-01-10T14:54:48.667,13,False,0.0
2021,18,3319,290,2,6247,13,19,2,35,0,0,0,0,0,0,False,False,False,0,2,2022-01-10T15:00:02.763,0,False,0.0
2021,18,3319,320,20,2408,2,32,10,1,1,0,1,0,1,0,False,False,False,0,3,2022-01-10T15:07:55.31,1,False,0.0
2021,18,3319,330,20,5140,2,44,3,-8,3,11,3,0,3,0,False,False,False,0,1,2022-01-10T15:10:23.083,3,True,0.0
2021,18,3319,340,20,8127,13,9,2,15,0,0,0,0,0,0,False,False,False,0,3,2022-01-11T23:14:33.293,0,False,0.0
2021,18,3319,360,2,2554,2,44,3,-4,-6,-2,-4,-2,-4,0,False,True,True,0,1,2022-01-10T17:22:44.717,-6,False,-2.0
2021,18,3319,365,20,6388,13,5,3,10,0,0,0,0,0,0,False,False,False,0,3,2022-01-11T23:14:56.65,0,False,0.0
2021,18,3319,375,20,8127,2,39,4,5,5,0,5,0,5,6,False,False,False,0,3,2022-01-10T15:27:08.737,5,False,0.0
2021,18,3319,405,2,2554,2,31,4,1,1,0,1,0,1,0,False,False,False,0,1,2022-01-10T17:24:39.363,1,False,0.0
2021,18,3319,410,2,8389,13,26,4,8,0,0,0,0,0,0,False,False,False,0,3,2022-01-12T16:16:08.61,0,False,0.0
2021,18,3319,435,20,8126,13,46,3,0,0,0,0,0,0,0,False,False,False,0,1,2022-01-10T15:44:55.59,0,False,0.0
2021,18,3319,445,20,5140,2,48,10,-5,13,18,11,2,11,0,False,False,False,0,1,2022-01-10T15:48:10.333,13,False,2.0
2021,18,3319,455,2,6247,2,34,4,-4,16,20,4,12,4,0,True,False,False,2,3,2022-01-10T15:52:34.477,16,False,12.0
2021,18,3319,470,2,3506,13,9,2,16,0,0,0,0,0,0,False,False,False,0,2,2022-01-12T14:19:19.607,0,False,0.0
2021,18,3319,485,2,7296,13,48,10,-2,0,0,0,0,0,0,False,False,False,0,1,2022-01-10T16:01:03.357,0,False,0.0
2021,18,3319,505,20,7353,2,4,10,4,5,1,5,0,5,0,False,False,False,0,3,2022-01-10T16:05:27.58,5,False,0.0
2021,18,3319,515,2,6247,13,21,8,40,0,0,0,0,0,0,False,False,False,0,2,2022-01-10T16:08:52.323,0,False,0.0
2021,18,3319,520,2,5214,2,19,6,30,33,3,30,3,30,0,False,False,False,0,3,2022-01-10T16:10:11.89,33,False,3.0
2021,18,3319,525,2,6247,2,4,10,4,4,0,4,0,4,0,False,False,False,0,4,2022-01-10T16:12:33.28,4,False,0.0
2021,18,3319,545,20,6388,2,31,4,6,8,2,8,0,8,0,False,False,False,0,3,2022-01-10T16:16:08.56,8,False,0.0
2021,18,3319,555,20,6388,2,5,3,10,13,3,13,0,13,0,False,False,False,1,2,2022-01-10T16:21:07.717,13,False,0.0
2021,18,3319,595,20,7353,2,5,5,5,10,5,9,1,9,0,False,False,False,0,3,2022-01-10T16:30:49.907,10,False,1.0
2021,18,3319,605,20,6388,13,7,3,5,0,0,0,0,0,0,False,False,False,0,3,2022-01-10T16:33:04.463,0,False,0.0
2021,18,3319,625,2,2554,2,48,10,-5,3,8,2,1,2,0,False,True,True,1,1,2022-01-12T15:52:09.417,3,False,1.0
2021,18,3319,675,2,7303,2,47,5,1,6,5,3,3,3,0,False,False,False,0,3,2022-01-11T22:22:15.933,6,False,3.0
2021,18,3319,680,2,6247,13,7,6,21,0,0,0,0,0,0,True,False,False,0,2,2022-01-10T16:52:33.4,0,False,0.0
2021,18,3319,725,2,6247,2,2,9,6,14,8,1,13,1,0,False,False,False,1,3,2022-01-10T17:00:17.467,14,False,13.0
2021,18,3319,730,2,6247,2,12,8,21,21,0,21,0,21,0,False,False,False,0,2,2022-01-10T17:01:54.237,21,False,0.0
2021,18,3319,735,2,7303,2,4,5,12,13,1,13,0,13,0,False,False,False,0,2,2022-01-12T16:16:08.61,13,True,0.0
2021,18,3319,740,2,8389,2,26,10,4,7,3,5,2,5,0,False,False,False,0,3,2022-01-10T17:04:10.923,7,False,2.0
2021,18,3319,745,2,6240,13,18,5,-2,0,0,0,0,0,0,False,False,False,0,2,2022-01-11T22:24:16.163,0,False,0.0
2021,18,3319,755,2,6247,2,2,9,12,17,5,17,0,17,0,False,False,False,0,2,2022-01-10T17:08:03.587,17,False,0.0
2021,18,3319,760,2,6247,13,8,7,19,0,0,0,0,0,0,False,False,False,0,3,2022-01-10T17:09:18.303,0,False,0.0
2021,18,3319,765,2,8389,3,29,6,19,0,0,0,0,0,0,False,False,False,0,2,2022-02-22T21:57:13.01,0,False,0.0
2021,18,3319,770,2,3506,13,6,9,14,0,0,0,0,0,0,False,False,False,0,3,2022-01-10T17:12:07.16,0,False,0.0
2021,18,3319,775,2,6247,2,8,8,18,18,0,18,0,18,0,False,False,False,0,3,2022-01-12T16:18:48.443,18,False,0.0
2021,18,3319,780,2,6247,2,47,5,1,1,0,1,0,1,6,True,False,False,0,3,2022-01-10T17:14:48.027,1,False,0.0
2021,18,3320,20,25,8421,2,5,5,6,4,-2,4,0,4,0,False,False,False,0,2,2022-01-10T13:37:56.96,4,False,0.0
2021,18,3320,35,3,8430,2,4,3,4,3,-1,3,0,3,0,False,False,False,0,2,2022-01-12T20:22:34.013,3,False,0.0
2021,18,3320,40,3,8430,2,2,10,6,19,13,12,7,12,0,True,False,False,0,3,2022-01-12T21:05:27.287,19,False,7.0
2021,18,3320,55,25,7053,2,31,10,2,11,9,8,3,8,0,False,False,False,0,4,2022-01-12T19:20:01.073,11,False,3.0
2021,18,3320,70,25,7666,13,5,5,10,0,0,0,0,0,0,False,False,False,0,3,2022-01-10T11:17:04.717,0,False,0.0
2021,18,3320,80,25,7060,2,2,9,3,10,7,8,2,8,0,False,False,False,1,2,2022-01-12T20:23:57.467,10,False,2.0
2021,18,3320,105,3,6454,2,5,5,11,13,2,12,1,12,0,False,False,False,0,4,2022-01-10T11:25:43.217,13,False,1.0
2021,18,3320,120,3,6454,13,17,8,25,0,0,0,0,0,0,False,False,False,0,3,2022-01-12T19:20:01.073,0,False,0.0
2021,18,3320,135,25,8422,2,6,10,5,7,2,6,1,6,0,False,False,False,0,4,2022-01-12T20:40:03.877,7,False,1.0
2021,18,3320,140,25,6259,13,12,2,30,0,0,0,0,0,0,False,False,False,0,3,2022-01-12T20:22:03.933,0,False,0.0
2021,18,3320,155,3,6936,2,13,9,2,11,9,10,1,10,0,False,False,False,0,3,2022-01-10T11:43:38.873,11,False,1.0
2021,18,3320,170,3,8434,13,19,3,8,0,0,0,0,0,0,False,False,False,0,2,2022-01-10T11:51:18.82,0,False,0.0
2021,18,3320,175,25,6259,2,30,5,0,0,0,0,0,0,0,False,False,False,0,4,2022-01-12T21:04:57.863,0,False,0.0
2021,18,3320,185,25,6259,2,50,9,-3,7,10,5,2,5,0,False,False,False,1,3,2022-01-10T11:56:28.007,7,False,2.0
2021,18,3320,200,3,6454,13,6,4,12,0,0,0,0,0,0,False,False,False,0,3,2022-01-12T20:17:46.55,0,False,0.0
2021,18,3320,205,3,6454,13,39,4,8,0,0,0,0,0,0,False,False,False,0,4,2022-01-12T21:04:27.687,0,False,0.0
2021,18,3320,220,25,7053,2,21,9,13,25,12,21,4,21,0,False,False,False,0,4,2022-01-12T19:20:01.073,25,False,4.0
2021,18,3320,230,25,7053,2,30,10,-3,2,5,1,1,1,0,False,False,False,0,4,2022-01-12T20:46:38.837,2,False,1.0
2021,18,3320,235,25,7060,13,5,2,18,0,0,0,0,0,0,False,False,False,0,2,2022-01-12T20:17:56.75,0,False,0.0
2021,18,3320,250,3,6936,2,4,9,10,10,0,10,0,10,0,False,False,False,0,3,2022-01-12T20:14:58.71,10,False,0.0
2021,18,3320,255,3,6454,2,5,5,6,6,0,6,0,6,0,False,False,False,0,3,2022-01-12T20:18:07.95,6,False,0.0
2021,18,3320,270,3,6454,2,47,5,-1,0,1,0,0,0,0,False,False,False,0,4,2022-01-10T13:49:48.033,0,False,0.0
2021,18,3320,275,3,6936,13,12,9,7,0,0,0,0,0,0,False,False,False,0,3,2022-01-11T21:37:13.167,0,False,0.0
2021,18,3320,285,25,7053,13,4,9,2,0,0,0,0,0,0,False,False,False,0,4,2022-01-10T13:56:47.853,0,False,0.0
2021,18,3320,295,25,6259,13,6,1,24,0,0,0,0,0,0,False,False,False,0,3,2022-01-12T20:47:33.79,0,False,0.0
2021,18,3320,305,3,6454,2,35,7,19,28,9,24,4,24,0,False,False,False,0,4,2022-01-10T14:02:28.8,28,False,4.0
2021,18,3320,320,3,6454,13,17,1,28,0,0,0,0,0,0,False,False,False,0,3,2022-01-12T19:20:01.073,0,False,0.0
2021,18,3320,340,25,7060,3,2,10,5,0,0,0,0,0,0,False,False,False,0,2,2022-01-10T14:11:39.45,0,False,0.0
2021,18,3320,345,25,8422,13,5,5,11,0,0,0,0,0,0,False,False,False,0,3,2022-01-10T14:13:48.297,0,False,0.0
2021,18,3320,360,3,6454,2,39,4,5,7,2,6,1,6,0,False,False,False,0,3,2022-01-10T14:18:18.407,7,False,1.0
2021,18,3320,375,3,713,2,46,3,-1,1,2,1,0,1,0,False,False,False,0,1,2022-01-12T20:51:54.597,1,False,0.0
2021,18,3320,400,3,6936,3,4,9,6,0,0,0,0,0,0,False,False,False,0,3,2022-01-12T20:52:51.077,0,False,0.0
2021,18,3320,410,3,4368,13,32,5,-7,0,0,0,0,0,0,True,False,False,0,3,2022-01-12T20:53:47.82,0,False,0.0
2021,18,3320,445,3,713,2,45,10,-5,5,10,2,3,2,0,False,False,False,1,1,2022-01-12T19:20:01.073,5,False,3.0
2021,18,3320,480,25,7060,2,4,3,6,5,-1,5,0,5,0,False,False,False,0,2,2022-02-22T22:04:29.45,5,False,0.0
2021,18,3320,490,25,7060,2,3,2,16,16,0,16,0,16,0,False,False,False,0,2,2022-01-10T14:53:44.06,16,False,0.0
2021,18,3320,500,25,7060,2,26,10,1,8,7,7,1,7,0,False,False,False,0,2,2022-01-10T14:57:25.563,8,False,1.0
2021,18,3320,525,3,6816,2,46,3,0,1,1,1,0,1,0,True,False,False,0,4,2022-01-11T21:34:00.97,1,False,0.0
2021,18,3320,530,3,6936,2,5,5,6,6,0,6,0,6,0,False,False,False,0,3,2022-01-10T15:04:05.147,6,False,0.0
2021,18,3320,545,25,6259,3,5,5,4,0,0,0,0,0,0,False,False,False,0,3,2022-01-10T15:08:39.657,0,False,0.0
2021,18,3320,600,3,6454,13,35,4,11,0,0,0,0,0,0,False,False,False,0,3,2022-01-10T15:23:25.177,0,False,0.0
2021,18,3320,605,25,8421,2,46,9,0,2,2,2,0,2,0,False,False,False,0,1,2022-01-12T19:20:01.073,2,False,0.0
2021,18,3320,620,25,7666,2,5,5,10,10,0,10,0,10,0,False,False,False,0,2,2022-01-10T15:29:17.527,10,False,0.0
2021,18,3320,625,25,8421,2,28,10,-3,10,13,1,9,1,0,False,False,False,1,1,2022-01-10T15:31:03.94,10,False,9.0
2021,18,3320,635,25,7081,2,46,9,0,24,24,12,12,12,0,False,False,False,1,1,2022-01-12T20:59:48.717,24,False,
2021,18,3320,640,25,8422,13,8,4,14,0,0,0,0,0,0,False,False,False,0,3,2022-01-12T19:20:01.073,0,False,0.0
2021,18,3320,645,25,7666,2,4,9,3,7,4,6,1,6,0,False,False,False,0,3,2022-01-10T15:38:56.213,7,False,1.0
2021,18,3320,675,25,7666,2,5,3,8,8,0,8,0,8,0,False,False,False,0,4,2022-01-12T21:04:06.823,8,True,0.0
2021,18,3320,685,25,7060,2,50,9,-3,-2,1,-2,0,-2,0,False,False,False,0,3,2022-02-17T16:31:05.8,-2,False,0.0
2021,18,3320,695,25,8422,2,47,10,0,8,8,4,4,4,0,False,False,False,1,4,2022-01-10T15:54:52.06,8,False,4.0
2021,18,3320,705,25,6259,2,35,8,18,20,2,19,1,19,0,False,False,False,0,3,2022-01-12T19:20:01.09,20,False,1.0
2021,18,3320,710,25,8422,13,5,10,4,0,0,0,0,0,0,False,False,False,0,4,2022-02-17T16:34:47.577,0,False,0.0
2021,18,3320,720,25,8422,2,4,5,4,11,7,4,7,4,0,False,False,False,1,3,2022-01-10T16:03:01.287,11,False,7.0
2021,18,3320,730,25,7060,2,13,9,1,3,2,3,0,3,0,True,False,False,1,3,2022-01-12T20:25:30.22,3,False,0.0
2021,18,3320,735,25,7666,2,2,10,2,6,4,2,4,2,6,False,False,False,1,2,2022-01-10T16:06:43.047,6,False,4.0
2021,18,3320,750,3,8430,13,2,9,6,0,0,0,0,0,0,False,False,False,0,2,2022-01-10T16:09:37.69,0,False,0.0
2021,18,3320,755,3,6454,2,33,4,3,11,8,6,5,6,0,False,False,False,0,4,2022-01-10T16:10:57.05,11,False,5.0
2021,18,3320,770,3,6454,13,29,6,15,0,0,0,0,0,0,False,False,False,0,4,2022-01-12T20:20:39.083,0,False,0.0
2021,18,3320,775,3,6454,2,5,10,5,8,3,7,1,7,0,False,False,False,0,3,2022-01-11T21:34:15.913,8,False,1.0
2021,18,3320,800,25,8422,2,5,5,6,10,4,9,1,9,0,False,False,False,0,4,2022-01-10T16:20:54.017,10,False,1.0
2021,18,3320,810,25,6259,13,6,9,10,0,0,0,0,0,0,False,False,False,0,3,2022-01-10T16:22:50.753,0,False,0.0
2021,18,3320,815,25,7666,2,4,5,4,6,2,4,2,4,0,False,False,False,0,2,2022-01-10T16:24:22.11,6,False,2.0
2021,18,3320,820,25,8422,2,47,5,0,3,3,3,0,3,0,False,False,False,0,4,2022-02-17T16:35:46.377,3,False,0.0
2021,18,3320,830,3,6454,2,38,9,2,12,10,5,7,5,0,False,False,False,1,4,2022-01-10T16:29:34.98,12,False,7.0
2021,18,3320,835,3,6936,13,19,2,21,0,0,0,0,0,0,False,False,False,0,2,2022-01-12T19:20:01.09,0,False,0.0
2021,18,3320,840,3,6936,13,6,1,19,0,0,0,0,0,0,False,False,False,0,2,2022-01-12T19:20:01.09,0,False,0.0
2021,18,3320,845,3,6454,13,17,1,29,0,0,0,0,0,0,False,False,False,0,3,2022-01-11T21:35:02.507,0,False,0.0
2021,18,3320,895,3,121,13,6,9,9,0,0,0,0,0,0,False,False,False,0,2,2022-01-10T16:50:49.797,0,False,0.0
2021,18,3320,900,3,6454,13,17,1,16,0,0,0,0,0,0,False,False,False,0,3,2022-01-12T19:20:01.09,0,False,0.0
2021,18,3320,910,25,8421,2,5,9,0,11,11,1,10,1,0,False,False,False,1,1,2022-01-12T19:20:01.09,11,False,10.0
2021,18,3320,920,25,7666,13,5,5,10,0,0,0,0,0,0,False,False,False,0,3,2022-01-10T17:02:00.707,0,False,0.0
2021,18,3320,925,25,8422,2,5,3,10,14,4,12,2,12,0,False,False,False,0,3,2022-01-12T21:03:33.897,14,False,2.0
2021,18,3320,930,25,7053,2,46,3,0,1,1,1,0,1,0,False,False,False,0,4,2022-01-10T17:06:48.63,1,False,0.0
2021,18,3320,940,25,7060,2,26,3,1,11,10,11,0,11,0,False,False,False,0,2,2022-01-10T17:09:40.483,11,False,0.0
2021,18,3320,950,25,6259,3,12,7,15,0,0,0,0,0,0,False,False,False,0,3,2022-02-17T16:36:54.287,0,False,0.0
2021,18,3320,960,25,7060,3,6,10,3,0,0,0,0,0,0,False,False,False,0,3,2022-01-10T17:14:58.54,0,False,0.0
2021,18,3320,970,25,6259,2,6,4,6,10,4,9,1,9,0,False,False,False,0,3,2022-01-12T21:03:08.987,10,False,1.0
2021,18,3321,10,4,6953,2,53,10,-4,17,21,14,3,14,0,False,False,False,0,4,2022-01-10T10:39:17.937,17,False,3.0
2021,18,3321,20,4,594,2,4,10,4,6,2,4,2,4,0,False,False,False,0,3,2022-01-12T23:47:03.133,6,False,2.0
2021,18,3321,40,4,2853,2,12,5,10,10,0,10,0,10,6,False,False,False,0,3,2022-01-10T16:12:27.28,10,True,0.0
2021,18,3321,75,4,2853,2,4,10,7,10,3,9,1,9,0,False,False,False,1,2,2022-01-10T16:12:43.663,10,False,1.0
2021,18,3321,90,4,2853,13,4,3,10,0,0,0,0,0,0,False,False,False,0,2,2022-01-10T11:16:43.313,0,True,
2021,18,3321,95,4,6983,2,48,9,-3,19,22,5,14,5,0,False,False,False,1,1,2022-01-10T11:20:01.203,19,False,14.0
2021,18,3321,100,4,2853,2,50,10,-1,11,12,3,8,3,0,False,False,False,1,2,2022-01-10T16:13:02.12,11,False,8.0
2021,18,3321,110,4,7646,13,12,2,40,0,0,0,0,0,0,False,False,False,0,2,2022-01-10T16:18:06.563,0,False,0.0
2021,18,3321,115,4,2853,2,4,9,3,6,3,5,1,5,0,True,False,False,0,3,2022-01-11T18:13:29.453,6,False,1.0
2021,18,3321,135,4,2853,13,19,6,21,0,0,0,0,0,0,False,False,False,0,2,2022-01-10T11:35:30.877,0,False,0.0
2021,18,3321,140,4,6953,13,2,9,5,0,0,0,0,0,0,False,False,False,0,3,2022-01-10T11:37:05.8,0,False,0.0
2021,18,3321,155,22,3170,2,4,8,16,16,0,16,0,16,0,True,False,False,0,3,2022-01-12T22:31:12.167,16,False,0.0
2021,18,3321,160,22,2629,3,30,9,1,0,0,0,0,0,0,False,False,False,0,4,2022-01-12T21:35:29.883,0,False,0.0
2021,18,3321,190,4,2853,2,49,9,-3,2,5,0,2,0,0,False,False,False,0,2,2022-02-17T16:41:51.647,2,False,2.0
2021,18,3321,200,4,7646,13,4,5,8,0,0,0,0,0,0,False,False,False,0,2,2022-01-12T23:37:01.54,0,False,0.0
2021,18,3321,205,22,4997,2,6,4,8,9,1,9,0,9,0,False,False,False,0,2,2022-01-10T12:01:52.1,9,False,0.0
2021,18,3321,240,4,2853,2,4,3,5,5,0,5,0,5,0,False,False,False,0,2,2022-01-12T23:39:37.807,5,False,0.0
2021,18,3321,245,4,7645,2,11,3,-2,3,5,1,2,1,0,True,False,False,0,1,2022-01-11T18:10:24.41,3,False,2.0
2021,18,3321,265,22,8451,13,5,3,2,0,0,0,0,0,0,False,False,False,0,1,2022-01-10T12:23:55.113,0,False,0.0
2021,18,3321,270,22,7118,13,2,10,5,0,0,0,0,0,0,False,False,False,0,2,2022-01-10T12:26:52.65,0,False,0.0
2021,18,3321,290,4,7646,3,26,9,4,0,0,0,0,0,0,False,False,False,0,3,2022-02-17T16:42:53.037,0,False,0.0
2021,18,3321,310,22,7610,13,35,5,14,0,0,0,0,0,0,False,False,False,0,3,2022-01-10T12:42:23.37,0,False,0.0
2021,18,3321,315,22,2629,2,31,10,5,5,0,5,0,5,0,False,False,False,0,4,2022-01-10T12:44:30.63,5,False,0.0
2021,18,3321,320,22,4997,2,6,9,5,5,0,5,0,5,0,False,False,False,0,2,2022-01-12T23:52:16.533,5,False,0.0
2021,18,3321,325,22,4997,2,2,10,6,40,34,40,0,40,6,False,False,False,0,2,2022-01-12T23:38:04.117,40,True,0.0
2021,18,3321,340,4,2853,13,5,6,18,0,0,0,0,0,0,False,False,False,0,2,2022-01-10T12:59:07.333,0,False,0.0
2021,18,3321,350,4,594,2,5,3,6,9,3,8,1,8,0,False,True,False,0,3,2022-01-10T13:02:20.51,9,False,1.0
2021,18,3321,390,4,594,2,4,9,6,13,7,11,2,11,0,False,False,False,0,3,2022-01-10T13:11:23.14,13,False,2.0
2021,18,3321,395,4,2853,2,5,5,14,17,3,15,2,15,0,False,False,False,1,3,2022-01-11T18:13:53.81,17,False,2.0
2021,18,3321,400,4,594,2,46,3,3,3,0,3,0,3,0,False,False,False,0,3,2022-01-11T18:14:06.38,3,True,0.0
2021,18,3321,405,4,2853,2,4,3,12,12,0,12,0,12,0,False,False,False,0,2,2022-01-10T13:16:57.797,12,False,0.0
2021,18,3321,410,4,7646,13,24,2,37,0,0,0,0,0,0,False,False,False,0,2,2022-01-10T13:18:52.86,0,False,0.0
2021,18,3321,415,4,7646,2,5,10,14,14,0,14,0,14,0,False,False,False,0,2,2022-01-10T13:20:27.517,14,True,0.0
2021,18,3321,425,4,7646,13,6,9,13,0,0,0,0,0,0,False,False,False,0,2,2022-01-12T23:40:43.54,0,False,0.0
2021,18,3321,430,4,2853,13,21,10,13,0,0,0,0,0,0,False,False,False,0,3,2022-02-17T16:44:53.41,0,False,0.0
2021,18,3321,435,4,2853,13,19,5,13,0,0,0,0,0,0,False,False,False,0,2,2022-01-10T13:33:23.557,0,False,
2021,18,3321,465,22,7118,2,6,9,2,2,0,2,0,2,0,False,False,False,0,2,2022-01-10T13:39:48.25,2,False,0.0
2021,18,3321,475,4,2853,13,2,10,10,0,0,0,0,0,0,False,False,False,0,2,2022-01-10T13:42:31.597,0,False,0.0
2021,18,3321,480,4,2853,2,4,5,6,8,2,7,1,7,0,False,False,False,0,2,2022-01-10T13:44:14.697,8,False,1.0
2021,18,3321,490,4,7646,13,4,5,9,0,0,0,0,0,0,False,False,False,0,2,2022-01-10T16:17:09.443,0,False,0.0
2021,18,3321,495,4,6953,13,7,10,13,0,0,0,0,0,0,False,False,False,0,3,2022-01-10T13:48:37.1,0,False,0.0
2021,18,3321,500,4,7646,13,4,6,15,0,0,0,0,0,0,False,False,False,0,2,2022-02-22T22:25:11.31,0,False,0.0
2021,18,3321,520,22,6812,13,12,5,13,0,0,0,0,0,0,False,False,False,0,1,2022-01-12T23:38:15.413,0,False,0.0
2021,18,3321,540,4,2853,13,35,10,14,0,0,0,0,0,0,False,False,False,0,3,2022-01-10T14:05:26.313,0,False,0.0
2021,18,3321,550,4,7646,13,12,2,28,0,0,0,0,0,0,False,False,False,0,3,2022-02-24T20:09:42.927,0,False,0.0
2021,18,3321,580,4,7937,13,13,3,3,0,0,0,0,0,0,False,False,False,0,4,2022-01-10T14:17:59.28,0,False,0.0
2021,18,3321,590,4,594,3,2,4,5,0,0,0,0,0,0,False,False,False,0,3,2022-01-10T14:21:22.51,0,False,0.0
2021,18,3321,605,22,743,13,11,6,20,0,0,0,0,0,0,False,False,False,0,1,2022-02-22T22:22:59.223,0,False,0.0
2021,18,3321,630,4,7645,2,6,10,2,3,1,3,0,3,0,False,False,False,0,1,2022-01-12T22:31:12.197,3,False,0.0
2021,18,3321,635,4,6953,2,7,6,23,28,5,23,5,23,0,False,False,False,0,3,2022-01-12T23:56:41.647,28,False,5.0
2021,18,3321,645,4,7646,3,29,2,15,0,0,0,0,0,0,False,False,False,0,2,2022-01-12T23:39:56.733,0,False,0.0
2021,18,3321,655,4,594,13,4,10,7,0,0,0,0,0,0,False,False,False,0,3,2022-02-22T22:18:02.973,0,False,0.0
2021,18,3321,680,22,8803,2,5,9,10,10,0,10,0,10,0,False,False,False,0,3,2022-01-12T23:55:16.293,10,False,0.0
2021,18,3321,695,22,8451,13,53,9,-4,0,0,0,0,0,0,True,False,False,0,3,2022-01-12T22:31:12.197,0,False,0.0
2021,18,3321,720,4,5119,2,12,5,5,9,4,7,2,7,0,True,False,False,0,3,2022-01-12T23:38:52.367,9,False,2.0
2021,18,3321,730,4,6953,2,55,4,-2,4,6,1,3,1,0,False,False,False,0,4,2022-02-17T16:49:47.81,4,False,3.0
2021,18,3321,750,22,7118,13,4,10,10,0,0,0,0,0,0,True,False,False,0,3,2022-01-12T23:39:02.557,0,False,0.0
2021,18,3321,755,22,8803,3,2,10,7,0,0,0,0,0,0,False,False,False,0,2,2022-01-10T15:34:45.267,0,False,0.0
2021,18,3321,770,4,7646,2,21,8,17,27,10,23,4,23,0,True,False,False,0,3,2022-01-10T15:40:46.543,27,False,4.0
2021,18,3321,780,4,7646,3,49,5,-3,0,0,0,0,0,0,False,False,False,0,2,2022-01-12T23:35:57.197,0,False,0.0
2021,18,3321,795,4,7646,2,49,10,-2,-2,0,-2,0,-2,0,True,False,False,0,2,2022-01-11T18:14:45.743,-2,False,0.0
2021,18,3321,800,4,6983,2,48,10,-6,5,11,5,0,5,6,True,False,False,0,1,2022-01-11T18:14:56.32,5,False,0.0
2021,18,3321,820,22,8451,3,28,10,-3,0,0,0,0,0,0,False,False,False,0,1,2022-02-17T16:51:44.05,0,False,0.0
2021,18,3321,825,22,2629,3,32,5,3,0,0,0,0,0,0,False,False,False,0,1,2022-02-24T20:10:10.133,0,False,0.0
2021,18,3321,840,4,2630,2,33,3,11,15,4,12,3,12,0,True,False,False,0,3,2022-01-10T16:03:45.633,15,False,3.0
2021,18,3322,10,7,8317,2,30,5,-1,2,3,1,1,1,0,False,False,False,0,3,2022-01-10T12:01:30.533,2,False,1.0
2021,18,3322,25,7,8317,13,5,3,11,0,0,0,0,0,0,False,False,False,0,2,2022-01-10T12:07:31.583,0,False,0.0
2021,18,3322,40,8,6439,2,45,5,-3,2,5,1,1,1,0,False,False,False,1,1,2022-01-12T17:51:56.76,2,False,1.0
2021,18,3322,60,7,8317,2,49,5,-3,24,27,5,19,5,0,False,False,False,1,2,2022-01-10T12:48:27.9,24,False,19.0
2021,18,3322,65,7,8317,13,4,3,5,0,0,0,0,0,0,False,False,False,0,2,2022-01-10T13:00:41.437,0,False,0.0
2021,18,3322,75,7,8057,13,16,4,8,0,0,0,0,0,0,False,False,False,0,4,2022-01-10T13:03:44.97,0,False,0.0
2021,18,3322,80,7,7046,2,2,9,5,9,4,7,2,7,0,False,False,False,0,3,2022-01-10T13:05:12.02,9,False,2.0
2021,18,3322,100,8,7651,2,5,5,5,6,1,6,0,6,0,False,False,False,0,3,2022-01-10T13:09:23.15,6,False,0.0
2021,18,3322,110,8,232,13,30,3,-5,0,0,0,0,0,0,False,False,False,0,3,2022-01-10T13:12:54.08,0,False,0.0
2021,18,3322,120,8,8349,3,2,9,7,0,0,0,0,0,0,False,False,False,0,2,2022-01-10T13:46:19.177,0,False,0.0
2021,18,3322,145,7,6985,13,48,10,-4,0,0,0,0,0,0,False,False,False,0,1,2022-01-10T13:53:05.443,0,False,0.0
2021,18,3322,150,7,6971,13,5,5,3,0,0,0,0,0,0,False,False,False,0,3,2022-01-10T13:56:06.39,0,False,0.0
2021,18,3322,155,7,7046,13,6,9,10,0,0,0,0,0,0,False,False,False,0,2,2022-01-10T13:58:37.663,0,False,0.0
2021,18,3322,170,8,7651,2,30,10,0,22,22,22,0,22,0,False,False,False,0,3,2022-01-10T14:01:41.073,22,True,0.0
2021,18,3322,175,8,8354,2,51,5,-6,8,14,5,3,5,0,True,False,False,0,3,2022-02-17T16:56:31.757,8,False,3.0
2021,18,3322,195,8,232,2,35,6,19,26,7,26,0,26,6,False,False,False,0,3,2022-01-10T14:08:45.527,26,True,0.0
2021,18,3322,215,7,8057,2,46,3,2,3,1,2,1,2,0,True,False,False,0,4,2022-01-12T17:54:53.08,3,False,1.0
2021,18,3322,240,8,7651,2,45,10,-2,10,12,0,10,0,0,False,False,False,2,2,2022-01-10T14:24:16.707,10,False,10.0
2021,18,3322,255,8,232,2,2,10,12,13,1,13,0,13,0,False,False,False,0,3,2022-01-10T14:34:05.02,13,False,0.0
2021,18,3322,290,7,8325,13,46,3,-1,0,0,0,0,0,0,True,False,False,0,1,2022-02-25T16:15:54.253,0,False,0.0
2021,18,3322,295,7,6975,2,28,10,-4,8,12,3,5,3,0,False,False,False,1,1,2022-01-10T14:50:34.853,8,False,5.0
2021,18,3322,310,8,232,2,50,9,-2,0,2,-1,1,-1,0,False,False,False,0,2,2022-01-10T14:55:50.81,0,False,1.0
2021,18,3322,320,8,232,2,5,5,5,9,4,5,4,5,0,False,False,False,2,4,2022-01-12T17:52:36.283,9,False,4.0
2021,18,3322,350,7,8325,2,46,3,-1,12,13,6,6,6,0,False,False,False,2,1,2022-01-10T15:16:15.54,12,False,6.0
2021,18,3322,400,8,232,2,5,3,10,22,12,11,11,11,0,True,False,False,2,2,2022-01-10T15:36:01.71,22,False,11.0
2021,18,3322,410,8,4976,2,4,4,5,6,1,6,0,6,0,False,False,False,0,3,2022-01-10T15:38:49.457,6,False,0.0
2021,18,3322,425,8,4976,2,4,4,2,5,3,3,2,3,0,False,False,False,0,4,2022-01-10T15:41:30.253,5,False,2.0
2021,18,3322,430,8,7009,2,44,3,-2,10,12,9,1,9,0,False,False,False,0,1,2022-01-10T15:43:34.73,10,False,1.0
2021,18,3322,435,8,8349,2,3,3,13,13,0,13,0,13,0,False,False,False,0,2,2022-01-10T15:45:03.843,13,True,0.0
2021,18,3322,440,8,7652,13,17,10,11,0,0,0,0,0,0,False,False,False,0,3,2022-01-12T00:03:36.153,0,False,0.0
2021,18,3322,450,8,8349,13,2,10,8,0,0,0,0,0,0,False,False,False,0,2,2022-01-12T17:57:09.867,0,False,0.0
2021,18,3322,455,8,7652,13,17,4,11,0,0,0,0,0,0,False,False,False,0,3,2022-01-12T00:03:54.763,0,False,0.0
2021,18,3322,475,8,232,13,5,3,6,0,0,0,0,0,0,False,False,False,0,3,2022-01-10T15:56:32.15,0,False,0.0
2021,18,3322,500,7,6971,2,30,10,-1,8,9,6,2,6,0,True,False,False,0,4,2022-01-12T17:58:41.477,8,False,2.0
2021,18,3322,515,7,8057,3,26,10,1,0,0,0,0,0,0,False,False,False,0,4,2022-01-12T17:10:42.407,0,False,0.0
2021,18,3322,520,7,8057,2,47,5,3,5,2,4,1,4,0,False,False,False,0,4,2022-01-12T17:51:07.51,5,False,1.0
2021,18,3322,525,7,6971,13,9,6,21,0,0,0,0,0,0,False,False,False,0,3,2022-01-10T16:18:40.03,0,False,
2021,18,3322,565,7,6985,2,48,9,-6,4,10,-2,6,-2,0,False,False,False,1,1,2022-01-10T18:15:50.063,4,False,6.0
2021,18,3322,580,8,7652,2,32,3,5,9,4,7,2,7,0,True,False,False,1,4,2022-01-10T16:36:34.713,9,False,2.0
2021,18,3322,625,8,232,2,26,10,5,5,0,5,0,5,0,False,False,False,0,2,2022-01-10T16:52:46.347,5,False,0.0
2021,18,3322,630,8,7651,3,2,9,2,0,0,0,0,0,0,False,False,False,0,2,2022-01-10T16:54:01.83,0,False,0.0
2021,18,3322,645,7,3445,13,4,3,8,0,0,0,0,0,0,False,False,False,0,2,2022-01-10T16:59:57.01,0,False,0.0
2021,18,3322,650,7,3445,13,2,9,7,0,0,0,0,0,0,False,False,False,0,2,2022-01-10T17:01:00.967,0,False,0.0
2021,18,3322,720,8,8354,2,50,10,-2,10,12,9,1,9,6,False,False,False,0,3,2022-01-10T17:25:47.413,10,False,1.0
2021,18,3322,740,7,8325,2,48,10,-3,-1,2,-2,1,-2,0,False,False,False,0,1,2022-01-12T17:51:27.877,-1,False,1.0
2021,18,3322,745,7,4932,2,5,6,15,15,0,15,0,15,0,False,False,False,0,3,2022-01-10T17:32:43.74,15,False,0.0
2021,18,3322,755,7,7046,13,21,6,27,0,0,0,0,0,0,False,False,False,0,2,2022-01-10T17:36:00.463,0,False,0.0
2021,18,3322,765,7,4932,2,17,1,20,26,6,26,0,26,0,False,False,False,0,3,2022-01-10T17:39:19.233,26,False,0.0
2021,18,3322,770,7,8057,2,32,5,3,8,5,5,3,5,0,False,False,False,1,4,2022-01-10T17:41:37.93,8,False,3.0
2021,18,3322,775,7,3445,13,22,2,23,0,0,0,0,0,0,False,False,False,0,2,2022-01-10T17:44:34.87,0,False,0.0
2021,18,3322,785,7,4932,13,42,4,4,0,0,0,0,0,0,False,False,False,0,3,2022-02-25T16:16:13.203,0,False,0.0
2021,18,3322,790,7,7046,13,17,9,13,0,0,0,0,0,0,True,False,False,0,3,2022-01-10T17:51:11.24,0,False,0.0
2021,18,3322,795,7,8325,2,48,9,-4,9,13,-2,11,-2,0,False,False,False,1,1,2022-01-10T17:52:22.93,9,False,11.0
2021,18,3322,805,7,8325,2,47,5,2,4,2,4,0,4,6,False,False,False,0,1,2022-01-10T17:54:37.843,4,True,0.0
2021,18,3323,10,12,6691,2,12,9,12,28,16,27,1,27,0,False,False,False,0,3,2022-01-10T11:39:23.56,28,False,1.0
2021,18,3323,15,12,7743,2,46,3,1,3,2,3,0,3,0,False,False,False,0,4,2022-01-10T11:40:31.32,3,False,0.0
2021,18,3323,25,12,556,2,2,10,2,5,3,3,2,3,0,False,False,False,0,3,2022-01-10T11:43:49.88,5,False,2.0
2021,18,3323,40,12,6691,3,4,10,5,0,0,0,0,0,0,True,False,False,0,3,2022-01-10T11:46:44.99,0,False,0.0
2021,18,3323,45,12,556,2,51,3,1,11,10,2,9,2,0,False,False,False,1,3,2022-01-10T11:48:00.6,11,False,9.0
2021,18,3323,60,12,6691,2,2,10,4,8,4,5,3,5,0,False,False,False,0,3,2022-01-10T11:51:37.423,8,False,3.0
2021,18,3323,70,12,467,13,33,10,1,0,0,0,0,0,0,False,False,False,0,4,2022-01-12T16:41:08.48,0,False,0.0
2021,18,3323,75,12,6691,2,12,10,1,1,0,1,0,1,6,False,False,False,0,3,2022-02-17T17:24:04.687,1,True,0.0
2021,18,3323,90,11,7732,2,49,10,-3,3,6,1,2,1,0,False,False,False,1,2,2022-01-12T16:37:19.887,3,False,2.0
2021,18,3323,105,11,4037,2,4,10,4,5,1,4,1,4,0,False,False,False,0,3,2022-01-10T12:04:27.187,5,False,1.0
2021,18,3323,110,11,4037,13,5,3,12,0,0,0,0,0,0,True,False,False,0,3,2022-01-12T17:15:40.78,0,False,0.0
2021,18,3323,120,11,6571,3,11,3,12,0,0,0,0,0,0,False,False,False,0,4,2022-01-10T12:11:07.853,0,False,0.0
2021,18,3323,125,12,556,2,18,3,0,1,1,1,0,1,0,False,False,False,0,3,2022-01-10T12:12:44.74,1,False,0.0
2021,18,3323,130,12,6357,13,2,4,8,0,0,0,0,0,0,False,False,False,0,3,2022-01-10T12:14:16.63,0,False,0.0
2021,18,3323,150,11,8359,2,13,10,3,17,14,7,10,7,0,True,False,False,1,2,2022-01-10T12:19:13.463,17,False,10.0
2021,18,3323,155,11,4037,2,11,2,24,75,51,75,0,75,6,False,False,False,0,1,2022-01-10T12:22:02.833,75,True,0.0
2021,18,3323,170,12,556,2,2,10,7,13,6,12,1,12,0,False,False,False,0,2,2022-01-12T16:50:35.183,13,False,1.0
2021,18,3323,175,12,7742,2,5,3,1,4,3,2,2,2,0,False,False,False,0,1,2022-01-10T12:25:28.91,4,False,2.0
2021,18,3323,190,12,6691,2,13,4,3,9,6,8,1,8,0,True,False,False,0,2,2022-01-10T12:33:22.177,9,False,1.0
2021,18,3323,205,12,556,13,9,2,23,0,0,0,0,0,0,False,False,False,0,3,2022-01-12T14:53:20.723,0,False,0.0
2021,18,3323,210,12,7743,2,28,5,0,1,1,1,0,1,0,False,False,False,0,3,2022-02-22T22:39:15.21,1,False,0.0
2021,18,3323,220,11,8359,2,4,4,9,9,0,9,0,9,0,False,False,False,0,3,2022-01-10T12:41:43.91,9,False,0.0
2021,18,3323,230,11,8359,2,35,8,16,16,0,16,0,16,0,True,False,False,0,2,2022-01-10T12:45:39.5,16,False,0.0
2021,18,3323,235,11,7732,2,16,10,-2,6,8,3,3,3,0,False,False,False,1,1,2022-01-10T12:46:58.76,6,False,3.0
2021,18,3323,240,11,8359,2,35,10,14,21,7,16,5,16,0,True,False,False,0,4,2022-01-12T16:42:05.577,21,False,5.0
2021,18,3323,245,11,4875,13,6,9,7,0,0,0,0,0,0,False,False,False,0,3,2022-01-10T12:51:42.827,0,False,0.0
2021,18,3323,260,11,8359,2,4,10,2,2,0,2,0,2,6,True,False,False,0,2,2022-01-10T12:55:43.94,2,True,0.0
2021,18,3323,285,12,556,2,6,9,13,16,3,16,0,16,0,False,False,False,0,3,2022-01-12T16:51:17.587,16,False,0.0
2021,18,3323,290,12,556,2,30,9,-2,9,11,7,2,7,0,False,False,False,0,3,2022-01-10T13:02:24.19,9,False,2.0
2021,18,3323,305,12,6691,2,43,6,25,29,4,29,0,29,6,True,False,False,0,4,2022-01-11T18:37:20.907,29,True,0.0
2021,18,3323,320,11,7732,2,50,10,-1,5,6,4,1,4,0,False,False,False,0,2,2022-01-10T13:08:51.12,5,False,1.0
2021,18,3323,340,11,6815,2,6,4,11,11,0,11,0,11,0,False,False,False,0,3,2022-01-12T16:42:27.107,11,False,0.0
2021,18,3323,350,11,7732,2,51,9,-6,2,8,2,0,2,0,True,False,False,0,3,2022-01-10T13:15:14.137,2,False,0.0
2021,18,3323,360,11,4875,2,3,5,11,11,0,11,0,11,0,False,False,False,0,2,2022-01-10T13:16:40.293,11,False,0.0
2021,18,3323,370,11,4037,2,4,9,10,18,8,16,2,16,0,False,False,False,0,3,2022-01-10T13:18:20.237,18,False,2.0
2021,18,3323,380,11,6815,2,39,4,5,5,0,5,0,5,0,False,False,False,1,3,2022-01-10T13:19:50.593,5,False,0.0
2021,18,3323,385,11,4875,13,9,2,16,0,0,0,0,0,0,False,False,False,0,2,2022-01-10T13:20:52.617,0,False,0.0
2021,18,3323,425,11,8359,13,5,3,14,0,0,0,0,0,0,False,False,False,0,2,2022-01-12T17:02:31.703,0,False,0.0
2021,18,3323,450,12,6872,2,51,10,1,2,1,2,0,2,0,False,True,True,0,3,2022-01-10T13:32:54.01,2,False,0.0
2021,18,3323,455,11,8641,2,21,5,9,36,27,35,1,35,6,False,False,False,0,4,2022-01-12T14:53:20.723,36,False,1.0
2021,18,3323,470,12,8279,2,32,10,-1,26,27,24,2,24,0,False,False,False,0,4,2022-01-10T13:41:29.567,26,False,2.0
2021,18,3323,485,12,7743,13,46,9,-1,0,0,0,0,0,0,True,False,False,0,4,2022-01-12T16:37:59.513,0,False,0.0
2021,18,3323,515,12,6356,13,12,10,-2,0,0,0,0,0,0,False,False,False,0,3,2022-02-24T20:12:08.35,0,False,0.0
2021,18,3323,520,12,8371,13,2,10,5,0,0,0,0,0,0,False,False,False,0,3,2022-01-10T13:53:21.59,0,False,0.0
2021,18,3323,535,11,8359,2,50,4,-4,1,5,-1,2,-1,0,True,False,False,0,3,2022-01-10T13:55:34.337,1,False,2.0
2021,18,3323,565,12,6872,2,4,10,6,12,6,9,3,9,0,False,False,False,0,3,2022-01-10T14:01:56.72,12,False,3.0
2021,18,3323,580,12,7593,3,35,2,16,0,0,0,0,0,0,False,False,False,0,4,2022-01-10T14:05:58.247,0,False,0.0
2021,18,3323,590,12,6872,2,5,5,2,2,0,2,0,2,0,False,False,False,0,3,2022-01-10T14:07:16.667,2,False,0.0
2021,18,3323,605,12,8044,2,46,3,2,3,1,3,0,3,0,False,False,False,0,1,2022-01-10T14:10:45.763,3,False,0.0
2021,18,3323,655,11,8359,2,13,5,4,15,11,13,2,13,0,True,False,False,0,2,2022-01-10T14:22:13.653,15,False,2.0
2021,18,3323,675,11,4561,2,47,10,1,9,8,4,5,4,0,False,False,False,0,1,2022-01-12T16:43:29.633,9,False,5.0
2021,18,3323,695,11,8359,13,5,5,9,0,0,0,0,0,0,False,False,False,0,3,2022-01-10T14:30:25.967,0,False,0.0
2021,18,3323,700,11,7732,3,5,3,6,0,0,0,0,0,0,False,False,False,0,1,2022-01-10T14:32:06.813,0,False,0.0
2021,18,3323,715,12,8371,2,5,3,4,5,1,5,0,5,0,False,False,False,0,2,2022-01-10T14:36:28.303,5,True,0.0
2021,18,3323,720,12,6356,2,5,5,4,4,0,4,0,4,0,False,False,False,0,3,2022-01-12T17:17:52.923,4,False,0.0
2021,18,3323,730,12,7743,2,53,4,-3,62,65,7,55,7,6,False,False,False,1,4,2022-01-12T16:52:55.873,62,False,55.0
2021,18,3323,750,11,8359,2,35,10,13,28,15,13,15,13,0,False,False,False,1,3,2022-01-10T14:46:49.567,28,False,15.0
2021,18,3323,760,11,4037,2,6,9,3,3,0,3,0,3,0,False,False,False,0,3,2022-01-10T14:49:15.92,3,False,0.0
2021,18,3323,765,11,8641,2,6,10,13,15,2,14,1,14,0,False,False,False,0,3,2022-01-10T14:51:00.657,15,False,1.0
2021,18,3323,790,12,8044,2,48,9,-4,0,4,-3,3,-3,0,False,False,False,0,1,2022-01-10T14:55:06.903,0,False,3.0
2021,18,3323,795,12,8371,13,2,10,11,0,0,0,0,0,0,False,False,False,0,3,2022-01-10T15:11:20.563,0,False,0.0
2021,18,3323,840,12,6356,13,8,8,43,0,0,0,0,0,0,False,False,False,0,3,2022-01-12T16:53:31.647,0,False,0.0
2021,18,3323,845,12,6356,2,6,1,15,18,3,16,2,16,0,False,False,False,0,2,2022-01-10T15:10:06.343,18,False,2.0
2021,18,3323,855,12,6356,13,6,8,21,0,0,0,0,0,0,False,False,False,0,3,2022-01-12T16:44:16.68,0,False,0.0
2021,18,3324,10,13,4498,2,47,10,1,7,6,2,5,2,0,False,False,False,1,3,2022-01-12T19:28:20.68,7,False,5.0
2021,18,3324,20,13,1510,13,4,5,4,0,0,0,0,0,0,False,False,False,0,2,2022-01-10T11:55:05.72,0,False,0.0
2021,18,3324,30,13,1510,2,38,9,-1,8,9,5,3,5,0,False,False,False,0,1,2022-01-10T11:57:28.813,8,False,3.0
2021,18,3324,45,13,8417,13,12,5,9,0,0,0,0,0,0,False,False,False,0,2,2022-01-10T12:02:24.77,0,False,0.0
2021,18,3324,50,13,8417,13,22,3,12,0,0,0,0,0,0,False,False,False,0,2,2022-01-10T12:04:10.36,0,False,0.0
2021,18,3324,70,31,661,13,6,9,14,0,0,0,0,0,0,True,False,False,0,3,2022-01-12T19:29:08.437,0,False,0.0
2021,18,3324,85,13,8417,13,35,8,25,0,0,0,0,0,0,False,False,False,0,3,2022-01-10T12:19:20.95,0,False,0.0
2021,18,3324,90,13,100,13,12,2,16,0,0,0,0,0,0,False,False,False,0,3,2022-02-24T20:12:52.28,0,False,0.0
2021,18,3324,100,31,6888,2,32,5,3,5,2,5,0,5,0,False,False,False,0,1,2022-01-10T12:23:07.493,5,False,0.0
2021,18,3324,115,31,2865,2,30,10,-1,2,3,2,0,2,0,False,False,False,0,4,2022-01-10T12:25:49.477,2,False,0.0
2021,18,3324,125,31,7913,2,17,1,25,29,4,28,1,28,0,False,False,False,0,3,2022-01-10T12:28:21.983,29,False,1.0
2021,18,3324,140,31,661,2,5,5,5,13,8,12,1,12,0,False,False,False,0,3,2022-01-10T12:38:49.813,13,False,1.0
2021,18,3324,150,31,3911,2,49,10,-4,4,8,3,1,3,0,True,False,False,0,3,2022-01-10T12:42:44.987,4,False,1.0
2021,18,3324,155,31,6724,13,26,10,4,0,0,0,0,0,0,False,False,False,0,3,2022-01-10T12:46:08.883,0,False,0.0
2021,18,3324,165,13,1510,2,16,9,2,14,12,10,4,10,0,False,False,False,1,1,2022-01-10T12:50:21.523,14,False,4.0
2021,18,3324,185,13,2455,2,48,9,-3,6,9,3,3,3,0,False,False,False,0,1,2022-01-10T12:57:35,6,False,3.0
2021,18,3324,195,31,661,2,2,10,4,9,5,8,1,8,0,False,False,False,0,2,2022-01-10T13:03:33.33,9,False,1.0
2021,18,3324,200,31,661,2,5,6,19,19,0,19,0,19,0,False,False,False,0,3,2022-01-10T13:08:31.81,19,True,0.0
2021,18,3324,210,31,8333,13,2,9,6,0,0,0,0,0,0,False,False,False,0,2,2022-01-10T13:14:50.567,0,False,0.0
2021,18,3324,215,31,6724,2,17,7,15,17,2,17,0,17,0,False,False,False,0,3,2022-01-12T19:29:22.18,17,False,0.0
2021,18,3324,225,31,7913,2,28,4,4,9,5,5,4,5,0,False,False,False,1,3,2022-01-12T18:02:24.657,9,False,4.0
2021,18,3324,235,31,4844,2,47,5,2,15,13,13,2,13,0,False,False,False,0,1,2022-01-10T13:22:29.283,15,False,2.0
2021,18,3324,245,31,3911,2,51,9,0,0,0,0,0,0,0,False,False,False,0,3,2022-01-10T13:30:22.887,0,False,0.0
2021,18,3324,255,31,6724,2,13,3,4,5,1,5,0,5,6,True,False,False,0,3,2022-01-10T13:38:57.333,5,True,0.0
2021,18,3324,275,13,876,2,51,10,-4,-3,1,-3,0,-3,0,False,False,False,0,3,2022-01-10T13:42:08.987,-3,False,0.0
2021,18,3324,280,13,876,2,6,7,19,25,6,25,0,25,0,False,False,False,0,3,2022-01-10T13:44:09.953,25,False,0.0
2021,18,3324,295,13,876,13,5,2,16,0,0,0,0,0,0,False,False,False,0,3,2022-01-10T13:49:18.297,0,False,0.0
2021,18,3324,315,31,6793,2,6,10,10,14,4,14,0,14,0,True,False,False,0,3,2022-01-10T13:54:04.28,14,False,0.0
2021,18,3324,320,31,661,13,35,8,17,0,0,0,0,0,0,False,False,False,0,3,2022-01-10T13:56:57.213,0,False,0.0
2021,18,3324,345,31,6793,2,4,7,19,24,5,21,3,21,0,False,False,False,0,2,2022-01-10T14:02:35.993,24,False,3.0
2021,18,3324,360,31,6793,2,4,9,4,14,10,14,0,14,6,False,False,False,0,3,2022-01-10T14:04:45.097,14,True,0.0
2021,18,3324,375,13,876,2,4,5,5,4,-1,4,0,4,0,False,False,False,0,2,2022-01-10T14:15:50.203,4,False,0.0
2021,18,3324,400,31,6722,2,48,9,-6,1,7,0,1,0,0,False,False,False,0,1,2022-01-10T14:22:22.48,1,False,1.0
2021,18,3324,410,31,661,2,4,9,14,14,0,14,0,14,0,False,False,False,0,3,2022-01-10T14:24:15.853,14,False,0.0
2021,18,3324,420,31,6793,13,4,3,12,0,0,0,0,0,0,False,False,False,0,2,2022-01-10T14:25:36.41,0,False,0.0
2021,18,3324,425,31,7913,13,39,4,8,0,0,0,0,0,0,False,False,False,0,3,2022-01-10T14:26:55.73,0,False,0.0
2021,18,3324,430,31,8333,13,8,1,49,0,0,0,0,0,0,False,False,False,0,2,2022-01-10T14:29:24.15,0,False,
2021,18,3324,435,31,7913,2,47,5,3,4,1,4,0,4,6,False,False,False,0,3,2022-01-10T14:39:14.943,4,True,0.0
2021,18,3324,465,31,661,13,7,2,38,0,0,0,0,0,0,False,False,False,0,3,2022-01-12T19:29:44.943,0,False,0.0
2021,18,3324,485,13,2455,2,12,4,5,7,2,6,1,6,0,False,False,False,0,1,2022-01-10T15:02:36.603,7,False,1.0
2021,18,3324,495,13,100,2,13,10,6,9,3,8,1,8,0,False,False,False,0,3,2022-01-10T15:05:18.743,9,False,1.0
2021,18,3324,500,13,100,13,12,2,24,0,0,0,0,0,0,False,False,False,0,3,2022-01-10T15:06:50.367,0,False,0.0
2021,18,3324,510,13,2455,2,48,10,-5,-5,0,-6,1,-6,0,False,False,False,0,1,2022-01-10T15:11:01.273,-5,False,1.0
2021,18,3324,515,13,1510,2,9,2,16,20,4,20,0,20,0,False,False,False,0,2,2022-01-10T15:12:32.813,20,False,0.0
2021,18,3324,520,13,3586,2,21,2,26,28,2,28,0,28,6,True,False,False,0,4,2022-02-17T18:03:21.71,28,True,0.0
2021,18,3324,555,31,6724,2,13,9,5,10,5,8,2,8,0,False,False,False,0,3,2022-01-10T15:31:16.58,10,False,2.0
2021,18,3324,565,13,8417,2,35,8,20,24,4,20,4,20,0,False,False,False,0,3,2022-01-10T15:34:05.737,24,False,4.0
2021,18,3324,570,13,100,2,4,10,6,8,2,6,2,6,0,False,False,False,1,3,2022-01-10T15:35:36.79,8,False,2.0
2021,18,3324,580,13,8417,2,6,4,13,13,0,13,0,13,0,False,False,False,0,2,2022-01-10T15:39:14.13,13,False,0.0
2021,18,3324,590,13,2455,13,11,2,17,0,0,0,0,0,0,True,False,False,0,1,2022-01-11T21:56:55.54,0,False,0.0
2021,18,3324,620,31,661,13,19,1,41,0,0,0,0,0,0,False,False,False,0,2,2022-01-10T15:53:10.087,0,False,0.0
2021,18,3324,630,13,100,2,36,1,15,37,22,32,5,32,0,False,False,False,0,3,2022-01-10T15:58:23.15,37,False,5.0
2021,18,3324,635,13,8417,13,19,7,33,0,0,0,0,0,0,False,False,False,0,3,2022-01-10T16:02:41.26,0,False,0.0
2021,18,3324,645,13,8417,2,6,8,20,30,10,27,3,27,0,False,False,False,0,2,2022-01-10T16:04:25.193,30,False,3.0
2021,18,3324,670,13,100,2,12,4,7,7,0,7,0,7,6,False,False,False,0,3,2022-01-10T16:12:31.047,7,True,0.0
2021,18,3324,695,31,7913,2,12,2,24,36,12,32,4,32,0,False,False,False,0,3,2022-01-10T16:27:32.757,36,False,4.0
2021,18,3324,710,31,6724,2,17,1,20,24,4,23,1,23,0,False,False,False,0,3,2022-01-10T16:33:37.803,24,False,1.0
2021,18,3324,720,31,661,2,6,10,3,3,0,3,0,3,6,False,False,False,0,3,2022-01-10T16:42:10.753,3,True,0.0
2021,18,3324,735,13,3586,2,5,5,3,5,2,5,0,5,0,False,False,False,0,3,2022-01-10T16:44:50.767,5,False,0.0
2021,18,3324,745,13,3586,2,13,10,4,5,1,5,0,5,0,False,False,False,1,3,2022-01-12T19:31:49.89,5,False,0.0
2021,18,3324,755,13,100,2,35,7,15,21,6,21,0,21,0,False,False,False,0,3,2022-01-10T16:50:31.343,21,False,0.0
2021,18,3324,765,13,100,2,6,4,4,5,1,5,0,5,0,False,False,False,0,3,2022-01-10T16:53:05.06,5,False,0.0
2021,18,3324,770,13,100,2,9,2,24,26,2,26,0,26,6,False,False,False,0,3,2022-01-12T18:02:24.697,26,True,0.0
2021,18,3324,785,31,6793,2,35,5,11,16,5,11,5,11,0,False,False,False,1,3,2022-01-10T16:58:26.433,16,False,5.0
2021,18,3325,20,15,914,2,2,3,9,17,8,14,3,14,0,True,False,False,0,2,2022-01-10T13:14:43.887,17,False,3.0
2021,18,3325,30,15,4886,2,28,9,-2,6,8,3,3,3,0,False,False,False,0,1,2022-01-10T13:17:41.487,6,False,3.0
2021,18,3325,40,15,914,2,5,10,10,12,2,12,0,12,0,False,False,False,0,3,2022-01-10T13:19:47.197,12,False,0.0
2021,18,3325,45,15,914,2,7,8,16,16,0,16,0,16,0,False,False,False,0,2,2022-01-10T13:22:25.18,16,False,0.0
2021,18,3325,55,15,4886,2,28,4,1,8,7,7,1,7,0,False,False,False,0,1,2022-01-10T13:25:16.007,8,False,1.0
2021,18,3325,60,15,7591,2,30,10,0,15,15,14,1,14,0,True,False,False,0,1,2022-01-10T13:27:43.643,15,False,1.0
2021,18,3325,65,15,4835,2,46,3,0,7,7,2,5,2,0,False,False,False,1,1,2022-01-10T13:29:13.473,7,False,5.0
2021,18,3325,70,15,4179,2,46,3,1,2,1,1,1,1,6,True,False,False,0,3,2022-01-10T13:30:47.343,2,False,1.0
2021,18,3325,85,14,1119,2,30,10,-1,11,12,9,2,9,0,False,False,False,0,4,2022-01-10T13:33:26.887,11,False,2.0
2021,18,3325,90,14,7582,13,47,5,1,0,0,0,0,0,0,False,False,False,0,1,2022-01-12T19:46:29.227,0,False,0.0
2021,18,3325,100,14,1119,13,12,9,0,0,0,0,0,0,0,False,False,False,0,3,2022-02-17T18:09:27.67,0,False,0.0
2021,18,3325,110,15,6814,2,44,3,-3,9,12,5,4,5,0,False,False,False,0,1,2022-01-10T13:48:24.427,9,False,4.0
2021,18,3325,130,15,6814,2,48,9,-5,1,6,-1,2,-1,0,False,False,False,0,1,2022-01-10T13:52:25.083,1,False,2.0
2021,18,3325,135,15,4886,2,4,9,6,11,5,10,1,10,0,True,False,False,0,3,2022-01-12T19:42:59.77,11,False,1.0
2021,18,3325,155,14,1114,2,17,1,29,33,4,33,0,33,0,False,False,False,0,3,2022-01-12T19:15:12.007,33,False,0.0
2021,18,3325,165,14,1114,2,4,10,5,6,1,6,0,6,0,False,False,False,0,2,2022-01-10T14:13:57.86,6,False,0.0
2021,18,3325,190,14,6543,2,44,3,-1,9,10,5,4,5,0,True,True,False,1,2,2022-01-10T14:20:52.537,9,False,4.0
2021,18,3325,215,15,914,2,4,9,6,6,0,6,0,6,0,True,False,False,0,2,2022-01-10T14:30:02.983,6,False,0.0
2021,18,3325,220,15,4179,3,19,6,38,0,0,0,0,0,0,False,False,False,0,2,2022-01-12T01:35:05.29,0,False,0.0
2021,18,3325,225,15,7591,2,2,10,6,18,12,10,8,10,0,False,False,False,1,3,2022-01-10T14:34:19.24,18,False,8.0
2021,18,3325,250,15,914,2,35,1,25,29,4,28,1,28,0,False,False,False,0,3,2022-01-10T14:40:42.483,29,False,1.0
2021,18,3325,260,15,7591,2,5,5,6,7,1,7,0,7,0,True,False,False,0,3,2022-01-12T01:35:55.993,7,False,0.0
2021,18,3325,265,15,914,13,35,3,4,0,0,0,0,0,0,True,False,False,0,3,2022-01-10T14:45:35.06,0,False,0.0
2021,18,3325,295,14,6938,13,17,1,37,0,0,0,0,0,0,False,False,False,0,3,2022-01-10T14:51:04.517,0,False,0.0
2021,18,3325,310,15,7591,2,12,5,8,10,2,9,1,9,0,True,False,False,0,2,2022-01-10T14:54:16.573,10,False,1.0
2021,18,3325,325,15,4886,13,28,4,-1,0,0,0,0,0,0,False,False,False,0,1,2022-02-17T18:11:40.123,0,False,0.0
2021,18,3325,330,15,8343,13,29,2,16,0,0,0,0,0,0,False,False,False,0,2,2022-02-24T20:15:06.417,0,False,
2021,18,3325,335,15,4179,2,2,9,6,14,8,11,3,11,0,False,False,False,0,2,2022-01-10T15:01:28.253,14,False,3.0
2021,18,3325,345,15,914,13,24,3,12,0,0,0,0,0,0,True,False,False,0,3,2022-01-10T15:03:09.093,0,False,
2021,18,3325,350,15,7591,2,5,3,4,12,8,7,5,7,0,False,False,False,1,3,2022-01-10T15:04:54.157,12,False,5.0
2021,18,3325,355,15,4886,13,4,4,3,0,0,0,0,0,0,False,False,False,0,1,2022-01-10T15:06:06.47,0,False,0.0
2021,18,3325,360,15,4179,2,5,5,8,8,0,7,1,7,0,False,False,False,1,3,2022-01-10T15:07:58.377,8,False,1.0
2021,18,3325,370,15,4179,13,9,5,2,0,0,0,0,0,0,False,False,False,0,2,2022-01-10T15:08:59.713,0,False,0.0
2021,18,3325,375,15,7591,3,46,3,2,0,0,0,0,0,0,False,False,False,0,3,2022-01-12T19:45:54.267,0,False,0.0
2021,18,3325,405,14,7582,2,44,3,-1,11,12,11,0,11,0,False,False,False,0,1,2022-01-10T15:30:07.557,11,True,0.0
2021,18,3325,415,15,8821,3,44,3,-5,0,0,0,0,0,0,False,False,False,0,1,2022-01-10T15:33:26.987,0,False,0.0
2021,18,3325,425,15,7591,3,4,9,5,0,0,0,0,0,0,False,False,False,0,3,2022-01-10T15:38:47.22,0,False,0.0
2021,18,3325,440,14,4449,13,4,10,8,0,0,0,0,0,0,False,False,False,0,3,2022-01-10T15:44:06.76,0,False,0.0
2021,18,3325,460,14,6543,13,5,5,5,0,0,0,0,0,0,False,False,False,0,3,2022-01-10T15:49:39.307,0,False,0.0
2021,18,3325,470,14,7584,3,8,1,17,0,0,0,0,0,0,False,False,False,0,3,2022-02-17T18:23:34.417,0,False,0.0
2021,18,3325,485,15,4886,3,31,9,1,0,0,0,0,0,0,False,False,False,0,1,2022-01-10T15:56:39.677,0,False,0.0
2021,18,3325,490,15,4835,2,32,5,1,1,0,1,0,1,0,False,False,False,0,3,2022-01-10T15:58:39.697,1,False,0.0
2021,18,3325,500,14,5197,13,35,6,17,0,0,0,0,0,0,False,False,False,0,4,2022-01-12T19:47:40.323,0,False,0.0
2021,18,3325,510,15,4835,2,31,10,3,6,3,4,2,4,0,False,False,False,0,4,2022-01-10T16:05:44.157,6,False,2.0
2021,18,3325,530,15,914,2,5,5,5,5,0,5,0,5,0,False,False,False,0,3,2022-01-10T16:26:00.13,5,False,0.0
2021,18,3325,535,15,914,2,12,5,3,3,0,3,0,3,6,False,False,False,0,3,2022-01-10T16:28:09.49,3,False,0.0
2021,18,3325,565,14,6938,13,5,5,11,0,0,0,0,0,0,False,False,False,0,3,2022-01-12T19:43:25.137,0,False,0.0
2021,18,3325,570,14,7584,2,2,10,6,9,3,6,3,6,0,False,False,False,0,3,2022-01-12T19:49:32.307,9,False,3.0
2021,18,3325,575,14,7584,2,6,10,4,4,0,4,0,4,0,False,False,False,0,2,2022-01-12T19:15:12.02,4,False,0.0
2021,18,3325,585,14,5197,13,5,5,13,0,0,0,0,0,0,False,False,False,0,4,2022-01-12T19:43:38.107,0,False,
2021,18,3325,595,14,4449,2,46,3,4,7,3,7,0,7,0,False,False,False,0,3,2022-01-12T19:49:13.99,7,True,0.0
2021,18,3325,600,14,6543,2,12,3,9,10,1,10,0,10,0,True,False,False,0,3,2022-01-10T16:50:20.64,10,False,0.0
2021,18,3325,630,14,1114,13,6,9,13,0,0,0,0,0,0,False,False,False,0,2,2022-01-10T16:56:13.207,0,False,0.0
2021,18,3325,640,14,1114,13,4,9,12,0,0,0,0,0,0,False,False,False,0,2,2022-01-10T16:58:05.567,0,False,0.0
2021,18,3325,645,14,6938,13,35,7,48,0,0,0,0,0,0,False,False,False,0,3,2022-01-10T16:59:34.927,0,False,0.0
2021,18,3325,705,14,7582,2,47,5,1,3,2,3,0,3,0,False,False,False,0,1,2022-01-10T17:25:15.627,3,False,0.0
2021,18,3325,710,14,5197,2,6,10,12,18,6,17,1,17,0,False,False,False,0,3,2022-01-10T17:26:14.42,18,False,1.0
2021,18,3325,715,14,7582,2,32,9,0,4,4,4,0,4,0,False,False,False,0,1,2022-01-10T17:27:21.83,4,False,0.0
2021,18,3325,720,14,7584,2,4,5,4,10,6,5,5,5,0,False,False,False,2,2,2022-01-10T17:28:37.167,10,False,5.0
2021,18,3325,725,14,7584,2,2,10,5,8,3,7,1,7,0,False,False,False,0,2,2022-01-10T17:29:30.267,8,False,1.0
2021,18,3325,730,14,7584,2,4,10,13,21,8,19,2,19,0,False,False,False,0,2,2022-01-10T17:30:26.62,21,False,2.0
2021,18,3325,740,14,5197,2,4,9,5,9,4,5,4,5,0,False,False,False,0,3,2022-01-10T17:33:29.387,9,False,4.0
2021,18,3325,745,14,1114,13,6,10,7,0,0,0,0,0,0,False,False,False,0,2,2022-01-10T17:34:23.893,0,False,0.0
2021,18,3325,750,14,7584,2,2,3,7,12,5,11,1,11,6,False,False,False,0,2,2022-01-10T17:35:18.347,12,False,1.0
2021,18,3326,10,17,8483,2,51,10,-3,9,12,6,3,6,0,False,False,False,0,3,2022-02-17T18:58:53.42,9,False,3.0
2021,18,3326,15,17,8483,2,5,5,4,4,0,4,0,4,0,True,False,False,0,3,2022-01-10T12:50:29.363,4,False,0.0
2021,18,3326,25,17,8483,2,5,3,5,5,0,5,0,5,0,False,False,False,0,3,2022-01-10T12:52:20.14,5,True,0.0
2021,18,3326,35,17,6274,2,2,9,9,13,4,11,2,11,0,False,False,False,0,3,2022-01-10T12:54:51,13,False,2.0
2021,18,3326,60,17,7024,2,4,10,4,7,3,7,0,7,0,False,False,False,0,1,2022-01-12T16:36:24.177,7,False,0.0
2021,18,3326,65,17,2253,2,2,9,5,9,4,7,2,7,0,False,False,False,0,2,2022-01-12T16:40:18.517,9,False,2.0
2021,18,3326,75,17,8483,2,11,3,7,7,0,7,0,7,6,True,False,False,0,3,2022-01-12T16:41:02,7,True,0.0
2021,18,3326,100,19,7175,13,4,5,3,0,0,0,0,0,0,False,False,False,0,3,2022-01-10T13:13:10.207,0,False,0.0
2021,18,3326,120,19,8493,2,44,3,-5,2,7,2,0,2,0,True,False,False,1,1,2022-01-12T16:37:56.047,2,False,0.0
2021,18,3326,130,19,7172,2,51,9,-3,5,8,2,3,2,0,False,False,False,0,1,2022-01-10T14:13:28.09,5,False,3.0
2021,18,3326,140,19,4282,13,12,9,12,0,0,0,0,0,0,False,False,False,0,3,2022-01-10T13:30:02.043,0,False,0.0
2021,18,3326,155,17,6276,2,11,3,12,17,5,15,2,15,0,False,False,False,0,4,2022-01-10T13:38:41.617,17,False,2.0
2021,18,3326,170,17,2253,13,6,9,13,0,0,0,0,0,0,False,False,False,0,2,2022-01-11T22:18:49.2,0,False,0.0
2021,18,3326,180,17,7024,2,48,4,-2,4,6,3,1,3,0,False,False,False,0,1,2022-01-10T13:49:30.22,4,False,1.0
2021,18,3326,225,17,2253,13,29,5,12,0,0,0,0,0,0,False,False,False,0,2,2022-01-10T14:00:44.76,0,False,0.0
2021,18,3326,240,19,7175,13,4,4,5,0,0,0,0,0,0,False,False,False,0,3,2022-01-10T14:04:43.53,0,False,0.0
2021,18,3326,245,19,4282,2,12,6,29,35,6,34,1,34,0,False,False,False,0,4,2022-01-10T14:06:43.247,35,False,1.0
2021,18,3326,250,19,7172,2,44,3,-4,7,11,5,2,5,0,False,False,False,0,1,2022-01-10T14:09:10.16,7,False,2.0
2021,18,3326,265,19,7175,2,39,4,5,5,0,5,0,5,0,True,False,False,0,3,2022-01-10T14:16:52.31,5,False,0.0
2021,18,3326,285,17,2253,2,5,5,3,3,0,3,0,3,0,False,False,False,0,2,2022-01-10T14:21:45.73,3,False,0.0
2021,18,3326,305,19,7172,2,4,4,4,13,9,10,3,10,0,False,False,False,1,1,2022-01-10T17:20:34.233,13,False,3.0
2021,18,3326,310,19,7175,13,35,8,18,0,0,0,0,0,0,False,False,False,0,3,2022-02-24T14:29:28.287,0,False,0.0
2021,18,3326,315,19,7175,13,42,10,5,0,0,0,0,0,0,True,False,False,0,2,2022-01-12T16:46:56.087,0,False,0.0
2021,18,3326,325,19,2256,13,4,3,7,0,0,0,0,0,0,True,False,False,0,3,2022-01-12T16:42:18.913,0,False,0.0
2021,18,3326,340,17,8483,3,2,9,12,0,0,0,0,0,0,False,False,False,0,3,2022-02-17T19:00:20.41,0,False,0.0
2021,18,3326,350,17,4383,13,12,6,19,0,0,0,0,0,0,False,False,False,0,2,2022-02-24T14:24:24.907,0,False,0.0
2021,18,3326,365,19,2256,2,4,6,19,23,4,21,2,21,0,False,False,False,0,2,2022-01-10T14:59:17.52,23,False,2.0
2021,18,3326,370,19,7173,13,6,7,18,0,0,0,0,0,0,True,False,False,0,3,2022-02-17T19:02:01.77,0,False,0.0
2021,18,3326,390,19,4912,2,50,9,-2,17,19,11,6,11,0,True,False,False,1,2,2022-01-10T15:03:17.657,17,False,6.0
2021,18,3326,420,17,404,2,44,3,-5,5,10,2,3,2,0,False,False,False,1,1,2022-01-10T15:08:29.613,5,False,3.0
2021,18,3326,425,17,6274,13,5,10,7,0,0,0,0,0,0,False,False,False,0,3,2022-01-10T15:09:36.447,0,False,
2021,18,3326,435,17,6274,2,6,4,5,9,4,8,1,8,0,False,False,False,0,3,2022-01-10T15:12:32.963,9,False,1.0
2021,18,3326,465,19,4912,2,4,9,6,6,0,6,0,6,0,True,False,False,0,3,2022-01-11T17:01:22.743,6,False,0.0
2021,18,3326,480,19,2256,13,12,2,31,0,0,0,0,0,0,False,False,False,0,3,2022-01-10T15:23:23.803,0,False,0.0
2021,18,3326,490,19,4282,13,12,5,8,0,0,0,0,0,0,False,False,False,0,3,2022-01-12T16:43:28.88,0,False,
2021,18,3326,515,19,1212,2,34,10,-4,2,6,-4,6,-4,0,True,False,False,1,2,2022-01-10T15:32:48.777,2,False,6.0
2021,18,3326,565,17,6276,13,35,4,14,0,0,0,0,0,0,False,False,False,0,4,2022-01-10T15:43:52.933,0,False,
2021,18,3326,580,17,6274,13,2,10,8,0,0,0,0,0,0,False,False,False,0,4,2022-01-10T15:49:04.103,0,False,0.0
2021,18,3326,585,17,4383,13,9,6,25,0,0,0,0,0,0,False,False,False,0,2,2022-01-10T15:50:05.31,0,False,
2021,18,3326,610,19,4912,13,4,10,5,0,0,0,0,0,0,True,False,False,0,3,2022-01-10T15:56:30.13,0,False,0.0
2021,18,3326,615,19,7175,2,9,2,21,28,7,28,0,28,0,False,False,False,0,3,2022-01-10T15:57:38.23,28,False,0.0
2021,18,3326,620,19,8493,13,12,3,3,0,0,0,0,0,0,False,False,False,0,1,2022-02-24T14:41:40.45,0,False,0.0
2021,18,3326,640,17,8483,2,34,4,-4,2,6,2,0,2,0,True,False,False,0,3,2022-01-10T16:02:53.177,2,False,0.0
2021,18,3326,690,17,7024,2,44,3,-2,0,2,-1,1,-1,0,False,False,False,0,1,2022-01-10T16:16:52.74,0,False,1.0
2021,18,3326,705,19,4282,2,39,10,6,6,0,6,0,6,0,False,False,False,0,4,2022-01-10T16:18:30.22,6,False,0.0
2021,18,3326,710,19,4282,2,7,2,26,32,6,32,0,32,0,False,False,False,0,4,2022-01-10T16:20:09.82,32,False,0.0
2021,18,3326,720,19,4282,2,4,10,5,5,0,5,0,5,0,False,False,False,0,4,2022-01-10T16:23:23.2,5,False,0.0
2021,18,3326,750,19,4912,2,50,9,-1,1,2,0,1,0,0,True,False,False,0,2,2022-01-10T16:28:25.473,1,False,1.0
2021,18,3326,755,19,1212,2,46,9,-2,18,20,15,3,15,6,False,False,False,0,1,2022-01-10T16:29:21.143,18,False,3.0
2021,18,3326,780,17,8483,13,5,5,8,0,0,0,0,0,0,False,False,False,0,3,2022-01-10T16:33:06.857,0,False,0.0
2021,18,3326,790,19,7175,2,19,6,39,39,0,39,0,39,0,True,False,False,0,2,2022-01-10T17:04:55.77,39,False,0.0
2021,18,3326,800,19,7172,2,12,3,4,11,7,10,1,10,0,False,False,False,1,1,2022-01-10T17:11:35.067,11,False,1.0
2021,18,3326,805,19,4282,2,13,9,5,8,3,8,0,8,0,False,False,False,0,3,2022-01-10T16:40:20.003,8,False,0.0
2021,18,3326,815,19,2256,13,9,3,12,0,0,0,0,0,0,False,False,False,0,3,2022-01-10T16:43:27.003,0,False,
2021,18,3326,840,17,6276,2,51,3,0,15,15,14,1,14,0,True,False,False,0,4,2022-01-11T22:19:08.153,15,False,1.0
2021,18,3326,905,19,7175,2,50,10,-2,1,3,1,0,1,0,True,True,True,0,2,2022-02-24T14:44:15.7,-2,False,0.0
2021,18,3327,10,6,7725,2,34,4,-4,14,18,1,13,1,0,True,False,False,1,3,2022-01-12T21:28:37.39,14,False,13.0
2021,18,3327,20,6,7725,2,2,9,2,16,14,9,7,9,0,True,False,False,0,2,2022-01-10T11:46:41.817,16,False,7.0
2021,18,3327,30,6,464,13,35,5,10,0,0,0,0,0,0,False,False,False,0,3,2022-01-10T11:49:24.27,0,False,0.0
2021,18,3327,35,6,3233,13,32,5,0,0,0,0,0,0,0,False,False,False,0,4,2022-01-10T11:52:44.413,0,False,0.0
2021,18,3327,50,18,4572,2,4,4,3,3,0,3,0,3,0,False,False,False,0,1,2022-01-10T11:55:44.343,3,False,0.0
2021,18,3327,70,6,6786,2,47,5,3,3,0,3,0,3,0,False,False,False,0,1,2022-01-10T12:02:05.757,3,False,0.0
2021,18,3327,100,6,7725,2,51,9,-2,5,7,4,1,4,0,True,False,False,0,3,2022-01-10T12:10:41.853,5,False,1.0
2021,18,3327,110,18,6361,13,17,10,14,0,0,0,0,0,0,False,False,False,0,4,2022-01-10T12:18:05.98,0,False,0.0
2021,18,3327,120,18,7711,2,26,10,6,7,1,7,0,7,0,False,False,False,0,3,2022-01-10T12:22:08.82,7,False,0.0
2021,18,3327,140,18,7712,13,13,10,1,0,0,0,0,0,0,False,False,False,0,3,2022-01-10T12:28:58.117,0,False,0.0
2021,18,3327,175,6,1378,2,2,9,5,5,0,5,0,5,0,False,False,False,0,2,2022-01-10T12:47:43.663,5,False,0.0
2021,18,3327,185,6,7725,2,13,10,2,19,17,16,3,16,0,False,False,False,0,3,2022-01-10T12:51:06.217,19,False,3.0
2021,18,3327,195,6,3233,2,4,9,11,11,0,11,0,11,0,False,False,False,0,3,2022-01-10T12:54:59.55,11,False,0.0
2021,18,3327,200,6,464,2,5,6,16,16,0,16,0,16,0,False,False,False,0,3,2022-01-10T12:58:50.167,16,False,0.0
2021,18,3327,215,6,1400,2,45,5,-4,6,10,5,1,5,0,True,False,False,0,1,2022-01-10T13:03:24.15,6,False,1.0
2021,18,3327,240,18,7711,13,6,10,11,0,0,0,0,0,0,True,False,False,0,2,2022-01-10T13:12:52.1,0,False,0.0
2021,18,3327,255,6,7725,2,7,6,16,18,2,18,0,18,0,False,False,False,0,3,2022-01-12T20:30:37.74,18,False,0.0
2021,18,3327,270,6,7725,2,50,10,-3,-1,2,-1,0,-1,0,False,False,False,0,3,2022-01-10T13:23:10.627,-1,False,0.0
2021,18,3327,280,6,7725,13,19,8,28,0,0,0,0,0,0,False,False,False,0,3,2022-01-10T13:26:48.647,0,False,0.0
2021,18,3327,295,18,7712,13,7,2,38,0,0,0,0,0,0,False,False,False,0,2,2022-02-24T14:54:40.627,0,False,0.0
2021,18,3327,310,18,6900,2,28,4,3,3,0,3,0,3,0,False,False,False,0,1,2022-01-10T13:47:36.507,3,False,0.0
2021,18,3327,330,6,7728,13,17,8,17,0,0,0,0,0,0,False,False,False,0,3,2022-01-10T13:55:53.213,0,False,0.0
2021,18,3327,345,6,3233,2,4,9,5,14,9,14,0,14,0,False,False,False,0,2,2022-01-10T13:59:31.54,14,False,0.0
2021,18,3327,350,6,3233,2,4,3,5,5,0,5,0,5,0,False,False,False,0,2,2022-01-10T14:00:51.523,5,False,0.0
2021,18,3327,355,6,1378,2,5,5,6,8,2,7,1,7,0,False,False,False,0,2,2022-01-10T14:01:52.843,8,False,1.0
2021,18,3327,360,6,1378,13,2,10,12,0,0,0,0,0,0,False,False,False,0,3,2022-01-10T14:03:52.457,0,False,0.0
2021,18,3327,365,6,1400,13,11,2,23,0,0,0,0,0,0,False,False,False,0,1,2022-01-10T14:07:18.313,0,False,0.0
2021,18,3327,370,6,1400,2,11,5,13,23,10,23,0,23,6,True,False,False,0,1,2022-01-10T14:09:34.41,23,True,0.0
2021,18,3327,385,18,7711,2,7,2,22,25,3,25,0,25,0,False,False,False,0,2,2022-01-10T14:16:10.793,25,True,0.0
2021,18,3327,390,18,8386,2,12,6,34,40,6,40,0,40,0,False,False,False,0,2,2022-01-10T14:22:32.3,40,False,0.0
2021,18,3327,400,18,7712,2,13,9,6,6,0,6,0,6,0,False,False,False,0,3,2022-01-10T14:25:38.99,6,False,
2021,18,3327,445,18,6361,2,53,9,-6,-3,3,-3,0,-3,0,False,False,False,0,4,2022-01-10T14:41:05.06,-3,False,0.0
2021,18,3327,450,18,6361,13,6,4,11,0,0,0,0,0,0,False,False,False,0,4,2022-01-10T14:42:48.373,0,False,0.0
2021,18,3327,455,18,8386,2,8,7,32,44,12,44,0,44,6,False,False,False,0,3,2022-01-10T14:47:41.613,44,True,0.0
2021,18,3327,470,6,7725,2,34,4,-4,8,12,8,0,8,0,True,False,False,0,3,2022-01-12T21:18:56.487,8,False,0.0
2021,18,3327,480,6,7728,2,17,1,16,20,4,19,1,19,0,False,False,False,0,4,2022-01-10T14:55:49.513,20,False,1.0
2021,18,3327,485,6,7725,13,4,7,17,0,0,0,0,0,0,False,False,False,0,2,2022-02-17T19:06:13.97,0,False,
2021,18,3327,500,6,7725,2,5,3,11,13,2,13,0,13,0,False,False,False,0,3,2022-01-10T15:02:57.163,13,True,0.0
2021,18,3327,525,18,6361,2,47,5,0,9,9,4,5,4,0,False,False,False,0,4,2022-01-10T15:13:34.64,9,False,5.0
2021,18,3327,550,6,7728,2,4,10,9,19,10,15,4,15,0,False,False,False,0,3,2022-01-10T15:24:15.453,19,False,4.0
2021,18,3327,560,6,464,2,4,5,6,6,0,6,0,6,0,False,False,False,0,2,2022-01-10T15:27:05.997,6,False,0.0
2021,18,3327,565,6,6786,2,45,5,-4,4,8,4,0,4,0,False,False,False,0,1,2022-01-10T15:28:32.07,4,False,0.0
2021,18,3327,570,6,6786,3,5,5,2,0,0,0,0,0,0,True,False,False,0,1,2022-01-10T15:30:17.387,0,False,0.0
2021,18,3327,575,6,1400,2,48,9,-7,4,11,-3,7,-3,0,False,False,False,1,1,2022-01-10T15:31:45.917,4,False,7.0
2021,18,3327,580,6,7725,13,6,6,15,0,0,0,0,0,0,False,False,False,0,2,2022-01-10T15:33:43.27,0,False,0.0
2021,18,3327,595,18,7711,2,30,10,1,4,3,4,0,4,0,False,False,False,0,3,2022-01-10T15:38:47.523,4,False,0.0
2021,18,3327,605,18,8386,2,7,2,19,19,0,19,0,19,0,False,False,False,0,3,2022-01-10T15:43:15.573,19,False,0.0
2021,18,3327,615,18,4152,2,32,10,1,7,6,3,4,3,0,False,False,False,0,1,2022-01-10T15:46:59.58,7,False,4.0
2021,18,3327,625,18,7711,2,19,2,45,45,0,45,0,45,6,False,False,False,0,2,2022-01-10T15:51:23.7,45,True,0.0
2021,18,3327,640,6,7725,2,34,4,-4,6,10,6,0,6,0,True,False,False,1,3,2022-01-12T21:12:08.477,6,False,0.0
2021,18,3327,645,6,7725,2,35,6,17,18,1,18,0,18,0,False,False,False,0,3,2022-01-10T15:56:29.387,18,False,0.0
2021,18,3327,660,6,464,13,5,2,15,0,0,0,0,0,0,False,False,False,0,2,2022-01-10T16:02:18.65,0,False,0.0
2021,18,3327,670,18,7712,13,5,3,4,0,0,0,0,0,0,False,False,False,0,3,2022-01-12T21:10:56.387,0,False,0.0
2021,18,3327,680,18,7711,2,35,2,21,26,5,26,0,26,0,False,False,False,0,3,2022-02-17T19:07:10.15,26,False,0.0
2021,18,3327,695,18,7712,2,35,6,21,21,0,21,0,21,6,False,False,False,0,3,2022-02-17T19:07:39.797,21,True,0.0
2021,18,3327,710,6,7728,2,32,10,0,7,7,4,3,4,0,False,False,False,0,4,2022-01-10T16:18:26.143,7,False,3.0
2021,18,3327,720,6,7725,2,5,5,6,7,1,7,0,7,0,True,False,False,0,2,2022-01-11T18:04:44.857,7,False,0.0
2021,18,3327,725,6,7725,13,6,1,21,0,0,0,0,0,0,False,False,False,0,3,2022-01-10T16:24:35.187,0,False,0.0
2021,18,3327,730,6,3233,2,4,10,5,6,1,6,0,6,0,False,False,False,0,1,2022-01-10T16:26:28.837,6,False,0.0
2021,18,3327,735,6,7725,2,51,9,-2,3,5,3,0,3,0,False,False,False,0,3,2022-01-10T16:28:31.893,3,False,0.0
2021,18,3327,740,6,8366,13,12,6,17,0,0,0,0,0,0,False,False,False,0,3,2022-01-10T16:30:54.167,0,False,0.0
2021,18,3327,755,6,3233,2,4,10,12,11,-1,11,0,11,0,False,False,False,0,3,2022-01-10T16:34:00.637,11,False,0.0
2021,18,3327,760,6,7725,13,8,10,6,0,0,0,0,0,0,False,False,False,0,3,2022-01-12T20:30:37.753,0,False,0.0
2021,18,3327,765,18,7711,3,50,3,-2,0,0,0,0,0,0,True,False,False,0,2,2022-01-10T16:38:45.15,0,False,0.0
2021,18,3327,790,6,7728,2,38,9,1,2,1,2,0,2,0,False,False,False,0,3,2022-01-10T16:43:40.95,2,False,0.0
2021,18,3327,795,6,1400,13,6,10,2,0,0,0,0,0,0,False,False,False,0,1,2022-01-10T16:45:22.747,0,False,0.0
2021,18,3327,800,6,666,2,4,10,9,10,1,9,1,9,0,False,False,False,0,3,2022-01-10T16:46:34.23,10,False,1.0
2021,18,3327,810,6,666,2,32,3,4,6,2,6,0,6,0,False,False,False,0,3,2022-01-10T16:50:10.82,6,False,0.0
2021,18,3327,825,6,8366,2,32,5,2,13,11,9,4,9,0,False,False,False,1,3,2022-01-12T21:11:11.477,13,False,4.0
2021,18,3328,15,32,7128,2,5,5,9,11,2,11,0,11,0,False,False,False,0,3,2022-01-10T10:06:21.293,11,True,0.0
2021,18,3328,30,32,7128,2,12,3,11,30,19,27,3,27,0,False,False,False,0,3,2022-01-11T17:43:26.567,30,False,3.0
2021,18,3328,55,32,6430,3,8,4,5,0,0,0,0,0,0,False,False,False,0,3,2022-01-10T10:21:55.173,0,False,0.0
2021,18,3328,75,21,6228,2,47,5,1,3,2,1,2,1,0,False,False,False,0,1,2022-01-11T22:53:14.267,3,False,2.0
2021,18,3328,90,21,813,2,47,5,4,9,5,7,2,7,0,False,False,False,0,4,2022-01-10T10:33:24.5,9,False,2.0
2021,18,3328,115,21,813,2,51,5,1,6,5,3,3,3,0,False,False,False,0,3,2022-01-10T10:43:48.473,6,False,3.0
2021,18,3328,130,32,7128,2,50,10,-2,12,14,11,1,11,0,False,False,False,0,2,2022-01-12T14:23:00.903,12,False,1.0
2021,18,3328,145,32,7128,13,19,6,27,0,0,0,0,0,0,False,False,False,0,3,2022-01-10T10:56:23.583,0,False,0.0
2021,18,3328,160,21,813,2,53,4,-4,-2,2,-2,0,-2,0,False,False,False,0,4,2022-01-10T11:03:19.283,-2,False,0.0
2021,18,3328,170,21,4422,3,51,3,-3,0,0,0,0,0,0,False,False,False,0,3,2022-02-17T19:12:49.867,0,False,0.0
2021,18,3328,195,32,2675,13,3,3,11,0,0,0,0,0,0,False,False,False,0,3,2022-01-11T17:42:55.773,0,False,0.0
2021,18,3328,250,32,7807,13,12,3,4,0,0,0,0,0,0,False,False,False,0,3,2022-01-12T14:40:57.437,0,False,0.0
2021,18,3328,260,21,4180,13,46,9,2,0,0,0,0,0,0,False,False,False,0,1,2022-01-10T11:35:44.46,0,False,0.0
2021,18,3328,290,32,7807,2,28,9,1,5,4,2,3,2,0,False,False,False,0,1,2022-01-10T11:44:07.78,5,False,3.0
2021,18,3328,295,32,3562,13,51,10,-4,0,0,0,0,0,0,True,False,False,0,1,2022-01-10T11:46:05.503,0,False,0.0
2021,18,3328,320,21,813,13,7,2,21,0,0,0,0,0,0,False,False,False,0,4,2022-01-12T14:43:31.903,0,False,0.0
2021,18,3328,340,32,7128,2,19,6,29,40,11,40,0,40,0,False,False,False,0,3,2022-01-10T11:59:27.593,40,False,0.0
2021,18,3328,350,32,8659,2,4,9,4,6,2,6,0,6,0,False,False,False,0,1,2022-01-12T14:27:44.32,6,False,0.0
2021,18,3328,355,32,8659,2,47,10,2,8,6,8,0,8,0,False,False,False,0,1,2022-01-11T17:43:48.673,8,False,0.0
2021,18,3328,395,21,4492,2,2,10,7,9,2,9,0,9,0,False,False,False,0,2,2022-01-10T12:19:36.283,9,False,0.0
2021,18,3328,410,21,7090,13,2,10,10,0,0,0,0,0,0,False,False,False,0,2,2022-01-10T12:26:15.73,0,False,0.0
2021,18,3328,415,21,4492,13,19,2,34,0,0,0,0,0,0,False,False,False,0,2,2022-01-10T12:28:22.9,0,False,0.0
2021,18,3328,440,32,2675,2,30,5,3,3,0,3,0,3,0,True,False,False,0,4,2022-01-12T14:58:28.043,3,False,0.0
2021,18,3328,465,32,7807,13,12,2,22,0,0,0,0,0,0,False,False,False,0,1,2022-01-10T12:46:23.297,0,False,0.0
2021,18,3328,470,32,7128,13,2,10,6,0,0,0,0,0,0,False,False,False,0,3,2022-01-10T12:47:49.343,0,False,0.0
2021,18,3328,490,21,3957,2,48,9,-3,6,9,5,1,5,0,False,False,False,0,1,2022-01-10T12:56:11.793,6,False,1.0
2021,18,3328,495,21,4422,13,5,10,4,0,0,0,0,0,0,False,False,False,0,3,2022-01-10T12:57:47.88,0,False,0.0
2021,18,3328,510,21,813,2,47,5,3,4,1,4,0,4,0,False,False,False,0,3,2022-01-12T14:28:05.03,4,False,0.0
2021,18,3328,525,21,4180,13,46,3,0,0,0,0,0,0,0,True,False,False,0,1,2022-01-10T13:16:14.673,0,False,0.0
2021,18,3328,535,21,4422,2,13,9,2,4,2,3,1,3,0,False,False,False,0,4,2022-01-10T13:19:55.187,4,False,1.0
2021,18,3328,545,21,6228,2,11,3,3,11,8,11,0,11,0,True,False,False,0,1,2022-01-12T14:28:21.177,11,False,0.0
2021,18,3328,555,21,6228,2,28,9,-1,5,6,5,0,5,0,False,False,False,0,1,2022-01-11T22:54:06.007,5,False,0.0
2021,18,3328,560,21,4422,13,5,5,3,0,0,0,0,0,0,True,False,False,0,2,2022-01-10T13:39:14.793,0,False,0.0
2021,18,3328,565,21,4492,2,5,5,3,7,4,7,0,7,0,False,False,False,0,3,2022-01-12T14:29:19.717,7,True,0.0
2021,18,3328,570,21,813,13,47,5,7,0,0,0,0,0,0,False,False,False,0,4,2022-01-12T14:40:37.88,0,False,0.0
2021,18,3328,580,21,7090,2,17,7,22,22,0,22,0,22,6,False,False,False,0,3,2022-01-10T13:46:14.587,22,True,0.0
2021,18,3328,600,32,8528,2,13,4,4,5,1,4,1,4,0,False,False,False,0,4,2022-01-12T14:10:09.673,5,False,1.0
2021,18,3328,675,21,4492,13,29,6,22,0,0,0,0,0,0,False,False,False,0,3,2022-02-25T16:19:34.387,0,False,0.0
2021,18,3328,680,21,6228,13,9,6,23,0,0,0,0,0,0,False,False,False,0,2,2022-01-10T14:19:17.497,0,False,0.0
2021,18,3328,750,21,4492,2,13,10,4,6,2,6,0,6,0,False,False,False,0,3,2022-01-10T14:49:17.783,6,False,0.0
2021,18,3328,755,21,4422,13,5,5,5,0,0,0,0,0,0,False,False,False,0,3,2022-01-10T14:51:06.537,0,False,0.0
2021,18,3328,760,21,7090,13,21,2,24,0,0,0,0,0,0,False,False,False,0,2,2022-01-10T14:53:10.073,0,False,
2021,18,3328,765,21,6981,13,6,7,15,0,0,0,0,0,0,False,False,False,0,2,2022-01-10T14:57:41.807,0,False,0.0
2021,18,3328,770,21,3957,2,48,9,-4,6,10,4,2,4,0,False,False,False,0,1,2022-01-10T14:59:01.357,6,False,2.0
2021,18,3328,785,21,6981,13,44,3,2,0,0,0,0,0,0,True,False,False,0,3,2022-01-10T15:03:53.75,0,False,0.0
2021,18,3328,790,21,7090,2,6,9,6,7,1,6,1,6,0,False,False,False,0,2,2022-01-10T15:05:13.07,7,False,1.0
2021,18,3328,795,21,6981,13,2,8,16,0,0,0,0,0,0,False,False,False,0,3,2022-01-10T15:09:25.127,0,False,0.0
2021,18,3329,10,24,8509,13,7,6,23,0,0,0,0,0,0,False,False,False,0,3,2022-01-09T13:21:38.787,0,False,0.0
2021,18,3329,20,24,8509,2,12,6,24,25,1,25,0,25,0,False,False,False,0,2,2022-01-12T16:56:05.747,25,False,0.0
2021,18,3329,25,24,7798,2,4,10,4,12,8,7,5,7,0,False,False,False,0,3,2022-01-09T13:50:50.18,12,False,5.0
2021,18,3329,55,24,565,2,55,4,-2,2,4,1,1,1,0,False,False,False,0,4,2022-01-10T20:27:41.41,2,False,1.0
2021,18,3329,60,24,8665,2,55,4,-1,3,4,3,0,3,6,False,False,False,0,4,2022-01-09T14:03:38.397,3,False,0.0
2021,18,3329,85,9,322,2,4,3,5,5,0,5,0,5,0,False,False,False,0,3,2022-01-11T01:31:10.217,5,False,0.0
2021,18,3329,90,9,6441,2,5,5,10,16,6,16,0,16,0,False,False,False,0,3,2022-01-09T14:12:17.227,16,False,0.0
2021,18,3329,95,9,7816,2,5,3,6,14,8,8,6,8,0,False,False,False,1,3,2022-01-09T14:14:21,14,False,6.0
2021,18,3329,110,9,6441,3,2,10,7,0,0,0,0,0,0,False,False,False,0,3,2022-02-17T19:25:28.32,0,False,0.0
2021,18,3329,115,9,322,2,13,10,3,14,11,14,0,14,0,False,False,False,0,3,2022-01-09T14:30:55.93,14,True,0.0
2021,18,3329,125,9,6441,2,46,3,4,14,10,14,0,14,6,True,False,False,0,4,2022-01-09T14:33:38.16,14,True,0.0
2021,18,3329,150,24,8665,3,12,3,12,0,0,0,0,0,0,False,False,False,0,3,2022-01-09T14:40:10.093,0,False,0.0
2021,18,3329,160,9,322,2,35,6,22,27,5,26,1,26,0,True,False,False,0,3,2022-01-09T14:43:15.18,27,False,1.0
2021,18,3329,170,9,7816,13,8,7,20,0,0,0,0,0,0,False,False,False,0,2,2022-01-12T16:56:41.763,0,False,
2021,18,3329,175,9,6446,2,4,4,9,10,1,9,1,9,0,False,False,False,0,3,2022-01-09T14:50:11.157,10,False,1.0
2021,18,3329,195,24,8509,2,3,5,12,12,0,12,0,12,0,False,False,False,0,2,2022-01-09T14:56:48.063,12,False,0.0
2021,18,3329,200,24,8509,2,3,10,5,4,-1,4,0,4,0,False,False,False,0,2,2022-01-09T14:58:13.703,4,False,0.0
2021,18,3329,205,24,7003,13,4,10,5,0,0,0,0,0,0,False,False,False,0,3,2022-02-17T19:26:49.72,0,False,0.0
2021,18,3329,210,24,8513,2,48,10,-3,7,10,5,2,5,0,False,False,False,0,1,2022-01-09T15:01:18.32,7,False,2.0
2021,18,3329,220,24,8513,3,28,10,1,0,0,0,0,0,0,False,False,False,0,1,2022-01-12T16:07:39.32,0,False,0.0
2021,18,3329,225,24,8665,2,17,10,13,13,0,13,0,13,0,False,False,False,0,4,2022-01-09T15:14:09.057,13,False,0.0
2021,18,3329,235,24,8513,2,48,10,-7,-8,-1,-8,0,-8,0,False,False,False,0,1,2022-02-24T15:06:33.937,-8,False,0.0
2021,18,3329,240,24,8513,2,50,5,-1,1,2,1,0,1,0,True,False,False,0,2,2022-01-10T20:29:19.563,1,False,0.0
2021,18,3329,265,9,7816,2,6,8,20,31,11,20,11,20,0,False,False,False,3,2,2022-01-09T15:29:11.043,31,False,11.0
2021,18,3329,290,9,6441,2,7,6,23,24,1,23,1,23,6,False,False,False,0,3,2022-01-09T15:36:14.713,24,False,1.0
2021,18,3329,315,24,7800,2,5,6,17,22,5,21,1,21,0,False,False,False,0,3,2022-01-09T15:42:51.213,22,False,1.0
2021,18,3329,320,24,8513,13,46,3,4,0,0,0,0,0,0,False,False,False,0,1,2022-01-09T15:44:15.307,0,False,0.0
2021,18,3329,330,24,8665,2,46,3,3,6,3,6,0,6,0,False,False,False,0,4,2022-01-09T15:47:33.2,6,False,0.0
2021,18,3329,340,24,565,2,32,10,2,9,7,4,5,4,0,False,False,False,0,4,2022-01-09T15:52:19.81,9,False,5.0
2021,18,3329,350,24,8513,13,4,10,1,0,0,0,0,0,0,False,False,False,0,1,2022-01-09T15:55:50.423,0,False,0.0
2021,18,3329,370,9,322,13,4,10,-2,0,0,0,0,0,0,False,False,False,0,3,2022-01-09T16:02:31.283,0,False,0.0
2021,18,3329,380,9,4385,2,4,4,4,7,3,6,1,6,0,False,False,False,0,1,2022-01-09T16:07:10.68,7,False,1.0
2021,18,3329,390,9,322,2,13,4,4,7,3,5,2,5,0,False,False,False,1,3,2022-01-12T17:12:25.503,7,False,2.0
2021,18,3329,400,9,322,2,19,2,25,26,1,25,1,25,0,False,False,False,0,2,2022-01-09T16:11:34.233,26,False,1.0
2021,18,3329,405,9,322,13,3,5,2,0,0,0,0,0,0,False,False,False,0,2,2022-02-17T19:27:30.607,0,False,0.0
2021,18,3329,410,9,6446,2,47,5,1,2,1,2,0,2,6,False,False,False,0,3,2022-01-12T17:12:52.863,2,True,0.0
2021,18,3329,430,24,7800,13,4,3,7,0,0,0,0,0,0,False,False,False,0,2,2022-01-09T16:19:50.777,0,False,
2021,18,3329,445,24,4382,13,32,5,-7,0,0,0,0,0,0,False,False,False,0,3,2022-01-09T16:29:14.553,0,False,0.0
2021,18,3329,465,9,6441,2,8,1,23,28,5,26,2,26,0,False,False,False,0,3,2022-01-12T17:09:25.637,28,False,2.0
2021,18,3329,475,9,4447,2,5,3,6,6,0,6,0,6,0,False,False,False,0,3,2022-01-09T16:35:19.733,6,False,0.0
2021,18,3329,480,9,4447,3,17,4,9,0,0,0,0,0,0,False,False,False,0,3,2022-01-09T16:36:27.52,0,False,0.0
2021,18,3329,485,9,6446,2,4,4,9,9,0,9,0,9,6,False,False,False,0,3,2022-01-09T18:41:04.957,9,True,0.0
2021,18,3329,525,9,4202,2,12,3,-1,3,4,2,1,2,0,False,False,False,0,1,2022-01-12T16:57:45.71,3,False,1.0
2021,18,3329,565,24,8665,13,12,5,12,0,0,0,0,0,0,False,False,False,0,3,2022-01-12T16:57:57.287,0,False,0.0
2021,18,3329,570,24,7800,2,13,10,1,11,10,-1,12,-1,0,False,False,False,2,3,2022-01-12T17:18:11.193,11,False,12.0
2021,18,3329,580,24,7798,2,5,5,7,7,0,7,0,7,0,False,False,False,0,3,2022-01-09T17:04:57.43,7,True,0.0
2021,18,3329,585,24,7800,2,13,10,2,4,2,3,1,3,0,False,False,False,0,3,2022-01-09T17:06:47.317,4,False,1.0
2021,18,3329,590,24,7003,3,9,6,22,0,0,0,0,0,0,False,False,False,0,3,2022-01-12T16:58:09.303,0,False,0.0
2021,18,3329,595,24,7734,13,45,5,-1,0,0,0,0,0,0,False,False,False,0,1,2022-01-09T17:09:56.447,0,False,0.0
2021,18,3329,600,24,7798,13,50,9,5,0,0,0,0,0,0,False,False,False,0,2,2022-01-09T17:12:29.373,0,False,0.0
2021,18,3329,630,9,4202,13,46,3,2,0,0,0,0,0,0,False,False,False,0,1,2022-01-12T16:58:20.55,0,False,0.0
2021,18,3329,640,9,6441,2,8,8,18,37,19,28,9,28,0,False,False,False,1,3,2022-01-09T17:25:49.35,37,False,9.0
2021,18,3329,665,9,4385,2,47,5,2,2,0,2,0,2,0,False,False,False,0,1,2022-01-09T17:32:37.333,2,False,0.0
2021,18,3329,670,9,4385,2,47,5,1,5,4,4,1,4,0,False,False,False,0,1,2022-01-09T17:34:02.533,5,False,1.0
2021,18,3329,685,9,4385,2,46,3,4,8,4,8,0,8,6,False,False,False,0,1,2022-01-09T17:37:23.207,8,True,0.0
2021,18,3329,700,24,7800,13,19,5,14,0,0,0,0,0,0,False,False,False,0,2,2022-01-10T20:28:06.02,0,False,0.0
2021,18,3329,735,9,4467,2,4,4,7,10,3,8,2,8,0,False,False,False,0,3,2022-01-09T17:59:13.023,10,False,2.0
2021,18,3329,755,24,7003,3,13,9,8,0,0,0,0,0,0,False,False,False,0,3,2022-02-17T19:29:56.74,0,False,0.0
2021,18,3329,795,24,7800,2,4,4,11,11,0,7,4,7,0,False,False,False,0,3,2022-01-09T18:14:03.503,11,False,4.0
2021,18,3329,810,24,7800,13,19,6,21,0,0,0,0,0,0,False,False,False,0,2,2022-01-09T18:18:59.547,0,False,0.0
2021,18,3329,830,24,4382,2,32,9,2,2,0,2,0,2,0,False,False,False,0,3,2022-01-09T18:24:36.16,2,False,0.0
2021,18,3329,835,24,8513,2,5,3,7,9,2,8,1,8,0,False,False,False,0,3,2022-01-09T18:26:18.687,9,False,1.0
2021,18,3329,855,24,7800,2,50,5,-1,36,37,0,36,0,6,False,False,False,2,2,2022-01-12T16:59:26.013,36,False,36.0
2021,18,3330,15,5,8408,13,47,5,0,0,0,0,0,0,0,False,False,False,0,4,2022-01-10T10:31:23.767,0,False,0.0
2021,18,3330,20,5,5220,2,5,3,9,20,11,17,3,17,0,False,False,False,0,3,2022-01-12T15:41:29.387,20,False,3.0
2021,18,3330,40,5,5220,3,2,9,6,0,0,0,0,0,0,False,False,False,0,2,2022-01-10T10:41:19.967,0,False,0.0
2021,18,3330,45,5,5220,2,51,5,-5,11,16,11,0,11,0,True,False,False,1,1,2022-01-10T10:43:17.947,11,False,0.0
2021,18,3330,50,5,3477,2,5,5,6,6,0,6,0,6,0,False,False,False,0,2,2022-01-12T15:41:54.117,6,False,0.0
2021,18,3330,60,5,3477,2,13,10,4,7,3,5,2,5,0,False,False,False,0,3,2022-01-10T10:48:02.167,7,False,2.0
2021,18,3330,65,5,566,2,4,10,2,3,1,2,1,2,0,False,False,False,1,1,2022-01-10T10:50:13.647,3,False,1.0
2021,18,3330,80,5,8409,2,51,3,-2,2,4,2,0,2,6,False,False,False,0,1,2022-01-10T10:57:55.643,2,True,0.0
2021,18,3330,100,30,63,13,17,1,20,0,0,0,0,0,0,False,False,False,0,4,2022-01-10T11:05:36.093,0,False,0.0
2021,18,3330,105,30,7893,2,26,9,4,5,1,5,0,5,0,False,False,False,0,3,2022-01-10T11:07:07.953,5,False,0.0
2021,18,3330,120,5,3477,13,17,8,21,0,0,0,0,0,0,False,False,False,0,3,2022-01-10T11:11:37.19,0,False,0.0
2021,18,3330,125,5,5220,2,52,9,4,19,15,17,2,17,0,False,False,False,0,3,2022-01-10T11:15:03.737,19,False,2.0
2021,18,3330,140,5,8832,2,4,4,8,8,0,8,0,8,0,False,False,False,0,3,2022-01-12T15:42:43.107,8,False,0.0
2021,18,3330,160,5,8832,2,4,9,3,3,0,3,0,3,0,False,False,False,0,3,2022-01-10T11:27:30.16,3,False,0.0
2021,18,3330,170,5,5220,13,19,6,32,0,0,0,0,0,0,False,False,False,0,2,2022-01-10T11:29:54.273,0,False,0.0
2021,18,3330,195,30,2290,2,4,10,1,5,4,4,1,4,0,False,False,False,0,1,2022-01-12T15:22:57.617,5,False,1.0
2021,18,3330,200,30,7893,2,2,9,3,3,0,3,0,3,0,False,False,False,0,2,2022-01-10T11:40:45.297,3,False,0.0
2021,18,3330,205,30,793,2,13,9,4,14,10,13,1,13,0,False,False,False,1,3,2022-01-10T11:43:48.097,14,False,1.0
2021,18,3330,210,30,63,13,7,6,16,0,0,0,0,0,0,False,False,False,0,4,2022-01-10T11:45:47.9,0,False,0.0
2021,18,3330,215,30,2290,2,5,3,5,7,2,7,0,7,0,False,False,False,0,4,2022-01-10T11:47:33.597,7,False,0.0
2021,18,3330,220,30,793,13,26,3,5,0,0,0,0,0,0,False,False,False,0,2,2022-01-10T11:49:16.907,0,False,0.0
2021,18,3330,250,5,3477,2,51,3,-3,-2,1,-2,0,-2,0,False,False,False,0,2,2022-01-12T16:22:48.337,-2,False,0.0
2021,18,3330,255,5,6372,13,29,2,18,0,0,0,0,0,0,False,False,False,0,3,2022-01-10T12:01:04.243,0,False,0.0
2021,18,3330,260,5,566,2,48,10,-4,18,22,14,4,14,0,False,False,False,0,1,2022-01-10T12:02:42.2,18,False,4.0
2021,18,3330,280,5,566,2,47,10,-1,9,10,7,2,7,0,False,False,False,0,1,2022-01-10T12:10:24.867,9,False,2.0
2021,18,3330,285,5,8408,2,55,4,1,1,0,1,0,1,0,False,False,False,0,4,2022-01-10T12:26:44.143,1,False,0.0
2021,18,3330,305,30,63,13,13,10,4,0,0,0,0,0,0,False,False,False,0,3,2022-01-10T12:21:21.673,0,False,0.0
2021,18,3330,315,5,566,2,48,10,-6,9,15,7,2,7,0,False,False,False,0,1,2022-01-10T12:23:52.34,9,False,
2021,18,3330,320,5,3477,2,2,10,8,13,5,13,0,13,0,False,False,False,0,2,2022-01-12T15:39:58.37,13,False,0.0
2021,18,3330,335,5,566,13,11,2,23,0,0,0,0,0,0,False,False,False,0,1,2022-01-10T12:30:59.63,0,False,0.0
2021,18,3330,345,30,7893,2,47,10,-1,0,1,-1,1,-1,0,False,False,False,0,3,2022-01-10T12:33:43.46,0,False,1.0
2021,18,3330,350,30,7893,13,42,10,4,0,0,0,0,0,0,False,False,False,0,3,2022-01-10T12:35:24.54,0,False,0.0
2021,18,3330,355,30,793,2,2,10,11,37,26,17,20,17,0,False,False,False,2,3,2022-01-12T16:14:19.947,37,False,20.0
2021,18,3330,365,30,63,2,39,4,5,7,2,7,0,7,0,False,False,False,0,3,2022-01-10T12:39:31.003,7,False,0.0
2021,18,3330,370,30,63,2,17,10,13,20,7,13,7,13,0,False,False,False,2,3,2022-01-10T12:41:04.507,20,False,7.0
2021,18,3330,380,30,256,2,29,2,24,24,0,24,0,24,0,False,False,False,0,2,2022-01-10T12:43:41.5,24,True,0.0
2021,18,3330,390,30,34,2,47,5,0,1,1,1,0,1,6,False,False,False,0,1,2022-01-10T12:46:49.383,1,True,0.0
2021,18,3330,425,30,63,2,17,1,20,42,22,34,8,34,0,False,False,False,1,4,2022-01-12T16:15:18.41,42,False,8.0
2021,18,3330,430,30,63,2,8,1,17,19,2,18,1,18,0,False,False,False,0,4,2022-01-10T13:08:07.477,19,False,1.0
2021,18,3330,435,30,256,2,50,10,-1,0,1,0,0,0,0,False,False,False,0,2,2022-01-10T13:07:55.363,0,False,0.0
2021,18,3330,445,30,7893,2,13,9,4,7,3,5,2,5,0,False,False,False,0,3,2022-01-10T13:11:05.58,7,False,2.0
2021,18,3330,470,5,8408,13,29,3,12,0,0,0,0,0,0,False,False,False,0,4,2022-01-12T15:22:57.617,0,False,0.0
2021,18,3330,475,5,566,13,51,10,-5,0,0,0,0,0,0,False,False,False,0,1,2022-01-10T13:18:56.047,0,False,0.0
2021,18,3330,485,30,793,2,4,5,4,5,1,4,1,4,0,False,False,False,0,2,2022-01-10T13:23:06.433,5,False,1.0
2021,18,3330,495,30,2290,3,5,5,4,0,0,0,0,0,0,True,False,False,0,3,2022-01-10T13:26:23.717,0,False,0.0
2021,18,3330,505,5,5220,2,5,5,5,5,0,5,0,5,0,True,False,False,0,3,2022-01-10T13:28:42.537,5,True,0.0
2021,18,3330,510,5,3477,2,51,3,-3,1,4,1,0,1,0,False,False,False,0,2,2022-01-12T16:32:13.137,1,False,0.0
2021,18,3330,515,5,8409,2,46,3,0,6,6,6,0,6,0,False,False,False,0,1,2022-01-10T13:32:24.917,6,False,0.0
2021,18,3330,525,5,5220,2,6,1,15,17,2,17,0,17,0,False,False,False,0,3,2022-01-10T13:36:20.44,17,False,0.0
2021,18,3330,535,5,8408,2,47,5,2,6,4,5,1,5,0,False,False,False,1,3,2022-01-12T16:12:36.813,6,False,1.0
2021,18,3330,555,30,793,2,4,10,10,10,0,10,0,10,0,False,False,False,0,2,2022-01-10T13:46:44.673,10,False,0.0
2021,18,3330,560,30,256,2,18,3,0,4,4,4,0,4,0,False,False,False,0,2,2022-01-10T13:47:11.33,4,False,0.0
2021,18,3330,565,30,7891,2,46,3,0,7,7,3,4,3,0,False,False,False,0,1,2022-01-10T13:48:59.063,7,False,4.0
2021,18,3330,570,30,256,2,18,5,0,9,9,8,1,8,0,False,False,False,0,2,2022-01-10T13:50:36.347,9,False,1.0
2021,18,3330,590,30,7893,2,4,9,3,7,4,6,1,6,0,False,False,False,1,3,2022-01-10T13:58:48.527,7,False,1.0
2021,18,3330,595,30,63,2,35,3,8,14,6,13,1,13,0,False,False,False,0,4,2022-01-10T14:00:21.4,14,False,1.0
2021,18,3330,600,30,7891,2,46,3,0,5,5,4,1,4,0,False,False,False,0,1,2022-01-10T14:01:34.73,5,False,1.0
2021,18,3330,610,30,793,2,5,5,3,3,0,3,0,3,6,False,False,False,0,2,2022-01-12T16:23:16.52,3,True,0.0
2021,18,3330,625,5,5220,2,2,9,6,9,3,9,0,9,0,False,False,False,0,2,2022-01-10T14:12:45.847,9,False,0.0
2021,18,3330,635,5,566,2,4,3,1,5,4,4,1,4,0,False,False,False,0,1,2022-01-10T14:15:15.81,5,False,1.0
2021,18,3330,640,5,566,2,48,9,-5,15,20,15,0,15,0,False,False,False,0,1,2022-01-10T14:18:07.433,15,False,0.0
2021,18,3330,650,5,5220,2,12,5,6,6,0,6,0,6,0,False,False,False,0,3,2022-01-12T15:44:56.52,6,True,0.0
2021,18,3330,655,5,5220,13,35,2,19,0,0,0,0,0,0,False,False,False,0,3,2022-01-12T15:22:57.617,0,False,0.0
2021,18,3330,660,5,3477,2,9,6,19,19,0,19,0,19,6,False,False,False,0,3,2022-01-12T15:46:35.4,19,True,0.0
2021,18,3330,675,30,63,2,8,4,11,28,17,12,16,12,0,False,False,False,1,4,2022-01-10T14:36:36.867,28,False,16.0
2021,18,3330,685,30,256,2,18,5,-2,7,9,1,6,1,0,False,False,False,2,2,2022-01-12T15:47:01.173,7,False,6.0
2021,18,3330,690,30,7268,2,2,10,9,9,0,9,0,9,0,False,False,False,0,2,2022-01-10T14:46:44.327,9,False,0.0
2021,18,3330,700,30,793,2,9,6,20,20,0,20,0,20,6,False,False,False,0,2,2022-01-10T14:50:26.517,20,True,0.0
2021,18,3330,715,5,566,2,32,5,-2,4,6,1,3,1,0,False,False,False,0,1,2022-01-10T14:57:33.323,4,False,3.0
2021,18,3330,730,30,63,2,46,3,0,7,7,5,2,5,0,True,False,False,0,3,2022-01-12T16:26:48.657,7,False,2.0
2021,18,3330,740,30,8307,13,9,6,22,0,0,0,0,0,0,False,False,False,0,3,2022-01-10T15:06:11.477,0,False,0.0
2021,18,3330,755,5,566,2,28,10,-6,3,9,0,3,0,0,False,False,False,1,1,2022-01-10T15:11:20.65,3,False,3.0
2021,18,3330,760,5,6562,3,2,9,6,0,0,0,0,0,0,False,False,False,0,3,2022-01-10T15:13:35.76,0,False,0.0
2021,18,3330,770,5,3477,2,39,4,5,6,1,6,0,6,0,False,False,False,0,3,2022-01-10T15:17:30.843,6,False,0.0
2021,18,3330,790,5,3477,13,8,8,30,0,0,0,0,0,0,False,False,False,0,3,2022-01-10T15:26:47.443,0,False,0.0
2021,18,3330,820,30,7893,13,4,9,10,0,0,0,0,0,0,False,False,False,0,3,2022-01-10T15:32:49.72,0,False,0.0
2021,18,3330,830,5,566,2,48,10,-5,-5,0,-5,0,-5,0,False,False,False,0,1,2022-01-10T15:35:23.42,-5,False,0.0
2021,18,3330,835,5,8408,13,8,4,14,0,0,0,0,0,0,False,False,False,0,3,2022-01-11T19:59:49.693,0,False,0.0
2021,18,3330,840,5,566,2,32,5,-1,4,5,4,0,4,0,False,False,False,0,1,2022-01-10T15:39:09.463,4,False,0.0
2021,18,3330,845,5,6372,13,19,7,40,0,0,0,0,0,0,False,False,False,0,2,2022-01-10T15:40:43.303,0,False,0.0
2021,18,3331,10,27,7408,13,4,6,20,0,0,0,0,0,0,False,False,False,0,3,2022-02-25T16:22:01.013,0,False,0.0
2021,18,3331,45,27,7849,2,30,3,-2,2,4,0,2,0,0,False,False,False,0,4,2022-01-10T10:59:29.183,2,False,2.0
2021,18,3331,50,27,650,2,7,2,30,43,13,42,1,42,6,False,False,False,0,3,2022-01-10T11:02:23.257,43,False,1.0
2021,18,3331,70,1,4587,2,44,5,-4,1,5,-1,2,-1,0,False,False,False,0,1,2022-01-12T19:32:24.667,1,False,2.0
2021,18,3331,80,1,910,13,19,2,28,0,0,0,0,0,0,False,False,False,0,3,2022-01-12T00:57:27.577,0,False,0.0
2021,18,3331,100,27,7408,2,2,4,5,9,4,8,1,8,0,True,False,False,0,3,2022-01-11T22:46:37.35,9,False,1.0
2021,18,3331,110,27,7408,2,2,9,7,7,0,7,0,7,0,False,False,False,0,2,2022-01-10T11:29:22.633,7,False,0.0
2021,18,3331,120,27,7404,3,12,5,6,0,0,0,0,0,0,True,False,False,0,1,2022-02-24T20:18:13.2,0,False,0.0
2021,18,3331,135,1,4587,2,44,3,-5,0,5,-1,1,-1,0,False,False,False,0,1,2022-01-10T11:45:27.457,0,False,1.0
2021,18,3331,140,1,910,2,9,2,23,26,3,25,1,25,0,False,False,False,0,3,2022-01-10T11:52:20.473,26,False,
2021,18,3331,145,1,894,2,4,4,13,13,0,13,0,13,0,False,False,False,0,3,2022-01-10T11:52:06.29,13,False,0.0
2021,18,3331,165,1,910,2,4,5,5,5,0,5,0,5,0,False,False,False,0,2,2022-01-10T12:04:48.347,5,False,0.0
2021,18,3331,175,1,4587,2,4,10,3,7,4,6,1,6,0,False,False,False,0,1,2022-01-10T12:10:13.523,7,False,1.0
2021,18,3331,180,1,894,2,13,5,4,4,0,4,0,4,0,False,False,False,0,4,2022-01-10T12:13:30.227,4,False,0.0
2021,18,3331,185,1,7782,2,44,9,-5,2,7,-1,3,-1,0,False,False,False,0,1,2022-01-12T00:57:41.163,2,False,3.0
2021,18,3331,195,1,6933,13,2,9,4,0,0,0,0,0,0,False,False,False,0,2,2022-01-12T19:39:23.083,0,False,0.0
2021,18,3331,225,1,7103,2,34,4,-4,4,8,2,2,2,0,True,False,False,0,3,2022-01-12T00:55:53.267,4,False,2.0
2021,18,3331,230,1,4587,2,48,9,-3,5,8,5,0,5,0,False,False,False,0,1,2022-01-10T12:33:28.543,5,False,0.0
2021,18,3331,255,27,4850,13,31,4,0,0,0,0,0,0,0,False,False,False,0,4,2022-01-10T12:42:45.113,0,False,0.0
2021,18,3331,260,27,7404,2,12,5,6,23,17,20,3,20,0,True,False,False,0,1,2022-02-24T20:18:28.603,23,False,3.0
2021,18,3331,275,27,7408,2,35,8,27,31,4,29,2,29,0,False,False,False,0,3,2022-01-10T13:00:25.967,31,False,2.0
2021,18,3331,285,27,7849,3,17,8,17,0,0,0,0,0,0,False,False,False,0,4,2022-01-10T18:21:20.673,0,False,0.0
2021,18,3331,290,27,7849,2,12,5,10,12,2,10,2,10,0,False,False,False,0,3,2022-02-24T20:18:39.783,12,False,2.0
2021,18,3331,295,27,650,2,3,5,5,5,0,5,0,5,6,False,False,False,0,2,2022-01-10T13:09:05.067,5,True,0.0
2021,18,3331,310,1,910,2,4,8,17,31,14,25,6,25,0,False,False,False,2,3,2022-01-12T19:53:06.55,31,False,
2021,18,3331,320,1,6933,2,4,9,4,8,4,7,1,7,0,False,False,False,0,3,2022-01-10T13:22:47.747,8,False,1.0
2021,18,3331,330,1,7103,2,45,10,-8,1,9,-3,4,-3,0,True,False,False,0,3,2022-01-12T19:36:38.847,1,False,4.0
2021,18,3331,340,1,6933,13,4,3,27,0,0,0,0,0,0,False,False,False,0,2,2022-02-25T16:22:22.913,0,False,0.0
2021,18,3331,350,1,894,13,12,2,35,0,0,0,0,0,0,False,False,False,0,2,2022-01-12T00:55:22.557,0,False,0.0
2021,18,3331,365,27,650,2,12,2,22,22,0,22,0,22,0,False,False,False,0,3,2022-01-10T13:46:25.403,22,False,0.0
2021,18,3331,385,27,7408,13,50,5,1,0,0,0,0,0,0,False,False,False,0,2,2022-01-11T22:42:54.46,0,False,0.0
2021,18,3331,400,27,7408,2,13,10,1,12,11,12,0,12,0,False,False,False,0,3,2022-01-10T13:57:34.66,12,True,
2021,18,3331,405,27,650,2,5,3,8,17,9,16,1,16,0,True,False,False,0,3,2022-01-11T22:47:38.3,17,False,1.0
2021,18,3331,415,27,7408,13,5,3,9,0,0,0,0,0,0,False,False,False,0,2,2022-01-10T14:05:06.187,0,False,0.0
2021,18,3331,420,27,4850,3,9,7,19,0,0,0,0,0,0,False,False,False,0,3,2022-01-10T14:06:35.53,0,False,0.0
2021,18,3331,440,1,6405,2,12,4,8,8,0,8,0,8,0,False,False,False,0,3,2022-01-10T14:13:46.477,8,False,0.0
2021,18,3331,450,1,894,2,4,9,13,13,0,13,0,13,0,False,False,False,0,3,2022-01-10T14:15:52.11,13,False,0.0
2021,18,3331,480,1,6933,2,4,9,3,9,6,6,3,6,0,False,False,False,1,2,2022-01-12T19:36:53.223,9,False,3.0
2021,18,3331,485,1,4587,2,32,9,-4,8,12,5,3,5,0,False,False,False,0,1,2022-01-10T14:26:26.837,8,False,3.0
2021,18,3331,490,1,6405,2,8,7,33,35,2,33,2,33,0,False,False,False,0,3,2022-01-12T18:57:16.61,35,False,2.0
2021,18,3331,495,1,894,2,53,9,-4,14,18,2,12,2,0,False,False,False,1,4,2022-01-12T19:37:11.037,14,False,12.0
2021,18,3331,505,1,4587,2,46,3,3,20,17,3,17,3,6,False,False,False,2,3,2022-01-12T18:57:16.61,20,False,17.0
2021,18,3331,525,27,7408,13,35,8,21,0,0,0,0,0,0,False,False,False,0,3,2022-01-12T19:48:31.613,0,False,0.0
2021,18,3331,530,27,7404,13,32,10,6,0,0,0,0,0,0,True,False,False,0,1,2022-01-12T19:40:30.703,0,False,0.0
2021,18,3331,565,27,4850,2,46,3,7,20,13,9,11,9,0,False,False,False,1,3,2022-01-12T19:37:24.577,20,False,11.0
2021,18,3331,580,27,7408,13,19,6,43,0,0,0,0,0,0,False,False,False,0,2,2022-01-10T15:14:41.77,0,False,0.0
2021,18,3331,600,1,910,13,4,5,6,0,0,0,0,0,0,False,False,False,0,2,2022-01-10T15:21:25.947,0,False,0.0
2021,18,3331,610,27,7408,2,4,3,4,9,5,8,1,8,0,False,False,False,0,2,2022-01-12T19:50:44.73,9,False,1.0
2021,18,3331,620,27,7408,2,51,5,-5,2,7,1,1,1,0,True,False,False,0,4,2022-01-11T22:48:53.02,2,False,1.0
2021,18,3331,630,27,7852,2,21,6,19,25,6,25,0,25,6,False,False,False,0,2,2022-01-10T15:36:38.94,25,True,0.0
2021,18,3331,715,1,894,2,5,8,18,19,1,18,1,18,0,False,False,False,0,3,2022-01-10T16:39:51.27,19,False,1.0
2021,18,3331,720,1,7762,2,47,5,-3,10,13,4,6,4,0,False,False,False,1,1,2022-01-10T16:42:20.813,10,False,6.0
2021,18,3331,735,1,894,2,39,4,6,6,0,6,0,6,0,False,False,False,0,4,2022-01-12T19:44:50.183,6,False,0.0
2021,18,3331,750,1,6405,13,20,3,12,0,0,0,0,0,0,False,False,False,0,2,2022-01-12T00:55:36.297,0,False,0.0
2021,18,3331,755,1,894,13,5,5,12,0,0,0,0,0,0,False,False,False,0,3,2022-01-12T19:35:21.967,0,False,0.0
2021,18,3331,770,27,650,2,5,5,11,11,0,11,0,11,0,False,False,False,0,2,2022-02-22T21:04:44.087,11,False,0.0
2021,18,3331,795,1,910,13,8,10,12,0,0,0,0,0,0,False,False,False,0,2,2022-02-22T21:47:35.467,0,False,0.0
2021,18,3331,800,1,910,2,4,10,5,9,4,9,0,9,0,False,False,False,0,2,2022-01-10T17:21:53.737,9,False,0.0
2021,18,3331,810,1,7762,2,4,10,2,9,7,7,2,7,0,False,False,False,1,1,2022-01-12T01:01:16.027,9,False,2.0
2021,18,3331,815,1,910,3,12,5,13,0,0,0,0,0,0,False,False,False,0,3,2022-01-10T17:28:11.063,0,False,0.0
2021,18,3331,825,1,894,2,6,4,14,15,1,15,0,15,0,False,False,False,0,3,2022-01-10T17:33:05.17,15,False,0.0
2021,18,3331,830,1,7762,2,48,3,-4,-4,0,-4,0,-4,0,False,False,False,0,1,2022-01-10T17:35:00.723,-4,False,0.0
2021,18,3331,835,1,910,2,6,10,6,9,3,8,1,8,0,False,False,False,1,2,2022-01-10T17:37:11.693,9,False,1.0
2021,18,3331,845,1,7762,2,12,5,2,10,8,3,7,3,0,False,False,False,1,1,2022-02-24T20:19:04.26,10,False,7.0
2021,18,3331,850,1,910,2,18,5,0,0,0,0,0,0,0,False,False,False,0,2,2022-01-10T17:41:59.36,0,False,0.0
2021,18,3331,860,1,910,13,12,5,8,0,0,0,0,0,0,False,False,False,0,3,2022-01-10T17:45:17.99,0,False,0.0
2021,18,3331,865,1,894,13,39,4,8,0,0,0,0,0,0,False,False,False,0,3,2022-01-10T18:27:07.437,0,False,
2021,18,3331,870,1,894,13,17,7,18,0,0,0,0,0,0,False,False,False,0,3,2022-01-10T17:49:27.173,0,False,0.0
2021,18,3332,10,10,282,13,30,10,-1,0,0,0,0,0,0,False,False,False,0,1,2022-01-09T13:48:55.22,0,False,0.0
2021,18,3332,20,10,7700,13,19,2,29,0,0,0,0,0,0,False,False,False,0,2,2022-01-09T13:51:30.393,0,False,0.0
2021,18,3332,35,16,7176,2,50,10,-2,3,5,3,0,3,0,False,False,False,0,3,2022-01-09T13:54:52.223,3,False,0.0
2021,18,3332,50,16,7176,2,49,3,-3,21,24,10,11,10,0,False,False,False,0,3,2022-01-09T13:59:56.35,21,False,11.0
2021,18,3332,60,16,6500,2,6,4,11,11,0,11,0,11,0,False,False,False,0,3,2022-01-09T14:02:33.203,11,False,0.0
2021,18,3332,65,16,6500,13,4,10,12,0,0,0,0,0,0,False,False,False,0,3,2022-01-09T14:04:14.51,0,False,0.0
2021,18,3332,75,16,4143,2,4,10,4,4,0,4,0,4,0,False,False,False,0,2,2022-01-09T14:06:29.477,4,False,0.0
2021,18,3332,85,16,4143,13,22,8,30,0,0,0,0,0,0,False,False,False,0,2,2022-01-12T21:10:08.307,0,False,0.0
2021,18,3332,90,16,374,2,26,10,4,9,5,6,3,6,0,True,False,False,0,3,2022-01-09T14:11:01.487,9,False,3.0
2021,18,3332,105,16,6500,13,4,10,5,0,0,0,0,0,0,False,False,False,0,4,2022-01-12T20:58:55.92,0,False,0.0
2021,18,3332,110,16,7176,2,5,9,3,4,1,4,0,4,0,True,False,False,0,3,2022-01-09T14:20:34.297,4,False,0.0
2021,18,3332,115,16,374,2,38,3,3,3,0,3,0,3,6,False,False,False,0,4,2022-01-09T17:28:27.277,3,True,0.0
2021,18,3332,135,10,7700,13,8,2,41,0,0,0,0,0,0,False,False,False,0,3,2022-01-09T14:27:11.36,0,False,0.0
2021,18,3332,140,10,6281,13,9,3,10,0,0,0,0,0,0,False,False,False,0,2,2022-01-09T14:29:06.787,0,False,0.0
2021,18,3332,170,10,7700,13,21,2,21,0,0,0,0,0,0,False,False,False,0,3,2022-02-17T17:01:59.74,0,False,0.0
2021,18,3332,175,10,4930,2,5,3,4,6,2,6,0,6,0,True,False,False,0,3,2022-01-09T14:41:53.713,6,False,0.0
2021,18,3332,180,10,6840,2,17,1,16,16,0,16,0,16,0,False,False,False,0,4,2022-02-17T17:04:09.727,16,False,0.0
2021,18,3332,205,16,7176,2,44,3,-3,3,6,3,0,3,0,True,False,False,0,3,2022-01-09T14:48:08.77,3,False,0.0
2021,18,3332,220,16,6499,2,47,10,2,11,9,7,4,7,0,False,False,False,1,1,2022-01-09T14:51:53.83,11,False,4.0
2021,18,3332,230,16,374,13,5,3,6,0,0,0,0,0,0,False,False,False,0,4,2022-01-09T14:55:38.17,0,False,0.0
2021,18,3332,265,10,4930,2,4,9,11,11,0,11,0,11,0,False,False,False,0,2,2022-01-09T15:03:52.223,11,False,0.0
2021,18,3332,300,16,4143,2,4,9,7,11,4,9,2,9,0,False,False,False,0,2,2022-01-12T20:19:58.927,11,False,2.0
2021,18,3332,310,16,6500,2,2,10,6,10,4,8,2,8,0,False,False,False,0,2,2022-01-09T15:13:05.873,10,False,2.0
2021,18,3332,320,16,7176,13,4,10,11,0,0,0,0,0,0,False,False,False,0,2,2022-01-09T15:15:58.267,0,False,0.0
2021,18,3332,325,16,6500,2,12,10,10,11,1,10,1,10,0,False,False,False,0,3,2022-01-09T15:18:27.91,11,False,1.0
2021,18,3332,335,16,3938,13,17,9,12,0,0,0,0,0,0,False,False,False,0,3,2022-01-09T17:35:43.75,0,False,0.0
2021,18,3332,340,16,374,13,6,9,10,0,0,0,0,0,0,False,False,False,0,3,2022-01-12T21:04:08.273,0,False,
2021,18,3332,345,16,7176,13,35,3,6,0,0,0,0,0,0,False,False,False,0,3,2022-01-09T15:24:12.213,0,False,0.0
2021,18,3332,355,16,6499,13,11,3,13,0,0,0,0,0,0,False,False,False,0,1,2022-01-09T15:27:32.183,0,False,0.0
2021,18,3332,360,16,3938,13,12,2,16,0,0,0,0,0,0,False,False,False,0,3,2022-02-25T16:23:25.607,0,False,0.0
2021,18,3332,385,10,4930,2,4,10,3,8,5,4,4,4,0,True,False,False,1,3,2022-01-09T15:38:18.567,8,False,4.0
2021,18,3332,395,10,7700,2,13,10,2,2,0,2,0,2,0,False,False,False,0,3,2022-01-09T15:40:33.487,2,False,0.0
2021,18,3332,410,10,6281,13,2,9,5,0,0,0,0,0,0,False,False,False,0,2,2022-01-09T15:43:00.81,0,False,0.0
2021,18,3332,420,16,6499,2,44,3,-4,2,6,1,1,1,0,False,False,False,0,1,2022-01-09T15:44:46.047,2,False,1.0
2021,18,3332,425,16,7176,2,4,10,11,11,0,11,0,11,0,False,False,False,0,2,2022-01-12T20:20:53.297,11,False,0.0
2021,18,3332,445,16,6499,2,48,9,0,17,17,15,2,15,0,False,False,False,1,1,2022-01-09T15:50:57.017,17,False,2.0
2021,18,3332,465,16,374,2,5,3,6,10,4,10,0,10,0,True,False,False,0,3,2022-01-09T15:54:16.92,10,False,0.0
2021,18,3332,485,16,7176,2,4,10,3,7,4,6,1,6,0,False,False,False,0,3,2022-01-09T15:58:10.32,7,False,1.0
2021,18,3332,495,16,7417,13,48,10,-4,0,0,0,0,0,0,False,False,False,0,1,2022-02-17T17:05:08.087,0,False,0.0
2021,18,3332,500,16,797,2,44,3,-5,14,19,13,1,13,6,False,False,False,2,1,2022-01-09T17:29:03.503,14,False,1.0
2021,18,3332,520,10,4930,13,4,10,3,0,0,0,0,0,0,True,False,False,0,3,2022-01-09T16:05:23.19,0,False,0.0
2021,18,3332,525,10,4930,2,19,2,26,31,5,31,0,31,0,False,False,False,0,2,2022-01-09T16:06:29.317,31,False,0.0
2021,18,3332,555,16,6500,13,12,10,14,0,0,0,0,0,0,False,False,False,0,3,2022-01-09T16:14:25.417,0,False,0.0
2021,18,3332,560,16,6500,2,26,10,1,5,4,5,0,5,0,False,False,False,0,2,2022-01-09T16:15:28.757,5,False,0.0
2021,18,3332,570,16,7176,2,51,9,-2,10,12,6,4,6,0,True,False,False,0,4,2022-01-09T16:18:48.007,10,False,4.0
2021,18,3332,580,16,797,2,45,5,-4,4,8,4,0,4,0,False,False,False,0,1,2022-01-09T16:20:49.607,4,False,0.0
2021,18,3332,585,16,1989,13,5,2,15,0,0,0,0,0,0,False,False,False,0,3,2022-01-09T16:22:06.93,0,False,0.0
2021,18,3332,605,10,4930,3,6,10,5,0,0,0,0,0,0,True,False,False,0,3,2022-01-10T15:33:58.877,0,False,0.0
2021,18,3332,610,10,8541,2,48,9,-3,11,14,9,2,9,0,False,False,False,0,1,2022-01-09T16:27:06.78,11,False,2.0
2021,18,3332,625,16,374,2,53,9,-2,12,14,5,7,5,0,False,False,False,1,3,2022-01-12T21:03:11.823,12,False,
2021,18,3332,635,16,6500,2,42,3,9,19,10,19,0,19,0,False,False,False,0,3,2022-01-12T20:19:58.927,19,False,0.0
2021,18,3332,640,16,3938,2,47,5,2,2,0,2,0,2,0,False,False,False,0,3,2022-01-11T02:11:51.437,2,False,0.0
2021,18,3332,650,16,4143,2,4,10,4,4,0,4,0,4,0,False,False,False,0,2,2022-01-09T16:42:26.27,4,False,0.0
2021,18,3332,665,16,4143,13,12,10,4,0,0,0,0,0,0,False,False,False,0,2,2022-01-09T16:44:56.33,0,False,0.0
2021,18,3332,670,16,4143,13,6,8,15,0,0,0,0,0,0,False,False,False,0,2,2022-01-09T16:46:10.937,0,False,0.0
2021,18,3332,695,10,282,2,45,5,-4,6,10,6,0,6,0,False,False,False,0,1,2022-01-09T16:50:19.77,6,False,0.0
2021,18,3332,705,10,6281,2,46,3,2,13,11,13,0,13,0,True,False,False,0,2,2022-01-09T16:52:57.647,13,False,0.0
2021,18,3332,715,10,8541,2,45,10,-6,7,13,5,2,5,0,False,False,False,0,1,2022-01-09T16:54:29.657,7,False,2.0
2021,18,3332,725,10,4930,2,5,5,4,10,6,7,3,7,0,True,False,False,0,3,2022-01-09T16:56:07.757,10,False,3.0
2021,18,3332,755,10,4930,2,9,5,14,29,15,29,0,29,0,False,False,False,1,3,2022-01-09T17:05:41.15,29,False,0.0
2021,18,3332,760,10,4930,13,7,6,36,0,0,0,0,0,0,False,False,False,0,2,2022-01-09T17:06:59.503,0,False,0.0
2021,18,3332,770,10,7700,2,9,6,26,28,2,26,2,26,0,False,False,False,0,2,2022-01-09T17:09:21.263,28,False,2.0
2021,18,3332,780,10,4930,13,8,9,13,0,0,0,0,0,0,True,False,False,0,3,2022-01-09T17:11:31.32,0,False,0.0
2021,18,3332,785,10,6840,13,29,3,12,0,0,0,0,0,0,False,False,False,0,3,2022-01-09T17:12:49.68,0,False,0.0
2021,18,3332,800,16,7176,2,51,9,-3,44,47,40,4,40,0,True,False,False,0,4,2022-01-09T17:15:00.037,44,False,4.0
2021,18,3332,815,16,797,2,51,5,-6,8,14,5,3,5,0,True,False,False,1,1,2022-01-09T17:17:37.25,8,False,3.0
2021,18,3332,845,16,374,2,35,10,11,12,1,12,0,12,0,True,False,False,0,3,2022-01-09T17:21:40.953,12,False,0.0
2021,18,3333,25,29,1067,2,4,9,13,13,0,13,0,13,0,False,False,False,0,3,2022-01-10T13:28:44.61,13,False,0.0
2021,18,3333,30,29,7788,2,47,10,-1,2,3,2,0,2,0,False,False,False,0,1,2022-01-10T13:34:06.21,2,False,0.0
2021,18,3333,40,29,4866,2,7,8,25,46,21,40,6,40,0,False,False,False,1,3,2022-01-12T17:23:01.543,46,False,6.0
2021,18,3333,50,29,3398,2,53,9,-3,8,11,7,1,7,0,False,False,False,0,4,2022-01-10T13:43:26.82,8,False,1.0
2021,18,3333,95,28,4922,2,6,9,3,4,1,4,0,4,0,True,False,False,0,4,2022-01-10T13:57:23.783,4,False,0.0
2021,18,3333,100,28,6410,2,6,4,7,13,6,12,1,12,0,False,False,False,0,3,2022-01-10T13:59:03.543,13,False,1.0
2021,18,3333,120,28,7751,13,11,2,20,0,0,0,0,0,0,False,False,False,0,1,2022-01-10T14:06:37.567,0,False,0.0
2021,18,3333,130,29,6266,2,47,10,1,6,5,6,0,6,0,False,False,False,1,1,2022-01-12T17:10:14.343,6,False,0.0
2021,18,3333,140,29,4866,2,4,9,5,7,2,7,0,7,0,False,False,False,0,3,2022-01-10T14:14:13.613,7,False,0.0
2021,18,3333,155,29,4866,2,6,9,14,16,2,16,0,16,0,False,False,False,0,3,2022-01-10T14:24:39.87,16,False,0.0
2021,18,3333,165,29,3398,2,2,10,7,9,2,7,2,7,0,True,False,False,0,4,2022-01-10T14:27:51.017,9,False,2.0
2021,18,3333,170,29,7828,2,13,10,4,7,3,5,2,5,0,False,False,False,0,2,2022-01-10T14:33:28.343,7,False,2.0
2021,18,3333,180,29,8455,13,12,5,0,0,0,0,0,0,0,True,False,False,0,4,2022-02-17T18:25:38.707,0,False,0.0
2021,18,3333,185,29,4866,2,5,5,3,7,4,5,2,5,0,False,False,False,0,3,2022-01-10T14:48:49.277,7,False,2.0
2021,18,3333,195,29,3398,2,33,10,2,2,0,2,0,2,6,False,False,False,0,4,2022-01-10T14:51:30.987,2,True,0.0
2021,18,3333,235,29,7788,2,4,9,2,2,0,2,0,2,0,False,False,False,0,1,2022-01-10T15:05:27.207,2,False,0.0
2021,18,3333,240,29,3398,2,29,2,15,15,0,15,0,15,6,False,False,False,0,2,2022-01-10T15:07:20.427,15,True,0.0
2021,18,3333,255,28,4922,2,53,9,-5,-2,3,-5,3,-5,0,False,False,False,1,4,2022-02-17T18:26:35.053,-2,False,3.0
2021,18,3333,260,28,7224,2,6,10,4,6,2,5,1,5,0,False,False,False,0,3,2022-01-10T15:13:57.87,6,False,1.0
2021,18,3333,265,28,7753,2,2,9,6,8,2,6,2,6,0,False,False,False,1,3,2022-01-12T17:30:22.523,8,False,2.0
2021,18,3333,275,28,408,13,8,7,29,0,0,0,0,0,0,False,False,False,0,3,2022-01-10T15:21:49.44,0,False,0.0
2021,18,3333,285,29,4866,2,5,3,4,8,4,8,0,8,0,False,False,False,0,2,2022-02-22T22:53:23.66,8,False,0.0
2021,18,3333,290,29,1067,2,2,9,3,5,2,5,0,5,0,False,False,False,0,2,2022-01-10T15:26:58.29,5,False,0.0
2021,18,3333,325,28,7619,2,8,9,14,19,5,14,5,14,0,False,False,False,0,2,2022-01-10T15:32:44.337,19,False,5.0
2021,18,3333,335,28,7619,2,50,3,-2,-2,0,-2,0,-2,0,False,False,False,0,2,2022-01-10T15:34:02.147,0,False,0.0
2021,18,3333,340,28,7751,2,32,10,-1,8,9,7,1,7,0,False,False,False,1,3,2022-01-10T15:37:14.333,8,False,1.0
2021,18,3333,350,28,7619,2,6,7,17,26,9,20,6,20,0,False,False,False,0,2,2022-01-10T15:39:07.153,26,False,6.0
2021,18,3333,385,28,7751,2,16,10,2,13,11,3,10,3,0,False,False,False,1,1,2022-01-10T15:53:54.093,13,False,10.0
2021,18,3333,390,28,7619,2,4,6,18,31,13,29,2,29,0,False,False,False,0,3,2022-01-10T15:56:01.493,31,False,2.0
2021,18,3333,400,28,4922,2,13,4,2,6,4,6,0,6,0,False,False,False,0,4,2022-01-10T16:05:58.457,6,False,0.0
2021,18,3333,430,29,7828,13,4,10,5,0,0,0,0,0,0,False,False,False,0,3,2022-01-10T16:14:17.04,0,False,0.0
2021,18,3333,490,28,7753,2,21,2,24,24,0,24,0,24,6,False,False,False,0,3,2022-01-10T16:43:30.75,24,True,0.0
2021,18,3333,510,29,6266,13,48,10,-4,0,0,0,0,0,0,False,False,False,0,1,2022-01-10T16:47:02.38,0,False,0.0
2021,18,3333,515,29,8455,13,19,6,49,0,0,0,0,0,0,False,False,False,0,3,2022-01-10T16:50:40.68,0,False,0.0
2021,18,3333,525,28,7619,3,8,7,15,0,0,0,0,0,0,False,False,False,0,3,2022-01-10T18:43:31.42,0,False,0.0
2021,18,3333,530,28,7753,13,5,3,12,0,0,0,0,0,0,False,False,False,0,2,2022-01-10T16:55:53.67,0,False,0.0
2021,18,3333,545,29,6266,13,4,9,1,0,0,0,0,0,0,False,False,False,0,1,2022-01-10T17:00:11.23,0,False,0.0
2021,18,3333,550,29,3398,13,12,5,6,0,0,0,0,0,0,False,False,False,0,4,2022-02-24T20:25:10.793,0,False,0.0
2021,18,3333,555,29,7828,2,8,8,22,24,2,24,0,24,0,False,False,False,0,2,2022-01-10T17:03:20.11,24,False,0.0
2021,18,3333,560,29,6266,13,12,3,0,0,0,0,0,0,0,False,False,False,0,1,2022-01-10T17:05:00.923,0,False,0.0
2021,18,3333,590,28,7224,2,50,3,-1,32,33,14,18,14,0,False,False,False,1,2,2022-01-10T17:13:39.58,32,False,18.0
2021,18,3333,605,28,7619,2,4,9,5,10,5,10,0,10,0,True,False,False,0,3,2022-01-10T17:19:27.57,10,False,0.0
2021,18,3333,620,28,4922,13,17,7,22,0,0,0,0,0,0,True,False,False,0,3,2022-01-12T03:47:59.66,0,False,0.0
2021,18,3333,635,29,7788,2,4,10,6,6,0,6,0,6,0,False,False,False,0,1,2022-01-10T17:32:05.247,6,False,0.0
2021,18,3333,640,29,4866,2,9,6,22,30,8,22,8,22,0,False,False,False,0,3,2022-01-12T17:38:39.28,30,False,8.0
2021,18,3333,665,29,4866,2,7,3,4,4,0,4,0,4,6,False,False,False,0,3,2022-01-10T17:41:48.007,4,True,0.0
2021,18,3333,680,28,4922,2,32,5,0,1,1,0,1,0,0,False,False,False,0,3,2022-01-10T17:45:06.233,1,False,1.0
2021,18,3333,685,28,4922,13,2,10,7,0,0,0,0,0,0,False,False,False,0,3,2022-01-10T17:46:08.707,0,False,0.0
2021,18,3333,740,28,7619,2,6,10,14,21,7,20,1,20,0,False,False,False,1,2,2022-01-10T17:52:52.307,21,False,1.0
2021,18,3333,745,28,7753,2,6,9,5,5,0,5,0,5,0,False,False,False,0,3,2022-01-10T17:54:13.023,5,False,0.0
2021,18,3333,750,28,7224,2,7,2,24,43,19,39,4,39,0,False,False,False,2,2,2022-01-10T17:57:21.453,43,False,4.0
2021,18,3333,765,28,7224,13,6,10,11,0,0,0,0,0,0,False,False,False,0,3,2022-01-10T18:02:44.41,0,False,0.0
2021,18,3333,770,28,7753,2,6,9,11,14,3,14,0,14,6,False,False,False,0,2,2022-01-10T18:05:39.03,14,True,0.0
2021,18,3333,785,29,3398,2,31,10,12,12,0,12,0,12,0,False,False,False,0,4,2022-01-10T18:08:08.587,12,False,0.0
2021,18,3333,810,28,7224,3,2,10,8,0,0,0,0,0,0,False,False,False,0,3,2022-01-10T18:12:30.96,0,False,0.0
2021,18,3333,830,28,7224,2,2,9,6,6,0,6,0,6,0,False,False,False,0,3,2022-01-10T18:17:59.713,6,False,0.0
2021,18,3333,835,28,7753,2,5,5,3,34,31,8,26,8,0,False,False,False,2,3,2022-01-12T17:35:37.04,34,False,26.0
2021,18,3333,860,28,7753,2,5,5,6,9,3,6,3,6,0,False,False,False,0,3,2022-01-10T18:24:45.253,9,False,3.0
2021,18,3333,880,28,4922,2,46,3,1,1,0,1,0,1,0,True,False,False,0,3,2022-01-12T03:48:23.273,1,False,0.0
2021,18,3333,900,29,1067,3,5,3,3,0,0,0,0,0,0,False,False,False,0,3,2022-02-17T18:32:36.257,0,False,0.0
2021,18,3333,905,29,1067,13,4,5,8,0,0,0,0,0,0,False,False,False,0,2,2022-01-10T18:32:59.87,0,False,0.0
2021,18,3333,910,29,4866,13,6,9,12,0,0,0,0,0,0,False,False,False,0,3,2022-01-10T18:41:23.227,0,False,
2021,18,3333,915,29,3398,2,12,5,7,9,2,8,1,8,0,True,False,False,0,3,2022-01-10T18:38:19.5,9,False,1.0
2021,18,3333,930,29,1067,13,19,2,42,0,0,0,0,0,0,False,False,False,0,2,2022-01-10T18:41:02.317,0,False,0.0
2021,18,3334,15,23,7241,2,44,3,-4,8,12,7,1,7,0,False,False,False,0,1,2022-01-10T10:40:56.8,8,False,1.0
2021,18,3334,20,23,2994,13,5,3,6,0,0,0,0,0,0,False,False,False,0,3,2022-01-10T10:45:44.17,0,False,0.0
2021,18,3334,30,23,7246,2,33,4,2,44,42,44,0,44,0,False,True,False,0,3,2022-01-12T15:53:05.02,44,False,0.0
2021,18,3334,35,23,7250,13,26,4,7,0,0,0,0,0,0,False,False,False,0,3,2022-01-10T10:52:51.497,0,False,
2021,18,3334,50,23,4949,13,12,5,6,0,0,0,0,0,0,False,False,False,0,2,2022-01-10T11:00:04.417,0,False,0.0
2021,18,3334,65,26,4619,2,45,5,-1,3,4,1,2,1,0,False,False,False,0,3,2022-01-10T11:04:18.203,3,False,2.0
2021,18,3334,70,26,4616,13,5,5,1,0,0,0,0,0,0,False,False,False,0,1,2022-01-12T15:35:24.827,0,False,0.0
2021,18,3334,75,26,309,2,13,9,4,5,1,5,0,5,0,False,False,False,0,3,2022-01-10T11:10:19.73,5,False,0.0
2021,18,3334,85,23,2994,13,4,5,5,0,0,0,0,0,0,False,False,False,0,2,2022-01-10T11:15:46.323,0,False,0.0
2021,18,3334,100,23,4949,2,30,5,-3,0,3,-1,1,-1,0,True,False,False,0,3,2022-01-12T16:11:21.167,0,False,1.0
2021,18,3334,105,23,4949,13,8,2,39,0,0,0,0,0,0,False,False,False,0,3,2022-01-10T11:25:02.48,0,False,0.0
2021,18,3334,120,23,7241,2,46,3,0,4,4,4,0,4,0,False,False,False,0,1,2022-01-10T11:32:17.947,4,False,0.0
2021,18,3334,130,23,4949,2,13,9,2,2,0,2,0,2,0,True,False,False,0,2,2022-01-12T15:35:41.387,2,False,0.0
2021,18,3334,140,23,7250,2,5,3,12,12,0,12,0,12,6,False,False,False,0,3,2022-01-10T17:35:20.01,12,True,0.0
2021,18,3334,155,26,4616,3,51,9,-5,0,0,0,0,0,0,False,False,False,0,1,2022-01-10T11:51:03.957,0,False,0.0
2021,18,3334,160,26,4619,2,4,10,5,5,0,5,0,5,0,False,False,False,0,3,2022-01-10T11:54:28.557,5,False,0.0
2021,18,3334,165,26,4616,2,12,4,10,14,4,10,4,10,0,False,False,False,0,2,2022-01-10T11:57:18.02,14,False,4.0
2021,18,3334,180,26,6301,3,4,9,3,0,0,0,0,0,0,False,False,False,0,1,2022-01-10T12:03:42.397,0,False,0.0
2021,18,3334,185,26,4619,13,19,6,33,0,0,0,0,0,0,False,False,False,0,2,2022-02-24T13:48:51.263,0,False,
2021,18,3334,195,26,958,2,7,6,16,19,3,19,0,19,0,False,False,False,0,4,2022-01-10T12:09:45.38,19,True,0.0
2021,18,3334,215,26,958,2,39,4,6,6,0,6,0,6,0,False,False,False,0,3,2022-01-12T16:12:52.19,6,False,0.0
2021,18,3334,225,26,8553,13,32,10,2,0,0,0,0,0,0,False,False,False,0,4,2022-01-10T12:22:19.083,0,False,0.0
2021,18,3334,230,26,7453,2,4,9,3,5,2,3,2,3,0,False,False,False,1,2,2022-01-10T12:24:47.833,5,False,2.0
2021,18,3334,255,23,4949,2,39,4,4,7,3,7,0,7,0,False,False,False,0,3,2022-01-11T19:45:25.08,7,False,0.0
2021,18,3334,260,23,3843,13,12,2,24,0,0,0,0,0,0,False,False,False,0,1,2022-01-10T12:33:00.517,0,False,
2021,18,3334,275,23,7689,2,38,4,3,12,9,9,3,9,0,False,False,False,0,3,2022-01-10T12:41:18.313,12,False,3.0
2021,18,3334,290,26,309,2,12,10,10,10,0,10,0,10,0,False,False,False,0,4,2022-01-10T12:47:06.813,10,False,0.0
2021,18,3334,300,26,8552,2,26,10,4,6,2,5,1,5,0,False,False,False,0,3,2022-01-10T12:51:13.557,6,False,1.0
2021,18,3334,305,26,7453,2,46,3,3,6,3,4,2,4,0,True,False,False,0,3,2022-01-10T12:53:06.227,6,False,2.0
2021,18,3334,315,26,958,13,4,9,10,0,0,0,0,0,0,False,False,False,0,3,2022-01-10T12:56:03.687,0,False,0.0
2021,18,3334,320,26,958,2,4,9,7,13,6,10,3,10,0,False,False,False,1,2,2022-01-10T12:59:22.823,13,False,3.0
2021,18,3334,350,26,4616,2,48,9,-3,14,17,8,6,8,6,False,False,False,1,1,2022-01-10T13:09:01.13,14,False,6.0
2021,18,3334,365,23,7250,3,17,4,11,0,0,0,0,0,0,False,False,False,0,3,2022-01-12T15:01:49.663,0,False,0.0
2021,18,3334,375,23,2994,2,2,4,6,18,12,13,5,13,0,False,False,False,0,4,2022-01-10T13:18:04.803,18,False,5.0
2021,18,3334,380,23,2994,3,5,5,4,0,0,0,0,0,0,False,False,False,0,3,2022-01-10T13:19:53.707,0,False,0.0
2021,18,3334,415,23,4949,13,12,6,42,0,0,0,0,0,0,False,False,False,0,3,2022-02-25T16:26:01.41,0,False,
2021,18,3334,435,26,309,13,13,9,4,0,0,0,0,0,0,False,False,False,0,3,2022-01-10T17:40:42.6,0,False,0.0
2021,18,3334,445,26,4619,13,4,3,13,0,0,0,0,0,0,False,False,False,0,2,2022-01-10T13:36:44.067,0,False,0.0
2021,18,3334,475,26,7453,2,5,3,6,7,1,7,0,7,0,False,False,False,0,2,2022-01-10T13:44:55.88,7,False,0.0
2021,18,3334,480,26,958,2,24,6,25,42,17,42,0,42,0,False,False,False,0,4,2022-01-10T13:46:50.527,42,False,0.0
2021,18,3334,495,26,4616,2,48,4,-8,2,10,-1,3,-1,0,False,False,False,1,1,2022-01-12T15:53:32.163,2,False,3.0
2021,18,3334,515,23,4949,13,5,3,14,0,0,0,0,0,0,False,False,False,0,3,2022-01-10T13:56:15.737,0,False,0.0
2021,18,3334,530,26,7453,2,45,5,-4,3,7,0,3,0,0,False,False,False,0,3,2022-01-10T14:00:40.077,3,False,3.0
2021,18,3334,545,23,2994,2,55,4,-3,4,7,2,2,2,0,False,False,False,0,3,2022-01-10T14:05:18.19,4,False,2.0
2021,18,3334,555,23,2994,13,7,9,12,0,0,0,0,0,0,False,False,False,0,4,2022-01-10T14:09:10.147,0,False,0.0
2021,18,3334,575,26,309,3,4,10,14,0,0,0,0,0,0,False,False,False,0,3,2022-01-10T14:22:28.873,0,False,0.0
2021,18,3334,590,23,2994,13,35,7,16,0,0,0,0,0,0,False,False,False,0,4,2022-02-17T18:42:20.723,0,False,0.0
2021,18,3334,595,23,7689,2,4,5,3,4,1,4,0,4,0,False,False,False,0,2,2022-01-10T14:29:11.58,4,False,0.0
2021,18,3334,600,23,7689,2,12,2,20,30,10,29,1,29,0,False,False,False,0,3,2022-01-10T14:31:17.52,30,False,1.0
2021,18,3334,625,23,7246,2,31,10,4,6,2,6,0,6,0,True,False,False,0,4,2022-01-11T19:47:49.533,6,False,0.0
2021,18,3334,640,23,7689,13,29,3,6,0,0,0,0,0,0,False,False,False,0,2,2022-01-10T14:50:04.32,0,False,0.0
2021,18,3334,670,23,7250,2,4,9,2,2,0,2,0,2,6,True,False,False,0,3,2022-01-10T14:59:10.4,2,True,0.0
2021,18,3334,685,26,309,2,4,4,5,6,1,6,0,6,0,False,False,False,0,3,2022-01-10T15:05:18.327,6,False,0.0
2021,18,3334,695,26,4619,13,12,6,34,0,0,0,0,0,0,False,False,False,0,2,2022-01-12T15:35:12.22,0,False,0.0
2021,18,3334,705,23,7250,2,51,9,-4,-1,3,-3,2,-3,0,True,False,False,0,3,2022-01-10T15:10:52.61,-1,False,2.0
2021,18,3334,715,23,3843,2,32,3,-3,8,11,6,2,6,0,False,False,False,0,1,2022-01-10T15:14:21.137,8,False,2.0
2021,18,3334,725,23,2994,13,5,3,5,0,0,0,0,0,0,False,False,False,0,3,2022-01-10T15:16:56.703,0,False,0.0
2021,18,3334,730,23,7250,2,38,4,3,0,-3,0,0,0,0,False,False,False,0,3,2022-01-10T15:18:38.253,0,False,0.0
2021,18,3334,745,26,4619,2,5,5,5,5,0,5,0,5,0,False,False,False,0,2,2022-01-10T15:21:21.143,5,False,0.0
2021,18,3334,750,26,4619,2,4,3,6,9,3,6,3,6,0,False,False,False,0,3,2022-01-12T15:01:49.677,9,False,3.0
2021,18,3334,755,26,4619,2,29,6,18,18,0,18,0,18,0,False,False,False,0,2,2022-01-10T15:24:31.94,18,False,0.0
2021,18,3334,760,26,4616,2,46,3,0,1,1,1,0,1,0,False,False,False,0,1,2022-01-10T15:25:43.683,1,False,0.0
2021,18,3334,765,26,8552,2,13,10,3,6,3,5,1,5,0,False,False,False,0,3,2022-01-10T15:27:33.363,6,False,1.0
2021,18,3334,770,26,7453,2,2,10,9,14,5,9,5,9,0,False,False,False,2,2,2022-01-12T15:54:24.98,14,False,5.0
2021,18,3334,775,26,958,13,17,8,18,0,0,0,0,0,0,False,False,False,0,3,2022-01-10T15:30:58.863,0,False,0.0
2021,18,3334,780,26,4616,2,5,5,2,4,2,3,1,3,0,False,False,False,0,1,2022-01-10T15:32:24.053,4,False,1.0
2021,18,3334,785,26,958,13,35,5,8,0,0,0,0,0,0,False,False,False,0,3,2022-01-10T15:34:27.357,0,False,0.0
2021,18,3334,790,26,4619,2,4,5,5,6,1,5,1,5,0,False,False,False,0,2,2022-01-10T15:36:14.74,6,False,1.0
2021,18,3334,800,26,4619,13,21,2,19,0,0,0,0,0,0,False,False,False,0,2,2022-02-17T18:45:10.283,0,False,0.0
2021,18,3334,805,26,4619,13,9,2,20,0,0,0,0,0,0,False,False,False,0,2,2022-01-10T15:41:49.837,0,False,0.0
2021,18,3334,810,26,8552,2,6,8,23,23,0,23,0,23,6,False,False,False,0,2,2022-01-10T15:43:19.593,23,True,0.0
2021,18,3334,850,26,4619,13,19,6,33,0,0,0,0,0,0,False,False,False,0,2,2022-01-10T15:54:36.22,0,False,0.0
2021,18,3334,860,26,8552,13,4,9,9,0,0,0,0,0,0,False,False,False,0,2,2022-01-10T15:57:54.277,0,False,0.0
2021,18,3334,865,26,8552,13,7,6,21,0,0,0,0,0,0,False,False,False,0,2,2022-01-10T16:02:12.797,0,False,0.0
2021,18,3334,870,26,309,2,13,9,5,11,6,8,3,8,0,False,False,False,0,3,2022-01-10T16:03:40.33,11,False,3.0
2021,18,3334,875,26,4616,13,6,4,5,0,0,0,0,0,0,False,False,False,0,1,2022-01-10T16:05:34.153,0,False,0.0
2021,18,3334,880,26,4619,13,9,6,22,0,0,0,0,0,0,False,False,False,0,3,2022-02-24T13:56:35.78,0,False,0.0
2021,18,3334,885,26,7453,3,13,3,3,0,0,0,0,0,0,False,False,False,0,3,2022-01-12T16:20:39.31,0,False,0.0
2021,18,3334,890,26,958,13,6,9,10,0,0,0,0,0,0,False,False,False,0,3,2022-01-12T15:36:37.353,0,False,
2021,18,3334,895,26,4616,13,5,3,4,0,0,0,0,0,0,False,False,False,0,1,2022-01-12T16:52:58.977,0,True,0.0
2021,18,3334,900,26,8552,13,5,3,10,0,0,0,0,0,0,False,False,False,0,2,2022-01-10T16:18:17.487,0,False,0.0
2021,18,3334,905,26,309,2,5,3,13,14,1,13,1,13,0,False,False,False,0,3,2022-01-10T16:20:13.863,14,False,1.0
2021,18,3334,915,26,4616,13,24,6,22,0,0,0,0,0,0,False,False,False,0,1,2022-01-10T16:23:46.517,0,False,0.0
2021,18,3334,920,26,8552,2,4,3,10,10,0,10,0,10,0,False,False,False,0,2,2022-01-10T16:25:55.96,10,False,0.0
2021,18,3334,935,26,4616,13,12,3,3,0,0,0,0,0,0,False,False,False,0,1,2022-02-24T20:26:14.423,0,False,0.0
2021,18,3334,940,26,8552,13,5,5,13,0,0,0,0,0,0,False,False,False,0,2,2022-01-10T16:37:24.003,0,False,0.0
2021,18,3334,950,26,4619,2,4,9,12,14,2,13,1,13,0,False,False,False,0,3,2022-01-10T16:40:40.037,14,False,1.0
2021,18,3334,960,26,4619,13,12,3,10,0,0,0,0,0,0,False,False,False,0,2,2022-01-10T16:42:26.38,0,False,0.0
2021,18,3334,965,26,7453,2,5,2,17,17,0,17,0,17,0,False,False,False,0,2,2022-01-10T16:46:07.3,17,False,0.0
2021,18,3334,970,26,4619,2,4,9,12,12,0,12,0,12,6,False,False,False,0,2,2022-01-10T16:47:44.243,12,True,0.0
2021,18,3334,1010,23,4949,2,5,5,6,7,1,7,0,7,0,False,False,False,0,3,2022-01-10T16:57:22.323,7,False,0.0
2021,18,3334,1015,23,2994,13,24,2,22,0,0,0,0,0,0,False,False,False,0,4,2022-01-12T16:45:04.1,0,False,0.0
2021,18,3334,1030,26,958,2,11,5,13,31,18,31,0,31,0,False,False,False,0,4,2022-01-10T17:05:09.47,31,True,
2021,18,3334,1035,26,309,2,4,4,5,6,1,6,0,6,0,False,False,False,0,3,2022-01-10T17:06:51.207,6,False,0.0
2021,18,3334,1040,26,4616,13,5,10,1,0,0,0,0,0,0,False,False,False,0,1,2022-01-12T15:01:49.74,0,False,0.0
2021,18,3334,1045,26,7453,13,3,5,12,0,0,0,0,0,0,False,False,False,0,2,2022-01-10T17:09:27.017,0,False,0.0
2021,18,3334,1050,26,4619,2,6,1,16,47,31,16,31,16,0,False,False,False,0,2,2022-01-12T15:54:38.427,47,False,31.0
2021,18,3334,1060,26,7453,13,5,5,5,0,0,0,0,0,0,False,False,False,0,2,2022-02-24T14:13:47.163,0,False,0.0
2021,18,3334,1065,26,4619,3,9,2,22,0,0,0,0,0,0,False,False,False,0,3,2022-01-10T17:16:59.06,0,False,0.0
2021,18,3334,1080,23,7689,2,35,6,17,17,0,17,0,17,0,False,False,False,0,3,2022-01-10T17:19:49.253,17,False,0.0
2021,18,3334,1090,23,3843,2,45,5,-4,-5,-1,-5,0,-5,0,True,False,False,0,1,2022-01-10T17:22:38.243,-5,False,0.0
2021,18,3334,1095,23,4949,2,5,3,13,11,-2,11,0,11,0,False,False,False,0,3,2022-02-24T14:04:46.667,11,False,0.0
2021,19,3335,20,23,4949,2,7,8,16,17,1,17,0,17,0,False,False,False,0,3,2022-01-16T10:23:42.777,17,False,0.0
2021,19,3335,25,23,7250,2,5,3,3,6,3,6,0,6,0,False,False,False,0,2,2022-01-16T10:25:22.78,6,True,0.0
2021,19,3335,35,23,2994,2,13,9,2,8,6,4,4,4,0,False,False,False,1,4,2022-01-19T22:15:22.663,8,False,4.0
2021,19,3335,40,23,7241,2,4,9,3,9,6,8,1,8,0,False,False,False,0,1,2022-01-16T10:29:00.383,9,False,1.0
2021,19,3335,55,23,7250,13,12,2,18,0,0,0,0,0,0,False,False,False,0,3,2022-02-24T20:27:22.493,0,False,0.0
2021,19,3335,70,7,8317,3,4,9,5,0,0,0,0,0,0,False,False,False,0,3,2022-01-16T10:34:19.167,0,False,0.0
2021,19,3335,75,7,8317,2,3,5,11,11,0,11,0,11,0,False,False,False,0,2,2022-01-16T10:35:36.907,11,False,0.0
2021,19,3335,85,7,8317,2,5,2,16,17,1,17,0,17,0,False,False,False,0,3,2022-01-16T10:38:24.117,17,True,0.0
2021,19,3335,95,7,8317,2,4,3,7,9,2,7,2,7,0,False,False,False,0,2,2022-01-16T10:40:37.33,9,False,2.0
2021,19,3335,100,7,4679,2,48,9,-3,21,24,20,1,20,0,False,False,False,0,1,2022-01-16T10:42:22.14,21,False,1.0
2021,19,3335,105,7,7659,3,5,5,9,0,0,0,0,0,0,False,False,False,0,2,2022-01-16T10:43:43.727,0,False,0.0
2021,19,3335,115,7,2631,2,4,10,7,7,0,7,0,7,6,False,False,False,0,3,2022-01-16T10:45:46.893,7,True,0.0
2021,19,3335,130,23,4949,2,26,9,13,13,0,13,0,13,0,False,False,False,0,3,2022-01-19T22:10:54.463,13,False,0.0
2021,19,3335,145,23,7250,2,50,3,-4,7,11,4,3,4,0,False,False,False,0,2,2022-01-16T10:51:38.107,7,False,3.0
2021,19,3335,195,23,2994,2,4,9,4,6,2,5,1,5,0,False,False,False,0,4,2022-01-16T11:01:08.43,6,False,1.0
2021,19,3335,225,7,4679,2,45,5,-6,-1,5,-2,1,-2,0,False,False,False,0,1,2022-01-16T11:08:58.033,-1,False,1.0
2021,19,3335,230,7,8317,2,29,2,21,28,7,28,0,28,0,False,False,False,0,2,2022-01-16T11:10:13.367,28,False,0.0
2021,19,3335,235,7,4679,13,12,5,6,0,0,0,0,0,0,False,False,False,0,1,2022-01-16T11:11:39.567,0,False,0.0
2021,19,3335,275,23,7246,13,12,10,9,0,0,0,0,0,0,False,False,False,0,4,2022-01-19T22:23:44.737,0,False,0.0
2021,19,3335,280,23,967,3,26,9,3,0,0,0,0,0,0,False,False,False,0,2,2022-01-16T11:21:55.23,0,False,0.0
2021,19,3335,295,7,2631,2,4,9,5,5,0,5,0,5,0,False,False,False,0,4,2022-01-16T11:27:53.68,5,False,0.0
2021,19,3335,305,7,3521,2,4,10,5,5,0,5,0,5,0,False,False,False,0,3,2022-01-16T11:30:15.287,5,False,0.0
2021,19,3335,315,7,2631,2,17,8,20,29,9,23,6,23,0,False,False,False,0,4,2022-01-16T11:32:47.08,29,False,6.0
2021,19,3335,320,7,8317,13,8,7,39,0,0,0,0,0,0,False,False,False,0,2,2022-01-16T11:34:26.617,0,False,0.0
2021,19,3335,330,7,3521,13,2,10,6,0,0,0,0,0,0,False,False,False,0,3,2022-01-19T22:11:20.53,0,False,0.0
2021,19,3335,340,7,4679,2,47,5,1,5,4,5,0,5,0,False,False,False,0,1,2022-01-16T12:23:47.503,5,False,0.0
2021,19,3335,355,7,3521,2,12,10,10,10,0,10,0,10,6,False,False,False,0,3,2022-01-16T11:44:36.75,10,True,0.0
2021,19,3335,370,23,7689,3,6,4,4,0,0,0,0,0,0,False,False,False,0,3,2022-01-19T21:39:11.263,0,False,0.0
2021,19,3335,375,23,7250,2,2,4,5,7,2,7,0,7,0,False,False,False,0,3,2022-01-16T11:48:36.047,7,False,0.0
2021,19,3335,380,23,7689,2,13,9,4,19,15,18,1,18,0,True,False,False,0,3,2022-01-16T11:50:02.9,19,False,1.0
2021,19,3335,385,23,4949,13,8,10,13,0,0,0,0,0,0,False,False,False,0,2,2022-01-16T11:51:29.913,0,False,0.0
2021,19,3335,400,23,3843,2,28,9,-4,4,8,3,1,3,0,False,False,False,0,1,2022-01-19T22:18:21.137,4,False,1.0
2021,19,3335,410,23,2994,13,13,9,6,0,0,0,0,0,0,False,False,False,0,4,2022-01-16T12:00:51.793,0,False,0.0
2021,19,3335,420,23,2994,2,5,3,6,11,5,10,1,10,0,False,False,False,0,3,2022-01-16T12:02:57.85,11,False,1.0
2021,19,3335,425,23,3843,13,16,9,0,0,0,0,0,0,0,False,False,False,0,1,2022-01-16T12:05:01.477,0,False,0.0
2021,19,3335,430,23,4949,2,8,10,14,14,0,14,0,14,6,False,False,False,0,2,2022-01-16T12:06:07.913,14,True,0.0
2021,19,3335,465,7,8317,2,4,4,5,5,0,5,0,5,0,False,False,False,0,3,2022-01-16T12:16:51.953,5,False,0.0
2021,19,3335,470,7,2631,2,47,10,4,9,5,5,4,5,0,False,False,False,0,4,2022-01-16T12:19:27.213,9,False,4.0
2021,19,3335,480,7,8317,2,2,9,6,7,1,7,0,7,0,False,False,False,0,2,2022-01-16T12:21:57.147,7,False,0.0
2021,19,3335,500,7,7659,13,19,2,34,0,0,0,0,0,0,False,False,False,0,2,2022-01-16T12:30:04.28,0,False,0.0
2021,19,3335,505,7,8317,2,52,4,2,9,7,8,1,8,0,False,False,False,0,3,2022-01-16T12:31:21.843,9,False,1.0
2021,19,3335,525,23,2994,2,6,9,11,12,1,12,0,12,0,False,False,False,0,3,2022-01-16T12:38:56.727,12,False,0.0
2021,19,3335,535,23,7689,2,5,5,6,6,0,6,0,6,0,False,False,False,0,3,2022-01-17T18:49:28.917,6,False,0.0
2021,19,3335,540,23,7250,13,7,6,19,0,0,0,0,0,0,False,False,False,0,3,2022-01-16T12:45:32.603,0,False,0.0
2021,19,3335,550,7,3521,2,46,3,1,5,4,5,0,5,0,False,False,False,0,3,2022-01-16T12:47:58.66,5,False,0.0
2021,19,3335,560,7,7659,13,3,5,12,0,0,0,0,0,0,False,False,False,0,2,2022-01-16T12:51:03.147,0,False,0.0
2021,19,3335,575,23,967,2,35,2,23,35,12,35,0,35,0,False,False,False,0,3,2022-01-16T12:58:54.06,35,True,
2021,19,3335,580,23,7250,2,4,9,8,9,1,9,0,9,0,False,False,False,0,3,2022-01-16T13:02:08.09,9,False,0.0
2021,19,3335,585,23,7689,13,9,2,22,0,0,0,0,0,0,False,False,False,0,2,2022-01-16T13:03:24.273,0,False,0.0
2021,19,3335,590,23,7250,2,17,4,8,16,8,14,2,14,0,False,False,False,1,3,2022-01-16T13:05:09.137,16,False,2.0
2021,19,3335,615,23,7241,2,47,10,-1,7,8,5,2,5,0,False,False,False,0,1,2022-01-16T13:19:56.017,7,False,2.0
2021,19,3335,620,23,7250,2,51,9,-2,5,7,2,3,2,0,False,False,False,1,3,2022-01-19T22:12:19.68,5,False,3.0
2021,19,3335,625,23,7246,13,7,8,18,0,0,0,0,0,0,False,False,False,0,4,2022-01-16T13:27:30.957,0,False,
2021,19,3335,630,23,7689,2,6,10,14,16,2,15,1,15,0,False,False,False,0,3,2022-01-16T13:29:22.373,16,False,1.0
2021,19,3335,645,23,2994,13,5,3,3,0,0,0,0,0,0,True,False,False,0,3,2022-01-19T22:11:42.35,0,False,0.0
2021,19,3335,655,23,2994,2,32,5,2,3,1,2,1,2,0,False,False,False,0,4,2022-01-19T22:19:56.93,3,False,1.0
2021,19,3335,675,7,2631,2,4,4,6,7,1,6,1,6,0,False,False,False,0,4,2022-01-16T13:44:57.17,7,False,1.0
2021,19,3335,685,7,8317,3,4,3,10,0,0,0,0,0,0,False,False,False,0,3,2022-01-16T13:50:50.477,0,False,0.0
2021,19,3335,690,7,4679,2,48,10,-6,3,9,1,2,1,0,False,False,False,0,1,2022-01-16T13:52:23.83,3,False,2.0
2021,19,3335,695,7,8317,2,29,5,14,19,5,16,3,16,0,False,False,False,0,2,2022-01-16T13:54:26.863,19,False,3.0
2021,19,3335,700,7,8317,2,2,10,11,11,0,11,0,11,0,False,False,False,0,3,2022-01-16T13:55:43.47,11,False,0.0
2021,19,3335,710,7,7659,2,6,10,4,10,6,9,1,9,0,False,False,False,0,2,2022-01-16T13:58:24.213,10,False,1.0
2021,19,3335,715,7,3521,2,2,10,6,6,0,6,0,6,0,False,False,False,0,3,2022-01-16T13:59:29.53,6,False,0.0
2021,19,3335,745,23,7250,2,44,3,-2,3,5,2,1,2,0,False,False,False,0,3,2022-01-16T14:04:50.53,3,False,1.0
2021,19,3335,750,23,7241,2,48,4,-3,19,22,19,0,19,0,False,False,False,0,1,2022-01-19T22:12:35.323,19,True,
2021,19,3335,755,23,7241,2,28,10,-5,-1,4,-3,2,-3,0,False,False,False,1,1,2022-01-19T22:22:14.433,-1,False,
2021,19,3335,760,23,2994,13,12,6,15,0,0,0,0,0,0,False,False,False,0,4,2022-01-19T22:23:23.547,0,False,0.0
2021,19,3335,765,23,2994,2,4,4,12,13,1,13,0,13,0,False,False,False,0,3,2022-01-16T14:11:40.697,13,False,0.0
2021,19,3335,770,23,7250,2,38,10,4,5,1,5,0,5,0,False,False,False,0,3,2022-01-16T14:13:06.893,5,False,0.0
2021,19,3335,775,23,7246,13,35,10,12,0,0,0,0,0,0,False,False,False,0,3,2022-01-16T14:15:31.84,0,False,0.0
2021,19,3335,780,23,7689,13,7,6,18,0,0,0,0,0,0,False,False,False,0,3,2022-01-16T14:17:51.713,0,False,0.0
2021,19,3335,790,23,967,2,35,7,22,26,4,26,0,26,0,False,False,False,0,3,2022-01-19T21:39:11.327,26,True,0.0
2021,19,3335,795,23,7241,2,4,4,4,13,9,7,6,7,0,False,False,False,0,1,2022-01-16T14:21:16.053,13,False,6.0
2021,19,3335,800,23,4949,2,5,5,5,7,2,7,0,7,0,False,False,False,0,2,2022-01-16T14:22:18.683,7,True,0.0
2021,19,3335,810,23,2994,13,13,5,3,0,0,0,0,0,0,False,False,False,0,4,2022-01-16T14:24:19.667,0,False,0.0
2021,19,3335,845,7,2631,2,32,9,0,7,7,6,1,6,0,False,False,False,0,4,2022-01-16T14:30:30.923,7,False,1.0
2021,19,3335,860,23,7241,2,32,3,-3,15,18,14,1,14,0,False,False,False,0,1,2022-01-16T14:35:44.427,15,False,1.0
2021,19,3335,865,23,2994,13,26,10,11,0,0,0,0,0,0,False,False,False,0,3,2022-01-16T14:37:08.917,0,False,0.0
2021,19,3335,875,23,2994,2,17,1,18,23,5,21,2,21,0,False,False,False,0,3,2022-01-16T14:39:44.79,23,False,2.0
2021,19,3335,880,23,7241,13,6,5,2,0,0,0,0,0,0,False,False,False,0,1,2022-01-16T14:41:03.067,0,False,0.0
2021,19,3335,885,23,7246,13,32,5,-1,0,0,0,0,0,0,False,False,False,0,4,2022-01-16T14:42:29.56,0,False,0.0
2021,19,3335,890,23,4949,2,4,10,9,10,1,10,0,10,0,False,False,False,0,2,2022-01-16T14:43:37.423,10,False,0.0
2021,19,3335,900,23,4949,13,2,10,9,0,0,0,0,0,0,False,False,False,0,2,2022-01-16T14:45:21.76,0,False,0.0
2021,19,3335,905,23,7250,13,12,3,9,0,0,0,0,0,0,False,False,False,0,3,2022-01-16T14:46:34.18,0,False,0.0
2021,19,3335,910,23,4949,13,4,10,7,0,0,0,0,0,0,False,False,False,0,3,2022-01-16T14:47:57.053,0,False,0.0
2021,19,3336,10,4,2853,2,4,9,6,9,3,7,2,7,0,False,False,False,1,2,2022-01-19T16:01:12.347,9,False,2.0
2021,19,3336,20,4,6983,2,45,5,-3,0,3,-2,2,-2,0,False,False,False,0,1,2022-01-16T11:39:09.753,0,False,2.0
2021,19,3336,30,4,213,13,12,4,9,0,0,0,0,0,0,False,False,False,0,3,2022-01-19T15:46:49.077,0,False,0.0
2021,19,3336,35,4,5119,2,47,5,2,7,5,6,1,6,0,True,False,False,0,2,2022-01-16T11:44:27.343,7,False,1.0
2021,19,3336,50,4,6953,2,12,5,8,8,0,8,0,8,6,False,False,False,0,4,2022-01-19T16:01:28.937,8,True,0.0
2021,19,3336,70,19,4912,2,3,3,9,9,0,9,0,9,0,False,False,False,0,3,2022-01-19T16:15:53.65,9,True,0.0
2021,19,3336,85,19,4912,13,3,3,7,0,0,0,0,0,0,False,False,False,0,3,2022-01-16T11:57:44.307,0,False,0.0
2021,19,3336,90,19,4282,2,12,2,22,30,8,29,1,29,0,False,False,False,0,3,2022-01-19T16:16:03.417,30,False,1.0
2021,19,3336,95,19,1212,3,7,2,25,0,0,0,0,0,0,False,False,False,0,1,2022-01-16T12:01:50.267,0,False,0.0
2021,19,3336,100,19,7175,3,5,5,8,0,0,0,0,0,0,False,False,False,0,3,2022-01-16T12:03:21.427,0,False,0.0
2021,19,3336,110,19,2256,13,21,6,34,0,0,0,0,0,0,False,False,False,0,2,2022-01-19T15:38:24.87,0,False,0.0
2021,19,3336,115,4,6953,2,35,6,21,24,3,22,2,22,0,False,False,False,0,3,2022-01-16T16:12:14.143,24,False,2.0
2021,19,3336,120,4,213,2,5,5,2,2,0,2,0,2,0,True,False,False,0,3,2022-01-17T18:52:48.73,2,False,0.0
2021,19,3336,135,4,6983,13,5,10,3,0,0,0,0,0,0,False,False,False,0,1,2022-01-16T12:13:47.067,0,False,0.0
2021,19,3336,140,4,5119,2,5,7,17,19,2,18,1,18,0,False,False,False,0,3,2022-01-16T16:13:30.43,19,False,1.0
2021,19,3336,145,4,2853,13,54,10,-1,0,0,0,0,0,0,True,False,False,0,3,2022-01-16T12:17:05.147,0,False,0.0
2021,19,3336,150,4,2853,2,5,5,5,6,1,6,0,6,0,True,False,False,0,3,2022-01-19T16:05:12.047,6,False,0.0
2021,19,3336,160,4,6953,2,8,10,11,11,0,11,0,11,6,False,False,False,0,3,2022-01-16T12:21:03.33,11,True,0.0
2021,19,3336,200,4,7646,13,4,9,5,0,0,0,0,0,0,False,False,False,0,3,2022-01-16T12:42:06.127,0,False,0.0
2021,19,3336,215,4,6983,2,4,4,3,5,2,4,1,4,0,False,False,False,1,1,2022-01-16T23:54:17.56,5,False,
2021,19,3336,220,4,7646,2,35,8,18,22,4,20,2,20,0,False,False,False,0,3,2022-01-17T18:52:35.763,22,False,2.0
2021,19,3336,270,19,8493,2,44,3,-4,4,8,1,3,1,0,True,False,False,1,1,2022-01-17T18:59:13.48,4,False,3.0
2021,19,3336,280,19,2256,13,19,6,25,0,0,0,0,0,0,False,False,False,0,2,2022-01-16T13:19:47.087,0,False,
2021,19,3336,300,19,1212,2,31,9,5,12,7,8,4,8,0,False,False,False,0,1,2022-01-16T13:25:54.727,12,False,4.0
2021,19,3336,310,4,5119,2,45,5,-5,19,24,9,10,9,0,True,False,False,1,2,2022-01-16T13:32:15.047,19,False,10.0
2021,19,3336,315,4,2853,2,19,2,38,45,7,38,7,38,0,False,False,False,0,2,2022-01-16T13:34:02.767,45,False,7.0
2021,19,3336,350,19,4912,2,3,3,11,10,-1,10,0,10,0,False,False,False,0,2,2022-01-19T16:16:15.403,10,True,0.0
2021,19,3336,355,19,1212,2,46,3,2,2,0,2,0,2,0,False,False,False,0,1,2022-01-16T16:12:33.183,2,False,0.0
2021,19,3336,360,19,1212,2,31,10,5,5,0,5,0,5,0,False,False,False,0,1,2022-01-19T16:03:36.267,5,False,0.0
2021,19,3336,365,19,1212,2,45,5,-1,8,9,8,0,8,0,False,False,False,0,1,2022-01-19T16:16:24.547,8,False,0.0
2021,19,3336,385,19,7175,2,4,9,5,7,2,7,0,7,0,True,False,False,0,2,2022-01-16T13:49:09.997,7,False,0.0
2021,19,3336,395,19,7175,2,29,2,17,19,2,19,0,19,0,True,False,False,0,3,2022-01-17T18:59:24.69,19,False,0.0
2021,19,3336,435,19,8493,2,48,4,-2,10,12,7,3,7,0,False,False,False,0,1,2022-01-16T13:56:39.603,10,False,3.0
2021,19,3336,445,19,4282,13,5,9,7,0,0,0,0,0,0,False,False,False,0,4,2022-01-16T23:53:02.6,0,False,0.0
2021,19,3336,455,4,7937,2,32,3,1,4,3,3,1,3,0,True,False,False,0,3,2022-01-16T14:03:20.793,4,False,1.0
2021,19,3336,460,4,6983,2,46,3,1,9,8,7,2,7,0,False,False,False,0,1,2022-01-16T14:04:59.06,9,False,2.0
2021,19,3336,465,4,6983,2,46,3,-2,4,6,3,1,3,0,False,False,False,0,1,2022-01-16T14:06:41.713,4,False,1.0
2021,19,3336,475,4,594,2,51,3,-1,7,8,5,2,5,0,True,False,False,0,3,2022-01-16T14:09:48.933,7,False,
2021,19,3336,480,4,213,2,19,6,34,34,0,34,0,34,6,False,False,False,0,2,2022-01-19T16:16:46.843,34,True,0.0
2021,19,3336,495,19,7172,2,4,4,6,7,1,7,0,7,0,False,False,False,0,1,2022-01-16T14:14:51.44,7,False,0.0
2021,19,3336,500,19,7175,2,4,9,1,1,0,1,0,1,0,False,False,False,0,3,2022-01-16T14:16:17.93,1,False,0.0
2021,19,3336,510,19,4912,2,7,2,20,43,23,36,7,36,0,False,False,False,0,3,2022-01-19T16:02:20.22,43,False,7.0
2021,19,3336,520,19,1212,13,48,9,-4,0,0,0,0,0,0,True,False,False,0,1,2022-01-16T14:27:23.183,0,False,0.0
2021,19,3336,525,19,8493,2,4,9,4,4,0,4,0,4,0,True,False,False,0,1,2022-01-19T16:16:55.913,4,False,0.0
2021,19,3336,530,19,7175,2,5,3,5,7,2,6,1,6,0,True,False,False,0,3,2022-01-16T14:30:01.61,7,False,1.0
2021,19,3336,545,19,7175,3,6,9,3,0,0,0,0,0,0,False,False,False,0,3,2022-01-16T14:36:04.583,0,False,0.0
2021,19,3336,550,19,4912,2,7,3,3,3,0,3,0,3,6,False,False,False,0,3,2022-01-16T14:37:31.68,3,True,0.0
2021,19,3336,570,4,6953,2,28,5,1,8,7,5,3,5,0,False,False,False,0,4,2022-01-16T15:00:37.273,8,False,3.0
2021,19,3336,585,4,594,2,12,10,11,19,8,17,2,17,0,False,False,False,0,3,2022-01-16T15:05:05.967,19,False,2.0
2021,19,3336,610,4,7646,2,8,7,15,19,4,16,3,16,6,False,False,False,1,3,2022-01-16T15:16:44.577,19,False,3.0
2021,19,3336,630,19,8493,2,50,9,-2,15,17,10,5,10,0,True,False,False,0,2,2022-01-16T23:52:02.35,15,False,5.0
2021,19,3336,635,19,7456,3,47,5,1,0,0,0,0,0,0,False,False,False,0,1,2022-01-19T15:46:38.457,0,False,0.0
2021,19,3336,640,19,7175,2,4,9,3,3,0,3,0,3,0,True,False,False,0,3,2022-01-19T16:07:24.443,3,False,0.0
2021,19,3336,655,4,6953,2,7,2,29,38,9,35,3,35,0,False,False,False,0,4,2022-01-16T15:28:03.63,38,False,3.0
2021,19,3336,665,4,8478,2,32,3,1,1,0,1,0,1,6,False,False,False,0,4,2022-01-16T15:30:59.707,1,True,0.0
2021,19,3336,705,19,4912,2,6,3,6,6,0,6,0,6,0,False,False,False,0,2,2022-01-19T16:02:42.427,6,False,0.0
2021,19,3336,710,19,4912,2,12,9,2,2,0,2,0,2,0,False,False,False,0,2,2022-01-19T16:04:21.247,2,False,0.0
2021,19,3336,715,19,7175,2,4,10,4,3,-1,3,0,3,0,True,False,False,0,2,2022-01-19T15:47:14.41,3,False,0.0
2021,19,3336,735,19,2256,2,50,9,0,18,18,17,1,17,0,False,False,False,0,3,2022-01-19T16:07:48.657,18,False,1.0
2021,19,3336,750,19,7175,13,36,9,4,0,0,0,0,0,0,False,False,False,0,3,2022-01-16T15:50:38.217,0,False,0.0
2021,19,3336,755,19,4282,3,28,3,4,0,0,0,0,0,0,False,False,False,0,1,2022-01-16T15:53:27.663,0,False,0.0
2021,19,3336,760,19,4912,2,7,3,4,4,0,4,0,4,6,True,False,False,0,2,2022-01-16T15:55:22.077,4,True,0.0
2021,19,3337,15,30,931,3,46,3,0,0,0,0,0,0,0,False,False,False,0,1,2022-01-17T10:46:44.333,0,False,0.0
2021,19,3337,20,30,256,13,3,5,12,0,0,0,0,0,0,False,False,False,0,2,2022-01-17T10:48:48.643,0,False,
2021,19,3337,30,30,256,3,2,10,2,0,0,0,0,0,0,False,False,False,0,2,2022-01-17T10:59:29.333,0,False,0.0
2021,19,3337,35,30,793,2,13,10,3,8,5,5,3,5,0,False,False,False,0,3,2022-01-17T11:01:47.007,8,False,3.0
2021,19,3337,40,30,793,2,18,3,-1,2,3,0,2,0,0,False,False,False,0,2,2022-01-17T11:03:11.91,2,False,2.0
2021,19,3337,45,30,931,2,16,9,6,6,0,6,0,6,0,False,False,False,0,1,2022-01-17T11:04:37.663,6,False,0.0
2021,19,3337,50,30,931,2,46,3,0,9,9,7,2,7,0,False,False,False,0,1,2022-01-17T11:06:38.983,9,False,2.0
2021,19,3337,55,30,4523,2,13,9,3,3,0,3,0,3,0,False,False,False,0,4,2022-01-17T11:09:13.223,3,False,0.0
2021,19,3337,60,30,2290,2,50,3,1,8,7,7,1,7,0,False,False,False,0,2,2022-01-17T11:11:15.317,8,False,1.0
2021,19,3337,90,24,6389,2,44,9,-3,1,4,0,1,0,0,False,False,False,0,1,2022-01-17T11:22:35.383,1,False,1.0
2021,19,3337,110,30,256,2,6,10,5,5,0,5,0,5,0,False,False,False,0,2,2022-01-17T11:27:02.62,5,False,0.0
2021,19,3337,115,30,7893,3,2,10,6,0,0,0,0,0,0,False,False,False,0,3,2022-01-19T23:41:18.933,0,False,0.0
2021,19,3337,140,24,6937,2,47,5,5,6,1,6,0,6,0,False,False,False,0,1,2022-01-19T23:41:31.58,6,False,0.0
2021,19,3337,145,24,7798,13,12,9,6,0,0,0,0,0,0,False,False,False,0,2,2022-01-18T23:26:20.923,0,False,0.0
2021,19,3337,160,30,63,2,26,4,4,13,9,7,6,7,0,False,False,False,0,4,2022-01-17T11:45:50.827,13,False,6.0
2021,19,3337,165,30,63,2,2,4,6,8,2,8,0,8,0,False,False,False,0,4,2022-01-17T11:56:31.823,8,False,0.0
2021,19,3337,170,30,7893,2,17,10,7,17,10,15,2,15,0,False,False,False,0,3,2022-01-19T23:43:25.933,17,False,2.0
2021,19,3337,175,30,63,13,8,1,16,0,0,0,0,0,0,False,False,False,0,4,2022-01-17T12:00:13.303,0,False,0.0
2021,19,3337,180,30,793,2,5,5,11,16,5,12,4,12,0,False,False,False,0,3,2022-01-19T23:43:37.143,16,False,4.0
2021,19,3337,185,30,793,2,18,3,-2,8,10,6,2,6,0,False,False,False,0,2,2022-01-17T12:03:30.673,8,False,2.0
2021,19,3337,225,24,6373,13,7,6,18,0,0,0,0,0,0,False,False,False,0,4,2022-01-17T12:12:50.607,0,False,0.0
2021,19,3337,240,30,793,2,4,2,15,18,3,17,1,17,0,False,False,False,0,2,2022-01-19T22:54:07.753,18,False,1.0
2021,19,3337,245,30,793,2,4,10,9,9,0,9,0,9,0,False,False,False,0,2,2022-01-19T22:20:58.21,9,False,0.0
2021,19,3337,255,30,7268,2,4,3,6,8,2,7,1,7,0,False,False,False,0,2,2022-01-17T12:21:07.81,8,False,1.0
2021,19,3337,265,30,7891,2,51,9,-5,5,10,3,2,3,0,False,False,False,0,1,2022-01-18T23:27:31.87,5,False,2.0
2021,19,3337,270,30,7893,2,2,4,4,13,9,10,3,10,0,False,False,False,0,3,2022-01-17T12:25:43.34,13,False,3.0
2021,19,3337,275,30,793,13,2,9,5,0,0,0,0,0,0,False,False,False,0,2,2022-01-17T12:27:06.37,0,False,0.0
2021,19,3337,280,30,931,2,34,4,-4,-4,0,-4,0,-4,0,True,False,False,0,2,2022-01-17T12:28:45.253,-4,False,0.0
2021,19,3337,305,24,7800,2,51,9,-3,0,3,0,0,0,0,False,False,False,0,3,2022-01-17T12:38:51.51,0,False,0.0
2021,19,3337,310,24,8513,2,51,5,-5,3,8,1,2,1,0,True,False,False,0,1,2022-01-19T23:43:49.727,3,False,2.0
2021,19,3337,315,24,6373,2,4,4,11,16,5,11,5,11,0,False,False,False,1,3,2022-01-17T12:42:42.217,16,False,5.0
2021,19,3337,325,24,6373,13,30,5,3,0,0,0,0,0,0,False,False,False,0,4,2022-01-17T12:46:44.8,0,False,0.0
2021,19,3337,330,24,6373,13,8,6,28,0,0,0,0,0,0,False,False,False,0,3,2022-01-17T12:48:53.64,0,False,0.0
2021,19,3337,340,24,6373,2,5,3,10,10,0,10,0,10,0,False,False,False,0,3,2022-01-17T12:50:47.513,10,False,0.0
2021,19,3337,345,24,6373,3,12,3,12,0,0,0,0,0,0,False,False,False,0,3,2022-01-18T23:26:36.927,0,False,0.0
2021,19,3337,355,24,6937,2,48,9,-4,1,5,0,1,0,0,False,False,False,0,1,2022-01-17T12:56:41.14,1,False,1.0
2021,19,3337,360,24,7798,13,3,5,11,0,0,0,0,0,0,False,False,False,0,2,2022-01-17T13:00:11.023,0,False,0.0
2021,19,3337,370,30,7891,2,5,9,3,4,1,4,0,4,0,False,False,False,0,1,2022-01-17T13:07:23.03,4,False,0.0
2021,19,3337,390,24,6373,2,53,9,-5,32,37,13,19,13,0,False,False,False,3,4,2022-01-17T13:13:12.143,10,False,19.0
2021,19,3337,400,24,8509,2,50,10,-2,9,11,7,2,7,0,False,False,False,0,2,2022-01-17T13:16:55.247,9,False,
2021,19,3337,405,24,6373,13,7,6,21,0,0,0,0,0,0,False,False,False,0,3,2022-01-17T13:19:31.6,0,False,0.0
2021,19,3337,415,24,7800,2,8,6,33,35,2,34,1,34,0,False,False,False,0,3,2022-01-18T23:28:02.82,35,False,1.0
2021,19,3337,420,24,8509,2,4,3,6,6,0,6,0,6,0,False,False,False,0,2,2022-01-17T16:42:46.703,6,False,0.0
2021,19,3337,425,24,8509,13,12,6,21,0,0,0,0,0,0,False,False,False,0,2,2022-01-18T23:26:51.893,0,True,0.0
2021,19,3337,440,30,63,2,32,5,-2,3,5,3,0,3,0,False,False,False,0,4,2022-01-19T22:21:26.053,3,False,0.0
2021,19,3337,460,24,8513,2,46,3,-1,0,1,0,0,0,0,False,False,False,0,1,2022-01-17T13:34:17.75,0,False,0.0
2021,19,3337,485,24,8513,2,48,10,-3,10,13,8,2,8,0,False,False,False,0,1,2022-01-17T13:47:00.33,10,False,2.0
2021,19,3337,490,24,6373,2,12,7,24,28,4,24,4,24,0,False,False,False,1,3,2022-01-19T23:42:02.973,28,False,4.0
2021,19,3337,495,24,7800,13,17,8,25,0,0,0,0,0,0,False,False,False,0,3,2022-01-17T13:52:03.993,0,False,0.0
2021,19,3337,500,24,6373,13,6,9,10,0,0,0,0,0,0,False,False,False,0,4,2022-01-17T13:53:36.733,0,False,0.0
2021,19,3337,505,24,8509,13,3,7,15,0,0,0,0,0,0,False,False,False,0,2,2022-01-17T13:55:54.567,0,False,0.0
2021,19,3337,525,30,256,13,4,3,9,0,0,0,0,0,0,False,False,False,0,2,2022-01-17T14:01:08.587,0,False,0.0
2021,19,3337,535,30,931,2,48,9,-3,22,25,13,9,13,0,False,False,False,0,1,2022-01-19T23:44:09.297,22,False,9.0
2021,19,3337,550,30,2290,2,6,10,4,5,1,5,0,5,0,False,False,False,0,3,2022-01-17T14:10:32.593,5,False,0.0
2021,19,3337,555,30,793,2,7,6,15,17,2,17,0,17,0,False,False,False,0,3,2022-01-17T14:12:43.463,17,False,0.0
2021,19,3337,560,30,63,2,35,4,2,2,0,2,0,2,6,False,False,False,0,4,2022-01-17T14:14:39.29,2,True,0.0
2021,19,3337,580,24,7798,2,49,10,-3,2,5,1,1,1,0,False,False,False,0,2,2022-01-17T14:34:44.563,2,False,1.0
2021,19,3337,585,24,6937,2,4,10,3,5,2,5,0,5,0,False,False,False,0,2,2022-01-17T14:36:01.373,5,False,0.0
2021,19,3337,590,24,7800,13,6,7,16,0,0,0,0,0,0,False,False,False,0,2,2022-01-17T14:37:28.483,0,False,0.0
2021,19,3337,595,24,8509,13,12,10,7,0,0,0,0,0,0,False,False,False,0,2,2022-01-17T14:43:08.507,0,False,0.0
2021,19,3337,600,30,793,2,35,6,23,36,13,26,10,26,6,False,False,False,1,3,2022-01-19T23:36:22.353,36,False,10.0
2021,19,3337,620,24,8509,13,6,3,4,0,0,0,0,0,0,False,False,False,0,2,2022-01-19T23:42:23.05,0,False,0.0
2021,19,3337,625,24,3476,2,32,5,-4,7,11,6,1,6,0,False,False,False,0,1,2022-01-17T14:57:23.08,7,False,1.0
2021,19,3337,675,24,7800,13,8,7,48,0,0,0,0,0,0,False,False,False,0,3,2022-01-17T15:14:30.163,0,False,0.0
2021,19,3337,680,24,8509,13,5,3,14,0,0,0,0,0,0,False,False,False,0,2,2022-01-17T15:16:21.697,0,False,0.0
2021,19,3337,715,24,8509,2,49,9,-2,31,33,7,24,7,0,False,False,False,3,2,2022-01-19T23:44:39.963,31,False,24.0
2021,19,3337,740,30,2290,2,30,9,-2,16,18,13,3,13,0,True,False,False,0,4,2022-01-19T23:37:59.4,16,False,3.0
2021,19,3337,745,30,793,2,49,5,-1,3,4,2,1,2,0,False,False,False,0,2,2022-01-17T15:46:33.883,3,False,1.0
2021,19,3337,750,30,63,2,5,9,5,5,0,5,0,5,0,False,False,False,0,4,2022-01-17T15:47:42.123,5,False,0.0
2021,19,3337,755,30,931,13,5,3,5,0,0,0,0,0,0,True,False,False,0,3,2022-01-17T15:49:20.317,0,False,0.0
2021,19,3337,770,24,8509,2,4,5,6,19,13,8,11,8,0,False,False,False,2,3,2022-01-17T15:53:58.077,19,False,11.0
2021,19,3337,780,24,6373,2,39,4,5,17,12,5,12,5,0,False,False,False,1,3,2022-01-19T23:44:52.007,17,False,12.0
2021,19,3337,785,24,7800,13,19,6,45,0,0,0,0,0,0,False,False,False,0,2,2022-01-17T15:57:49.937,0,False,0.0
2021,19,3337,790,24,8509,2,50,5,-1,4,5,2,2,2,0,False,False,False,0,2,2022-01-17T16:00:59.22,4,False,2.0
2021,19,3337,795,24,8513,2,48,9,-3,20,23,15,5,15,0,False,False,False,0,1,2022-01-19T23:42:34.057,20,False,5.0
2021,19,3337,805,24,8509,13,29,6,21,0,0,0,0,0,0,False,False,False,0,2,2022-01-17T16:08:04.313,0,False,0.0
2021,19,3337,810,24,8513,2,16,9,4,16,12,14,2,14,6,False,False,False,2,1,2022-01-19T23:45:06.517,16,False,2.0
2021,19,3337,860,30,931,2,5,5,5,6,1,6,0,6,0,False,False,False,0,3,2022-01-17T16:18:59.557,6,False,0.0
2021,19,3337,895,24,7800,13,12,6,26,0,0,0,0,0,0,False,False,False,0,3,2022-01-17T16:30:38.827,0,False,0.0
2021,19,3337,900,24,6373,2,4,9,11,11,0,11,0,11,0,False,False,False,0,3,2022-01-19T23:42:58.24,11,False,0.0
2021,19,3337,910,24,8509,13,12,6,32,0,0,0,0,0,0,False,False,False,0,2,2022-01-17T16:40:13.71,0,False,0.0
2021,19,3338,25,28,408,2,35,3,13,17,4,17,0,17,0,False,False,False,0,2,2022-01-17T12:30:04.253,17,False,0.0
2021,19,3338,30,28,7619,2,2,10,7,11,4,8,3,8,0,False,False,False,0,2,2022-01-17T12:31:18.787,11,False,3.0
2021,19,3338,40,28,7224,2,50,3,-2,15,17,7,8,7,0,False,False,False,0,2,2022-01-17T12:34:12.163,15,False,8.0
2021,19,3338,80,28,8471,13,5,9,1,0,0,0,0,0,0,False,False,False,0,1,2022-01-19T15:11:30.14,0,False,0.0
2021,19,3338,85,28,7753,13,2,9,6,0,0,0,0,0,0,False,False,False,0,2,2022-01-18T22:16:13.123,0,False,0.0
2021,19,3338,90,28,7753,2,5,3,11,11,0,11,0,11,0,True,False,False,0,3,2022-01-18T22:17:21.18,11,False,0.0
2021,19,3338,110,28,8471,2,31,10,-10,-11,-1,-11,0,-11,0,False,False,False,0,1,2022-01-17T17:45:20.027,-11,False,0.0
2021,19,3338,120,28,262,2,5,10,4,10,6,5,5,5,0,False,False,False,0,1,2022-01-19T15:32:55.077,10,False,5.0
2021,19,3338,135,9,322,13,5,5,5,0,0,0,0,0,0,True,False,False,0,3,2022-01-17T13:14:48.943,0,False,0.0
2021,19,3338,140,9,322,2,4,3,11,10,-1,10,0,10,0,False,False,False,0,2,2022-01-17T13:20:57.793,10,False,0.0
2021,19,3338,150,9,4202,3,45,5,-2,0,0,0,0,0,0,True,False,False,0,1,2022-01-18T19:20:51.993,0,False,0.0
2021,19,3338,155,9,7816,2,12,1,20,32,12,29,3,29,0,False,False,False,0,2,2022-01-17T13:28:32.217,32,False,
2021,19,3338,160,9,6441,2,52,4,3,7,4,7,0,7,0,False,True,False,0,2,2022-01-19T14:51:49.577,6,False,0.0
2021,19,3338,185,28,7619,2,34,4,-4,9,13,4,5,4,0,True,False,False,0,3,2022-01-18T22:17:39.487,9,False,5.0
2021,19,3338,205,28,7224,2,13,4,4,19,15,16,3,16,0,True,False,False,1,3,2022-01-18T22:17:52.04,19,False,3.0
2021,19,3338,220,28,7619,2,12,5,10,10,0,10,0,10,0,False,False,False,0,3,2022-01-19T15:33:31.35,10,False,0.0
2021,19,3338,275,9,6441,2,26,3,1,18,17,14,4,14,0,False,False,False,2,3,2022-01-17T14:20:04.09,18,False,4.0
2021,19,3338,290,9,322,2,9,2,20,20,0,20,0,20,6,False,False,False,0,3,2022-01-18T03:21:34.83,20,True,0.0
2021,19,3338,305,28,7619,2,43,2,26,37,11,36,1,36,0,False,False,False,1,3,2022-01-17T14:25:22.047,37,False,1.0
2021,19,3338,315,28,262,2,6,4,4,5,1,5,0,5,0,False,False,False,0,3,2022-01-17T14:28:05.557,5,False,0.0
2021,19,3338,320,28,4922,13,5,9,5,0,0,0,0,0,0,False,False,False,0,3,2022-01-17T14:29:21.593,0,False,0.0
2021,19,3338,335,9,322,2,2,9,8,9,1,8,1,8,0,True,False,False,0,2,2022-01-18T19:21:27.407,9,False,1.0
2021,19,3338,355,9,6441,13,6,4,13,0,0,0,0,0,0,False,False,False,0,3,2022-01-17T14:45:08.083,0,False,0.0
2021,19,3338,365,9,6446,2,4,3,11,12,1,12,0,12,0,False,False,False,0,3,2022-01-17T14:49:37.86,12,False,0.0
2021,19,3338,370,9,322,2,6,9,6,8,2,7,1,7,0,True,False,False,0,2,2022-01-19T14:51:49.61,8,False,1.0
2021,19,3338,375,9,6446,2,5,3,5,6,1,5,1,5,0,False,False,False,0,3,2022-01-17T14:51:33.547,6,False,1.0
2021,19,3338,380,9,7183,13,31,4,4,0,0,0,0,0,0,False,False,False,0,1,2022-01-17T14:52:59.33,0,False,
2021,19,3338,385,9,4447,13,35,8,16,0,0,0,0,0,0,False,False,False,0,4,2022-01-18T03:28:01.543,0,False,0.0
2021,19,3338,390,9,4202,2,12,10,-15,0,15,-2,2,-2,0,True,False,False,0,1,2022-01-18T19:22:01.237,0,False,2.0
2021,19,3338,395,9,6441,13,4,4,11,0,0,0,0,0,0,False,False,False,0,3,2022-01-17T14:58:32.347,0,False,0.0
2021,19,3338,445,9,6446,2,4,10,5,5,0,5,0,5,0,False,False,False,0,4,2022-01-19T15:34:49.06,5,False,0.0
2021,19,3338,485,9,6441,13,19,2,50,0,0,0,0,0,0,False,False,False,0,2,2022-01-17T15:15:25.97,0,False,0.0
2021,19,3338,490,9,7816,13,3,3,10,0,0,0,0,0,0,False,False,False,0,2,2022-01-18T03:22:35.403,0,False,0.0
2021,19,3338,515,28,262,13,5,5,13,0,0,0,0,0,0,True,False,False,0,3,2022-01-18T22:18:04.51,0,False,0.0
2021,19,3338,520,28,7753,2,5,5,6,13,7,8,5,8,0,False,False,False,0,3,2022-01-17T15:24:57.007,13,False,5.0
2021,19,3338,525,28,6410,13,35,10,12,0,0,0,0,0,0,False,False,False,0,3,2022-01-17T15:26:24.167,0,False,0.0
2021,19,3338,535,28,7753,13,7,3,13,0,0,0,0,0,0,True,False,False,0,3,2022-02-17T16:23:38.827,0,False,0.0
2021,19,3338,545,9,7816,13,5,6,18,0,0,0,0,0,0,False,False,False,0,2,2022-01-19T14:51:49.623,0,False,0.0
2021,19,3338,550,9,6446,2,5,5,10,14,4,12,2,12,0,False,False,False,0,4,2022-01-17T15:34:10.173,14,False,2.0
2021,19,3338,555,9,6446,2,51,9,0,8,8,4,4,4,0,False,False,False,0,3,2022-01-19T15:23:13.223,5,False,4.0
2021,19,3338,565,9,6441,13,4,9,7,0,0,0,0,0,0,False,False,False,0,3,2022-01-19T15:16:56.34,0,False,0.0
2021,19,3338,585,9,322,2,6,10,6,6,0,6,0,6,0,False,False,False,0,2,2022-01-17T15:42:27.71,6,False,0.0
2021,19,3338,590,9,7816,13,3,3,13,0,0,0,0,0,0,False,False,False,0,2,2022-01-17T15:43:23.11,0,False,0.0
2021,19,3338,620,28,7619,2,50,5,-1,-1,0,-1,0,-1,0,False,False,False,0,2,2022-01-17T16:12:26.06,-1,False,0.0
2021,19,3338,625,28,7619,13,22,6,21,0,0,0,0,0,0,False,False,False,0,2,2022-01-18T22:17:05.663,0,False,0.0
2021,19,3338,640,9,7816,2,4,3,14,18,4,14,4,14,0,False,False,False,1,2,2022-01-19T15:26:03.45,18,False,
2021,19,3338,645,9,6441,2,35,1,21,24,3,21,3,21,0,False,False,False,0,3,2022-01-19T14:51:49.623,24,False,3.0
2021,19,3338,660,9,6441,2,6,4,5,5,0,5,0,5,0,True,False,False,0,3,2022-01-18T19:22:31.91,5,False,0.0
2021,19,3338,670,9,322,13,13,10,3,0,0,0,0,0,0,False,False,False,0,3,2022-02-25T16:30:13.003,0,False,0.0
2021,19,3338,675,9,3755,2,4,5,7,16,9,16,0,16,0,False,False,False,0,2,2022-01-17T16:26:43.637,16,False,0.0
2021,19,3338,685,9,322,13,12,3,14,0,0,0,0,0,0,False,False,False,0,2,2022-02-25T16:30:40.707,0,False,0.0
2021,19,3338,690,9,6712,2,4,3,5,6,1,6,0,6,0,False,False,False,1,2,2022-01-17T16:29:22.26,6,False,0.0
2021,19,3338,695,9,7183,2,32,3,1,2,1,2,0,2,0,False,False,False,0,3,2022-01-17T16:30:29.593,2,False,0.0
2021,19,3338,710,28,4922,2,2,4,9,18,9,14,4,14,0,False,False,False,0,4,2022-01-17T16:37:32.753,18,False,4.0
2021,19,3338,725,28,6410,13,12,5,7,0,0,0,0,0,0,False,False,False,0,3,2022-01-19T15:24:52.337,0,False,0.0
2021,19,3338,730,9,322,2,4,3,11,11,0,11,0,11,0,True,False,False,0,2,2022-01-17T16:46:34.81,11,False,0.0
2021,19,3338,735,9,7816,2,4,5,10,10,0,10,0,10,0,False,False,False,0,2,2022-01-19T14:51:49.623,10,False,0.0
2021,19,3338,740,9,322,13,12,3,7,0,0,0,0,0,0,False,False,False,0,2,2022-01-17T16:50:14.337,0,False,0.0
2021,19,3338,775,28,7753,2,4,5,5,5,0,5,0,5,0,False,False,False,0,3,2022-01-17T16:57:26.723,5,False,0.0
2021,19,3338,790,28,4922,13,30,9,-2,0,0,0,0,0,0,False,False,False,0,4,2022-01-17T17:04:13.85,0,False,0.0
2021,19,3338,800,28,7224,13,6,4,12,0,0,0,0,0,0,False,False,False,0,3,2022-01-18T03:24:09.413,0,False,
2021,19,3338,815,28,7224,2,13,4,4,4,0,4,0,4,0,True,False,False,0,3,2022-01-19T16:18:26.81,4,False,0.0
2021,19,3338,835,9,6446,13,5,3,5,0,0,0,0,0,0,True,False,False,0,3,2022-01-18T03:24:37.197,0,False,0.0
2021,19,3338,840,9,6446,2,35,2,19,38,19,37,1,37,0,False,False,False,0,4,2022-03-03T14:21:03.103,38,False,1.0
2021,19,3338,850,9,7816,3,13,10,3,0,0,0,0,0,0,False,False,False,0,3,2022-01-17T17:18:19.69,0,False,0.0
2021,19,3338,860,9,4202,13,12,5,6,0,0,0,0,0,0,False,False,False,0,1,2022-02-24T20:29:51.093,0,False,0.0
2021,19,3338,865,9,6441,13,12,2,31,0,0,0,0,0,0,False,False,False,0,3,2022-01-17T17:22:10.433,0,False,0.0
2021,19,3338,935,9,6441,2,6,9,11,9,-2,9,0,9,0,False,False,False,0,2,2022-01-17T17:33:52.473,9,False,0.0
2021,19,3338,940,9,7183,2,51,3,-4,10,14,10,0,10,0,True,False,False,0,1,2022-01-17T17:35:32.483,10,False,0.0
2021,19,3338,945,9,6446,2,5,3,8,9,1,9,0,9,0,False,False,False,0,3,2022-01-17T17:36:26.233,9,False,0.0
2021,19,3339,20,25,7060,13,9,2,17,0,0,0,0,0,0,False,False,False,0,2,2022-01-17T10:06:56.56,0,False,0.0
2021,19,3339,35,16,7176,2,51,9,-4,-4,0,-4,0,-4,0,False,False,False,0,3,2022-01-17T10:12:19.673,-4,False,0.0
2021,19,3339,40,16,374,13,4,4,10,0,0,0,0,0,0,False,False,False,0,3,2022-01-17T10:15:36.72,0,False,0.0
2021,19,3339,50,25,4227,13,5,3,3,0,0,0,0,0,0,False,False,False,0,3,2022-01-18T18:39:37.297,0,False,0.0
2021,19,3339,60,25,8422,13,9,5,10,0,0,0,0,0,0,False,False,False,0,3,2022-01-17T10:25:22.987,0,False,0.0
2021,19,3339,70,16,797,2,48,9,-3,20,23,18,2,18,0,False,False,False,0,1,2022-01-17T10:35:09.247,20,False,2.0
2021,19,3339,80,16,374,13,6,4,10,0,0,0,0,0,0,False,False,False,0,3,2022-01-17T10:35:22.49,0,False,0.0
2021,19,3339,85,16,6500,2,13,9,4,5,1,5,0,5,0,False,False,False,0,3,2022-01-17T10:37:25.953,5,False,0.0
2021,19,3339,100,25,8422,2,4,3,3,3,0,3,0,3,0,True,False,False,0,4,2022-01-17T10:42:14.627,3,False,0.0
2021,19,3339,115,16,4143,13,35,10,2,0,0,0,0,0,0,False,False,False,0,3,2022-01-19T16:55:57.94,0,False,0.0
2021,19,3339,120,25,7060,2,2,4,4,4,0,4,0,4,0,False,False,False,0,2,2022-01-19T15:43:57.023,4,False,0.0
2021,19,3339,125,25,4583,2,5,5,3,7,4,4,3,4,0,False,False,False,0,3,2022-01-19T16:58:40.27,7,False,3.0
2021,19,3339,135,25,7060,3,2,10,2,0,0,0,0,0,0,False,False,False,0,2,2022-01-17T10:55:43.383,0,False,0.0
2021,19,3339,145,25,4583,13,17,7,16,0,0,0,0,0,0,False,False,False,0,3,2022-01-17T10:58:33.53,0,False,0.0
2021,19,3339,155,16,4143,2,4,5,5,5,0,5,0,5,0,False,False,False,0,2,2022-01-17T11:01:58.11,5,False,0.0
2021,19,3339,165,16,7176,2,30,5,0,4,4,2,2,2,0,False,False,False,0,4,2022-01-17T11:06:05.92,4,False,2.0
2021,19,3339,185,16,4143,2,4,10,14,15,1,15,0,15,0,False,False,False,0,2,2022-01-19T17:17:48.93,15,False,0.0
2021,19,3339,190,16,8537,13,4,10,5,0,0,0,0,0,0,False,False,False,0,3,2022-01-17T11:15:36.01,0,False,0.0
2021,19,3339,200,16,6500,13,12,6,23,0,0,0,0,0,0,False,False,False,0,3,2022-01-19T16:56:13.48,0,False,0.0
2021,19,3339,225,25,7060,2,13,9,3,5,2,4,1,4,0,False,False,False,0,2,2022-01-17T11:32:26.753,5,False,1.0
2021,19,3339,240,25,7060,13,19,6,27,0,0,0,0,0,0,False,False,False,0,2,2022-01-17T11:38:14.897,0,False,0.0
2021,19,3339,270,16,3938,2,4,7,18,20,2,17,3,17,0,False,False,False,1,2,2022-01-19T16:57:49.107,20,False,3.0
2021,19,3339,275,16,3938,2,5,3,3,2,-1,2,0,2,0,False,False,False,0,3,2022-01-17T12:02:59.95,2,False,0.0
2021,19,3339,280,16,797,2,48,9,-4,14,18,11,3,11,0,False,False,False,1,1,2022-01-19T17:02:57.99,14,False,3.0
2021,19,3339,300,16,374,2,33,10,6,15,9,11,4,11,0,False,False,False,0,3,2022-01-19T17:16:03.593,15,False,4.0
2021,19,3339,305,16,797,2,32,10,-6,5,11,3,2,3,0,False,False,False,0,1,2022-01-19T16:57:58.397,5,False,2.0
2021,19,3339,310,16,797,2,48,10,-2,4,6,4,0,4,6,False,False,False,0,1,2022-01-17T12:36:02.953,4,True,0.0
2021,19,3339,325,25,7666,13,8,7,27,0,0,0,0,0,0,False,False,False,0,2,2022-01-19T16:58:08.317,0,False,0.0
2021,19,3339,335,25,7060,3,2,9,1,0,0,0,0,0,0,False,False,False,0,2,2022-01-17T12:44:33.933,0,False,0.0
2021,19,3339,345,16,6500,13,4,4,10,0,0,0,0,0,0,False,False,False,0,3,2022-01-19T18:19:36.25,0,False,0.0
2021,19,3339,350,16,374,2,6,9,6,31,25,22,9,22,0,True,False,False,1,3,2022-01-19T16:58:59.457,31,False,9.0
2021,19,3339,365,16,3938,2,45,10,-4,0,4,0,0,0,0,False,False,False,1,3,2022-01-19T16:59:21.817,0,False,0.0
2021,19,3339,370,16,2568,2,53,10,-2,3,5,-1,4,-1,0,False,False,False,1,4,2022-01-19T17:00:15.953,3,False,4.0
2021,19,3339,380,16,6500,2,21,5,12,12,0,12,0,12,6,False,False,False,0,2,2022-01-17T13:09:15.653,12,True,0.0
2021,19,3339,400,25,8422,2,46,3,-1,5,6,3,2,3,0,False,False,False,0,4,2022-01-17T13:13:06.44,5,False,2.0
2021,19,3339,405,25,7666,13,19,2,25,0,0,0,0,0,0,False,False,False,0,2,2022-01-19T16:56:23.54,0,False,0.0
2021,19,3339,420,16,797,2,44,3,-4,15,19,14,1,14,0,True,False,False,0,1,2022-01-17T13:18:53.557,15,False,1.0
2021,19,3339,425,16,4143,2,22,2,26,27,1,27,0,27,0,False,False,False,0,2,2022-01-19T16:04:50.443,27,False,0.0
2021,19,3339,440,16,8537,13,12,9,9,0,0,0,0,0,0,False,False,False,0,3,2022-01-17T13:42:46.003,0,False,0.0
2021,19,3339,445,16,374,2,35,2,26,48,22,48,0,48,6,False,False,False,0,3,2022-01-19T16:04:50.46,48,True,0.0
2021,19,3339,485,16,4143,2,2,9,6,29,23,25,4,25,0,False,False,False,0,2,2022-01-17T13:58:08.09,29,False,4.0
2021,19,3339,495,16,374,2,50,3,-2,8,10,4,4,4,0,False,False,False,1,2,2022-01-19T16:04:50.473,8,False,4.0
2021,19,3339,500,16,797,2,48,4,-6,23,29,19,4,19,0,False,False,False,0,1,2022-01-17T14:05:05.397,23,False,4.0
2021,19,3339,510,16,3938,2,54,10,-2,4,6,4,0,4,0,True,False,False,0,3,2022-01-17T14:11:52.627,4,False,0.0
2021,19,3339,515,16,7156,2,31,10,1,1,0,1,0,1,6,False,False,False,0,4,2022-01-17T14:14:31.88,1,True,0.0
2021,19,3339,530,25,8421,2,45,5,-5,0,5,0,0,0,0,False,True,True,0,1,2022-01-19T16:59:35.427,-1,False,0.0
2021,19,3339,540,16,3938,2,19,2,31,31,0,31,0,31,6,False,False,False,0,3,2022-01-17T14:23:11.813,31,True,0.0
2021,19,3339,565,25,7666,2,2,9,11,16,5,11,5,11,0,False,False,False,0,2,2022-01-17T14:27:43.363,16,False,5.0
2021,19,3339,570,25,8421,2,28,9,-6,0,6,0,0,0,0,False,False,False,0,1,2022-01-17T14:30:00.18,0,False,0.0
2021,19,3339,575,25,4583,2,16,4,4,6,2,5,1,5,0,False,False,False,0,3,2022-01-17T14:31:44.44,6,False,1.0
2021,19,3339,580,25,8422,2,46,3,-2,8,10,-1,9,-1,0,False,False,False,1,4,2022-01-17T14:33:53.333,8,False,9.0
2021,19,3339,585,25,7666,2,2,9,2,5,3,3,2,3,0,False,False,False,1,2,2022-01-17T14:35:17.143,5,False,2.0
2021,19,3339,595,25,4583,2,46,3,2,5,3,4,1,4,0,False,False,False,0,3,2022-01-18T18:39:51.313,5,False,1.0
2021,19,3339,600,25,6486,2,9,6,19,22,3,23,-1,23,0,False,False,False,0,2,2022-01-17T14:40:53.12,22,False,-1.0
2021,19,3339,605,25,7060,2,19,10,13,13,0,13,0,13,6,False,False,False,0,2,2022-01-17T14:46:46.683,13,True,0.0
2021,19,3339,625,16,374,2,5,10,5,6,1,5,1,5,0,False,False,False,0,3,2022-01-17T14:59:46.17,6,False,1.0
2021,19,3339,630,16,6500,2,26,5,1,15,14,10,5,10,0,False,False,False,0,3,2022-01-17T15:02:40.373,15,False,5.0
2021,19,3339,635,16,6500,2,18,5,-2,3,5,2,1,2,0,False,False,False,0,2,2022-01-17T15:04:20.233,3,False,1.0
2021,19,3339,640,16,7176,2,7,6,15,41,26,15,26,15,0,False,False,False,1,3,2022-01-19T18:19:47.23,41,False,26.0
2021,19,3339,665,16,6500,2,2,4,2,2,0,2,0,2,6,False,False,False,0,2,2022-01-17T15:27:56.113,2,True,0.0
2021,19,3339,685,25,4583,2,26,10,2,1,-1,2,-1,2,0,False,False,False,1,3,2022-01-17T15:33:20.297,1,False,-1.0
2021,19,3339,690,25,7666,2,26,10,1,4,3,2,2,2,0,False,False,False,0,2,2022-01-17T15:34:48.897,4,False,2.0
2021,19,3339,700,25,6486,3,6,4,4,0,0,0,0,0,0,False,False,False,0,3,2022-01-17T15:39:57.677,0,False,
2021,19,3339,705,25,6486,13,9,2,30,0,0,0,0,0,0,False,False,False,0,2,2022-01-17T15:44:02.61,0,False,0.0
2021,19,3339,710,25,6259,13,5,9,12,0,0,0,0,0,0,False,False,False,0,3,2022-01-17T15:48:06.513,0,False,
2021,19,3339,720,25,4583,2,47,5,1,7,6,6,1,6,0,False,False,False,0,3,2022-01-17T15:51:46.09,7,False,1.0
2021,19,3339,725,25,8422,2,2,4,3,9,6,3,6,3,0,False,False,False,1,3,2022-01-19T17:00:25.693,9,False,6.0
2021,19,3339,730,25,7666,13,12,9,10,0,0,0,0,0,0,False,False,False,0,2,2022-01-19T17:02:31.27,0,False,0.0
2021,19,3339,740,25,7060,13,19,2,26,0,0,0,0,0,0,False,False,False,0,2,2022-01-19T17:19:01.67,0,False,0.0
2021,19,3339,745,25,6259,2,39,4,4,8,4,6,2,6,0,False,False,False,1,3,2022-01-17T16:01:23.82,8,False,2.0
2021,19,3339,750,25,7666,3,9,6,16,0,0,0,0,0,0,False,False,False,0,2,2022-01-17T16:03:17.663,0,False,0.0
2021,19,3339,755,25,7060,2,2,5,1,5,4,4,1,4,0,False,False,False,0,2,2022-01-17T16:05:44.627,5,False,1.0
2021,19,3339,760,25,6486,2,21,6,15,15,0,15,0,15,6,False,False,False,0,2,2022-01-17T16:08:39.463,15,True,0.0
2021,19,3339,790,16,7176,2,51,5,-4,2,6,0,2,0,0,False,False,False,2,2,2022-01-19T17:17:11.04,2,False,2.0
2021,19,3339,815,25,7081,2,48,9,-1,5,6,5,0,5,0,False,False,False,0,1,2022-01-17T16:41:26.99,5,False,0.0
2021,19,3339,820,25,4583,13,13,9,3,0,0,0,0,0,0,False,False,False,0,3,2022-01-17T16:43:25.397,0,False,0.0
2021,19,3339,825,25,7053,2,4,4,5,5,0,5,0,5,0,False,False,False,0,4,2022-01-17T16:46:05.76,5,False,0.0
2021,19,3339,830,25,7060,2,4,10,4,7,3,6,1,6,0,False,False,False,0,2,2022-01-17T16:53:51.713,7,False,1.0
2021,19,3339,835,25,7053,2,39,4,5,7,2,5,2,5,0,False,False,False,1,4,2022-01-17T16:49:44.03,7,False,2.0
2021,19,3339,845,25,4583,3,5,5,3,0,0,0,0,0,0,False,False,False,0,3,2022-01-17T16:53:37.377,0,False,0.0
2021,19,3339,860,25,7053,2,13,10,2,10,8,3,7,3,0,False,False,False,2,4,2022-01-17T16:58:34.583,10,False,7.0
2021,19,3339,870,25,6259,2,2,10,11,12,1,12,0,12,0,False,False,False,0,2,2022-01-19T16:04:50.537,12,False,0.0
2021,19,3339,875,25,7081,2,28,4,3,11,8,8,3,8,0,False,False,False,0,1,2022-01-17T17:02:37.167,11,False,3.0
2021,19,3339,885,25,7053,2,4,10,5,11,6,10,1,10,0,False,False,False,0,3,2022-01-17T17:04:47.48,11,False,1.0
2021,19,3340,15,1,5032,2,53,9,-5,2,7,2,0,2,0,False,False,False,0,4,2022-01-18T11:09:38.16,2,False,0.0
2021,19,3340,20,1,910,13,9,2,29,0,0,0,0,0,0,False,False,False,0,2,2022-01-18T11:12:00.597,0,False,0.0
2021,19,3340,35,29,4866,2,30,10,0,5,5,1,4,1,0,False,False,False,0,4,2022-01-20T16:14:31.763,5,False,4.0
2021,19,3340,65,1,6405,13,6,4,10,0,0,0,0,0,0,False,False,False,0,3,2022-01-18T11:24:14.413,0,False,0.0
2021,19,3340,70,1,8439,13,12,2,45,0,0,0,0,0,0,False,False,False,0,3,2022-02-24T20:31:12.093,0,False,0.0
2021,19,3340,80,29,1067,2,2,4,13,17,4,17,0,17,0,False,False,False,0,2,2022-01-20T16:16:10.877,17,False,0.0
2021,19,3340,110,29,3398,2,6,9,13,22,9,15,7,15,0,False,False,False,1,3,2022-01-18T11:48:37.29,22,False,7.0
2021,19,3340,125,29,1067,2,9,3,4,4,0,4,0,4,6,False,False,False,0,2,2022-01-18T11:51:56.72,4,True,0.0
2021,19,3340,150,1,6405,2,50,3,-5,-4,1,-4,0,-4,0,False,False,False,0,2,2022-01-18T16:32:55.2,0,True,0.0
2021,19,3340,175,29,3398,2,26,4,8,14,6,9,5,9,0,False,False,False,1,4,2022-01-18T12:15:14.333,14,False,5.0
2021,19,3340,200,29,1067,2,9,6,15,31,16,31,0,31,0,False,False,False,0,2,2022-01-18T13:01:08.31,31,True,0.0
2021,19,3340,235,1,6405,13,12,10,11,0,0,0,0,0,0,False,False,False,0,2,2022-01-20T16:15:01.31,0,False,0.0
2021,19,3340,240,1,8439,2,32,3,0,6,6,4,2,4,0,False,False,False,0,3,2022-01-18T12:21:11.043,6,False,2.0
2021,19,3340,260,29,7788,3,19,2,26,0,0,0,0,0,0,False,False,False,0,2,2022-01-18T12:27:21.85,0,False,0.0
2021,19,3340,275,1,910,13,9,2,20,0,0,0,0,0,0,False,False,False,0,2,2022-01-20T16:08:39.283,0,False,0.0
2021,19,3340,280,1,8439,13,12,5,-1,0,0,0,0,0,0,False,False,False,0,3,2022-01-20T16:11:19.757,0,False,0.0
2021,19,3340,295,1,894,2,53,10,-1,5,6,4,1,4,0,False,False,False,0,4,2022-01-18T12:40:33.42,5,False,1.0
2021,19,3340,305,1,6406,13,12,6,16,0,0,0,0,0,0,False,False,False,0,1,2022-01-18T12:43:48.113,0,False,0.0
2021,19,3340,310,1,8439,2,4,9,11,11,0,11,0,11,0,False,False,False,0,3,2022-01-20T16:09:38.043,11,False,0.0
2021,19,3340,320,1,8439,2,51,9,-6,-2,4,-3,1,-3,0,True,False,False,0,3,2022-01-18T12:50:15.057,-2,False,1.0
2021,19,3340,325,1,4587,3,48,10,3,0,0,0,0,0,0,False,False,False,0,1,2022-01-20T16:11:30.873,0,False,0.0
2021,19,3340,330,29,4866,13,5,6,21,0,0,0,0,0,0,False,False,False,0,3,2022-01-18T12:55:28.853,0,False,0.0
2021,19,3340,335,29,1067,2,6,9,10,24,14,21,3,21,0,False,False,False,0,3,2022-01-18T12:56:37.593,24,False,
2021,19,3340,360,1,5032,13,12,5,2,0,0,0,0,0,0,False,False,False,0,4,2022-01-18T13:04:13.24,0,False,0.0
2021,19,3340,365,1,894,13,6,4,7,0,0,0,0,0,0,False,False,False,0,3,2022-01-18T13:05:37.823,0,False,0.0
2021,19,3340,370,1,8439,2,38,9,0,6,6,6,0,6,0,False,False,False,0,3,2022-01-18T13:07:59.507,6,False,0.0
2021,19,3340,395,29,3398,3,5,3,6,0,0,0,0,0,0,False,False,False,0,3,2022-01-18T13:12:15.493,0,False,0.0
2021,19,3340,430,29,3398,2,16,9,3,10,7,8,2,8,0,True,False,False,0,3,2022-01-18T13:41:18.12,10,False,2.0
2021,19,3340,435,29,4866,3,4,10,8,0,0,0,0,0,0,False,False,False,0,3,2022-01-20T16:11:56.48,0,False,0.0
2021,19,3340,440,29,1067,2,50,10,-1,2,3,1,1,1,0,False,False,False,0,2,2022-01-18T13:44:08.537,2,False,1.0
2021,19,3340,445,29,4866,13,19,6,38,0,0,0,0,0,0,False,False,False,0,2,2022-01-18T13:46:32.457,0,False,
2021,19,3340,450,29,7788,2,11,2,26,40,14,34,6,34,0,False,False,False,0,1,2022-01-18T13:52:26.063,40,False,6.0
2021,19,3340,460,29,4866,2,30,5,1,4,3,4,0,4,0,False,False,False,0,3,2022-01-18T13:52:07.437,4,False,0.0
2021,19,3340,465,29,4866,2,5,5,6,7,1,7,0,7,6,False,False,False,0,3,2022-01-18T13:53:44.26,7,True,0.0
2021,19,3340,485,1,8439,2,12,5,9,11,2,9,2,9,0,False,False,False,0,3,2022-01-20T16:12:07.593,11,False,2.0
2021,19,3340,495,1,5032,2,44,3,-6,0,6,-2,2,-2,0,False,False,False,0,1,2022-01-20T16:14:06.843,0,False,2.0
2021,19,3340,510,1,6405,2,5,3,7,7,0,7,0,7,0,False,False,False,0,3,2022-01-18T16:31:26.223,7,False,0.0
2021,19,3340,525,1,6405,2,17,8,17,23,6,20,3,20,0,False,False,False,1,3,2022-01-18T16:31:13.34,23,False,3.0
2021,19,3340,530,1,4587,2,49,9,-1,5,6,0,5,0,0,True,False,False,0,2,2022-01-19T20:50:38.6,5,False,5.0
2021,19,3340,555,29,7828,2,8,8,32,41,9,34,7,34,0,False,False,False,0,3,2022-01-18T14:23:09.863,41,False,7.0
2021,19,3340,595,1,6405,2,5,3,7,7,0,7,0,7,0,False,False,False,0,2,2022-01-18T16:30:53.657,7,False,0.0
2021,19,3340,600,1,894,2,51,10,-1,4,5,3,1,3,0,False,False,False,0,3,2022-01-18T14:39:27.26,4,False,1.0
2021,19,3340,605,1,6405,2,2,4,6,8,2,6,2,6,0,False,False,False,0,3,2022-01-18T16:30:38.327,8,False,2.0
2021,19,3340,615,1,7762,2,44,9,-5,13,18,10,3,10,0,False,False,False,0,1,2022-01-20T15:11:25.813,13,False,3.0
2021,19,3340,620,1,894,2,6,9,11,12,1,12,0,12,0,False,False,False,0,4,2022-01-18T14:45:51.68,12,False,0.0
2021,19,3340,630,1,6405,13,12,9,5,0,0,0,0,0,0,False,False,False,0,3,2022-01-18T14:48:34.503,0,False,0.0
2021,19,3340,635,1,6933,13,9,6,24,0,0,0,0,0,0,False,False,False,0,3,2022-01-18T14:51:15.917,0,False,0.0
2021,19,3340,640,1,6405,2,12,8,16,16,0,16,0,16,0,False,False,False,0,3,2022-01-18T16:30:24.187,16,True,
2021,19,3340,660,29,7788,2,44,3,-4,14,18,14,0,14,0,False,False,False,1,1,2022-01-18T14:59:01.33,14,True,
2021,19,3340,675,29,4866,2,2,4,8,29,21,23,6,23,0,False,False,False,0,3,2022-01-18T15:03:59.06,29,False,6.0
2021,19,3340,685,29,4866,2,5,5,3,16,13,5,11,5,0,False,False,False,2,2,2022-01-18T15:06:33.4,16,False,11.0
2021,19,3340,725,1,7762,2,48,9,-2,13,15,11,2,11,0,False,False,False,0,1,2022-01-18T15:13:51.337,13,False,2.0
2021,19,3340,730,1,6405,13,17,7,27,0,0,0,0,0,0,False,False,False,0,3,2022-01-18T15:16:38.147,0,False,0.0
2021,19,3340,735,1,910,13,3,5,13,0,0,0,0,0,0,False,False,False,0,2,2022-01-18T15:18:38.48,0,False,0.0
2021,19,3340,745,1,6405,2,5,5,6,6,0,6,0,6,0,False,False,False,0,3,2022-01-18T16:30:07.553,6,False,0.0
2021,19,3340,750,1,6933,13,5,3,11,0,0,0,0,0,0,False,False,False,0,2,2022-01-20T16:13:00.24,0,False,0.0
2021,20,3341,10,31,661,13,4,8,17,0,0,0,0,0,0,False,False,False,0,2,2022-01-23T13:37:07.593,0,False,0.0
2021,20,3341,20,7,4679,2,6,9,1,21,20,6,15,6,0,False,False,False,3,1,2022-01-27T13:15:36.177,21,False,15.0
2021,20,3341,30,7,4679,13,5,9,2,0,0,0,0,0,0,False,False,False,0,1,2022-02-17T16:59:10.877,0,False,0.0
2021,20,3341,40,7,7659,2,2,10,7,8,1,7,1,7,0,False,False,False,0,2,2022-01-23T11:44:07.127,8,False,1.0
2021,20,3341,75,7,2631,13,5,3,4,0,0,0,0,0,0,False,False,False,0,4,2022-01-23T11:51:21.043,0,False,0.0
2021,20,3341,85,7,4455,2,48,9,-1,4,5,2,2,2,0,False,False,False,0,1,2022-01-23T11:54:28.307,4,False,2.0
2021,20,3341,95,31,661,2,30,10,0,11,11,7,4,7,0,False,False,False,0,3,2022-01-23T11:57:07.87,11,False,4.0
2021,20,3341,115,31,6888,3,32,5,1,0,0,0,0,0,0,False,False,False,0,1,2022-01-23T12:04:00.683,0,False,0.0
2021,20,3341,120,31,6793,13,2,9,9,0,0,0,0,0,0,False,False,False,0,2,2022-01-23T12:06:27.293,0,False,0.0
2021,20,3341,140,7,8317,2,18,3,0,57,57,1,56,1,0,False,False,False,1,2,2022-01-27T12:33:30.42,57,False,56.0
2021,20,3341,155,7,7659,2,6,10,3,7,4,7,0,7,0,False,False,False,0,2,2022-01-23T12:14:22.8,7,False,0.0
2021,20,3341,175,31,661,2,4,9,4,13,9,10,3,10,0,False,False,False,0,3,2022-01-23T12:20:18.423,13,False,3.0
2021,20,3341,180,31,6793,13,8,8,37,0,0,0,0,0,0,False,False,False,0,2,2022-01-23T12:21:41.747,0,False,0.0
2021,20,3341,185,31,3911,2,51,5,-1,3,4,2,1,2,0,False,False,False,1,3,2022-01-27T13:16:14.273,3,False,1.0
2021,20,3341,210,7,8317,13,2,5,6,0,0,0,0,0,0,False,False,False,0,2,2022-01-23T12:30:40.297,0,False,0.0
2021,20,3341,220,7,7659,2,5,6,18,19,1,19,0,19,0,False,False,False,0,3,2022-01-23T12:32:32.613,19,False,0.0
2021,20,3341,235,7,2631,2,33,10,-2,7,9,6,1,6,0,False,False,False,0,3,2022-01-23T12:37:14.453,7,False,1.0
2021,20,3341,245,31,6793,2,22,8,34,41,7,36,5,36,0,False,False,False,0,3,2022-01-27T13:12:06.773,41,False,5.0
2021,20,3341,260,31,6722,2,44,3,-1,3,4,1,2,1,0,True,False,False,0,1,2022-01-27T13:16:27.333,3,False,2.0
2021,20,3341,270,31,661,2,35,10,11,13,2,12,1,12,0,False,False,False,0,3,2022-01-23T12:51:01.877,13,False,1.0
2021,20,3341,275,31,6793,2,26,5,1,8,7,2,6,2,0,False,False,False,1,3,2022-01-23T12:52:33.803,8,False,6.0
2021,20,3341,305,7,3521,13,6,7,15,0,0,0,0,0,0,False,False,False,0,3,2022-01-27T13:16:41.97,0,False,0.0
2021,20,3341,310,7,3521,2,4,4,5,7,2,6,1,6,0,False,False,False,0,3,2022-01-23T13:01:20.853,7,False,1.0
2021,20,3341,320,7,2631,2,4,9,5,6,1,5,1,5,0,False,False,False,0,3,2022-01-23T13:03:23.397,6,False,1.0
2021,20,3341,330,7,7659,2,5,5,8,15,7,13,2,13,0,False,False,False,0,3,2022-01-23T13:05:42.817,15,False,2.0
2021,20,3341,335,7,4679,2,47,5,-2,4,6,2,2,2,0,False,False,False,0,1,2022-01-23T13:06:56.617,4,False,2.0
2021,20,3341,340,7,7659,2,6,10,13,22,9,20,2,20,0,False,False,False,0,3,2022-01-23T13:08:15.77,22,False,2.0
2021,20,3341,360,7,2631,2,48,9,0,1,1,1,0,1,0,True,False,False,0,1,2022-01-23T13:12:46.37,1,False,0.0
2021,20,3341,395,31,6793,13,5,5,14,0,0,0,0,0,0,False,False,False,0,2,2022-01-23T13:17:31.18,0,False,0.0
2021,20,3341,400,31,6724,13,12,9,4,0,0,0,0,0,0,False,False,False,0,3,2022-01-27T14:00:01.523,0,False,0.0
2021,20,3341,420,7,4679,2,31,9,-2,5,7,4,1,4,0,False,False,False,0,1,2022-01-23T13:24:18.227,5,False,1.0
2021,20,3341,425,7,7659,13,5,5,13,0,0,0,0,0,0,False,False,False,0,2,2022-01-23T13:26:39.6,0,False,0.0
2021,20,3341,430,7,3521,2,29,5,7,10,3,10,0,10,0,False,False,False,0,3,2022-01-23T13:28:18.99,10,False,0.0
2021,20,3341,435,7,4679,2,4,4,4,11,7,9,2,9,0,False,False,False,1,1,2022-01-27T13:24:28.28,11,False,2.0
2021,20,3341,450,7,2631,2,17,4,7,32,25,28,4,28,0,False,False,False,0,3,2022-01-23T13:32:33.9,32,False,4.0
2021,20,3341,465,7,4679,2,4,10,3,7,4,6,1,6,0,False,False,False,0,1,2022-01-23T13:43:45.773,7,False,1.0
2021,20,3341,475,7,7659,2,30,3,0,12,12,12,0,12,0,True,False,False,0,4,2022-01-23T13:46:26.65,12,True,0.0
2021,20,3341,495,7,2631,2,39,4,5,11,6,8,3,8,0,False,False,False,2,4,2022-01-23T13:50:10.427,11,False,3.0
2021,20,3341,540,31,3911,13,51,5,-11,0,0,0,0,0,0,False,False,False,0,3,2022-01-27T13:12:34.043,0,False,0.0
2021,20,3341,550,7,8317,2,18,9,-2,4,6,2,2,2,0,False,False,False,0,3,2022-01-23T14:05:29.807,4,False,2.0
2021,20,3341,555,7,7659,13,2,9,7,0,0,0,0,0,0,False,False,False,0,3,2022-01-23T14:07:09.683,0,False,0.0
2021,20,3341,575,31,6793,2,23,7,37,40,3,40,0,40,0,False,False,False,0,3,2022-01-23T14:11:55.58,40,False,0.0
2021,20,3341,585,31,6793,13,13,4,1,0,0,0,0,0,0,False,False,False,0,2,2022-01-23T14:16:36.157,0,False,0.0
2021,20,3341,595,31,6722,2,28,9,3,5,2,5,0,5,0,False,False,False,0,1,2022-01-27T13:24:38.863,5,False,0.0
2021,20,3341,610,7,4455,3,46,9,2,0,0,0,0,0,0,False,False,False,0,1,2022-01-27T13:17:29.64,0,False,0.0
2021,20,3341,625,31,6793,2,21,2,32,33,1,32,1,32,6,False,False,False,0,2,2022-01-23T15:49:51.757,33,False,1.0
2021,20,3341,640,7,2631,2,39,4,5,7,2,7,0,7,0,False,False,False,0,3,2022-01-23T14:58:16.61,7,False,0.0
2021,20,3341,655,7,8317,2,30,10,0,21,21,0,21,0,0,False,False,False,2,3,2022-01-27T13:14:23.827,21,False,21.0
2021,20,3341,665,7,8317,2,12,3,0,8,8,3,5,3,0,False,False,False,1,3,2022-01-23T15:03:09.547,8,False,5.0
2021,20,3341,690,31,6793,2,12,6,20,20,0,20,0,20,0,False,False,False,0,2,2022-01-23T15:08:41.567,20,False,0.0
2021,20,3341,695,31,661,2,5,3,6,6,0,6,0,6,0,False,False,False,0,3,2022-01-23T15:09:55.077,6,True,0.0
2021,20,3341,700,31,661,2,13,3,3,3,0,3,0,3,0,False,False,False,0,2,2022-01-27T13:14:37.097,3,False,0.0
2021,20,3341,720,7,7659,2,6,10,3,13,10,7,6,7,0,False,False,False,1,2,2022-01-23T15:17:37.97,13,False,6.0
2021,20,3341,725,7,2631,2,4,9,4,7,3,5,2,5,0,False,False,False,0,3,2022-01-23T15:18:59.647,7,False,2.0
2021,20,3341,740,7,4679,2,4,4,3,3,0,3,0,3,0,False,False,False,0,1,2022-01-23T15:21:45.137,3,False,0.0
2021,20,3341,765,31,661,2,6,4,12,16,4,14,2,14,0,False,False,False,0,3,2022-01-27T13:17:44.473,16,False,2.0
2021,20,3341,780,31,6722,2,4,9,5,5,0,5,0,5,0,False,False,False,0,1,2022-01-23T15:30:18.817,5,False,0.0
2021,20,3341,785,31,7913,13,4,9,13,0,0,0,0,0,0,False,False,False,0,3,2022-01-23T15:33:02.59,0,False,0.0
2021,20,3341,790,7,8317,2,7,2,17,19,2,19,0,19,0,False,False,False,0,2,2022-01-23T15:34:19.037,19,True,0.0
2021,20,3342,15,12,556,2,2,10,8,14,6,12,2,12,0,False,False,False,0,2,2022-01-23T10:11:31.04,14,False,2.0
2021,20,3342,25,12,4537,2,45,5,-5,19,24,4,15,4,0,False,False,False,1,1,2022-01-23T10:16:40.067,19,False,15.0
2021,20,3342,30,12,4537,3,48,4,-2,0,0,0,0,0,0,False,False,False,0,1,2022-01-23T10:18:17.37,0,False,0.0
2021,20,3342,35,12,556,2,6,4,11,10,-1,10,0,10,0,False,False,False,0,3,2022-01-23T10:20:29.277,10,False,0.0
2021,20,3342,45,12,556,2,2,4,6,11,5,11,0,11,0,False,False,False,0,3,2022-01-23T10:26:41.977,11,False,0.0
2021,20,3342,95,12,556,2,51,3,1,7,6,7,0,7,0,False,False,False,1,3,2022-01-26T20:34:28.943,7,False,0.0
2021,20,3342,105,12,4537,2,28,10,-3,9,12,7,2,7,0,False,False,False,0,1,2022-01-23T10:48:46.763,9,False,2.0
2021,20,3342,115,12,467,2,32,9,0,1,1,1,0,1,0,False,True,True,0,4,2022-01-23T10:53:28.997,0,False,0.0
2021,20,3342,125,28,7619,13,2,4,9,0,0,0,0,0,0,False,False,False,0,3,2022-01-26T20:50:46.59,0,False,0.0
2021,20,3342,145,12,8279,13,32,9,-2,0,0,0,0,0,0,True,False,False,0,4,2022-01-23T11:08:09.163,0,False,0.0
2021,20,3342,150,12,8279,13,12,2,35,0,0,0,0,0,0,False,False,False,0,3,2022-01-23T11:10:26.723,0,False,0.0
2021,20,3342,165,28,4922,3,8,8,22,0,0,0,0,0,0,False,False,False,0,3,2022-01-23T11:14:40.063,0,False,0.0
2021,20,3342,170,28,7753,3,8,10,14,0,0,0,0,0,0,False,False,False,0,3,2022-01-23T11:16:25.43,0,False,0.0
2021,20,3342,180,12,4537,2,46,3,0,3,3,3,0,3,0,True,False,False,0,3,2022-01-23T11:18:41.683,3,False,0.0
2021,20,3342,210,28,7224,13,2,10,6,0,0,0,0,0,0,False,False,False,0,2,2022-01-23T11:24:37.83,0,False,0.0
2021,20,3342,240,12,556,2,5,5,4,8,4,6,2,6,0,False,False,False,0,3,2022-01-23T11:33:52.403,8,False,2.0
2021,20,3342,260,12,4537,2,28,10,-2,9,11,3,6,3,0,False,False,False,1,1,2022-01-23T11:39:28.583,9,False,6.0
2021,20,3342,275,28,8471,13,4,9,3,0,0,0,0,0,0,False,False,False,0,1,2022-01-23T11:42:51.503,0,False,0.0
2021,20,3342,280,28,4922,2,29,3,14,15,1,15,0,15,0,False,False,False,0,3,2022-01-23T11:44:17.297,15,False,0.0
2021,20,3342,305,28,8471,2,12,10,2,16,14,14,2,14,0,False,False,False,0,1,2022-01-23T11:52:08.237,16,False,2.0
2021,20,3342,325,28,4922,2,2,9,6,12,6,10,2,10,0,False,False,False,0,3,2022-01-23T11:56:28.843,12,False,2.0
2021,20,3342,340,28,4922,13,12,2,15,0,0,0,0,0,0,False,False,False,0,3,2022-01-23T12:07:41.81,0,False,0.0
2021,20,3342,355,12,4537,2,47,5,-1,5,6,2,3,2,0,False,False,False,0,1,2022-01-23T12:11:39.523,5,False,3.0
2021,20,3342,360,12,4537,2,12,2,35,75,40,69,6,69,0,False,False,False,0,1,2022-01-23T12:13:59.977,75,False,6.0
2021,20,3342,420,28,7224,2,50,10,-2,18,20,11,7,11,0,False,False,False,1,2,2022-01-23T12:27:49.707,18,False,7.0
2021,20,3342,435,28,7753,2,5,3,5,9,4,6,3,6,0,False,False,False,0,3,2022-01-23T12:34:09.77,9,False,
2021,20,3342,440,28,8471,2,4,5,4,3,-1,3,0,3,0,False,False,False,0,2,2022-01-23T12:41:56.95,3,False,0.0
2021,20,3342,445,28,7224,2,50,9,-5,12,17,6,6,6,0,False,False,False,1,3,2022-01-26T20:34:49.453,12,False,6.0
2021,20,3342,465,12,7743,3,36,1,17,0,0,0,0,0,0,False,False,False,0,4,2022-01-23T12:53:24.84,0,False,0.0
2021,20,3342,470,12,4537,2,28,10,1,6,5,2,4,2,0,False,False,False,0,1,2022-01-23T12:55:08.817,6,False,4.0
2021,20,3342,480,28,7760,13,32,5,1,0,0,0,0,0,0,False,False,False,0,4,2022-01-23T12:59:48.343,0,False,0.0
2021,20,3342,500,12,556,2,4,5,6,6,0,6,0,6,0,False,False,False,0,2,2022-01-23T13:07:30.76,6,False,0.0
2021,20,3342,530,12,556,2,8,8,25,25,0,25,0,25,0,False,False,False,0,3,2022-01-26T21:14:28.053,25,False,0.0
2021,20,3342,540,12,556,13,35,5,13,0,0,0,0,0,0,False,False,False,0,3,2022-01-23T13:20:02.717,0,False,
2021,20,3342,545,12,4537,2,48,10,-4,1,5,-1,2,-1,0,False,False,False,0,1,2022-01-23T13:22:09.647,1,False,2.0
2021,20,3342,555,12,556,2,5,9,5,5,0,5,0,5,0,False,False,False,0,3,2022-01-23T13:27:35.94,5,False,0.0
2021,20,3342,560,12,6691,2,5,3,6,6,0,6,0,6,0,False,False,False,0,3,2022-01-23T13:29:09.077,6,False,0.0
2021,20,3342,575,12,4537,2,46,3,0,2,2,2,0,2,0,False,False,False,0,1,2022-01-23T13:34:09.81,2,False,0.0
2021,20,3342,605,28,8471,2,45,5,-1,-1,0,-1,0,-1,0,False,False,False,0,1,2022-01-23T13:46:59.67,-1,False,0.0
2021,20,3342,615,28,4922,2,2,10,7,24,17,13,11,13,0,False,False,False,1,3,2022-01-26T21:15:06.35,24,False,11.0
2021,20,3342,630,28,7753,2,2,10,4,6,2,6,0,6,0,False,False,False,0,3,2022-01-26T21:22:01.063,6,False,0.0
2021,20,3342,645,12,556,13,9,5,12,0,0,0,0,0,0,False,False,False,0,2,2022-01-23T14:09:05.747,0,False,0.0
2021,20,3342,675,12,556,2,4,5,5,4,-1,4,0,4,0,False,False,False,0,2,2022-01-23T14:20:42.733,4,False,0.0
2021,20,3342,680,12,496,13,5,3,4,0,0,0,0,0,0,False,False,False,0,2,2022-01-26T21:17:30.9,0,False,0.0
2021,20,3342,685,12,556,13,8,8,45,0,0,0,0,0,0,False,False,False,0,3,2022-01-23T14:24:21.467,0,False,0.0
2021,20,3342,700,28,4922,2,2,10,6,12,6,9,3,9,0,False,False,False,0,3,2022-01-23T14:29:03.713,12,False,3.0
2021,20,3342,715,28,7224,2,16,9,5,14,9,11,3,11,0,False,False,False,0,1,2022-01-23T14:34:07.393,14,False,3.0
2021,20,3343,25,30,7268,13,5,5,14,0,0,0,0,0,0,True,False,False,0,2,2022-01-24T18:57:15.643,0,False,0.0
2021,20,3343,30,30,63,13,2,9,7,0,0,0,0,0,0,False,False,False,0,2,2022-01-24T13:01:02.117,0,False,0.0
2021,20,3343,40,29,1067,2,4,3,5,6,1,5,1,5,0,False,False,False,0,2,2022-01-24T13:06:02.523,6,False,1.0
2021,20,3343,45,29,7788,2,45,5,-7,9,16,7,2,7,0,False,False,False,0,1,2022-01-24T13:07:33.063,9,False,2.0
2021,20,3343,50,29,4866,2,35,2,15,17,2,15,2,15,0,False,False,False,0,3,2022-01-24T13:23:13.787,17,False,2.0
2021,20,3343,60,29,1067,2,12,4,2,20,18,18,2,18,0,False,False,False,0,3,2022-01-24T13:27:52.347,20,False,2.0
2021,20,3343,65,29,3398,2,17,8,25,29,4,29,0,29,0,False,False,False,0,3,2022-01-24T13:31:04.277,29,False,0.0
2021,20,3343,75,29,4866,13,8,9,8,0,0,0,0,0,0,False,False,False,0,3,2022-01-26T22:52:55.69,0,False,0.0
2021,20,3343,80,29,7828,13,9,5,8,0,0,0,0,0,0,False,False,False,0,2,2022-01-24T13:36:37.433,0,False,0.0
2021,20,3343,100,30,63,13,7,2,15,0,0,0,0,0,0,False,False,False,0,4,2022-01-24T18:57:34.317,0,False,0.0
2021,20,3343,105,30,793,13,4,9,2,0,0,0,0,0,0,False,False,False,0,3,2022-01-24T13:47:25.04,0,False,0.0
2021,20,3343,115,29,1067,2,35,5,10,9,-1,9,0,9,0,True,False,False,0,3,2022-01-26T00:17:55.39,9,False,0.0
2021,20,3343,120,29,7828,13,22,7,27,0,0,0,0,0,0,False,False,False,0,3,2022-01-24T13:52:11.323,0,False,
2021,20,3343,125,29,3398,2,4,10,7,9,2,8,1,8,0,False,False,False,0,3,2022-01-26T00:16:33.47,9,False,1.0
2021,20,3343,135,29,1067,13,5,5,-2,0,0,0,0,0,0,False,False,False,0,3,2022-01-26T23:01:49.847,0,False,0.0
2021,20,3343,150,29,7366,2,31,9,0,7,7,7,0,7,6,False,False,False,0,4,2022-01-24T14:05:08.273,7,False,0.0
2021,20,3343,165,30,4937,2,48,10,-4,13,17,9,4,9,0,False,False,False,0,1,2022-01-24T14:16:58.077,13,False,4.0
2021,20,3343,170,30,63,2,12,10,11,29,18,24,5,24,0,False,False,False,0,4,2022-01-26T22:43:25.483,29,False,5.0
2021,20,3343,180,30,7268,2,26,10,5,5,0,5,0,5,0,True,False,False,0,3,2022-01-26T18:01:08.85,5,False,0.0
2021,20,3343,185,30,2290,3,53,4,0,0,0,0,0,0,0,False,False,False,0,3,2022-01-25T23:17:30.043,0,False,0.0
2021,20,3343,215,29,4866,2,19,2,37,70,33,70,0,70,6,False,False,False,1,2,2022-01-24T14:33:36.273,70,True,0.0
2021,20,3343,235,30,793,3,4,3,5,0,0,0,0,0,0,False,False,False,0,2,2022-01-24T14:37:38.793,0,False,0.0
2021,20,3343,240,30,793,13,3,5,10,0,0,0,0,0,0,False,False,False,0,2,2022-01-24T14:39:00.333,0,False,0.0
2021,20,3343,255,29,3398,13,5,5,4,0,0,0,0,0,0,False,False,False,0,3,2022-01-26T23:05:36.883,0,False,0.0
2021,20,3343,260,29,1067,13,5,3,13,0,0,0,0,0,0,False,False,False,0,2,2022-01-26T23:06:45.543,0,False,0.0
2021,20,3343,270,30,793,13,3,3,3,0,0,0,0,0,0,False,False,False,0,2,2022-01-24T14:48:37.207,0,False,0.0
2021,20,3343,275,30,7893,2,13,4,2,3,1,3,0,3,0,False,False,False,0,3,2022-01-24T14:50:14.633,3,False,0.0
2021,20,3343,280,30,793,2,13,4,5,9,4,9,0,9,0,False,False,False,0,3,2022-01-26T18:01:08.863,9,False,0.0
2021,20,3343,285,30,793,2,18,3,0,4,4,2,2,2,0,False,False,False,0,2,2022-01-24T14:55:01.367,4,False,2.0
2021,20,3343,290,30,7893,13,13,9,5,0,0,0,0,0,0,False,False,False,0,3,2022-01-26T22:39:49.03,0,False,0.0
2021,20,3343,295,30,793,2,5,3,11,21,10,14,7,14,0,False,False,False,1,2,2022-01-24T15:01:39.173,21,False,7.0
2021,20,3343,300,30,793,2,4,3,3,8,5,5,3,5,0,False,False,False,0,2,2022-01-24T15:05:11.937,8,False,3.0
2021,20,3343,305,30,4937,2,11,5,7,19,12,16,3,16,0,False,False,False,0,1,2022-01-26T23:07:01.803,19,False,3.0
2021,20,3343,310,30,4937,2,4,10,0,1,1,1,0,1,0,False,False,False,0,1,2022-01-24T15:09:26.36,1,False,0.0
2021,20,3343,315,30,7893,3,13,4,3,0,0,0,0,0,0,False,False,False,0,3,2022-01-24T15:13:17.997,0,False,0.0
2021,20,3343,320,30,931,13,6,10,0,0,0,0,0,0,0,False,False,False,0,1,2022-01-26T18:01:08.863,0,False,0.0
2021,20,3343,335,29,7788,2,44,3,-4,6,10,-1,7,-1,0,False,False,False,1,1,2022-01-26T23:07:17.36,6,False,7.0
2021,20,3343,340,29,7788,2,50,3,0,5,5,0,5,0,0,False,False,False,1,2,2022-01-26T22:43:53.817,5,False,5.0
2021,20,3343,360,29,3398,2,16,9,3,6,3,5,1,5,0,True,False,False,0,3,2022-01-24T15:30:30.83,6,False,1.0
2021,20,3343,365,29,4866,2,4,3,3,4,1,3,1,3,0,False,False,False,0,3,2022-01-26T18:01:08.88,4,False,1.0
2021,20,3343,370,29,1067,2,4,3,4,7,3,6,1,6,0,False,False,False,0,2,2022-01-26T23:08:20.83,7,False,1.0
2021,20,3343,380,29,6266,2,48,9,-4,-4,0,-4,0,-4,0,False,False,False,0,1,2022-01-26T22:40:21.647,-4,False,0.0
2021,20,3343,390,29,4866,2,51,5,-3,11,14,1,10,1,0,True,False,False,1,3,2022-01-26T18:01:08.88,11,False,10.0
2021,20,3343,415,30,63,13,7,2,23,0,0,0,0,0,0,False,False,False,0,4,2022-01-24T15:51:34.86,0,False,0.0
2021,20,3343,430,29,3398,2,4,10,6,7,1,7,0,7,0,False,False,False,0,3,2022-01-24T15:56:54.33,7,False,0.0
2021,20,3343,435,29,7828,2,4,5,7,11,4,10,1,10,0,False,False,False,0,2,2022-01-24T15:58:35.16,11,False,1.0
2021,20,3343,470,29,1067,2,21,3,14,17,3,17,0,17,0,False,False,False,0,3,2022-01-24T16:06:15.653,17,True,0.0
2021,20,3343,485,29,4866,2,5,5,9,13,4,11,2,11,0,False,False,False,0,3,2022-01-24T16:09:46.007,13,False,2.0
2021,20,3343,490,29,4866,13,4,4,8,0,0,0,0,0,0,False,False,False,0,3,2022-01-26T22:37:42.22,0,False,0.0
2021,20,3343,510,30,7893,3,2,10,3,0,0,0,0,0,0,False,False,False,0,2,2022-01-24T16:20:44.393,0,False,0.0
2021,20,3343,520,29,7366,2,3,3,13,11,-2,11,0,11,0,False,False,False,0,2,2022-01-26T22:37:52.937,11,False,0.0
2021,20,3343,525,29,4866,2,13,9,3,4,1,3,1,3,0,False,False,False,1,3,2022-01-24T16:25:39.367,4,False,1.0
2021,20,3343,530,29,1067,2,29,3,10,10,0,10,0,10,0,False,False,False,0,2,2022-01-24T16:27:00.433,10,True,0.0
2021,20,3343,560,30,793,2,5,3,3,5,2,5,0,5,0,False,False,False,0,3,2022-01-24T16:38:49.127,5,False,0.0
2021,20,3343,565,30,4523,2,5,3,4,7,3,5,2,5,0,False,False,False,0,4,2022-01-24T16:55:17.137,7,False,2.0
2021,20,3343,570,30,7268,2,18,3,-2,-2,0,-2,0,-2,0,False,False,False,0,2,2022-01-26T23:09:44.797,-2,False,0.0
2021,20,3343,575,30,63,2,21,6,18,42,24,40,2,40,0,False,False,False,0,4,2022-01-26T18:01:08.88,42,False,2.0
2021,20,3343,580,30,793,13,3,3,11,0,0,0,0,0,0,True,False,False,0,3,2022-01-24T17:00:08.713,0,False,0.0
2021,20,3343,585,30,793,2,5,5,10,11,1,10,1,10,0,False,False,False,0,2,2022-01-26T23:10:11.277,11,False,1.0
2021,20,3343,600,30,63,13,4,10,13,0,0,0,0,0,0,False,False,False,0,4,2022-01-26T22:38:11.6,0,False,0.0
2021,20,3343,615,29,4866,2,32,9,2,3,1,4,-1,4,0,False,True,True,0,3,2022-01-24T18:54:46.93,0,False,-1.0
2021,20,3343,620,30,63,13,7,6,27,0,0,0,0,0,0,False,False,False,0,4,2022-01-24T17:10:56.243,0,False,0.0
2021,20,3343,625,30,63,2,53,9,-5,1,6,-1,2,-1,0,False,False,False,0,4,2022-01-24T17:12:09.223,1,False,2.0
2021,20,3343,630,30,63,13,4,9,13,0,0,0,0,0,0,False,False,False,0,3,2022-01-24T17:14:29.19,0,False,0.0
2021,20,3343,635,30,7268,2,4,3,14,16,2,16,0,16,0,False,False,False,0,2,2022-01-24T17:15:46.073,16,False,0.0
2021,20,3343,640,30,7893,2,50,10,-2,3,5,2,1,2,0,False,False,False,1,3,2022-01-26T23:12:05.223,3,False,1.0
2021,20,3343,645,30,7893,2,5,3,4,9,5,4,5,4,0,False,False,False,2,3,2022-01-26T22:43:39.547,9,False,5.0
2021,20,3343,675,29,3398,13,6,7,20,0,0,0,0,0,0,False,False,False,0,2,2022-01-26T22:38:31.107,0,False,0.0
2021,20,3343,680,29,3398,3,32,5,5,0,0,0,0,0,0,True,False,False,0,4,2022-01-26T22:40:40.303,0,False,0.0
2021,20,3343,700,30,63,2,2,4,7,13,6,9,4,9,0,False,False,False,0,3,2022-01-26T22:44:05.073,13,False,4.0
2021,20,3343,705,30,4937,2,45,5,2,5,3,3,2,3,0,False,False,False,0,1,2022-01-24T17:43:35.263,5,False,2.0
2021,20,3343,710,30,63,13,7,2,17,0,0,0,0,0,0,False,False,False,0,4,2022-01-24T17:45:00.427,0,False,0.0
2021,20,3343,720,30,793,13,19,6,30,0,0,0,0,0,0,False,False,False,0,2,2022-01-24T17:47:24.623,0,False,0.0
2021,20,3343,745,29,7828,2,5,5,5,18,13,5,13,5,0,False,False,False,1,3,2022-01-24T17:55:01.23,18,False,13.0
2021,20,3343,775,30,4937,2,48,9,-6,9,15,7,2,7,0,False,False,False,0,1,2022-01-24T18:01:22.783,9,False,2.0
2021,20,3343,780,30,793,2,5,3,6,6,0,6,0,6,0,False,False,False,0,2,2022-01-24T18:02:35.26,6,False,0.0
2021,20,3343,785,30,793,13,19,6,18,0,0,0,0,0,0,False,False,False,0,2,2022-01-26T22:38:58.117,0,False,
2021,20,3343,790,30,7268,13,3,5,10,0,0,0,0,0,0,False,False,False,0,2,2022-01-24T18:06:12.58,0,False,0.0
2021,20,3343,795,30,4937,2,48,10,-5,4,9,0,4,0,0,False,False,False,2,1,2022-01-26T22:45:15.88,4,False,4.0
2021,20,3343,800,30,4937,2,46,9,-4,-3,1,-3,0,-3,0,False,False,False,0,1,2022-01-24T18:10:02.833,-3,False,0.0
2021,20,3343,805,30,2290,13,6,9,11,0,0,0,0,0,0,False,False,False,0,3,2022-01-26T23:27:13.263,0,False,0.0
2021,20,3343,830,29,6266,2,45,5,-6,0,6,-3,3,-3,0,False,False,False,0,1,2022-01-26T22:39:07.907,0,False,3.0
2021,20,3343,845,30,7268,2,3,6,19,19,0,19,0,19,0,True,False,False,0,2,2022-01-24T18:20:46.747,19,False,0.0
2021,20,3343,850,30,4937,2,44,3,-4,3,7,-1,4,-1,0,False,False,False,0,1,2022-01-24T18:22:29.377,3,False,4.0
2021,20,3343,855,30,793,2,19,2,45,55,10,55,0,55,6,False,False,False,0,2,2022-01-24T18:23:58.21,55,True,0.0
2021,20,3343,880,30,4937,2,4,3,5,5,0,5,0,5,0,False,False,False,0,2,2022-01-24T18:29:47.023,5,False,0.0
2021,20,3343,900,30,793,13,3,3,12,0,0,0,0,0,0,False,False,False,0,2,2022-01-24T18:33:44.827,0,False,0.0
2021,20,3343,905,30,793,13,21,6,18,0,0,0,0,0,0,False,False,False,0,3,2022-01-26T22:39:17.477,0,False,0.0
2021,20,3343,910,30,2290,2,2,4,6,9,3,7,2,7,0,False,False,False,0,3,2022-01-24T18:37:27.73,9,False,2.0
2021,20,3343,945,29,4866,2,5,6,19,20,1,19,1,19,0,False,False,False,0,3,2022-01-26T22:39:34.857,20,False,1.0
2021,20,3343,950,29,4866,2,17,1,36,44,8,41,3,41,0,False,False,False,0,3,2022-01-26T18:03:51.31,44,False,3.0
2021,20,3344,10,4,6983,2,45,10,-5,13,18,10,3,10,0,False,False,False,1,1,2022-01-24T12:35:10.023,13,False,3.0
2021,20,3344,15,4,6953,3,38,4,3,0,0,0,0,0,0,False,False,False,0,4,2022-01-24T12:36:52.643,0,False,0.0
2021,20,3344,20,4,2853,2,50,9,-3,1,4,0,1,0,0,True,False,False,0,3,2022-01-24T12:38:10.55,1,False,1.0
2021,20,3344,25,4,594,2,5,10,7,7,0,7,0,7,0,False,False,False,0,3,2022-01-24T12:39:24.803,7,False,0.0
2021,20,3344,35,4,6983,2,45,5,-6,4,10,3,1,3,0,False,False,False,0,1,2022-01-24T12:43:46.547,4,False,1.0
2021,20,3344,45,4,6983,2,31,4,1,15,14,12,3,12,0,False,False,False,0,1,2022-01-24T12:46:51.36,15,False,3.0
2021,20,3344,55,4,2853,13,2,9,3,0,0,0,0,0,0,False,False,False,0,3,2022-01-24T12:49:02.92,0,False,0.0
2021,20,3344,90,16,3938,2,50,9,-2,1,3,0,1,0,0,False,False,False,0,3,2022-01-24T12:55:59.787,1,False,1.0
2021,20,3344,95,16,797,2,12,9,2,5,3,4,1,4,0,False,False,False,0,1,2022-01-24T12:57:25.11,5,False,1.0
2021,20,3344,100,16,374,13,12,4,8,0,0,0,0,0,0,True,False,False,0,3,2022-01-24T12:58:47.99,0,False,0.0
2021,20,3344,125,16,3938,13,2,4,6,0,0,0,0,0,0,False,False,False,0,2,2022-01-27T15:55:43.39,0,False,0.0
2021,20,3344,130,16,6500,2,4,9,3,5,2,4,1,4,0,False,False,False,0,2,2022-01-27T15:54:57.203,5,False,1.0
2021,20,3344,150,4,5119,2,45,5,-4,3,7,2,1,2,0,True,False,False,0,3,2022-01-24T13:15:31.187,3,False,1.0
2021,20,3344,160,4,2853,2,4,9,3,5,2,4,1,4,0,True,False,False,0,3,2022-01-24T13:18:05.143,5,False,1.0
2021,20,3344,165,4,6953,2,38,9,1,1,0,1,0,1,0,False,False,False,0,4,2022-01-24T13:19:27.36,1,False,0.0
2021,20,3344,175,4,6953,2,39,4,5,8,3,5,3,5,0,False,False,False,0,4,2022-01-24T13:21:16.893,8,False,3.0
2021,20,3344,185,4,7937,2,44,3,-5,1,6,0,1,0,0,True,False,False,0,2,2022-01-24T13:25:22.78,1,False,1.0
2021,20,3344,190,4,7646,13,4,3,9,0,0,0,0,0,0,False,False,False,0,2,2022-01-24T13:27:04.58,0,False,0.0
2021,20,3344,205,16,6500,3,5,9,3,0,0,0,0,0,0,False,False,False,0,3,2022-01-24T13:32:29.337,0,False,0.0
2021,20,3344,215,16,374,2,32,3,0,5,5,4,1,4,0,False,False,False,0,4,2022-01-24T13:35:27.167,5,False,1.0
2021,20,3344,245,16,374,2,6,7,16,21,5,20,1,20,0,False,False,False,0,3,2022-01-24T13:43:44.75,21,False,1.0
2021,20,3344,250,16,6500,2,4,4,12,12,0,12,0,12,0,False,False,False,1,3,2022-01-24T13:45:40.503,12,False,0.0
2021,20,3344,255,16,3938,2,35,10,10,10,0,10,0,10,0,False,False,False,0,3,2022-01-24T13:47:18.557,10,False,0.0
2021,20,3344,270,16,7681,2,5,5,5,9,4,6,3,6,0,True,False,False,2,2,2022-01-24T13:53:19.153,9,False,3.0
2021,20,3344,275,16,797,2,45,5,-5,6,11,2,4,2,0,False,False,False,0,1,2022-01-24T13:54:36.68,6,False,4.0
2021,20,3344,305,16,7681,13,55,4,-2,0,0,0,0,0,0,False,False,False,0,1,2022-01-24T14:01:15.11,0,False,0.0
2021,20,3344,310,16,6500,2,2,10,2,2,0,2,0,2,6,False,False,False,0,3,2022-01-24T14:02:51.203,2,True,0.0
2021,20,3344,325,4,594,2,2,4,9,24,15,17,7,17,0,False,False,False,1,3,2022-01-24T14:07:35.573,24,False,7.0
2021,20,3344,330,4,2853,2,4,5,2,1,-1,1,0,1,0,False,False,False,0,2,2022-01-24T14:08:36.277,1,False,0.0
2021,20,3344,335,4,594,2,2,4,5,7,2,7,0,7,0,False,False,False,0,3,2022-01-24T14:09:48.447,7,False,0.0
2021,20,3344,340,4,7646,2,2,9,5,5,0,5,0,5,0,False,False,False,0,2,2022-01-24T14:10:59.243,5,False,0.0
2021,20,3344,360,4,7646,2,8,1,16,18,2,18,0,18,6,False,False,False,0,2,2022-01-24T14:16:37.657,18,True,0.0
2021,20,3344,375,16,374,13,12,9,14,0,0,0,0,0,0,False,False,False,0,4,2022-01-24T14:18:42.577,0,False,
2021,20,3344,380,16,3938,2,35,10,8,26,18,26,0,26,0,True,False,False,0,2,2022-01-26T18:40:16.753,26,True,0.0
2021,20,3344,385,16,3938,2,6,10,3,4,1,4,0,4,0,False,False,False,0,3,2022-01-24T14:21:49.78,4,True,0.0
2021,20,3344,390,16,374,2,4,9,5,8,3,7,1,7,0,False,False,False,0,3,2022-01-24T14:23:02.017,8,False,1.0
2021,20,3344,450,16,797,2,51,9,-7,7,14,5,2,5,0,False,False,False,0,1,2022-01-24T15:05:08.14,7,False,2.0
2021,20,3344,455,16,3938,2,5,5,4,7,3,6,1,6,0,False,False,False,0,2,2022-01-24T15:06:16.627,7,False,1.0
2021,20,3344,460,16,8537,2,4,9,4,8,4,6,2,6,0,False,False,False,0,3,2022-01-24T15:07:32.633,8,False,2.0
2021,20,3344,470,16,3938,2,16,9,3,3,0,3,0,3,0,False,False,False,0,3,2022-01-24T15:10:00.703,3,False,0.0
2021,20,3344,475,16,797,2,47,10,1,20,19,15,5,15,0,False,False,False,1,1,2022-01-24T15:13:30.733,20,False,5.0
2021,20,3344,510,4,7937,2,32,3,1,7,6,5,2,5,0,False,False,False,0,1,2022-01-24T15:22:35.287,7,False,2.0
2021,20,3344,535,16,374,2,5,3,4,8,4,5,3,5,0,True,False,False,0,3,2022-01-27T16:28:53.283,8,False,3.0
2021,20,3344,540,16,6500,2,4,10,3,5,2,5,0,5,0,False,False,False,0,3,2022-01-24T15:31:57.603,5,False,0.0
2021,20,3344,565,4,7646,2,8,8,49,75,26,75,0,75,6,False,False,False,0,2,2022-01-24T15:39:51.64,75,True,0.0
2021,20,3344,585,16,8537,2,5,5,6,6,0,6,0,6,0,False,False,False,0,3,2022-01-24T15:44:19.6,6,False,0.0
2021,20,3344,590,16,3938,2,4,10,7,5,-2,5,0,5,0,False,False,False,0,3,2022-01-24T15:46:28.383,5,False,0.0
2021,20,3344,600,16,3938,2,13,4,2,7,5,2,5,2,0,False,False,False,1,3,2022-01-24T15:49:30.743,7,False,5.0
2021,20,3344,615,16,6500,13,2,9,6,0,0,0,0,0,0,False,False,False,0,3,2022-01-24T15:53:44.75,0,False,0.0
2021,20,3344,625,4,7646,2,6,7,17,17,0,17,0,17,0,False,False,False,0,2,2022-01-24T15:56:12.237,17,False,0.0
2021,20,3344,630,4,6953,13,32,5,0,0,0,0,0,0,0,False,False,False,0,4,2022-01-24T15:58:30.493,0,False,0.0
2021,20,3344,640,4,7646,13,12,2,24,0,0,0,0,0,0,False,False,False,0,2,2022-01-24T16:01:04.7,0,False,0.0
2021,20,3344,685,4,594,2,4,3,4,8,4,7,1,7,0,False,False,False,0,3,2022-01-24T16:11:39.157,8,False,1.0
2021,20,3344,695,4,594,2,5,3,3,5,2,5,0,5,0,True,False,False,0,3,2022-01-24T16:14:29.607,5,False,0.0
2021,20,3344,720,4,594,2,4,5,3,9,6,7,2,7,0,False,False,False,0,3,2022-01-24T16:26:54,9,False,2.0
2021,20,3344,735,4,594,13,5,5,3,0,0,0,0,0,0,False,False,False,0,3,2022-01-24T16:29:52.403,0,False,0.0
2021,20,3344,750,4,594,3,2,4,7,0,0,0,0,0,0,False,False,False,0,3,2022-01-24T16:34:47.68,0,False,0.0
2021,20,3344,760,4,6983,2,28,10,-7,-7,0,-7,0,-7,0,False,False,False,0,1,2022-01-24T16:37:42.023,-7,False,0.0
2021,20,3344,770,4,7646,2,23,7,27,27,0,27,0,27,6,False,False,False,0,2,2022-01-25T17:45:27.867,27,True,0.0
2021,20,3344,785,16,797,13,12,5,7,0,0,0,0,0,0,False,False,False,0,1,2022-01-24T16:43:19.947,0,False,0.0
2021,20,3344,795,16,374,2,5,9,10,11,1,11,0,11,0,True,False,False,0,3,2022-01-26T01:17:41.773,11,False,0.0
2021,20,3344,800,16,797,13,46,3,4,0,0,0,0,0,0,False,False,False,0,1,2022-02-24T20:36:08.917,0,False,0.0
2021,20,3344,805,16,3938,2,6,9,12,64,52,63,1,63,6,False,False,False,1,3,2022-01-24T16:48:59.34,64,False,1.0
2021,20,3344,820,4,2853,13,4,2,17,0,0,0,0,0,0,False,False,False,0,2,2022-01-24T16:51:17.697,0,False,0.0
2021,20,3344,825,4,7646,2,6,7,18,28,10,28,0,28,0,False,False,False,0,2,2022-01-27T15:55:05.47,28,False,0.0
2021,20,3344,835,4,7646,2,4,3,12,12,0,12,0,12,0,False,False,False,0,2,2022-01-24T16:54:30.233,12,False,0.0
2021,20,3344,840,4,2853,13,12,2,22,0,0,0,0,0,0,False,False,False,0,2,2022-01-24T16:55:41.36,0,False,0.0
2021,20,3344,845,4,213,2,4,2,16,16,0,16,0,16,0,False,False,False,0,2,2022-01-24T16:56:51.183,16,False,0.0
2021,20,3344,850,4,7646,2,8,1,19,19,0,19,0,19,6,False,False,False,0,3,2022-01-24T16:58:22.167,19,True,0.0
2021,20,3344,870,16,3938,2,49,9,5,19,14,18,1,18,0,False,False,False,0,2,2022-01-24T17:00:49.927,19,False,1.0
2021,20,3344,885,16,374,2,17,9,14,25,11,22,3,22,0,False,False,False,0,3,2022-01-24T17:02:44.96,25,False,3.0
2021,20,3344,915,16,6500,2,4,10,3,5,2,5,0,5,0,False,False,False,0,3,2022-01-24T17:07:00.643,5,False,0.0
2021,20,3344,920,16,374,2,5,9,10,10,0,10,0,10,0,True,False,False,0,4,2022-01-24T17:08:08.477,10,False,0.0
2021,20,3344,930,16,797,2,48,9,-3,16,19,13,3,13,0,False,False,False,0,1,2022-01-24T17:10:10.267,16,False,3.0
2021,20,3344,935,16,3938,2,4,10,3,4,1,1,3,1,0,False,False,False,2,3,2022-01-24T17:11:27.087,4,False,3.0
2021,20,3344,940,16,7176,2,13,10,2,26,24,26,0,26,0,False,False,False,0,3,2022-01-24T17:12:42.453,26,True,0.0
2021,20,3344,945,16,374,2,29,5,8,8,0,8,0,8,6,True,False,False,0,3,2022-01-24T17:13:53.707,8,True,0.0
2021,21,3345,15,7,8317,2,50,9,-3,2,5,1,1,1,0,False,False,False,0,2,2022-01-31T14:27:14.947,2,False,1.0
2021,21,3345,20,7,2631,13,5,3,5,0,0,0,0,0,0,True,False,False,0,3,2022-01-31T14:28:11.577,0,False,0.0
2021,21,3345,35,16,797,2,44,3,0,14,14,10,4,10,0,True,False,False,0,1,2022-01-31T14:33:40.217,14,False,4.0
2021,21,3345,40,16,3938,2,4,10,2,8,6,6,2,6,0,False,False,False,0,3,2022-01-31T14:35:50.85,8,False,2.0
2021,21,3345,65,16,374,2,5,3,6,10,4,9,1,9,0,True,False,False,0,3,2022-01-31T14:41:35.737,10,False,1.0
2021,21,3345,80,16,3938,2,4,5,1,6,5,4,2,4,0,True,False,False,0,2,2022-01-31T14:45:01.267,6,False,2.0
2021,21,3345,85,16,3938,2,12,5,10,10,0,10,0,10,6,False,False,False,0,2,2022-01-31T14:46:20.267,10,True,0.0
2021,21,3345,105,7,4679,2,4,10,0,2,2,1,1,1,0,False,False,False,0,1,2022-01-31T14:51:06.103,2,False,1.0
2021,21,3345,120,7,4679,2,4,9,0,7,7,5,2,5,0,False,False,False,0,1,2022-01-31T14:54:46.807,7,False,2.0
2021,21,3345,125,7,3521,2,47,5,1,3,2,2,1,2,0,False,False,False,0,3,2022-01-31T14:55:54.327,3,False,1.0
2021,21,3345,130,7,2631,3,4,10,12,0,0,0,0,0,0,False,False,False,0,4,2022-01-31T14:57:40.927,0,False,0.0
2021,21,3345,135,7,3521,2,4,9,5,5,0,5,0,5,0,False,False,False,0,3,2022-01-31T14:59:46.797,5,False,0.0
2021,21,3345,140,7,3521,2,5,5,6,9,3,7,2,7,0,False,False,False,0,3,2022-02-01T20:53:21.32,9,False,2.0
2021,21,3345,150,7,3521,13,12,3,14,0,0,0,0,0,0,False,False,False,0,2,2022-02-17T17:02:34.057,0,False,0.0
2021,21,3345,155,7,7659,13,9,3,14,0,0,0,0,0,0,False,False,False,0,2,2022-01-31T15:04:41.55,0,False,0.0
2021,21,3345,160,7,8317,13,9,5,14,0,0,0,0,0,0,False,False,False,0,2,2022-01-31T15:05:45.123,0,False,0.0
2021,21,3345,175,16,7176,2,9,6,36,44,8,37,7,37,0,False,False,False,0,3,2022-01-31T15:10:20.253,44,False,7.0
2021,21,3345,190,16,3938,13,35,9,13,0,0,0,0,0,0,True,False,False,0,2,2022-01-31T15:13:12.473,0,False,0.0
2021,21,3345,195,16,797,2,28,5,1,11,10,9,2,9,0,False,False,False,0,1,2022-02-02T18:05:50.037,11,False,2.0
2021,21,3345,200,16,3938,2,13,10,3,7,4,6,1,6,0,True,False,False,0,3,2022-01-31T15:16:43.333,7,False,1.0
2021,21,3345,210,16,374,2,12,5,5,5,0,5,0,5,6,False,False,False,0,3,2022-01-31T15:20:39.057,5,True,0.0
2021,21,3345,245,7,4455,13,47,5,1,0,0,0,0,0,0,False,False,False,0,1,2022-02-02T18:03:35.6,0,False,0.0
2021,21,3345,260,16,7176,13,19,6,45,0,0,0,0,0,0,False,False,False,0,2,2022-01-31T18:17:55.877,0,False,
2021,21,3345,270,16,374,2,5,3,14,19,5,17,2,17,0,False,False,False,1,4,2022-02-02T16:49:55.457,19,False,2.0
2021,21,3345,285,16,797,2,5,3,3,5,2,5,0,5,0,False,False,False,0,1,2022-01-31T15:48:31.913,5,False,0.0
2021,21,3345,290,16,374,2,38,9,3,12,9,4,8,4,0,False,False,False,1,4,2022-01-31T15:49:45.82,12,False,8.0
2021,21,3345,295,16,7176,2,51,5,2,3,1,3,0,3,6,True,False,False,0,3,2022-02-02T16:49:55.457,3,True,0.0
2021,21,3345,310,7,8317,2,4,5,4,6,2,4,2,4,0,True,False,False,1,3,2022-01-31T15:54:17.283,6,False,2.0
2021,21,3345,320,7,7659,2,6,10,8,8,0,8,0,8,0,False,False,False,0,3,2022-01-31T15:57:25.217,8,False,0.0
2021,21,3345,330,7,7659,2,12,5,14,18,4,15,3,15,0,False,False,False,0,3,2022-02-02T18:09:06.593,18,False,3.0
2021,21,3345,345,7,4455,2,48,10,-2,41,43,6,35,6,6,False,False,False,1,1,2022-01-31T16:03:25.737,41,False,35.0
2021,21,3345,360,16,7176,3,4,5,4,0,0,0,0,0,0,False,False,False,0,2,2022-02-02T16:49:55.473,0,False,0.0
2021,21,3345,365,16,3938,2,8,8,28,33,5,33,0,33,0,False,False,False,0,3,2022-02-02T16:49:55.473,33,True,0.0
2021,21,3345,370,16,3938,2,5,9,12,14,2,12,2,12,0,False,False,False,0,3,2022-01-31T16:09:49.273,14,False,2.0
2021,21,3345,380,16,374,2,4,4,6,9,3,5,4,5,0,False,False,False,2,4,2022-01-31T16:11:46.503,9,False,4.0
2021,21,3345,385,16,6500,2,4,9,9,10,1,10,0,10,0,False,False,False,0,2,2022-01-31T18:14:40.757,10,False,0.0
2021,21,3345,395,16,3938,13,22,2,15,0,0,0,0,0,0,False,False,False,0,2,2022-01-31T18:18:28.283,0,False,
2021,21,3345,410,16,3938,2,44,3,-4,0,4,-1,1,-1,0,True,False,False,0,4,2022-01-31T16:16:28.703,0,False,1.0
2021,21,3345,430,16,6500,2,5,10,2,6,4,5,1,5,0,False,False,False,0,3,2022-01-31T18:15:19.507,6,False,1.0
2021,21,3345,440,16,3938,13,12,5,12,0,0,0,0,0,0,False,False,False,0,3,2022-01-31T16:22:52.7,0,False,0.0
2021,21,3345,445,16,374,13,7,5,11,0,0,0,0,0,0,True,False,False,0,3,2022-01-31T16:24:50.463,0,False,0.0
2021,21,3345,455,7,7659,2,7,6,22,44,22,30,14,30,0,False,False,False,1,3,2022-01-31T16:28:04.167,44,False,14.0
2021,21,3345,470,7,6975,13,2,10,7,0,0,0,0,0,0,False,False,False,0,4,2022-01-31T16:30:53.55,0,False,0.0
2021,21,3345,475,7,7659,13,9,2,25,0,0,0,0,0,0,False,False,False,0,3,2022-02-02T18:09:20.94,0,False,0.0
2021,21,3345,485,16,7681,2,45,10,-3,4,7,0,4,0,0,False,False,False,1,1,2022-01-31T16:34:58.46,4,False,4.0
2021,21,3345,505,16,6500,13,35,2,15,0,0,0,0,0,0,False,False,False,0,3,2022-01-31T16:40:20.87,0,False,0.0
2021,21,3345,520,7,6975,2,4,10,4,4,0,4,0,4,0,False,False,False,0,4,2022-01-31T16:43:28.66,4,False,0.0
2021,21,3345,535,7,8317,2,12,5,13,22,9,21,1,21,0,False,False,False,0,2,2022-01-31T16:50:29.637,22,False,1.0
2021,21,3345,545,7,8317,13,2,9,6,0,0,0,0,0,0,False,False,False,0,2,2022-01-31T16:53:51.097,0,False,
2021,21,3345,550,7,4679,2,48,10,0,18,18,16,2,16,0,False,False,False,0,1,2022-01-31T16:58:34.673,18,False,2.0
2021,21,3345,560,7,3521,13,51,10,-2,0,0,0,0,0,0,False,False,False,0,3,2022-01-31T17:02:19.88,0,False,0.0
2021,21,3345,565,7,4455,2,44,9,-4,2,6,0,2,0,0,False,False,False,0,1,2022-01-31T17:06:32.647,2,False,2.0
2021,21,3345,585,16,4143,13,4,9,-2,0,0,0,0,0,0,False,False,False,0,4,2022-01-31T17:11:53.243,0,False,0.0
2021,21,3345,595,7,8317,2,4,10,9,17,8,15,2,15,0,False,False,False,0,2,2022-01-31T17:15:21.4,17,False,2.0
2021,21,3345,605,7,8317,13,9,3,2,0,0,0,0,0,0,False,False,False,0,2,2022-02-02T18:06:44.017,0,False,0.0
2021,21,3345,610,7,8317,2,29,3,2,2,0,2,0,2,6,False,False,False,0,2,2022-01-31T17:17:55.643,2,False,0.0
2021,21,3345,625,16,797,3,48,9,-5,0,0,0,0,0,0,False,False,False,0,1,2022-02-02T18:06:59.173,0,False,0.0
2021,21,3345,630,16,374,2,13,4,4,7,3,5,2,5,0,False,False,False,0,3,2022-02-02T16:49:55.52,7,False,2.0
2021,21,3345,650,7,8317,13,7,6,19,0,0,0,0,0,0,False,False,False,0,3,2022-01-31T17:24:41.307,0,False,0.0
2021,21,3345,660,16,7681,13,44,3,-4,0,0,0,0,0,0,False,False,False,0,1,2022-01-31T17:26:48.673,0,False,0.0
2021,21,3345,680,7,7659,13,12,2,19,0,0,0,0,0,0,True,False,False,0,3,2022-01-31T17:31:28.647,0,False,0.0
2021,21,3345,695,7,3521,2,18,5,-5,2,7,-1,3,-1,0,False,False,False,0,2,2022-01-31T17:35:37.27,2,False,3.0
2021,21,3345,715,7,7659,2,6,10,3,16,13,3,13,3,0,False,False,False,1,2,2022-02-02T16:49:55.52,16,False,13.0
2021,21,3345,725,7,7659,13,9,2,18,0,0,0,0,0,0,False,False,False,0,2,2022-01-31T17:41:56.893,0,False,0.0
2021,21,3345,730,7,8317,2,6,10,4,5,1,4,1,4,0,False,False,False,0,2,2022-01-31T17:42:48.917,5,False,1.0
2021,21,3345,735,7,4455,2,45,5,-5,0,5,0,0,0,0,False,False,False,0,1,2022-01-31T17:43:38.53,0,False,0.0
2021,21,3345,750,16,7176,2,51,10,-3,5,8,1,4,1,0,True,False,False,1,3,2022-01-31T17:45:37.357,5,False,4.0
2021,21,3345,755,16,374,2,2,10,5,5,0,5,0,5,0,False,False,False,0,2,2022-01-31T17:47:41.983,5,False,0.0
2021,21,3345,760,16,374,2,4,5,5,8,3,5,3,5,0,True,False,False,0,3,2022-01-31T17:47:34.527,8,False,3.0
2021,21,3345,770,16,374,2,17,10,10,18,8,16,2,16,0,False,False,False,0,3,2022-01-31T17:49:29.74,18,False,2.0
2021,21,3345,800,16,374,2,55,4,-2,2,4,1,1,1,0,False,False,False,0,4,2022-01-31T17:55:17.733,2,False,1.0
2021,21,3345,855,16,4143,13,5,3,4,0,0,0,0,0,0,False,False,False,0,3,2022-02-02T18:09:50.457,0,False,0.0
2021,21,3345,860,16,4143,13,2,10,5,0,0,0,0,0,0,False,False,False,0,2,2022-01-31T18:02:42.803,0,False,0.0
2021,21,3345,865,16,3938,13,35,6,35,0,0,0,0,0,0,False,False,False,0,3,2022-01-31T18:03:51.127,0,False,0.0
2021,21,3345,870,7,7659,2,2,9,7,9,2,7,2,7,0,False,False,False,0,2,2022-01-31T18:05:06.16,9,False,2.0
2021,21,3345,885,7,7659,2,2,9,7,8,1,7,1,7,0,False,False,False,0,2,2022-01-31T18:07:26.133,8,False,1.0
2021,21,3346,10,29,1067,2,18,10,-2,3,5,2,1,2,0,False,False,False,0,2,2022-01-31T17:57:28.62,3,False,1.0
2021,21,3346,15,29,7828,2,4,5,4,3,-1,3,0,3,0,False,False,False,0,2,2022-01-31T13:37:24.593,3,False,0.0
2021,21,3346,20,29,1067,13,8,10,11,0,0,0,0,0,0,False,False,False,0,2,2022-01-31T13:38:48.21,0,False,0.0
2021,21,3346,40,28,4922,13,17,1,21,0,0,0,0,0,0,False,False,False,0,3,2022-02-02T16:29:31.303,0,False,0.0
2021,21,3346,55,29,3398,13,53,10,-2,0,0,0,0,0,0,False,False,False,0,4,2022-01-31T13:50:43.647,0,False,0.0
2021,21,3346,60,29,4866,2,5,10,10,17,7,14,3,14,0,False,False,False,0,3,2022-01-31T13:52:16.693,17,False,3.0
2021,21,3346,65,29,7788,2,32,9,-1,2,3,1,1,1,0,False,False,False,0,1,2022-02-02T15:36:36.957,2,False,1.0
2021,21,3346,70,29,3398,2,32,10,1,13,12,9,4,9,0,False,False,False,0,4,2022-01-31T13:55:42.26,13,False,4.0
2021,21,3346,75,29,1067,2,2,10,10,10,0,10,0,10,0,False,False,False,0,2,2022-01-31T17:57:47.23,10,False,0.0
2021,21,3346,90,29,3398,2,4,9,3,5,2,4,1,4,0,False,False,False,0,3,2022-01-31T14:02:53.337,5,False,1.0
2021,21,3346,95,29,4866,13,13,4,3,0,0,0,0,0,0,False,False,False,0,3,2022-01-31T14:10:39.76,0,False,0.0
2021,21,3346,100,28,7619,2,2,10,12,12,0,12,0,12,0,False,False,False,0,3,2022-02-01T22:33:18.817,12,False,0.0
2021,21,3346,110,28,8471,2,6,9,2,18,16,6,12,6,0,False,False,False,1,1,2022-01-31T14:13:06.823,18,False,12.0
2021,21,3346,125,28,7619,13,6,10,6,0,0,0,0,0,0,False,False,False,0,2,2022-01-31T14:17:14.38,0,False,0.0
2021,21,3346,145,29,7828,13,3,5,9,0,0,0,0,0,0,False,False,False,0,2,2022-02-02T16:23:48.153,0,False,
2021,21,3346,180,29,1067,2,45,5,-1,6,7,3,3,3,0,False,False,False,0,2,2022-01-31T17:58:03.527,6,False,3.0
2021,21,3346,200,29,6266,13,4,4,3,0,0,0,0,0,0,False,False,False,0,1,2022-01-31T14:45:27.45,0,False,0.0
2021,21,3346,205,29,7366,2,33,4,3,11,8,9,2,9,0,False,False,False,0,4,2022-02-02T18:01:31.123,11,False,2.0
2021,21,3346,215,29,4866,2,50,9,0,7,7,1,6,1,0,False,False,False,0,3,2022-01-31T14:49:57.193,7,False,6.0
2021,21,3346,220,29,4866,2,5,5,14,15,1,15,0,15,0,False,False,False,0,2,2022-01-31T14:52:51.017,15,True,0.0
2021,21,3346,235,29,4866,2,7,2,16,16,0,16,0,16,6,False,False,False,0,3,2022-01-31T14:56:48.44,16,True,0.0
2021,21,3346,250,28,7224,2,50,9,-1,2,3,2,0,2,0,False,False,False,0,3,2022-01-31T17:53:26.583,2,False,0.0
2021,21,3346,255,28,7619,2,19,6,25,31,6,26,5,26,0,False,False,False,0,2,2022-01-31T15:01:15.693,31,False,5.0
2021,21,3346,270,28,7224,2,50,10,-2,44,46,1,43,1,6,True,False,False,1,2,2022-02-02T18:13:48.66,44,False,43.0
2021,21,3346,290,29,4866,13,5,2,15,0,0,0,0,0,0,False,False,False,0,2,2022-01-31T15:09:52.293,0,False,0.0
2021,21,3346,295,29,1067,2,6,9,12,13,1,13,0,13,0,False,False,False,0,2,2022-01-31T17:58:20.247,13,False,0.0
2021,21,3346,310,29,4866,3,8,9,12,0,0,0,0,0,0,False,False,False,0,2,2022-01-31T15:21:27.763,0,False,0.0
2021,21,3346,315,29,4866,2,5,3,9,9,0,9,0,9,0,False,False,False,0,3,2022-01-31T15:23:01.48,9,False,0.0
2021,21,3346,325,29,8455,3,8,7,38,0,0,0,0,0,0,False,False,False,0,2,2022-01-31T15:25:51.76,0,False,0.0
2021,21,3346,340,29,1067,13,19,2,35,0,0,0,0,0,0,False,False,False,0,2,2022-01-31T15:29:29.723,0,False,0.0
2021,21,3346,355,28,7224,3,2,4,8,0,0,0,0,0,0,False,False,False,0,3,2022-01-31T15:34:12.023,0,False,0.0
2021,21,3346,365,28,4922,2,2,9,5,11,6,9,2,9,0,False,False,False,0,3,2022-01-31T15:36:27.53,11,False,2.0
2021,21,3346,375,28,7751,2,28,10,1,6,5,6,0,6,0,False,False,False,0,1,2022-01-31T15:38:09.993,6,False,0.0
2021,21,3346,380,28,7619,2,2,9,8,13,5,11,2,11,0,False,False,False,0,2,2022-01-31T15:39:27.367,13,False,2.0
2021,21,3346,415,28,7224,13,12,10,7,0,0,0,0,0,0,False,False,False,0,2,2022-01-31T15:45:52.75,0,False,0.0
2021,21,3346,445,28,8471,2,5,10,1,11,10,7,4,7,0,False,False,False,0,1,2022-02-02T16:25:13.017,11,False,4.0
2021,21,3346,455,28,7619,13,12,10,9,0,0,0,0,0,0,False,False,False,0,2,2022-02-02T16:26:51.55,0,False,0.0
2021,21,3346,460,28,4922,13,2,9,7,0,0,0,0,0,0,False,False,False,0,2,2022-01-31T16:00:10.32,0,False,0.0
2021,21,3346,475,29,1067,2,3,3,13,13,0,13,0,13,0,False,False,False,0,2,2022-01-31T17:58:39.277,13,True,0.0
2021,21,3346,480,29,1067,2,8,7,24,26,2,26,0,26,0,False,False,False,0,2,2022-01-31T17:59:00.333,26,False,0.0
2021,21,3346,485,29,7366,2,5,5,4,9,5,7,2,7,0,False,False,False,0,3,2022-01-31T16:06:58.023,9,False,2.0
2021,21,3346,515,28,7619,2,2,9,11,13,2,12,1,12,0,False,False,False,0,2,2022-02-02T15:36:36.973,13,False,1.0
2021,21,3346,525,28,7224,2,50,3,-4,14,18,7,7,7,0,False,False,False,0,2,2022-01-31T16:20:17.973,14,False,7.0
2021,21,3346,535,28,7224,13,2,4,4,0,0,0,0,0,0,False,False,False,0,2,2022-02-02T15:36:36.973,0,False,0.0
2021,21,3346,540,28,7753,2,16,4,8,11,3,8,3,8,0,True,False,False,0,3,2022-01-31T16:27:09.547,11,False,3.0
2021,21,3346,550,28,4922,2,7,6,16,16,0,16,0,16,6,False,False,False,0,4,2022-02-01T22:33:40.09,16,True,0.0
2021,21,3346,565,29,4866,2,5,5,6,7,1,7,0,7,0,False,False,False,0,2,2022-02-02T18:09:39.527,7,False,0.0
2021,21,3346,575,29,4866,2,5,3,7,11,4,7,4,7,0,False,False,False,1,3,2022-01-31T16:35:23.887,11,False,4.0
2021,21,3346,585,29,7366,2,53,4,-5,20,25,12,8,12,0,False,False,False,1,4,2022-01-31T16:37:13.213,20,False,8.0
2021,21,3346,595,29,7366,2,32,10,-2,9,11,8,1,8,0,False,False,False,0,4,2022-01-31T18:03:34.787,9,False,1.0
2021,21,3346,605,29,4866,2,9,3,11,11,0,11,0,11,6,False,False,False,0,3,2022-01-31T16:45:32.873,11,True,0.0
2021,21,3346,620,28,8471,2,6,4,2,21,19,14,7,14,0,False,False,False,0,1,2022-01-31T16:48:28.953,21,False,7.0
2021,21,3346,625,28,7619,13,44,9,-1,0,0,0,0,0,0,False,False,False,0,2,2022-01-31T16:49:43.827,0,False,0.0
2021,21,3346,630,28,7224,2,4,10,3,12,9,10,2,10,0,False,False,False,0,1,2022-02-01T22:33:53.53,12,False,2.0
2021,21,3346,660,29,7828,13,19,1,45,0,0,0,0,0,0,False,False,False,0,3,2022-02-02T16:25:23.983,0,False,0.0
2021,21,3346,665,29,1067,2,19,6,28,29,1,29,0,29,0,False,False,False,0,2,2022-01-31T17:08:34.773,29,False,0.0
2021,21,3346,675,29,7828,13,21,2,26,0,0,0,0,0,0,False,False,False,0,2,2022-01-31T17:11:40.043,0,False,0.0
2021,21,3346,680,29,4866,2,50,10,0,16,16,10,6,10,0,False,False,False,0,3,2022-01-31T17:13:17.067,16,False,6.0
2021,21,3346,685,29,7828,13,7,2,25,0,0,0,0,0,0,False,False,False,0,3,2022-02-02T18:14:08.26,0,False,0.0
2021,21,3346,690,29,1067,2,4,5,4,7,3,6,1,6,0,False,False,False,0,2,2022-02-02T18:10:37.54,7,False,1.0
2021,21,3346,695,29,6266,2,53,10,-7,-4,3,-6,2,-6,0,False,False,False,0,3,2022-01-31T17:16:52.4,-4,False,2.0
2021,21,3346,710,28,4922,13,28,4,3,0,0,0,0,0,0,False,False,False,0,4,2022-01-31T17:26:57.64,0,False,0.0
2021,21,3346,720,28,7619,13,12,5,13,0,0,0,0,0,0,False,False,False,0,3,2022-01-31T17:28:39.937,0,False,0.0
2021,21,3346,725,28,408,3,12,3,-2,0,0,0,0,0,0,False,False,False,0,3,2022-01-31T17:30:36.647,0,False,0.0
2021,21,3346,740,29,7828,2,12,5,7,6,-1,6,0,6,0,True,False,False,0,2,2022-02-24T20:37:31.67,6,True,0.0
2021,21,3346,745,29,7366,2,4,10,5,8,3,6,2,6,0,False,False,False,0,4,2022-01-31T17:35:23.597,8,False,2.0
2021,21,3346,755,29,1067,2,4,3,5,6,1,5,1,5,0,False,False,False,0,2,2022-01-31T17:37:46.053,6,False,1.0
2021,21,3346,760,29,4866,2,2,4,5,25,20,7,18,7,0,True,False,False,1,2,2022-02-02T16:25:51.847,25,False,18.0
2021,21,3346,785,29,4866,2,51,10,-3,8,11,5,3,5,0,False,False,False,0,3,2022-01-31T17:43:02.597,8,False,3.0
2021,21,3346,805,28,7751,13,26,10,2,0,0,0,0,0,0,True,False,False,0,3,2022-01-31T17:45:30.997,0,False,0.0
2021,21,3346,810,28,7753,2,32,3,-4,-3,1,-3,0,-3,0,True,False,False,0,4,2022-02-02T18:12:09.077,-3,False,0.0
2021,21,3346,815,28,7751,3,12,3,-3,0,0,0,0,0,0,False,False,False,0,1,2022-02-02T16:26:09.757,0,False,0.0
2021,22,3347,15,29,7788,2,31,4,0,7,7,6,1,6,0,False,False,False,0,1,2022-02-14T10:22:35.357,7,False,1.0
2021,22,3347,40,7,3521,2,26,10,3,8,5,7,1,7,0,False,False,False,0,3,2022-02-14T10:50:17.053,8,False,1.0
2021,22,3347,55,7,8317,13,4,10,4,0,0,0,0,0,0,False,False,False,0,3,2022-02-14T10:53:42.157,0,False,0.0
2021,22,3347,70,29,4866,2,45,5,-1,20,21,2,18,2,0,True,False,False,2,3,2022-02-16T17:23:03.027,20,False,18.0
2021,22,3347,80,29,7378,2,44,3,-4,3,7,0,3,0,0,False,False,False,0,1,2022-02-14T11:03:33.46,3,False,3.0
2021,22,3347,85,29,1067,2,9,2,17,17,0,17,0,17,6,False,False,False,0,3,2022-02-14T11:04:43.517,17,True,0.0
2021,22,3347,100,7,4679,2,45,10,-5,0,5,0,0,0,0,False,False,False,0,1,2022-02-14T17:14:27.667,0,False,0.0
2021,22,3347,105,7,8317,2,6,4,4,6,2,5,1,5,0,False,False,False,0,3,2022-02-14T11:08:31.613,6,False,1.0
2021,22,3347,110,7,8325,13,11,2,17,0,0,0,0,0,0,False,False,False,0,1,2022-02-16T16:36:28.24,0,False,0.0
2021,22,3347,120,29,8455,2,32,4,1,5,4,4,1,4,0,False,False,False,0,4,2022-02-14T11:15:23.57,5,False,1.0
2021,22,3347,135,29,7828,2,5,3,4,4,0,4,0,4,0,False,False,False,0,3,2022-02-14T11:18:05.93,4,False,0.0
2021,22,3347,150,7,8317,2,19,2,42,46,4,42,4,42,0,False,False,False,0,2,2022-02-14T11:22:52.107,46,False,4.0
2021,22,3347,155,7,7659,13,4,9,8,0,0,0,0,0,0,False,False,False,0,3,2022-02-14T11:24:01.56,0,False,0.0
2021,22,3347,160,7,4679,3,47,5,-1,0,0,0,0,0,0,False,False,False,0,1,2022-02-14T11:25:22.82,0,False,0.0
2021,22,3347,165,7,7659,13,2,10,10,0,0,0,0,0,0,False,False,False,0,2,2022-02-14T11:27:11.817,0,False,0.0
2021,22,3347,190,29,4866,13,6,1,15,0,0,0,0,0,0,False,False,False,0,2,2022-02-16T17:42:04.023,0,False,0.0
2021,22,3347,195,29,1067,2,35,10,14,35,21,33,2,33,0,False,False,False,0,3,2022-02-14T11:39:11.657,35,False,2.0
2021,22,3347,200,29,7378,2,11,6,15,25,10,24,1,24,0,False,False,False,0,1,2022-02-16T17:27:58.377,25,False,1.0
2021,22,3347,215,29,4866,2,7,5,11,11,0,11,0,11,6,False,False,False,0,4,2022-02-14T17:10:23.37,11,True,0.0
2021,22,3347,230,7,3521,2,2,4,5,11,6,8,3,8,0,False,False,False,0,3,2022-02-14T11:50:34.52,11,False,3.0
2021,22,3347,240,7,8317,2,6,4,3,10,7,9,1,9,0,False,False,False,0,3,2022-02-14T11:59:47.747,10,False,1.0
2021,22,3347,255,7,4679,2,45,5,-4,0,4,-3,3,-3,0,True,False,False,0,1,2022-02-16T17:29:27.777,0,False,3.0
2021,22,3347,260,7,7659,2,4,10,8,14,6,9,5,9,0,False,False,False,0,2,2022-02-14T12:19:07.973,14,False,5.0
2021,22,3347,270,7,4679,2,6,5,4,4,0,4,0,4,0,False,False,False,0,2,2022-02-14T12:25:19.85,4,False,0.0
2021,22,3347,285,7,7659,2,7,5,6,6,0,6,0,6,6,False,False,False,0,3,2022-02-14T12:31:56.75,6,True,0.0
2021,22,3347,305,29,7828,2,44,3,-1,13,14,13,0,13,0,True,False,False,2,3,2022-02-16T17:23:12.09,13,False,0.0
2021,22,3347,315,29,1067,3,13,10,1,0,0,0,0,0,0,False,False,False,0,3,2022-02-16T18:03:59.05,0,False,0.0
2021,22,3347,320,29,7825,2,6,4,13,16,3,15,1,15,0,False,False,False,0,3,2022-02-14T13:41:31,16,False,1.0
2021,22,3347,340,29,7828,13,12,6,43,0,0,0,0,0,0,False,False,False,0,3,2022-02-14T13:45:43.557,0,False,0.0
2021,22,3347,350,7,7659,2,5,5,5,5,0,5,0,5,0,False,False,False,0,2,2022-02-14T13:48:04.123,5,False,0.0
2021,22,3347,355,7,2631,2,31,10,-3,6,9,3,3,3,0,False,False,False,0,3,2022-02-16T17:39:24.183,6,False,3.0
2021,22,3347,365,7,3521,2,5,3,4,4,0,4,0,4,0,False,False,False,0,3,2022-02-16T17:31:35.577,4,False,0.0
2021,22,3347,390,29,7378,13,19,6,26,0,0,0,0,0,0,False,False,False,0,2,2022-02-16T18:04:23.93,0,False,0.0
2021,22,3347,395,29,4866,2,5,5,5,9,4,7,2,7,0,False,False,False,0,3,2022-02-14T17:10:37.097,9,False,2.0
2021,22,3347,405,29,7828,13,9,6,29,0,0,0,0,0,0,False,False,False,0,3,2022-02-16T16:36:28.24,0,False,0.0
2021,22,3347,430,7,7659,2,11,6,38,75,37,75,0,75,6,False,False,False,0,3,2022-02-14T14:06:51.713,75,True,0.0
2021,22,3347,445,29,8455,3,6,1,15,0,0,0,0,0,0,False,False,False,0,3,2022-02-14T14:10:10.42,0,False,0.0
2021,22,3347,450,7,4679,2,44,3,-6,0,6,-1,1,-1,0,False,False,False,0,1,2022-02-14T17:14:02.413,0,False,1.0
2021,22,3347,460,7,8317,2,49,10,2,10,8,8,2,8,0,False,False,False,0,3,2022-02-14T14:14:51.273,10,False,2.0
2021,22,3347,475,7,2631,2,4,5,-1,5,6,2,3,2,0,False,False,False,1,2,2022-02-14T14:18:03.713,5,False,3.0
2021,22,3347,500,29,4866,13,5,5,5,0,0,0,0,0,0,False,False,False,0,2,2022-02-16T17:40:16.857,0,False,0.0
2021,22,3347,505,29,7378,2,29,5,12,15,3,13,2,13,0,True,False,False,0,3,2022-02-14T14:22:52.527,15,False,2.0
2021,22,3347,515,29,4866,2,4,9,13,13,0,13,0,13,0,False,False,False,0,2,2022-02-16T17:33:54.52,13,False,0.0
2021,22,3347,520,29,7825,2,4,9,4,16,12,9,7,9,0,False,False,False,1,4,2022-02-14T14:55:04.637,16,False,7.0
2021,22,3347,525,29,8455,2,4,5,5,7,2,6,1,6,0,False,False,False,0,2,2022-02-14T14:54:57.053,7,False,1.0
2021,22,3347,535,29,557,13,45,5,3,0,0,0,0,0,0,False,False,False,0,6,2022-02-14T14:58:03.7,0,False,0.0
2021,22,3347,560,7,8317,13,3,5,9,0,0,0,0,0,0,False,False,False,0,2,2022-02-15T20:51:24.187,0,False,0.0
2021,22,3347,570,29,7828,2,30,10,-1,-1,0,-1,0,-1,0,True,False,False,0,4,2022-02-14T15:13:06.777,-1,False,0.0
2021,22,3347,580,29,7788,2,4,10,4,4,0,4,0,4,0,False,False,False,0,1,2022-02-14T15:16:28.487,4,False,0.0
2021,22,3347,605,7,3445,2,2,10,9,17,8,14,3,14,0,False,False,False,0,2,2022-02-14T15:26:11.05,17,False,3.0
2021,22,3347,630,29,7828,13,9,2,24,0,0,0,0,0,0,False,False,False,0,3,2022-02-16T16:36:28.24,0,False,0.0
2021,22,3347,645,7,3521,2,12,10,8,16,8,14,2,14,0,False,False,False,0,3,2022-02-14T15:56:39.907,16,False,2.0
2021,22,3347,655,7,7659,13,2,10,7,0,0,0,0,0,0,False,False,False,0,2,2022-02-14T17:18:56.09,0,False,0.0
2021,22,3347,670,29,7828,2,44,3,-7,7,14,6,1,6,0,True,False,False,0,3,2022-02-14T16:04:22.983,7,False,1.0
2021,22,3347,680,29,8455,13,5,3,3,0,0,0,0,0,0,False,False,False,0,3,2022-02-14T16:06:23.017,0,False,0.0
2021,22,3347,705,7,8325,2,44,3,-1,3,4,2,1,2,0,False,False,False,0,1,2022-02-14T16:13:58.88,3,False,1.0
2021,22,3347,710,7,4679,2,45,10,-6,-3,3,-4,1,-4,0,False,False,False,0,1,2022-02-14T16:16:25.863,-3,False,1.0
2021,22,3347,720,7,3521,3,2,9,6,0,0,0,0,0,0,False,False,False,0,3,2022-02-14T16:22:47.13,0,False,0.0
2021,22,3347,730,29,7825,2,4,10,4,9,5,7,2,7,0,False,False,False,0,4,2022-02-16T17:34:25.633,9,False,2.0
2021,22,3347,735,29,8455,13,3,5,13,0,0,0,0,0,0,False,False,False,0,2,2022-02-14T16:26:18.52,0,False,0.0
2021,22,3347,750,29,7788,13,4,4,3,0,0,0,0,0,0,False,False,False,0,1,2022-02-14T16:32:12.683,0,False,0.0
2021,22,3347,755,29,4866,2,4,9,5,8,3,6,2,6,0,False,False,False,0,3,2022-02-14T17:11:10.903,8,False,2.0
2021,22,3347,760,29,7825,2,4,5,4,6,2,5,1,5,0,False,False,False,0,2,2022-02-14T16:34:23.193,6,False,1.0
2021,22,3347,765,29,7788,2,47,5,-3,3,6,1,2,1,0,True,False,False,0,3,2022-02-14T16:35:35.113,3,False,2.0
2021,22,3347,770,29,4866,2,8,10,13,22,9,16,6,16,0,False,False,False,0,2,2022-02-16T17:49:52.76,22,False,6.0
2021,22,3347,775,29,4866,2,5,10,8,8,0,8,0,8,0,False,False,False,0,3,2022-02-14T17:11:39.407,8,False,0.0
2021,22,3347,790,29,7828,13,35,10,8,0,0,0,0,0,0,False,False,False,0,3,2022-02-14T16:44:48.087,0,False,0.0
2021,22,3347,795,29,7378,13,16,10,0,0,0,0,0,0,0,False,False,False,0,1,2022-02-14T16:45:59.887,0,False,0.0
2021,22,3347,800,29,4866,13,2,4,6,0,0,0,0,0,0,False,False,False,0,3,2022-02-14T16:48:49.063,0,False,
2021,22,3347,805,29,4866,2,5,5,4,4,0,4,0,4,6,False,False,False,0,3,2022-02-14T16:52:21.073,4,True,
2021,22,3347,810,29,4866,13,5,5,4,0,0,0,0,0,0,False,False,False,0,3,2022-02-14T16:53:15.443,0,False,
2021,22,3347,825,29,4866,2,29,5,1,1,0,1,0,1,6,False,False,False,0,2,2022-02-14T17:12:15.62,1,True,0.0
2021,22,3347,840,7,8317,2,4,3,2,17,15,17,0,17,0,False,False,False,0,2,2022-02-14T16:58:25.643,17,True,0.0
2021,22,3347,845,7,3521,2,2,4,8,9,1,9,0,9,0,False,False,False,0,3,2022-02-14T16:59:47.273,9,False,0.0
2021,22,3347,850,7,8317,13,9,2,37,0,0,0,0,0,0,False,False,False,0,2,2022-02-25T16:34:27.68,0,False,0.0
2021,22,3347,865,7,4455,13,12,5,3,0,0,0,0,0,0,False,False,False,0,1,2022-02-14T17:05:49.003,0,False,0.0
